subject,interval,date_time,light,vo2,vco2,rer,heat,xyt,xt,xa,xf,yt,ya,yf,z,drink,feed
V285,1,2019-09-09 11:38:43,1,2699,2417,0.895,0.3,430,237,100,337,193,71,264,6,0.0,0.0
V285,2,2019-09-09 11:58:43,1,3351,2478,0.74,0.4,38,13,5,18,25,8,33,0,0.0,0.0
V285,3,2019-09-09 12:18:43,1,3287,2505,0.762,0.4,59,32,13,45,27,9,36,0,0.0,0.0
V285,4,2019-09-09 12:38:43,1,2979,2240,0.752,0.3,9,6,1,7,3,0,3,0,0.0,0.0
V285,5,2019-09-09 12:58:43,1,5029,4039,0.803,0.6,1139,637,431,1068,502,223,725,56,0.0,0.0
V285,6,2019-09-09 13:18:43,1,4252,3247,0.764,0.5,1351,741,330,1071,610,259,869,65,0.0,0.0
V285,7,2019-09-09 13:38:43,1,3183,2340,0.735,0.4,52,26,1,27,26,5,31,0,0.0,0.0
V285,8,2019-09-09 13:58:43,1,3078,2256,0.733,0.4,29,13,0,13,16,6,22,0,0.0,0.0
V285,9,2019-09-09 14:18:43,1,2814,2258,0.803,0.3,40,24,8,32,16,6,22,0,0.0,0.0
V285,10,2019-09-09 14:38:43,1,2969,2202,0.742,0.3,29,9,0,9,20,6,26,0,0.0,0.0
V285,11,2019-09-09 14:58:43,1,4006,3168,0.791,0.5,2301,1349,767,2116,952,453,1405,200,0.0,0.03
V285,12,2019-09-09 15:18:43,1,3131,2251,0.719,0.4,452,222,31,253,230,54,284,0,0.0,0.0
V285,13,2019-09-09 15:38:43,1,3057,2250,0.736,0.4,23,14,5,19,9,4,13,0,0.0,0.0
V285,14,2019-09-09 15:58:43,1,3417,2607,0.763,0.4,158,70,14,84,88,25,113,0,0.0,-0.03
V285,15,2019-09-09 16:18:43,1,2946,2245,0.762,0.3,1473,784,381,1165,689,275,964,100,0.0,0.03
V285,16,2019-09-09 16:38:43,1,3090,2399,0.776,0.4,52,31,4,35,21,5,26,0,0.0,0.0
V285,17,2019-09-09 16:58:43,1,4685,3851,0.822,0.6,3966,2282,1527,3809,1684,985,2669,693,0.0,0.02
V285,18,2019-09-09 17:18:43,1,3567,2881,0.808,0.4,1344,699,128,827,645,134,779,8,0.0,0.0
V285,19,2019-09-09 17:38:43,1,3251,2377,0.731,0.4,18,18,6,24,0,0,0,0,0.0,0.0
V285,20,2019-09-09 17:58:43,0,3137,2373,0.757,0.4,386,232,39,271,154,20,174,0,0.0,0.0
V285,21,2019-09-09 18:18:43,0,4754,3857,0.811,0.6,2310,1302,816,2118,1008,608,1616,361,0.0,0.03
V285,22,2019-09-09 18:38:43,0,3026,2531,0.836,0.4,1193,710,280,990,483,184,667,66,0.0,0.0
V285,23,2019-09-09 18:58:43,0,4716,3929,0.833,0.6,5899,3407,2379,5786,2492,1487,3979,1003,0.0,0.06
V285,24,2019-09-09 19:18:43,0,4826,3826,0.793,0.6,6164,3689,2660,6349,2475,1504,3979,1197,0.0,0.03
V285,25,2019-09-09 19:38:43,0,4428,3514,0.794,0.5,4918,2753,1786,4539,2165,1219,3384,974,0.0,0.03
V285,26,2019-09-09 19:58:43,0,4152,3401,0.819,0.5,4732,2649,1739,4388,2083,1219,3302,1074,0.0,0.03
V285,27,2019-09-09 20:18:43,0,4326,3544,0.819,0.5,4647,2654,1701,4355,1993,1153,3146,645,0.0,0.08
V285,28,2019-09-09 20:38:43,0,4195,3559,0.849,0.5,3690,2153,1362,3515,1537,817,2354,422,0.0,0.09
V285,29,2019-09-09 20:58:43,0,3763,3555,0.945,0.5,4163,2470,1548,4018,1693,894,2587,544,0.0,0.07
V285,30,2019-09-09 21:18:43,0,2732,2455,0.898,0.3,1394,831,393,1224,563,271,834,78,0.0,0.07
V285,31,2019-09-09 21:38:43,0,2875,2534,0.881,0.3,124,79,44,123,45,23,68,4,0.0,0.0
V285,32,2019-09-09 21:58:43,0,3917,3907,0.997,0.5,2137,1234,750,1984,903,546,1449,170,0.0,0.04
V285,33,2019-09-09 22:18:43,0,3730,3622,0.971,0.5,2994,1809,1101,2910,1185,618,1803,216,0.0,0.18
V285,34,2019-09-09 22:38:43,0,3754,3470,0.924,0.5,4386,2593,1739,4332,1793,1042,2835,983,0.14,0.0
V285,35,2019-09-09 22:58:43,0,3319,3372,1.016,0.4,2481,1471,687,2158,1010,444,1454,112,0.0,0.18
V285,36,2019-09-09 23:18:43,0,2774,2585,0.932,0.3,547,366,209,575,181,86,267,44,0.0,0.0
V285,37,2019-09-09 23:38:43,0,3949,3832,0.971,0.5,2709,1697,1160,2857,1012,570,1582,303,0.0,0.09
V285,38,2019-09-09 23:58:43,0,3571,3725,1.043,0.4,2593,1569,902,2471,1024,511,1535,278,0.16,0.16
V285,39,2019-10-09 00:18:43,0,2559,2661,1.04,0.3,2102,1214,679,1893,888,427,1315,212,0.0,0.09
V285,40,2019-10-09 00:38:43,0,2922,2754,0.942,0.4,108,66,23,89,42,17,59,0,0.0,0.0
V285,41,2019-10-09 00:58:43,0,4254,4112,0.967,0.5,797,423,182,605,374,168,542,9,0.0,0.0
V285,42,2019-10-09 01:18:43,0,3817,3702,0.97,0.5,3028,1866,1167,3033,1162,633,1795,165,0.16,0.29
V285,43,2019-10-09 01:38:43,0,3921,3787,0.966,0.5,3017,1767,1017,2784,1250,584,1834,307,0.12,0.15
V285,44,2019-10-09 01:58:43,0,2693,2534,0.941,0.3,34,26,3,29,8,3,11,0,0.0,0.0
V285,45,2019-10-09 02:18:43,0,2787,2875,1.032,0.3,11,3,0,3,8,2,10,0,0.0,0.0
V285,46,2019-10-09 02:38:43,0,2909,2858,0.983,0.4,224,131,62,193,93,54,147,2,0.0,0.0
V285,47,2019-10-09 02:58:43,0,3872,4335,1.12,0.5,3373,2012,1311,3323,1361,683,2044,563,0.0,0.22
V285,48,2019-10-09 03:18:43,0,3834,3817,0.996,0.5,2597,1446,729,2175,1151,431,1582,260,0.1,0.19
V285,49,2019-10-09 03:38:43,0,2519,2693,1.069,0.3,2162,1363,852,2215,799,344,1143,232,0.12,0.0
V285,50,2019-10-09 03:58:43,0,3554,3936,1.107,0.4,950,544,250,794,406,209,615,32,0.0,0.07
V285,51,2019-10-09 04:18:43,0,2894,2529,0.874,0.3,1722,988,566,1554,734,349,1083,202,0.0,0.09
V285,52,2019-10-09 04:38:43,0,4046,3962,0.979,0.5,1187,689,393,1082,498,245,743,75,0.0,0.0
V285,53,2019-10-09 04:58:43,0,3377,3359,0.995,0.4,2160,1373,881,2254,787,384,1171,251,0.12,0.26
V285,54,2019-10-09 05:18:43,0,3474,3606,1.038,0.4,2457,1551,961,2512,906,446,1352,111,0.12,0.13
V285,55,2019-10-09 05:38:43,0,2994,2821,0.942,0.4,310,167,29,196,143,23,166,3,0.0,0.0
V285,56,2019-10-09 05:58:43,1,4113,3897,0.948,0.5,1068,613,362,975,455,194,649,65,0.0,0.0
V285,57,2019-10-09 06:18:43,1,2341,2358,1.007,0.3,1070,652,382,1034,418,219,637,44,0.0,0.11
V285,58,2019-10-09 06:38:43,1,3102,2593,0.836,0.4,36,13,2,15,23,5,28,0,0.0,0.0
V285,59,2019-10-09 06:58:43,1,2545,2420,0.951,0.3,26,8,4,12,18,6,24,0,0.0,0.0
V285,60,2019-10-09 07:18:43,1,2769,2645,0.955,0.3,36,14,2,16,22,1,23,0,0.0,0.0
V285,61,2019-10-09 07:38:43,1,4233,4229,0.999,0.5,568,313,157,470,255,75,330,27,0.0,0.0
V285,62,2019-10-09 07:58:43,1,3181,3301,1.038,0.4,2511,1376,707,2083,1135,501,1636,199,0.0,0.09
V285,63,2019-10-09 08:18:43,1,2800,2606,0.931,0.3,196,106,27,133,90,28,118,0,0.0,0.0
V285,64,2019-10-09 08:38:43,1,2559,2281,0.891,0.3,39,27,9,36,12,4,16,0,0.0,0.0
V285,65,2019-10-09 08:58:43,1,2581,2297,0.89,0.3,103,46,14,60,57,18,75,0,0.0,0.0
V285,66,2019-10-09 09:18:43,1,3845,3439,0.894,0.5,347,213,101,314,134,57,191,13,0.0,0.0
V285,67,2019-10-09 09:38:43,1,3568,3338,0.936,0.4,2231,1322,716,2038,909,410,1319,159,0.0,0.17
V285,68,2019-10-09 09:58:43,1,2918,2749,0.942,0.4,79,29,4,33,50,17,67,0,0.0,0.0
V285,69,2019-10-09 10:18:43,1,3364,3348,0.995,0.4,1507,848,498,1346,659,274,933,94,0.0,0.0
V285,70,2019-10-09 10:38:43,1,3285,2742,0.834,0.4,245,138,27,165,107,16,123,0,0.0,0.0
V285,71,2019-10-09 10:58:43,1,3725,3257,0.875,0.4,629,339,71,410,290,111,401,0,0.0,0.09
V285,72,2019-10-09 11:18:43,1,3194,2690,0.842,0.4,199,101,15,116,98,17,115,0,0.0,0.0
V285,73,2019-10-09 11:38:43,1,2977,2518,0.846,0.4,26,11,2,13,15,5,20,0,0.0,0.0
V285,74,2019-10-09 11:58:43,1,3056,2706,0.885,0.4,114,57,20,77,57,23,80,0,0.0,0.0
V285,75,2019-10-09 12:18:43,1,3418,3045,0.891,0.4,1579,838,477,1315,741,323,1064,90,0.0,0.08
V285,76,2019-10-09 12:38:43,1,3150,2500,0.794,0.4,55,34,3,37,21,7,28,0,0.0,0.0
V285,77,2019-10-09 12:58:43,1,3443,2844,0.826,0.4,305,193,68,261,112,44,156,2,0.0,0.07
V285,78,2019-10-09 13:18:43,1,3660,3363,0.919,0.4,1671,998,473,1471,673,269,942,145,0.12,0.1
V285,79,2019-10-09 13:38:43,1,2980,2580,0.866,0.4,29,28,8,36,1,0,1,0,0.0,0.0
V285,80,2019-10-09 13:58:43,1,2738,2393,0.874,0.3,24,21,3,24,3,0,3,0,0.0,0.0
V285,81,2019-10-09 14:18:43,1,2979,2366,0.794,0.3,243,132,40,172,111,53,164,0,0.0,0.02
V285,82,2019-10-09 14:38:43,1,3793,3473,0.916,0.5,1080,649,325,974,431,171,602,13,0.0,0.14
V285,83,2019-10-09 14:58:43,1,2952,2693,0.912,0.4,43,14,3,17,29,13,42,0,0.0,0.0
V285,84,2019-10-09 15:18:43,1,2740,2385,0.87,0.3,20,13,2,15,7,2,9,0,0.0,0.0
V285,85,2019-10-09 15:38:43,1,2817,2427,0.862,0.3,60,31,12,43,29,8,37,0,0.0,0.0
V285,86,2019-10-09 15:58:43,1,3525,3102,0.88,0.4,347,216,113,329,131,51,182,0,0.0,0.0
V285,87,2019-10-09 16:18:43,1,3812,3685,0.967,0.5,1149,683,324,1007,466,160,626,56,0.0,0.1
V285,88,2019-10-09 16:38:43,1,2906,2496,0.859,0.3,150,90,15,105,60,19,79,13,0.0,0.0
V285,89,2019-10-09 16:58:43,1,3113,2691,0.864,0.4,109,28,3,31,81,21,102,0,0.0,0.0
V285,90,2019-10-09 17:18:43,1,3489,3401,0.975,0.4,1232,708,280,988,524,164,688,29,0.0,0.15
V285,91,2019-10-09 17:38:43,1,2963,2701,0.911,0.4,121,67,16,83,54,20,74,2,0.0,0.0
V285,92,2019-10-09 17:58:43,0,3041,2689,0.884,0.4,38,22,1,23,16,2,18,0,0.0,0.0
V285,93,2019-10-09 18:18:43,0,3935,3594,0.913,0.5,1313,737,294,1031,576,227,803,84,0.0,0.0
V285,94,2019-10-09 18:38:43,0,4176,4130,0.989,0.5,3205,1900,1180,3080,1305,647,1952,498,0.0,0.16
V285,95,2019-10-09 18:58:43,0,3853,3754,0.974,0.5,4354,2583,1668,4251,1771,847,2618,519,0.0,0.03
V285,96,2019-10-09 19:18:43,0,4230,4060,0.96,0.5,5942,3592,2560,6152,2350,1381,3731,882,0.0,0.09
V285,97,2019-10-09 19:38:43,0,4124,3982,0.965,0.5,4888,2933,1965,4898,1955,1042,2997,899,0.0,0.08
V285,98,2019-10-09 19:58:43,0,4196,3957,0.943,0.5,5227,3099,2093,5192,2128,1154,3282,937,0.0,0.08
V285,99,2019-10-09 20:18:43,0,4427,4094,0.925,0.5,4870,3049,1953,5002,1821,991,2812,617,0.0,0.07
V285,100,2019-10-09 20:38:43,0,3960,3765,0.951,0.5,4314,2688,1690,4378,1626,851,2477,477,0.0,0.09
V285,101,2019-10-09 20:58:43,0,3628,3787,1.044,0.5,2134,1224,612,1836,910,306,1216,148,0.0,0.13
V285,102,2019-10-09 21:18:43,0,3933,3754,0.954,0.5,722,407,250,657,315,129,444,25,0.0,0.0
V285,103,2019-10-09 21:38:43,0,4006,3964,0.99,0.5,4572,2755,1790,4545,1817,971,2788,329,0.16,0.16
V285,104,2019-10-09 21:58:43,0,4022,3807,0.947,0.5,4307,2578,1672,4250,1729,917,2646,399,0.0,0.08
V285,105,2019-10-09 22:18:43,0,3583,3593,1.003,0.4,3234,1934,1176,3110,1300,602,1902,229,0.14,0.19
V285,106,2019-10-09 22:38:43,0,4120,4038,0.98,0.5,2739,1466,779,2245,1273,544,1817,244,0.0,0.06
V285,107,2019-10-09 22:58:43,0,2577,2743,1.065,0.3,1142,596,255,851,546,174,720,73,0.0,0.09
V285,108,2019-10-09 23:18:43,0,3283,3412,1.039,0.4,2751,1644,958,2602,1107,505,1612,262,0.0,0.0
V285,109,2019-10-09 23:38:43,0,3169,3342,1.055,0.4,2885,1615,1002,2617,1270,672,1942,281,0.1,0.24
V285,110,2019-10-09 23:58:43,0,3448,3573,1.036,0.4,2401,1427,699,2126,974,403,1377,150,0.0,0.1
V285,111,2019-11-09 00:18:43,0,2880,2837,0.985,0.4,1516,1012,507,1519,504,197,701,60,0.12,0.15
V285,112,2019-11-09 00:38:43,0,3790,3882,1.024,0.5,798,520,299,819,278,140,418,34,0.06,0.0
V285,113,2019-11-09 00:58:43,0,2358,2582,1.095,0.3,526,283,40,323,243,23,266,2,0.0,0.0
V285,114,2019-11-09 01:18:43,0,3695,3781,1.023,0.5,1295,818,382,1200,477,216,693,55,0.0,0.11
V285,115,2019-11-09 01:38:43,0,3225,3383,1.049,0.4,3378,2062,1303,3365,1316,723,2039,316,0.0,0.25
V285,116,2019-11-09 01:58:43,0,2960,2849,0.963,0.4,561,373,153,526,188,90,278,13,0.0,0.0
V285,117,2019-11-09 02:18:43,0,2800,3089,1.103,0.4,148,70,27,97,78,49,127,0,0.0,0.0
V285,118,2019-11-09 02:38:43,0,3738,3883,1.039,0.5,2134,1421,781,2202,713,344,1057,57,0.22,0.25
V285,119,2019-11-09 02:58:43,0,2783,2877,1.034,0.3,214,105,15,120,109,26,135,2,0.0,0.0
V285,120,2019-11-09 03:18:43,0,3453,3693,1.07,0.4,1695,1127,625,1752,568,247,815,34,0.0,0.21
V285,121,2019-11-09 03:38:43,0,3034,3164,1.043,0.4,876,507,182,689,369,108,477,16,0.0,0.09
V285,122,2019-11-09 03:58:43,0,2635,2835,1.076,0.3,27,7,2,9,20,6,26,0,0.0,0.0
V285,123,2019-11-09 04:18:43,0,3550,3691,1.04,0.4,421,257,119,376,164,87,251,16,0.0,0.0
V285,124,2019-11-09 04:38:43,0,3165,3310,1.046,0.4,2151,1338,852,2190,813,366,1179,137,0.22,0.2
V285,125,2019-11-09 04:58:43,0,3217,3309,1.029,0.4,2250,1345,740,2085,905,418,1323,192,0.12,0.04
V285,126,2019-11-09 05:18:43,0,3522,3500,0.994,0.4,3178,1829,1143,2972,1349,642,1991,229,0.0,0.22
V285,127,2019-11-09 05:38:43,0,2835,2955,1.042,0.4,452,259,60,319,193,55,248,0,0.0,0.0
V285,128,2019-11-09 05:58:43,1,2649,2635,0.995,0.3,21,16,1,17,5,1,6,0,0.0,0.0
V285,129,2019-11-09 06:18:43,1,3352,3393,1.012,0.4,847,436,173,609,411,185,596,28,0.0,0.12
V285,130,2019-11-09 06:38:43,1,2636,2644,1.003,0.3,2324,1295,775,2070,1029,559,1588,195,0.0,0.03
V285,131,2019-11-09 06:58:43,1,2658,2491,0.937,0.3,17,1,0,1,16,2,18,0,0.0,0.0
V285,132,2019-11-09 07:18:43,1,2719,2543,0.935,0.3,25,11,4,15,14,4,18,0,0.0,0.0
V285,133,2019-11-09 07:38:43,1,2749,2548,0.927,0.3,17,5,1,6,12,3,15,0,0.0,0.0
V285,134,2019-11-09 07:58:43,1,3767,3811,1.012,0.5,2903,1872,1196,3068,1031,535,1566,170,0.14,0.12
V285,135,2019-11-09 08:18:43,1,3094,2959,0.956,0.4,744,413,105,518,331,104,435,35,0.0,0.0
V285,136,2019-11-09 08:38:43,1,3043,2747,0.903,0.4,101,25,6,31,76,12,88,0,0.0,0.0
V285,137,2019-11-09 08:58:43,1,3420,3362,0.983,0.4,620,341,157,498,279,126,405,15,0.0,0.09
V285,138,2019-11-09 09:18:43,1,2825,2774,0.982,0.3,985,580,292,872,405,185,590,88,0.0,0.0
V285,139,2019-11-09 09:38:43,1,2735,2491,0.911,0.3,49,31,6,37,18,5,23,0,0.0,0.0
V285,140,2019-11-09 09:58:43,1,3780,3463,0.916,0.5,420,242,128,370,178,63,241,3,0.0,0.03
V285,141,2019-11-09 10:18:43,1,3128,3122,0.998,0.4,1770,1168,589,1757,602,264,866,163,0.0,0.11
V285,142,2019-11-09 10:38:43,1,2709,2414,0.891,0.3,41,31,4,35,10,5,15,0,0.0,0.0
V285,143,2019-11-09 10:58:43,1,4265,3751,0.879,0.5,2377,1517,994,2511,860,450,1310,126,0.0,0.0
V285,144,2019-11-09 11:18:43,1,3013,2634,0.874,0.4,1508,868,417,1285,640,237,877,53,0.0,0.09
V285,145,2019-11-09 11:38:43,1,2897,2391,0.825,0.3,39,18,2,20,21,2,23,0,0.0,0.0
V285,146,2019-11-09 11:58:43,1,2713,2195,0.809,0.3,50,26,10,36,24,5,29,0,0.0,0.0
V285,147,2019-11-09 12:18:43,1,2853,2212,0.776,0.3,45,13,1,14,32,9,41,0,0.0,0.0
V285,148,2019-11-09 12:38:43,1,3476,3015,0.867,0.4,481,270,123,393,211,80,291,21,0.0,0.08
V285,149,2019-11-09 12:58:43,1,3321,3225,0.971,0.4,1994,1138,555,1693,856,328,1184,131,0.0,0.03
V285,150,2019-11-09 13:18:43,1,2716,2270,0.836,0.3,77,57,10,67,20,8,28,0,0.0,0.0
V285,151,2019-11-09 13:38:43,1,2711,2193,0.809,0.3,94,59,30,89,35,9,44,0,0.0,0.0
V285,152,2019-11-09 13:58:43,1,3561,3382,0.95,0.4,1481,964,572,1536,517,230,747,25,0.0,0.21
V285,153,2019-11-09 14:18:43,1,2818,2745,0.974,0.3,751,458,187,645,293,135,428,52,0.0,0.0
V285,154,2019-11-09 14:38:43,1,2656,2440,0.919,0.3,45,31,13,44,14,7,21,0,0.0,0.0
V285,155,2019-11-09 14:58:43,1,2478,2236,0.902,0.3,20,7,0,7,13,4,17,0,0.0,0.0
V285,156,2019-11-09 15:18:43,1,3284,3169,0.965,0.4,1040,542,230,772,498,204,702,15,0.0,0.08
V285,157,2019-11-09 15:38:43,1,2616,2502,0.956,0.3,2018,1241,735,1976,777,399,1176,150,0.16,0.03
V285,158,2019-11-09 15:58:43,1,2810,2514,0.895,0.3,22,11,5,16,11,1,12,0,0.0,0.0
V285,159,2019-11-09 16:18:43,1,2684,2389,0.89,0.3,112,62,28,90,50,13,63,0,0.0,0.0
V285,160,2019-11-09 16:38:43,1,3447,3404,0.988,0.4,2093,1282,663,1945,811,330,1141,97,0.0,0.16
V285,161,2019-11-09 16:58:43,1,2921,2747,0.94,0.4,383,279,52,331,104,18,122,0,0.0,0.0
V285,162,2019-11-09 17:18:43,1,2763,2634,0.954,0.3,113,45,11,56,68,16,84,0,0.0,0.0
V285,163,2019-11-09 17:38:43,1,2733,2414,0.883,0.3,26,19,5,24,7,3,10,0,0.0,0.0
V285,164,2019-11-09 17:58:43,0,3943,3936,0.998,0.5,1699,1126,613,1739,573,319,892,98,0.0,0.1
V285,165,2019-11-09 18:18:43,0,3329,3334,1.001,0.4,1364,792,307,1099,572,171,743,11,0.0,0.07
V285,166,2019-11-09 18:38:43,0,4039,3811,0.944,0.5,4383,2545,1595,4140,1838,987,2825,646,0.0,0.03
V285,167,2019-11-09 18:58:43,0,3720,3485,0.937,0.4,4389,2466,1543,4009,1923,1059,2982,628,0.0,0.06
V285,168,2019-11-09 19:18:43,0,3920,3779,0.964,0.5,4286,2596,1681,4277,1690,996,2686,759,0.0,0.1
V285,169,2019-11-09 19:38:43,0,2964,2641,0.891,0.4,2077,1145,586,1731,932,413,1345,115,0.0,0.03
V285,170,2019-11-09 19:58:43,0,3952,3775,0.955,0.5,2482,1585,1135,2720,897,532,1429,304,0.0,0.12
V285,171,2019-11-09 20:18:43,0,4060,3940,0.971,0.5,5246,3034,1944,4978,2212,1215,3427,669,0.0,0.03
V285,172,2019-11-09 20:38:43,0,3889,3727,0.958,0.5,3627,2088,1121,3209,1539,842,2381,447,0.0,0.1
V285,173,2019-11-09 20:58:43,0,3505,3448,0.984,0.4,1566,885,422,1307,681,318,999,62,0.0,0.13
V285,174,2019-11-09 21:18:43,0,2967,3124,1.053,0.4,599,321,163,484,278,120,398,7,0.14,0.08
V285,175,2019-11-09 21:38:43,0,2862,2861,1.0,0.4,1626,980,528,1508,646,311,957,99,0.0,0.09
V285,176,2019-11-09 21:58:43,0,3747,3858,1.03,0.5,2139,1288,720,2008,851,430,1281,51,0.08,0.19
V285,177,2019-11-09 22:18:43,0,3392,3499,1.032,0.4,417,280,156,436,137,72,209,21,0.0,0.0
V285,178,2019-11-09 22:38:43,0,2999,3121,1.041,0.4,851,451,185,636,400,169,569,14,0.0,0.19
V285,179,2019-11-09 22:58:43,0,3572,3600,1.008,0.4,3591,2028,1224,3252,1563,819,2382,296,0.16,0.1
V285,180,2019-11-09 23:18:43,0,2888,2898,1.003,0.4,912,545,329,874,367,170,537,38,0.0,0.15
V285,181,2019-11-09 23:38:43,0,2919,2998,1.027,0.4,581,315,145,460,266,85,351,13,0.0,0.0
V285,182,2019-11-09 23:58:43,0,3750,3819,1.019,0.5,1133,610,220,830,523,180,703,72,0.14,0.16
V285,183,2019-12-09 00:18:43,0,3240,3185,0.983,0.4,832,558,302,860,274,129,403,35,0.0,0.13
V285,184,2019-12-09 00:38:43,0,3533,3850,1.09,0.4,3560,2157,1170,3327,1403,692,2095,304,0.12,0.09
V285,185,2019-12-09 00:58:43,0,3242,3387,1.045,0.4,2652,1589,924,2513,1063,533,1596,201,0.1,0.19
V285,186,2019-12-09 01:18:43,0,2711,2862,1.056,0.3,1679,1002,532,1534,677,325,1002,36,0.0,0.07
V285,187,2019-12-09 01:38:43,0,2824,2957,1.047,0.4,54,38,11,49,16,6,22,0,0.0,0.0
V285,188,2019-12-09 01:58:43,0,3405,3671,1.078,0.4,636,399,152,551,237,111,348,3,0.0,0.03
V285,189,2019-12-09 02:18:43,0,3645,3877,1.064,0.5,3243,1916,1166,3082,1327,686,2013,354,0.0,0.17
V285,190,2019-12-09 02:38:43,0,3042,3150,1.036,0.4,99,54,19,73,45,7,52,1,0.0,0.0
V285,191,2019-12-09 02:58:43,0,3619,4100,1.133,0.5,1705,981,492,1473,724,324,1048,139,0.1,0.11
V285,192,2019-12-09 03:18:43,0,2809,2775,0.988,0.3,663,406,216,622,257,128,385,17,0.0,0.03
V285,193,2019-12-09 03:38:43,0,3493,3722,1.065,0.4,1905,1179,695,1874,726,396,1122,99,0.0,0.13
V285,194,2019-12-09 03:58:43,0,2158,2189,1.015,0.3,1772,1050,657,1707,722,328,1050,227,0.14,0.0
V285,195,2019-12-09 04:18:43,0,2423,2457,1.014,0.3,12,2,0,2,10,0,10,0,0.0,0.0
V285,196,2019-12-09 04:38:43,0,3465,3422,0.988,0.4,2259,1397,791,2188,862,440,1302,110,0.0,0.13
V285,197,2019-12-09 04:58:43,0,2467,2474,1.003,0.3,808,431,165,596,377,113,490,31,0.0,0.0
V285,198,2019-12-09 05:18:43,0,2995,2604,0.87,0.4,52,25,4,29,27,7,34,0,0.0,0.0
V285,199,2019-12-09 05:38:43,0,3426,3224,0.941,0.4,2571,1596,1049,2645,975,579,1554,178,0.0,0.03
V285,200,2019-12-09 05:58:43,1,2158,2094,0.97,0.3,840,507,189,696,333,127,460,23,0.0,0.0
V285,201,2019-12-09 06:18:43,1,2670,2221,0.832,0.3,18,9,2,11,9,0,9,0,0.0,0.0
V285,202,2019-12-09 06:38:43,1,3027,2714,0.897,0.4,162,70,15,85,92,36,128,24,0.0,0.0
V285,203,2019-12-09 06:58:43,1,2373,1956,0.824,0.3,637,348,202,550,289,133,422,16,0.0,0.0
V285,204,2019-12-09 07:18:43,1,2375,1996,0.841,0.3,35,33,10,43,2,0,2,0,0.0,0.0
V285,205,2019-12-09 07:38:43,1,3260,2864,0.878,0.4,294,129,31,160,165,54,219,2,0.0,0.0
V285,206,2019-12-09 07:58:43,1,2598,2057,0.792,0.3,445,209,91,300,236,64,300,6,0.0,0.0
V285,207,2019-12-09 08:18:43,1,2686,2172,0.809,0.3,12,7,0,7,5,3,8,0,0.0,0.0
V285,208,2019-12-09 08:38:43,1,2733,2136,0.782,0.3,78,50,8,58,28,7,35,0,0.0,0.0
V285,209,2019-12-09 08:58:43,1,3273,2742,0.838,0.4,2809,1786,1088,2874,1023,508,1531,205,0.0,0.03
V285,210,2019-12-09 09:18:43,1,2630,2140,0.814,0.3,303,161,25,186,142,27,169,0,0.0,0.0
V285,211,2019-12-09 09:38:43,1,2512,2023,0.805,0.3,1,0,0,0,1,0,1,0,0.0,0.0
V285,212,2019-12-09 09:58:43,1,2322,1853,0.798,0.3,29,7,0,7,22,7,29,0,0.0,0.0
V285,213,2019-12-09 10:18:43,1,2286,1763,0.771,0.3,19,8,2,10,11,4,15,0,0.0,0.0
V285,214,2019-12-09 10:38:43,1,2460,1895,0.77,0.3,211,183,10,193,28,14,42,0,0.0,0.03
V285,215,2019-12-09 10:58:43,1,3212,2734,0.851,0.4,2525,1575,850,2425,950,432,1382,135,0.0,0.0
V285,216,2019-12-09 11:18:43,1,3267,3155,0.966,0.4,2943,1798,1048,2846,1145,516,1661,296,0.0,0.2
V285,217,2019-12-09 11:38:43,1,2798,2670,0.954,0.3,1520,833,401,1234,687,280,967,11,0.14,0.12
V285,218,2019-12-09 11:58:43,1,2619,2410,0.92,0.3,22,16,0,16,6,0,6,0,0.0,0.02
V285,219,2019-12-09 12:18:43,1,2644,2316,0.876,0.3,44,23,0,23,21,4,25,0,0.0,0.0
V285,220,2019-12-09 12:38:43,1,2753,2622,0.952,0.3,229,132,36,168,97,36,133,0,0.0,0.05
V285,221,2019-12-09 12:58:43,1,3560,3544,0.996,0.4,1808,995,562,1557,813,382,1195,76,0.1,0.24
V285,222,2019-12-09 13:18:43,1,2791,2775,0.994,0.3,118,56,4,60,62,6,68,0,0.0,0.0
V285,223,2019-12-09 13:38:43,1,2433,2429,0.998,0.3,27,10,0,10,17,8,25,0,0.0,0.0
V285,224,2019-12-09 13:58:43,1,2652,2646,0.998,0.3,31,11,3,14,20,7,27,0,0.0,0.0
V285,225,2019-12-09 14:18:43,1,3323,3457,1.04,0.4,1227,795,435,1230,432,235,667,28,0.0,0.23
V285,226,2019-12-09 14:38:43,1,2468,2563,1.038,0.3,724,424,181,605,300,101,401,17,0.0,0.0
V285,227,2019-12-09 14:58:43,1,2485,2484,1.0,0.3,22,0,0,0,22,7,29,0,0.0,0.0
V285,228,2019-12-09 15:18:43,1,2417,2371,0.981,0.3,38,14,2,16,24,10,34,0,0.0,0.0
V285,229,2019-12-09 15:38:43,1,3297,3305,1.003,0.4,360,172,23,195,188,27,215,0,0.0,0.0
V285,230,2019-12-09 15:58:43,1,3083,3160,1.025,0.4,1213,694,319,1013,519,232,751,21,0.0,0.16
V285,231,2019-12-09 16:18:43,1,2435,2458,1.01,0.3,24,18,0,18,6,2,8,0,0.0,0.0
V285,232,2019-12-09 16:38:43,1,2455,2457,1.001,0.3,232,127,33,160,105,23,128,0,0.0,0.08
V285,233,2019-12-09 16:58:43,1,2702,2725,1.009,0.3,514,287,138,425,227,80,307,5,0.0,0.07
V285,234,2019-12-09 17:18:43,1,3407,3567,1.047,0.4,982,572,300,872,410,164,574,43,0.0,0.08
V285,235,2019-12-09 17:38:43,1,2730,2716,0.995,0.3,390,256,18,274,134,23,157,0,0.0,0.0
V285,236,2019-12-09 17:58:43,0,3286,3327,1.013,0.4,887,566,284,850,321,144,465,18,0.0,0.08
V285,237,2019-12-09 18:18:43,0,4880,4508,0.924,0.6,2862,1855,1185,3040,1007,557,1564,115,0.06,-0.03
V285,238,2019-12-09 18:38:43,0,3591,3347,0.932,0.4,2517,1553,774,2327,964,421,1385,51,0.0,0.0
V285,239,2019-12-09 18:58:43,0,3732,3030,0.812,0.4,1379,816,469,1285,563,288,851,38,0.0,0.0
V285,240,2019-12-09 19:18:43,0,2363,1990,0.842,0.3,1495,882,508,1390,613,328,941,78,0.0,0.0
V285,241,2019-12-09 19:38:43,0,4125,3341,0.81,0.5,2540,1594,945,2539,946,557,1503,216,0.0,0.0
V285,242,2019-12-09 19:58:43,0,3395,2698,0.795,0.4,4641,2797,1890,4687,1844,994,2838,657,0.0,0.0
V285,243,2019-12-09 20:18:43,0,2847,2188,0.768,0.3,74,55,6,61,19,1,20,0,0.0,0.0
V285,244,2019-12-09 20:38:43,0,3655,2909,0.796,0.4,5863,3542,2460,6002,2321,1328,3649,789,0.0,0.0
V285,245,2019-12-09 20:58:43,0,3194,2554,0.799,0.4,3413,1985,1179,3164,1428,699,2127,432,0.0,0.03
V285,246,2019-12-09 21:18:43,0,3736,2930,0.784,0.4,752,458,305,763,294,146,440,49,0.0,0.0
V285,247,2019-12-09 21:38:43,0,3806,2940,0.773,0.4,4511,2620,1677,4297,1891,1035,2926,767,0.0,0.0
V285,248,2019-12-09 21:58:43,0,3388,2621,0.774,0.4,3748,2186,1346,3532,1562,780,2342,522,0.0,0.0
V285,249,2019-12-09 22:18:43,0,3120,2332,0.748,0.4,1489,885,529,1414,604,248,852,70,0.16,0.0
V285,250,2019-12-09 22:38:43,0,2576,1962,0.762,0.3,52,34,1,35,18,8,26,0,0.0,0.0
V285,251,2019-12-09 22:58:43,0,4053,3143,0.775,0.5,2807,1750,1113,2863,1057,607,1664,359,0.0,0.0
V285,252,2019-12-09 23:18:43,0,2386,1865,0.781,0.3,2984,1766,1081,2847,1218,632,1850,273,0.0,0.0
V285,253,2019-12-09 23:38:43,0,2300,1786,0.777,0.3,3223,1999,1346,3345,1224,669,1893,366,0.0,0.0
V285,254,2019-12-09 23:58:43,0,2436,1813,0.744,0.3,24,14,0,14,10,1,11,0,0.0,0.0
V285,255,2019-09-13 00:18:43,0,3414,2699,0.791,0.4,599,396,239,635,203,124,327,23,0.0,0.0
V285,256,2019-09-13 00:38:43,0,3428,2634,0.769,0.4,4665,2903,2018,4921,1762,1072,2834,856,0.0,0.0
V285,257,2019-09-13 00:58:43,0,2042,1527,0.748,0.2,1565,935,555,1490,630,282,912,112,0.0,0.0
V285,258,2019-09-13 01:18:43,0,2538,1980,0.78,0.3,46,25,0,25,21,10,31,0,0.0,0.0
V285,259,2019-09-13 01:38:43,0,3787,2934,0.775,0.4,930,581,328,909,349,180,529,17,0.0,0.0
V285,260,2019-09-13 01:58:43,0,2968,2333,0.786,0.3,4250,2687,1736,4423,1563,919,2482,432,0.0,0.0
V285,261,2019-09-13 02:18:43,0,2225,1764,0.792,0.3,1072,639,323,962,433,215,648,50,0.0,0.0
V285,262,2019-09-13 02:38:43,0,2309,1764,0.764,0.3,46,16,7,23,30,7,37,0,0.0,0.0
V285,263,2019-09-13 02:58:43,0,3932,3103,0.789,0.5,1142,716,364,1080,426,194,620,25,0.0,0.0
V285,264,2019-09-13 03:18:43,0,3714,2953,0.795,0.4,4553,2965,1897,4862,1588,850,2438,573,0.16,0.0
V285,265,2019-09-13 03:38:43,0,2966,2383,0.803,0.3,3281,1941,1268,3209,1340,670,2010,320,0.0,0.0
V285,266,2019-09-13 03:58:43,0,1330,1000,0.752,0.2,583,347,133,480,236,83,319,4,0.0,0.0
V285,267,2019-09-13 04:18:43,0,1934,1437,0.743,0.2,503,336,199,535,167,61,228,32,0.0,0.0
V285,268,2019-09-13 04:38:43,0,1994,1481,0.743,0.2,13,7,2,9,6,0,6,0,0.0,0.0
V285,269,2019-09-13 04:58:43,0,2658,2094,0.788,0.3,74,25,1,26,49,17,66,0,0.0,0.0
V285,270,2019-09-13 05:18:43,0,2833,2249,0.794,0.3,1638,1067,677,1744,571,284,855,68,0.12,0.0
V285,271,2019-09-13 05:38:43,0,1297,1002,0.773,0.2,143,57,16,73,86,15,101,0,0.0,0.0
V285,272,2019-09-13 05:58:43,1,1119,848,0.758,0.1,7,2,1,3,5,0,5,0,0.0,0.0
V285,273,2019-09-13 06:18:43,1,2288,1672,0.731,0.3,22,15,0,15,7,3,10,0,0.0,0.0
V285,274,2019-09-13 06:38:43,1,2703,2019,0.747,0.3,24,13,1,14,11,3,14,0,0.0,0.0
V285,275,2019-09-13 06:58:43,1,3414,2899,0.849,0.4,1719,1181,766,1947,538,301,839,20,0.0,0.05
V285,276,2019-09-13 07:18:43,1,2745,2745,1.0,0.3,853,550,251,801,303,130,433,30,0.22,0.49
V285,277,2019-09-13 07:38:43,1,3173,3184,1.004,0.4,2316,1597,914,2511,719,357,1076,54,0.26,0.26
V285,278,2019-09-13 07:58:43,1,2567,2628,1.024,0.3,986,676,436,1112,310,153,463,8,0.12,0.21
V285,279,2019-09-13 08:18:43,1,2594,2674,1.031,0.3,147,97,65,162,50,23,73,2,0.06,0.0
V285,280,2019-09-13 08:38:43,1,2591,2636,1.017,0.3,41,18,4,22,23,7,30,0,0.0,0.0
V285,281,2019-09-13 08:58:43,1,2611,2678,1.025,0.3,21,7,0,7,14,2,16,0,0.0,0.0
V285,282,2019-09-13 09:18:43,1,2923,3040,1.04,0.4,1291,869,397,1266,422,193,615,10,0.06,0.16
V285,283,2019-09-13 09:38:43,1,3474,3576,1.03,0.4,1279,765,421,1186,514,209,723,9,0.0,0.0
V285,284,2019-09-13 09:58:43,1,2418,2467,1.02,0.3,841,539,292,831,302,130,432,4,0.0,0.0
V285,285,2019-09-13 10:18:43,1,2194,2306,1.051,0.3,26,15,4,19,11,5,16,0,0.0,0.0
V285,286,2019-09-13 10:38:43,1,2438,2546,1.044,0.3,67,36,18,54,31,13,44,0,0.0,0.0
V285,287,2019-09-13 10:58:43,1,2699,2893,1.072,0.3,894,584,271,855,310,138,448,36,0.16,0.23
V285,288,2019-09-13 11:18:43,1,2378,2494,1.049,0.3,857,542,248,790,315,110,425,10,0.0,0.14
V285,289,2019-09-13 11:38:43,1,2468,2632,1.066,0.3,53,32,7,39,21,4,25,0,0.0,0.0
V275,1,2019-09-09 11:28:43,1,3300,2110,0.639,0.4,16,15,5,20,1,0,1,0,0.0,0.0
V275,2,2019-09-09 11:48:43,1,3985,3200,0.803,0.5,1204,805,422,1227,399,173,572,73,0.0,0.0
V275,3,2019-09-09 12:08:43,1,2789,2299,0.824,0.3,851,564,326,890,287,132,419,23,0.0,0.0
V275,4,2019-09-09 12:28:43,1,2871,2207,0.769,0.4,44,15,8,23,29,9,38,0,0.0,0.0
V275,5,2019-09-09 12:48:43,1,2842,2248,0.791,0.4,54,34,15,49,20,10,30,0,0.0,0.0
V275,6,2019-09-09 13:08:43,1,3718,3359,0.904,0.5,1628,1014,624,1638,614,296,910,77,0.0,0.03
V275,7,2019-09-09 13:28:43,1,2878,2254,0.783,0.4,8,6,1,7,2,0,2,0,0.0,0.0
V275,8,2019-09-09 13:48:43,1,2896,2504,0.865,0.4,968,579,274,853,389,164,553,47,0.0,0.02
V275,9,2019-09-09 14:08:43,1,2998,2194,0.732,0.4,8,7,2,9,1,0,1,0,0.0,0.0
V275,10,2019-09-09 14:28:43,1,2795,2238,0.801,0.3,4,4,2,6,0,0,0,0,0.0,0.0
V275,11,2019-09-09 14:48:43,1,2935,2463,0.839,0.4,487,329,181,510,158,65,223,5,0.0,0.0
V275,12,2019-09-09 15:08:43,1,2907,2479,0.853,0.4,68,45,18,63,23,10,33,0,0.0,0.0
V275,13,2019-09-09 15:28:43,1,3700,3096,0.837,0.5,558,372,102,474,186,67,253,5,0.0,0.04
V275,14,2019-09-09 15:48:43,1,2750,2266,0.824,0.3,50,35,8,43,15,3,18,0,0.0,0.0
V275,15,2019-09-09 16:08:43,1,3071,2280,0.742,0.4,19,5,1,6,14,5,19,0,0.02,0.0
V275,16,2019-09-09 16:28:43,1,3824,3269,0.855,0.5,631,390,138,528,241,89,330,4,0.0,0.03
V275,17,2019-09-09 16:48:43,1,3795,3253,0.857,0.5,407,307,120,427,100,59,159,9,0.0,0.04
V275,18,2019-09-09 17:08:43,1,3026,2753,0.91,0.4,868,488,242,730,380,132,512,18,0.02,0.09
V275,19,2019-09-09 17:28:43,1,2863,2487,0.869,0.4,30,17,0,17,13,5,18,0,0.0,0.0
V275,20,2019-09-09 17:48:43,1,2736,2323,0.849,0.3,61,29,10,39,32,10,42,0,0.0,0.0
V275,21,2019-09-09 18:08:43,0,3503,3085,0.881,0.4,295,200,21,221,95,26,121,3,0.0,-0.03
V275,22,2019-09-09 18:28:43,0,2861,2415,0.844,0.4,965,561,163,724,404,127,531,17,0.0,0.03
V275,23,2019-09-09 18:48:43,0,3365,3037,0.902,0.4,1203,719,237,956,484,202,686,29,0.0,0.09
V275,24,2019-09-09 19:08:43,0,4148,3896,0.939,0.5,1766,1063,569,1632,703,367,1070,126,0.0,0.11
V275,25,2019-09-09 19:28:43,0,3753,3714,0.99,0.5,2396,1349,703,2052,1047,498,1545,394,0.02,0.09
V275,26,2019-09-09 19:48:43,0,2706,2897,1.071,0.4,989,591,306,897,398,213,611,47,0.02,0.11
V275,27,2019-09-09 20:08:43,0,4031,3975,0.986,0.5,1240,740,449,1189,500,293,793,127,0.06,0.07
V275,28,2019-09-09 20:28:43,0,3542,3458,0.976,0.5,2557,1487,974,2461,1070,658,1728,453,0.02,0.19
V275,29,2019-09-09 20:48:43,0,3542,3671,1.037,0.5,772,433,123,556,339,106,445,16,0.08,0.03
V275,30,2019-09-09 21:08:43,0,3716,3884,1.045,0.5,2433,1408,835,2243,1025,594,1619,456,0.02,0.19
V275,31,2019-09-09 21:28:43,0,2456,2670,1.087,0.3,1100,606,282,888,494,184,678,133,0.02,0.03
V275,32,2019-09-09 21:48:43,0,3451,2909,0.843,0.4,658,353,165,518,305,140,445,48,0.0,0.17
V275,33,2019-09-09 22:08:43,0,3154,3136,0.994,0.4,2384,1412,862,2274,972,566,1538,364,0.08,0.03
V275,34,2019-09-09 22:28:43,0,3844,3949,1.027,0.5,1071,628,253,881,443,170,613,44,0.1,0.37
V275,35,2019-09-09 22:48:43,0,2827,3063,1.083,0.4,103,63,3,66,40,16,56,0,0.12,0.0
V275,36,2019-09-09 23:08:43,0,2675,2894,1.082,0.4,553,321,145,466,232,86,318,21,0.0,0.0
V275,37,2019-09-09 23:28:43,0,3518,3621,1.029,0.5,1503,912,493,1405,591,338,929,75,0.12,0.15
V275,38,2019-09-09 23:48:43,0,2953,3038,1.029,0.4,24,15,3,18,9,0,9,0,0.0,0.0
V275,39,2019-10-09 00:08:43,0,3416,3642,1.066,0.5,1354,826,445,1271,528,256,784,50,0.0,0.03
V275,40,2019-10-09 00:28:43,0,2928,3096,1.057,0.4,1293,789,447,1236,504,251,755,43,0.06,0.2
V275,41,2019-10-09 00:48:43,0,3405,3186,0.936,0.4,176,106,53,159,70,40,110,2,0.0,0.0
V275,42,2019-10-09 01:08:43,0,2902,3225,1.111,0.4,997,560,188,748,437,165,602,9,0.0,0.25
V275,43,2019-10-09 01:28:43,0,2984,3256,1.091,0.4,507,337,85,422,170,75,245,0,0.14,0.09
V275,44,2019-10-09 01:48:43,0,3425,3500,1.022,0.4,669,378,189,567,291,140,431,9,0.08,0.04
V275,45,2019-10-09 02:08:43,0,3077,3357,1.091,0.4,1450,797,426,1223,653,305,958,102,0.08,0.16
V275,46,2019-10-09 02:28:43,0,2777,3104,1.118,0.4,88,42,5,47,46,21,67,0,0.0,0.0
V275,47,2019-10-09 02:48:43,0,3760,3740,0.995,0.5,1030,663,227,890,367,169,536,6,0.0,0.27
V275,48,2019-10-09 03:08:43,0,3005,2796,0.931,0.4,49,36,12,48,13,5,18,0,0.1,0.0
V275,49,2019-10-09 03:28:43,0,2866,2981,1.04,0.4,67,38,7,45,29,4,33,0,0.0,0.0
V275,50,2019-10-09 03:48:43,0,2754,2718,0.987,0.4,433,224,91,315,209,102,311,3,0.0,0.08
V275,51,2019-10-09 04:08:43,0,2850,3051,1.07,0.4,52,23,7,30,29,12,41,0,0.0,0.0
V275,52,2019-10-09 04:28:43,0,3677,3962,1.077,0.5,1220,652,357,1009,568,291,859,99,0.0,0.23
V275,53,2019-10-09 04:48:43,0,2967,3122,1.052,0.4,1125,628,218,846,497,180,677,51,0.08,0.07
V275,54,2019-10-09 05:08:43,0,3024,3028,1.001,0.4,84,50,12,62,34,10,44,0,0.0,0.0
V275,55,2019-10-09 05:28:43,0,3647,3836,1.052,0.5,1526,933,419,1352,593,277,870,42,0.1,0.16
V275,56,2019-10-09 05:48:43,0,3648,4154,1.139,0.5,2291,1220,660,1880,1071,604,1675,234,0.04,0.14
V275,57,2019-10-09 06:08:43,1,2432,2758,1.134,0.3,1259,700,408,1108,559,274,833,57,0.04,0.08
V275,58,2019-10-09 06:28:43,1,2831,2800,0.989,0.4,104,76,24,100,28,16,44,0,0.0,0.0
V275,59,2019-10-09 06:48:43,1,2621,2557,0.976,0.3,78,54,7,61,24,10,34,0,0.0,0.0
V275,60,2019-10-09 07:08:43,1,3770,3838,1.018,0.5,1677,994,569,1563,683,349,1032,121,0.0,0.08
V275,61,2019-10-09 07:28:43,1,3483,3598,1.033,0.5,1463,933,352,1285,530,202,732,19,0.02,0.04
V275,62,2019-10-09 07:48:43,1,2568,2435,0.948,0.3,124,100,0,100,24,3,27,0,0.0,0.0
V275,63,2019-10-09 08:08:43,1,2587,2406,0.93,0.3,33,19,0,19,14,5,19,0,0.0,0.0
V275,64,2019-10-09 08:28:43,1,2447,2270,0.928,0.3,202,160,26,186,42,21,63,0,0.0,0.0
V275,65,2019-10-09 08:48:43,1,3124,2738,0.876,0.4,730,411,186,597,319,159,478,39,0.0,0.14
V275,66,2019-10-09 09:08:43,1,2986,2949,0.988,0.4,1206,714,263,977,492,193,685,43,0.02,0.0
V275,67,2019-10-09 09:28:43,1,3012,2573,0.854,0.4,34,16,5,21,18,8,26,0,0.0,0.0
V275,68,2019-10-09 09:48:43,1,3115,2260,0.726,0.4,81,44,12,56,37,19,56,0,0.0,0.0
V275,69,2019-10-09 10:08:43,1,4762,3996,0.839,0.6,284,178,92,270,106,50,156,3,0.02,0.0
V275,70,2019-10-09 10:28:43,1,2989,2531,0.847,0.4,97,50,11,61,47,18,65,0,0.0,0.0
V275,71,2019-10-09 10:48:43,1,3047,2391,0.785,0.4,464,306,39,345,158,54,212,0,0.0,0.0
V275,72,2019-10-09 11:08:43,1,2772,2213,0.798,0.3,260,155,29,184,105,22,127,0,0.0,0.0
V275,73,2019-10-09 11:28:43,1,2917,2366,0.811,0.4,178,131,17,148,47,19,66,0,0.0,0.0
V275,74,2019-10-09 11:48:43,1,2684,2462,0.917,0.3,334,169,68,237,165,58,223,10,0.0,0.03
V275,75,2019-10-09 12:08:43,1,2922,2420,0.828,0.4,87,72,2,74,15,3,18,0,0.0,0.0
V275,76,2019-10-09 12:28:43,1,2664,2177,0.817,0.3,146,101,13,114,45,15,60,0,0.0,0.0
V275,77,2019-10-09 12:48:43,1,2777,2263,0.815,0.3,96,61,20,81,35,14,49,0,0.0,0.0
V275,78,2019-10-09 13:08:43,1,2508,1997,0.796,0.3,74,45,13,58,29,13,42,0,0.0,0.0
V275,79,2019-10-09 13:28:43,1,3142,2600,0.828,0.4,218,144,38,182,74,27,101,0,0.0,0.0
V275,80,2019-10-09 13:48:43,1,3360,3238,0.964,0.4,1204,730,375,1105,474,204,678,10,0.0,0.08
V275,81,2019-10-09 14:08:43,1,2846,2458,0.864,0.4,62,47,1,48,15,2,17,0,0.0,0.03
V275,82,2019-10-09 14:28:43,1,2683,2326,0.867,0.3,53,29,10,39,24,6,30,0,0.0,0.0
V275,83,2019-10-09 14:48:43,1,2873,2420,0.842,0.4,47,17,5,22,30,6,36,0,0.0,0.0
V275,84,2019-10-09 15:08:43,1,2618,2146,0.82,0.3,60,29,9,38,31,17,48,0,0.0,0.0
V275,85,2019-10-09 15:28:43,1,2640,2200,0.833,0.3,60,30,6,36,30,12,42,0,0.0,0.0
V275,86,2019-10-09 15:48:43,1,3138,2657,0.847,0.4,208,131,22,153,77,34,111,0,0.0,0.0
V275,87,2019-10-09 16:08:43,1,3457,3492,1.01,0.5,1056,645,281,926,411,170,581,16,0.02,0.22
V275,88,2019-10-09 16:28:43,1,2719,2708,0.996,0.4,529,358,65,423,171,31,202,0,0.0,0.0
V275,89,2019-10-09 16:48:43,1,2884,2682,0.93,0.4,71,29,8,37,42,18,60,0,0.0,0.0
V275,90,2019-10-09 17:08:43,1,3216,2898,0.901,0.4,112,61,19,80,51,18,69,0,0.0,0.0
V275,91,2019-10-09 17:28:43,1,2760,2376,0.861,0.3,73,37,10,47,36,7,43,0,0.0,0.0
V275,92,2019-10-09 17:48:43,1,3634,3449,0.949,0.5,1055,616,224,840,439,132,571,16,0.0,0.18
V275,93,2019-10-09 18:08:43,0,2994,2833,0.946,0.4,282,135,20,155,147,12,159,0,0.0,0.0
V275,94,2019-10-09 18:28:43,0,4018,3799,0.946,0.5,846,476,107,583,370,132,502,0,0.0,0.0
V275,95,2019-10-09 18:48:43,0,3186,3077,0.966,0.4,865,492,182,674,373,115,488,12,0.0,0.18
V275,96,2019-10-09 19:08:43,0,3688,3921,1.063,0.5,1412,813,323,1136,599,235,834,57,0.02,0.16
V275,97,2019-10-09 19:28:43,0,3867,4100,1.06,0.5,992,612,290,902,380,156,536,60,0.0,0.0
V275,98,2019-10-09 19:48:43,0,2913,3074,1.055,0.4,904,518,185,703,386,162,548,16,0.02,0.19
V275,99,2019-10-09 20:08:43,0,3330,3578,1.074,0.4,788,479,161,640,309,114,423,18,0.1,0.14
V275,100,2019-10-09 20:28:43,0,3646,3772,1.034,0.5,1793,1064,593,1657,729,356,1085,213,0.06,0.16
V275,101,2019-10-09 20:48:43,0,4016,4150,1.033,0.5,907,567,314,881,340,183,523,31,0.0,0.1
V275,102,2019-10-09 21:08:43,0,2790,2967,1.064,0.4,725,451,186,637,274,111,385,29,0.04,0.12
V275,103,2019-10-09 21:28:43,0,3821,4173,1.092,0.5,957,532,236,768,425,199,624,17,0.1,0.2
V275,104,2019-10-09 21:48:43,0,2781,3010,1.083,0.4,141,72,15,87,69,34,103,0,0.1,0.0
V275,105,2019-10-09 22:08:43,0,3896,4308,1.106,0.5,1678,1000,524,1524,678,309,987,89,0.02,0.24
V275,106,2019-10-09 22:28:43,0,2738,2955,1.079,0.4,713,464,165,629,249,91,340,11,0.04,0.11
V275,107,2019-10-09 22:48:43,0,3555,3829,1.077,0.5,894,538,294,832,356,200,556,12,0.0,0.04
V275,108,2019-10-09 23:08:43,0,4226,4482,1.061,0.6,2759,1673,1102,2775,1086,570,1656,327,0.06,0.24
V275,109,2019-10-09 23:28:43,0,3267,3621,1.108,0.4,3116,1878,1215,3093,1238,711,1949,536,0.06,0.12
V275,110,2019-10-09 23:48:43,0,3322,3531,1.063,0.4,719,403,145,548,316,149,465,16,0.08,0.14
V275,111,2019-11-09 00:08:43,0,3937,4206,1.068,0.5,2103,1242,757,1999,861,486,1347,142,0.02,0.0
V275,112,2019-11-09 00:28:43,0,3678,3815,1.037,0.5,3221,1921,1143,3064,1300,742,2042,524,0.08,0.16
V275,113,2019-11-09 00:48:43,0,3689,3829,1.038,0.5,1947,1121,580,1701,826,422,1248,86,0.1,0.16
V275,114,2019-11-09 01:08:43,0,2940,3146,1.07,0.4,65,29,2,31,36,8,44,0,0.0,0.0
V275,115,2019-11-09 01:28:43,0,2822,3112,1.103,0.4,88,51,10,61,37,20,57,0,0.0,0.0
V275,116,2019-11-09 01:48:43,0,3808,4010,1.053,0.5,633,394,179,573,239,94,333,28,0.0,0.0
V275,117,2019-11-09 02:08:43,0,4235,4498,1.062,0.6,2414,1410,905,2315,1004,558,1562,274,0.04,0.39
V275,118,2019-11-09 02:28:43,0,3698,4010,1.084,0.5,1654,995,410,1405,659,295,954,100,0.14,0.08
V275,119,2019-11-09 02:48:43,0,3214,3209,0.999,0.4,52,33,5,38,19,9,28,0,0.0,0.0
V275,120,2019-11-09 03:08:43,0,2776,2972,1.071,0.4,92,62,8,70,30,6,36,0,0.0,0.0
V275,121,2019-11-09 03:28:43,0,3580,3773,1.054,0.5,1703,1010,521,1531,693,336,1029,109,0.1,0.16
V275,122,2019-11-09 03:48:43,0,3826,4037,1.055,0.5,1980,1149,610,1759,831,445,1276,175,0.1,0.16
V275,123,2019-11-09 04:08:43,0,3051,3222,1.056,0.4,149,126,14,140,23,10,33,0,0.0,0.0
V275,124,2019-11-09 04:28:43,0,2907,2779,0.956,0.4,70,42,1,43,28,8,36,0,0.02,0.0
V275,125,2019-11-09 04:48:43,0,3851,3810,0.989,0.5,1165,698,313,1011,467,226,693,21,0.0,0.0
V275,126,2019-11-09 05:08:43,0,4190,4348,1.038,0.6,3204,1800,1147,2947,1404,787,2191,452,0.06,0.22
V275,127,2019-11-09 05:28:43,0,3789,4020,1.061,0.5,2471,1484,900,2384,987,559,1546,140,0.16,0.19
V275,128,2019-11-09 05:48:43,0,3915,4057,1.036,0.5,1963,1122,583,1705,841,420,1261,121,0.0,0.03
V275,129,2019-11-09 06:08:43,1,2743,2727,0.994,0.4,786,442,244,686,344,203,547,20,0.0,0.0
V275,130,2019-11-09 06:28:43,1,2839,2429,0.856,0.4,55,40,6,46,15,6,21,0,0.0,0.0
V275,131,2019-11-09 06:48:43,1,2840,2469,0.869,0.4,60,31,6,37,29,5,34,0,0.02,0.0
V275,132,2019-11-09 07:08:43,1,2504,2219,0.886,0.3,446,246,101,347,200,81,281,6,0.0,0.0
V275,133,2019-11-09 07:28:43,1,2844,2318,0.815,0.4,79,51,17,68,28,16,44,0,0.0,0.0
V275,134,2019-11-09 07:48:43,1,2720,2271,0.835,0.3,155,108,19,127,47,15,62,0,0.0,0.0
V275,135,2019-11-09 08:08:43,1,3003,2369,0.789,0.4,96,55,15,70,41,10,51,0,0.0,0.0
V275,136,2019-11-09 08:28:43,1,2606,2049,0.786,0.3,208,141,31,172,67,24,91,0,0.0,0.0
V275,137,2019-11-09 08:48:43,1,2970,2324,0.783,0.4,77,46,14,60,31,13,44,0,0.0,0.0
V275,138,2019-11-09 09:08:43,1,2838,2258,0.796,0.4,108,63,20,83,45,16,61,0,0.0,0.0
V275,139,2019-11-09 09:28:43,1,2882,2294,0.796,0.4,440,259,132,391,181,66,247,2,0.0,0.0
V275,140,2019-11-09 09:48:43,1,2619,2116,0.808,0.3,78,51,17,68,27,10,37,0,0.0,0.0
V275,141,2019-11-09 10:08:43,1,2506,1953,0.779,0.3,45,27,12,39,18,6,24,0,0.0,0.0
V275,142,2019-11-09 10:28:43,1,2689,2148,0.799,0.3,56,32,7,39,24,11,35,0,0.02,0.0
V275,143,2019-11-09 10:48:43,1,3785,2983,0.788,0.5,48,31,6,37,17,6,23,0,0.0,0.0
V275,144,2019-11-09 11:08:43,1,4071,3445,0.846,0.5,752,432,109,541,320,141,461,3,0.02,0.0
V275,145,2019-11-09 11:28:43,1,3804,3156,0.83,0.5,823,436,91,527,387,136,523,0,0.0,0.05
V275,146,2019-11-09 11:48:43,1,3087,2595,0.841,0.4,57,46,4,50,11,5,16,0,0.0,0.0
V275,147,2019-11-09 12:08:43,1,3084,2494,0.809,0.4,100,60,8,68,40,18,58,0,0.0,0.0
V275,148,2019-11-09 12:28:43,1,2994,2415,0.807,0.4,73,43,18,61,30,14,44,0,0.0,0.0
V275,149,2019-11-09 12:48:43,1,3073,2427,0.79,0.4,38,20,6,26,18,12,30,0,0.0,0.0
V275,150,2019-11-09 13:08:43,1,3576,2890,0.808,0.4,505,361,74,435,144,40,184,0,0.0,0.0
V275,151,2019-11-09 13:28:43,1,3123,2442,0.782,0.4,73,45,16,61,28,9,37,0,0.0,0.0
V275,152,2019-11-09 13:48:43,1,2945,2409,0.818,0.4,82,58,18,76,24,5,29,0,0.0,0.0
V275,153,2019-11-09 14:08:43,1,3061,2428,0.793,0.4,99,37,20,57,62,26,88,0,0.0,0.0
V275,154,2019-11-09 14:28:43,1,4190,3507,0.837,0.5,566,299,27,326,267,73,340,0,0.0,0.0
V275,155,2019-11-09 14:48:43,1,4103,3831,0.934,0.5,1320,820,381,1201,500,238,738,22,0.0,0.13
V275,156,2019-11-09 15:08:43,1,3083,2789,0.904,0.4,215,102,26,128,113,35,148,0,0.0,0.0
V275,157,2019-11-09 15:28:43,1,3147,2725,0.866,0.4,102,60,12,72,42,18,60,0,0.0,0.0
V275,158,2019-11-09 15:48:43,1,3044,2533,0.832,0.4,53,42,11,53,11,4,15,0,0.0,0.0
V275,159,2019-11-09 16:08:43,1,2843,2392,0.842,0.4,82,49,24,73,33,12,45,0,0.0,0.0
V275,160,2019-11-09 16:28:43,1,3874,3459,0.893,0.5,343,213,25,238,130,31,161,0,0.0,0.0
V275,161,2019-11-09 16:48:43,1,3139,2871,0.915,0.4,646,374,110,484,272,83,355,3,0.0,0.13
V275,162,2019-11-09 17:08:43,1,2938,2573,0.876,0.4,23,16,4,20,7,1,8,0,0.0,0.0
V275,163,2019-11-09 17:28:43,1,3151,2748,0.872,0.4,453,271,86,357,182,70,252,4,0.02,0.0
V275,164,2019-11-09 17:48:43,1,3713,3234,0.871,0.5,294,169,48,217,125,43,168,0,0.0,0.03
V275,165,2019-11-09 18:08:43,0,3162,2976,0.941,0.4,200,106,35,141,94,35,129,0,0.0,0.07
V275,166,2019-11-09 18:28:43,0,3882,3561,0.917,0.5,1081,632,138,770,449,122,571,3,0.0,0.07
V275,167,2019-11-09 18:48:43,0,3342,3248,0.972,0.4,1235,711,316,1027,524,216,740,46,0.0,0.07
V275,168,2019-11-09 19:08:43,0,3864,4038,1.045,0.5,2166,1284,770,2054,882,489,1371,210,0.0,0.15
V275,169,2019-11-09 19:28:43,0,3030,3123,1.031,0.4,2088,1128,582,1710,960,493,1453,185,0.0,0.09
V275,170,2019-11-09 19:48:43,0,3805,4008,1.054,0.5,1541,882,494,1376,659,373,1032,169,0.06,0.18
V275,171,2019-11-09 20:08:43,0,3097,3105,1.003,0.4,788,464,151,615,324,112,436,3,0.0,0.05
V275,172,2019-11-09 20:28:43,0,3622,3805,1.05,0.5,1838,1030,554,1584,808,426,1234,69,0.06,0.18
V275,173,2019-11-09 20:48:43,0,3023,3324,1.1,0.4,1241,698,313,1011,543,260,803,25,0.08,0.27
V275,174,2019-11-09 21:08:43,0,3302,3565,1.08,0.4,1498,880,458,1338,618,319,937,118,0.0,0.0
V275,175,2019-11-09 21:28:43,0,3593,3881,1.08,0.5,1148,699,397,1096,449,244,693,66,0.04,0.22
V275,176,2019-11-09 21:48:43,0,3258,3573,1.097,0.4,1989,1144,694,1838,845,472,1317,194,0.16,0.13
V275,177,2019-11-09 22:08:43,0,3578,3752,1.049,0.5,191,149,9,158,42,13,55,0,0.0,0.0
V275,178,2019-11-09 22:28:43,0,3323,3639,1.095,0.4,1105,621,308,929,484,183,667,2,0.0,0.09
V275,179,2019-11-09 22:48:43,0,3003,3211,1.069,0.4,425,262,144,406,163,92,255,6,0.0,0.08
V275,180,2019-11-09 23:08:43,0,3562,3632,1.02,0.5,878,577,282,859,301,117,418,3,0.0,0.11
V275,181,2019-11-09 23:28:43,0,3306,3865,1.169,0.4,2618,1550,938,2488,1068,582,1650,289,0.1,0.17
V275,182,2019-11-09 23:48:43,0,3982,4295,1.079,0.5,1944,1114,609,1723,830,455,1285,156,0.24,0.37
V275,183,2019-12-09 00:08:43,0,3056,3217,1.053,0.4,299,247,21,268,52,18,70,0,0.0,0.0
V275,184,2019-12-09 00:28:43,0,3035,3231,1.064,0.4,104,60,23,83,44,26,70,0,0.0,0.0
V275,185,2019-12-09 00:48:43,0,2943,3118,1.06,0.4,788,431,179,610,357,144,501,20,0.0,0.0
V275,186,2019-12-09 01:08:43,0,3587,3915,1.092,0.5,635,423,185,608,212,101,313,14,0.0,0.19
V275,187,2019-12-09 01:28:43,0,3597,3945,1.097,0.5,2969,1748,1101,2849,1221,739,1960,307,0.16,0.14
V275,188,2019-12-09 01:48:43,0,3916,4364,1.114,0.5,2626,1513,844,2357,1113,574,1687,232,0.04,0.07
V275,189,2019-12-09 02:08:43,0,2875,3111,1.082,0.4,867,530,217,747,337,137,474,5,0.1,0.09
V275,190,2019-12-09 02:28:43,0,3337,3362,1.008,0.4,80,52,16,68,28,7,35,0,0.0,0.0
V275,191,2019-12-09 02:48:43,0,3479,3607,1.037,0.5,479,200,31,231,279,79,358,0,0.0,0.0
V275,192,2019-12-09 03:08:43,0,3636,3924,1.079,0.5,1648,924,492,1416,724,325,1049,49,0.0,0.26
V275,193,2019-12-09 03:28:43,0,3930,4120,1.048,0.5,2937,1758,1101,2859,1179,713,1892,386,0.14,0.1
V275,194,2019-12-09 03:48:43,0,4414,4497,1.019,0.6,2579,1449,888,2337,1130,663,1793,304,0.16,0.21
V275,195,2019-12-09 04:08:43,0,2889,3095,1.071,0.4,1599,931,499,1430,668,341,1009,36,0.08,0.03
V275,196,2019-12-09 04:28:43,0,3241,3296,1.017,0.4,102,79,3,82,23,6,29,0,0.0,0.0
V275,197,2019-12-09 04:48:43,0,4217,4345,1.03,0.6,1259,758,329,1087,501,213,714,28,0.02,0.0
V275,198,2019-12-09 05:08:43,0,4452,4434,0.996,0.6,3255,1886,1225,3111,1369,811,2180,253,0.02,0.15
V275,199,2019-12-09 05:28:43,0,3778,3750,0.993,0.5,2942,1660,975,2635,1282,738,2020,298,0.08,0.06
V275,200,2019-12-09 05:48:43,0,3266,3186,0.976,0.4,2408,1394,813,2207,1014,540,1554,76,0.0,0.0
V275,201,2019-12-09 06:08:43,1,3130,2482,0.793,0.4,138,95,17,112,43,11,54,0,0.0,0.0
V275,202,2019-12-09 06:28:43,1,3151,2664,0.845,0.4,142,74,27,101,68,22,90,0,0.0,0.0
V275,203,2019-12-09 06:48:43,1,3053,2356,0.772,0.4,36,15,1,16,21,6,27,0,0.0,0.0
V275,204,2019-12-09 07:08:43,1,2618,2241,0.856,0.3,268,137,45,182,131,51,182,0,0.0,0.0
V275,205,2019-12-09 07:28:43,1,2898,2324,0.802,0.4,47,34,5,39,13,6,19,0,0.0,0.0
V275,206,2019-12-09 07:48:43,1,2903,2265,0.78,0.4,45,28,10,38,17,10,27,0,0.0,0.0
V275,207,2019-12-09 08:08:43,1,2829,2249,0.795,0.4,22,11,3,14,11,2,13,0,0.0,0.0
V275,208,2019-12-09 08:28:43,1,2823,2261,0.801,0.4,144,68,27,95,76,35,111,0,0.0,0.0
V275,209,2019-12-09 08:48:43,1,2629,2050,0.78,0.3,32,16,4,20,16,2,18,0,0.0,0.0
V275,210,2019-12-09 09:08:43,1,3515,2876,0.818,0.4,575,346,76,422,229,70,299,0,0.0,0.0
V275,211,2019-12-09 09:28:43,1,2997,2325,0.776,0.4,377,239,101,340,138,70,208,0,0.0,0.0
V275,212,2019-12-09 09:48:43,1,2956,2246,0.76,0.4,42,14,6,20,28,8,36,0,0.0,0.0
V275,213,2019-12-09 10:08:43,1,2800,2195,0.784,0.3,66,47,12,59,19,6,25,0,0.02,0.0
V275,214,2019-12-09 10:28:43,1,2720,2140,0.787,0.3,90,45,13,58,45,18,63,0,0.0,0.0
V275,215,2019-12-09 10:48:43,1,2901,2228,0.768,0.4,29,24,0,24,5,2,7,0,0.0,0.0
V275,216,2019-12-09 11:08:43,1,4186,3355,0.801,0.5,475,242,90,332,233,77,310,2,0.02,0.0
V275,217,2019-12-09 11:28:43,1,3494,3377,0.967,0.5,1558,958,487,1445,600,241,841,32,0.0,0.09
V275,218,2019-12-09 11:48:43,1,2872,2570,0.895,0.4,174,123,6,129,51,9,60,0,0.0,0.0
V275,219,2019-12-09 12:08:43,1,2911,2441,0.839,0.4,51,37,7,44,14,4,18,0,0.0,0.0
V275,220,2019-12-09 12:28:43,1,3034,2506,0.826,0.4,85,49,16,65,36,13,49,0,0.0,0.0
V275,221,2019-12-09 12:48:43,1,2783,2277,0.818,0.3,30,17,2,19,13,0,13,0,0.0,0.0
V275,222,2019-12-09 13:08:43,1,3378,2945,0.872,0.4,865,464,198,662,401,95,496,13,0.0,0.19
V275,223,2019-12-09 13:28:43,1,2859,2760,0.965,0.4,457,266,113,379,191,72,263,4,0.0,0.0
V275,224,2019-12-09 13:48:43,1,3062,2741,0.895,0.4,56,41,11,52,15,1,16,0,0.0,0.02
V275,225,2019-12-09 14:08:43,1,2925,2599,0.888,0.4,45,26,9,35,19,7,26,0,0.0,0.0
V275,226,2019-12-09 14:28:43,1,3251,2827,0.87,0.4,277,187,36,223,90,29,119,0,0.0,0.0
V275,227,2019-12-09 14:48:43,1,2886,2435,0.844,0.4,71,37,11,48,34,17,51,0,0.0,0.0
V275,228,2019-12-09 15:08:43,1,3000,2392,0.797,0.4,37,5,0,5,32,8,40,0,0.0,0.0
V275,229,2019-12-09 15:28:43,1,3111,2879,0.925,0.4,538,335,119,454,203,75,278,0,0.0,0.16
V275,230,2019-12-09 15:48:43,1,3019,2966,0.983,0.4,866,474,196,670,392,126,518,24,0.0,0.05
V275,231,2019-12-09 16:08:43,1,2829,2648,0.936,0.4,26,18,0,18,8,1,9,0,0.0,0.0
V275,232,2019-12-09 16:28:43,1,2806,2493,0.888,0.4,88,62,13,75,26,10,36,0,0.0,0.0
V275,233,2019-12-09 16:48:43,1,2791,2427,0.87,0.4,76,52,12,64,24,11,35,0,0.02,0.0
V275,234,2019-12-09 17:08:43,1,3376,3240,0.96,0.4,874,579,172,751,295,62,357,0,0.0,0.16
V275,235,2019-12-09 17:28:43,1,3160,2971,0.94,0.4,128,94,12,106,34,9,43,0,0.0,0.0
V275,236,2019-12-09 17:48:43,1,2803,2614,0.932,0.4,198,102,18,120,96,20,116,0,0.0,0.0
V275,237,2019-12-09 18:08:43,0,3694,3739,1.012,0.5,900,569,108,677,331,50,381,2,0.0,0.06
V275,238,2019-12-09 18:28:43,0,3612,3260,0.903,0.5,1601,967,490,1457,634,275,909,43,0.0,0.0
V275,239,2019-12-09 18:48:43,0,4084,3160,0.774,0.5,909,535,268,803,374,147,521,23,0.0,0.0
V275,240,2019-12-09 19:08:43,0,2952,3131,1.06,0.4,359,196,63,259,163,33,196,2,0.0,0.0
V275,241,2019-12-09 19:28:43,0,3603,2886,0.801,0.4,3132,1885,1197,3082,1247,712,1959,249,0.0,0.0
V275,242,2019-12-09 19:48:43,0,3737,2991,0.8,0.5,3319,1970,1275,3245,1349,771,2120,473,0.0,0.0
V275,243,2019-12-09 20:08:43,0,2143,1697,0.792,0.3,1674,1025,575,1600,649,347,996,243,0.02,0.0
V275,244,2019-12-09 20:28:43,0,4182,3303,0.79,0.5,942,589,358,947,353,179,532,185,0.0,0.0
V275,245,2019-12-09 20:48:43,0,3425,2699,0.788,0.4,2910,1719,996,2715,1191,685,1876,314,0.0,0.0
V275,246,2019-12-09 21:08:43,0,3889,3041,0.782,0.5,4525,2698,1760,4458,1827,1055,2882,739,0.0,0.0
V275,247,2019-12-09 21:28:43,0,3185,2575,0.808,0.4,2779,1649,913,2562,1130,561,1691,341,0.0,0.0
V275,248,2019-12-09 21:48:43,0,3238,2579,0.797,0.4,3100,1777,1039,2816,1323,706,2029,494,0.0,0.0
V275,249,2019-12-09 22:08:43,0,1857,1408,0.758,0.2,2148,1273,828,2101,875,471,1346,363,0.0,0.0
V275,250,2019-12-09 22:28:43,0,4113,3200,0.778,0.5,935,517,321,838,418,198,616,68,0.0,0.0
V275,251,2019-12-09 22:48:43,0,3915,3025,0.773,0.5,4541,2769,1600,4369,1772,941,2713,742,0.0,0.0
V275,252,2019-12-09 23:08:43,0,3675,2912,0.792,0.5,4719,2864,1791,4655,1855,1067,2922,767,0.0,0.0
V275,253,2019-12-09 23:28:43,0,3839,3016,0.786,0.5,4882,2970,1773,4743,1912,1105,3017,730,0.02,0.0
V275,254,2019-12-09 23:48:43,0,3749,2895,0.772,0.5,3912,2363,1323,3686,1549,840,2389,380,0.0,0.0
V275,255,2019-09-13 00:08:43,0,3491,2735,0.783,0.4,3821,2346,1353,3699,1475,768,2243,517,0.0,0.0
V275,256,2019-09-13 00:28:43,0,3358,2630,0.783,0.4,2476,1565,842,2407,911,482,1393,210,0.0,0.0
V275,257,2019-09-13 00:48:43,0,3192,2457,0.77,0.4,2390,1379,735,2114,1011,540,1551,256,0.0,0.0
V275,258,2019-09-13 01:08:43,0,3663,2853,0.779,0.5,4367,2491,1479,3970,1876,1038,2914,558,0.0,0.0
V275,259,2019-09-13 01:28:43,0,3234,2512,0.777,0.4,3719,2195,1233,3428,1524,839,2363,620,0.0,0.0
V275,260,2019-09-13 01:48:43,0,3438,2816,0.819,0.4,2669,1709,963,2672,960,507,1467,275,0.02,0.0
V275,261,2019-09-13 02:08:43,0,1543,1178,0.763,0.2,508,305,140,445,203,82,285,33,0.0,0.03
V275,262,2019-09-13 02:28:43,0,2318,1754,0.757,0.3,748,451,272,723,297,147,444,86,0.0,0.0
V275,263,2019-09-13 02:48:43,0,3631,2807,0.773,0.4,2664,1629,949,2578,1035,585,1620,277,0.0,-0.03
V275,264,2019-09-13 03:08:43,0,3399,2630,0.774,0.4,3804,2198,1270,3468,1606,890,2496,624,0.0,0.0
V275,265,2019-09-13 03:28:43,0,2489,1921,0.772,0.3,1950,1131,619,1750,819,437,1256,193,0.02,0.0
V275,266,2019-09-13 03:48:43,0,2382,1827,0.767,0.3,149,97,21,118,52,14,66,7,0.0,0.0
V275,267,2019-09-13 04:08:43,0,1519,1165,0.767,0.2,128,108,16,124,20,4,24,1,0.0,0.0
V275,268,2019-09-13 04:28:43,0,3690,2835,0.768,0.5,4478,2634,1733,4367,1844,1057,2901,679,0.0,0.0
V275,269,2019-09-13 04:48:43,0,3296,2572,0.78,0.4,3842,2266,1300,3566,1576,860,2436,466,0.0,0.0
V275,270,2019-09-13 05:08:43,0,1382,1053,0.762,0.2,843,469,239,708,374,200,574,118,0.0,0.0
V275,271,2019-09-13 05:28:43,0,1980,1489,0.752,0.2,546,392,121,513,154,76,230,13,0.0,0.0
V275,272,2019-09-13 05:48:43,0,1512,1133,0.749,0.2,105,78,1,79,27,8,35,0,0.0,0.0
V275,273,2019-09-13 06:08:43,1,1130,883,0.781,0.1,38,11,1,12,27,5,32,0,0.0,0.0
V275,274,2019-09-13 06:28:43,1,1450,1076,0.742,0.2,6,0,0,0,6,2,8,0,0.02,0.0
V275,275,2019-09-13 06:48:43,1,2214,1642,0.741,0.3,41,36,0,36,5,0,5,0,0.0,0.0
V275,276,2019-09-13 07:08:43,1,3500,3149,0.9,0.4,1324,823,463,1286,501,248,749,41,0.0,0.23
V275,277,2019-09-13 07:28:43,1,3081,3032,0.984,0.4,1522,889,513,1402,633,333,966,97,0.32,0.31
V275,278,2019-09-13 07:48:43,1,2520,2541,1.008,0.3,1396,883,475,1358,513,254,767,20,0.28,0.29
V275,279,2019-09-13 08:08:43,1,3124,3133,1.003,0.4,1352,757,383,1140,595,292,887,34,0.18,0.15
V275,280,2019-09-13 08:28:43,1,2792,2817,1.009,0.4,170,103,16,119,67,14,81,0,0.0,0.0
V275,281,2019-09-13 08:48:43,1,2722,2695,0.99,0.4,101,59,19,78,42,19,61,0,0.02,-0.02
V275,282,2019-09-13 09:08:43,1,2541,2572,1.012,0.3,71,42,13,55,29,5,34,0,0.0,0.0
V275,283,2019-09-13 09:28:43,1,2880,2930,1.017,0.4,52,21,6,27,31,4,35,0,0.0,0.0
V275,284,2019-09-13 09:48:43,1,3174,3159,0.995,0.4,756,431,130,561,325,93,418,0,0.02,0.0
V275,285,2019-09-13 10:08:43,1,2979,3157,1.06,0.4,666,429,198,627,237,98,335,1,0.08,0.3
V275,286,2019-09-13 10:28:43,1,2546,2635,1.035,0.3,294,161,34,195,133,45,178,0,0.0,0.0
V275,287,2019-09-13 10:48:43,1,2543,2625,1.032,0.3,46,24,7,31,22,7,29,0,0.02,0.0
V275,288,2019-09-13 11:08:43,1,3049,3203,1.051,0.4,387,263,89,352,124,38,162,0,0.02,0.0
V275,289,2019-09-13 11:28:43,1,3104,3298,1.063,0.4,455,240,95,335,215,71,286,0,0.12,0.39
V276,1,2019-09-09 11:32:43,1,3302,2821,0.854,0.4,663,394,197,591,269,156,425,33,0.0,0.0
V276,2,2019-09-09 11:52:43,1,2794,2111,0.756,0.4,828,520,231,751,308,133,441,28,0.0,0.0
V276,3,2019-09-09 12:12:43,1,2918,2214,0.759,0.4,80,46,2,48,34,2,36,0,0.0,0.0
V276,4,2019-09-09 12:32:43,1,4315,3443,0.798,0.6,600,371,196,567,229,112,341,14,0.0,0.0
V276,5,2019-09-09 12:52:43,1,2544,1842,0.724,0.3,485,306,89,395,179,88,267,3,0.0,0.0
V276,6,2019-09-09 13:12:43,1,2705,1957,0.724,0.3,137,131,5,136,6,0,6,0,0.0,0.0
V276,7,2019-09-09 13:32:43,1,2639,1854,0.703,0.3,125,123,6,129,2,2,4,0,0.0,0.0
V276,8,2019-09-09 13:52:43,1,2773,2018,0.728,0.4,54,46,3,49,8,1,9,0,0.0,0.0
V276,9,2019-09-09 14:12:43,1,2640,1990,0.754,0.3,21,17,0,17,4,0,4,0,0.0,0.0
V276,10,2019-09-09 14:32:43,1,2613,1983,0.759,0.3,270,245,13,258,25,1,26,0,0.0,0.0
V276,11,2019-09-09 14:52:43,1,4486,3592,0.801,0.6,694,412,212,624,282,148,430,14,0.0,0.0
V276,12,2019-09-09 15:12:43,1,3942,3286,0.834,0.5,1359,784,174,958,575,241,816,22,0.0,0.05
V276,13,2019-09-09 15:32:43,1,2653,2051,0.773,0.3,202,142,5,147,60,23,83,0,0.0,0.0
V276,14,2019-09-09 15:52:43,1,2787,2047,0.734,0.4,184,162,6,168,22,9,31,0,0.0,-0.02
V276,15,2019-09-09 16:12:43,1,2878,2167,0.753,0.4,74,57,18,75,17,4,21,0,0.0,0.0
V276,16,2019-09-09 16:32:43,1,2842,2174,0.765,0.4,53,29,11,40,24,10,34,0,0.0,0.0
V276,17,2019-09-09 16:52:43,1,4284,3475,0.811,0.6,785,467,253,720,318,152,470,19,0.0,0.0
V276,18,2019-09-09 17:12:43,1,2561,1972,0.77,0.3,760,438,117,555,322,98,420,18,0.02,0.0
V276,19,2019-09-09 17:32:43,1,2735,2033,0.743,0.4,32,21,1,22,11,2,13,0,0.0,0.0
V276,20,2019-09-09 17:52:43,1,2764,2105,0.761,0.4,24,9,0,9,15,0,15,0,0.0,0.0
V276,21,2019-09-09 18:12:43,0,4466,3721,0.833,0.6,817,492,265,757,325,174,499,53,0.0,0.03
V276,22,2019-09-09 18:32:43,0,4049,3387,0.836,0.5,2088,1189,501,1690,899,356,1255,95,0.02,0.03
V276,23,2019-09-09 18:52:43,0,4495,3933,0.875,0.6,1455,906,537,1443,549,285,834,124,0.0,0.07
V276,24,2019-09-09 19:12:43,0,4097,3943,0.962,0.6,3058,1839,1143,2982,1219,715,1934,622,0.04,0.1
V276,25,2019-09-09 19:32:43,0,3795,3544,0.934,0.5,3168,1850,1013,2863,1318,758,2076,308,0.0,0.03
V276,26,2019-09-09 19:52:43,0,4047,3672,0.907,0.5,3155,1887,1085,2972,1268,711,1979,449,0.02,0.11
V276,27,2019-09-09 20:12:43,0,2778,2355,0.848,0.4,1334,789,253,1042,545,166,711,47,0.04,0.03
V276,28,2019-09-09 20:32:43,0,4163,3884,0.933,0.6,1840,1163,769,1932,677,394,1071,279,0.02,0.1
V276,29,2019-09-09 20:52:43,0,3501,3510,1.003,0.5,1990,1133,582,1715,857,441,1298,190,0.1,0.26
V276,30,2019-09-09 21:12:43,0,2846,2670,0.938,0.4,399,245,49,294,154,37,191,5,0.08,0.0
V276,31,2019-09-09 21:32:43,0,4039,3990,0.988,0.6,1283,790,473,1263,493,283,776,127,0.04,0.11
V276,32,2019-09-09 21:52:43,0,3163,3308,1.046,0.4,1198,620,191,811,578,206,784,34,0.1,0.04
V276,33,2019-09-09 22:12:43,0,3627,3635,1.002,0.5,312,172,57,229,140,56,196,9,0.02,0.05
V276,34,2019-09-09 22:32:43,0,3685,3801,1.031,0.5,2183,1358,684,2042,825,498,1323,127,0.14,0.32
V276,35,2019-09-09 22:52:43,0,2597,2535,0.976,0.4,618,294,70,364,324,115,439,10,0.06,0.06
V276,36,2019-09-09 23:12:43,0,2779,2744,0.988,0.4,36,9,1,10,27,4,31,0,0.0,0.0
V276,37,2019-09-09 23:32:43,0,3727,3987,1.07,0.5,1003,614,297,911,389,178,567,50,0.04,0.17
V276,38,2019-09-09 23:52:43,0,3441,3667,1.066,0.5,1626,931,298,1229,695,285,980,35,0.14,0.14
V276,39,2019-10-09 00:12:43,0,2570,2627,1.022,0.4,737,379,178,557,358,169,527,8,0.04,0.12
V276,40,2019-10-09 00:32:43,0,2928,2911,0.994,0.4,38,15,0,15,23,1,24,0,0.0,0.0
V276,41,2019-10-09 00:52:43,0,2736,2832,1.035,0.4,115,91,5,96,24,7,31,0,0.0,0.0
V276,42,2019-10-09 01:12:43,0,3727,3763,1.01,0.5,640,412,194,606,228,110,338,31,0.04,0.02
V276,43,2019-10-09 01:32:43,0,2695,2711,1.006,0.4,883,488,167,655,395,148,543,22,0.1,0.19
V276,44,2019-10-09 01:52:43,0,2782,2858,1.027,0.4,76,43,4,47,33,10,43,0,0.0,0.0
V276,45,2019-10-09 02:12:43,0,2708,2714,1.002,0.4,87,25,3,28,62,9,71,0,0.0,0.0
V276,46,2019-10-09 02:32:43,0,2733,2604,0.953,0.4,877,474,76,550,403,110,513,0,0.0,0.05
V276,47,2019-10-09 02:52:43,0,2552,2632,1.031,0.4,72,40,5,45,32,13,45,0,0.0,0.0
V276,48,2019-10-09 03:12:43,0,3817,3792,0.993,0.5,772,492,202,694,280,158,438,24,0.0,0.19
V276,49,2019-10-09 03:32:43,0,3406,3578,1.05,0.5,1703,989,464,1453,714,354,1068,114,0.18,0.24
V276,50,2019-10-09 03:52:43,0,3837,4036,1.052,0.5,1538,954,454,1408,584,290,874,85,0.14,0.1
V276,51,2019-10-09 04:12:43,0,2893,2799,0.967,0.4,267,143,26,169,124,27,151,0,0.02,0.0
V276,52,2019-10-09 04:32:43,0,2760,2902,1.052,0.4,59,34,5,39,25,12,37,0,0.0,0.0
V276,53,2019-10-09 04:52:43,0,3539,3787,1.07,0.5,920,499,189,688,421,163,584,19,0.02,0.19
V276,54,2019-10-09 05:12:43,0,3002,3097,1.032,0.4,1600,991,569,1560,609,350,959,204,0.1,0.15
V276,55,2019-10-09 05:32:43,0,2805,2891,1.031,0.4,50,35,1,36,15,3,18,0,0.02,0.0
V276,56,2019-10-09 05:52:43,0,3641,3808,1.046,0.5,338,148,28,176,190,38,228,0,0.0,0.0
V276,57,2019-10-09 06:12:43,1,3616,3761,1.04,0.5,2151,1280,712,1992,871,468,1339,152,0.08,0.2
V276,58,2019-10-09 06:32:43,1,3475,3509,1.01,0.5,2006,1151,568,1719,855,454,1309,83,0.06,0.09
V276,59,2019-10-09 06:52:43,1,2537,2551,1.005,0.4,355,162,39,201,193,52,245,0,0.02,0.0
V276,60,2019-10-09 07:12:43,1,2649,2647,0.999,0.4,35,19,6,25,16,7,23,0,0.0,0.0
V276,61,2019-10-09 07:32:43,1,2731,2596,0.951,0.4,139,120,9,129,19,7,26,0,0.0,0.0
V276,62,2019-10-09 07:52:43,1,3362,3407,1.014,0.5,1481,878,434,1312,603,287,890,61,0.0,0.1
V276,63,2019-10-09 08:12:43,1,2675,2529,0.945,0.4,139,92,7,99,47,9,56,0,0.0,0.0
V276,64,2019-10-09 08:32:43,1,2673,2422,0.906,0.4,79,38,5,43,41,16,57,0,0.0,0.0
V276,65,2019-10-09 08:52:43,1,2811,2538,0.903,0.4,95,58,17,75,37,20,57,0,0.0,0.0
V276,66,2019-10-09 09:12:43,1,2735,2307,0.844,0.4,121,51,4,55,70,21,91,0,0.02,0.0
V276,67,2019-10-09 09:32:43,1,3985,3453,0.867,0.5,386,230,94,324,156,72,228,6,0.0,0.03
V276,68,2019-10-09 09:52:43,1,2744,2464,0.898,0.4,1037,694,309,1003,343,161,504,24,0.02,0.0
V276,69,2019-10-09 10:12:43,1,3847,3264,0.848,0.5,757,422,147,569,335,173,508,25,0.02,-3.45
V276,70,2019-10-09 10:32:43,1,2724,2392,0.878,0.4,249,140,20,160,109,37,146,0,0.0,0.18
V276,71,2019-10-09 10:52:43,1,3072,2570,0.837,0.4,57,26,0,26,31,8,39,0,0.0,0.0
V276,72,2019-10-09 11:12:43,1,3242,2690,0.83,0.4,182,109,2,111,73,15,88,0,0.0,0.0
V276,73,2019-10-09 11:32:43,1,3534,3260,0.923,0.5,1541,881,464,1345,660,310,970,108,0.0,0.02
V276,74,2019-10-09 11:52:43,1,2707,2230,0.824,0.4,92,39,1,40,53,10,63,0,0.0,-0.04
V276,75,2019-10-09 12:12:43,1,2766,2230,0.806,0.4,16,5,0,5,11,3,14,0,0.0,0.0
V276,76,2019-10-09 12:32:43,1,2837,2256,0.795,0.4,32,11,0,11,21,2,23,0,0.0,0.0
V276,77,2019-10-09 12:52:43,1,3420,2987,0.873,0.5,330,215,70,285,115,46,161,6,0.0,0.18
V276,78,2019-10-09 13:12:43,1,2496,2321,0.93,0.3,998,554,230,784,444,189,633,24,0.08,-0.04
V276,79,2019-10-09 13:32:43,1,2800,2362,0.844,0.4,67,48,2,50,19,6,25,0,0.02,-0.12
V276,80,2019-10-09 13:52:43,1,3012,2635,0.875,0.4,67,34,2,36,33,8,41,0,0.0,0.0
V276,81,2019-10-09 14:12:43,1,3495,3250,0.93,0.5,512,290,132,422,222,66,288,12,0.0,0.0
V276,82,2019-10-09 14:32:43,1,3470,3519,1.014,0.5,1135,687,258,945,448,201,649,34,0.1,-0.03
V276,83,2019-10-09 14:52:43,1,2888,2759,0.955,0.4,43,31,1,32,12,4,16,0,0.0,-0.24
V276,84,2019-10-09 15:12:43,1,2777,2521,0.908,0.4,51,17,3,20,34,5,39,0,0.0,-0.01
V276,85,2019-10-09 15:32:43,1,3244,3017,0.93,0.4,171,67,9,76,104,23,127,0,0.0,0.11
V276,86,2019-10-09 15:52:43,1,2596,2481,0.956,0.4,386,221,79,300,165,52,217,2,0.0,0.14
V276,87,2019-10-09 16:12:43,1,2731,2662,0.975,0.4,50,20,1,21,30,12,42,0,0.0,0.03
V276,88,2019-10-09 16:32:43,1,2809,2608,0.928,0.4,46,22,5,27,24,6,30,0,0.0,0.0
V276,89,2019-10-09 16:52:43,1,3178,3081,0.969,0.4,241,129,4,133,112,27,139,0,0.0,-0.01
V276,90,2019-10-09 17:12:43,1,3374,3429,1.016,0.5,1180,721,299,1020,459,178,637,34,0.08,0.02
V276,91,2019-10-09 17:32:43,1,2854,2693,0.944,0.4,112,70,8,78,42,7,49,0,0.0,0.0
V276,92,2019-10-09 17:52:43,1,3046,2647,0.869,0.4,133,84,3,87,49,7,56,0,0.0,-0.03
V276,93,2019-10-09 18:12:43,0,3723,3550,0.953,0.5,521,299,48,347,222,35,257,0,0.0,0.0
V276,94,2019-10-09 18:32:43,0,3861,3976,1.03,0.5,2255,1367,788,2155,888,473,1361,354,0.02,0.05
V276,95,2019-10-09 18:52:43,0,2799,2810,1.004,0.4,419,228,31,259,191,40,231,0,0.0,-0.03
V276,96,2019-10-09 19:12:43,0,4133,4343,1.051,0.6,3198,1896,1174,3070,1302,816,2118,820,0.1,0.23
V276,97,2019-10-09 19:32:43,0,3940,4162,1.056,0.6,2797,1655,951,2606,1142,638,1780,570,0.08,-0.19
V276,98,2019-10-09 19:52:43,0,3842,4172,1.086,0.5,1609,900,404,1304,709,342,1051,210,0.04,0.23
V276,99,2019-10-09 20:12:43,0,3485,3826,1.098,0.5,2341,1355,700,2055,986,485,1471,372,0.1,-0.27
V276,100,2019-10-09 20:32:43,0,3209,3442,1.073,0.5,1591,827,406,1233,764,330,1094,170,0.06,0.07
V276,101,2019-10-09 20:52:43,0,2807,3025,1.078,0.4,44,28,4,32,16,4,20,0,0.0,0.0
V276,102,2019-10-09 21:12:43,0,3423,3778,1.104,0.5,1215,734,376,1110,481,204,685,79,0.04,0.0
V276,103,2019-10-09 21:32:43,0,3948,4178,1.058,0.6,3109,1836,1033,2869,1273,704,1977,470,0.08,0.0
V276,104,2019-10-09 21:52:43,0,3423,3490,1.02,0.5,1802,1087,551,1638,715,330,1045,150,0.04,0.0
V276,105,2019-10-09 22:12:43,0,2891,3051,1.056,0.4,305,162,23,185,143,36,179,2,0.08,0.0
V276,106,2019-10-09 22:32:43,0,3104,3054,0.984,0.4,41,25,0,25,16,4,20,0,0.0,0.0
V276,107,2019-10-09 22:52:43,0,3683,3933,1.068,0.5,1824,1157,691,1848,667,381,1048,152,0.0,0.0
V276,108,2019-10-09 23:12:43,0,3781,4046,1.07,0.5,1650,905,356,1261,745,288,1033,111,0.08,0.0
V276,109,2019-10-09 23:32:43,0,2882,2919,1.013,0.4,1008,633,189,822,375,139,514,26,0.02,0.0
V276,110,2019-10-09 23:52:43,0,2617,2548,0.974,0.4,657,403,136,539,254,107,361,34,0.04,0.0
V276,111,2019-11-09 00:12:43,0,3038,2976,0.98,0.4,367,231,74,305,136,62,198,6,0.0,0.0
V276,112,2019-11-09 00:32:43,0,2856,2768,0.969,0.4,71,41,17,58,30,13,43,0,0.0,0.0
V276,113,2019-11-09 00:52:43,0,3756,4035,1.074,0.5,1536,938,511,1449,598,320,918,156,0.04,0.0
V276,114,2019-11-09 01:12:43,0,2901,2923,1.008,0.4,253,134,33,167,119,40,159,4,0.06,0.0
V276,115,2019-11-09 01:32:43,0,3133,2990,0.954,0.4,60,33,5,38,27,5,32,0,0.0,0.0
V276,116,2019-11-09 01:52:43,0,3750,3756,1.002,0.5,1536,959,385,1344,577,266,843,106,0.02,0.0
V276,117,2019-11-09 02:12:43,0,3568,3882,1.088,0.5,2330,1412,748,2160,918,520,1438,259,0.18,0.0
V276,118,2019-11-09 02:32:43,0,3738,3963,1.06,0.5,2365,1327,757,2084,1038,557,1595,226,0.1,0.0
V276,119,2019-11-09 02:52:43,0,2796,2960,1.059,0.4,411,274,23,297,137,44,181,0,0.0,0.0
V276,120,2019-11-09 03:12:43,0,2997,3012,1.005,0.4,38,20,4,24,18,5,23,0,0.0,0.0
V276,121,2019-11-09 03:32:43,0,3075,2839,0.923,0.4,119,65,8,73,54,15,69,0,0.0,0.0
V276,122,2019-11-09 03:52:43,0,2962,2976,1.005,0.4,657,394,95,489,263,43,306,2,0.0,0.0
V276,123,2019-11-09 04:12:43,0,3115,3181,1.021,0.4,1351,803,396,1199,548,241,789,177,0.12,0.0
V276,124,2019-11-09 04:32:43,0,3169,3169,1.0,0.4,232,216,0,216,16,7,23,0,0.0,0.0
V276,125,2019-11-09 04:52:43,0,3877,3973,1.025,0.5,1319,765,332,1097,554,242,796,39,0.02,0.0
V276,126,2019-11-09 05:12:43,0,2882,2932,1.017,0.4,1071,633,195,828,438,193,631,69,0.08,0.0
V276,127,2019-11-09 05:32:43,0,3036,3081,1.015,0.4,106,70,8,78,36,8,44,0,0.02,0.0
V276,128,2019-11-09 05:52:43,0,3860,3992,1.034,0.5,2162,1270,637,1907,892,485,1377,110,0.04,0.0
V276,129,2019-11-09 06:12:43,1,3768,3676,0.976,0.5,3903,2304,1515,3819,1599,923,2522,729,0.04,0.0
V276,130,2019-11-09 06:32:43,1,3160,3059,0.968,0.4,1544,921,440,1361,623,288,911,76,0.08,0.0
V276,131,2019-11-09 06:52:43,1,2867,2544,0.887,0.4,115,101,1,102,14,0,14,0,0.0,0.0
V276,132,2019-11-09 07:12:43,1,2781,2389,0.859,0.4,28,17,1,18,11,0,11,0,0.0,0.0
V276,133,2019-11-09 07:32:43,1,2737,2552,0.932,0.4,493,278,82,360,215,65,280,3,0.0,0.0
V276,134,2019-11-09 07:52:43,1,2929,2632,0.899,0.4,54,18,4,22,36,15,51,0,0.0,0.0
V276,135,2019-11-09 08:12:43,1,2713,2373,0.875,0.4,60,33,3,36,27,14,41,0,0.0,0.0
V276,136,2019-11-09 08:32:43,1,3213,2874,0.895,0.4,453,298,90,388,155,54,209,0,0.0,0.0
V276,137,2019-11-09 08:52:43,1,3678,3073,0.836,0.5,755,427,155,582,328,133,461,7,0.0,0.04
V276,138,2019-11-09 09:12:43,1,2742,2337,0.852,0.4,121,33,4,37,88,17,105,0,0.0,0.0
V276,139,2019-11-09 09:32:43,1,2774,2276,0.82,0.4,19,14,1,15,5,0,5,0,0.0,0.0
V276,140,2019-11-09 09:52:43,1,2815,2264,0.804,0.4,148,96,17,113,52,18,70,0,0.0,0.0
V276,141,2019-11-09 10:12:43,1,3522,3189,0.906,0.5,800,465,174,639,335,112,447,7,0.0,0.11
V276,142,2019-11-09 10:32:43,1,2837,2608,0.919,0.4,199,149,27,176,50,10,60,0,0.02,0.0
V276,143,2019-11-09 10:52:43,1,3998,3389,0.848,0.5,588,351,141,492,237,116,353,6,0.02,0.0
V276,144,2019-11-09 11:12:43,1,3818,3508,0.919,0.5,535,306,87,393,229,85,314,24,0.0,0.0
V276,145,2019-11-09 11:32:43,1,2518,2173,0.863,0.3,995,627,191,818,368,129,497,27,0.0,0.04
V276,146,2019-11-09 11:52:43,1,2957,2461,0.832,0.4,38,15,0,15,23,5,28,0,0.0,0.0
V276,147,2019-11-09 12:12:43,1,2899,2374,0.819,0.4,24,7,0,7,17,8,25,0,0.0,0.0
V276,148,2019-11-09 12:32:43,1,2803,2624,0.936,0.4,424,284,62,346,140,58,198,0,0.0,0.14
V276,149,2019-11-09 12:52:43,1,2754,2526,0.917,0.4,15,2,1,3,13,6,19,0,0.0,0.0
V276,150,2019-11-09 13:12:43,1,2722,2474,0.909,0.4,60,31,11,42,29,9,38,0,0.02,0.0
V276,151,2019-11-09 13:32:43,1,3753,3711,0.989,0.5,1169,748,413,1161,421,202,623,102,0.1,0.22
V276,152,2019-11-09 13:52:43,1,2667,2691,1.009,0.4,913,541,158,699,372,126,498,23,0.06,-0.02
V276,153,2019-11-09 14:12:43,1,2700,2450,0.908,0.4,29,2,0,2,27,13,40,0,0.0,0.0
V276,154,2019-11-09 14:32:43,1,2706,2429,0.898,0.4,65,42,7,49,23,2,25,0,0.0,0.0
V276,155,2019-11-09 14:52:43,1,3600,3447,0.957,0.5,586,366,174,540,220,98,318,10,0.0,0.15
V276,156,2019-11-09 15:12:43,1,2614,2513,0.961,0.4,798,588,144,732,210,32,242,0,0.02,0.0
V276,157,2019-11-09 15:32:43,1,2743,2533,0.923,0.4,37,17,0,17,20,11,31,0,0.0,0.0
V276,158,2019-11-09 15:52:43,1,2673,2465,0.922,0.4,67,31,9,40,36,6,42,0,0.0,0.0
V276,159,2019-11-09 16:12:43,1,3325,3260,0.981,0.5,385,235,34,269,150,25,175,0,0.0,0.1
V276,160,2019-11-09 16:32:43,1,2661,2690,1.011,0.4,761,405,104,509,356,102,458,22,0.12,0.0
V276,161,2019-11-09 16:52:43,1,2902,2590,0.892,0.4,35,21,0,21,14,0,14,0,0.0,0.0
V276,162,2019-11-09 17:12:43,1,3301,3102,0.94,0.4,348,204,93,297,144,52,196,7,0.0,0.11
V276,163,2019-11-09 17:32:43,1,3461,3591,1.037,0.5,1693,941,498,1439,752,292,1044,145,0.04,0.09
V276,164,2019-11-09 17:52:43,1,2906,2840,0.977,0.4,44,15,2,17,29,4,33,0,0.0,0.0
V276,165,2019-11-09 18:12:43,0,3549,3563,1.004,0.5,614,388,26,414,226,37,263,0,0.0,0.0
V276,166,2019-11-09 18:32:43,0,3767,3879,1.03,0.5,2580,1452,785,2237,1128,498,1626,332,0.06,0.15
V276,167,2019-11-09 18:52:43,0,3115,3237,1.039,0.4,1186,636,256,892,550,182,732,42,0.04,0.19
V276,168,2019-11-09 19:12:43,0,3076,3204,1.042,0.4,123,88,2,90,35,13,48,0,0.0,0.0
V276,169,2019-11-09 19:32:43,0,3972,4250,1.07,0.6,2684,1628,943,2571,1056,525,1581,354,0.06,0.21
V276,170,2019-11-09 19:52:43,0,3744,3959,1.057,0.5,2717,1580,885,2465,1137,563,1700,397,0.14,0.25
V276,171,2019-11-09 20:12:43,0,2954,3184,1.078,0.4,610,303,107,410,307,84,391,14,0.06,0.0
V276,172,2019-11-09 20:32:43,0,2962,3212,1.084,0.4,218,146,37,183,72,24,96,0,0.0,0.0
V276,173,2019-11-09 20:52:43,0,3692,3993,1.082,0.5,1959,1240,578,1818,719,366,1085,146,0.06,0.2
V276,174,2019-11-09 21:12:43,0,3517,3862,1.098,0.5,3386,1854,1075,2929,1532,676,2208,410,0.14,0.17
V276,175,2019-11-09 21:32:43,0,3101,3251,1.048,0.4,837,455,98,553,382,115,497,29,0.06,0.0
V276,176,2019-11-09 21:52:43,0,3025,3070,1.015,0.4,62,33,0,33,29,8,37,0,0.0,0.0
V276,177,2019-11-09 22:12:43,0,3204,3184,0.994,0.4,181,120,32,152,61,14,75,0,0.0,0.0
V276,178,2019-11-09 22:32:43,0,4022,4293,1.067,0.6,3041,1813,1177,2990,1228,646,1874,327,0.14,0.23
V276,179,2019-11-09 22:52:43,0,3331,3625,1.088,0.5,1844,1067,494,1561,777,327,1104,53,0.1,0.23
V276,180,2019-11-09 23:12:43,0,2958,3088,1.044,0.4,274,112,8,120,162,38,200,0,0.0,0.0
V276,181,2019-11-09 23:32:43,0,3310,3371,1.018,0.5,94,56,6,62,38,12,50,0,0.0,0.0
V276,182,2019-11-09 23:52:43,0,2751,2826,1.027,0.4,145,89,27,116,56,11,67,0,0.0,0.0
V276,183,2019-12-09 00:12:43,0,3976,4251,1.069,0.6,1836,1058,467,1525,778,374,1152,124,0.14,0.24
V276,184,2019-12-09 00:32:43,0,3546,3874,1.092,0.5,2172,1263,624,1887,909,420,1329,235,0.14,0.18
V276,185,2019-12-09 00:52:43,0,2848,3058,1.074,0.4,447,230,31,261,217,45,262,0,0.0,0.15
V276,186,2019-12-09 01:12:43,0,3270,3411,1.043,0.5,69,41,7,48,28,8,36,0,0.0,0.0
V276,187,2019-12-09 01:32:43,0,2617,2801,1.07,0.4,643,349,129,478,294,71,365,16,0.04,0.0
V276,188,2019-12-09 01:52:43,0,2960,3062,1.034,0.4,70,30,4,34,40,8,48,0,0.0,0.0
V276,189,2019-12-09 02:12:43,0,3577,3918,1.095,0.5,1082,641,219,860,441,122,563,17,0.0,0.0
V276,190,2019-12-09 02:32:43,0,3493,3743,1.072,0.5,1425,862,346,1208,563,239,802,47,0.1,0.1
V276,191,2019-12-09 02:52:43,0,2770,2899,1.047,0.4,337,226,116,342,111,45,156,10,0.0,0.1
V276,192,2019-12-09 03:12:43,0,3240,3278,1.012,0.4,18,3,0,3,15,10,25,0,0.0,0.0
V276,193,2019-12-09 03:32:43,0,3673,3727,1.015,0.5,1592,995,511,1506,597,278,875,35,0.06,0.07
V276,194,2019-12-09 03:52:43,0,3769,3924,1.041,0.5,3245,1948,1219,3167,1297,661,1958,627,0.1,0.13
V276,195,2019-12-09 04:12:43,0,3388,3521,1.039,0.5,1397,726,317,1043,671,226,897,43,0.04,0.0
V276,196,2019-12-09 04:32:43,0,3268,2989,0.915,0.4,35,17,1,18,18,3,21,0,0.0,0.0
V276,197,2019-12-09 04:52:43,0,3616,3726,1.03,0.5,836,490,179,669,346,140,486,11,0.0,0.19
V276,198,2019-12-09 05:12:43,0,2805,2886,1.029,0.4,597,305,103,408,292,93,385,10,0.1,0.05
V276,199,2019-12-09 05:32:43,0,3853,4050,1.051,0.5,2119,1278,690,1968,841,438,1279,128,0.02,0.06
V276,200,2019-12-09 05:52:43,0,3884,4160,1.071,0.5,3016,1839,996,2835,1177,616,1793,399,0.16,0.19
V276,201,2019-12-09 06:12:43,1,3569,3397,0.952,0.5,1436,750,248,998,686,211,897,81,0.04,0.0
V276,202,2019-12-09 06:32:43,1,3160,2827,0.895,0.4,89,46,8,54,43,13,56,0,0.0,0.0
V276,203,2019-12-09 06:52:43,1,2787,2535,0.909,0.4,116,105,4,109,11,0,11,0,0.0,0.0
V276,204,2019-12-09 07:12:43,1,3284,3209,0.977,0.5,652,386,168,554,266,109,375,7,0.0,0.18
V276,205,2019-12-09 07:32:43,1,2808,2839,1.011,0.4,646,393,101,494,253,76,329,7,0.06,0.0
V276,206,2019-12-09 07:52:43,1,3051,2809,0.921,0.4,42,20,2,22,22,5,27,0,0.0,0.0
V276,207,2019-12-09 08:12:43,1,3120,2776,0.89,0.4,40,17,5,22,23,3,26,0,0.0,-0.03
V276,208,2019-12-09 08:32:43,1,2742,2427,0.885,0.4,233,166,22,188,67,11,78,0,0.0,0.0
V276,209,2019-12-09 08:52:43,1,3372,3017,0.895,0.5,99,64,19,83,35,15,50,0,0.0,0.0
V276,210,2019-12-09 09:12:43,1,3281,3278,0.999,0.5,1103,645,220,865,458,165,623,6,0.04,0.06
V276,211,2019-12-09 09:32:43,1,2857,2499,0.874,0.4,94,55,5,60,39,1,40,0,0.0,0.0
V276,212,2019-12-09 09:52:43,1,2899,2379,0.821,0.4,20,11,5,16,9,1,10,0,0.0,0.0
V276,213,2019-12-09 10:12:43,1,3453,3012,0.872,0.5,174,102,36,138,72,14,86,0,0.0,0.0
V276,214,2019-12-09 10:32:43,1,2652,2431,0.917,0.4,1000,608,201,809,392,156,548,28,0.06,0.03
V276,215,2019-12-09 10:52:43,1,2943,2525,0.858,0.4,34,25,1,26,9,0,9,0,0.0,0.0
V276,216,2019-12-09 11:12:43,1,3531,3131,0.887,0.5,1011,603,136,739,408,156,564,1,0.02,0.0
V276,217,2019-12-09 11:32:43,1,2966,2390,0.806,0.4,473,275,10,285,198,29,227,0,0.0,0.0
V276,218,2019-12-09 11:52:43,1,3043,2424,0.796,0.4,121,105,7,112,16,0,16,0,0.0,0.0
V276,219,2019-12-09 12:12:43,1,2579,2355,0.913,0.3,302,180,38,218,122,39,161,0,0.0,0.14
V276,220,2019-12-09 12:32:43,1,3088,2907,0.942,0.4,46,17,2,19,29,6,35,0,0.0,0.0
V276,221,2019-12-09 12:52:43,1,2737,2464,0.9,0.4,47,32,2,34,15,3,18,0,0.0,0.0
V276,222,2019-12-09 13:12:43,1,3673,3546,0.965,0.5,549,357,155,512,192,93,285,25,0.0,0.17
V276,223,2019-12-09 13:32:43,1,2632,2591,0.984,0.4,320,191,25,216,129,30,159,0,0.0,0.02
V276,224,2019-12-09 13:52:43,1,2830,2638,0.932,0.4,19,5,0,5,14,5,19,0,0.0,0.0
V276,225,2019-12-09 14:12:43,1,3036,2779,0.915,0.4,37,22,6,28,15,7,22,0,0.0,0.0
V276,226,2019-12-09 14:32:43,1,3380,3518,1.041,0.5,548,315,95,410,233,72,305,2,0.1,0.17
V276,227,2019-12-09 14:52:43,1,2937,2916,0.993,0.4,100,57,24,81,43,18,61,1,0.0,0.0
V276,228,2019-12-09 15:12:43,1,2692,2592,0.963,0.4,46,21,3,24,25,8,33,0,0.0,0.0
V276,229,2019-12-09 15:32:43,1,3231,3025,0.936,0.4,196,64,21,85,132,17,149,0,0.0,0.11
V276,230,2019-12-09 15:52:43,1,2866,2797,0.976,0.4,256,93,12,105,163,16,179,0,0.0,0.0
V276,231,2019-12-09 16:12:43,1,2794,2583,0.925,0.4,28,4,0,4,24,9,33,0,0.0,0.0
V276,232,2019-12-09 16:32:43,1,3124,2839,0.909,0.4,286,168,103,271,118,55,173,0,0.0,0.12
V276,233,2019-12-09 16:52:43,1,3222,3260,1.012,0.4,1531,1029,340,1369,502,205,707,98,0.06,0.05
V276,234,2019-12-09 17:12:43,1,2895,2675,0.924,0.4,35,3,1,4,32,8,40,0,0.0,0.0
V276,235,2019-12-09 17:32:43,1,3281,2969,0.905,0.4,121,59,13,72,62,28,90,0,0.0,0.0
V276,236,2019-12-09 17:52:43,1,4007,3722,0.929,0.5,1159,724,359,1083,435,204,639,46,0.0,0.13
V276,237,2019-12-09 18:12:43,0,3299,3412,1.035,0.5,1280,814,344,1158,466,167,633,103,0.02,0.05
V276,238,2019-12-09 18:32:43,0,2854,2622,0.919,0.4,995,591,287,878,404,196,600,5,0.0,0.0
V276,239,2019-12-09 18:52:43,0,3446,3008,0.873,0.5,1002,558,207,765,444,165,609,7,0.0,0.0
V276,240,2019-12-09 19:12:43,0,4075,3522,0.864,0.5,2027,1203,615,1818,824,419,1243,196,0.04,0.0
V276,241,2019-12-09 19:32:43,0,2124,1724,0.812,0.3,1006,518,195,713,488,160,648,87,0.02,0.0
V276,242,2019-12-09 19:52:43,0,3883,3139,0.808,0.5,2697,1669,1071,2740,1028,566,1594,272,0.04,0.0
V276,243,2019-12-09 20:12:43,0,3367,2750,0.817,0.4,2731,1686,984,2670,1045,582,1627,443,0.06,0.0
V276,244,2019-12-09 20:32:43,0,2432,1915,0.788,0.3,106,50,4,54,56,0,56,0,0.0,0.0
V276,245,2019-12-09 20:52:43,0,3498,2807,0.802,0.5,1851,1049,477,1526,802,346,1148,210,0.04,0.0
V276,246,2019-12-09 21:12:43,0,3233,2564,0.793,0.4,1959,1166,463,1629,793,318,1111,130,0.02,0.0
V276,247,2019-12-09 21:32:43,0,1909,1515,0.794,0.3,80,61,1,62,19,6,25,0,0.02,0.0
V276,248,2019-12-09 21:52:43,0,3748,2990,0.798,0.5,1134,626,327,953,508,239,747,102,0.0,0.0
V276,249,2019-12-09 22:12:43,0,2420,1859,0.768,0.3,1615,874,369,1243,741,295,1036,182,0.02,0.0
V276,250,2019-12-09 22:32:43,0,1828,1414,0.773,0.2,569,286,86,372,283,87,370,15,0.0,0.0
V276,251,2019-12-09 22:52:43,0,3460,2764,0.799,0.5,227,175,31,206,52,20,72,1,0.02,0.0
V276,252,2019-12-09 23:12:43,0,3086,2457,0.796,0.4,1810,1107,557,1664,703,395,1098,160,0.04,0.0
V276,253,2019-12-09 23:32:43,0,1586,1275,0.804,0.2,46,15,2,17,31,11,42,0,0.0,0.0
V276,254,2019-12-09 23:52:43,0,2280,1769,0.776,0.3,1,0,0,0,1,1,2,0,0.0,0.0
V276,255,2019-09-13 00:12:43,0,3598,2870,0.798,0.5,2221,1319,707,2026,902,512,1414,291,0.06,0.0
V276,256,2019-09-13 00:32:43,0,3324,2621,0.789,0.4,2619,1526,886,2412,1093,582,1675,327,0.08,0.0
V276,257,2019-09-13 00:52:43,0,2828,2214,0.783,0.4,2033,1164,567,1731,869,393,1262,190,0.06,0.0
V276,258,2019-09-13 01:12:43,0,1632,1295,0.793,0.2,338,166,48,214,172,58,230,1,0.0,0.0
V276,259,2019-09-13 01:32:43,0,1417,1100,0.777,0.2,41,20,2,22,21,6,27,0,0.02,0.0
V276,260,2019-09-13 01:52:43,0,3441,2652,0.771,0.4,364,259,54,313,105,34,139,3,0.0,0.0
V276,261,2019-09-13 02:12:43,0,4069,3241,0.797,0.5,511,325,113,438,186,73,259,7,0.0,0.0
V276,262,2019-09-13 02:32:43,0,2889,2289,0.792,0.4,1388,835,394,1229,553,317,870,83,0.08,0.0
V276,263,2019-09-13 02:52:43,0,1719,1342,0.781,0.2,1118,651,240,891,467,200,667,97,0.04,0.0
V276,264,2019-09-13 03:12:43,0,1600,1233,0.771,0.2,24,21,0,21,3,0,3,0,0.0,0.0
V276,265,2019-09-13 03:32:43,0,1347,1043,0.774,0.2,18,17,0,17,1,0,1,0,0.0,0.0
V276,266,2019-09-13 03:52:43,0,4118,3273,0.795,0.5,394,221,95,316,173,72,245,4,0.0,0.0
V276,267,2019-09-13 04:12:43,0,3106,2411,0.776,0.4,1951,1107,584,1691,844,435,1279,142,0.04,0.0
V276,268,2019-09-13 04:32:43,0,3199,2488,0.778,0.4,2702,1686,957,2643,1016,595,1611,290,0.08,0.0
V276,269,2019-09-13 04:52:43,0,1609,1197,0.744,0.2,1292,760,380,1140,532,238,770,195,0.0,0.0
V276,270,2019-09-13 05:12:43,0,1093,860,0.786,0.1,13,10,4,14,3,0,3,0,0.0,0.0
V276,271,2019-09-13 05:32:43,0,1852,1417,0.765,0.2,31,24,1,25,7,1,8,0,0.0,0.0
V276,272,2019-09-13 05:52:43,0,2245,1744,0.777,0.3,195,143,52,195,52,19,71,0,0.0,0.0
V276,273,2019-09-13 06:12:43,1,1462,1114,0.762,0.2,42,15,5,20,27,9,36,0,0.0,0.0
V276,274,2019-09-13 06:32:43,1,1321,1011,0.766,0.2,9,1,0,1,8,2,10,0,0.0,0.0
V276,275,2019-09-13 06:52:43,1,3981,3225,0.81,0.5,104,68,11,79,36,11,47,0,0.02,-0.03
V276,276,2019-09-13 07:12:43,1,3747,3548,0.947,0.5,1163,708,301,1009,455,215,670,24,0.22,0.21
V276,277,2019-09-13 07:32:43,1,3173,3230,1.018,0.4,666,428,180,608,238,124,362,17,0.32,0.42
V276,278,2019-09-13 07:52:43,1,3311,3285,0.992,0.5,968,633,144,777,335,147,482,5,0.22,0.22
V276,279,2019-09-13 08:12:43,1,2395,2390,0.998,0.3,170,96,2,98,74,22,96,0,0.0,0.0
V276,280,2019-09-13 08:32:43,1,2384,2466,1.035,0.3,16,2,0,2,14,1,15,0,0.0,0.0
V276,281,2019-09-13 08:52:43,1,2335,2392,1.024,0.3,36,22,6,28,14,5,19,0,0.0,0.0
V276,282,2019-09-13 09:12:43,1,2123,2151,1.013,0.3,116,59,0,59,57,8,65,0,0.02,-0.03
V276,283,2019-09-13 09:32:43,1,3637,3469,0.954,0.5,600,384,219,603,216,128,344,1,0.02,-0.03
V276,284,2019-09-13 09:52:43,1,3114,3363,1.08,0.4,807,425,174,599,382,184,566,1,0.2,0.35
V276,285,2019-09-13 10:12:43,1,2252,2364,1.05,0.3,602,382,42,424,220,45,265,0,0.08,0.0
V276,286,2019-09-13 10:32:43,1,2420,2513,1.038,0.3,9,8,0,8,1,0,1,0,0.0,-0.03
V276,287,2019-09-13 10:52:43,1,2363,2471,1.046,0.3,19,16,2,18,3,1,4,0,0.0,0.0
V276,288,2019-09-13 11:12:43,1,2817,2998,1.064,0.4,193,113,26,139,80,24,104,6,0.0,0.08
V276,289,2019-09-13 11:32:43,1,2511,2647,1.054,0.4,582,317,80,397,265,89,354,0,0.18,0.19
V284,1,2019-09-09 11:36:43,1,2345,2052,0.875,0.3,46,42,4,46,4,2,6,0,0.0,0.0
V284,2,2019-09-09 11:56:43,1,3677,2848,0.775,0.4,2199,1253,662,1915,946,776,1722,79,0.0,0.0
V284,3,2019-09-09 12:16:43,1,2785,2110,0.758,0.3,435,203,30,233,232,175,407,0,0.0,0.0
V284,4,2019-09-09 12:36:43,1,2660,1982,0.745,0.3,25,23,2,25,2,2,4,0,0.0,0.0
V284,5,2019-09-09 12:56:43,1,2728,1973,0.723,0.3,14,14,4,18,0,0,0,0,0.0,0.0
V284,6,2019-09-09 13:16:43,1,2700,1934,0.716,0.3,30,30,4,34,0,0,0,0,0.0,0.0
V284,7,2019-09-09 13:36:43,1,2624,1990,0.758,0.3,60,36,8,44,24,14,38,0,0.0,0.0
V284,8,2019-09-09 13:56:43,1,2763,2062,0.746,0.3,28,5,2,7,23,14,37,0,0.0,0.0
V284,9,2019-09-09 14:16:43,1,4196,3431,0.818,0.5,664,366,132,498,298,238,536,14,0.0,0.03
V284,10,2019-09-09 14:36:43,1,3424,2990,0.873,0.4,995,465,138,603,530,417,947,10,0.0,0.02
V284,11,2019-09-09 14:56:43,1,2780,2197,0.79,0.3,149,42,3,45,107,84,191,0,0.0,0.0
V284,12,2019-09-09 15:16:43,1,2842,2266,0.797,0.3,146,59,12,71,87,74,161,0,0.0,0.05
V284,13,2019-09-09 15:36:43,1,2714,2319,0.854,0.3,101,52,11,63,49,43,92,0,0.0,0.04
V284,14,2019-09-09 15:56:43,1,3814,3367,0.883,0.5,474,263,130,393,211,166,377,11,0.0,0.06
V284,15,2019-09-09 16:16:43,1,2691,2291,0.852,0.3,612,330,88,418,282,230,512,13,0.0,0.0
V284,16,2019-09-09 16:36:43,1,2666,2324,0.872,0.3,40,8,1,9,32,23,55,0,0.0,0.0
V284,17,2019-09-09 16:56:43,1,3261,2682,0.822,0.4,153,72,15,87,81,64,145,0,0.0,0.0
V284,18,2019-09-09 17:16:43,1,2946,2582,0.876,0.4,613,336,117,453,277,218,495,26,0.0,0.06
V284,19,2019-09-09 17:36:43,1,2733,2170,0.794,0.3,22,11,2,13,11,7,18,0,0.0,0.0
V284,20,2019-09-09 17:56:43,0,3400,3069,0.903,0.4,646,271,85,356,375,308,683,12,0.0,0.12
V284,21,2019-09-09 18:16:43,0,3024,2750,0.909,0.4,146,55,5,60,91,67,158,16,0.0,0.0
V284,22,2019-09-09 18:36:43,0,4157,4015,0.966,0.5,2420,1373,910,2283,1047,874,1921,418,0.0,0.08
V284,23,2019-09-09 18:56:43,0,3765,3609,0.958,0.5,2183,1262,653,1915,921,739,1660,196,0.0,0.05
V284,24,2019-09-09 19:16:43,0,3974,3701,0.931,0.5,2809,1715,1074,2789,1094,941,2035,441,0.0,0.09
V284,25,2019-09-09 19:36:43,0,3816,3528,0.924,0.5,2726,1657,1070,2727,1069,909,1978,587,0.0,0.04
V284,26,2019-09-09 19:56:43,0,3763,3559,0.946,0.5,2201,1189,671,1860,1012,825,1837,370,0.0,0.07
V284,27,2019-09-09 20:16:43,0,3189,2799,0.877,0.4,1097,489,240,729,608,499,1107,129,0.0,0.05
V284,28,2019-09-09 20:36:43,0,3794,3464,0.913,0.5,1214,690,408,1098,524,440,964,160,0.0,0.05
V284,29,2019-09-09 20:56:43,0,2912,2679,0.92,0.4,731,358,120,478,373,327,700,13,0.0,0.0
V284,30,2019-09-09 21:16:43,0,3938,3645,0.926,0.5,3037,1668,1113,2781,1369,1160,2529,692,0.0,0.11
V284,31,2019-09-09 21:36:43,0,2810,2470,0.879,0.3,856,407,151,558,449,356,805,14,0.0,0.03
V284,32,2019-09-09 21:56:43,0,3076,3335,1.084,0.4,1862,1078,711,1789,784,660,1444,243,0.0,0.15
V284,33,2019-09-09 22:16:43,0,3882,3804,0.98,0.5,2837,1758,1190,2948,1079,928,2007,602,0.2,0.08
V284,34,2019-09-09 22:36:43,0,3837,3815,0.994,0.5,2644,1393,837,2230,1251,1087,2338,506,0.06,0.19
V284,35,2019-09-09 22:56:43,0,3141,3310,1.054,0.4,1428,647,194,841,781,620,1401,72,0.04,0.09
V284,36,2019-09-09 23:16:43,0,2674,2507,0.937,0.3,42,13,0,13,29,25,54,0,0.0,0.0
V284,37,2019-09-09 23:36:43,0,3365,3405,1.012,0.4,918,421,180,601,497,413,910,44,0.1,0.16
V284,38,2019-09-09 23:56:43,0,2901,3138,1.082,0.4,997,538,295,833,459,389,848,48,0.02,0.1
V284,39,2019-10-09 00:16:43,0,3722,4035,1.084,0.5,2252,1214,752,1966,1038,893,1931,363,0.12,0.16
V284,40,2019-10-09 00:36:43,0,2545,2375,0.933,0.3,865,528,277,805,337,275,612,154,0.04,0.0
V284,41,2019-10-09 00:56:43,0,2898,2687,0.927,0.4,47,16,2,18,31,22,53,0,0.0,0.0
V284,42,2019-10-09 01:16:43,0,3440,3114,0.905,0.4,254,136,50,186,118,94,212,1,0.0,0.1
V284,43,2019-10-09 01:36:43,0,3909,3780,0.967,0.5,1763,921,448,1369,842,694,1536,128,0.08,0.07
V284,44,2019-10-09 01:56:43,0,2875,2740,0.953,0.4,138,81,47,128,57,47,104,0,0.0,0.0
V284,45,2019-10-09 02:16:43,0,3365,3652,1.085,0.4,1607,860,443,1303,747,614,1361,143,0.08,0.24
V284,46,2019-10-09 02:36:43,0,2826,2709,0.959,0.4,208,152,12,164,56,44,100,0,0.0,0.0
V284,47,2019-10-09 02:56:43,0,2961,3212,1.085,0.4,196,113,25,138,83,58,141,0,0.0,0.06
V284,48,2019-10-09 03:16:43,0,2698,2618,0.97,0.3,1061,581,315,896,480,401,881,77,0.04,0.07
V284,49,2019-10-09 03:36:43,0,2607,2713,1.041,0.3,52,14,1,15,38,28,66,0,0.0,0.0
V284,50,2019-10-09 03:56:43,0,3065,3144,1.026,0.4,161,65,17,82,96,77,173,0,0.0,0.07
V284,51,2019-10-09 04:16:43,0,4075,3780,0.928,0.5,1962,1049,601,1650,913,753,1666,88,0.12,0.16
V284,52,2019-10-09 04:36:43,0,2891,2857,0.988,0.4,254,135,10,145,119,93,212,0,0.0,0.0
V284,53,2019-10-09 04:56:43,0,3421,3462,1.012,0.4,399,218,104,322,181,150,331,7,0.0,0.12
V284,54,2019-10-09 05:16:43,0,2685,2684,1.0,0.3,1368,706,302,1008,662,529,1191,43,0.06,0.03
V284,55,2019-10-09 05:36:43,0,3152,2829,0.898,0.4,55,44,5,49,11,8,19,0,0.0,0.0
V284,56,2019-10-09 05:56:43,1,4048,3531,0.872,0.5,270,153,36,189,117,90,207,0,0.02,0.06
V284,57,2019-10-09 06:16:43,1,3247,3279,1.01,0.4,1753,946,540,1486,807,654,1461,188,0.02,0.07
V284,58,2019-10-09 06:36:43,1,2646,2366,0.894,0.3,46,18,3,21,28,22,50,0,0.0,0.0
V284,59,2019-10-09 06:56:43,1,2670,2258,0.846,0.3,30,26,10,36,4,3,7,0,0.0,0.0
V284,60,2019-10-09 07:16:43,1,3894,3511,0.902,0.5,320,170,70,240,150,116,266,5,0.0,0.03
V284,61,2019-10-09 07:36:43,1,3112,2968,0.954,0.4,1667,878,480,1358,789,648,1437,258,0.04,0.03
V284,62,2019-10-09 07:56:43,1,2678,2369,0.885,0.3,458,192,21,213,266,181,447,0,0.0,0.0
V284,63,2019-10-09 08:16:43,1,2599,2033,0.782,0.3,51,28,3,31,23,13,36,0,0.0,0.0
V284,64,2019-10-09 08:36:43,1,2649,2117,0.799,0.3,39,33,1,34,6,3,9,0,0.0,0.0
V284,65,2019-10-09 08:56:43,1,2513,2023,0.805,0.3,66,32,9,41,34,26,60,0,0.0,0.03
V284,66,2019-10-09 09:16:43,1,3550,2983,0.84,0.4,162,73,10,83,89,62,151,0,0.0,0.0
V284,67,2019-10-09 09:36:43,1,3369,3098,0.92,0.4,1820,1004,563,1567,816,669,1485,141,0.06,0.1
V284,68,2019-10-09 09:56:43,1,2779,2186,0.787,0.3,426,189,43,232,237,175,412,15,0.02,0.0
V284,69,2019-10-09 10:16:43,1,3114,2909,0.934,0.4,1249,679,288,967,570,446,1016,123,0.0,-0.05
V284,70,2019-10-09 10:36:43,1,2976,2411,0.81,0.4,441,199,110,309,242,193,435,8,0.0,0.02
V284,71,2019-10-09 10:56:43,1,2896,2283,0.788,0.3,50,21,3,24,29,21,50,0,0.0,0.0
V284,72,2019-10-09 11:16:43,1,2626,2174,0.828,0.3,397,245,108,353,152,118,270,5,0.0,0.1
V284,73,2019-10-09 11:36:43,1,2965,2587,0.873,0.4,41,27,6,33,14,8,22,0,0.0,0.0
V284,74,2019-10-09 11:56:43,1,3417,3072,0.899,0.4,262,108,22,130,154,113,267,0,0.0,0.05
V284,75,2019-10-09 12:16:43,1,2764,2491,0.901,0.3,877,431,197,628,446,360,806,15,0.0,0.06
V284,76,2019-10-09 12:36:43,1,2956,2456,0.831,0.4,50,26,1,27,24,21,45,0,0.0,0.0
V284,77,2019-10-09 12:56:43,1,2812,2282,0.812,0.3,38,18,6,24,20,19,39,0,0.0,0.0
V284,78,2019-10-09 13:16:43,1,2773,2214,0.798,0.3,53,23,1,24,30,25,55,0,0.0,0.0
V284,79,2019-10-09 13:36:43,1,2525,2443,0.968,0.3,1052,536,294,830,516,412,928,59,0.0,0.16
V284,80,2019-10-09 13:56:43,1,2406,2200,0.914,0.3,64,37,10,47,27,19,46,0,0.0,0.02
V284,81,2019-10-09 14:16:43,1,2768,2298,0.83,0.3,45,20,4,24,25,17,42,0,0.0,0.0
V284,82,2019-10-09 14:36:43,1,3339,3158,0.946,0.4,1145,513,106,619,632,478,1110,9,0.0,0.08
V284,83,2019-10-09 14:56:43,1,2786,2399,0.861,0.3,132,24,3,27,108,74,182,0,0.0,0.0
V284,84,2019-10-09 15:16:43,1,2651,2245,0.847,0.3,64,18,8,26,46,35,81,0,0.0,0.0
V284,85,2019-10-09 15:36:43,1,3362,3100,0.922,0.4,405,184,85,269,221,172,393,22,0.0,0.1
V284,86,2019-10-09 15:56:43,1,2942,2699,0.917,0.4,818,452,139,591,366,282,648,37,0.0,0.0
V284,87,2019-10-09 16:16:43,1,2776,2410,0.868,0.3,43,17,8,25,26,20,46,0,0.0,0.0
V284,88,2019-10-09 16:36:43,1,2590,2193,0.847,0.3,126,62,20,82,64,43,107,0,0.0,0.0
V284,89,2019-10-09 16:56:43,1,2823,2353,0.834,0.3,144,72,25,97,72,60,132,0,0.0,0.05
V284,90,2019-10-09 17:16:43,1,3343,3256,0.974,0.4,2254,1196,669,1865,1058,857,1915,399,0.12,0.12
V284,91,2019-10-09 17:36:43,1,2815,2685,0.954,0.4,25,9,1,10,16,12,28,0,0.0,0.0
V284,92,2019-10-09 17:56:43,0,3520,3552,1.009,0.4,1019,489,201,690,530,414,944,33,0.0,0.05
V284,93,2019-10-09 18:16:43,0,2937,2592,0.882,0.4,213,106,64,170,107,86,193,14,0.0,0.03
V284,94,2019-10-09 18:36:43,0,3887,4040,1.039,0.5,1718,849,384,1233,869,692,1561,114,0.0,0.11
V284,95,2019-10-09 18:56:43,0,3714,3847,1.036,0.5,3325,1771,1172,2943,1554,1315,2869,611,0.0,0.06
V284,96,2019-10-09 19:16:43,0,4136,4078,0.986,0.5,2399,1244,800,2044,1155,1002,2157,440,0.0,0.09
V284,97,2019-10-09 19:36:43,0,3875,3790,0.978,0.5,3330,1781,1154,2935,1549,1325,2874,535,0.0,0.08
V284,98,2019-10-09 19:56:43,0,3755,3611,0.962,0.5,2562,1259,742,2001,1303,1088,2391,339,0.0,0.11
V284,99,2019-10-09 20:16:43,0,2921,2560,0.876,0.4,645,286,77,363,359,291,650,23,0.0,0.0
V284,100,2019-10-09 20:36:43,0,3770,3842,1.019,0.5,2762,1487,1035,2522,1275,1089,2364,643,0.1,0.14
V284,101,2019-10-09 20:56:43,0,3613,3844,1.064,0.5,4128,2324,1573,3897,1804,1572,3376,626,0.0,0.14
V284,102,2019-10-09 21:16:43,0,3188,3398,1.066,0.4,2221,1211,590,1801,1010,857,1867,137,0.1,0.24
V284,103,2019-10-09 21:36:43,0,3019,3062,1.014,0.4,940,437,132,569,503,405,908,14,0.0,0.07
V284,104,2019-10-09 21:56:43,0,3363,3201,0.952,0.4,307,183,77,260,124,96,220,12,0.08,0.0
V284,105,2019-10-09 22:16:43,0,3908,4088,1.046,0.5,3190,1722,1097,2819,1468,1296,2764,478,0.1,0.18
V284,106,2019-10-09 22:36:43,0,2835,2699,0.952,0.4,1113,615,276,891,498,418,916,53,0.08,0.07
V284,107,2019-10-09 22:56:43,0,3625,3967,1.094,0.5,1048,542,313,855,506,408,914,90,0.0,0.13
V284,108,2019-10-09 23:16:43,0,3661,3995,1.091,0.5,2598,1286,811,2097,1312,1106,2418,342,0.08,0.14
V284,109,2019-10-09 23:36:43,0,3702,3849,1.04,0.5,2416,1246,687,1933,1170,997,2167,223,0.08,0.12
V284,110,2019-10-09 23:56:43,0,2716,2717,1.0,0.3,1371,694,372,1066,677,569,1246,42,0.08,0.11
V284,111,2019-11-09 00:16:43,0,2848,2869,1.007,0.4,51,21,7,28,30,25,55,0,0.0,0.0
V284,112,2019-11-09 00:36:43,0,3773,3947,1.046,0.5,640,365,133,498,275,212,487,3,0.0,0.0
V284,113,2019-11-09 00:56:43,0,3702,4208,1.137,0.5,3019,1640,1071,2711,1379,1184,2563,223,0.06,0.2
V284,114,2019-11-09 01:16:43,0,4092,4217,1.031,0.5,2449,1281,771,2052,1168,990,2158,185,0.08,0.07
V284,115,2019-11-09 01:36:43,0,2863,2851,0.996,0.4,2096,1084,700,1784,1012,877,1889,162,0.06,0.07
V284,116,2019-11-09 01:56:43,0,2967,2812,0.948,0.4,57,17,4,21,40,32,72,0,0.0,0.0
V284,117,2019-11-09 02:16:43,0,2438,2474,1.015,0.3,100,10,2,12,90,71,161,0,0.0,0.0
V284,118,2019-11-09 02:36:43,0,3242,2955,0.912,0.4,421,211,122,333,210,174,384,4,0.0,0.0
V284,119,2019-11-09 02:56:43,0,3590,3697,1.03,0.5,2349,1169,698,1867,1180,984,2164,239,0.0,0.09
V284,120,2019-11-09 03:16:43,0,2269,2218,0.978,0.3,1399,710,337,1047,689,568,1257,275,0.0,0.0
V284,121,2019-11-09 03:36:43,0,2846,2284,0.803,0.3,18,10,3,13,8,6,14,0,0.0,0.0
V284,122,2019-11-09 03:56:43,0,3223,2926,0.908,0.4,1420,769,287,1056,651,534,1185,6,0.0,0.0
V284,123,2019-11-09 04:16:43,0,2188,1719,0.786,0.3,1823,1015,682,1697,808,704,1512,174,0.0,0.03
V284,124,2019-11-09 04:36:43,0,2825,2199,0.779,0.3,37,19,7,26,18,14,32,0,0.0,0.0
V284,125,2019-11-09 04:56:43,0,3445,2731,0.793,0.4,960,532,309,841,428,365,793,67,0.0,0.0
V284,126,2019-11-09 05:16:43,0,3355,2560,0.763,0.4,61,20,2,22,41,31,72,0,0.0,0.0
V284,127,2019-11-09 05:36:43,0,3559,3003,0.844,0.4,2393,1297,780,2077,1096,927,2023,264,0.0,0.0
V284,128,2019-11-09 05:56:43,1,2335,1805,0.773,0.3,1249,686,284,970,563,442,1005,121,0.0,0.0
V284,129,2019-11-09 06:16:43,1,2719,1980,0.728,0.3,23,9,1,10,14,10,24,0,0.0,0.0
V284,130,2019-11-09 06:36:43,1,2276,1668,0.733,0.3,35,25,2,27,10,8,18,0,0.0,0.0
V284,131,2019-11-09 06:56:43,1,2674,1993,0.746,0.3,53,23,7,30,30,23,53,0,0.0,0.0
V284,132,2019-11-09 07:16:43,1,3228,2501,0.775,0.4,169,47,3,50,122,98,220,0,0.0,0.0
V284,133,2019-11-09 07:36:43,1,2400,1799,0.75,0.3,89,33,4,37,56,43,99,0,0.0,0.0
V284,134,2019-11-09 07:56:43,1,2596,1892,0.729,0.3,38,6,2,8,32,22,54,0,0.0,0.0
V284,135,2019-11-09 08:16:43,1,2381,1751,0.735,0.3,73,33,4,37,40,30,70,0,0.0,0.0
V284,136,2019-11-09 08:36:43,1,2546,1879,0.738,0.3,19,15,0,15,4,4,8,0,0.0,0.0
V284,137,2019-11-09 08:56:43,1,3462,2657,0.767,0.4,1855,1009,653,1662,846,708,1554,142,0.0,0.0
V284,138,2019-11-09 09:16:43,1,2545,1919,0.754,0.3,917,410,75,485,507,397,904,3,0.0,0.0
V284,139,2019-11-09 09:36:43,1,2562,1933,0.754,0.3,62,48,2,50,14,9,23,0,0.0,0.0
V284,140,2019-11-09 09:56:43,1,2337,1731,0.74,0.3,34,20,3,23,14,11,25,0,0.0,0.03
V284,141,2019-11-09 10:16:43,1,2477,1848,0.746,0.3,0,0,0,0,0,0,0,0,0.0,0.0
V284,142,2019-11-09 10:36:43,1,2485,1870,0.752,0.3,17,17,0,17,0,0,0,0,0.0,0.0
V284,143,2019-11-09 10:56:43,1,4304,3508,0.815,0.5,1234,741,429,1170,493,419,912,53,0.0,0.06
V284,144,2019-11-09 11:16:43,1,3058,2959,0.968,0.4,1829,1061,508,1569,768,644,1412,32,0.0,0.24
V284,145,2019-11-09 11:36:43,1,2614,2580,0.987,0.3,421,231,10,241,190,141,331,0,0.0,0.0
V284,146,2019-11-09 11:56:43,1,2696,2597,0.963,0.3,27,25,6,31,2,1,3,0,0.0,0.0
V284,147,2019-11-09 12:16:43,1,3390,3418,1.008,0.4,565,363,170,533,202,163,365,13,0.12,0.13
V284,148,2019-11-09 12:36:43,1,2517,2590,1.029,0.3,418,228,85,313,190,148,338,19,0.0,0.03
V284,149,2019-11-09 12:56:43,1,2542,2593,1.02,0.3,33,20,7,27,13,10,23,0,0.0,0.0
V284,150,2019-11-09 13:16:43,1,2961,2934,0.991,0.4,148,60,17,77,88,68,156,0,0.0,0.0
V284,151,2019-11-09 13:36:43,1,2346,2448,1.044,0.3,556,303,154,457,253,207,460,13,0.0,0.15
V284,152,2019-11-09 13:56:43,1,2500,2526,1.01,0.3,20,13,4,17,7,3,10,0,0.0,0.0
V284,153,2019-11-09 14:16:43,1,3205,3309,1.032,0.4,263,100,21,121,163,131,294,0,0.0,0.0
V284,154,2019-11-09 14:36:43,1,2534,2636,1.04,0.3,1042,522,221,743,520,421,941,11,0.06,0.15
V284,155,2019-11-09 14:56:43,1,2605,2660,1.021,0.3,49,31,3,34,18,13,31,0,0.0,0.0
V284,156,2019-11-09 15:16:43,1,2551,2423,0.95,0.3,8,2,0,2,6,5,11,0,0.0,0.0
V284,157,2019-11-09 15:36:43,1,3391,3297,0.972,0.4,1340,821,478,1299,519,427,946,155,0.0,0.14
V284,158,2019-11-09 15:56:43,1,2496,2564,1.027,0.3,995,352,139,491,643,492,1135,13,0.08,0.03
V284,159,2019-11-09 16:16:43,1,2586,2553,0.987,0.3,80,46,9,55,34,28,62,0,0.0,0.0
V284,160,2019-11-09 16:36:43,1,2550,2373,0.931,0.3,82,53,11,64,29,27,56,0,0.0,0.0
V284,161,2019-11-09 16:56:43,1,2944,2981,1.012,0.4,1368,675,111,786,693,547,1240,0,0.0,0.08
V284,162,2019-11-09 17:16:43,1,2700,2751,1.019,0.3,156,98,61,159,58,51,109,5,0.04,0.1
V284,163,2019-11-09 17:36:43,1,2615,2584,0.988,0.3,54,15,10,25,39,33,72,0,0.0,0.0
V284,164,2019-11-09 17:56:43,0,3308,3377,1.021,0.4,1404,670,364,1034,734,584,1318,89,0.0,0.09
V284,165,2019-11-09 18:16:43,0,3312,3286,0.992,0.4,583,344,175,519,239,200,439,24,0.0,0.1
V284,166,2019-11-09 18:36:43,0,3555,3659,1.029,0.5,1994,950,460,1410,1044,871,1915,202,0.06,0.06
V284,167,2019-11-09 18:56:43,0,3627,3872,1.068,0.5,2252,1182,739,1921,1070,895,1965,200,0.08,0.17
V284,168,2019-11-09 19:16:43,0,3256,3695,1.135,0.4,1183,656,404,1060,527,450,977,159,0.06,0.14
V284,169,2019-11-09 19:36:43,0,3044,3158,1.037,0.4,2364,1232,800,2032,1132,979,2111,307,0.04,0.08
V284,170,2019-11-09 19:56:43,0,3266,3636,1.113,0.4,674,388,238,626,286,234,520,22,0.04,0.14
V284,171,2019-11-09 20:16:43,0,2657,2959,1.113,0.3,1120,514,244,758,606,514,1120,32,0.0,0.0
V284,172,2019-11-09 20:36:43,0,3844,4211,1.096,0.5,2298,1270,859,2129,1028,892,1920,368,0.08,0.21
V284,173,2019-11-09 20:56:43,0,3791,4082,1.077,0.5,3962,2009,1314,3323,1953,1706,3659,609,0.1,0.29
V284,174,2019-11-09 21:16:43,0,2694,2881,1.07,0.3,708,350,158,508,358,301,659,24,0.02,0.03
V284,175,2019-11-09 21:36:43,0,3018,3118,1.033,0.4,66,38,9,47,28,22,50,0,0.0,0.0
V284,176,2019-11-09 21:56:43,0,3733,4050,1.085,0.5,1992,1008,577,1585,984,841,1825,126,0.06,0.22
V284,177,2019-11-09 22:16:43,0,3409,3766,1.105,0.4,460,214,80,294,246,189,435,14,0.04,0.0
V284,178,2019-11-09 22:36:43,0,3789,4047,1.068,0.5,2389,1262,785,2047,1127,985,2112,132,0.04,0.18
V284,179,2019-11-09 22:56:43,0,4260,4446,1.044,0.5,5839,3042,2154,5196,2797,2472,5269,1177,0.16,0.11
V284,180,2019-11-09 23:16:43,0,2894,3003,1.038,0.4,1416,840,428,1268,576,488,1064,111,0.04,0.15
V284,181,2019-11-09 23:36:43,0,3773,3926,1.041,0.5,2902,1612,1041,2653,1290,1097,2387,207,0.1,0.12
V284,182,2019-11-09 23:56:43,0,3765,3925,1.043,0.5,3837,2052,1360,3412,1785,1518,3303,792,0.12,0.07
V284,183,2019-12-09 00:16:43,0,3142,3110,0.99,0.4,1823,868,504,1372,955,755,1710,46,0.0,0.11
V284,184,2019-12-09 00:36:43,0,2986,3201,1.072,0.4,83,49,8,57,34,26,60,0,0.0,0.0
V284,185,2019-12-09 00:56:43,0,2992,3133,1.047,0.4,40,17,6,23,23,16,39,0,0.0,0.0
V284,186,2019-12-09 01:16:43,0,3956,4258,1.076,0.5,2691,1554,1004,2558,1137,963,2100,286,0.08,0.19
V284,187,2019-12-09 01:36:43,0,3672,3918,1.067,0.5,3374,1735,1113,2848,1639,1415,3054,404,0.1,0.14
V284,188,2019-12-09 01:56:43,0,3108,3237,1.042,0.4,99,49,4,53,50,41,91,0,0.0,0.0
V284,189,2019-12-09 02:16:43,0,3126,3231,1.034,0.4,97,55,17,72,42,33,75,0,0.0,0.0
V284,190,2019-12-09 02:36:43,0,2941,3090,1.051,0.4,1261,651,395,1046,610,497,1107,49,0.02,0.14
V284,191,2019-12-09 02:56:43,0,3330,3808,1.144,0.4,970,548,316,864,422,360,782,50,0.0,0.0
V284,192,2019-12-09 03:16:43,0,4150,4340,1.046,0.5,3811,2032,1355,3387,1779,1583,3362,551,0.14,0.19
V284,193,2019-12-09 03:36:43,0,3559,3831,1.076,0.5,3796,2011,1299,3310,1785,1545,3330,357,0.06,0.04
V284,194,2019-12-09 03:56:43,0,2901,2941,1.014,0.4,349,169,42,211,180,139,319,0,0.0,0.03
V284,195,2019-12-09 04:16:43,0,2749,2765,1.006,0.3,63,31,8,39,32,24,56,0,0.0,0.0
V284,196,2019-12-09 04:36:43,0,3767,3660,0.972,0.5,1608,822,484,1306,786,663,1449,46,0.0,0.09
V284,197,2019-12-09 04:56:43,0,3554,3669,1.032,0.5,2961,1568,965,2533,1393,1206,2599,336,0.18,0.12
V284,198,2019-12-09 05:16:43,0,2705,2619,0.968,0.3,299,195,9,204,104,73,177,0,0.0,0.0
V284,199,2019-12-09 05:36:43,0,3057,2875,0.94,0.4,291,171,101,272,120,95,215,0,0.0,0.0
V284,200,2019-12-09 05:56:43,1,3534,3763,1.065,0.5,4167,2124,1413,3537,2043,1758,3801,549,0.0,0.1
V284,201,2019-12-09 06:16:43,1,2766,2646,0.956,0.3,1289,646,370,1016,643,516,1159,190,0.04,0.03
V284,202,2019-12-09 06:36:43,1,2841,2570,0.905,0.4,61,43,3,46,18,14,32,0,0.0,0.0
V284,203,2019-12-09 06:56:43,1,2860,2474,0.865,0.4,14,14,6,20,0,0,0,0,0.0,0.0
V284,204,2019-12-09 07:16:43,1,2209,2115,0.957,0.3,271,104,34,138,167,132,299,5,0.0,0.03
V284,205,2019-12-09 07:36:43,1,2693,2389,0.887,0.3,61,37,7,44,24,15,39,0,0.0,0.0
V284,206,2019-12-09 07:56:43,1,3836,3395,0.885,0.5,718,397,223,620,321,261,582,10,0.0,0.0
V284,207,2019-12-09 08:16:43,1,3164,3106,0.982,0.4,1802,896,471,1367,906,730,1636,156,0.0,0.05
V284,208,2019-12-09 08:36:43,1,3243,2604,0.803,0.4,159,113,13,126,46,31,77,0,0.0,0.0
V284,209,2019-12-09 08:56:43,1,2583,2196,0.85,0.3,18,18,4,22,0,0,0,0,0.0,0.0
V284,210,2019-12-09 09:16:43,1,2384,2221,0.931,0.3,382,185,50,235,197,149,346,11,0.0,0.04
V284,211,2019-12-09 09:36:43,1,2723,2344,0.861,0.3,71,35,6,41,36,22,58,0,0.0,0.0
V284,212,2019-12-09 09:56:43,1,3382,3106,0.918,0.4,1094,590,271,861,504,387,891,12,0.0,0.09
V284,213,2019-12-09 10:16:43,1,2405,2317,0.964,0.3,870,472,214,686,398,340,738,52,0.14,0.0
V284,214,2019-12-09 10:36:43,1,2673,2304,0.862,0.3,30,14,4,18,16,13,29,0,0.0,0.0
V284,215,2019-12-09 10:56:43,1,2900,2414,0.832,0.4,30,20,5,25,10,8,18,0,0.0,0.0
V284,216,2019-12-09 11:16:43,1,3501,3124,0.892,0.4,1685,844,437,1281,841,672,1513,32,0.0,0.04
V284,217,2019-12-09 11:36:43,1,2767,2289,0.827,0.3,390,108,7,115,282,216,498,3,0.0,0.0
V284,218,2019-12-09 11:56:43,1,2766,2316,0.837,0.3,53,39,0,39,14,11,25,0,0.0,0.0
V284,219,2019-12-09 12:16:43,1,2851,2255,0.791,0.3,53,13,2,15,40,31,71,0,0.0,0.0
V284,220,2019-12-09 12:36:43,1,2919,2858,0.979,0.4,831,378,111,489,453,340,793,0,0.0,0.08
V284,221,2019-12-09 12:56:43,1,2659,2333,0.877,0.3,36,10,0,10,26,19,45,0,0.0,0.0
V284,222,2019-12-09 13:16:43,1,3500,3276,0.936,0.4,419,250,129,379,169,141,310,31,0.0,0.09
V284,223,2019-12-09 13:36:43,1,2375,2254,0.949,0.3,349,199,109,308,150,122,272,15,0.0,0.0
V284,224,2019-12-09 13:56:43,1,2552,2317,0.908,0.3,51,27,1,28,24,15,39,0,0.0,0.0
V284,225,2019-12-09 14:16:43,1,2550,2219,0.87,0.3,43,19,1,20,24,15,39,0,0.0,0.0
V284,226,2019-12-09 14:36:43,1,3208,2869,0.894,0.4,256,72,3,75,184,150,334,0,0.0,0.0
V284,227,2019-12-09 14:56:43,1,3865,3802,0.984,0.5,3013,1725,1084,2809,1288,1111,2399,419,0.0,0.23
V284,228,2019-12-09 15:16:43,1,2482,2486,1.002,0.3,621,319,133,452,302,250,552,6,0.1,0.02
V284,229,2019-12-09 15:36:43,1,2732,2426,0.888,0.3,80,62,2,64,18,13,31,0,0.0,0.0
V284,230,2019-12-09 15:56:43,1,2694,2399,0.89,0.3,170,138,1,139,32,24,56,0,0.0,0.0
V284,231,2019-12-09 16:16:43,1,2473,2124,0.859,0.3,197,148,1,149,49,34,83,0,0.0,0.0
V284,232,2019-12-09 16:36:43,1,3141,3177,1.011,0.4,1018,618,156,774,400,314,714,5,0.0,0.15
V284,233,2019-12-09 16:56:43,1,2598,2450,0.943,0.3,185,84,1,85,101,76,177,0,0.0,0.0
V284,234,2019-12-09 17:16:43,1,3177,3048,0.959,0.4,261,103,14,117,158,124,282,1,0.0,0.05
V284,235,2019-12-09 17:36:43,1,2943,2848,0.967,0.4,949,535,280,815,414,344,758,37,0.0,0.09
V284,236,2019-12-09 17:56:43,0,3576,3643,1.019,0.5,444,232,10,242,212,155,367,0,0.0,0.03
V284,237,2019-12-09 18:16:43,0,4314,4292,0.995,0.5,2313,1266,738,2004,1047,864,1911,174,0.0,0.1
V284,238,2019-12-09 18:36:43,0,3456,3480,1.007,0.4,3210,1732,1154,2886,1478,1296,2774,75,0.0,0.0
V284,239,2019-12-09 18:56:43,0,3904,3208,0.822,0.5,1751,968,654,1622,783,687,1470,205,0.0,0.0
V284,240,2019-12-09 19:16:43,0,3732,3096,0.83,0.5,3676,1989,1213,3202,1687,1453,3140,442,0.0,0.0
V284,241,2019-12-09 19:36:43,0,2946,2304,0.782,0.4,2174,1234,663,1897,940,802,1742,106,0.0,0.0
V284,242,2019-12-09 19:56:43,0,3499,2838,0.811,0.4,435,222,77,299,213,158,371,2,0.0,0.0
V284,243,2019-12-09 20:16:43,0,2513,1915,0.762,0.3,3028,1737,1181,2918,1291,1116,2407,224,0.0,0.0
V284,244,2019-12-09 20:36:43,0,2710,2107,0.777,0.3,37,33,0,33,4,2,6,0,0.0,0.0
V284,245,2019-12-09 20:56:43,0,3571,2843,0.796,0.4,2781,1466,869,2335,1315,1144,2459,268,0.14,0.0
V284,246,2019-12-09 21:16:43,0,1823,1434,0.787,0.2,1035,536,269,805,499,410,909,95,0.0,0.03
V284,247,2019-12-09 21:36:43,0,3359,2709,0.806,0.4,1081,525,254,779,556,453,1009,24,0.0,0.0
V284,248,2019-12-09 21:56:43,0,2110,1580,0.749,0.3,403,178,105,283,225,182,407,3,0.0,0.0
V284,249,2019-12-09 22:16:43,0,3725,2900,0.779,0.4,2150,1209,705,1914,941,825,1766,300,0.0,0.0
V284,250,2019-12-09 22:36:43,0,3452,2681,0.777,0.4,4113,2083,1333,3416,2030,1750,3780,649,0.0,0.0
V284,251,2019-12-09 22:56:43,0,3446,2732,0.793,0.4,3348,1457,912,2369,1891,1628,3519,422,0.0,0.0
V284,252,2019-12-09 23:16:43,0,1612,1186,0.736,0.2,618,320,188,508,298,256,554,83,0.0,0.0
V284,253,2019-12-09 23:36:43,0,2497,1893,0.758,0.3,90,27,4,31,63,49,112,0,0.0,0.0
V284,254,2019-12-09 23:56:43,0,3740,2981,0.797,0.5,1282,587,284,871,695,586,1281,41,0.0,0.0
V284,255,2019-09-13 00:16:43,0,3458,2664,0.77,0.4,3839,1960,1267,3227,1879,1612,3491,548,0.0,0.0
V284,256,2019-09-13 00:36:43,0,2991,2303,0.77,0.4,3181,1598,933,2531,1583,1365,2948,444,0.1,0.0
V284,257,2019-09-13 00:56:43,0,1702,1271,0.746,0.2,1276,578,348,926,698,595,1293,188,0.08,0.0
V284,258,2019-09-13 01:16:43,0,2196,1685,0.767,0.3,4,0,0,0,4,4,8,0,0.0,0.0
V284,259,2019-09-13 01:36:43,0,3717,2880,0.775,0.4,2141,1042,696,1738,1099,953,2052,219,0.0,-0.03
V284,260,2019-09-13 01:56:43,0,2841,2159,0.76,0.3,2900,1513,964,2477,1387,1201,2588,423,0.08,0.0
V284,261,2019-09-13 02:16:43,0,1382,1045,0.757,0.2,54,23,5,28,31,25,56,0,0.0,0.0
V284,262,2019-09-13 02:36:43,0,2504,1917,0.766,0.3,25,5,1,6,20,14,34,0,0.0,0.0
V284,263,2019-09-13 02:56:43,0,4129,3267,0.791,0.5,1293,712,515,1227,581,496,1077,184,0.0,0.0
V284,264,2019-09-13 03:16:43,0,3126,2429,0.777,0.4,2442,1256,743,1999,1186,1005,2191,373,0.0,0.0
V284,265,2019-09-13 03:36:43,0,2471,1902,0.77,0.3,3874,2046,1381,3427,1828,1573,3401,540,0.08,0.0
V284,266,2019-09-13 03:56:43,0,1485,1159,0.78,0.2,20,6,1,7,14,11,25,0,0.0,0.0
V284,267,2019-09-13 04:16:43,0,1719,1294,0.753,0.2,2,0,0,0,2,2,4,0,0.0,0.0
V284,268,2019-09-13 04:36:43,0,3288,2587,0.787,0.4,350,120,58,178,230,170,400,9,0.0,0.0
V284,269,2019-09-13 04:56:43,0,1521,1147,0.754,0.2,782,418,233,651,364,287,651,45,0.0,0.0
V284,270,2019-09-13 05:16:43,0,1290,1155,0.895,0.2,152,111,63,174,41,34,75,4,0.0,0.0
V284,271,2019-09-13 05:36:43,0,1972,1480,0.75,0.2,1257,656,408,1064,601,512,1113,128,0.0,0.0
V284,272,2019-09-13 05:56:43,1,2206,1656,0.75,0.3,21,15,1,16,6,4,10,0,0.0,0.0
V284,273,2019-09-13 06:16:43,1,1618,1220,0.754,0.2,32,0,0,0,32,21,53,0,0.0,0.0
V284,274,2019-09-13 06:36:43,1,1853,1387,0.749,0.2,10,6,1,7,4,3,7,0,0.0,0.0
V284,275,2019-09-13 06:56:43,1,4908,3954,0.806,0.6,878,503,277,780,375,317,692,7,0.0,0.09
V284,276,2019-09-13 07:16:43,1,3202,3197,0.998,0.4,2178,1132,645,1777,1046,899,1945,89,0.26,0.28
V284,277,2019-09-13 07:36:43,1,3298,3403,1.032,0.4,1949,1094,568,1662,855,728,1583,58,0.2,0.36
V284,278,2019-09-13 07:56:43,1,3219,3299,1.025,0.4,1517,715,354,1069,802,663,1465,50,0.16,0.19
V284,279,2019-09-13 08:16:43,1,2421,2502,1.034,0.3,98,28,9,37,70,54,124,0,0.0,0.0
V284,280,2019-09-13 08:36:43,1,2452,2582,1.053,0.3,112,51,36,87,61,56,117,30,0.1,0.0
V284,281,2019-09-13 08:56:43,1,2452,2597,1.059,0.3,214,63,20,83,151,120,271,0,0.0,0.04
V284,282,2019-09-13 09:16:43,1,2744,2979,1.085,0.4,157,81,7,88,76,60,136,0,0.0,0.0
V284,283,2019-09-13 09:36:43,1,3373,3514,1.042,0.4,1099,621,317,938,478,397,875,10,0.1,0.02
V284,284,2019-09-13 09:56:43,1,3163,3367,1.064,0.4,1555,893,418,1311,662,556,1218,28,0.16,0.34
V284,285,2019-09-13 10:16:43,1,2205,2388,1.083,0.3,272,175,21,196,97,71,168,0,0.0,0.0
V284,286,2019-09-13 10:36:43,1,2346,2539,1.083,0.3,53,29,4,33,24,20,44,0,0.0,0.0
V284,287,2019-09-13 10:56:43,1,2607,2833,1.087,0.3,139,107,14,121,32,24,56,2,0.0,0.0
V284,288,2019-09-13 11:16:43,1,3127,3389,1.084,0.4,1498,899,529,1428,599,504,1103,16,0.1,0.34
V284,289,2019-09-13 11:36:43,1,2392,2612,1.092,0.3,930,689,44,733,241,166,407,0,0.0,0.0
V283,1,2019-09-09 11:34:43,1,4362,3686,0.845,0.5,2359,1460,884,2344,899,494,1393,266,0.0,0.11
V283,2,2019-09-09 11:54:43,1,3079,2306,0.749,0.4,774,487,71,558,287,70,357,9,0.0,-0.03
V283,3,2019-09-09 12:14:43,1,2747,2062,0.75,0.3,34,27,1,28,7,2,9,0,0.0,0.0
V283,4,2019-09-09 12:34:43,1,2801,2093,0.747,0.3,23,12,2,14,11,7,18,0,0.0,-0.03
V283,5,2019-09-09 12:54:43,1,2952,2151,0.729,0.4,70,40,6,46,30,14,44,0,0.0,0.0
V283,6,2019-09-09 13:14:43,1,4747,3721,0.784,0.6,608,377,188,565,231,111,342,34,0.0,-0.02
V283,7,2019-09-09 13:34:43,1,4455,3547,0.796,0.6,2075,1328,672,2000,747,363,1110,282,0.0,0.09
V283,8,2019-09-09 13:54:43,1,3384,2680,0.792,0.4,1227,743,335,1078,484,229,713,163,0.0,0.0
V283,9,2019-09-09 14:14:43,1,2864,2319,0.81,0.4,46,29,4,33,17,10,27,0,0.0,0.0
V283,10,2019-09-09 14:34:43,1,2898,2175,0.751,0.4,15,14,0,14,1,0,1,0,0.0,-0.03
V283,11,2019-09-09 14:54:43,1,2854,2165,0.759,0.3,33,20,4,24,13,6,19,0,0.0,-0.04
V283,12,2019-09-09 15:14:43,1,4104,3556,0.867,0.5,1588,999,458,1457,589,271,860,154,0.0,0.09
V283,13,2019-09-09 15:34:43,1,3655,3180,0.87,0.5,2246,1425,730,2155,821,430,1251,442,0.06,0.03
V283,14,2019-09-09 15:54:43,1,3000,2335,0.778,0.4,113,65,9,74,48,16,64,0,0.0,0.0
V283,15,2019-09-09 16:14:43,1,3046,2311,0.759,0.4,33,25,4,29,8,2,10,0,0.0,0.0
V283,16,2019-09-09 16:34:43,1,2716,2366,0.871,0.3,1008,545,223,768,463,102,565,36,0.0,0.03
V283,17,2019-09-09 16:54:43,1,2966,2272,0.766,0.4,8,3,1,4,5,1,6,0,0.0,0.0
V283,18,2019-09-09 17:14:43,1,3537,2788,0.788,0.4,143,80,37,117,63,33,96,2,0.0,0.04
V283,19,2019-09-09 17:34:43,1,3003,2647,0.882,0.4,317,190,73,263,127,60,187,8,0.0,0.07
V283,20,2019-09-09 17:54:43,1,2934,2542,0.866,0.4,66,40,12,52,26,10,36,0,0.0,0.0
V283,21,2019-09-09 18:14:43,0,3907,3382,0.866,0.5,598,387,62,449,211,50,261,4,0.02,0.0
V283,22,2019-09-09 18:34:43,0,4491,3921,0.873,0.6,3862,2228,1338,3566,1634,1019,2653,1079,0.0,0.07
V283,23,2019-09-09 18:54:43,0,4543,4125,0.908,0.6,3508,2037,1119,3156,1471,815,2286,829,0.0,0.08
V283,24,2019-09-09 19:14:43,0,4333,4032,0.931,0.6,4307,2582,1540,4122,1725,1072,2797,988,0.0,0.11
V283,25,2019-09-09 19:34:43,0,3222,3142,0.975,0.4,1502,832,330,1162,670,285,955,283,0.06,0.07
V283,26,2019-09-09 19:54:43,0,4238,3896,0.919,0.5,3597,2124,1362,3486,1473,918,2391,846,0.02,0.11
V283,27,2019-09-09 20:14:43,0,4498,4199,0.933,0.6,4736,2716,1724,4440,2020,1301,3321,893,0.04,0.12
V283,28,2019-09-09 20:34:43,0,4394,4227,0.962,0.6,5415,3157,2096,5253,2258,1397,3655,1773,0.0,0.03
V283,29,2019-09-09 20:54:43,0,3859,3754,0.973,0.5,2789,1626,885,2511,1163,591,1754,683,0.08,0.15
V283,30,2019-09-09 21:14:43,0,4462,4278,0.959,0.6,1790,1093,646,1739,697,391,1088,351,0.04,0.06
V283,31,2019-09-09 21:34:43,0,3938,3823,0.971,0.5,3684,2160,1307,3467,1524,924,2448,918,0.02,0.18
V283,32,2019-09-09 21:54:43,0,3352,3569,1.064,0.4,3884,2331,1462,3793,1553,952,2505,785,0.04,0.13
V283,33,2019-09-09 22:14:43,0,2691,2587,0.961,0.3,316,221,30,251,95,41,136,0,0.0,0.0
V283,34,2019-09-09 22:34:43,0,2866,2676,0.934,0.4,77,55,7,62,22,6,28,0,0.0,0.0
V283,35,2019-09-09 22:54:43,0,3722,3739,1.004,0.5,1424,880,472,1352,544,240,784,146,0.08,0.17
V283,36,2019-09-09 23:14:43,0,2779,2694,0.969,0.4,623,385,198,583,238,128,366,38,0.06,0.14
V283,37,2019-09-09 23:34:43,0,3861,4065,1.053,0.5,441,274,127,401,167,67,234,41,0.02,0.0
V283,38,2019-09-09 23:54:43,0,3988,4273,1.072,0.5,1674,1088,604,1692,586,326,912,132,0.0,0.13
V283,39,2019-10-09 00:14:43,0,3747,4027,1.075,0.5,3177,1916,1158,3074,1261,728,1989,609,0.12,0.24
V283,40,2019-10-09 00:34:43,0,2645,2524,0.954,0.3,508,295,94,389,213,60,273,76,0.0,0.0
V283,41,2019-10-09 00:54:43,0,2746,2629,0.958,0.4,143,83,14,97,60,18,78,0,0.0,0.0
V283,42,2019-10-09 01:14:43,0,2860,2572,0.899,0.4,95,51,11,62,44,14,58,0,0.0,0.0
V283,43,2019-10-09 01:34:43,0,4208,4100,0.974,0.5,1176,734,410,1144,442,218,660,48,0.02,0.13
V283,44,2019-10-09 01:54:43,0,3271,3267,0.999,0.4,1019,599,279,878,420,182,602,46,0.14,0.19
V283,45,2019-10-09 02:14:43,0,2639,2834,1.074,0.3,34,14,3,17,20,8,28,0,0.0,0.0
V283,46,2019-10-09 02:34:43,0,2997,2741,0.915,0.4,127,74,20,94,53,22,75,0,0.0,0.0
V283,47,2019-10-09 02:54:43,0,2427,2777,1.144,0.3,735,471,176,647,264,118,382,11,0.06,0.1
V283,48,2019-10-09 03:14:43,0,3417,3334,0.976,0.4,290,171,66,237,119,55,174,3,0.0,0.12
V283,49,2019-10-09 03:34:43,0,3849,4111,1.068,0.5,2958,1732,1014,2746,1226,657,1883,683,0.08,0.17
V283,50,2019-10-09 03:54:43,0,3742,4045,1.081,0.5,4756,2807,1852,4659,1949,1130,3079,1412,0.06,0.0
V283,51,2019-10-09 04:14:43,0,4254,4198,0.987,0.6,2932,1754,1013,2767,1178,694,1872,344,0.1,0.18
V283,52,2019-10-09 04:34:43,0,3829,4052,1.058,0.5,3691,2188,1277,3465,1503,787,2290,642,0.04,0.14
V283,53,2019-10-09 04:54:43,0,3630,3876,1.068,0.5,2779,1653,942,2595,1126,624,1750,492,0.06,0.07
V283,54,2019-10-09 05:14:43,0,3638,3761,1.034,0.5,2335,1439,746,2185,896,476,1372,157,0.02,0.09
V283,55,2019-10-09 05:34:43,0,2976,2840,0.954,0.4,89,48,5,53,41,9,50,0,0.0,0.0
V283,56,2019-10-09 05:54:43,0,3697,3618,0.979,0.5,1034,669,383,1052,365,194,559,95,0.0,0.23
V283,57,2019-10-09 06:14:43,1,3675,3835,1.043,0.5,3822,2283,1340,3623,1539,936,2475,721,0.1,0.11
V283,58,2019-10-09 06:34:43,1,2912,2789,0.958,0.4,942,609,237,846,333,150,483,19,0.08,0.0
V283,59,2019-10-09 06:54:43,1,2838,2564,0.903,0.4,41,20,5,25,21,8,29,0,0.0,0.0
V283,60,2019-10-09 07:14:43,1,3816,3761,0.986,0.5,1636,1008,581,1589,628,318,946,167,0.0,0.05
V283,61,2019-10-09 07:34:43,1,2630,2584,0.983,0.3,1608,973,464,1437,635,301,936,85,0.0,0.0
V283,62,2019-10-09 07:54:43,1,2953,2585,0.876,0.4,61,29,8,37,32,2,34,0,0.0,0.0
V283,63,2019-10-09 08:14:43,1,2942,2452,0.833,0.4,24,17,4,21,7,1,8,0,0.0,0.0
V283,64,2019-10-09 08:34:43,1,3253,2864,0.88,0.4,1132,648,310,958,484,216,700,42,0.02,0.12
V283,65,2019-10-09 08:54:43,1,2942,2660,0.904,0.4,56,36,8,44,20,4,24,0,0.0,0.0
V283,66,2019-10-09 09:14:43,1,2966,2611,0.88,0.4,69,41,11,52,28,10,38,0,0.0,0.0
V283,67,2019-10-09 09:34:43,1,3219,2599,0.807,0.4,82,35,10,45,47,20,67,0,0.0,0.0
V283,68,2019-10-09 09:54:43,1,3031,2494,0.823,0.4,44,33,7,40,11,6,17,0,0.0,0.0
V283,69,2019-10-09 10:14:43,1,3745,3380,0.902,0.5,1473,949,461,1410,524,274,798,52,0.02,0.01
V283,70,2019-10-09 10:34:43,1,2917,2408,0.826,0.4,446,267,57,324,179,44,223,1,0.0,0.0
V283,71,2019-10-09 10:54:43,1,2995,2402,0.802,0.4,90,64,21,85,26,9,35,0,0.0,0.0
V283,72,2019-10-09 11:14:43,1,3011,2640,0.877,0.4,103,59,24,83,44,18,62,0,0.0,0.1
V283,73,2019-10-09 11:34:43,1,2923,2474,0.846,0.4,36,18,2,20,18,8,26,0,0.0,0.0
V283,74,2019-10-09 11:54:43,1,2900,2429,0.838,0.4,104,82,16,98,22,12,34,0,0.0,0.0
V283,75,2019-10-09 12:14:43,1,3374,2961,0.878,0.4,1750,1069,527,1596,681,311,992,121,0.02,0.06
V283,76,2019-10-09 12:34:43,1,2876,2281,0.793,0.4,73,50,7,57,23,8,31,0,0.0,0.0
V283,77,2019-10-09 12:54:43,1,2950,2254,0.764,0.4,60,42,17,59,18,4,22,0,0.0,0.0
V283,78,2019-10-09 13:14:43,1,2604,2010,0.772,0.3,29,12,4,16,17,7,24,0,0.0,0.0
V283,79,2019-10-09 13:34:43,1,2740,2413,0.881,0.3,865,525,200,725,340,121,461,45,0.0,0.07
V283,80,2019-10-09 13:54:43,1,2673,2317,0.867,0.3,52,38,3,41,14,5,19,0,0.0,0.0
V283,81,2019-10-09 14:14:43,1,2755,2213,0.803,0.3,39,26,4,30,13,9,22,0,0.0,0.0
V283,82,2019-10-09 14:34:43,1,3684,3196,0.867,0.5,589,339,111,450,250,85,335,26,0.0,0.1
V283,83,2019-10-09 14:54:43,1,3632,3494,0.962,0.5,2819,1732,1013,2745,1087,577,1664,502,0.06,0.07
V283,84,2019-10-09 15:14:43,1,3059,2575,0.842,0.4,175,113,14,127,62,11,73,0,0.0,0.0
V283,85,2019-10-09 15:34:43,1,2743,2234,0.814,0.3,44,21,6,27,23,8,31,0,0.0,0.0
V283,86,2019-10-09 15:54:43,1,2867,2257,0.787,0.4,63,36,8,44,27,6,33,0,0.0,0.0
V283,87,2019-10-09 16:14:43,1,2719,2355,0.866,0.3,1027,680,183,863,347,109,456,16,0.0,0.05
V283,88,2019-10-09 16:34:43,1,2861,2320,0.811,0.4,27,21,1,22,6,3,9,0,0.0,0.0
V283,89,2019-10-09 16:54:43,1,3767,3322,0.882,0.5,759,455,250,705,304,175,479,58,0.0,0.11
V283,90,2019-10-09 17:14:43,1,2816,2554,0.907,0.4,592,389,60,449,203,52,255,1,0.04,0.03
V283,91,2019-10-09 17:34:43,1,2926,2568,0.878,0.4,66,38,6,44,28,11,39,0,0.0,0.0
V283,92,2019-10-09 17:54:43,1,3208,2742,0.855,0.4,305,199,94,293,106,53,159,0,0.0,0.11
V283,93,2019-10-09 18:14:43,0,4173,4152,0.995,0.5,2851,1762,877,2639,1089,512,1601,320,0.0,0.03
V283,94,2019-10-09 18:34:43,0,3934,3825,0.972,0.5,3793,2271,1416,3687,1522,874,2396,922,0.02,0.08
V283,95,2019-10-09 18:54:43,0,4260,4152,0.975,0.6,3919,2396,1441,3837,1523,816,2339,912,0.02,0.06
V283,96,2019-10-09 19:14:43,0,3826,3704,0.968,0.5,3918,2387,1495,3882,1531,924,2455,609,0.0,0.15
V283,97,2019-10-09 19:34:43,0,4089,3970,0.971,0.5,3701,2254,1395,3649,1447,833,2280,556,0.0,0.05
V283,98,2019-10-09 19:54:43,0,3276,3147,0.961,0.4,2969,1761,974,2735,1208,662,1870,341,0.0,0.18
V283,99,2019-10-09 20:14:43,0,4048,3906,0.965,0.5,5019,3104,2104,5208,1915,1133,3048,788,0.02,0.0
V283,100,2019-10-09 20:34:43,0,3856,3807,0.987,0.5,4066,2523,1568,4091,1543,819,2362,513,0.0,0.07
V283,101,2019-10-09 20:54:43,0,3017,2685,0.89,0.4,453,237,36,273,216,30,246,0,0.0,0.0
V283,102,2019-10-09 21:14:43,0,3820,3774,0.988,0.5,2399,1468,920,2388,931,508,1439,275,0.0,0.11
V283,103,2019-10-09 21:34:43,0,3868,3810,0.985,0.5,3499,2124,1193,3317,1375,759,2134,446,0.1,0.15
V283,104,2019-10-09 21:54:43,0,4178,4135,0.99,0.5,3338,2006,1195,3201,1332,708,2040,278,0.06,0.21
V283,105,2019-10-09 22:14:43,0,2997,3026,1.01,0.4,2328,1456,813,2269,872,482,1354,210,0.04,0.06
V283,106,2019-10-09 22:34:43,0,3586,3516,0.98,0.5,1182,714,422,1136,468,257,725,91,0.0,0.04
V283,107,2019-10-09 22:54:43,0,3829,4101,1.071,0.5,3496,2094,1289,3383,1402,762,2164,499,0.04,0.19
V283,108,2019-10-09 23:14:43,0,3653,3864,1.058,0.5,3057,1916,1271,3187,1141,632,1773,311,0.06,0.18
V283,109,2019-10-09 23:34:43,0,3998,4019,1.005,0.5,4912,3115,2157,5272,1797,1078,2875,961,0.04,0.07
V283,110,2019-10-09 23:54:43,0,3653,3656,1.001,0.5,2566,1560,863,2423,1006,483,1489,200,0.1,0.2
V283,111,2019-11-09 00:14:43,0,2841,2809,0.989,0.4,129,91,14,105,38,15,53,0,0.0,0.0
V283,112,2019-11-09 00:34:43,0,3891,4116,1.058,0.5,1062,661,368,1029,401,200,601,143,0.02,0.17
V283,113,2019-11-09 00:54:43,0,3356,3800,1.132,0.5,2819,1775,1078,2853,1044,535,1579,216,0.18,0.25
V283,114,2019-11-09 01:14:43,0,3556,3644,1.025,0.5,2531,1612,834,2446,919,488,1407,221,0.1,0.23
V283,115,2019-11-09 01:34:43,0,3873,4003,1.033,0.5,2567,1636,761,2397,931,506,1437,56,0.06,0.12
V283,116,2019-11-09 01:54:43,0,3696,3860,1.045,0.5,534,355,232,587,179,92,271,34,0.06,0.0
V283,117,2019-11-09 02:14:43,0,2640,2884,1.093,0.4,910,545,196,741,365,146,511,53,0.0,0.0
V283,118,2019-11-09 02:34:43,0,3920,4058,1.035,0.5,1093,690,417,1107,403,187,590,44,0.0,0.0
V283,119,2019-11-09 02:54:43,0,2939,3104,1.056,0.4,243,139,81,220,104,62,166,4,0.0,0.09
V283,120,2019-11-09 03:14:43,0,2658,2713,1.021,0.3,79,42,16,58,37,15,52,0,0.0,0.0
V283,121,2019-11-09 03:34:43,0,3956,4123,1.042,0.5,824,426,137,563,398,115,513,3,0.0,0.09
V283,122,2019-11-09 03:54:43,0,3933,4259,1.083,0.5,3464,2220,1325,3545,1244,689,1933,383,0.08,0.13
V283,123,2019-11-09 04:14:43,0,4517,4724,1.046,0.6,4192,2634,1764,4398,1558,861,2419,799,0.08,0.25
V283,124,2019-11-09 04:34:43,0,3508,3656,1.042,0.5,3682,2285,1430,3715,1397,787,2184,458,0.14,0.12
V283,125,2019-11-09 04:54:43,0,2609,2641,1.012,0.3,359,235,20,255,124,47,171,0,0.0,0.0
V283,126,2019-11-09 05:14:43,0,3259,3282,1.007,0.4,158,74,22,96,84,32,116,0,0.0,0.02
V283,127,2019-11-09 05:34:43,0,3983,4248,1.067,0.5,4901,3131,2070,5201,1770,1059,2829,495,0.0,0.08
V283,128,2019-11-09 05:54:43,0,3702,3919,1.059,0.5,3140,1959,1184,3143,1181,708,1889,208,0.08,0.23
V283,129,2019-11-09 06:14:43,1,3928,3901,0.993,0.5,5882,3776,2563,6339,2106,1245,3351,945,0.08,0.0
V283,130,2019-11-09 06:34:43,1,3372,3286,0.974,0.4,2224,1303,682,1985,921,459,1380,23,0.0,0.03
V283,131,2019-11-09 06:54:43,1,2804,2444,0.872,0.4,103,69,12,81,34,10,44,0,0.0,0.0
V283,132,2019-11-09 07:14:43,1,2781,2421,0.871,0.4,76,41,16,57,35,8,43,0,0.0,0.0
V283,133,2019-11-09 07:34:43,1,4409,4023,0.913,0.6,1082,694,447,1141,388,219,607,125,0.0,0.0
V283,134,2019-11-09 07:54:43,1,2671,2316,0.867,0.3,1528,883,442,1325,645,310,955,100,0.0,0.0
V283,135,2019-11-09 08:14:43,1,3054,2457,0.804,0.4,21,12,5,17,9,2,11,0,0.0,0.0
V283,136,2019-11-09 08:34:43,1,2778,2330,0.839,0.3,144,88,23,111,56,19,75,0,0.0,0.0
V283,137,2019-11-09 08:54:43,1,2474,1963,0.793,0.3,485,288,122,410,197,77,274,63,0.0,0.0
V283,138,2019-11-09 09:14:43,1,2798,2199,0.786,0.3,39,22,6,28,17,3,20,0,0.0,0.0
V283,139,2019-11-09 09:34:43,1,2746,2144,0.781,0.3,45,18,7,25,27,9,36,0,0.0,0.0
V283,140,2019-11-09 09:54:43,1,2597,1971,0.759,0.3,59,42,8,50,17,5,22,0,0.0,0.0
V283,141,2019-11-09 10:14:43,1,3947,3263,0.827,0.5,2369,1464,803,2267,905,518,1423,210,0.02,0.07
V283,142,2019-11-09 10:34:43,1,3372,2847,0.844,0.4,1472,789,361,1150,683,284,967,78,0.0,0.0
V283,143,2019-11-09 10:54:43,1,4315,3530,0.818,0.5,1083,720,425,1145,363,202,565,19,0.02,0.0
V283,144,2019-11-09 11:14:43,1,2912,2567,0.881,0.4,567,329,134,463,238,106,344,15,0.0,0.04
V283,145,2019-11-09 11:34:43,1,2629,2241,0.852,0.3,247,149,36,185,98,41,139,2,0.0,0.03
V283,146,2019-11-09 11:54:43,1,2852,2348,0.823,0.4,39,26,2,28,13,3,16,0,0.0,0.0
V283,147,2019-11-09 12:14:43,1,2833,2279,0.804,0.4,113,77,8,85,36,16,52,0,0.0,0.0
V283,148,2019-11-09 12:34:43,1,2793,2158,0.773,0.3,109,77,9,86,32,13,45,0,0.0,0.0
V283,149,2019-11-09 12:54:43,1,3746,3270,0.873,0.5,1133,717,405,1122,416,197,613,48,0.0,0.11
V283,150,2019-11-09 13:14:43,1,2857,2670,0.935,0.4,807,468,172,640,339,176,515,19,0.04,0.05
V283,151,2019-11-09 13:34:43,1,2889,2568,0.889,0.4,25,10,1,11,15,0,15,0,0.0,0.0
V283,152,2019-11-09 13:54:43,1,2729,2301,0.843,0.3,57,29,3,32,28,13,41,0,0.0,0.0
V283,153,2019-11-09 14:14:43,1,3584,3310,0.924,0.5,668,404,113,517,264,97,361,5,0.0,0.0
V283,154,2019-11-09 14:34:43,1,2660,2476,0.931,0.3,423,290,158,448,133,79,212,16,0.0,0.11
V283,155,2019-11-09 14:54:43,1,2597,2294,0.883,0.3,52,35,5,40,17,5,22,0,0.0,0.0
V283,156,2019-11-09 15:14:43,1,2707,2396,0.885,0.3,48,21,7,28,27,13,40,0,0.0,0.0
V283,157,2019-11-09 15:34:43,1,3657,3311,0.906,0.5,366,234,35,269,132,24,156,0,0.0,0.0
V283,158,2019-11-09 15:54:43,1,3527,3491,0.99,0.5,2833,1755,963,2718,1078,551,1629,185,0.08,0.13
V283,159,2019-11-09 16:14:43,1,2689,2608,0.97,0.3,964,504,180,684,460,135,595,1,0.0,0.11
V283,160,2019-11-09 16:34:43,1,2676,2415,0.902,0.3,54,32,9,41,22,3,25,0,0.0,0.0
V283,161,2019-11-09 16:54:43,1,2776,2452,0.883,0.4,82,53,11,64,29,11,40,0,0.0,0.0
V283,162,2019-11-09 17:14:43,1,3733,3684,0.987,0.5,1717,990,562,1552,727,365,1092,154,0.0,0.1
V283,163,2019-11-09 17:34:43,1,2744,2676,0.975,0.4,752,367,177,544,385,151,536,36,0.0,0.0
V283,164,2019-11-09 17:54:43,1,3143,2857,0.909,0.4,93,44,21,65,49,20,69,2,0.0,0.1
V283,165,2019-11-09 18:14:43,0,3899,3903,1.001,0.5,2580,1537,671,2208,1043,445,1488,168,0.02,0.04
V283,166,2019-11-09 18:34:43,0,2589,2606,1.007,0.3,2408,1500,945,2445,908,481,1389,424,0.0,0.06
V283,167,2019-11-09 18:54:43,0,3920,4044,1.032,0.5,4957,3099,2196,5295,1858,1175,3033,824,0.02,0.12
V283,168,2019-11-09 19:14:43,0,3828,4057,1.06,0.5,5622,3537,2484,6021,2085,1294,3379,615,0.0,0.14
V283,169,2019-11-09 19:34:43,0,3019,2960,0.981,0.4,1594,959,537,1496,635,296,931,80,0.0,0.06
V283,170,2019-11-09 19:54:43,0,3510,3681,1.049,0.5,1736,1070,576,1646,666,333,999,68,0.0,0.12
V283,171,2019-11-09 20:14:43,0,2698,2821,1.046,0.4,2249,1303,809,2112,946,538,1484,261,0.0,0.04
V283,172,2019-11-09 20:34:43,0,3527,3513,0.996,0.5,1615,1024,693,1717,591,334,925,166,0.04,0.19
V283,173,2019-11-09 20:54:43,0,3963,4084,1.031,0.5,4244,2627,1597,4224,1617,943,2560,481,0.06,0.1
V283,174,2019-11-09 21:14:43,0,3676,3851,1.048,0.5,6275,3866,2803,6669,2409,1503,3912,719,0.06,0.17
V283,175,2019-11-09 21:34:43,0,3543,3557,1.004,0.5,4106,2579,1734,4313,1527,863,2390,587,0.0,0.09
V283,176,2019-11-09 21:54:43,0,2954,3001,1.016,0.4,102,48,8,56,54,17,71,0,0.02,0.0
V283,177,2019-11-09 22:14:43,0,3764,3979,1.057,0.5,2465,1595,979,2574,870,515,1385,154,0.02,0.19
V283,178,2019-11-09 22:34:43,0,4247,4414,1.039,0.6,5271,3119,2080,5199,2152,1314,3466,872,0.12,0.13
V283,179,2019-11-09 22:54:43,0,4013,4225,1.053,0.5,4454,2673,1644,4317,1781,1020,2801,403,0.06,0.12
V283,180,2019-11-09 23:14:43,0,4081,4210,1.032,0.5,5145,3142,2112,5254,2003,1250,3253,476,0.04,0.16
V283,181,2019-11-09 23:34:43,0,4122,4294,1.042,0.5,5965,3595,2487,6082,2370,1514,3884,724,0.08,0.11
V283,182,2019-11-09 23:54:43,0,3732,3863,1.035,0.5,3595,2072,1393,3465,1523,862,2385,282,0.04,0.08
V283,183,2019-12-09 00:14:43,0,2811,2733,0.972,0.4,143,83,9,92,60,15,75,0,0.0,0.0
V283,184,2019-12-09 00:34:43,0,2624,2539,0.968,0.3,64,30,4,34,34,12,46,0,0.0,0.0
V283,185,2019-12-09 00:54:43,0,4235,4272,1.009,0.6,3608,2268,1524,3792,1340,857,2197,306,0.0,0.13
V283,186,2019-12-09 01:14:43,0,4327,4419,1.021,0.6,9190,5704,4247,9951,3486,2258,5744,1764,0.04,0.03
V283,187,2019-12-09 01:34:43,0,4029,4097,1.017,0.5,6549,4031,2714,6745,2518,1595,4113,682,0.02,0.09
V283,188,2019-12-09 01:54:43,0,3642,3594,0.987,0.5,4195,2568,1585,4153,1627,875,2502,543,0.06,0.03
V283,189,2019-12-09 02:14:43,0,3664,3435,0.937,0.5,6869,4247,2943,7190,2622,1715,4337,871,0.02,0.03
V283,190,2019-12-09 02:34:43,0,2069,1745,0.844,0.3,1959,1201,605,1806,758,367,1125,264,0.0,0.0
V283,191,2019-12-09 02:54:43,0,3507,3001,0.856,0.4,3398,2140,1360,3500,1258,729,1987,422,0.0,0.0
V283,192,2019-12-09 03:14:43,0,2719,2152,0.791,0.3,166,81,6,87,85,18,103,0,0.0,0.0
V283,193,2019-12-09 03:34:43,0,2643,2161,0.818,0.3,46,20,6,26,26,11,37,0,0.0,0.0
V283,194,2019-12-09 03:54:43,0,3298,2718,0.824,0.4,206,79,29,108,127,24,151,3,0.02,0.0
V283,195,2019-12-09 04:14:43,0,4130,3347,0.81,0.5,6557,4108,2855,6963,2449,1595,4044,839,0.0,0.0
V283,196,2019-12-09 04:34:43,0,3777,2966,0.785,0.5,5346,3184,1973,5157,2162,1288,3450,377,0.02,0.0
V283,197,2019-12-09 04:54:43,0,3590,2852,0.795,0.4,2723,1665,924,2589,1058,581,1639,144,0.0,0.0
V283,198,2019-12-09 05:14:43,0,1870,1432,0.766,0.2,2122,1239,757,1996,883,520,1403,99,0.02,0.03
V283,199,2019-12-09 05:34:43,0,1754,1325,0.756,0.2,1844,1120,719,1839,724,410,1134,276,0.04,0.0
V283,200,2019-12-09 05:54:43,0,2391,1850,0.774,0.3,43,25,4,29,18,4,22,0,0.0,0.0
V283,201,2019-12-09 06:14:43,1,2426,1756,0.724,0.3,58,38,8,46,20,8,28,0,0.0,0.0
V283,202,2019-12-09 06:34:43,1,2504,1883,0.752,0.3,35,26,10,36,9,2,11,0,0.0,0.0
V283,203,2019-12-09 06:54:43,1,2245,1734,0.773,0.3,17,2,1,3,15,0,15,0,0.0,0.0
V283,204,2019-12-09 07:14:43,1,4172,3275,0.785,0.5,2160,1303,793,2096,857,499,1356,325,0.02,0.0
V283,205,2019-12-09 07:34:43,1,2828,2262,0.8,0.4,2778,1752,1088,2840,1026,636,1662,193,0.02,0.0
V283,206,2019-12-09 07:54:43,1,2361,1759,0.745,0.3,108,80,2,82,28,12,40,0,0.0,0.0
V283,207,2019-12-09 08:14:43,1,2393,1766,0.738,0.3,19,10,3,13,9,2,11,0,0.0,0.0
V283,208,2019-12-09 08:34:43,1,2397,1787,0.746,0.3,42,27,5,32,15,5,20,0,0.0,0.0
V283,209,2019-12-09 08:54:43,1,2577,1942,0.754,0.3,20,12,1,13,8,0,8,0,0.0,0.0
V283,210,2019-12-09 09:14:43,1,3281,2602,0.793,0.4,2071,1260,784,2044,811,479,1290,248,0.0,0.0
V283,211,2019-12-09 09:34:43,1,2265,1681,0.742,0.3,268,177,21,198,91,16,107,0,0.0,0.0
V283,212,2019-12-09 09:54:43,1,2308,1755,0.76,0.3,30,22,1,23,8,4,12,0,0.0,0.0
V283,213,2019-12-09 10:14:43,1,2237,1688,0.755,0.3,41,26,5,31,15,4,19,0,0.02,0.0
V283,214,2019-12-09 10:34:43,1,2365,1823,0.771,0.3,66,43,7,50,23,13,36,0,0.0,0.0
V283,215,2019-12-09 10:54:43,1,3293,2605,0.791,0.4,358,217,66,283,141,50,191,0,0.0,0.0
V283,216,2019-12-09 11:14:43,1,3261,3061,0.938,0.4,1994,1270,792,2062,724,404,1128,48,0.02,0.3
V283,217,2019-12-09 11:34:43,1,3289,3281,0.998,0.4,1697,1042,485,1527,655,309,964,40,0.16,0.22
V283,218,2019-12-09 11:54:43,1,2579,2555,0.991,0.3,80,57,6,63,23,7,30,0,0.0,0.0
V283,219,2019-12-09 12:14:43,1,2596,2575,0.992,0.3,27,13,1,14,14,0,14,0,0.0,0.0
V283,220,2019-12-09 12:34:43,1,2187,2221,1.016,0.3,55,31,4,35,24,4,28,0,0.0,0.0
V283,221,2019-12-09 12:54:43,1,3212,3259,1.015,0.4,609,377,192,569,232,112,344,11,0.0,0.07
V283,222,2019-12-09 13:14:43,1,2573,2587,1.005,0.3,1125,658,318,976,467,246,713,37,0.12,0.16
V283,223,2019-12-09 13:34:43,1,2592,2613,1.008,0.3,31,18,2,20,13,2,15,0,0.0,0.0
V283,224,2019-12-09 13:54:43,1,2458,2530,1.029,0.3,30,22,4,26,8,2,10,0,0.0,0.0
V283,225,2019-12-09 14:14:43,1,3428,3573,1.042,0.5,1220,728,417,1145,492,239,731,77,0.0,0.13
V283,226,2019-12-09 14:34:43,1,3215,3483,1.083,0.4,1644,970,423,1393,674,318,992,21,0.12,0.24
V283,227,2019-12-09 14:54:43,1,2449,2558,1.044,0.3,354,220,17,237,134,35,169,0,0.04,0.0
V283,228,2019-12-09 15:14:43,1,2336,2400,1.027,0.3,46,32,8,40,14,5,19,0,0.0,0.0
V283,229,2019-12-09 15:34:43,1,3066,3073,1.002,0.4,620,374,215,589,246,118,364,25,0.0,0.07
V283,230,2019-12-09 15:54:43,1,2875,2969,1.033,0.4,109,73,7,80,36,10,46,0,0.0,0.0
V283,231,2019-12-09 16:14:43,1,3418,3612,1.057,0.5,2484,1583,919,2502,901,529,1430,221,0.04,0.24
V283,232,2019-12-09 16:34:43,1,2500,2641,1.056,0.3,612,357,143,500,255,80,335,15,0.04,0.07
V283,233,2019-12-09 16:54:43,1,2674,2790,1.044,0.4,21,9,0,9,12,1,13,0,0.0,0.0
V283,234,2019-12-09 17:14:43,1,2839,2953,1.04,0.4,132,70,26,96,62,24,86,0,0.0,0.04
V283,235,2019-12-09 17:34:43,1,2635,2726,1.035,0.3,1843,1144,547,1691,699,310,1009,143,0.0,0.07
V283,236,2019-12-09 17:54:43,1,3092,3162,1.023,0.4,278,140,75,215,138,78,216,14,0.0,0.05
V283,237,2019-12-09 18:14:43,0,3452,3396,0.984,0.4,2147,1304,586,1890,843,377,1220,73,0.02,0.08
V283,238,2019-12-09 18:34:43,0,3737,3726,0.997,0.5,4623,2911,1995,4906,1712,1006,2718,211,0.0,-0.05
V283,239,2019-12-09 18:54:43,0,3697,3265,0.883,0.5,4272,2651,1864,4515,1621,982,2603,400,0.0,0.0
V283,240,2019-12-09 19:14:43,0,2592,2329,0.898,0.3,2287,1382,794,2176,905,497,1402,161,0.0,0.0
V283,241,2019-12-09 19:34:43,0,3719,3038,0.817,0.5,3629,2314,1571,3885,1315,824,2139,385,0.0,0.0
V283,242,2019-12-09 19:54:43,0,2637,2158,0.818,0.3,522,302,48,350,220,28,248,0,0.0,0.0
V283,243,2019-12-09 20:14:43,0,3912,3248,0.83,0.5,1257,758,477,1235,499,305,804,57,0.0,0.0
V283,244,2019-12-09 20:34:43,0,3497,2860,0.818,0.4,5152,3280,2342,5622,1872,1171,3043,646,0.04,0.0
V283,245,2019-12-09 20:54:43,0,2194,1814,0.827,0.3,1483,914,533,1447,569,308,877,169,0.02,0.0
V283,246,2019-12-09 21:14:43,0,3603,2843,0.789,0.4,4242,2605,1778,4383,1637,1040,2677,379,0.02,0.0
V283,247,2019-12-09 21:34:43,0,1829,1497,0.819,0.2,1387,834,453,1287,553,264,817,137,0.0,0.0
V283,248,2019-12-09 21:54:43,0,3673,2909,0.792,0.5,1085,684,430,1114,401,229,630,58,0.0,0.0
V283,249,2019-12-09 22:14:43,0,3707,2988,0.806,0.5,5086,3074,2015,5089,2012,1124,3136,677,0.04,0.02
V283,250,2019-12-09 22:34:43,0,1689,1376,0.815,0.2,1033,587,294,881,446,180,626,52,0.02,0.0
V283,251,2019-12-09 22:54:43,0,3991,3148,0.789,0.5,2131,1317,840,2157,814,468,1282,197,0.0,0.0
V283,252,2019-12-09 23:14:43,0,3634,2829,0.779,0.4,5669,3522,2486,6008,2147,1317,3464,717,0.04,0.0
V283,253,2019-12-09 23:34:43,0,3301,2605,0.789,0.4,4734,2943,1989,4932,1791,1087,2878,478,0.04,0.0
V283,254,2019-12-09 23:54:43,0,1653,1337,0.808,0.2,358,201,65,266,157,67,224,6,0.0,-0.01
V283,255,2019-09-13 00:14:43,0,3437,2744,0.798,0.4,579,338,227,565,241,121,362,41,0.0,0.0
V283,256,2019-09-13 00:34:43,0,3607,2848,0.79,0.4,5321,3285,2219,5504,2036,1226,3262,518,0.02,0.0
V283,257,2019-09-13 00:54:43,0,3505,2782,0.794,0.4,6168,3870,2714,6584,2298,1392,3690,1009,0.1,0.0
V283,258,2019-09-13 01:14:43,0,1904,1550,0.814,0.2,3059,1979,1284,3263,1080,593,1673,280,0.04,0.0
V283,259,2019-09-13 01:34:43,0,1740,1327,0.762,0.2,65,29,3,32,36,12,48,0,0.0,0.0
V283,260,2019-09-13 01:54:43,0,3884,3015,0.776,0.5,1976,1259,857,2116,717,435,1152,173,0.0,0.0
V283,261,2019-09-13 02:14:43,0,3472,2700,0.778,0.4,5718,3553,2363,5916,2165,1343,3508,846,0.04,0.0
V283,262,2019-09-13 02:34:43,0,1457,1174,0.806,0.2,1096,615,387,1002,481,223,704,65,0.02,0.0
V283,263,2019-09-13 02:54:43,0,2376,1846,0.777,0.3,111,72,9,81,39,15,54,0,0.0,0.0
V283,264,2019-09-13 03:14:43,0,3431,2737,0.798,0.4,540,338,191,529,202,97,299,25,0.02,0.0
V283,265,2019-09-13 03:34:43,0,1978,1530,0.773,0.2,3394,2133,1521,3654,1261,694,1955,559,0.02,0.0
V283,266,2019-09-13 03:54:43,0,1455,1129,0.776,0.2,30,16,0,16,14,0,14,0,0.0,0.0
V283,267,2019-09-13 04:14:43,0,1694,1322,0.78,0.2,540,313,155,468,227,100,327,4,0.0,0.0
V283,268,2019-09-13 04:34:43,0,3054,2459,0.805,0.4,815,492,271,763,323,158,481,31,0.0,0.0
V283,269,2019-09-13 04:54:43,0,1617,1257,0.777,0.2,117,79,22,101,38,12,50,0,0.0,0.0
V283,270,2019-09-13 05:14:43,0,3188,2489,0.781,0.4,323,207,96,303,116,50,166,18,0.0,0.0
V283,271,2019-09-13 05:34:43,0,2422,1914,0.79,0.3,2500,1505,919,2424,995,450,1445,214,0.06,0.0
V283,272,2019-09-13 05:54:43,0,1116,877,0.786,0.1,54,33,3,36,21,3,24,0,0.0,0.0
V283,273,2019-09-13 06:14:43,1,1733,1341,0.774,0.2,91,73,5,78,18,7,25,0,0.0,0.0
V283,274,2019-09-13 06:34:43,1,2109,1613,0.765,0.3,63,43,0,43,20,0,20,0,0.0,0.0
V283,275,2019-09-13 06:54:43,1,4288,3472,0.81,0.5,862,614,415,1029,248,118,366,7,0.0,0.02
V283,276,2019-09-13 07:14:43,1,3339,3384,1.013,0.4,1939,1173,688,1861,766,408,1174,39,0.26,0.31
V283,277,2019-09-13 07:34:43,1,3144,3221,1.024,0.4,1670,1093,611,1704,577,294,871,17,0.14,0.34
V283,278,2019-09-13 07:54:43,1,3140,3244,1.033,0.4,1833,1148,674,1822,685,410,1095,52,0.16,0.25
V283,279,2019-09-13 08:14:43,1,2718,2876,1.058,0.4,1722,1092,589,1681,630,341,971,28,0.14,0.26
V283,280,2019-09-13 08:34:43,1,2980,3167,1.063,0.4,610,357,144,501,253,82,335,15,0.06,0.0
V283,281,2019-09-13 08:54:43,1,2214,2374,1.073,0.3,60,35,8,43,25,2,27,0,0.0,0.0
V283,282,2019-09-13 09:14:43,1,2247,2374,1.056,0.3,20,9,6,15,11,6,17,0,0.0,-0.03
V283,283,2019-09-13 09:34:43,1,3719,3921,1.054,0.5,1451,943,625,1568,508,260,768,25,0.02,-0.04
V283,284,2019-09-13 09:54:43,1,2822,2988,1.059,0.4,2074,1286,694,1980,788,440,1228,34,0.08,0.19
V283,285,2019-09-13 10:14:43,1,2325,2531,1.089,0.3,483,177,58,235,306,104,410,0,0.06,0.22
V283,286,2019-09-13 10:34:43,1,2415,2583,1.07,0.3,59,38,7,45,21,2,23,0,0.0,0.0
V283,287,2019-09-13 10:54:43,1,2470,2679,1.085,0.3,68,49,9,58,19,10,29,0,0.0,0.0
V283,288,2019-09-13 11:14:43,1,2400,2603,1.085,0.3,232,150,50,200,82,28,110,3,0.0,-0.02
V283,289,2019-09-13 11:34:43,1,2670,2931,1.098,0.4,123,70,30,100,53,23,76,0,0.0,0.0
V273,1,2019-09-09 11:24:43,1,4346,3427,0.788,0.6,667,382,187,569,285,127,412,31,0.0,0.0
V273,2,2019-09-09 11:44:43,1,2915,2283,0.783,0.4,880,634,110,744,246,68,314,0,0.0,0.0
V273,3,2019-09-09 12:04:43,1,2750,2040,0.742,0.3,20,9,1,10,11,6,17,0,0.0,0.0
V273,4,2019-09-09 12:24:43,1,4431,3486,0.787,0.6,569,357,173,530,212,59,271,14,0.0,0.0
V273,5,2019-09-09 12:44:43,1,3121,2534,0.812,0.4,1003,579,193,772,424,152,576,11,0.0,0.0
V273,6,2019-09-09 13:04:43,1,2685,2123,0.791,0.3,49,26,7,33,23,4,27,0,0.0,0.0
V273,7,2019-09-09 13:24:43,1,2873,2117,0.737,0.4,3,2,0,2,1,0,1,0,0.0,0.0
V273,8,2019-09-09 13:44:43,1,2632,1988,0.755,0.3,106,82,23,105,24,9,33,0,0.0,0.0
V273,9,2019-09-09 14:04:43,1,2831,2126,0.751,0.4,55,25,0,25,30,0,30,0,0.0,0.0
V273,10,2019-09-09 14:24:43,1,4294,3555,0.828,0.6,1007,586,282,868,421,185,606,28,0.0,0.0
V273,11,2019-09-09 14:44:43,1,3728,3313,0.889,0.5,1137,673,250,923,464,162,626,46,0.0,0.08
V273,12,2019-09-09 15:04:43,1,2874,2332,0.811,0.4,70,38,5,43,32,6,38,0,0.0,0.0
V273,13,2019-09-09 15:24:43,1,2884,2183,0.757,0.4,56,42,0,42,14,3,17,0,0.0,0.0
V273,14,2019-09-09 15:44:43,1,2720,2145,0.788,0.3,58,32,14,46,26,10,36,0,0.0,0.0
V273,15,2019-09-09 16:04:43,1,3969,3351,0.844,0.5,827,502,203,705,325,129,454,20,0.0,0.05
V273,16,2019-09-09 16:24:43,1,2727,2298,0.843,0.4,80,51,12,63,29,11,40,0,0.0,0.02
V273,17,2019-09-09 16:44:43,1,3540,3130,0.884,0.5,395,205,48,253,190,21,211,0,0.02,0.0
V273,18,2019-09-09 17:04:43,1,2563,2250,0.878,0.3,758,494,144,638,264,92,356,8,0.0,0.07
V273,19,2019-09-09 17:24:43,1,3432,3003,0.875,0.4,215,127,53,180,88,39,127,0,0.0,0.05
V273,20,2019-09-09 17:44:43,1,2807,2562,0.913,0.4,86,59,7,66,27,12,39,0,0.0,0.0
V273,21,2019-09-09 18:04:43,0,3290,2945,0.895,0.4,431,303,27,330,128,33,161,0,0.0,0.0
V273,22,2019-09-09 18:24:43,0,4050,3563,0.88,0.5,665,314,83,397,351,92,443,3,0.0,0.04
V273,23,2019-09-09 18:44:43,0,4166,3908,0.938,0.6,1921,1303,744,2047,618,304,922,298,0.0,0.12
V273,24,2019-09-09 19:04:43,0,3187,3222,1.011,0.4,615,443,108,551,172,65,237,9,0.0,0.03
V273,25,2019-09-09 19:24:43,0,3989,4227,1.06,0.5,2179,1343,790,2133,836,362,1198,202,0.06,0.13
V273,26,2019-09-09 19:44:43,0,3960,3954,0.999,0.5,2714,1694,963,2657,1020,489,1509,314,0.02,0.1
V273,27,2019-09-09 20:04:43,0,3915,3741,0.956,0.5,1565,887,407,1294,678,284,962,159,0.08,0.08
V273,28,2019-09-09 20:24:43,0,3957,3931,0.993,0.5,2663,1647,913,2560,1016,558,1574,360,0.08,0.17
V273,29,2019-09-09 20:44:43,0,3856,4058,1.052,0.5,1603,899,462,1361,704,301,1005,130,0.06,0.13
V273,30,2019-09-09 21:04:43,0,3173,3011,0.949,0.4,84,28,2,30,56,20,76,0,0.02,0.0
V273,31,2019-09-09 21:24:43,0,3952,4003,1.013,0.5,1991,1255,748,2003,736,395,1131,155,0.02,0.16
V273,32,2019-09-09 21:44:43,0,4360,4315,0.99,0.6,2199,1283,703,1986,916,426,1342,253,0.12,0.23
V273,33,2019-09-09 22:04:43,0,3696,2857,0.773,0.5,476,236,42,278,240,79,319,0,0.0,0.0
V273,34,2019-09-09 22:24:43,0,2893,2930,1.013,0.4,102,75,5,80,27,12,39,0,0.0,0.0
V273,35,2019-09-09 22:44:43,0,4265,4516,1.059,0.6,919,512,237,749,407,148,555,36,0.0,0.0
V273,36,2019-09-09 23:04:43,0,3470,3443,0.992,0.5,992,616,264,880,376,160,536,55,0.08,0.2
V273,37,2019-09-09 23:24:43,0,3701,3815,1.031,0.5,599,345,167,512,254,112,366,49,0.06,0.12
V273,38,2019-09-09 23:44:43,0,4059,4404,1.085,0.6,2250,1261,683,1944,989,507,1496,207,0.14,0.09
V273,39,2019-10-09 00:04:43,0,3896,4079,1.047,0.5,1368,843,362,1205,525,236,761,29,0.08,0.29
V273,40,2019-10-09 00:24:43,0,2991,3070,1.026,0.4,69,43,3,46,26,8,34,0,0.0,0.0
V273,41,2019-10-09 00:44:43,0,2924,3025,1.034,0.4,385,191,73,264,194,76,270,6,0.0,0.03
V273,42,2019-10-09 01:04:43,0,3287,3536,1.076,0.5,446,272,109,381,174,54,228,6,0.0,0.15
V273,43,2019-10-09 01:24:43,0,2753,2893,1.051,0.4,831,497,258,755,334,152,486,36,0.1,0.05
V273,44,2019-10-09 01:44:43,0,3758,3908,1.04,0.5,390,215,43,258,175,45,220,0,0.0,0.06
V273,45,2019-10-09 02:04:43,0,2931,3099,1.057,0.4,143,80,47,127,63,23,86,0,0.06,0.0
V273,46,2019-10-09 02:24:43,0,3004,3101,1.032,0.4,123,74,16,90,49,21,70,0,0.0,0.0
V273,47,2019-10-09 02:44:43,0,3619,3624,1.001,0.5,645,362,116,478,283,110,393,19,0.0,0.2
V273,48,2019-10-09 03:04:43,0,3614,3250,0.899,0.5,148,74,7,81,74,18,92,0,0.0,0.0
V273,49,2019-10-09 03:24:43,0,2591,2670,1.031,0.4,79,49,9,58,30,6,36,0,0.0,0.0
V273,50,2019-10-09 03:44:43,0,3693,3625,0.982,0.5,1068,642,265,907,426,187,613,65,0.1,0.2
V273,51,2019-10-09 04:04:43,0,2987,3000,1.004,0.4,1191,674,328,1002,517,255,772,92,0.1,0.14
V273,52,2019-10-09 04:24:43,0,3059,3059,1.0,0.4,74,54,0,54,20,2,22,0,0.0,0.0
V273,53,2019-10-09 04:44:43,0,3882,4216,1.086,0.5,862,473,186,659,389,146,535,23,0.08,0.11
V273,54,2019-10-09 05:04:43,0,3311,3331,1.006,0.4,158,97,15,112,61,17,78,0,0.0,0.09
V273,55,2019-10-09 05:24:43,0,4259,4405,1.034,0.6,1606,934,489,1423,672,350,1022,187,0.08,0.12
V273,56,2019-10-09 05:44:43,0,3813,4109,1.078,0.5,2171,1318,696,2014,853,458,1311,189,0.1,0.24
V273,57,2019-10-09 06:04:43,1,3438,3765,1.095,0.5,2265,1381,687,2068,884,441,1325,274,0.1,0.0
V273,58,2019-10-09 06:24:43,1,3163,3054,0.966,0.4,1009,555,205,760,454,227,681,26,0.0,0.04
V273,59,2019-10-09 06:44:43,1,2885,2703,0.937,0.4,23,14,0,14,9,2,11,0,0.0,0.0
V273,60,2019-10-09 07:04:43,1,2757,2637,0.956,0.4,456,273,71,344,183,84,267,8,0.0,0.04
V273,61,2019-10-09 07:24:43,1,2884,2718,0.942,0.4,83,61,6,67,22,8,30,0,0.0,0.0
V273,62,2019-10-09 07:44:43,1,3351,3080,0.919,0.4,101,65,23,88,36,9,45,0,0.0,0.0
V273,63,2019-10-09 08:04:43,1,3891,3603,0.926,0.5,568,374,143,517,194,81,275,4,0.0,0.06
V273,64,2019-10-09 08:24:43,1,2906,2995,1.031,0.4,348,185,60,245,163,35,198,0,0.0,0.09
V273,65,2019-10-09 08:44:43,1,2927,2713,0.927,0.4,49,31,3,34,18,7,25,0,0.02,0.0
V273,66,2019-10-09 09:04:43,1,2754,2598,0.943,0.4,149,82,17,99,67,28,95,0,0.0,0.0
V273,67,2019-10-09 09:24:43,1,3074,2858,0.93,0.4,648,398,120,518,250,68,318,10,0.0,0.08
V273,68,2019-10-09 09:44:43,1,3178,2620,0.825,0.4,40,18,0,18,22,1,23,0,0.0,0.0
V273,69,2019-10-09 10:04:43,1,4051,3326,0.821,0.5,343,203,72,275,140,58,198,0,0.0,-0.05
V273,70,2019-10-09 10:24:43,1,3982,3475,0.873,0.5,1571,1085,577,1662,486,227,713,96,0.1,0.0
V273,71,2019-10-09 10:44:43,1,3205,2541,0.793,0.4,187,90,10,100,97,21,118,0,0.0,0.0
V273,72,2019-10-09 11:04:43,1,3138,2487,0.793,0.4,39,12,0,12,27,4,31,0,0.0,0.0
V273,73,2019-10-09 11:24:43,1,4343,3717,0.856,0.6,492,265,120,385,227,86,313,26,0.0,0.1
V273,74,2019-10-09 11:44:43,1,3010,2655,0.882,0.4,1181,777,390,1167,404,190,594,35,0.0,0.03
V273,75,2019-10-09 12:04:43,1,3193,2547,0.798,0.4,25,19,0,19,6,1,7,0,0.0,0.0
V273,76,2019-10-09 12:24:43,1,3006,2419,0.805,0.4,26,13,0,13,13,7,20,0,0.0,0.0
V273,77,2019-10-09 12:44:43,1,3690,3387,0.918,0.5,699,437,130,567,262,84,346,2,0.0,0.12
V273,78,2019-10-09 13:04:43,1,3162,2820,0.892,0.4,29,16,6,22,13,3,16,0,0.0,0.0
V273,79,2019-10-09 13:24:43,1,2986,2552,0.855,0.4,17,7,1,8,10,0,10,0,0.0,0.0
V273,80,2019-10-09 13:44:43,1,3570,3117,0.873,0.5,324,177,83,260,147,41,188,2,0.0,0.12
V273,81,2019-10-09 14:04:43,1,3124,2839,0.909,0.4,541,256,50,306,285,53,338,2,0.0,0.0
V273,82,2019-10-09 14:24:43,1,3016,2690,0.892,0.4,20,8,0,8,12,2,14,0,0.0,0.0
V273,83,2019-10-09 14:44:43,1,3093,2926,0.946,0.4,766,436,131,567,330,91,421,15,0.1,0.05
V273,84,2019-10-09 15:04:43,1,3026,2584,0.854,0.4,25,16,4,20,9,0,9,0,0.02,0.0
V273,85,2019-10-09 15:24:43,1,2917,2482,0.851,0.4,68,40,10,50,28,9,37,0,0.0,0.0
V273,86,2019-10-09 15:44:43,1,3014,2506,0.831,0.4,65,42,18,60,23,5,28,0,0.0,0.0
V273,87,2019-10-09 16:04:43,1,3652,3757,1.029,0.5,1684,1054,540,1594,630,219,849,153,0.0,0.15
V273,88,2019-10-09 16:24:43,1,3166,2747,0.868,0.4,137,54,7,61,83,14,97,0,0.0,0.0
V273,89,2019-10-09 16:44:43,1,2950,2515,0.852,0.4,49,24,3,27,25,8,33,0,0.0,0.02
V273,90,2019-10-09 17:04:43,1,3360,3345,0.995,0.5,679,327,136,463,352,99,451,36,0.0,0.12
V273,91,2019-10-09 17:24:43,1,2955,2774,0.939,0.4,38,14,0,14,24,5,29,0,0.0,0.0
V273,92,2019-10-09 17:44:43,1,3247,2988,0.92,0.4,368,243,118,361,125,57,182,10,0.0,0.1
V273,93,2019-10-09 18:04:43,0,3343,3275,0.98,0.4,314,176,55,231,138,31,169,0,0.0,0.0
V273,94,2019-10-09 18:24:43,0,4496,4350,0.967,0.6,1916,1329,579,1908,587,227,814,62,0.0,0.08
V273,95,2019-10-09 18:44:43,0,4588,4484,0.977,0.6,2308,1480,823,2303,828,366,1194,420,0.04,0.13
V273,96,2019-10-09 19:04:43,0,3373,3284,0.973,0.5,1602,1005,457,1462,597,203,800,121,0.04,0.0
V273,97,2019-10-09 19:24:43,0,4434,4194,0.946,0.6,1380,887,538,1425,493,219,712,170,0.0,0.11
V273,98,2019-10-09 19:44:43,0,4601,4660,1.013,0.6,3345,2148,1337,3485,1197,655,1852,739,0.1,0.09
V273,99,2019-10-09 20:04:43,0,4280,4447,1.039,0.6,2982,1900,1081,2981,1082,597,1679,384,0.08,0.18
V273,100,2019-10-09 20:24:43,0,4036,4286,1.062,0.6,2379,1510,874,2384,869,424,1293,323,0.1,0.21
V273,101,2019-10-09 20:44:43,0,3356,3370,1.004,0.5,1571,999,577,1576,572,300,872,214,0.08,0.02
V273,102,2019-10-09 21:04:43,0,3950,3866,0.979,0.5,884,558,299,857,326,152,478,106,0.0,0.1
V273,103,2019-10-09 21:24:43,0,3870,3984,1.03,0.5,2004,1212,611,1823,792,393,1185,252,0.06,0.19
V273,104,2019-10-09 21:44:43,0,3151,3192,1.013,0.4,79,48,18,66,31,10,41,4,0.0,0.07
V273,105,2019-10-09 22:04:43,0,3058,3218,1.052,0.4,260,148,71,219,112,47,159,0,0.0,0.05
V273,106,2019-10-09 22:24:43,0,2839,3067,1.08,0.4,102,45,11,56,57,18,75,0,0.0,0.04
V273,107,2019-10-09 22:44:43,0,4248,4539,1.068,0.6,1427,921,480,1401,506,224,730,125,0.08,0.13
V273,108,2019-10-09 23:04:43,0,2936,3158,1.076,0.4,977,648,330,978,329,163,492,29,0.02,0.09
V273,109,2019-10-09 23:24:43,0,3016,3091,1.025,0.4,86,63,2,65,23,9,32,0,0.0,0.03
V273,110,2019-10-09 23:44:43,0,4032,4194,1.04,0.6,924,559,195,754,365,118,483,23,0.02,0.07
V273,111,2019-11-09 00:04:43,0,3367,3460,1.028,0.5,1450,888,464,1352,562,295,857,139,0.16,0.29
V273,112,2019-11-09 00:24:43,0,3229,3237,1.003,0.4,95,47,2,49,48,16,64,0,0.0,0.0
V273,113,2019-11-09 00:44:43,0,3732,3993,1.07,0.5,360,186,41,227,174,53,227,2,0.0,0.11
V273,114,2019-11-09 01:04:43,0,3704,4067,1.098,0.5,1709,1077,598,1675,632,339,971,118,0.16,0.2
V273,115,2019-11-09 01:24:43,0,3840,4228,1.101,0.5,2228,1433,840,2273,795,455,1250,230,0.18,0.22
V273,116,2019-11-09 01:44:43,0,4022,4194,1.043,0.5,2137,1346,761,2107,791,357,1148,103,0.1,0.03
V273,117,2019-11-09 02:04:43,0,3039,3190,1.05,0.4,74,52,9,61,22,9,31,0,0.0,0.03
V273,118,2019-11-09 02:24:43,0,3379,3276,0.969,0.5,161,90,18,108,71,25,96,0,0.0,0.0
V273,119,2019-11-09 02:44:43,0,2965,2875,0.97,0.4,88,52,4,56,36,7,43,0,0.0,0.0
V273,120,2019-11-09 03:04:43,0,3004,3039,1.012,0.4,192,153,19,172,39,17,56,0,0.0,0.0
V273,121,2019-11-09 03:24:43,0,4045,4104,1.015,0.5,1478,862,347,1209,616,235,851,29,0.04,0.18
V273,122,2019-11-09 03:44:43,0,3272,3253,0.994,0.4,284,162,48,210,122,17,139,0,0.0,0.07
V273,123,2019-11-09 04:04:43,0,3443,3404,0.989,0.5,235,147,13,160,88,19,107,0,0.0,0.0
V273,124,2019-11-09 04:24:43,0,3205,3268,1.02,0.4,1323,845,519,1364,478,216,694,142,0.04,0.18
V273,125,2019-11-09 04:44:43,0,3561,3506,0.984,0.5,69,40,19,59,29,8,37,0,0.0,0.0
V273,126,2019-11-09 05:04:43,0,4289,4411,1.029,0.6,2233,1379,783,2162,854,391,1245,174,0.12,0.17
V273,127,2019-11-09 05:24:43,0,3839,4156,1.083,0.5,2193,1391,790,2181,802,412,1214,159,0.14,0.11
V273,128,2019-11-09 05:44:43,0,3172,3094,0.975,0.4,113,72,8,80,41,3,44,0,0.0,0.0
V273,129,2019-11-09 06:04:43,1,3085,2859,0.927,0.4,79,34,10,44,45,18,63,0,0.0,0.0
V273,130,2019-11-09 06:24:43,1,3857,3448,0.894,0.5,191,98,12,110,93,28,121,0,0.0,0.04
V273,131,2019-11-09 06:44:43,1,3576,3496,0.978,0.5,1578,996,535,1531,582,224,806,110,0.0,0.07
V273,132,2019-11-09 07:04:43,1,2995,2825,0.943,0.4,188,125,79,204,63,41,104,3,0.0,0.0
V273,133,2019-11-09 07:24:43,1,2993,2553,0.853,0.4,91,15,3,18,76,6,82,0,0.0,0.0
V273,134,2019-11-09 07:44:43,1,3028,2580,0.852,0.4,159,74,18,92,85,29,114,0,0.0,0.0
V273,135,2019-11-09 08:04:43,1,2706,2285,0.844,0.4,176,69,12,81,107,29,136,0,0.02,0.0
V273,136,2019-11-09 08:24:43,1,3144,2536,0.807,0.4,44,13,6,19,31,11,42,0,0.0,0.0
V273,137,2019-11-09 08:44:43,1,3222,2596,0.806,0.4,80,38,12,50,42,9,51,0,0.0,0.0
V273,138,2019-11-09 09:04:43,1,2945,2387,0.81,0.4,94,33,6,39,61,14,75,0,0.0,0.0
V273,139,2019-11-09 09:24:43,1,3551,3245,0.914,0.5,663,414,116,530,249,96,345,0,0.0,0.1
V273,140,2019-11-09 09:44:43,1,3189,2713,0.851,0.4,25,11,4,15,14,5,19,0,0.0,0.0
V273,141,2019-11-09 10:04:43,1,3072,2568,0.836,0.4,43,19,6,25,24,7,31,0,0.0,0.0
V273,142,2019-11-09 10:24:43,1,4084,3653,0.894,0.5,572,363,161,524,209,79,288,26,0.0,0.04
V273,143,2019-11-09 10:44:43,1,3754,3613,0.962,0.5,2032,1348,863,2211,684,317,1001,186,0.12,0.09
V273,144,2019-11-09 11:04:43,1,3773,3497,0.927,0.5,691,405,150,555,286,106,392,4,0.0,-0.03
V273,145,2019-11-09 11:24:43,1,3048,2547,0.836,0.4,536,294,91,385,242,72,314,7,0.0,0.0
V273,146,2019-11-09 11:44:43,1,3165,2525,0.798,0.4,45,13,1,14,32,5,37,0,0.0,0.0
V273,147,2019-11-09 12:04:43,1,3129,2507,0.801,0.4,42,22,10,32,20,5,25,0,0.0,0.0
V273,148,2019-11-09 12:24:43,1,3053,2469,0.808,0.4,78,47,10,57,31,10,41,0,0.0,0.0
V273,149,2019-11-09 12:44:43,1,4081,3889,0.953,0.5,1586,1002,559,1561,584,263,847,146,0.04,0.18
V273,150,2019-11-09 13:04:43,1,3071,2856,0.93,0.4,303,152,11,163,151,23,174,0,0.0,0.0
V273,151,2019-11-09 13:24:43,1,3014,2625,0.871,0.4,30,18,2,20,12,4,16,0,0.0,0.0
V273,152,2019-11-09 13:44:43,1,2959,2579,0.871,0.4,156,111,7,118,45,15,60,0,0.0,0.0
V273,153,2019-11-09 14:04:43,1,2709,2632,0.972,0.4,201,94,33,127,107,42,149,0,0.02,0.18
V273,154,2019-11-09 14:24:43,1,2918,2713,0.93,0.4,40,24,4,28,16,3,19,0,0.0,0.0
V273,155,2019-11-09 14:44:43,1,3749,3614,0.964,0.5,234,153,45,198,81,37,118,4,0.0,0.05
V273,156,2019-11-09 15:04:43,1,3224,3145,0.975,0.4,808,493,70,563,315,52,367,0,0.0,0.04
V273,157,2019-11-09 15:24:43,1,3044,2698,0.886,0.4,14,6,0,6,8,3,11,0,0.0,0.0
V273,158,2019-11-09 15:44:43,1,2949,2593,0.879,0.4,29,13,6,19,16,4,20,0,0.0,0.02
V273,159,2019-11-09 16:04:43,1,3012,2605,0.865,0.4,110,53,20,73,57,19,76,0,0.0,0.0
V273,160,2019-11-09 16:24:43,1,3975,3913,0.984,0.5,1169,642,255,897,527,166,693,32,0.06,0.12
V273,161,2019-11-09 16:44:43,1,2954,2802,0.948,0.4,171,89,13,102,82,21,103,0,0.0,0.0
V273,162,2019-11-09 17:04:43,1,3629,3352,0.924,0.5,290,176,8,184,114,27,141,0,0.0,0.0
V273,163,2019-11-09 17:24:43,1,3098,2886,0.932,0.4,594,379,128,507,215,87,302,16,0.0,0.1
V273,164,2019-11-09 17:44:43,1,3376,2996,0.888,0.4,38,28,4,32,10,6,16,0,0.0,0.0
V273,165,2019-11-09 18:04:43,0,3916,4066,1.038,0.5,515,298,72,370,217,65,282,0,0.0,0.1
V273,166,2019-11-09 18:24:43,0,3142,3043,0.968,0.4,1393,884,464,1348,509,216,725,141,0.0,0.05
V273,167,2019-11-09 18:44:43,0,4094,3943,0.963,0.5,1316,782,372,1154,534,191,725,19,0.0,0.12
V273,168,2019-11-09 19:04:43,0,3764,4047,1.075,0.5,2648,1637,967,2604,1011,494,1505,289,0.1,0.26
V273,169,2019-11-09 19:24:43,0,3817,4072,1.067,0.5,2727,1755,978,2733,972,492,1464,460,0.06,0.13
V273,170,2019-11-09 19:44:43,0,3295,3478,1.055,0.5,605,448,191,639,157,82,239,1,0.0,0.0
V273,171,2019-11-09 20:04:43,0,3609,3712,1.029,0.5,265,138,17,155,127,26,153,0,0.0,0.0
V273,172,2019-11-09 20:24:43,0,2925,3115,1.065,0.4,1236,777,478,1255,459,239,698,114,0.08,0.17
V273,173,2019-11-09 20:44:43,0,3950,4324,1.095,0.5,1162,763,456,1219,399,187,586,84,0.02,0.13
V273,174,2019-11-09 21:04:43,0,4145,4396,1.061,0.6,2339,1493,776,2269,846,401,1247,73,0.08,0.12
V273,175,2019-11-09 21:24:43,0,3458,3387,0.979,0.5,147,83,17,100,64,26,90,0,0.0,0.0
V273,176,2019-11-09 21:44:43,0,4094,4306,1.052,0.6,1415,807,415,1222,608,257,865,92,0.06,0.25
V273,177,2019-11-09 22:04:43,0,3002,3230,1.076,0.4,685,444,215,659,241,119,360,12,0.08,0.18
V273,178,2019-11-09 22:24:43,0,3470,3684,1.062,0.5,313,201,11,212,112,42,154,0,0.0,0.0
V273,179,2019-11-09 22:44:43,0,4016,4299,1.071,0.6,2071,1329,699,2028,742,313,1055,247,0.14,0.26
V273,180,2019-11-09 23:04:43,0,4107,4384,1.067,0.6,2894,1736,1037,2773,1158,612,1770,361,0.12,0.09
V273,181,2019-11-09 23:24:43,0,2943,3278,1.114,0.4,82,60,2,62,22,6,28,0,0.0,0.0
V273,182,2019-11-09 23:44:43,0,3980,4234,1.064,0.5,1400,846,475,1321,554,253,807,59,0.08,0.21
V273,183,2019-12-09 00:04:43,0,3975,4289,1.079,0.5,2874,1770,1051,2821,1104,589,1693,256,0.18,0.12
V273,184,2019-12-09 00:24:43,0,3066,3175,1.036,0.4,954,557,212,769,397,151,548,48,0.0,0.0
V273,185,2019-12-09 00:44:43,0,3226,3326,1.031,0.4,30,18,1,19,12,6,18,0,0.0,0.0
V273,186,2019-12-09 01:04:43,0,3776,3959,1.048,0.5,1233,780,404,1184,453,203,656,32,0.02,0.15
V273,187,2019-12-09 01:24:43,0,3723,3943,1.059,0.5,1329,731,358,1089,598,261,859,68,0.12,0.1
V273,188,2019-12-09 01:44:43,0,3229,3253,1.008,0.4,37,23,1,24,14,4,18,0,0.02,0.0
V273,189,2019-12-09 02:04:43,0,3659,3837,1.049,0.5,1151,719,393,1112,432,206,638,45,0.0,0.14
V273,190,2019-12-09 02:24:43,0,3228,3287,1.019,0.4,485,261,52,313,224,31,255,0,0.0,0.0
V273,191,2019-12-09 02:44:43,0,3416,3301,0.966,0.5,78,51,9,60,27,9,36,0,0.0,0.03
V273,192,2019-12-09 03:04:43,0,3503,3564,1.017,0.5,743,414,128,542,329,98,427,5,0.0,0.15
V273,193,2019-12-09 03:24:43,0,3738,3958,1.059,0.5,479,269,79,348,210,57,267,3,0.0,0.0
V273,194,2019-12-09 03:44:43,0,4193,4275,1.02,0.6,2386,1577,957,2534,809,385,1194,149,0.16,0.25
V273,195,2019-12-09 04:04:43,0,2884,3036,1.053,0.4,1925,1088,636,1724,837,447,1284,271,0.1,0.03
V273,196,2019-12-09 04:24:43,0,3319,3244,0.977,0.4,66,45,8,53,21,8,29,0,0.0,0.0
V273,197,2019-12-09 04:44:43,0,4253,4454,1.047,0.6,2776,1707,1102,2809,1069,557,1626,295,0.08,0.18
V273,198,2019-12-09 05:04:43,0,4246,4285,1.009,0.6,2843,1827,1077,2904,1016,499,1515,234,0.14,0.03
V273,199,2019-12-09 05:24:43,0,4016,4060,1.011,0.5,1612,975,444,1419,637,285,922,66,0.08,0.06
V273,200,2019-12-09 05:44:43,0,2808,2648,0.943,0.4,17,6,3,9,11,1,12,0,0.0,0.03
V273,201,2019-12-09 06:04:43,1,3233,2764,0.855,0.4,41,19,5,24,22,10,32,0,0.0,0.0
V273,202,2019-12-09 06:24:43,1,2913,2472,0.849,0.4,71,41,6,47,30,15,45,0,0.0,0.0
V273,203,2019-12-09 06:44:43,1,3486,3090,0.886,0.5,502,333,105,438,169,71,240,0,0.0,0.0
V273,204,2019-12-09 07:04:43,1,3142,2658,0.846,0.4,55,37,4,41,18,7,25,0,0.0,0.0
V273,205,2019-12-09 07:24:43,1,3001,2470,0.823,0.4,29,18,2,20,11,3,14,0,0.0,0.0
V273,206,2019-12-09 07:44:43,1,2621,2166,0.827,0.3,210,106,13,119,104,35,139,0,0.0,0.0
V273,207,2019-12-09 08:04:43,1,3080,2558,0.831,0.4,25,12,0,12,13,4,17,0,0.0,0.0
V273,208,2019-12-09 08:24:43,1,2731,2200,0.806,0.4,52,26,8,34,26,6,32,0,0.0,0.0
V273,209,2019-12-09 08:44:43,1,3747,3091,0.825,0.5,1136,621,310,931,515,176,691,10,0.0,0.0
V273,210,2019-12-09 09:04:43,1,3128,2909,0.93,0.4,696,432,193,625,264,90,354,19,0.0,0.09
V273,211,2019-12-09 09:24:43,1,2859,2434,0.851,0.4,22,10,0,10,12,0,12,0,0.02,0.0
V273,212,2019-12-09 09:44:43,1,2946,2491,0.846,0.4,53,17,3,20,36,16,52,0,0.0,0.0
V273,213,2019-12-09 10:04:43,1,2978,2421,0.813,0.4,25,5,0,5,20,10,30,0,0.0,0.0
V273,214,2019-12-09 10:24:43,1,2759,2293,0.831,0.4,321,176,43,219,145,36,181,1,0.0,0.0
V273,215,2019-12-09 10:44:43,1,2741,2189,0.798,0.4,27,16,0,16,11,0,11,0,0.0,0.0
V273,216,2019-12-09 11:04:43,1,3915,3039,0.776,0.5,318,181,32,213,137,53,190,0,0.0,-0.05
V273,217,2019-12-09 11:24:43,1,3941,3760,0.954,0.5,1930,1215,635,1850,715,334,1049,75,0.08,0.15
V273,218,2019-12-09 11:44:43,1,3209,3014,0.939,0.4,849,354,63,417,495,117,612,0,0.0,0.06
V273,219,2019-12-09 12:04:43,1,3034,2683,0.884,0.4,60,38,0,38,22,6,28,0,0.0,0.0
V273,220,2019-12-09 12:24:43,1,3128,2718,0.869,0.4,56,32,5,37,24,6,30,0,0.0,0.0
V273,221,2019-12-09 12:44:43,1,3704,3429,0.926,0.5,474,224,67,291,250,44,294,0,0.0,0.09
V273,222,2019-12-09 13:04:43,1,3196,2898,0.907,0.4,200,123,6,129,77,15,92,0,0.0,0.0
V273,223,2019-12-09 13:24:43,1,2961,2700,0.912,0.4,66,30,9,39,36,7,43,0,0.0,0.02
V273,224,2019-12-09 13:44:43,1,2972,2857,0.961,0.4,134,67,15,82,67,29,96,0,0.0,0.07
V273,225,2019-12-09 14:04:43,1,2892,2663,0.921,0.4,65,32,9,41,33,15,48,0,0.0,0.0
V273,226,2019-12-09 14:24:43,1,3996,3675,0.92,0.5,1358,804,388,1192,554,233,787,121,0.02,0.19
V273,227,2019-12-09 14:44:43,1,2964,2982,1.006,0.4,654,401,164,565,253,95,348,32,0.06,0.0
V273,228,2019-12-09 15:04:43,1,2906,2616,0.9,0.4,28,18,1,19,10,6,16,0,0.0,0.02
V273,229,2019-12-09 15:24:43,1,3325,3085,0.928,0.4,269,153,47,200,116,36,152,3,0.0,0.11
V273,230,2019-12-09 15:44:43,1,3041,2961,0.973,0.4,563,256,32,288,307,57,364,0,0.0,0.0
V273,231,2019-12-09 16:04:43,1,2842,2639,0.928,0.4,142,136,2,138,6,0,6,0,0.0,0.0
V273,232,2019-12-09 16:24:43,1,3066,2714,0.885,0.4,108,48,21,69,60,21,81,0,0.0,0.0
V273,233,2019-12-09 16:44:43,1,3580,3523,0.984,0.5,854,554,259,813,300,147,447,6,0.0,0.21
V273,234,2019-12-09 17:04:43,1,3172,3193,1.007,0.4,395,118,18,136,277,53,330,0,0.0,0.0
V273,235,2019-12-09 17:24:43,1,3049,2921,0.958,0.4,30,4,1,5,26,6,32,0,0.0,0.0
V273,236,2019-12-09 17:44:43,1,3609,3489,0.967,0.5,668,392,107,499,276,69,345,4,0.0,0.14
V273,237,2019-12-09 18:04:43,0,3474,3565,1.026,0.5,122,74,9,83,48,11,59,0,0.0,0.0
V273,238,2019-12-09 18:24:43,0,3721,3579,0.962,0.5,1955,1223,667,1890,732,329,1061,35,0.0,0.0
V273,239,2019-12-09 18:44:43,0,3005,2408,0.801,0.4,799,433,162,595,366,118,484,8,0.0,0.0
V273,240,2019-12-09 19:04:43,0,4208,3484,0.828,0.5,4045,2733,1666,4399,1312,744,2056,241,0.02,0.0
V273,241,2019-12-09 19:24:43,0,3551,2967,0.835,0.5,2721,1662,959,2621,1059,463,1522,317,0.0,-0.03
V273,242,2019-12-09 19:44:43,0,3974,3256,0.819,0.5,1123,785,450,1235,338,164,502,57,0.0,0.0
V273,243,2019-12-09 20:04:43,0,3904,3162,0.81,0.5,3732,2545,1632,4177,1187,638,1825,520,0.02,0.0
V273,244,2019-12-09 20:24:43,0,3858,3181,0.825,0.5,2391,1514,813,2327,877,452,1329,192,0.0,0.0
V273,245,2019-12-09 20:44:43,0,4466,3580,0.802,0.6,2885,1943,1174,3117,942,458,1400,684,0.02,0.0
V273,246,2019-12-09 21:04:43,0,3766,3099,0.823,0.5,3612,2413,1476,3889,1199,581,1780,883,0.0,0.0
V273,247,2019-12-09 21:24:43,0,2006,1580,0.788,0.3,1291,865,372,1237,426,165,591,19,0.0,0.0
V273,248,2019-12-09 21:44:43,0,3955,3166,0.801,0.5,2157,1491,930,2421,666,362,1028,266,0.0,0.0
V273,249,2019-12-09 22:04:43,0,3698,3047,0.824,0.5,2670,1778,987,2765,892,443,1335,483,0.0,0.0
V273,250,2019-12-09 22:24:43,0,3006,2329,0.775,0.4,2494,1718,953,2671,776,368,1144,414,0.0,0.0
V273,251,2019-12-09 22:44:43,0,2257,1740,0.771,0.3,31,15,2,17,16,2,18,0,0.0,0.0
V273,252,2019-12-09 23:04:43,0,4037,3362,0.833,0.5,676,434,172,606,242,97,339,7,0.0,0.0
V273,253,2019-12-09 23:24:43,0,3963,3124,0.788,0.5,3024,2056,1206,3262,968,553,1521,487,0.0,0.0
V273,254,2019-12-09 23:44:43,0,3315,2638,0.796,0.4,1851,1058,507,1565,793,344,1137,290,0.0,0.0
V273,255,2019-09-13 00:04:43,0,2725,2155,0.791,0.3,1421,819,401,1220,602,204,806,80,0.0,0.0
V273,256,2019-09-13 00:24:43,0,1588,1237,0.779,0.2,49,44,0,44,5,1,6,0,0.0,0.0
V273,257,2019-09-13 00:44:43,0,3262,2550,0.782,0.4,289,206,72,278,83,17,100,2,0.0,0.0
V273,258,2019-09-13 01:04:43,0,2345,1794,0.765,0.3,904,609,362,971,295,121,416,57,0.02,0.0
V273,259,2019-09-13 01:24:43,0,2034,1621,0.797,0.3,652,401,195,596,251,95,346,59,0.0,0.0
V273,260,2019-09-13 01:44:43,0,1333,1076,0.808,0.2,78,10,2,12,68,11,79,0,0.0,0.0
V273,261,2019-09-13 02:04:43,0,2113,1579,0.747,0.3,61,36,0,36,25,0,25,0,0.0,0.0
V273,262,2019-09-13 02:24:43,0,4431,3565,0.804,0.6,837,571,262,833,266,85,351,45,0.0,0.0
V273,263,2019-09-13 02:44:43,0,3956,3190,0.807,0.5,2419,1479,895,2374,940,451,1391,627,0.1,0.0
V273,264,2019-09-13 03:04:43,0,3076,2425,0.788,0.4,2457,1649,962,2611,808,444,1252,399,0.06,-0.02
V273,265,2019-09-13 03:24:43,0,1523,1181,0.775,0.2,624,315,74,389,309,58,367,0,0.0,0.0
V273,266,2019-09-13 03:44:43,0,1485,1152,0.776,0.2,9,2,0,2,7,1,8,0,0.0,0.02
V273,267,2019-09-13 04:04:43,0,1129,846,0.749,0.1,20,15,3,18,5,0,5,0,0.0,0.0
V273,268,2019-09-13 04:24:43,0,2414,1918,0.795,0.3,114,83,20,103,31,2,33,0,0.0,0.0
V273,269,2019-09-13 04:44:43,0,2266,1730,0.764,0.3,841,574,310,884,267,115,382,64,0.0,0.0
V273,270,2019-09-13 05:04:43,0,1937,1477,0.762,0.2,19,14,0,14,5,0,5,0,0.0,-0.02
V273,271,2019-09-13 05:24:43,0,1298,1003,0.773,0.2,2,2,0,2,0,0,0,0,0.0,0.0
V273,272,2019-09-13 05:44:43,0,932,707,0.759,0.1,10,5,3,8,5,1,6,0,0.0,0.0
V273,273,2019-09-13 06:04:43,1,761,584,0.767,0.1,9,0,0,0,9,0,9,0,0.0,0.0
V273,274,2019-09-13 06:24:43,1,716,549,0.766,0.1,8,2,1,3,6,1,7,0,0.0,0.0
V273,275,2019-09-13 06:44:43,1,755,554,0.734,0.1,32,16,0,16,16,0,16,0,0.0,0.0
V273,276,2019-09-13 07:04:43,1,5070,4220,0.832,0.7,195,108,16,124,87,22,109,0,0.0,0.02
V273,277,2019-09-13 07:24:43,1,4258,3904,0.917,0.6,1784,1131,619,1750,653,289,942,67,0.3,0.3
V273,278,2019-09-13 07:44:43,1,3590,3573,0.995,0.5,1142,760,320,1080,382,168,550,17,0.26,0.38
V273,279,2019-09-13 08:04:43,1,3457,3438,0.995,0.5,1541,1057,584,1641,484,232,716,24,0.22,0.33
V273,280,2019-09-13 08:24:43,1,2926,2904,0.993,0.4,598,318,128,446,280,79,359,5,0.08,0.14
V273,281,2019-09-13 08:44:43,1,3683,3773,1.024,0.5,261,126,19,145,135,32,167,21,0.0,0.0
V273,282,2019-09-13 09:04:43,1,3093,3236,1.046,0.4,1195,664,276,940,531,197,728,9,0.16,0.26
V273,283,2019-09-13 09:24:43,1,2940,3088,1.05,0.4,146,126,21,147,20,1,21,0,0.0,0.0
V273,284,2019-09-13 09:44:43,1,3278,3381,1.031,0.4,1166,730,416,1146,436,194,630,23,0.08,0.07
V273,285,2019-09-13 10:04:43,1,2468,2614,1.059,0.3,613,418,198,616,195,91,286,0,0.08,0.1
V273,286,2019-09-13 10:24:43,1,2587,2747,1.062,0.4,69,40,7,47,29,7,36,0,0.0,0.0
V273,287,2019-09-13 10:44:43,1,2509,2711,1.08,0.3,43,22,9,31,21,6,27,0,0.0,-0.03
V273,288,2019-09-13 11:04:43,1,2670,2880,1.078,0.4,232,136,70,206,96,45,141,2,0.02,0.03
V273,289,2019-09-13 11:24:43,1,2458,2661,1.082,0.3,918,545,218,763,373,98,471,0,0.02,0.37
V274,1,2019-09-09 11:26:43,1,2984,1984,0.665,0.4,39,12,5,17,27,7,34,0,0.0,-0.04
V274,2,2019-09-09 11:46:43,1,2720,2073,0.762,0.3,41,31,2,33,10,0,10,0,0.0,0.1
V274,3,2019-09-09 12:06:43,1,2527,1897,0.751,0.3,511,266,121,387,245,97,342,0,0.0,0.01
V274,4,2019-09-09 12:26:43,1,2571,1918,0.746,0.3,221,95,33,128,126,30,156,0,0.0,-0.01
V274,5,2019-09-09 12:46:43,1,2451,1918,0.782,0.3,54,32,3,35,22,5,27,0,0.0,0.0
V274,6,2019-09-09 13:06:43,1,2582,1993,0.772,0.3,60,47,0,47,13,1,14,0,0.0,0.0
V274,7,2019-09-09 13:26:43,1,2582,1907,0.739,0.3,174,89,20,109,85,25,110,0,0.0,0.0
V274,8,2019-09-09 13:46:43,1,2529,1912,0.756,0.3,48,29,3,32,19,7,26,0,0.0,-0.03
V274,9,2019-09-09 14:06:43,1,2764,1889,0.683,0.3,39,13,0,13,26,2,28,0,0.0,0.0
V274,10,2019-09-09 14:26:43,1,3739,2999,0.802,0.5,486,206,72,278,280,85,365,0,0.0,0.02
V274,11,2019-09-09 14:46:43,1,2458,1789,0.728,0.3,590,232,69,301,358,80,438,0,0.0,0.0
V274,12,2019-09-09 15:06:43,1,2574,1998,0.776,0.3,28,9,1,10,19,2,21,0,0.0,0.0
V274,13,2019-09-09 15:26:43,1,2540,1832,0.721,0.3,53,37,2,39,16,6,22,0,0.0,0.0
V274,14,2019-09-09 15:46:43,1,2627,2003,0.762,0.3,97,53,3,56,44,6,50,0,0.0,0.0
V274,15,2019-09-09 16:06:43,1,2886,2006,0.695,0.4,128,16,5,21,112,18,130,0,0.0,0.0
V274,16,2019-09-09 16:26:43,1,2719,2071,0.762,0.3,447,204,54,258,243,78,321,0,0.0,0.09
V274,17,2019-09-09 16:46:43,1,2878,2391,0.831,0.4,100,31,1,32,69,9,78,0,0.0,0.0
V274,18,2019-09-09 17:06:43,1,3542,3035,0.857,0.5,254,111,11,122,143,31,174,0,0.0,0.0
V274,19,2019-09-09 17:26:43,1,2712,2368,0.873,0.3,359,153,26,179,206,33,239,0,0.0,0.03
V274,20,2019-09-09 17:46:43,1,3454,3156,0.914,0.4,1270,562,243,805,708,164,872,9,0.0,0.08
V274,21,2019-09-09 18:06:43,0,2599,2221,0.855,0.3,60,4,0,4,56,2,58,0,0.0,0.0
V274,22,2019-09-09 18:26:43,0,3759,3290,0.875,0.5,997,417,125,542,580,124,704,2,0.0,0.07
V274,23,2019-09-09 18:46:43,0,3296,3100,0.94,0.4,361,187,51,238,174,54,228,0,0.0,0.02
V274,24,2019-09-09 19:06:43,0,3715,3765,1.013,0.5,1118,528,252,780,590,182,772,30,0.0,0.1
V274,25,2019-09-09 19:26:43,0,3493,3649,1.045,0.5,1224,617,327,944,607,241,848,25,0.0,0.07
V274,26,2019-09-09 19:46:43,0,3235,3365,1.04,0.4,642,318,133,451,324,128,452,9,0.02,0.15
V274,27,2019-09-09 20:06:43,0,2866,2664,0.929,0.4,952,542,283,825,410,162,572,7,0.02,0.11
V274,28,2019-09-09 20:26:43,0,3842,3849,1.002,0.5,1013,574,291,865,439,197,636,6,0.0,0.14
V274,29,2019-09-09 20:46:43,0,3544,3742,1.056,0.5,1607,919,519,1438,688,258,946,8,0.06,0.06
V274,30,2019-09-09 21:06:43,0,3542,3577,1.01,0.5,1981,1115,661,1776,866,391,1257,27,0.04,0.24
V274,31,2019-09-09 21:26:43,0,2607,2697,1.035,0.3,267,70,15,85,197,22,219,0,0.0,0.0
V274,32,2019-09-09 21:46:43,0,3697,3445,0.932,0.5,494,302,153,455,192,62,254,3,0.08,0.06
V274,33,2019-09-09 22:06:43,0,3641,3283,0.902,0.5,1135,569,256,825,566,167,733,2,0.0,0.07
V274,34,2019-09-09 22:26:43,0,2718,2658,0.978,0.4,519,192,76,268,327,122,449,0,0.0,0.11
V274,35,2019-09-09 22:46:43,0,2411,2545,1.056,0.3,64,42,3,45,22,2,24,0,0.0,0.0
V274,36,2019-09-09 23:06:43,0,2599,2586,0.995,0.3,118,77,12,89,41,7,48,0,0.0,0.01
V274,37,2019-09-09 23:26:43,0,2821,2561,0.908,0.4,63,21,4,25,42,17,59,0,0.0,0.0
V274,38,2019-09-09 23:46:43,0,2535,2448,0.966,0.3,956,444,180,624,512,144,656,7,0.0,0.09
V274,39,2019-10-09 00:06:43,0,3047,3240,1.063,0.4,983,557,312,869,426,174,600,6,0.14,0.28
V274,40,2019-10-09 00:26:43,0,2538,2563,1.01,0.3,47,20,3,23,27,4,31,0,0.0,0.03
V274,41,2019-10-09 00:46:43,0,2632,2627,0.998,0.3,112,29,4,33,83,8,91,0,0.0,0.0
V274,42,2019-10-09 01:06:43,0,2820,3134,1.111,0.4,711,314,128,442,397,143,540,10,0.06,0.14
V274,43,2019-10-09 01:26:43,0,2929,3108,1.061,0.4,194,72,22,94,122,35,157,0,0.0,0.0
V274,44,2019-10-09 01:46:43,0,2709,2637,0.973,0.4,391,189,76,265,202,63,265,0,0.08,0.09
V274,45,2019-10-09 02:06:43,0,2454,2481,1.011,0.3,101,45,11,56,56,20,76,0,0.0,0.0
V274,46,2019-10-09 02:26:43,0,3370,3566,1.058,0.5,598,307,47,354,291,64,355,0,0.0,0.0
V274,47,2019-10-09 02:46:43,0,4028,3888,0.965,0.5,1362,745,400,1145,617,244,861,14,0.12,0.32
V274,48,2019-10-09 03:06:43,0,3466,3038,0.876,0.4,767,335,140,475,432,139,571,6,0.08,0.12
V274,49,2019-10-09 03:26:43,0,3549,3782,1.066,0.5,496,212,75,287,284,72,356,0,0.0,0.04
V274,50,2019-10-09 03:46:43,0,2702,2615,0.968,0.4,614,212,75,287,402,120,522,1,0.06,0.13
V274,51,2019-10-09 04:06:43,0,3336,3457,1.036,0.4,330,162,42,204,168,38,206,4,0.0,0.0
V274,52,2019-10-09 04:26:43,0,2536,2324,0.917,0.3,223,77,24,101,146,35,181,0,0.0,-0.03
V274,53,2019-10-09 04:46:43,0,2822,2876,1.019,0.4,733,321,116,437,412,153,565,1,0.0,0.2
V274,54,2019-10-09 05:06:43,0,2709,2707,0.999,0.4,76,35,5,40,41,8,49,0,0.0,0.0
V274,55,2019-10-09 05:26:43,0,3476,3365,0.968,0.5,265,168,35,203,97,19,116,0,0.02,0.0
V274,56,2019-10-09 05:46:43,0,3576,3881,1.085,0.5,1614,930,530,1460,684,276,960,51,0.14,0.29
V274,57,2019-10-09 06:06:43,1,3030,3426,1.131,0.4,1588,930,524,1454,658,278,936,25,0.08,0.2
V274,58,2019-10-09 06:26:43,1,2559,2604,1.018,0.3,164,51,8,59,113,23,136,0,0.0,0.0
V274,59,2019-10-09 06:46:43,1,3476,3641,1.047,0.5,340,175,25,200,165,36,201,0,0.0,0.0
V274,60,2019-10-09 07:06:43,1,2621,2551,0.974,0.3,155,86,9,95,69,20,89,0,0.0,0.0
V274,61,2019-10-09 07:26:43,1,3789,3713,0.98,0.5,349,163,63,226,186,59,245,2,0.0,0.0
V274,62,2019-10-09 07:46:43,1,3409,3487,1.023,0.5,1144,579,260,839,565,208,773,6,0.1,0.12
V274,63,2019-10-09 08:06:43,1,2351,2385,1.014,0.3,640,301,82,383,339,90,429,0,0.04,0.05
V274,64,2019-10-09 08:26:43,1,2766,2710,0.98,0.4,75,24,5,29,51,13,64,0,0.0,0.0
V274,65,2019-10-09 08:46:43,1,2747,2422,0.882,0.4,82,53,14,67,29,10,39,0,0.0,-0.11
V274,66,2019-10-09 09:06:43,1,3143,2952,0.939,0.4,575,314,143,457,261,68,329,5,0.0,0.3
V274,67,2019-10-09 09:26:43,1,2922,2687,0.92,0.4,695,281,79,360,414,126,540,0,0.04,0.0
V274,68,2019-10-09 09:46:43,1,2799,2451,0.876,0.4,81,61,1,62,20,1,21,0,0.0,0.0
V274,69,2019-10-09 10:06:43,1,3827,3103,0.811,0.5,455,236,81,317,219,108,327,1,0.02,0.0
V274,70,2019-10-09 10:26:43,1,2203,1959,0.889,0.3,533,257,31,288,276,64,340,0,0.0,0.0
V274,71,2019-10-09 10:46:43,1,2812,2247,0.799,0.4,58,25,5,30,33,6,39,0,0.0,0.0
V274,72,2019-10-09 11:06:43,1,3409,3001,0.88,0.4,480,183,63,246,297,83,380,0,0.0,0.13
V274,73,2019-10-09 11:26:43,1,2741,2372,0.865,0.4,879,432,79,511,447,82,529,0,0.0,0.0
V274,74,2019-10-09 11:46:43,1,2302,2011,0.874,0.3,44,28,3,31,16,3,19,0,0.0,0.0
V274,75,2019-10-09 12:06:43,1,2787,2347,0.842,0.4,80,53,5,58,27,17,44,0,0.0,0.0
V274,76,2019-10-09 12:26:43,1,3526,3370,0.956,0.5,1005,478,225,703,527,168,695,1,0.0,0.12
V274,77,2019-10-09 12:46:43,1,2610,2476,0.949,0.3,814,423,52,475,391,102,493,0,0.0,0.0
V274,78,2019-10-09 13:06:43,1,2597,2254,0.868,0.3,85,36,8,44,49,7,56,0,0.0,0.0
V274,79,2019-10-09 13:26:43,1,2631,2224,0.845,0.3,129,88,7,95,41,12,53,0,0.0,0.0
V274,80,2019-10-09 13:46:43,1,3449,2991,0.867,0.4,419,188,54,242,231,89,320,0,0.06,0.07
V274,81,2019-10-09 14:06:43,1,2759,2394,0.868,0.4,65,35,13,48,30,6,36,0,0.0,0.0
V274,82,2019-10-09 14:26:43,1,2748,2330,0.848,0.4,66,32,12,44,34,5,39,0,0.0,0.02
V274,83,2019-10-09 14:46:43,1,3667,3302,0.9,0.5,397,168,32,200,229,43,272,0,0.0,0.05
V274,84,2019-10-09 15:06:43,1,2771,2733,0.986,0.4,876,400,91,491,476,111,587,0,0.02,0.11
V274,85,2019-10-09 15:26:43,1,2597,2397,0.923,0.3,38,13,4,17,25,1,26,0,0.0,0.0
V274,86,2019-10-09 15:46:43,1,2740,2420,0.883,0.4,57,33,3,36,24,3,27,0,0.0,0.0
V274,87,2019-10-09 16:06:43,1,2691,2423,0.9,0.3,119,74,20,94,45,15,60,0,0.0,0.0
V274,88,2019-10-09 16:26:43,1,2963,2893,0.977,0.4,1025,547,155,702,478,133,611,0,0.02,0.09
V274,89,2019-10-09 16:46:43,1,2706,2400,0.887,0.3,41,30,3,33,11,3,14,0,0.0,0.02
V274,90,2019-10-09 17:06:43,1,3190,2973,0.932,0.4,461,169,41,210,292,60,352,0,0.0,0.0
V274,91,2019-10-09 17:26:43,1,2478,2334,0.942,0.3,102,47,9,56,55,16,71,0,0.0,0.08
V274,92,2019-10-09 17:46:43,1,3269,3169,0.969,0.4,628,274,66,340,354,88,442,0,0.0,0.07
V274,93,2019-10-09 18:06:43,0,3324,3215,0.967,0.4,1718,922,369,1291,796,207,1003,38,0.04,0.04
V274,94,2019-10-09 18:26:43,0,3887,3638,0.936,0.5,511,206,45,251,305,96,401,0,0.0,0.0
V274,95,2019-10-09 18:46:43,0,4152,3898,0.939,0.5,2275,1327,764,2091,948,432,1380,140,0.04,0.13
V274,96,2019-10-09 19:06:43,0,3281,3394,1.034,0.4,1393,832,396,1228,561,220,781,96,0.08,0.23
V274,97,2019-10-09 19:26:43,0,2813,2894,1.029,0.4,937,386,121,507,551,97,648,7,0.0,0.11
V274,98,2019-10-09 19:46:43,0,3959,4148,1.048,0.5,1085,638,369,1007,447,167,614,50,0.1,0.07
V274,99,2019-10-09 20:06:43,0,2765,2831,1.024,0.4,1458,835,403,1238,623,226,849,50,0.0,0.04
V274,100,2019-10-09 20:26:43,0,2901,2925,1.009,0.4,157,83,9,92,74,6,80,0,0.0,0.0
V274,101,2019-10-09 20:46:43,0,3672,3746,1.02,0.5,1851,950,504,1454,901,373,1274,87,0.02,0.19
V274,102,2019-10-09 21:06:43,0,3899,4129,1.059,0.5,2112,1184,458,1642,928,386,1314,56,0.08,0.12
V274,103,2019-10-09 21:26:43,0,2730,2734,1.001,0.4,932,478,161,639,454,136,590,18,0.04,0.12
V274,104,2019-10-09 21:46:43,0,2901,2937,1.012,0.4,101,73,8,81,28,6,34,0,0.0,0.02
V274,105,2019-10-09 22:06:43,0,2718,2695,0.991,0.4,331,199,35,234,132,56,188,0,0.0,0.0
V274,106,2019-10-09 22:26:43,0,4069,4227,1.039,0.5,787,397,175,572,390,135,525,35,0.0,0.0
V274,107,2019-10-09 22:46:43,0,3314,3468,1.046,0.4,1398,735,306,1041,663,262,925,51,0.1,0.25
V274,108,2019-10-09 23:06:43,0,2729,2858,1.048,0.4,270,145,32,177,125,38,163,0,0.0,0.09
V274,109,2019-10-09 23:26:43,0,2876,2962,1.03,0.4,60,33,2,35,27,8,35,0,0.0,0.0
V274,110,2019-10-09 23:46:43,0,4062,4218,1.038,0.5,764,449,145,594,315,93,408,21,0.0,0.0
V274,111,2019-11-09 00:06:43,0,3519,3652,1.038,0.5,1648,836,370,1206,812,365,1177,56,0.04,0.27
V274,112,2019-11-09 00:26:43,0,2822,2814,0.997,0.4,417,224,82,306,193,63,256,3,0.08,0.16
V274,113,2019-11-09 00:46:43,0,3042,3063,1.007,0.4,403,203,35,238,200,36,236,5,0.0,0.0
V274,114,2019-11-09 01:06:43,0,3497,3823,1.093,0.5,559,311,152,463,248,99,347,9,0.0,0.07
V274,115,2019-11-09 01:26:43,0,3514,3947,1.123,0.5,2053,1196,574,1770,857,379,1236,51,0.12,0.18
V274,116,2019-11-09 01:46:43,0,3772,3919,1.039,0.5,2413,1423,743,2166,990,455,1445,74,0.16,0.22
V274,117,2019-11-09 02:06:43,0,2777,2865,1.032,0.4,1034,513,213,726,521,214,735,33,0.08,0.18
V274,118,2019-11-09 02:26:43,0,2830,2936,1.037,0.4,170,32,5,37,138,16,154,0,0.0,0.03
V274,119,2019-11-09 02:46:43,0,3020,3177,1.052,0.4,254,105,23,128,149,44,193,0,0.0,0.0
V274,120,2019-11-09 03:06:43,0,2558,2802,1.095,0.3,914,326,55,381,588,65,653,4,0.0,0.0
V274,121,2019-11-09 03:26:43,0,2743,2806,1.023,0.4,94,59,20,79,35,12,47,0,0.0,0.0
V274,122,2019-11-09 03:46:43,0,3560,3625,1.018,0.5,1661,870,372,1242,791,252,1043,9,0.02,0.21
V274,123,2019-11-09 04:06:43,0,2674,2769,1.035,0.4,1210,749,411,1160,461,209,670,37,0.06,0.14
V274,124,2019-11-09 04:26:43,0,3158,3149,0.997,0.4,203,101,19,120,102,33,135,0,0.0,0.0
V274,125,2019-11-09 04:46:43,0,3615,3800,1.051,0.5,755,338,57,395,417,71,488,0,0.0,0.0
V274,126,2019-11-09 05:06:43,0,3774,3787,1.004,0.5,807,350,129,479,457,128,585,11,0.04,0.03
V274,127,2019-11-09 05:26:43,0,3791,4107,1.084,0.5,1873,1064,551,1615,809,361,1170,63,0.1,0.18
V274,128,2019-11-09 05:46:43,0,3333,3497,1.049,0.4,1857,923,384,1307,934,416,1350,43,0.06,0.11
V274,129,2019-11-09 06:06:43,1,2757,2789,1.012,0.4,384,185,50,235,199,37,236,0,0.0,0.0
V274,130,2019-11-09 06:26:43,1,2664,2504,0.94,0.3,56,24,1,25,32,5,37,0,0.0,0.0
V274,131,2019-11-09 06:46:43,1,3267,3011,0.922,0.4,193,104,21,125,89,26,115,0,0.0,0.0
V274,132,2019-11-09 07:06:43,1,2291,2052,0.896,0.3,432,214,27,241,218,48,266,1,0.0,0.0
V274,133,2019-11-09 07:26:43,1,2451,2087,0.852,0.3,128,82,4,86,46,7,53,0,0.0,0.0
V274,134,2019-11-09 07:46:43,1,2707,2299,0.849,0.3,194,132,28,160,62,25,87,0,0.0,0.0
V274,135,2019-11-09 08:06:43,1,2770,2271,0.82,0.4,106,56,17,73,50,15,65,0,0.0,0.0
V274,136,2019-11-09 08:26:43,1,3591,3347,0.932,0.5,1172,530,207,737,642,225,867,16,0.02,0.19
V274,137,2019-11-09 08:46:43,1,2772,2663,0.961,0.4,661,320,110,430,341,75,416,6,0.0,0.0
V274,138,2019-11-09 09:06:43,1,2841,2595,0.913,0.4,53,31,12,43,22,2,24,0,0.0,0.0
V274,139,2019-11-09 09:26:43,1,2618,2265,0.865,0.3,51,23,0,23,28,8,36,0,0.0,0.03
V274,140,2019-11-09 09:46:43,1,3291,3169,0.963,0.4,573,312,43,355,261,67,328,0,0.0,0.0
V274,141,2019-11-09 10:06:43,1,2643,2243,0.848,0.3,156,65,10,75,91,22,113,0,0.02,0.0
V274,142,2019-11-09 10:26:43,1,2642,2225,0.842,0.3,137,33,2,35,104,12,116,0,0.0,0.0
V274,143,2019-11-09 10:46:43,1,3127,2587,0.827,0.4,52,22,5,27,30,9,39,0,0.0,0.0
V274,144,2019-11-09 11:06:43,1,3765,3224,0.856,0.5,1084,586,199,785,498,180,678,6,0.0,0.0
V274,145,2019-11-09 11:26:43,1,2536,2203,0.869,0.3,552,267,88,355,285,91,376,0,0.0,0.04
V274,146,2019-11-09 11:46:43,1,2752,2240,0.814,0.3,92,52,9,61,40,11,51,0,0.0,0.0
V274,147,2019-11-09 12:06:43,1,2771,2192,0.791,0.3,62,45,9,54,17,7,24,0,0.0,0.0
V274,148,2019-11-09 12:26:43,1,3134,2781,0.888,0.4,1459,781,246,1027,678,170,848,7,0.0,0.0
V274,149,2019-11-09 12:46:43,1,2364,1864,0.789,0.3,91,52,12,64,39,4,43,0,0.0,0.0
V274,150,2019-11-09 13:06:43,1,2863,2272,0.793,0.4,127,58,7,65,69,6,75,0,0.0,0.0
V274,151,2019-11-09 13:26:43,1,2603,2069,0.795,0.3,49,34,9,43,15,0,15,0,0.0,0.03
V274,152,2019-11-09 13:46:43,1,2500,2042,0.817,0.3,72,37,20,57,35,1,36,0,0.0,0.0
V274,153,2019-11-09 14:06:43,1,3339,3268,0.979,0.4,1078,436,153,589,642,153,795,0,0.0,0.15
V274,154,2019-11-09 14:26:43,1,2809,2630,0.936,0.4,82,42,11,53,40,11,51,0,0.0,0.0
V274,155,2019-11-09 14:46:43,1,2685,2471,0.92,0.4,69,36,8,44,33,7,40,0,0.0,0.0
V274,156,2019-11-09 15:06:43,1,2491,2273,0.912,0.3,89,60,7,67,29,13,42,0,0.0,0.0
V274,157,2019-11-09 15:26:43,1,4046,3892,0.962,0.5,724,352,116,468,372,90,462,5,0.02,0.03
V274,158,2019-11-09 15:46:43,1,3313,3348,1.011,0.4,1536,811,350,1161,725,257,982,32,0.1,0.17
V274,159,2019-11-09 16:06:43,1,2644,2472,0.935,0.3,412,150,10,160,262,38,300,0,0.0,0.0
V274,160,2019-11-09 16:26:43,1,2673,2399,0.898,0.3,118,47,10,57,71,10,81,0,0.0,0.02
V274,161,2019-11-09 16:46:43,1,2848,2628,0.923,0.4,127,65,10,75,62,22,84,0,0.0,0.0
V274,162,2019-11-09 17:06:43,1,2729,2420,0.887,0.4,572,264,50,314,308,68,376,1,0.0,0.0
V274,163,2019-11-09 17:26:43,1,2792,2688,0.963,0.4,503,206,43,249,297,72,369,0,0.0,0.1
V274,164,2019-11-09 17:46:43,1,3286,2979,0.906,0.4,296,128,30,158,168,24,192,0,0.0,0.0
V274,165,2019-11-09 18:06:43,0,3414,3423,1.003,0.5,744,349,54,403,395,60,455,0,0.0,0.05
V274,166,2019-11-09 18:26:43,0,4099,3916,0.955,0.5,2478,1465,739,2204,1013,409,1422,65,0.02,0.15
V274,167,2019-11-09 18:46:43,0,3798,3971,1.045,0.5,2421,1317,723,2040,1104,532,1636,106,0.08,0.22
V274,168,2019-11-09 19:06:43,0,3232,3546,1.097,0.4,1661,910,309,1219,751,217,968,46,0.04,0.06
V274,169,2019-11-09 19:26:43,0,3393,3633,1.071,0.5,284,133,26,159,151,38,189,21,0.0,0.0
V274,170,2019-11-09 19:46:43,0,4027,4388,1.09,0.5,3450,2117,1389,3506,1333,684,2017,329,0.06,0.23
V274,171,2019-11-09 20:06:43,0,3537,3738,1.057,0.5,2213,1180,616,1796,1033,471,1504,81,0.1,0.21
V274,172,2019-11-09 20:26:43,0,3006,3190,1.061,0.4,900,390,98,488,510,126,636,12,0.0,0.15
V274,173,2019-11-09 20:46:43,0,2860,3126,1.093,0.4,80,49,5,54,31,6,37,0,0.0,0.03
V274,174,2019-11-09 21:06:43,0,3438,3766,1.096,0.5,489,248,103,351,241,78,319,20,0.0,0.0
V274,175,2019-11-09 21:26:43,0,3712,3923,1.057,0.5,1765,959,504,1463,806,354,1160,77,0.08,0.27
V274,176,2019-11-09 21:46:43,0,2595,2784,1.073,0.4,1063,617,277,894,446,191,637,32,0.0,0.08
V274,177,2019-11-09 22:06:43,0,2966,3212,1.083,0.4,143,57,14,71,86,17,103,0,0.0,0.0
V274,178,2019-11-09 22:26:43,0,2641,2875,1.088,0.4,1071,436,63,499,635,116,751,3,0.0,0.0
V274,179,2019-11-09 22:46:43,0,3112,3427,1.101,0.4,391,210,125,335,181,59,240,12,0.0,0.17
V274,180,2019-11-09 23:06:43,0,3795,3972,1.046,0.5,2477,1362,723,2085,1115,490,1605,102,0.1,0.09
V274,181,2019-11-09 23:26:43,0,2911,3457,1.188,0.4,2092,1138,566,1704,954,423,1377,62,0.1,0.31
V274,182,2019-11-09 23:46:43,0,3842,4060,1.057,0.5,2958,1689,711,2400,1269,601,1870,113,0.06,0.03
V274,183,2019-12-09 00:06:43,0,3639,3822,1.05,0.5,2485,1395,681,2076,1090,523,1613,136,0.1,0.22
V274,184,2019-12-09 00:26:43,0,2587,2676,1.034,0.3,435,210,33,243,225,41,266,0,0.0,0.0
V274,185,2019-12-09 00:46:43,0,3039,3108,1.023,0.4,103,47,18,65,56,28,84,0,0.0,0.0
V274,186,2019-12-09 01:06:43,0,3390,3645,1.075,0.5,639,354,79,433,285,88,373,0,0.0,0.0
V274,187,2019-12-09 01:26:43,0,2824,2806,0.993,0.4,477,205,47,252,272,76,348,0,0.0,0.0
V274,188,2019-12-09 01:46:43,0,3255,3352,1.03,0.4,548,306,132,438,242,93,335,8,0.0,0.0
V274,189,2019-12-09 02:06:43,0,3353,3475,1.036,0.4,1713,863,352,1215,850,378,1228,17,0.02,0.16
V274,190,2019-12-09 02:26:43,0,3242,3340,1.03,0.4,2161,1199,547,1746,962,476,1438,69,0.14,0.26
V274,191,2019-12-09 02:46:43,0,2549,2680,1.051,0.3,1191,750,325,1075,441,153,594,12,0.18,0.18
V274,192,2019-12-09 03:06:43,0,2932,2984,1.018,0.4,58,33,8,41,25,6,31,0,0.0,0.0
V274,193,2019-12-09 03:26:43,0,2596,2662,1.025,0.3,587,307,92,399,280,69,349,2,0.0,0.0
V274,194,2019-12-09 03:46:43,0,3092,2861,0.926,0.4,48,32,0,32,16,8,24,0,0.0,0.0
V274,195,2019-12-09 04:06:43,0,3266,3403,1.042,0.4,1714,769,325,1094,945,322,1267,15,0.0,0.25
V274,196,2019-12-09 04:26:43,0,3222,3367,1.045,0.4,1356,751,339,1090,605,280,885,28,0.1,0.03
V274,197,2019-12-09 04:46:43,0,2543,2676,1.052,0.3,93,52,17,69,41,7,48,0,0.0,0.03
V274,198,2019-12-09 05:06:43,0,3915,3721,0.95,0.5,325,133,24,157,192,57,249,2,0.0,0.0
V274,199,2019-12-09 05:26:43,0,3730,3911,1.048,0.5,1884,1126,599,1725,758,348,1106,51,0.08,0.26
V274,200,2019-12-09 05:46:43,0,2734,2988,1.093,0.4,1434,805,331,1136,629,304,933,25,0.02,0.03
V274,201,2019-12-09 06:06:43,1,2886,2681,0.929,0.4,38,11,3,14,27,1,28,0,0.0,0.0
V274,202,2019-12-09 06:26:43,1,2604,2382,0.915,0.3,46,15,2,17,31,6,37,0,0.0,0.0
V274,203,2019-12-09 06:46:43,1,2473,2005,0.811,0.3,119,61,10,71,58,13,71,0,0.0,0.0
V274,204,2019-12-09 07:06:43,1,2097,1920,0.916,0.3,527,206,41,247,321,59,380,0,0.0,0.0
V274,205,2019-12-09 07:26:43,1,3967,3499,0.882,0.5,621,292,126,418,329,137,466,7,0.0,0.0
V274,206,2019-12-09 07:46:43,1,2538,2101,0.828,0.3,318,134,10,144,184,37,221,0,0.0,0.0
V274,207,2019-12-09 08:06:43,1,3681,3327,0.904,0.5,469,181,23,204,288,33,321,0,0.0,0.0
V274,208,2019-12-09 08:26:43,1,2995,2832,0.945,0.4,1017,522,153,675,495,181,676,20,0.0,0.09
V274,209,2019-12-09 08:46:43,1,2597,2291,0.882,0.3,49,22,4,26,27,1,28,0,0.0,0.0
V274,210,2019-12-09 09:06:43,1,2397,2124,0.886,0.3,107,69,13,82,38,9,47,0,0.0,0.0
V274,211,2019-12-09 09:26:43,1,3588,3082,0.859,0.5,154,72,11,83,82,20,102,0,0.0,0.0
V274,212,2019-12-09 09:46:43,1,2698,2209,0.819,0.3,109,43,4,47,66,13,79,0,0.02,0.03
V274,213,2019-12-09 10:06:43,1,3125,2629,0.841,0.4,246,132,36,168,114,34,148,0,0.0,0.0
V274,214,2019-12-09 10:26:43,1,2588,2115,0.817,0.3,99,64,17,81,35,6,41,0,0.0,0.0
V274,215,2019-12-09 10:46:43,1,3481,3227,0.927,0.5,1562,810,308,1118,752,203,955,8,0.02,0.13
V274,216,2019-12-09 11:06:43,1,3304,2937,0.889,0.4,1128,605,257,862,523,226,749,6,0.02,0.0
V274,217,2019-12-09 11:26:43,1,2627,2250,0.857,0.3,653,322,92,414,331,81,412,2,0.0,0.0
V274,218,2019-12-09 11:46:43,1,2850,2436,0.855,0.4,61,26,4,30,35,10,45,0,0.0,0.0
V274,219,2019-12-09 12:06:43,1,2690,2227,0.828,0.3,143,52,16,68,91,13,104,0,0.0,0.0
V274,220,2019-12-09 12:26:43,1,3334,2940,0.882,0.4,515,235,57,292,280,50,330,0,0.0,0.0
V274,221,2019-12-09 12:46:43,1,2805,2271,0.809,0.4,60,32,10,42,28,9,37,0,0.0,0.0
V274,222,2019-12-09 13:06:43,1,2272,1779,0.783,0.3,30,20,6,26,10,0,10,0,0.0,0.0
V274,223,2019-12-09 13:26:43,1,3530,3058,0.866,0.5,1034,506,103,609,528,98,626,0,0.0,0.08
V274,224,2019-12-09 13:46:43,1,2781,2668,0.96,0.4,1230,640,263,903,590,161,751,10,0.0,0.06
V274,225,2019-12-09 14:06:43,1,2788,2453,0.88,0.4,33,21,1,22,12,0,12,0,0.0,0.0
V274,226,2019-12-09 14:26:43,1,2826,2410,0.853,0.4,106,77,30,107,29,7,36,0,0.0,0.0
V274,227,2019-12-09 14:46:43,1,2646,2319,0.876,0.3,84,39,13,52,45,8,53,0,0.0,0.03
V274,228,2019-12-09 15:06:43,1,2944,2570,0.873,0.4,193,115,19,134,78,11,89,0,0.0,0.0
V274,229,2019-12-09 15:26:43,1,3086,3097,1.003,0.4,1125,670,195,865,455,111,566,4,0.0,0.16
V274,230,2019-12-09 15:46:43,1,2632,2480,0.942,0.3,186,112,4,116,74,19,93,0,0.0,0.0
V274,231,2019-12-09 16:06:43,1,2607,2415,0.927,0.3,35,12,2,14,23,4,27,0,0.0,0.03
V274,232,2019-12-09 16:26:43,1,2418,2139,0.885,0.3,74,26,8,34,48,5,53,0,0.0,0.0
V274,233,2019-12-09 16:46:43,1,2569,2454,0.955,0.3,782,363,114,477,419,114,533,0,0.0,0.04
V274,234,2019-12-09 17:06:43,1,2600,2356,0.906,0.3,76,48,4,52,28,3,31,0,0.0,0.0
V274,235,2019-12-09 17:26:43,1,3250,3052,0.939,0.4,1334,722,169,891,612,153,765,18,0.0,0.09
V274,236,2019-12-09 17:46:43,1,2787,2663,0.956,0.4,123,79,12,91,44,10,54,0,0.02,0.11
V274,237,2019-12-09 18:06:43,0,4016,3904,0.972,0.5,777,459,170,629,318,93,411,16,0.0,0.03
V274,238,2019-12-09 18:26:43,0,3084,3177,1.03,0.4,1716,1002,523,1525,714,353,1067,14,0.0,0.06
V274,239,2019-12-09 18:46:43,0,4189,3569,0.852,0.5,1676,962,486,1448,714,326,1040,23,0.0,0.0
V274,240,2019-12-09 19:06:43,0,3798,3166,0.834,0.5,4073,2459,1719,4178,1614,867,2481,306,0.02,0.0
V274,241,2019-12-09 19:26:43,0,2091,1828,0.874,0.3,1578,766,391,1157,812,305,1117,95,0.02,0.0
V274,242,2019-12-09 19:46:43,0,4026,3251,0.808,0.5,582,252,102,354,330,103,433,7,0.0,0.0
V274,243,2019-12-09 20:06:43,0,3967,3187,0.803,0.5,897,456,176,632,441,175,616,10,0.0,0.0
V274,244,2019-12-09 20:26:43,0,3196,2613,0.818,0.4,3167,1757,1155,2912,1410,700,2110,369,0.04,0.0
V274,245,2019-12-09 20:46:43,0,1787,1391,0.778,0.2,191,47,8,55,144,58,202,9,0.0,0.0
V274,246,2019-12-09 21:06:43,0,3638,2882,0.792,0.5,2213,1134,666,1800,1079,502,1581,175,0.04,0.0
V274,247,2019-12-09 21:26:43,0,2834,2283,0.806,0.4,1823,835,431,1266,988,401,1389,39,0.0,0.0
V274,248,2019-12-09 21:46:43,0,1857,1432,0.771,0.2,526,210,88,298,316,116,432,3,0.0,0.0
V274,249,2019-12-09 22:06:43,0,3119,2507,0.804,0.4,408,165,60,225,243,84,327,12,0.0,0.0
V274,250,2019-12-09 22:26:43,0,3425,2683,0.783,0.4,3063,1750,1116,2866,1313,660,1973,226,0.02,0.0
V274,251,2019-12-09 22:46:43,0,3749,2909,0.776,0.5,3621,2002,1176,3178,1619,849,2468,151,0.02,0.0
V274,252,2019-12-09 23:06:43,0,3344,2717,0.812,0.4,3614,1979,1076,3055,1635,798,2433,380,0.02,0.0
V274,253,2019-12-09 23:26:43,0,3156,2506,0.794,0.4,3495,1783,947,2730,1712,774,2486,326,0.02,0.0
V274,254,2019-12-09 23:46:43,0,3327,2626,0.789,0.4,3487,1833,988,2821,1654,759,2413,562,0.04,0.03
V274,255,2019-09-13 00:06:43,0,2827,2247,0.795,0.4,3172,1851,948,2799,1321,639,1960,306,0.02,-0.03
V274,256,2019-09-13 00:26:43,0,3435,2702,0.787,0.4,3004,1521,868,2389,1483,669,2152,350,0.02,0.0
V274,257,2019-09-13 00:46:43,0,3408,2685,0.788,0.4,3470,1866,1092,2958,1604,785,2389,641,0.02,0.0
V274,258,2019-09-13 01:06:43,0,3201,2475,0.773,0.4,3031,1528,853,2381,1503,626,2129,342,0.02,0.0
V274,259,2019-09-13 01:26:43,0,1290,1004,0.778,0.2,49,8,4,12,41,1,42,2,0.0,0.0
V274,260,2019-09-13 01:46:43,0,1984,1524,0.768,0.2,18,1,0,1,17,2,19,0,0.0,0.0
V274,261,2019-09-13 02:06:43,0,3026,2361,0.78,0.4,2238,1210,687,1897,1028,481,1509,124,0.02,0.0
V274,262,2019-09-13 02:26:43,0,3296,2546,0.772,0.4,3160,1685,955,2640,1475,712,2187,333,0.0,0.0
V274,263,2019-09-13 02:46:43,0,3157,2467,0.781,0.4,3271,1813,971,2784,1458,689,2147,226,0.04,0.0
V274,264,2019-09-13 03:06:43,0,1671,1285,0.769,0.2,1276,668,350,1018,608,239,847,52,0.02,0.0
V274,265,2019-09-13 03:26:43,0,1055,809,0.767,0.1,152,57,8,65,95,18,113,7,0.0,0.0
V274,266,2019-09-13 03:46:43,0,3387,2611,0.771,0.4,1526,952,451,1403,574,241,815,75,0.0,0.0
V274,267,2019-09-13 04:06:43,0,1715,1318,0.768,0.2,738,419,157,576,319,110,429,44,0.0,0.0
V274,268,2019-09-13 04:26:43,0,1436,1031,0.718,0.2,712,412,234,646,300,93,393,11,0.0,0.0
V274,269,2019-09-13 04:46:43,0,1053,801,0.761,0.1,47,16,2,18,31,8,39,0,0.0,0.0
V274,270,2019-09-13 05:06:43,0,1722,1291,0.75,0.2,277,167,51,218,110,26,136,5,0.0,0.0
V274,271,2019-09-13 05:26:43,0,2140,1647,0.769,0.3,104,71,16,87,33,2,35,0,0.0,0.0
V274,272,2019-09-13 05:46:43,0,2639,2046,0.775,0.3,115,46,9,55,69,7,76,0,0.0,0.0
V274,273,2019-09-13 06:06:43,1,2634,2094,0.795,0.3,1673,886,494,1380,787,366,1153,152,0.0,0.0
V274,274,2019-09-13 06:26:43,1,1703,1290,0.757,0.2,617,335,157,492,282,112,394,17,0.0,0.0
V274,275,2019-09-13 06:46:43,1,1024,751,0.734,0.1,59,14,1,15,45,13,58,0,0.0,0.0
V274,276,2019-09-13 07:06:43,1,4139,3573,0.863,0.5,2038,1190,609,1799,848,366,1214,32,0.14,0.09
V274,277,2019-09-13 07:26:43,1,2988,2933,0.982,0.4,1642,942,483,1425,700,327,1027,26,0.22,0.38
V274,278,2019-09-13 07:46:43,1,2896,2917,1.007,0.4,1479,816,459,1275,663,305,968,39,0.2,0.31
V274,279,2019-09-13 08:06:43,1,2795,2879,1.03,0.4,1603,872,461,1333,731,308,1039,14,0.08,0.26
V274,280,2019-09-13 08:26:43,1,2148,2179,1.014,0.3,570,333,53,386,237,70,307,0,0.06,0.0
V274,281,2019-09-13 08:46:43,1,2195,2209,1.006,0.3,138,53,7,60,85,21,106,0,0.0,0.0
V274,282,2019-09-13 09:06:43,1,2317,2404,1.037,0.3,90,39,1,40,51,8,59,0,0.0,0.0
V274,283,2019-09-13 09:26:43,1,2671,2816,1.054,0.4,217,109,33,142,108,31,139,0,0.0,0.0
V274,284,2019-09-13 09:46:43,1,3582,3701,1.033,0.5,2185,1278,786,2064,907,418,1325,53,0.12,0.04
V274,285,2019-09-13 10:06:43,1,3122,3378,1.082,0.4,1850,914,510,1424,936,454,1390,24,0.04,0.32
V274,286,2019-09-13 10:26:43,1,2734,2855,1.044,0.4,1195,656,292,948,539,201,740,30,0.06,0.23
V274,287,2019-09-13 10:46:43,1,2405,2585,1.075,0.3,43,10,1,11,33,6,39,0,0.0,0.0
V274,288,2019-09-13 11:06:43,1,2286,2467,1.079,0.3,29,9,5,14,20,5,25,0,0.0,0.0
V274,289,2019-09-13 11:26:43,1,2033,2204,1.084,0.3,97,43,2,45,54,7,61,0,0.0,0.0
 V272,1,2019-09-09 11:22:43,1,4038,2429,0.602,0.5,12,12,1,13,0,0,0,0,0.0,0.0
 V272,2,2019-09-09 11:42:43,1,4044,3269,0.808,0.5,745,745,298,1043,0,0,0,43,0.0,0.0
 V272,3,2019-09-09 12:02:43,1,2766,2073,0.75,0.4,145,145,18,163,0,0,0,0,0.0,0.0
 V272,4,2019-09-09 12:22:43,1,2917,2166,0.743,0.4,32,32,14,46,0,0,0,0,0.0,0.0
 V272,5,2019-09-09 12:42:43,1,4176,3414,0.818,0.6,155,155,52,207,0,0,0,13,0.0,0.0
 V272,6,2019-09-09 13:02:43,1,3760,3094,0.823,0.5,920,920,354,1274,0,0,0,38,0.0,0.0
 V272,7,2019-09-09 13:22:43,1,2795,2112,0.756,0.4,18,18,2,20,0,0,0,1,0.0,0.0
 V272,8,2019-09-09 13:42:43,1,2945,2172,0.738,0.4,47,47,3,50,0,0,0,0,0.0,0.0
 V272,9,2019-09-09 14:02:43,1,4114,3398,0.826,0.5,512,512,161,673,0,0,0,32,0.0,0.06
 V272,10,2019-09-09 14:22:43,1,2805,2425,0.865,0.4,271,271,58,329,0,0,0,6,0.0,0.05
 V272,11,2019-09-09 14:42:43,1,2946,2369,0.804,0.4,47,47,2,49,0,0,0,0,0.0,0.0
 V272,12,2019-09-09 15:02:43,1,3069,2512,0.819,0.4,71,71,11,82,0,0,0,0,0.0,-0.03
 V272,13,2019-09-09 15:22:43,1,4264,3845,0.902,0.6,556,556,198,754,0,0,0,21,0.0,0.11
 V272,14,2019-09-09 15:42:43,1,2814,2542,0.903,0.4,102,102,8,110,0,0,0,1,0.0,0.0
 V272,15,2019-09-09 16:02:43,1,3070,2601,0.847,0.4,102,102,4,106,0,0,0,0,0.02,0.0
 V272,16,2019-09-09 16:22:43,1,4266,3767,0.883,0.6,381,381,145,526,0,0,0,23,0.0,0.08
 V272,17,2019-09-09 16:42:43,1,2857,2526,0.884,0.4,256,256,32,288,0,0,0,2,0.0,0.0
 V272,18,2019-09-09 17:02:43,1,2884,2438,0.845,0.4,61,61,10,71,0,0,0,0,0.0,-0.02
 V272,19,2019-09-09 17:22:43,1,3614,3337,0.923,0.5,442,442,113,555,0,0,0,18,0.0,0.11
 V272,20,2019-09-09 17:42:43,1,3279,2976,0.908,0.4,39,39,7,46,0,0,0,0,0.0,-0.02
 V272,21,2019-09-09 18:02:43,0,2924,2605,0.891,0.4,105,105,33,138,0,0,0,4,0.02,0.03
 V272,22,2019-09-09 18:22:43,0,4495,4104,0.913,0.6,764,764,246,1010,0,0,0,32,0.0,0.06
 V272,23,2019-09-09 18:42:43,0,3737,3475,0.93,0.5,305,305,58,363,0,0,0,18,0.0,0.06
 V272,24,2019-09-09 19:02:43,0,4052,4121,1.017,0.6,712,712,351,1063,0,0,0,131,0.0,0.06
 V272,25,2019-09-09 19:22:43,0,3854,3857,1.001,0.5,991,991,524,1515,0,0,0,93,0.0,0.06
 V272,26,2019-09-09 19:42:43,0,3189,2912,0.913,0.4,1042,1042,665,1707,0,0,0,157,0.0,0.04
 V272,27,2019-09-09 20:02:43,0,4243,4060,0.957,0.6,1247,1247,759,2006,0,0,0,146,0.0,0.06
 V272,28,2019-09-09 20:22:43,0,3353,3299,0.984,0.5,617,617,307,924,0,0,0,10,0.0,0.11
 V272,29,2019-09-09 20:42:43,0,3019,2983,0.988,0.4,621,621,353,974,0,0,0,43,0.0,0.12
 V272,30,2019-09-09 21:02:43,0,4689,4380,0.934,0.6,719,719,418,1137,0,0,0,76,0.22,0.0
 V272,31,2019-09-09 21:22:43,0,4233,4277,1.01,0.6,1006,1006,532,1538,0,0,0,100,0.14,0.34
 V272,32,2019-09-09 21:42:43,0,4297,4263,0.992,0.6,457,457,259,716,0,0,0,66,0.1,0.03
 V272,33,2019-09-09 22:02:43,0,4646,4128,0.888,0.6,1541,1541,867,2408,0,0,0,356,0.08,0.02
 V272,34,2019-09-09 22:22:43,0,4060,4269,1.051,0.6,840,840,401,1241,0,0,0,73,0.1,0.31
 V272,35,2019-09-09 22:42:43,0,3256,3429,1.053,0.5,95,95,40,135,0,0,0,7,0.1,-0.03
 V272,36,2019-09-09 23:02:43,0,3529,3511,0.995,0.5,153,153,51,204,0,0,0,2,0.0,0.0
 V272,37,2019-09-09 23:22:43,0,4129,4363,1.057,0.6,822,822,327,1149,0,0,0,61,0.1,0.26
 V272,38,2019-09-09 23:42:43,0,3804,4063,1.068,0.5,1410,1410,791,2201,0,0,0,266,0.06,0.21
 V272,39,2019-10-09 00:02:43,0,3932,4047,1.029,0.5,1115,1115,571,1686,0,0,0,229,0.26,0.0
 V272,40,2019-10-09 00:22:43,0,2841,2834,0.998,0.4,95,95,12,107,0,0,0,0,0.0,-0.03
 V272,41,2019-10-09 00:42:43,0,2774,2748,0.991,0.4,70,70,6,76,0,0,0,0,0.0,-0.03
 V272,42,2019-10-09 01:02:43,0,3068,3150,1.027,0.4,97,97,25,122,0,0,0,0,0.0,0.0
 V272,43,2019-10-09 01:22:43,0,4135,4339,1.049,0.6,611,611,252,863,0,0,0,26,0.0,0.2
 V272,44,2019-10-09 01:42:43,0,2666,2826,1.06,0.4,261,261,84,345,0,0,0,1,0.08,-0.03
 V272,45,2019-10-09 02:02:43,0,3622,3749,1.035,0.5,713,713,320,1033,0,0,0,62,0.16,0.25
 V272,46,2019-10-09 02:22:43,0,2925,3037,1.038,0.4,32,32,9,41,0,0,0,0,0.0,-0.03
 V272,47,2019-10-09 02:42:43,0,2846,2786,0.979,0.4,318,318,58,376,0,0,0,0,0.0,-0.03
 V272,48,2019-10-09 03:02:43,0,3287,2958,0.9,0.4,47,47,21,68,0,0,0,4,0.0,-0.02
 V272,49,2019-10-09 03:22:43,0,3641,3769,1.035,0.5,299,299,105,404,0,0,0,3,0.02,0.1
 V272,50,2019-10-09 03:42:43,0,3017,3077,1.02,0.4,355,355,94,449,0,0,0,0,0.0,-0.03
 V272,51,2019-10-09 04:02:43,0,3802,3825,1.006,0.5,467,467,164,631,0,0,0,33,0.2,0.26
 V272,52,2019-10-09 04:22:43,0,3153,3207,1.017,0.4,196,196,28,224,0,0,0,0,0.0,-0.03
 V272,53,2019-10-09 04:42:43,0,2799,2839,1.014,0.4,140,140,33,173,0,0,0,0,0.0,0.0
 V272,54,2019-10-09 05:02:43,0,4504,4509,1.001,0.6,664,664,303,967,0,0,0,54,0.1,0.08
 V272,55,2019-10-09 05:22:43,0,4091,4214,1.03,0.6,926,926,444,1370,0,0,0,119,0.06,0.2
 V272,56,2019-10-09 05:42:43,0,3076,3156,1.026,0.4,482,482,167,649,0,0,0,11,0.16,0.07
 V272,57,2019-10-09 06:02:43,1,3566,3792,1.063,0.5,73,73,24,97,0,0,0,1,0.0,0.0
 V272,58,2019-10-09 06:22:43,1,3539,3744,1.058,0.5,779,779,392,1171,0,0,0,92,0.04,0.24
 V272,59,2019-10-09 06:42:43,1,2747,2816,1.025,0.4,514,514,166,680,0,0,0,42,0.14,-0.03
 V272,60,2019-10-09 07:02:43,1,3218,3069,0.954,0.4,32,32,7,39,0,0,0,0,0.0,0.0
 V272,61,2019-10-09 07:22:43,1,3547,3408,0.961,0.5,96,96,12,108,0,0,0,0,0.02,-0.03
 V272,62,2019-10-09 07:42:43,1,3774,3557,0.942,0.5,307,307,126,433,0,0,0,47,0.0,-0.03
 V272,63,2019-10-09 08:02:43,1,2919,2717,0.931,0.4,112,112,7,119,0,0,0,0,0.0,0.0
 V272,64,2019-10-09 08:22:43,1,3094,2817,0.911,0.4,61,61,12,73,0,0,0,0,0.0,-0.03
 V272,65,2019-10-09 08:42:43,1,3393,2974,0.876,0.5,69,69,25,94,0,0,0,0,0.0,-0.02
 V272,66,2019-10-09 09:02:43,1,2733,2370,0.867,0.4,50,50,13,63,0,0,0,0,0.0,-0.03
 V272,67,2019-10-09 09:22:43,1,2835,2379,0.839,0.4,166,166,24,190,0,0,0,0,0.0,-0.03
 V272,68,2019-10-09 09:42:43,1,4565,4020,0.881,0.6,772,772,284,1056,0,0,0,55,0.0,0.06
 V272,69,2019-10-09 10:02:43,1,4710,4038,0.857,0.6,824,824,436,1260,0,0,0,49,0.08,0.0
 V272,70,2019-10-09 10:22:43,1,2906,2388,0.822,0.4,171,171,61,232,0,0,0,0,0.0,0.0
 V272,71,2019-10-09 10:42:43,1,2977,2364,0.794,0.4,36,36,11,47,0,0,0,0,0.0,0.0
 V272,72,2019-10-09 11:02:43,1,4318,3616,0.837,0.6,203,203,49,252,0,0,0,4,0.0,0.0
 V272,73,2019-10-09 11:22:43,1,3530,3250,0.921,0.5,692,692,233,925,0,0,0,4,0.0,0.07
 V272,74,2019-10-09 11:42:43,1,2927,2402,0.821,0.4,33,33,2,35,0,0,0,0,0.0,-0.03
 V272,75,2019-10-09 12:02:43,1,2946,2361,0.801,0.4,26,26,3,29,0,0,0,0,0.0,-0.03
 V272,76,2019-10-09 12:22:43,1,2873,2468,0.859,0.4,337,337,120,457,0,0,0,2,0.0,0.05
 V272,77,2019-10-09 12:42:43,1,2801,2380,0.85,0.4,11,11,3,14,0,0,0,0,0.0,-0.03
 V272,78,2019-10-09 13:02:43,1,3577,3475,0.971,0.5,773,773,327,1100,0,0,0,65,0.04,0.14
 V272,79,2019-10-09 13:22:43,1,3035,2909,0.959,0.4,98,98,23,121,0,0,0,0,0.0,0.05
 V272,80,2019-10-09 13:42:43,1,2747,2490,0.906,0.4,38,38,7,45,0,0,0,0,0.0,-0.03
 V272,81,2019-10-09 14:02:43,1,2947,2504,0.85,0.4,25,25,2,27,0,0,0,0,0.02,-0.03
 V272,82,2019-10-09 14:22:43,1,3149,2776,0.882,0.4,63,63,13,76,0,0,0,0,0.0,0.0
 V272,83,2019-10-09 14:42:43,1,2968,2586,0.871,0.4,19,19,4,23,0,0,0,0,0.0,-0.03
 V272,84,2019-10-09 15:02:43,1,3737,3620,0.969,0.5,514,514,118,632,0,0,0,1,0.0,0.08
 V272,85,2019-10-09 15:22:43,1,2785,2534,0.91,0.4,53,53,9,62,0,0,0,0,0.0,-0.03
 V272,86,2019-10-09 15:42:43,1,2708,2512,0.928,0.4,456,456,81,537,0,0,0,2,0.0,0.04
 V272,87,2019-10-09 16:02:43,1,2973,2597,0.873,0.4,29,29,8,37,0,0,0,0,0.0,0.0
 V272,88,2019-10-09 16:22:43,1,2895,2402,0.83,0.4,16,16,8,24,0,0,0,0,0.0,-0.03
 V272,89,2019-10-09 16:42:43,1,3690,3634,0.985,0.5,474,474,212,686,0,0,0,13,0.02,0.19
 V272,90,2019-10-09 17:02:43,1,2934,2771,0.945,0.4,182,182,19,201,0,0,0,0,0.0,-0.03
 V272,91,2019-10-09 17:22:43,1,2870,2697,0.94,0.4,73,73,17,90,0,0,0,0,0.0,0.0
 V272,92,2019-10-09 17:42:43,1,3203,2929,0.915,0.4,78,78,18,96,0,0,0,0,0.0,-0.03
 V272,93,2019-10-09 18:02:43,0,3365,3147,0.935,0.5,667,667,147,814,0,0,0,0,0.0,0.07
 V272,94,2019-10-09 18:22:43,0,4124,3980,0.965,0.6,410,410,65,475,0,0,0,2,0.0,-0.03
 V272,95,2019-10-09 18:42:43,0,4401,4379,0.995,0.6,1036,1036,487,1523,0,0,0,153,0.02,0.13
 V272,96,2019-10-09 19:02:43,0,2922,2886,0.988,0.4,966,966,494,1460,0,0,0,298,0.0,0.03
 V272,97,2019-10-09 19:22:43,0,3156,3114,0.987,0.4,444,444,217,661,0,0,0,39,0.0,0.07
 V272,98,2019-10-09 19:42:43,0,3882,3968,1.022,0.5,721,721,300,1021,0,0,0,80,0.14,0.21
 V272,99,2019-10-09 20:02:43,0,2777,2850,1.026,0.4,593,593,286,879,0,0,0,195,0.0,0.0
 V272,100,2019-10-09 20:22:43,0,3728,3915,1.05,0.5,775,775,316,1091,0,0,0,67,0.06,0.08
 V272,101,2019-10-09 20:42:43,0,3032,3131,1.033,0.4,241,241,116,357,0,0,0,21,0.0,0.13
 V272,102,2019-10-09 21:02:43,0,4253,4433,1.042,0.6,629,629,323,952,0,0,0,68,0.14,0.16
 V272,103,2019-10-09 21:22:43,0,3997,4206,1.052,0.6,1137,1137,626,1763,0,0,0,294,0.16,0.23
 V272,104,2019-10-09 21:42:43,0,3320,3452,1.04,0.5,369,369,124,493,0,0,0,8,0.04,0.11
 V272,105,2019-10-09 22:02:43,0,3207,3399,1.06,0.5,75,75,16,91,0,0,0,0,0.0,-0.03
 V272,106,2019-10-09 22:22:43,0,2944,3142,1.067,0.4,442,442,143,585,0,0,0,12,0.14,0.11
 V272,107,2019-10-09 22:42:43,0,3838,4070,1.06,0.5,322,322,94,416,0,0,0,3,0.0,-0.03
 V272,108,2019-10-09 23:02:43,0,4292,4675,1.089,0.6,1696,1696,1015,2711,0,0,0,517,0.08,0.25
 V272,109,2019-10-09 23:22:43,0,4232,4625,1.093,0.6,1752,1752,1055,2807,0,0,0,380,0.12,0.06
 V272,110,2019-10-09 23:42:43,0,2924,3037,1.039,0.4,284,284,112,396,0,0,0,43,0.06,0.14
 V272,111,2019-11-09 00:02:43,0,3636,3982,1.095,0.5,141,141,59,200,0,0,0,3,0.0,-0.06
 V272,112,2019-11-09 00:22:43,0,3345,3453,1.032,0.5,141,141,64,205,0,0,0,3,0.0,0.0
 V272,113,2019-11-09 00:42:43,0,4204,4581,1.09,0.6,1079,1079,569,1648,0,0,0,126,0.14,0.18
 V272,114,2019-11-09 01:02:43,0,3452,3713,1.076,0.5,667,667,213,880,0,0,0,9,0.18,0.29
 V272,115,2019-11-09 01:22:43,0,3521,3791,1.077,0.5,733,733,341,1074,0,0,0,17,0.16,0.05
 V272,116,2019-11-09 01:42:43,0,3508,3636,1.036,0.5,105,105,14,119,0,0,0,0,0.0,-0.03
 V272,117,2019-11-09 02:02:43,0,3428,3737,1.09,0.5,110,110,25,135,0,0,0,0,0.0,-0.03
 V272,118,2019-11-09 02:22:43,0,3030,3038,1.003,0.4,212,212,82,294,0,0,0,2,0.02,-0.05
 V272,119,2019-11-09 02:42:43,0,3154,3375,1.07,0.4,251,251,52,303,0,0,0,0,0.0,-0.03
 V272,120,2019-11-09 03:02:43,0,2775,2998,1.08,0.4,671,671,215,886,0,0,0,36,0.08,0.19
 V272,121,2019-11-09 03:22:43,0,3336,3416,1.024,0.5,46,46,9,55,0,0,0,0,0.0,-0.03
 V272,122,2019-11-09 03:42:43,0,2975,2958,0.994,0.4,234,234,85,319,0,0,0,5,0.08,-0.03
 V272,123,2019-11-09 04:02:43,0,3242,3053,0.942,0.4,60,60,17,77,0,0,0,0,0.0,-0.03
 V272,124,2019-11-09 04:22:43,0,3583,3600,1.005,0.5,483,483,160,643,0,0,0,8,0.0,0.24
 V272,125,2019-11-09 04:42:43,0,3871,4038,1.043,0.5,1194,1194,653,1847,0,0,0,169,0.28,0.1
 V272,126,2019-11-09 05:02:43,0,2820,2985,1.058,0.4,172,172,53,225,0,0,0,0,0.0,0.04
 V272,127,2019-11-09 05:22:43,0,3693,3862,1.046,0.5,48,48,13,61,0,0,0,0,0.0,-0.03
 V272,128,2019-11-09 05:42:43,0,4404,4622,1.049,0.6,1208,1208,724,1932,0,0,0,202,0.22,0.23
 V272,129,2019-11-09 06:02:43,1,3515,3666,1.043,0.5,863,863,441,1304,0,0,0,176,0.04,-0.03
 V272,130,2019-11-09 06:22:43,1,3114,3017,0.969,0.4,59,59,12,71,0,0,0,0,0.0,-0.06
 V272,131,2019-11-09 06:42:43,1,2825,2660,0.942,0.4,61,61,8,69,0,0,0,0,0.02,-0.05
 V272,132,2019-11-09 07:02:43,1,2687,2469,0.919,0.4,60,60,13,73,0,0,0,0,0.0,-0.03
 V272,133,2019-11-09 07:22:43,1,2908,2576,0.886,0.4,76,76,19,95,0,0,0,0,0.0,-0.03
 V272,134,2019-11-09 07:42:43,1,2966,2580,0.87,0.4,14,14,3,17,0,0,0,0,0.0,-0.03
 V272,135,2019-11-09 08:02:43,1,3731,3559,0.954,0.5,541,541,212,753,0,0,0,25,0.0,0.08
 V272,136,2019-11-09 08:22:43,1,3115,2906,0.933,0.4,62,62,1,63,0,0,0,0,0.0,-0.03
 V272,137,2019-11-09 08:42:43,1,2957,2667,0.902,0.4,27,27,7,34,0,0,0,0,0.0,-0.03
 V272,138,2019-11-09 09:02:43,1,3482,3220,0.925,0.5,183,183,38,221,0,0,0,0,0.0,-0.06
 V272,139,2019-11-09 09:22:43,1,3187,2813,0.883,0.4,58,58,13,71,0,0,0,0,0.02,-0.03
 V272,140,2019-11-09 09:42:43,1,2909,2507,0.862,0.4,44,44,6,50,0,0,0,0,0.0,-0.03
 V272,141,2019-11-09 10:02:43,1,2803,2345,0.837,0.4,50,50,8,58,0,0,0,0,0.0,-0.06
 V272,142,2019-11-09 10:22:43,1,4275,3716,0.869,0.6,490,490,192,682,0,0,0,31,0.0,0.0
 V272,143,2019-11-09 10:42:43,1,3492,3344,0.958,0.5,874,874,438,1312,0,0,0,86,0.04,0.03
 V272,144,2019-11-09 11:02:43,1,3076,2512,0.816,0.4,261,261,99,360,0,0,0,3,0.02,0.0
 V272,145,2019-11-09 11:22:43,1,3038,2507,0.825,0.4,191,191,39,230,0,0,0,0,0.0,0.0
 V272,146,2019-11-09 11:42:43,1,3096,2480,0.801,0.4,46,46,12,58,0,0,0,0,0.0,0.0
 V272,147,2019-11-09 12:02:43,1,2865,2313,0.807,0.4,52,52,21,73,0,0,0,0,0.0,0.0
 V272,148,2019-11-09 12:22:43,1,3864,3275,0.848,0.5,218,218,48,266,0,0,0,0,0.0,0.0
 V272,149,2019-11-09 12:42:43,1,3681,3473,0.943,0.5,1115,1115,473,1588,0,0,0,97,0.02,0.07
 V272,150,2019-11-09 13:02:43,1,3001,2529,0.843,0.4,95,95,18,113,0,0,0,0,0.0,-0.03
 V272,151,2019-11-09 13:22:43,1,3277,2788,0.851,0.4,78,78,24,102,0,0,0,0,0.0,-0.03
 V272,152,2019-11-09 13:42:43,1,2949,2647,0.898,0.4,47,47,16,63,0,0,0,0,0.0,0.02
 V272,153,2019-11-09 14:02:43,1,3678,3297,0.896,0.5,251,251,80,331,0,0,0,1,0.0,0.03
 V272,154,2019-11-09 14:22:43,1,2944,2892,0.982,0.4,234,234,93,327,0,0,0,7,0.0,0.04
 V272,155,2019-11-09 14:42:43,1,2791,2574,0.922,0.4,45,45,12,57,0,0,0,0,0.0,-0.02
 V272,156,2019-11-09 15:02:43,1,2920,2587,0.886,0.4,34,34,7,41,0,0,0,0,0.02,-0.03
 V272,157,2019-11-09 15:22:43,1,3393,3126,0.921,0.5,202,202,36,238,0,0,0,0,0.0,-0.02
 V272,158,2019-11-09 15:42:43,1,2808,2612,0.93,0.4,568,568,174,742,0,0,0,0,0.0,0.04
 V272,159,2019-11-09 16:02:43,1,2700,2449,0.907,0.4,23,23,4,27,0,0,0,0,0.0,-0.03
 V272,160,2019-11-09 16:22:43,1,2889,2468,0.854,0.4,380,380,58,438,0,0,0,0,0.0,-0.03
 V272,161,2019-11-09 16:42:43,1,3102,2573,0.829,0.4,33,33,9,42,0,0,0,0,0.0,0.0
 V272,162,2019-11-09 17:02:43,1,2909,2397,0.824,0.4,74,74,25,99,0,0,0,0,0.0,0.0
 V272,163,2019-11-09 17:22:43,1,3736,3608,0.966,0.5,1149,1149,626,1775,0,0,0,179,0.02,0.12
 V272,164,2019-11-09 17:42:43,1,3064,2767,0.903,0.4,419,419,49,468,0,0,0,0,0.0,-0.05
 V272,165,2019-11-09 18:02:43,0,4002,3725,0.931,0.5,352,352,78,430,0,0,0,3,0.0,-0.05
 V272,166,2019-11-09 18:22:43,0,3068,2955,0.963,0.4,774,774,345,1119,0,0,0,109,0.0,0.07
 V272,167,2019-11-09 18:42:43,0,3368,3607,1.071,0.5,635,635,265,900,0,0,0,38,0.08,0.12
 V272,168,2019-11-09 19:02:43,0,3879,4130,1.065,0.5,453,453,127,580,0,0,0,1,0.04,0.09
 V272,169,2019-11-09 19:22:43,0,3533,3647,1.032,0.5,1152,1152,576,1728,0,0,0,292,0.1,0.08
 V272,170,2019-11-09 19:42:43,0,3487,3646,1.046,0.5,393,393,174,567,0,0,0,19,0.06,0.27
 V272,171,2019-11-09 20:02:43,0,3433,3681,1.072,0.5,254,254,102,356,0,0,0,20,0.04,-0.02
 V272,172,2019-11-09 20:22:43,0,3730,4023,1.078,0.5,793,793,413,1206,0,0,0,55,0.1,0.27
 V272,173,2019-11-09 20:42:43,0,3103,3353,1.081,0.4,173,173,54,227,0,0,0,1,0.06,-0.02
 V272,174,2019-11-09 21:02:43,0,3568,3809,1.068,0.5,540,540,143,683,0,0,0,0,0.0,-0.05
 V272,175,2019-11-09 21:22:43,0,3187,3389,1.063,0.4,359,359,171,530,0,0,0,48,0.08,0.15
 V272,176,2019-11-09 21:42:43,0,4157,4449,1.07,0.6,760,760,346,1106,0,0,0,74,0.12,0.17
 V272,177,2019-11-09 22:02:43,0,3499,3746,1.071,0.5,1032,1032,515,1547,0,0,0,230,0.06,0.06
 V272,178,2019-11-09 22:22:43,0,3818,4104,1.075,0.5,258,258,138,396,0,0,0,13,0.0,0.06
 V272,179,2019-11-09 22:42:43,0,3827,4161,1.087,0.5,420,420,165,585,0,0,0,41,0.0,-0.03
 V272,180,2019-11-09 23:02:43,0,4052,4426,1.092,0.6,1164,1164,555,1719,0,0,0,133,0.32,0.37
 V272,181,2019-11-09 23:22:43,0,2751,3065,1.114,0.4,311,311,43,354,0,0,0,0,0.0,-0.03
 V272,182,2019-11-09 23:42:43,0,2978,3205,1.076,0.4,69,69,23,92,0,0,0,0,0.0,-0.06
 V272,183,2019-12-09 00:02:43,0,3166,3363,1.062,0.4,325,325,42,367,0,0,0,0,0.0,-0.03
 V272,184,2019-12-09 00:22:43,0,4349,4644,1.068,0.6,821,821,355,1176,0,0,0,66,0.04,0.11
 V272,185,2019-12-09 00:42:43,0,4354,4680,1.075,0.6,1494,1494,765,2259,0,0,0,332,0.2,0.25
 V272,186,2019-12-09 01:02:43,0,4121,4506,1.094,0.6,1567,1567,854,2421,0,0,0,361,0.18,0.16
 V272,187,2019-12-09 01:22:43,0,3729,4038,1.083,0.5,1007,1007,406,1413,0,0,0,140,0.04,0.06
 V272,188,2019-12-09 01:42:43,0,3003,3221,1.073,0.4,138,138,25,163,0,0,0,0,0.0,-0.06
 V272,189,2019-12-09 02:02:43,0,3447,3694,1.072,0.5,54,54,15,69,0,0,0,0,0.0,-0.06
 V272,190,2019-12-09 02:22:43,0,2907,3108,1.069,0.4,118,118,33,151,0,0,0,0,0.0,-0.03
 V272,191,2019-12-09 02:42:43,0,3971,4199,1.057,0.6,764,764,293,1057,0,0,0,69,0.06,-0.02
 V272,192,2019-12-09 03:02:43,0,3782,3993,1.056,0.5,919,919,398,1317,0,0,0,82,0.1,0.21
 V272,193,2019-12-09 03:22:43,0,3334,3521,1.056,0.5,122,122,3,125,0,0,0,0,0.02,-0.06
 V272,194,2019-12-09 03:42:43,0,2828,2860,1.011,0.4,117,117,18,135,0,0,0,0,0.0,-0.06
 V272,195,2019-12-09 04:02:43,0,3762,3937,1.047,0.5,538,538,210,748,0,0,0,9,0.0,-0.03
 V272,196,2019-12-09 04:22:43,0,4072,4377,1.075,0.6,1235,1235,664,1899,0,0,0,222,0.26,0.31
 V272,197,2019-12-09 04:42:43,0,3283,3562,1.085,0.5,465,465,197,662,0,0,0,18,0.0,-0.06
 V272,198,2019-12-09 05:02:43,0,3110,3066,0.986,0.4,37,37,1,38,0,0,0,0,0.0,-0.06
 V272,199,2019-12-09 05:22:43,0,4468,4654,1.042,0.6,1312,1312,779,2091,0,0,0,269,0.08,0.15
 V272,200,2019-12-09 05:42:43,0,2896,3133,1.082,0.4,889,889,440,1329,0,0,0,178,0.1,0.02
 V272,201,2019-12-09 06:02:43,1,3067,3014,0.983,0.4,53,53,7,60,0,0,0,0,0.0,-0.06
 V272,202,2019-12-09 06:22:43,1,3025,2918,0.965,0.4,53,53,23,76,0,0,0,0,0.02,-0.09
 V272,203,2019-12-09 06:42:43,1,2559,2434,0.951,0.4,139,139,29,168,0,0,0,0,0.0,-0.06
 V272,204,2019-12-09 07:02:43,1,2899,2621,0.904,0.4,34,34,8,42,0,0,0,0,0.0,-0.03
 V272,205,2019-12-09 07:22:43,1,2918,2742,0.939,0.4,46,46,9,55,0,0,0,0,0.0,-0.09
 V272,206,2019-12-09 07:42:43,1,2684,2303,0.858,0.4,159,159,37,196,0,0,0,0,0.0,-0.06
 V272,207,2019-12-09 08:02:43,1,2977,2631,0.884,0.4,38,38,14,52,0,0,0,0,0.0,-0.05
 V272,208,2019-12-09 08:22:43,1,2934,2549,0.869,0.4,66,66,20,86,0,0,0,0,0.0,-0.06
 V272,209,2019-12-09 08:42:43,1,2928,2425,0.828,0.4,42,42,10,52,0,0,0,0,0.02,-0.05
 V272,210,2019-12-09 09:02:43,1,2851,2346,0.823,0.4,18,18,4,22,0,0,0,0,0.0,-0.06
 V272,211,2019-12-09 09:22:43,1,3671,3177,0.865,0.5,161,161,44,205,0,0,0,0,0.0,-0.05
 V272,212,2019-12-09 09:42:43,1,4021,3869,0.962,0.6,788,788,325,1113,0,0,0,8,0.08,0.23
 V272,213,2019-12-09 10:02:43,1,3254,3187,0.98,0.4,325,325,120,445,0,0,0,6,0.0,-0.06
 V272,214,2019-12-09 10:22:43,1,3145,2973,0.945,0.4,72,72,14,86,0,0,0,0,0.02,-0.03
 V272,215,2019-12-09 10:42:43,1,3012,2820,0.936,0.4,40,40,12,52,0,0,0,0,0.0,-0.06
 V272,216,2019-12-09 11:02:43,1,4592,3875,0.844,0.6,327,327,87,414,0,0,0,1,0.02,-0.03
 V272,217,2019-12-09 11:22:43,1,3674,3247,0.884,0.5,351,351,92,443,0,0,0,0,0.0,0.0
 V272,218,2019-12-09 11:42:43,1,3539,2988,0.844,0.5,34,34,15,49,0,0,0,0,0.0,0.0
 V272,219,2019-12-09 12:02:43,1,2878,2397,0.833,0.4,58,58,14,72,0,0,0,0,0.0,0.0
 V272,220,2019-12-09 12:22:43,1,4361,3948,0.905,0.6,530,530,231,761,0,0,0,41,0.0,0.12
 V272,221,2019-12-09 12:42:43,1,3213,3123,0.972,0.4,608,608,296,904,0,0,0,10,0.0,0.0
 V272,222,2019-12-09 13:02:43,1,2972,2640,0.888,0.4,21,21,4,25,0,0,0,0,0.02,-0.05
 V272,223,2019-12-09 13:22:43,1,2887,2510,0.869,0.4,28,28,11,39,0,0,0,0,0.0,-0.03
 V272,224,2019-12-09 13:42:43,1,3035,2579,0.85,0.4,21,21,1,22,0,0,0,0,0.0,-0.03
 V272,225,2019-12-09 14:02:43,1,3573,3165,0.886,0.5,188,188,58,246,0,0,0,0,0.0,0.0
 V272,226,2019-12-09 14:22:43,1,2670,2538,0.95,0.4,411,411,114,525,0,0,0,3,0.0,0.11
 V272,227,2019-12-09 14:42:43,1,3368,3147,0.934,0.5,114,114,52,166,0,0,0,4,0.02,-0.05
 V272,228,2019-12-09 15:02:43,1,2765,2564,0.927,0.4,97,97,44,141,0,0,0,12,0.0,0.0
 V272,229,2019-12-09 15:22:43,1,3114,2791,0.896,0.4,84,84,18,102,0,0,0,0,0.0,-0.03
 V272,230,2019-12-09 15:42:43,1,2844,2418,0.85,0.4,329,329,50,379,0,0,0,0,0.02,-0.03
 V272,231,2019-12-09 16:02:43,1,3127,2679,0.857,0.4,67,67,11,78,0,0,0,0,0.0,0.0
 V272,232,2019-12-09 16:22:43,1,4019,3565,0.887,0.5,490,490,265,755,0,0,0,70,0.0,0.08
 V272,233,2019-12-09 16:42:43,1,3044,2746,0.902,0.4,776,776,350,1126,0,0,0,49,0.0,-0.02
 V272,234,2019-12-09 17:02:43,1,2849,2438,0.856,0.4,25,25,9,34,0,0,0,0,0.0,-0.03
 V272,235,2019-12-09 17:22:43,1,3626,3365,0.928,0.5,325,325,75,400,0,0,0,0,0.0,-0.03
 V272,236,2019-12-09 17:42:43,1,3080,2787,0.905,0.4,426,426,111,537,0,0,0,17,0.0,0.06
 V272,237,2019-12-09 18:02:43,0,3907,3863,0.989,0.5,386,386,136,522,0,0,0,4,0.0,0.12
 V272,238,2019-12-09 18:22:43,0,3867,3804,0.984,0.5,954,954,431,1385,0,0,0,18,0.02,0.0
 V272,239,2019-12-09 18:42:43,0,3944,3525,0.894,0.5,762,762,435,1197,0,0,0,36,0.0,0.0
 V272,240,2019-12-09 19:02:43,0,4125,3442,0.834,0.5,1979,1979,1065,3044,0,0,0,316,0.02,0.0
 V272,241,2019-12-09 19:22:43,0,3640,3020,0.83,0.5,1799,1799,955,2754,0,0,0,229,0.02,-0.05
 V272,242,2019-12-09 19:42:43,0,2794,2302,0.824,0.4,332,332,119,451,0,0,0,8,0.04,-0.03
 V272,243,2019-12-09 20:02:43,0,3506,2958,0.844,0.5,1501,1501,825,2326,0,0,0,341,0.02,-0.05
 V272,244,2019-12-09 20:22:43,0,3839,3086,0.804,0.5,108,108,15,123,0,0,0,0,0.02,-0.02
 V272,245,2019-12-09 20:42:43,0,3668,2927,0.798,0.5,1835,1835,1050,2885,0,0,0,369,0.0,-0.03
 V272,246,2019-12-09 21:02:43,0,2393,1895,0.792,0.3,826,826,382,1208,0,0,0,111,0.0,-0.05
 V272,247,2019-12-09 21:22:43,0,3058,2449,0.801,0.4,152,152,70,222,0,0,0,3,0.0,-0.05
 V272,248,2019-12-09 21:42:43,0,3570,2800,0.784,0.5,1508,1508,811,2319,0,0,0,244,0.02,-0.02
 V272,249,2019-12-09 22:02:43,0,1896,1525,0.805,0.3,148,148,26,174,0,0,0,0,0.0,-0.06
 V272,250,2019-12-09 22:22:43,0,3269,2593,0.793,0.4,1391,1391,790,2181,0,0,0,269,0.02,-0.03
 V272,251,2019-12-09 22:42:43,0,3106,2381,0.767,0.4,1246,1246,738,1984,0,0,0,281,0.06,-0.04
 V272,252,2019-12-09 23:02:43,0,3606,2907,0.806,0.5,134,134,64,198,0,0,0,23,0.0,-0.06
 V272,253,2019-12-09 23:22:43,0,2741,2077,0.758,0.4,1176,1176,650,1826,0,0,0,227,0.02,-0.03
 V272,254,2019-12-09 23:42:43,0,3920,3111,0.794,0.5,448,448,220,668,0,0,0,60,0.0,-0.05
 V272,255,2019-09-13 00:02:43,0,2498,1983,0.794,0.3,108,108,27,135,0,0,0,5,0.0,-0.03
 V272,256,2019-09-13 00:22:43,0,2806,2145,0.765,0.4,925,925,496,1421,0,0,0,131,0.04,-0.06
 V272,257,2019-09-13 00:42:43,0,3083,2396,0.777,0.4,996,996,515,1511,0,0,0,128,0.06,-0.03
 V272,258,2019-09-13 01:02:43,0,1582,1260,0.796,0.2,21,21,8,29,0,0,0,0,0.0,-0.06
 V272,259,2019-09-13 01:22:43,0,4034,3173,0.786,0.5,617,617,366,983,0,0,0,110,0.0,-0.03
 V272,260,2019-09-13 01:42:43,0,2051,1576,0.768,0.3,890,890,515,1405,0,0,0,183,0.02,-0.05
 V272,261,2019-09-13 02:02:43,0,3253,2482,0.763,0.4,348,348,178,526,0,0,0,38,0.0,-0.05
 V272,262,2019-09-13 02:22:43,0,1630,1252,0.768,0.2,12,12,5,17,0,0,0,0,0.0,-0.03
 V272,263,2019-09-13 02:42:43,0,3128,2436,0.779,0.4,69,69,12,81,0,0,0,0,0.0,-0.06
 V272,264,2019-09-13 03:02:43,0,1978,1541,0.779,0.3,519,519,286,805,0,0,0,64,0.0,-0.03
 V272,265,2019-09-13 03:22:43,0,1402,1077,0.768,0.2,5,5,1,6,0,0,0,0,0.0,-0.06
 V272,266,2019-09-13 03:42:43,0,4106,3171,0.772,0.5,417,417,206,623,0,0,0,36,0.04,-0.02
 V272,267,2019-09-13 04:02:43,0,2729,2070,0.758,0.4,1228,1228,756,1984,0,0,0,288,0.02,-0.06
 V272,268,2019-09-13 04:22:43,0,1416,1077,0.761,0.2,43,43,1,44,0,0,0,0,0.02,-0.05
 V272,269,2019-09-13 04:42:43,0,3427,2637,0.769,0.4,161,161,65,226,0,0,0,11,0.0,-0.03
 V272,270,2019-09-13 05:02:43,0,1374,1064,0.774,0.2,143,143,80,223,0,0,0,19,0.0,-0.03
 V272,271,2019-09-13 05:22:43,0,1240,934,0.753,0.2,4,4,1,5,0,0,0,0,0.0,-0.06
 V272,272,2019-09-13 05:42:43,0,1059,818,0.772,0.1,16,16,1,17,0,0,0,0,0.0,-0.02
 V272,273,2019-09-13 06:02:43,1,1050,819,0.78,0.1,50,50,0,50,0,0,0,0,0.0,-0.06
 V272,274,2019-09-13 06:22:43,1,1345,1019,0.757,0.2,24,24,0,24,0,0,0,0,0.0,-0.03
 V272,275,2019-09-13 06:42:43,1,3203,2406,0.751,0.4,31,31,1,32,0,0,0,0,0.0,-0.02
 V272,276,2019-09-13 07:02:43,1,4738,4138,0.873,0.6,785,785,465,1250,0,0,0,37,0.22,0.15
 V272,277,2019-09-13 07:22:43,1,3689,3716,1.007,0.5,762,762,339,1101,0,0,0,25,0.32,0.36
 V272,278,2019-09-13 07:42:43,1,3492,3609,1.033,0.5,971,971,405,1376,0,0,0,34,0.28,0.39
 V272,279,2019-09-13 08:02:43,1,3582,3626,1.012,0.5,946,946,426,1372,0,0,0,31,0.26,0.19
 V272,280,2019-09-13 08:22:43,1,2625,2727,1.039,0.4,166,166,12,178,0,0,0,0,0.0,-0.06
 V272,281,2019-09-13 08:42:43,1,2518,2650,1.052,0.4,17,17,2,19,0,0,0,0,0.0,-0.03
 V272,282,2019-09-13 09:02:43,1,2457,2588,1.053,0.3,66,66,17,83,0,0,0,2,0.0,-0.03
 V272,283,2019-09-13 09:22:43,1,2729,2941,1.078,0.4,57,57,25,82,0,0,0,0,0.0,-0.05
 V272,284,2019-09-13 09:42:43,1,3160,3326,1.053,0.4,642,642,319,961,0,0,0,4,0.08,0.23
 V272,285,2019-09-13 10:02:43,1,2603,2784,1.07,0.4,480,480,138,618,0,0,0,0,0.12,0.09
 V272,286,2019-09-13 10:22:43,1,2761,2940,1.065,0.4,5,5,1,6,0,0,0,0,0.0,-0.03
 V272,287,2019-09-13 10:42:43,1,3322,3683,1.109,0.5,342,342,143,485,0,0,0,1,0.04,0.13
 V272,288,2019-09-13 11:02:43,1,2683,2853,1.063,0.4,299,299,130,429,0,0,0,5,0.08,0.0
 V272,289,2019-09-13 11:22:43,1,2647,2870,1.084,0.4,53,53,3,56,0,0,0,0,0.0,-0.03
