subject,interval,date_time,light,vo2,vco2,rer,heat,xyt,xt,xa,xf,yt,ya,yf,z,drink,feed
1001,1,23-09-2019 11:40:00,1,3945.0,3140.0,0.796,19.019,140,82,46,36,58,31,27,10,0.01,0.0
1001,2,23-09-2019 11:42:00,1,3957.0,3103.0,0.784,19.027,73,51,28,23,22,6,16,10,0.0,0.0
1001,3,23-09-2019 11:44:00,1,4158.0,3229.0,0.777,19.957,126,62,36,26,64,31,33,7,0.0,0.01
1001,4,23-09-2019 11:46:00,1,3959.0,3052.0,0.771,18.977,96,86,51,35,10,4,6,0,0.01,0.0
1001,5,23-09-2019 11:48:00,1,3945.0,3135.0,0.795,19.016,170,129,82,47,41,21,20,7,0.0,0.01
1001,6,23-09-2019 11:50:00,1,3962.0,3069.0,0.775,19.007,164,134,98,36,30,17,13,28,0.0,0.02
1001,7,23-09-2019 11:52:00,1,3846.0,3057.0,0.795,18.539,102,65,35,30,37,4,33,1,0.0,0.0
1001,8,23-09-2019 11:54:00,1,3754.0,2951.0,0.786,18.06,42,30,15,15,12,4,8,3,0.0,0.0
1001,9,23-09-2019 11:56:00,1,3781.0,2879.0,0.761,18.085,14,10,0,10,4,0,4,0,0.01,0.0
1001,10,23-09-2019 11:58:00,1,3461.0,2734.0,0.79,16.664,1,0,0,0,1,0,1,0,0.0,0.0
1001,11,23-09-2019 12:00:00,1,3261.0,2592.0,0.795,15.72,2,1,0,1,1,0,1,0,0.01,0.0
1001,12,23-09-2019 12:02:00,1,3289.0,2475.0,0.752,15.7,6,4,0,4,2,0,2,0,0.0,0.0
1001,13,23-09-2019 12:04:00,1,3097.0,2367.0,0.764,14.822,85,57,20,37,28,9,19,11,0.0,0.0
1001,14,23-09-2019 12:06:00,1,3077.0,2399.0,0.779,14.781,226,171,132,39,55,29,26,23,0.0,0.0
1001,15,23-09-2019 12:08:00,1,3484.0,2660.0,0.764,16.671,224,168,126,42,56,24,32,24,0.0,0.0
1001,16,23-09-2019 12:10:00,1,3264.0,2641.0,0.809,15.785,13,9,3,6,4,1,3,0,0.0,0.0
1001,17,23-09-2019 12:12:00,1,3116.0,2529.0,0.8115,15.078,0,0,0,0,0,0,0,0,0.0,0.0
1001,18,23-09-2019 12:14:00,1,2968.0,2417.0,0.814,14.371,2,0,0,0,2,1,1,0,0.0,0.0
1001,19,23-09-2019 12:16:00,1,2983.0,2389.0,0.801,14.398,0,0,0,0,0,0,0,0,0.0,0.0
1001,20,23-09-2019 12:18:00,1,2982.0,2314.0,0.776,14.311,1,1,0,1,0,0,0,0,0.0,0.0
1001,21,23-09-2019 12:20:00,1,2659.0,2220.0,0.835,12.934,0,0,0,0,0,0,0,0,0.0,0.0
1001,22,23-09-2019 12:22:00,1,2688.0,2117.0,0.788,12.934,0,0,0,0,0,0,0,0,0.0,0.0
1001,23,23-09-2019 12:24:00,1,2484.0,2026.0,0.815,12.031,0,0,0,0,0,0,0,0,0.0,0.0
1001,24,23-09-2019 12:26:00,1,2509.0,1978.0,0.788,12.074,66,49,30,19,17,8,9,0,0.0,0.0
1001,25,23-09-2019 12:28:00,1,2481.0,2054.0,0.828,12.05,156,128,89,39,28,17,11,19,0.0,0.0
1001,26,23-09-2019 12:30:00,1,2669.0,2256.0,0.845,13.014,123,83,56,27,40,15,25,12,0.0,0.0
1001,27,23-09-2019 12:32:00,1,2974.0,2342.0,0.787,14.31,173,121,84,37,52,34,18,7,0.0,0.0
1001,28,23-09-2019 12:34:00,1,2972.0,2348.0,0.79,14.31,73,55,30,25,18,0,18,0,0.0,0.0
1001,29,23-09-2019 12:36:00,1,2969.0,2368.0,0.797,14.321,56,38,19,19,18,6,12,1,0.0,0.0
1001,30,23-09-2019 12:38:00,1,2964.0,2401.0,0.81,14.338,26,22,14,8,4,1,3,0,0.0,0.0
1001,31,23-09-2019 12:40:00,1,2986.0,2331.0,0.781,14.345,14,14,1,13,0,0,0,0,0.0,0.0
1001,32,23-09-2019 12:42:00,1,2678.0,2209.0,0.825,12.997,4,2,1,1,2,0,2,0,0.01,0.0
1001,33,23-09-2019 12:44:00,1,2583.0,2087.0,0.808,12.487,15,13,0,13,2,0,2,0,0.0,0.0
1001,34,23-09-2019 12:46:00,1,2608.0,2009.5,0.771,12.5,15,8,1,7,7,0,7,0,0.0,0.0
1001,35,23-09-2019 12:48:00,1,2633.0,1932.0,0.734,12.513,6,6,0,6,0,0,0,0,0.0,0.0
1001,36,23-09-2019 12:50:00,1,2519.0,1891.0,0.75,12.019,0,0,0,0,0,0,0,0,0.0,0.0
1001,37,23-09-2019 12:52:00,1,2418.0,1858.0,0.769,11.584,1,1,0,1,0,0,0,0,0.0,0.0
1001,38,23-09-2019 12:54:00,1,2417.0,1833.0,0.759,11.552,0,0,0,0,0,0,0,0,0.0,0.0
1001,39,23-09-2019 12:56:00,1,2421.0,1814.0,0.749,11.546,3,2,0,2,1,1,0,0,0.0,0.0
1001,40,23-09-2019 12:58:00,1,2431.0,1794.0,0.738,11.566,2,2,0,2,0,0,0,0,0.0,0.0
1001,41,23-09-2019 13:00:00,1,2422.0,1791.0,0.739,11.526,24,18,10,8,6,2,4,0,0.0,0.01
1001,42,23-09-2019 13:02:00,1,2428.0,1828.0,0.753,11.588,5,4,1,3,1,0,1,0,0.0,0.0
1001,43,23-09-2019 13:04:00,1,2414.0,1837.0,0.761,11.545,0,0,0,0,0,0,0,0,0.0,0.0
1001,44,23-09-2019 13:06:00,1,2423.0,1845.0,0.761,11.59,2,2,0,2,0,0,0,0,0.0,0.0
1001,45,23-09-2019 13:08:00,1,2431.0,1823.0,0.75,11.599,10,10,2,8,0,0,0,0,0.0,0.0
1001,46,23-09-2019 13:10:00,1,2430.0,1804.0,0.742,11.572,0,0,0,0,0,0,0,0,0.0,0.0
1001,47,23-09-2019 13:12:00,1,2427.0,1785.0,0.736,11.54,0,0,0,0,0,0,0,0,0.0,0.0
1001,48,23-09-2019 13:14:00,1,2432.0,1767.0,0.726,11.539,0,0,0,0,0,0,0,0,0.0,0.0
1001,49,23-09-2019 13:16:00,1,2443.0,1736.0,0.711,11.549,0,0,0,0,0,0,0,0,0.0,0.0
1001,50,23-09-2019 13:18:00,1,2453.0,1730.0,0.705,11.579,2,2,0,2,0,0,0,0,0.0,0.0
1001,51,23-09-2019 13:20:00,1,2446.0,1760.0,0.7195,11.5855,5,5,0,5,0,0,0,0,0.0,0.0
1001,52,23-09-2019 13:22:00,1,2439.0,1790.0,0.734,11.592,10,10,0,10,0,0,0,0,0.0,0.0
1001,53,23-09-2019 13:24:00,1,2429.0,1823.0,0.751,11.589,6,6,4,2,0,0,0,0,0.0,0.0
1001,54,23-09-2019 13:26:00,1,2428.0,1815.0,0.748,11.575,3,0,0,0,3,0,3,0,0.0,0.0
1001,55,23-09-2019 13:28:00,1,2438.0,1811.0,0.743,11.611,3,2,1,1,1,0,1,0,0.0,0.0
1001,56,23-09-2019 13:30:00,1,2438.0,1802.0,0.739,11.602,0,0,0,0,0,0,0,0,0.0,0.0
1001,57,23-09-2019 13:32:00,1,2436.0,1777.0,0.729,11.566,4,2,1,1,2,0,2,0,0.0,0.0
1001,58,23-09-2019 13:34:00,1,2430.0,1762.0,0.725,11.523,26,15,9,6,11,7,4,0,0.0,0.0
1001,59,23-09-2019 13:36:00,1,2433.0,1778.0,0.731,11.557,72,37,24,13,35,20,15,14,0.01,0.0
1001,60,23-09-2019 13:38:00,1,2612.0,1998.0,0.765,12.503,182,120,83,37,62,33,29,18,0.0,0.0
1001,61,23-09-2019 13:40:00,1,2798.0,2127.0,0.76,13.378,110,80,52,28,30,6,24,8,0.0,0.0
1001,62,23-09-2019 13:42:00,1,2784.0,2186.0,0.785,13.39,112,56,32,24,56,16,40,10,0.0,0.0
1001,63,23-09-2019 13:44:00,1,2990.0,2319.0,0.776,14.348,184,122,94,28,62,43,19,11,0.0,0.0
1001,64,23-09-2019 13:46:00,1,3105.0,2344.0,0.755,14.828,87,66,41,25,21,8,13,16,0.0,0.0
1001,65,23-09-2019 13:48:00,1,2884.0,2282.0,0.791,13.888,47,9,0,9,38,2,36,0,0.0,0.0
1001,66,23-09-2019 13:50:00,1,3115.0,2336.0,0.75,14.859,101,82,52,30,19,4,15,2,0.0,0.0
1001,67,23-09-2019 13:52:00,1,2999.0,2339.0,0.78,14.407,223,194,150,44,29,10,19,3,0.0,0.0
1001,68,23-09-2019 13:54:00,1,2955.5,2251.5,0.7615,14.139,245,167,109,58,78,46,32,11,0.0,0.0
1001,69,23-09-2019 13:56:00,1,2912.0,2164.0,0.743,13.871,125,106,65,41,19,9,10,4,0.0,0.0
1001,70,23-09-2019 13:58:00,1,3099.0,2338.0,0.754,14.799,93,58,38,20,35,17,18,12,0.0,0.0
1001,71,23-09-2019 14:00:00,1,2880.0,2282.0,0.792,13.875,36,33,4,29,3,2,1,2,0.0,0.0
1001,72,23-09-2019 14:02:00,1,3101.0,2350.0,0.758,14.818,1,1,0,1,0,0,0,0,0.0,0.0
1001,73,23-09-2019 14:04:00,1,2883.0,2275.0,0.789,13.878,39,23,7,16,16,3,13,1,0.0,0.0
1001,74,23-09-2019 14:06:00,1,2986.0,2306.0,0.772,14.316,8,5,3,2,3,0,3,0,0.0,0.0
1001,75,23-09-2019 14:08:00,1,2894.0,2263.0,0.782,13.909,7,3,0,3,4,0,4,0,0.0,0.0
1001,76,23-09-2019 14:10:00,1,2697.0,2085.0,0.773,12.934,2,2,0,2,0,0,0,0,0.0,0.0
1001,77,23-09-2019 14:12:00,1,2724.0,1982.0,0.728,12.928,13,10,0,10,3,0,3,0,0.0,0.0
1001,78,23-09-2019 14:14:00,1,2516.0,1895.0,0.753,12.012,43,43,0,43,0,0,0,0,0.0,0.0
1001,79,23-09-2019 14:16:00,1,2538.0,1804.0,0.711,11.999,10,5,0,5,5,0,5,0,0.01,0.0
1001,80,23-09-2019 14:18:00,1,2550.0,1769.0,0.694,12.005,3,1,0,1,2,0,2,0,0.0,0.0
1001,81,23-09-2019 14:20:00,1,2447.0,1770.0,0.723,11.601,7,0,0,0,7,0,7,0,0.0,0.0
1001,82,23-09-2019 14:22:00,1,2444.0,1727.0,0.707,11.54,0,0,0,0,0,0,0,0,0.0,0.0
1001,83,23-09-2019 14:24:00,1,2441.0,1758.0,0.72,11.565,7,6,4,2,1,0,1,0,0.0,0.0
1001,84,23-09-2019 14:26:00,1,2444.0,1747.0,0.715,11.563,3,3,1,2,0,0,0,0,0.0,0.0
1001,85,23-09-2019 14:28:00,1,2494.5,1771.0,0.71,11.7885,0,0,0,0,0,0,0,0,0.0,0.0
1001,86,23-09-2019 14:30:00,1,2545.0,1795.0,0.705,12.014,0,0,0,0,0,0,0,0,0.01,0.0
1001,87,23-09-2019 14:32:00,1,2548.0,1810.0,0.711,12.043,0,0,0,0,0,0,0,0,0.0,0.0
1001,88,23-09-2019 14:34:00,1,2448.0,1750.0,0.715,11.582,0,0,0,0,0,0,0,0,0.0,0.0
1001,89,23-09-2019 14:36:00,1,2438.0,1736.0,0.712,11.53,6,3,0,3,3,1,2,0,0.0,0.0
1001,90,23-09-2019 14:38:00,1,2554.0,1767.0,0.692,12.021,0,0,0,0,0,0,0,0,0.0,0.0
1001,91,23-09-2019 14:40:00,1,2558.0,1772.0,0.693,12.042,10,4,0,4,6,0,6,0,0.0,0.0
1001,92,23-09-2019 14:42:00,1,2549.0,1766.0,0.693,11.998,1,0,0,0,1,0,1,0,0.0,0.0
1001,93,23-09-2019 14:44:00,1,2550.0,1782.0,0.699,12.022,0,0,0,0,0,0,0,0,0.0,0.0
1001,94,23-09-2019 14:46:00,1,2554.0,1747.0,0.684,11.995,3,3,0,3,0,0,0,0,0.0,0.0
1001,95,23-09-2019 14:48:00,1,2557.0,1724.0,0.674,11.984,1,1,1,0,0,0,0,0,0.0,0.0
1001,96,23-09-2019 14:50:00,1,2447.0,1720.0,0.703,11.544,5,5,0,5,0,0,0,0,0.0,0.0
1001,97,23-09-2019 14:52:00,1,2447.0,1723.0,0.704,11.549,2,2,0,2,0,0,0,0,0.0,0.0
1001,98,23-09-2019 14:54:00,1,2443.0,1729.0,0.708,11.539,10,10,0,10,0,0,0,0,0.0,0.0
1001,99,23-09-2019 14:56:00,1,2338.0,1685.0,0.721,11.079,27,17,6,11,10,5,5,0,0.0,0.0
1001,100,23-09-2019 14:58:00,1,2341.0,1691.0,0.723,11.096,0,0,0,0,0,0,0,0,0.0,0.0
1001,101,23-09-2019 15:00:00,1,2455.0,1719.0,0.7,11.576,0,0,0,0,0,0,0,0,0.0,0.0
1001,102,23-09-2019 15:02:00,1,2397.0,1714.5,0.7155,11.343,1,0,0,0,1,0,1,0,0.0,0.0
1001,103,23-09-2019 15:04:00,1,2339.0,1710.0,0.731,11.11,0,0,0,0,0,0,0,0,0.0,0.0
1001,104,23-09-2019 15:06:00,1,2445.0,1736.0,0.71,11.556,0,0,0,0,0,0,0,0,0.0,0.0
1001,105,23-09-2019 15:08:00,1,2459.0,1725.0,0.702,11.601,34,12,8,4,22,7,15,1,0.0,0.0
1001,106,23-09-2019 15:10:00,1,2440.0,1760.0,0.721,11.561,2,1,1,0,1,0,1,0,0.0,0.0
1001,107,23-09-2019 15:12:00,1,2452.0,1745.0,0.711,11.594,1,1,1,0,0,0,0,0,0.0,0.0
1001,108,23-09-2019 15:14:00,1,2452.0,1734.0,0.707,11.579,0,0,0,0,0,0,0,0,0.0,0.0
1001,109,23-09-2019 15:16:00,1,2443.0,1748.0,0.716,11.56,0,0,0,0,0,0,0,0,0.0,0.0
1001,110,23-09-2019 15:18:00,1,2441.0,1758.0,0.72,11.563,2,0,0,0,2,0,2,0,0.0,0.0
1001,111,23-09-2019 15:20:00,1,2563.0,1763.0,0.688,12.052,13,5,4,1,8,2,6,0,0.0,0.0
1001,112,23-09-2019 15:22:00,1,2559.0,1766.0,0.69,12.038,10,9,1,8,1,0,1,0,0.01,0.0
1001,113,23-09-2019 15:24:00,1,2445.0,1746.0,0.714,11.566,5,5,0,5,0,0,0,0,0.0,0.0
1001,114,23-09-2019 15:26:00,1,2341.0,1698.0,0.725,11.105,14,10,0,10,4,0,4,0,0.0,0.0
1001,115,23-09-2019 15:28:00,1,2231.0,1667.0,0.747,10.636,2,2,0,2,0,0,0,0,0.0,0.0
1001,116,23-09-2019 15:30:00,1,2231.0,1641.0,0.736,10.606,6,0,0,0,6,0,6,0,0.0,0.0
1001,117,23-09-2019 15:32:00,1,2234.0,1666.0,0.746,10.646,5,4,0,4,1,0,1,0,0.0,0.0
1001,118,23-09-2019 15:34:00,1,2227.0,1656.0,0.744,10.61,7,7,0,7,0,0,0,0,0.0,0.0
1001,119,23-09-2019 15:36:00,1,2226.0,1667.0,0.749,10.6165,12,5,0,5,7,0,7,0,0.0,0.0
1001,120,23-09-2019 15:38:00,1,2225.0,1678.0,0.754,10.623,3,3,0,3,0,0,0,0,0.0,0.0
1001,121,23-09-2019 15:40:00,1,2226.0,1683.0,0.756,10.635,0,0,0,0,0,0,0,0,0.0,0.0
1001,122,23-09-2019 15:42:00,1,2242.0,1645.0,0.734,10.656,14,8,2,6,6,0,6,0,0.0,0.0
1001,123,23-09-2019 15:44:00,1,2237.0,1652.0,0.739,10.643,8,3,0,3,5,0,5,0,0.01,0.0
1001,124,23-09-2019 15:46:00,1,2235.0,1669.0,0.747,10.653,3,3,0,3,0,0,0,0,0.0,0.0
1001,125,23-09-2019 15:48:00,1,2229.0,1695.0,0.761,10.658,5,4,0,4,1,0,1,0,0.0,0.0
1001,126,23-09-2019 15:50:00,1,2227.0,1692.0,0.76,10.648,11,8,2,6,3,1,2,0,0.0,0.0
1001,127,23-09-2019 15:52:00,1,2230.0,1696.0,0.76,10.666,0,0,0,0,0,0,0,0,0.0,0.0
1001,128,23-09-2019 15:54:00,1,2239.0,1646.0,0.735,10.646,0,0,0,0,0,0,0,0,0.0,0.0
1001,129,23-09-2019 15:56:00,1,2246.0,1645.0,0.732,10.673,7,0,0,0,7,1,6,0,0.0,0.0
1001,130,23-09-2019 15:58:00,1,2229.0,1671.0,0.749,10.633,3,0,0,0,3,0,3,0,0.0,0.0
1001,131,23-09-2019 16:00:00,1,2227.0,1693.0,0.76,10.649,23,12,6,6,11,0,11,0,0.0,0.0
1001,132,23-09-2019 16:02:00,1,2222.0,1701.0,0.765,10.639,0,0,0,0,0,0,0,0,0.0,0.0
1001,133,23-09-2019 16:04:00,1,2222.0,1689.0,0.76,10.623,1,1,0,1,0,0,0,0,0.0,0.0
1001,134,23-09-2019 16:06:00,1,2235.0,1675.0,0.749,10.662,4,4,1,3,0,0,0,0,0.0,0.0
1001,135,23-09-2019 16:08:00,1,2233.0,1666.0,0.746,10.643,0,0,0,0,0,0,0,0,0.0,0.0
1001,136,23-09-2019 16:10:00,1,2241.5,1615.5,0.721,10.6215,8,7,1,6,1,0,1,0,0.0,0.0
1001,137,23-09-2019 16:12:00,1,2250.0,1565.0,0.696,10.6,5,4,2,2,1,0,1,0,0.0,0.0
1001,138,23-09-2019 16:14:00,1,2255.0,1560.0,0.692,10.614,14,14,1,13,0,0,0,0,0.0,0.01
1001,139,23-09-2019 16:16:00,1,2261.0,1576.0,0.697,10.653,6,6,0,6,0,0,0,0,0.0,0.0
1001,140,23-09-2019 16:18:00,1,2370.0,1577.0,0.665,11.086,13,13,0,13,0,0,0,0,0.0,0.0
1001,141,23-09-2019 16:20:00,1,2257.0,1569.0,0.695,10.631,17,17,1,16,0,0,0,0,0.0,0.0
1001,142,23-09-2019 16:22:00,1,2354.0,1614.0,0.686,11.061,3,3,0,3,0,0,0,0,0.0,0.0
1001,143,23-09-2019 16:24:00,1,2363.0,1624.0,0.687,11.107,2,2,1,1,0,0,0,0,0.0,0.0
1001,144,23-09-2019 16:26:00,1,2356.0,1655.0,0.702,11.114,11,4,2,2,7,3,4,0,0.0,0.0
1001,145,23-09-2019 16:28:00,1,2446.0,1758.0,0.719,11.585,2,1,0,1,1,0,1,0,0.0,0.0
1001,146,23-09-2019 16:30:00,1,2331.0,1743.0,0.748,11.114,11,0,0,0,11,0,11,0,0.0,0.0
1001,147,23-09-2019 16:32:00,1,2324.0,1727.0,0.743,11.071,12,8,0,8,4,0,4,0,0.0,0.0
1001,148,23-09-2019 16:34:00,1,2334.0,1715.0,0.735,11.095,0,0,0,0,0,0,0,0,0.0,0.0
1001,149,23-09-2019 16:36:00,1,2354.0,1681.0,0.714,11.135,55,22,8,14,33,3,30,1,0.0,0.0
1001,150,23-09-2019 16:38:00,1,2631.0,1918.0,0.729,12.489,67,34,19,15,33,5,28,7,0.0,0.0
1001,151,23-09-2019 16:40:00,1,2822.0,2118.0,0.751,13.462,160,88,56,32,72,51,21,13,0.0,0.0
1001,152,23-09-2019 16:42:00,1,3021.0,2224.0,0.736,14.364,290,195,146,49,95,60,35,17,0.0,0.01
1001,153,23-09-2019 16:44:00,1,3120.0,2297.5,0.7365,14.8355,92,61,42,19,31,8,23,7,0.0,0.0
1001,154,23-09-2019 16:46:00,1,3219.0,2371.0,0.737,15.307,8,8,2,6,0,0,0,0,0.0,0.0
1001,155,23-09-2019 16:48:00,1,3304.0,2458.0,0.744,15.741,41,19,4,15,22,1,21,0,0.0,0.0
1001,156,23-09-2019 16:50:00,1,3305.0,2418.0,0.731,15.7,135,105,66,39,30,14,16,9,0.0,0.0
1001,157,23-09-2019 16:52:00,1,3325.0,2407.0,0.724,15.765,79,67,38,29,12,1,11,33,0.01,0.0
1001,158,23-09-2019 16:54:00,1,2338.0,1702.0,0.728,11.094,104,68,27,41,36,7,29,0,0.0,0.0
1001,159,23-09-2019 16:56:00,1,3015.0,2171.0,0.72,14.285,226,173,118,55,53,24,29,1,0.0,0.0
1001,160,23-09-2019 16:58:00,1,3193.0,2356.0,0.738,15.187,184,116,81,35,68,45,23,13,0.0,0.0
1001,161,23-09-2019 17:00:00,1,3323.0,2397.0,0.721,15.747,39,29,13,16,10,2,8,3,0.0,0.0
1001,162,23-09-2019 17:02:00,1,3317.0,2441.0,0.736,15.771,35,9,0,9,26,0,26,0,0.0,0.0
1001,163,23-09-2019 17:04:00,1,3322.0,2427.0,0.731,15.775,22,8,4,4,14,2,12,2,0.0,0.0
1001,164,23-09-2019 17:06:00,1,3292.0,2474.0,0.751,15.709,7,7,2,5,0,0,0,0,0.0,0.0
1001,165,23-09-2019 17:08:00,1,3315.0,2436.0,0.735,15.76,2,1,0,1,1,1,0,0,0.0,0.0
1001,166,23-09-2019 17:10:00,1,3007.0,2206.0,0.734,14.29,0,0,0,0,0,0,0,0,0.0,0.0
1001,167,23-09-2019 17:12:00,1,2815.0,2100.0,0.746,13.416,0,0,0,0,0,0,0,0,0.0,0.0
1001,168,23-09-2019 17:14:00,1,2849.0,2008.0,0.705,13.448,0,0,0,0,0,0,0,0,0.0,0.0
1001,169,23-09-2019 17:16:00,1,2620.0,1898.0,0.725,12.423,13,10,4,6,3,0,3,0,0.0,0.0
1001,170,23-09-2019 17:18:00,1,2485.5,1778.5,0.7155,11.761,0,0,0,0,0,0,0,0,0.0,0.0
1001,171,23-09-2019 17:20:00,1,2351.0,1659.0,0.706,11.099,0,0,0,0,0,0,0,0,0.0,0.0
1001,172,23-09-2019 17:22:00,1,2359.0,1626.0,0.689,11.096,0,0,0,0,0,0,0,0,0.0,0.0
1001,173,23-09-2019 17:24:00,1,2362.0,1616.0,0.684,11.097,0,0,0,0,0,0,0,0,0.0,0.0
1001,174,23-09-2019 17:26:00,1,2257.0,1590.0,0.704,10.655,0,0,0,0,0,0,0,0,0.0,0.0
1001,175,23-09-2019 17:28:00,1,2257.0,1576.0,0.698,10.638,0,0,0,0,0,0,0,0,0.0,0.0
1001,176,23-09-2019 17:30:00,1,2261.0,1560.0,0.69,10.635,16,13,10,3,3,0,3,0,0.0,0.0
1001,177,23-09-2019 17:32:00,1,2363.0,1640.0,0.694,11.124,0,0,0,0,0,0,0,0,0.0,0.0
1001,178,23-09-2019 17:34:00,1,2341.0,1671.0,0.714,11.073,0,0,0,0,0,0,0,0,0.0,0.0
1001,179,23-09-2019 17:36:00,1,2350.0,1676.0,0.713,11.113,8,8,1,7,0,0,0,0,0.0,0.0
1001,180,23-09-2019 17:38:00,1,2358.0,1669.0,0.708,11.137,1,0,0,0,1,0,1,0,0.01,0.0
1001,181,23-09-2019 17:40:00,1,2352.0,1669.0,0.71,11.116,2,1,0,1,1,0,1,0,0.0,0.0
1001,182,23-09-2019 17:42:00,1,2361.0,1612.0,0.683,11.087,4,4,0,4,0,0,0,0,0.0,0.0
1001,183,23-09-2019 17:44:00,1,2361.0,1612.0,0.683,11.086,0,0,0,0,0,0,0,0,0.0,0.0
1001,184,23-09-2019 17:46:00,1,2370.0,1613.0,0.68,11.125,1,1,0,1,0,0,0,0,0.0,0.0
1001,185,23-09-2019 17:48:00,1,2364.0,1604.0,0.679,11.093,0,0,0,0,0,0,0,0,0.0,0.0
1001,186,23-09-2019 17:50:00,1,2365.0,1607.0,0.679,11.099,0,0,0,0,0,0,0,0,0.0,0.0
1001,187,23-09-2019 17:52:00,1,2356.0,1646.5,0.6985,11.1075,13,10,5,5,3,2,1,0,0.0,0.0
1001,188,23-09-2019 17:54:00,1,2347.0,1686.0,0.718,11.116,0,0,0,0,0,0,0,0,0.0,0.0
1001,189,23-09-2019 17:56:00,1,2337.0,1709.0,0.731,11.1,1,1,0,1,0,0,0,0,0.0,0.0
1001,190,23-09-2019 17:58:00,1,2449.0,1727.0,0.705,11.562,1,1,0,1,0,0,0,0,0.0,0.0
1001,191,23-09-2019 18:00:00,0,2446.0,1736.0,0.71,11.562,3,3,0,3,0,0,0,0,0.0,0.0
1001,192,23-09-2019 18:02:00,0,2559.0,1751.0,0.684,12.022,0,0,0,0,0,0,0,0,0.0,0.0
1001,193,23-09-2019 18:04:00,0,2334.0,1695.0,0.726,11.073,155,81,61,20,74,53,21,11,0.0,0.0
1001,194,23-09-2019 18:06:00,0,2648.0,1834.0,0.692,12.463,124,85,68,17,39,17,22,20,0.0,0.0
1001,195,23-09-2019 18:08:00,0,2811.0,2095.0,0.745,13.397,401,262,213,49,139,100,39,70,0.01,0.01
1001,196,23-09-2019 18:10:00,0,2990.0,2284.0,0.764,14.311,431,301,252,49,130,96,34,54,0.0,0.0
1001,197,23-09-2019 18:12:00,0,3316.0,2405.0,0.725,15.729,401,245,195,50,156,118,38,68,0.0,0.0
1001,198,23-09-2019 18:14:00,0,3297.0,2436.0,0.739,15.689,243,168,119,49,75,40,35,80,0.0,0.0
1001,199,23-09-2019 18:16:00,0,3526.0,2446.0,0.694,16.604,87,60,28,32,27,6,21,78,0.0,0.0
1001,200,23-09-2019 18:18:00,0,3702.0,2676.0,0.723,17.551,203,137,99,38,66,32,34,57,0.0,0.02
1001,201,23-09-2019 18:20:00,0,3299.0,2461.0,0.746,15.725,373,245,193,52,128,88,40,67,0.0,0.0
1001,202,23-09-2019 18:22:00,0,3689.0,2762.0,0.749,17.595,294,216,164,52,78,34,44,52,0.0,0.0
1001,203,23-09-2019 18:24:00,0,2995.0,2269.0,0.757,14.314,179,94,65,29,85,41,44,57,0.0,0.01
1001,204,23-09-2019 18:26:00,0,3565.0,2760.0,0.7715,17.1025,104,69,37,32,35,2,33,68,0.0,0.0
1001,205,23-09-2019 18:28:00,0,4135.0,3251.0,0.786,19.891,191,153,106,47,38,5,33,70,0.0,0.05
1001,206,23-09-2019 18:30:00,0,3844.0,2980.0,0.775,18.447,257,182,140,42,75,55,20,20,0.0,0.11
1001,207,23-09-2019 18:32:00,0,2967.0,2379.0,0.802,14.325,213,141,106,35,72,48,24,23,0.0,0.0
1001,208,23-09-2019 18:34:00,0,3550.0,2808.0,0.791,17.095,225,167,120,47,58,32,26,56,0.0,0.0
1001,209,23-09-2019 18:36:00,0,4144.0,3251.0,0.785,19.927,158,116,71,45,42,12,30,79,0.0,0.0
1001,210,23-09-2019 18:38:00,0,3909.0,3204.0,0.82,18.948,266,203,157,46,63,37,26,26,0.0,0.0
1001,211,23-09-2019 18:40:00,0,3247.0,2635.0,0.812,15.712,173,134,99,35,39,16,23,32,0.0,0.0
1001,212,23-09-2019 18:42:00,0,2857.0,2350.0,0.823,13.861,39,20,3,17,19,0,19,4,0.0,0.0
1001,213,23-09-2019 18:44:00,0,2703.0,2102.0,0.778,12.977,49,24,5,19,25,8,17,2,0.0,0.0
1001,214,23-09-2019 18:46:00,0,2587.0,2046.0,0.791,12.458,94,69,29,40,25,8,17,4,0.0,0.0
1001,215,23-09-2019 18:48:00,0,2807.0,2126.0,0.758,13.413,205,116,87,29,89,51,38,40,0.0,0.0
1001,216,23-09-2019 18:50:00,0,2985.0,2309.0,0.773,14.319,316,217,165,52,99,63,36,46,0.0,0.0
1001,217,23-09-2019 18:52:00,0,3526.0,2969.0,0.842,17.18,197,129,98,31,68,40,28,60,0.0,0.0
1001,218,23-09-2019 18:54:00,0,3605.0,3038.0,0.843,17.566,211,141,101,40,70,31,39,22,0.0,0.0
1001,219,23-09-2019 18:56:00,0,3209.0,2780.0,0.866,15.723,78,39,20,19,39,15,24,3,0.0,0.0
1001,220,23-09-2019 18:58:00,0,2971.0,2403.0,0.809,14.368,168,79,47,32,89,50,39,19,0.0,0.0
1001,221,23-09-2019 19:00:00,0,3296.0,2731.5,0.827,16.0105,207,158,116,42,49,24,25,19,0.0,0.01
1001,222,23-09-2019 19:02:00,0,3621.0,3060.0,0.845,17.653,5,2,1,1,3,1,2,0,0.0,0.0
1001,223,23-09-2019 19:04:00,0,2943.0,2539.0,0.863,14.407,0,0,0,0,0,0,0,0,0.0,0.0
1001,224,23-09-2019 19:06:00,0,2968.0,2418.0,0.815,14.371,14,11,0,11,3,1,2,0,0.0,0.0
1001,225,23-09-2019 19:08:00,0,2755.0,2352.0,0.854,13.461,2,0,0,0,2,1,1,0,0.0,0.0
1001,226,23-09-2019 19:10:00,0,2770.0,2297.0,0.829,13.457,14,6,2,4,8,0,8,0,0.0,0.0
1001,227,23-09-2019 19:12:00,0,2784.0,2260.0,0.812,13.473,5,2,0,2,3,0,3,0,0.0,0.0
1001,228,23-09-2019 19:14:00,0,2787.0,2223.0,0.798,13.443,2,0,0,0,2,0,2,0,0.0,0.0
1001,229,23-09-2019 19:16:00,0,2675.0,2185.0,0.817,12.959,190,119,92,27,71,40,31,25,0.0,0.0
1001,230,23-09-2019 19:18:00,0,2948.0,2480.0,0.841,14.361,287,204,149,55,83,43,40,39,0.0,0.0
1001,231,23-09-2019 19:20:00,0,3039.0,2567.0,0.845,14.818,104,79,30,49,25,4,21,93,0.0,0.0
1001,232,23-09-2019 19:22:00,0,4256.0,3751.0,0.881,20.92,91,78,41,37,13,0,13,86,0.0,0.05
1001,233,23-09-2019 19:24:00,0,4339.0,3853.0,0.888,21.362,359,227,175,52,132,95,37,30,0.0,0.08
1001,234,23-09-2019 19:26:00,0,3769.0,3332.0,0.884,18.539,223,147,124,23,76,46,30,33,0.02,0.0
1001,235,23-09-2019 19:28:00,0,3223.0,2695.0,0.836,15.682,250,192,144,48,58,34,24,77,0.0,0.0
1001,236,23-09-2019 19:30:00,0,4072.0,3564.0,0.875,19.99,92,61,26,35,31,4,27,79,0.0,0.0
1001,237,23-09-2019 19:32:00,0,4493.0,4048.0,0.901,22.185,124,96,52,44,28,2,26,78,0.0,0.01
1001,238,23-09-2019 19:34:00,0,3936.0,3542.5,0.9,19.43,293,198,146,52,95,59,36,33,0.0,0.08
1001,239,23-09-2019 19:36:00,0,3379.0,3037.0,0.899,16.675,361,227,186,41,134,90,44,59,0.0,0.0
1001,240,23-09-2019 19:38:00,0,3408.0,2902.0,0.852,16.641,134,94,71,23,40,18,22,7,0.0,0.0
1001,241,23-09-2019 19:40:00,0,2940.0,2471.0,0.84,14.319,192,118,92,26,74,45,29,37,0.0,0.0
1001,242,23-09-2019 19:42:00,0,3582.0,3180.0,0.888,17.633,49,34,7,27,15,1,14,1,0.0,0.0
1001,243,23-09-2019 19:44:00,0,2950.0,2480.0,0.841,14.367,67,28,15,13,39,18,21,5,0.0,0.0
1001,244,23-09-2019 19:46:00,0,2964.0,2455.0,0.828,14.396,99,38,26,12,61,23,38,11,0.0,0.0
1001,245,23-09-2019 19:48:00,0,2970.0,2429.0,0.818,14.39,274,157,116,41,117,65,52,12,0.0,0.0
1001,246,23-09-2019 19:50:00,0,3130.0,2701.0,0.863,15.32,208,126,94,32,82,45,37,18,0.0,0.0
1001,247,23-09-2019 19:52:00,0,3307.0,2883.0,0.872,16.221,55,27,14,13,28,12,16,3,0.0,0.01
1001,248,23-09-2019 19:54:00,0,2920.0,2596.0,0.889,14.377,50,36,11,25,14,7,7,1,0.0,0.0
1001,249,23-09-2019 19:56:00,0,2938.0,2528.0,0.86,14.373,38,28,8,20,10,0,10,1,0.0,0.0
1001,250,23-09-2019 19:58:00,0,2928.0,2582.0,0.882,14.396,3,1,0,1,2,1,1,0,0.0,0.0
1001,251,23-09-2019 20:00:00,0,3248.0,2702.0,0.832,15.787,7,3,1,2,4,0,4,0,0.0,0.0
1001,252,23-09-2019 20:02:00,0,3024.0,2653.0,0.877,14.853,2,0,0,0,2,0,2,0,0.0,0.0
1001,253,23-09-2019 20:04:00,0,2930.0,2576.0,0.879,14.396,14,3,0,3,11,0,11,0,0.0,0.0
1001,254,23-09-2019 20:06:00,0,2931.0,2524.0,0.861,14.343,4,2,0,2,2,0,2,0,0.0,0.0
1001,255,23-09-2019 20:08:00,0,2839.5,2446.0,0.8615,13.8955,0,0,0,0,0,0,0,0,0.0,0.0
1001,256,23-09-2019 20:10:00,0,2748.0,2368.0,0.862,13.448,0,0,0,0,0,0,0,0,0.0,0.01
1001,257,23-09-2019 20:12:00,0,2756.0,2352.0,0.853,13.461,3,0,0,0,3,0,3,0,0.0,0.0
1001,258,23-09-2019 20:14:00,0,2765.0,2314.0,0.837,13.458,26,18,4,14,8,1,7,0,0.0,0.0
1001,259,23-09-2019 20:16:00,0,2654.0,2273.0,0.857,12.971,324,276,213,63,48,21,27,38,0.0,0.0
1001,260,23-09-2019 20:18:00,0,3292.0,2947.0,0.895,16.235,183,136,84,52,47,19,28,78,0.0,0.0
1001,261,23-09-2019 20:20:00,0,4013.0,3760.0,0.937,19.973,75,60,26,34,15,0,15,59,0.0,0.0
1001,262,23-09-2019 20:22:00,0,4326.0,3900.0,0.902,21.363,197,136,92,44,61,30,31,46,0.0,0.0
1001,263,23-09-2019 20:24:00,0,3759.0,3426.0,0.912,18.603,380,247,190,57,133,87,46,31,0.0,0.13
1001,264,23-09-2019 20:26:00,0,3828.0,3497.0,0.914,18.953,171,95,62,33,76,45,31,20,0.0,0.0
1001,265,23-09-2019 20:28:00,0,2924.0,2585.0,0.884,14.383,126,95,57,38,31,6,25,67,0.0,0.0
1001,266,23-09-2019 20:30:00,0,4202.0,3866.0,0.92,20.834,79,64,37,27,15,0,15,67,0.0,0.06
1001,267,23-09-2019 20:32:00,0,4469.0,4261.0,0.953,22.323,220,158,115,43,62,40,22,45,0.0,0.0
1001,268,23-09-2019 20:34:00,0,3997.0,3827.0,0.958,19.984,272,200,159,41,72,42,30,3,0.0,0.06
1001,269,23-09-2019 20:36:00,0,3357.0,3149.0,0.938,16.712,100,82,71,11,18,7,11,0,0.0,0.0
1001,270,23-09-2019 20:38:00,0,2932.0,2575.0,0.878,14.402,3,3,2,1,0,0,0,0,0.0,0.0
1001,271,23-09-2019 20:40:00,0,2934.0,2529.0,0.862,14.361,13,13,2,11,0,0,0,0,0.0,0.01
1001,272,23-09-2019 20:42:00,0,2830.5,2473.0,0.874,13.8905,6,4,0,4,2,1,1,0,0.0,0.0
1001,273,23-09-2019 20:44:00,0,2727.0,2417.0,0.886,13.42,2,0,0,0,2,0,2,0,0.0,0.0
1001,274,23-09-2019 20:46:00,0,2728.0,2430.0,0.891,13.439,2,0,0,0,2,0,2,0,0.0,0.0
1001,275,23-09-2019 20:48:00,0,2732.0,2417.0,0.885,13.439,1,0,0,0,1,0,1,0,0.0,0.0
1001,276,23-09-2019 20:50:00,0,2725.0,2404.0,0.882,13.397,35,19,11,8,16,8,8,2,0.0,0.0
1001,277,23-09-2019 20:52:00,0,2650.0,2304.0,0.869,12.993,4,4,1,3,0,0,0,0,0.0,0.0
1001,278,23-09-2019 20:54:00,0,2763.0,2332.0,0.844,13.47,1,1,0,1,0,0,0,0,0.0,0.0
1001,279,23-09-2019 20:56:00,0,2535.0,2310.0,0.911,12.546,12,12,8,4,0,0,0,0,0.0,0.0
1001,280,23-09-2019 20:58:00,0,2523.0,2297.0,0.91,12.483,0,0,0,0,0,0,0,0,0.0,0.0
1001,281,23-09-2019 21:00:00,0,2537.0,2295.0,0.905,12.537,171,94,64,30,77,40,37,9,0.0,0.0
1001,282,23-09-2019 21:02:00,0,2568.0,2121.0,0.826,12.465,220,174,131,43,46,20,26,42,0.0,0.0
1001,283,23-09-2019 21:04:00,0,3793.0,3633.0,0.958,18.965,412,291,231,60,121,80,41,42,0.0,0.01
1001,284,23-09-2019 21:06:00,0,3332.0,3197.0,0.96,16.668,278,188,142,46,90,67,23,35,0.0,0.0
1001,285,23-09-2019 21:08:00,0,2868.0,2777.0,0.968,14.377,219,120,85,35,99,67,32,20,0.0,0.0
1001,286,23-09-2019 21:10:00,0,3365.0,3119.0,0.927,16.712,96,70,29,41,26,0,26,89,0.01,0.03
1001,287,23-09-2019 21:12:00,0,4347.0,4173.0,0.96,21.748,55,47,16,31,8,0,8,60,0.0,0.04
1001,288,23-09-2019 21:14:00,0,4266.0,4109.0,0.963,21.358,219,141,95,46,78,51,27,44,0.0,0.07
1001,289,23-09-2019 21:16:00,0,3537.0,3344.5,0.941,17.6395,199,106,69,37,93,52,41,22,0.0,0.0
1001,290,23-09-2019 21:18:00,0,2808.0,2580.0,0.919,13.921,155,70,42,28,85,51,34,5,0.0,0.01
1001,291,23-09-2019 21:20:00,0,2705.0,2519.0,0.931,13.446,145,92,62,30,53,32,21,13,0.0,0.0
1001,292,23-09-2019 21:22:00,0,2837.0,2488.0,0.877,13.933,214,119,86,33,95,70,25,34,0.0,0.01
1001,293,23-09-2019 21:24:00,0,3351.0,3161.0,0.943,16.701,302,166,121,45,136,89,47,28,0.0,0.0
1001,294,23-09-2019 21:26:00,0,3546.0,3333.0,0.94,17.659,116,92,60,32,24,4,20,58,0.0,0.0
1001,295,23-09-2019 21:28:00,0,4248.0,4115.0,0.969,21.291,96,80,43,37,16,1,15,43,0.0,0.16
1001,296,23-09-2019 21:30:00,0,4456.0,4232.0,0.95,22.242,104,69,45,24,35,13,22,11,0.0,0.0
1001,297,23-09-2019 21:32:00,0,3162.0,2979.0,0.942,15.756,116,76,51,25,40,26,14,13,0.0,0.0
1001,298,23-09-2019 21:34:00,0,2694.0,2510.0,0.932,13.394,100,79,46,33,21,12,9,4,0.0,0.0
1001,299,23-09-2019 21:36:00,0,2716.0,2508.0,0.923,13.479,173,119,74,45,54,28,26,29,0.0,0.0
1001,300,23-09-2019 21:38:00,0,2935.0,2591.0,0.883,14.432,342,228,175,53,114,79,35,35,0.0,0.0
1001,301,23-09-2019 21:40:00,0,4150.0,4009.0,0.966,20.79,113,60,38,22,53,29,24,6,0.0,0.0
1001,302,23-09-2019 21:42:00,0,3202.0,2874.0,0.898,15.799,78,41,23,18,37,21,16,0,0.0,0.0
1001,303,23-09-2019 21:44:00,0,2706.0,2516.0,0.93,13.446,115,63,34,29,52,22,30,10,0.0,0.0
1001,304,23-09-2019 21:46:00,0,2902.0,2681.0,0.924,14.4,48,35,13,22,13,1,12,2,0.0,0.0
1001,305,23-09-2019 21:48:00,0,3283.0,3005.0,0.915,16.263,51,24,8,16,27,9,18,1,0.0,0.0
1001,306,23-09-2019 21:50:00,0,2997.5,2748.5,0.917,14.853,4,2,1,1,2,0,2,0,0.0,0.0
1001,307,23-09-2019 21:52:00,0,2712.0,2492.0,0.919,13.443,5,2,1,1,3,0,3,0,0.0,0.0
1001,308,23-09-2019 21:54:00,0,2743.0,2329.0,0.849,13.385,23,20,0,20,3,0,3,0,0.0,0.0
1001,309,23-09-2019 21:56:00,0,2650.0,2301.0,0.868,12.989,31,28,6,22,3,1,2,0,0.0,0.0
1001,310,23-09-2019 21:58:00,0,2543.0,2285.0,0.899,12.547,4,1,1,0,3,0,3,0,0.0,0.0
1001,311,23-09-2019 22:00:00,0,2537.0,2295.0,0.904,12.537,8,4,0,4,4,0,4,0,0.0,0.0
1001,312,23-09-2019 22:02:00,0,2555.0,2239.0,0.876,12.546,9,4,0,4,5,0,5,0,0.0,0.0
1001,313,23-09-2019 22:04:00,0,2556.0,2238.0,0.876,12.55,14,5,2,3,9,0,9,0,0.0,0.0
1001,314,23-09-2019 22:06:00,0,2554.0,2218.0,0.868,12.516,17,8,0,8,9,0,9,0,0.0,0.0
1001,315,23-09-2019 22:08:00,0,2548.0,2253.0,0.884,12.535,13,10,0,10,3,0,3,0,0.0,0.0
1001,316,23-09-2019 22:10:00,0,2546.0,2215.0,0.87,12.484,11,5,0,5,6,0,6,0,0.0,0.0
1001,317,23-09-2019 22:12:00,0,2554.0,2224.0,0.871,12.526,13,10,0,10,3,0,3,0,0.01,0.0
1001,318,23-09-2019 22:14:00,0,2557.0,2206.0,0.863,12.517,111,70,46,24,41,19,22,11,0.0,0.0
1001,319,23-09-2019 22:16:00,0,3439.0,3253.0,0.946,17.151,214,133,91,42,81,51,30,46,0.0,0.0
1001,320,23-09-2019 22:18:00,0,3494.0,3468.0,0.992,17.606,148,101,74,27,47,27,20,20,0.0,0.0
1001,321,23-09-2019 22:20:00,0,3314.0,3242.0,0.978,16.647,236,150,116,34,86,47,39,33,0.0,0.0
1001,322,23-09-2019 22:22:00,0,3771.0,3811.0,1.011,19.077,288,192,142,50,96,74,22,38,0.0,0.0
1001,323,23-09-2019 22:24:00,0,3869.0,3872.5,1.0015,19.5315,95,72,42,30,23,2,21,53,0.0,0.0
1001,324,23-09-2019 22:26:00,0,3967.0,3934.0,0.992,19.986,76,54,15,39,22,0,22,101,0.0,0.0
1001,325,23-09-2019 22:28:00,0,4268.0,4138.0,0.97,21.395,48,36,12,24,12,0,12,69,0.0,0.35
1001,326,23-09-2019 22:30:00,0,3963.0,3945.0,0.996,19.981,21,19,2,17,2,0,2,2,0.0,0.02
1001,327,23-09-2019 22:32:00,0,3805.0,3691.0,0.97,19.079,364,259,202,57,105,72,33,29,0.0,0.01
1001,328,23-09-2019 22:34:00,0,3413.0,3347.0,0.981,17.152,233,166,124,42,67,35,32,16,0.0,0.0
1001,329,23-09-2019 22:36:00,0,2857.0,2806.0,0.982,14.362,56,32,16,16,24,8,16,6,0.0,0.0
1001,330,23-09-2019 22:38:00,0,2519.0,2318.0,0.92,12.492,224,134,94,40,90,65,25,19,0.0,0.0
1001,331,23-09-2019 22:40:00,0,3345.0,3153.0,0.943,16.669,225,153,110,43,72,46,26,21,0.0,0.0
1001,332,23-09-2019 22:42:00,0,3258.0,3044.0,0.934,16.206,223,140,97,43,83,53,30,2,0.0,0.0
1001,333,23-09-2019 22:44:00,0,3533.0,3309.0,0.937,17.583,137,65,35,30,72,35,37,5,0.0,0.0
1001,334,23-09-2019 22:46:00,0,2879.0,2755.0,0.957,14.394,45,24,3,21,21,2,19,0,0.0,0.0
1001,335,23-09-2019 22:48:00,0,3171.0,2966.0,0.935,15.777,108,48,25,23,60,40,20,21,0.0,0.0
1001,336,23-09-2019 22:50:00,0,3995.0,3855.0,0.965,20.007,144,82,52,30,62,43,19,0,0.0,0.0
1001,337,23-09-2019 22:52:00,0,3534.0,3395.0,0.961,17.682,229,138,91,47,91,57,34,14,0.0,0.0
1001,338,23-09-2019 22:54:00,0,4243.0,4154.0,0.979,21.316,119,77,54,23,42,21,21,12,0.0,0.0
1001,339,23-09-2019 22:56:00,0,3775.0,3725.0,0.987,18.999,49,26,14,12,23,15,8,8,0.0,0.0
1001,340,23-09-2019 22:58:00,0,3651.0,3562.5,0.9755,18.33,5,4,2,2,1,1,0,0,0.0,0.0
1001,341,23-09-2019 23:00:00,0,3527.0,3400.0,0.964,17.661,0,0,0,0,0,0,0,0,0.0,0.0
1001,342,23-09-2019 23:02:00,0,3528.0,3371.0,0.955,17.631,30,19,8,11,11,4,7,0,0.0,0.0
1001,343,23-09-2019 23:04:00,0,3523.0,3356.0,0.953,17.594,5,1,1,0,4,1,3,0,0.0,0.0
1001,344,23-09-2019 23:06:00,0,3352.0,3141.0,0.937,16.683,4,3,2,1,1,0,1,0,0.0,0.0
1001,345,23-09-2019 23:08:00,0,3157.0,2974.0,0.942,15.732,0,0,0,0,0,0,0,0,0.0,0.0
1001,346,23-09-2019 23:10:00,0,3176.0,2899.0,0.913,15.722,71,32,18,14,39,26,13,5,0.0,0.0
1001,347,23-09-2019 23:12:00,0,3154.0,2991.0,0.948,15.74,238,164,119,45,74,41,33,36,0.0,0.0
1001,348,23-09-2019 23:14:00,0,3149.0,3048.0,0.968,15.782,98,60,41,19,38,25,13,10,0.0,0.0
1001,349,23-09-2019 23:16:00,0,3355.0,3124.0,0.931,16.678,164,95,63,32,69,48,21,16,0.0,0.01
1001,350,23-09-2019 23:18:00,0,3346.0,3203.0,0.957,16.73,271,190,132,58,81,44,37,11,0.0,0.0
1001,351,23-09-2019 23:20:00,0,3333.0,3207.0,0.962,16.68,72,27,14,13,45,12,33,1,0.0,0.0
1001,352,23-09-2019 23:22:00,0,3323.0,3238.0,0.974,16.676,57,26,6,20,31,15,16,4,0.0,0.0
1001,353,23-09-2019 23:24:00,0,3344.0,3148.0,0.941,16.66,18,2,0,2,16,5,11,0,0.0,0.0
1001,354,23-09-2019 23:26:00,0,3154.0,3032.0,0.962,15.782,3,3,2,1,0,0,0,0,0.0,0.0
1001,355,23-09-2019 23:28:00,0,3174.0,2975.0,0.938,15.798,11,11,6,5,0,0,0,0,0.0,0.0
1001,356,23-09-2019 23:30:00,0,2855.0,2843.0,0.996,14.398,1,1,0,1,0,0,0,0,0.0,0.0
1001,357,23-09-2019 23:32:00,0,2815.5,2752.0,0.9775,14.141,2,1,0,1,1,1,0,0,0.0,0.0
1001,358,23-09-2019 23:34:00,0,2776.0,2661.0,0.959,13.884,10,7,2,5,3,0,3,0,0.0,0.0
1001,359,23-09-2019 23:36:00,0,2683.0,2586.0,0.964,13.432,14,12,5,7,2,0,2,0,0.0,0.0
1001,360,23-09-2019 23:38:00,0,2705.0,2521.0,0.932,13.447,47,21,15,6,26,13,13,0,0.0,0.0
1001,361,23-09-2019 23:40:00,0,2720.0,2457.0,0.903,13.439,137,85,61,24,52,29,23,26,0.0,0.0
1001,362,23-09-2019 23:42:00,0,2678.0,2627.0,0.981,13.461,115,58,42,16,57,25,32,13,0.0,0.0
1001,363,23-09-2019 23:44:00,0,2857.0,2834.0,0.992,14.392,155,111,82,29,44,13,31,7,0.0,0.0
1001,364,23-09-2019 23:46:00,0,2855.0,2845.0,0.996,14.4,132,85,48,37,47,19,28,9,0.0,0.0
1001,365,23-09-2019 23:48:00,0,3161.0,2971.0,0.94,15.743,42,23,7,16,19,10,9,2,0.0,0.0
1001,366,23-09-2019 23:50:00,0,3064.0,2949.0,0.962,15.336,17,15,0,15,2,0,2,0,0.0,0.0
1001,367,23-09-2019 23:52:00,0,2843.0,2855.0,1.004,14.362,1,1,0,1,0,0,0,0,0.0,0.0
1001,368,23-09-2019 23:54:00,0,2867.0,2787.0,0.972,14.379,8,6,3,3,2,1,1,0,0.0,0.0
1001,369,23-09-2019 23:56:00,0,2892.0,2722.0,0.941,14.408,0,0,0,0,0,0,0,0,0.0,0.0
1001,370,23-09-2019 23:58:00,0,2677.0,2623.0,0.98,13.451,44,26,21,5,18,10,8,0,0.0,0.0
1001,371,24-09-2019 00:00:00,0,2708.0,2507.0,0.926,13.446,17,13,3,10,4,0,4,0,0.0,0.0
1001,372,24-09-2019 00:02:00,0,2888.0,2743.0,0.95,14.413,203,142,96,46,61,36,25,19,0.0,0.0
1001,373,24-09-2019 00:04:00,0,2890.0,2727.0,0.943,14.407,91,68,36,32,23,3,20,28,0.0,0.0
1001,374,24-09-2019 00:06:00,0,2880.5,2750.0,0.9545,14.395,131,62,44,18,69,26,43,1,0.0,0.0
1001,375,24-09-2019 00:08:00,0,2871.0,2773.0,0.966,14.383,29,18,3,15,11,2,9,1,0.01,0.0
1001,376,24-09-2019 00:10:00,0,2853.0,2822.0,0.989,14.363,259,139,93,46,120,84,36,11,0.0,0.0
1001,377,24-09-2019 00:12:00,0,2959.0,2876.0,0.972,14.841,144,102,71,31,42,18,24,13,0.0,0.0
1001,378,24-09-2019 00:14:00,0,3057.0,2906.0,0.95,15.263,15,11,5,6,4,0,4,0,0.0,0.0
1001,379,24-09-2019 00:16:00,0,2852.0,2825.0,0.99,14.365,224,165,119,46,59,37,22,57,0.0,0.0
1001,380,24-09-2019 00:18:00,0,2846.0,2872.0,1.009,14.394,170,141,86,55,29,2,27,71,0.0,0.0
1001,381,24-09-2019 00:20:00,0,3158.0,2979.0,0.943,15.74,78,51,32,19,27,15,12,4,0.0,0.0
1001,382,24-09-2019 00:22:00,0,2534.0,2295.0,0.906,12.525,224,145,109,36,79,49,30,13,0.0,0.0
1001,383,24-09-2019 00:24:00,0,2877.0,2751.0,0.956,14.379,130,100,63,37,30,6,24,89,0.0,0.0
1001,384,24-09-2019 00:26:00,0,3541.0,3281.0,0.927,17.584,176,127,87,40,49,11,38,74,0.0,0.02
1001,385,24-09-2019 00:28:00,0,3368.0,3131.0,0.93,16.737,132,98,54,44,34,3,31,80,0.0,0.0
1001,386,24-09-2019 00:30:00,0,3832.0,3589.0,0.936,19.072,277,221,165,56,56,39,17,29,0.0,0.1
1001,387,24-09-2019 00:32:00,0,2987.0,2789.0,0.934,14.855,132,88,68,20,44,33,11,16,0.0,0.0
1001,388,24-09-2019 00:34:00,0,2335.0,2152.0,0.921,11.584,1,1,1,0,0,0,0,0,0.0,0.0
1001,389,24-09-2019 00:36:00,0,2063.0,1876.0,0.909,10.206,65,41,20,21,24,18,6,2,0.0,0.0
1001,390,24-09-2019 00:38:00,0,1881.0,1673.0,0.89,9.263,40,22,11,11,18,7,11,0,0.0,0.0
1001,391,24-09-2019 00:40:00,0,2026.5,1778.5,0.8785,9.9535,0,0,0,0,0,0,0,0,0.0,0.0
1001,392,24-09-2019 00:42:00,0,2172.0,1884.0,0.867,10.644,37,13,9,4,24,16,8,1,0.0,0.0
1001,393,24-09-2019 00:44:00,0,2281.0,1913.0,0.839,11.106,1,0,0,0,1,0,1,0,0.0,0.0
1001,394,24-09-2019 00:46:00,0,2563.0,2186.0,0.853,12.517,7,2,1,1,5,1,4,0,0.0,0.0
1001,395,24-09-2019 00:48:00,0,3066.0,2894.0,0.944,15.285,1,0,0,0,1,0,1,0,0.0,0.0
1001,396,24-09-2019 00:50:00,0,3065.0,2944.0,0.961,15.336,1,0,0,0,1,0,1,0,0.0,0.0
1001,397,24-09-2019 00:52:00,0,2958.0,2881.0,0.974,14.842,2,0,0,0,2,1,1,0,0.0,0.0
1001,398,24-09-2019 00:54:00,0,3175.0,2947.0,0.928,15.772,106,57,41,16,49,24,25,12,0.0,0.0
1001,399,24-09-2019 00:56:00,0,3163.0,3034.0,0.959,15.822,169,131,93,38,38,21,17,36,0.0,0.0
1001,400,24-09-2019 00:58:00,0,3152.0,3004.0,0.953,15.746,222,155,118,37,67,35,32,38,0.0,0.0
1001,401,24-09-2019 01:00:00,0,3345.0,3176.0,0.949,16.696,12,2,1,1,10,3,7,0,0.0,0.0
1001,402,24-09-2019 01:02:00,0,3069.0,2952.0,0.962,15.359,3,2,0,2,1,0,1,0,0.0,0.0
1001,403,24-09-2019 01:04:00,0,3169.0,2939.0,0.927,15.739,4,3,2,1,1,0,1,0,0.0,0.0
1001,404,24-09-2019 01:06:00,0,3067.0,2929.0,0.955,15.328,0,0,0,0,0,0,0,0,0.0,0.0
1001,405,24-09-2019 01:08:00,0,2850.0,2835.0,0.995,14.366,14,6,4,2,8,1,7,0,0.0,0.0
1001,406,24-09-2019 01:10:00,0,2885.0,2734.0,0.948,14.393,39,21,10,11,18,9,9,4,0.0,0.0
1001,407,24-09-2019 01:12:00,0,2860.0,2812.0,0.983,14.381,247,175,117,58,72,44,28,24,0.0,0.0
1001,408,24-09-2019 01:14:00,0,3016.0,2886.5,0.9585,15.0775,88,66,24,42,22,4,18,84,0.0,0.0
1001,409,24-09-2019 01:16:00,0,3172.0,2961.0,0.934,15.774,227,174,127,47,53,27,26,73,0.0,0.0
1001,410,24-09-2019 01:18:00,0,3165.0,2939.0,0.929,15.724,244,158,118,40,86,53,33,71,0.0,0.0
1001,411,24-09-2019 01:20:00,0,2895.0,2695.0,0.931,14.388,285,222,173,49,63,41,22,30,0.0,0.0
1001,412,24-09-2019 01:22:00,0,2808.0,2624.0,0.935,13.969,361,234,181,53,127,83,44,26,0.0,0.0
1001,413,24-09-2019 01:24:00,0,3089.0,2834.0,0.917,15.31,170,130,88,42,40,7,33,71,0.0,0.0
1001,414,24-09-2019 01:26:00,0,3368.0,3139.0,0.932,16.745,245,184,137,47,61,37,24,13,0.0,0.01
1001,415,24-09-2019 01:28:00,0,2878.0,2730.0,0.949,14.361,185,118,79,39,67,42,25,6,0.0,0.0
1001,416,24-09-2019 01:30:00,0,2541.0,2291.0,0.902,12.547,46,13,7,6,33,8,25,0,0.0,0.0
1001,417,24-09-2019 01:32:00,0,2357.0,2040.0,0.865,11.545,113,86,55,31,27,16,11,28,0.01,0.0
1001,418,24-09-2019 01:34:00,0,3381.0,3051.0,0.902,16.7,224,149,114,35,75,43,32,24,0.0,0.0
1001,419,24-09-2019 01:36:00,0,3179.0,2943.0,0.926,15.785,127,95,60,35,32,11,21,2,0.0,0.0
1001,420,24-09-2019 01:38:00,0,3293.0,2961.0,0.899,16.253,129,104,61,43,25,8,17,6,0.0,0.0
1001,421,24-09-2019 01:40:00,0,3103.0,2776.0,0.895,15.299,270,186,147,39,84,58,26,22,0.0,0.0
1001,422,24-09-2019 01:42:00,0,3202.0,2895.0,0.904,15.82,24,4,1,3,20,5,15,1,0.0,0.0
1001,423,24-09-2019 01:44:00,0,3365.0,3103.0,0.922,16.692,105,45,23,22,60,27,33,7,0.0,0.0
1001,424,24-09-2019 01:46:00,0,3534.0,3308.0,0.936,17.587,328,202,156,46,126,90,36,52,0.0,0.0
1001,425,24-09-2019 01:48:00,0,3502.5,3229.5,0.922,17.376,97,48,26,22,49,18,31,1,0.0,0.0
1001,426,24-09-2019 01:50:00,0,3471.0,3151.0,0.908,17.165,28,16,8,8,12,1,11,0,0.0,0.0
1001,427,24-09-2019 01:52:00,0,3584.0,3211.0,0.896,17.676,290,192,148,44,98,64,34,24,0.0,0.0
1001,428,24-09-2019 01:54:00,0,3477.0,3135.0,0.902,17.172,190,112,67,45,78,36,42,66,0.0,0.0
1001,429,24-09-2019 01:56:00,0,3673.0,3321.0,0.904,18.147,215,139,95,44,76,25,51,74,0.0,0.0
1001,430,24-09-2019 01:58:00,0,3573.0,3216.0,0.9,17.637,147,97,59,38,50,7,43,66,0.0,0.0
1001,431,24-09-2019 02:00:00,0,3759.0,3297.0,0.877,18.462,161,115,65,50,46,3,43,71,0.0,0.0
1001,432,24-09-2019 02:02:00,0,3871.0,3436.0,0.888,19.054,279,220,166,54,59,27,32,72,0.0,0.0
1001,433,24-09-2019 02:04:00,0,3863.0,3340.0,0.865,18.917,209,140,89,51,69,40,29,66,0.0,0.0
1001,434,24-09-2019 02:06:00,0,3430.0,2890.0,0.842,16.716,402,265,208,57,137,85,52,76,0.0,0.0
1001,435,24-09-2019 02:08:00,0,3676.0,3230.0,0.879,18.059,273,193,146,47,80,39,41,62,0.0,0.0
1001,436,24-09-2019 02:10:00,0,3587.0,3088.0,0.861,17.551,150,107,66,41,43,14,29,43,0.0,0.0
1001,437,24-09-2019 02:12:00,0,3606.0,3122.0,0.866,17.662,207,135,95,40,72,40,32,36,0.0,0.0
1001,438,24-09-2019 02:14:00,0,3896.0,3273.0,0.84,18.974,143,112,70,42,31,4,27,62,0.0,0.0
1001,439,24-09-2019 02:16:00,0,3884.0,3347.0,0.862,19.011,220,149,98,51,71,40,31,75,0.0,0.0
1001,440,24-09-2019 02:18:00,0,3976.0,3428.0,0.862,19.461,186,116,82,34,70,43,27,33,0.0,0.0
1001,441,24-09-2019 02:20:00,0,2905.0,2641.0,0.909,14.371,149,85,54,31,64,27,37,12,0.0,0.0
1001,442,24-09-2019 02:22:00,0,2929.5,2566.5,0.8765,14.3855,260,186,142,44,74,40,34,13,0.0,0.0
1001,443,24-09-2019 02:24:00,0,2954.0,2492.0,0.844,14.4,234,144,91,53,90,60,30,21,0.0,0.0
1001,444,24-09-2019 02:26:00,0,3393.0,2951.0,0.87,16.637,197,156,96,60,41,8,33,83,0.0,0.0
1001,445,24-09-2019 02:28:00,0,3568.0,3193.0,0.895,17.593,126,78,49,29,48,30,18,10,0.0,0.0
1001,446,24-09-2019 02:30:00,0,2762.0,2269.0,0.821,13.394,143,104,58,46,39,3,36,58,0.01,0.0
1001,447,24-09-2019 02:32:00,0,3878.0,3306.0,0.853,18.939,123,74,35,39,49,4,45,78,0.01,0.0
1001,448,24-09-2019 02:34:00,0,4149.0,3593.0,0.866,20.323,134,92,68,24,42,11,31,34,0.0,0.0
1001,449,24-09-2019 02:36:00,0,3224.0,2715.0,0.842,15.707,207,155,114,41,52,24,28,43,0.0,0.0
1001,450,24-09-2019 02:38:00,0,2924.0,2596.0,0.888,14.396,55,28,17,11,27,16,11,0,0.0,0.0
1001,451,24-09-2019 02:40:00,0,2787.0,2224.0,0.798,13.444,68,37,19,18,31,9,22,7,0.0,0.0
1001,452,24-09-2019 02:42:00,0,2669.0,2151.0,0.806,12.896,214,107,76,31,107,74,33,60,0.0,0.0
1001,453,24-09-2019 02:44:00,0,2768.0,2272.0,0.821,13.423,402,298,227,71,104,78,26,58,0.0,0.0
1001,454,24-09-2019 02:46:00,0,3224.0,2737.0,0.849,15.734,466,295,231,64,171,129,42,49,0.0,0.03
1001,455,24-09-2019 02:48:00,0,3419.0,2893.0,0.846,16.672,72,52,31,21,20,14,6,5,0.0,0.0
1001,456,24-09-2019 02:50:00,0,2981.0,2321.0,0.779,14.313,179,118,76,42,61,40,21,34,0.0,0.0
1001,457,24-09-2019 02:52:00,0,3891.0,3302.0,0.849,18.985,161,117,72,45,44,2,42,90,0.0,0.0
1001,458,24-09-2019 02:54:00,0,4072.0,3438.0,0.844,19.85,196,154,108,46,42,12,30,80,0.0,0.0
1001,459,24-09-2019 02:56:00,0,3903.0,3250.0,0.832,18.977,208,152,117,35,56,29,27,37,0.0,0.0
1001,460,24-09-2019 02:58:00,0,3734.0,3062.0,0.82,18.104,208,141,91,50,67,22,45,74,0.0,0.0
1001,461,24-09-2019 03:00:00,0,4183.0,3483.0,0.833,20.336,137,92,61,31,45,7,38,70,0.0,0.0
1001,462,24-09-2019 03:02:00,0,4279.0,3550.0,0.83,20.788,107,73,37,36,34,2,32,77,0.0,0.0
1001,463,24-09-2019 03:04:00,0,4080.0,3444.0,0.844,19.889,167,120,82,38,47,15,32,97,0.0,0.0
1001,464,24-09-2019 03:06:00,0,4101.0,3441.0,0.839,19.97,128,103,74,29,25,4,21,16,0.0,0.0
1001,465,24-09-2019 03:08:00,0,4098.0,3472.0,0.847,19.99,116,79,44,35,37,7,30,71,0.0,0.02
1001,466,24-09-2019 03:10:00,0,4095.0,3465.0,0.846,19.97,153,102,85,17,51,29,22,16,0.0,0.0
1001,467,24-09-2019 03:12:00,0,3253.0,2627.0,0.808,15.724,229,154,114,40,75,49,26,27,0.0,0.02
1001,468,24-09-2019 03:14:00,0,3267.0,2589.0,0.793,15.737,211,137,96,41,74,47,27,5,0.0,0.0
1001,469,24-09-2019 03:16:00,0,2760.0,2256.0,0.818,13.372,213,139,94,45,74,36,38,70,0.0,0.0
1001,470,24-09-2019 03:18:00,0,3927.0,3207.0,0.817,19.023,94,60,48,12,34,20,14,10,0.0,0.0
1001,471,24-09-2019 03:20:00,0,2966.0,2443.0,0.824,14.393,102,79,70,9,23,15,8,4,0.0,0.0
1001,472,24-09-2019 03:22:00,0,2777.0,2287.0,0.824,13.473,242,143,105,38,99,63,36,24,0.0,0.0
1001,473,24-09-2019 03:24:00,0,3268.0,2629.0,0.805,15.786,282,177,132,45,105,67,38,38,0.0,0.0
1001,474,24-09-2019 03:26:00,0,2974.0,2388.0,0.803,14.361,280,205,153,52,75,41,34,45,0.0,0.0
1001,475,24-09-2019 03:28:00,0,3440.0,2850.0,0.829,16.709,96,56,27,29,40,19,21,0,0.0,0.0
1001,476,24-09-2019 03:30:00,0,3447.5,2824.0,0.8195,16.709,215,139,101,38,76,39,37,37,0.0,0.0
1001,477,24-09-2019 03:32:00,0,3455.0,2798.0,0.81,16.709,134,76,54,22,58,28,30,48,0.0,0.0
1001,478,24-09-2019 03:34:00,0,3620.0,3039.0,0.839,17.627,208,155,109,46,53,12,41,74,0.0,0.0
1001,479,24-09-2019 03:36:00,0,4100.0,3389.0,0.827,19.904,124,83,46,37,41,2,39,47,0.0,0.0
1001,480,24-09-2019 03:38:00,0,4100.0,3346.0,0.816,19.858,165,123,90,33,42,9,33,59,0.0,0.0
1001,481,24-09-2019 03:40:00,0,3888.0,3304.0,0.85,18.979,148,105,74,31,43,20,23,39,0.0,0.0
1001,482,24-09-2019 03:42:00,0,3898.0,3329.0,0.854,19.043,157,105,78,27,52,26,26,31,0.0,0.04
1001,483,24-09-2019 03:44:00,0,3704.0,3092.0,0.835,18.016,192,141,95,46,51,19,32,89,0.0,0.0
1001,484,24-09-2019 03:46:00,0,4065.0,3543.0,0.872,19.937,184,85,64,21,99,73,26,1,0.0,0.0
1001,485,24-09-2019 03:48:00,0,3328.0,2780.0,0.835,16.189,37,11,3,8,26,3,23,0,0.0,0.0
1001,486,24-09-2019 03:50:00,0,2950.0,2421.0,0.821,14.305,12,9,3,6,3,0,3,0,0.0,0.0
1001,487,24-09-2019 03:52:00,0,2792.0,2196.0,0.786,13.433,212,159,120,39,53,39,14,18,0.0,0.0
1001,488,24-09-2019 03:54:00,0,2867.0,2326.0,0.811,13.874,142,103,66,37,39,7,32,53,0.0,0.0
1001,489,24-09-2019 03:56:00,0,2931.0,2537.0,0.866,14.355,297,190,143,47,107,77,30,53,0.0,0.0
1001,490,24-09-2019 03:58:00,0,3037.0,2578.0,0.849,14.82,320,201,153,48,119,76,43,21,0.0,0.03
1001,491,24-09-2019 04:00:00,0,3224.0,2696.0,0.836,15.686,114,58,34,24,56,24,32,2,0.0,0.0
1001,492,24-09-2019 04:02:00,0,2782.0,2217.0,0.797,13.415,220,190,136,54,30,10,20,81,0.0,0.0
1001,493,24-09-2019 04:04:00,0,3332.5,2765.0,0.825,16.191,296,220,171,49,76,39,37,69,0.0,0.0
1001,494,24-09-2019 04:06:00,0,3883.0,3313.0,0.853,18.967,148,104,67,37,44,13,31,67,0.0,0.0
1001,495,24-09-2019 04:08:00,0,4183.0,3575.0,0.855,20.439,195,151,100,51,44,13,31,90,0.0,0.0
1001,496,24-09-2019 04:10:00,0,4055.0,3548.0,0.875,19.903,124,93,65,28,31,12,19,5,0.0,0.0
1001,497,24-09-2019 04:12:00,0,2964.0,2466.0,0.832,14.407,199,148,111,37,51,21,30,56,0.0,0.0
1001,498,24-09-2019 04:14:00,0,3636.0,3006.0,0.827,17.652,230,180,129,51,50,25,25,26,0.0,0.0
1001,499,24-09-2019 04:16:00,0,3231.0,2702.0,0.836,15.72,435,317,256,61,118,87,31,30,0.0,0.0
1001,500,24-09-2019 04:18:00,0,3243.0,2689.0,0.829,15.756,131,87,58,29,44,24,20,11,0.0,0.0
1001,501,24-09-2019 04:20:00,0,2878.0,2356.0,0.818,13.948,14,4,1,3,10,7,3,0,0.0,0.0
1001,502,24-09-2019 04:22:00,0,2613.0,2016.0,0.772,12.528,0,0,0,0,0,0,0,0,0.0,0.0
1001,503,24-09-2019 04:24:00,0,2410.0,1867.0,0.775,11.564,2,2,1,1,0,0,0,0,0.0,0.0
1001,504,24-09-2019 04:26:00,0,2311.0,1829.0,0.791,11.13,1,1,0,1,0,0,0,0,0.0,0.0
1001,505,24-09-2019 04:28:00,0,2305.0,1800.0,0.781,11.073,23,15,10,5,8,5,3,0,0.0,0.0
1001,506,24-09-2019 04:30:00,0,2523.0,1885.0,0.747,12.029,0,0,0,0,0,0,0,0,0.0,0.0
1001,507,24-09-2019 04:32:00,0,2628.0,1955.0,0.744,12.519,198,177,150,27,21,13,8,0,0.0,0.0
1001,508,24-09-2019 04:34:00,0,2808.0,2144.0,0.763,13.439,22,21,2,19,1,0,1,0,0.0,0.0
1001,509,24-09-2019 04:36:00,0,2768.0,2301.0,0.831,13.455,225,222,177,45,3,0,3,0,0.0,0.0
1001,510,24-09-2019 04:38:00,0,2816.0,2324.0,0.8255,13.6685,215,211,180,31,4,0,4,0,0.0,0.0
1001,511,24-09-2019 04:40:00,0,2864.0,2347.0,0.82,13.882,241,166,120,46,75,50,25,22,0.0,0.0
1001,512,24-09-2019 04:42:00,0,2966.0,2415.0,0.814,14.362,306,220,167,53,86,63,23,54,0.0,0.0
1001,513,24-09-2019 04:44:00,0,2972.0,2372.0,0.798,14.335,196,134,97,37,62,41,21,22,0.0,0.0
1001,514,24-09-2019 04:46:00,0,2952.0,2474.0,0.838,14.369,203,133,99,34,70,37,33,44,0.0,0.0
1001,515,24-09-2019 04:48:00,0,3177.0,2496.0,0.786,15.282,100,66,40,26,34,7,27,40,0.0,0.0
1001,516,24-09-2019 04:50:00,0,2813.0,2135.0,0.759,13.447,80,52,24,28,28,10,18,0,0.0,0.0
1001,517,24-09-2019 04:52:00,0,2824.0,2093.0,0.741,13.446,176,120,92,28,56,41,15,17,0.0,0.0
1001,518,24-09-2019 04:54:00,0,3162.0,2511.0,0.794,15.238,209,108,77,31,101,64,37,13,0.0,0.0
1001,519,24-09-2019 04:56:00,0,3480.0,2674.0,0.768,16.671,147,100,74,26,47,32,15,14,0.0,0.0
1001,520,24-09-2019 04:58:00,0,3482.0,2681.0,0.77,16.689,147,125,80,45,22,8,14,78,0.0,0.0
1001,521,24-09-2019 05:00:00,0,3458.0,2746.0,0.794,16.666,148,106,74,32,42,15,27,40,0.0,0.0
1001,522,24-09-2019 05:02:00,0,3008.0,2248.0,0.747,14.339,218,116,75,41,102,63,39,5,0.0,0.0
1001,523,24-09-2019 05:04:00,0,2989.0,2310.0,0.773,14.335,119,87,57,30,32,7,25,6,0.0,0.09
1001,524,24-09-2019 05:06:00,0,3302.0,2457.0,0.744,15.733,246,175,123,52,71,40,31,5,0.0,0.0
1001,525,24-09-2019 05:08:00,0,3175.0,2468.0,0.777,15.242,386,264,211,53,122,88,34,53,0.01,0.0
1001,526,24-09-2019 05:10:00,0,3176.0,2470.0,0.778,15.249,34,17,9,8,17,5,12,0,0.0,0.0
1001,527,24-09-2019 05:12:00,0,3235.5,2447.0,0.757,15.458,80,33,8,25,47,10,37,1,0.0,0.0
1001,528,24-09-2019 05:14:00,0,3295.0,2424.0,0.736,15.667,189,112,78,34,77,41,36,14,0.0,0.0
1001,529,24-09-2019 05:16:00,0,3271.0,2582.0,0.789,15.747,152,94,58,36,58,22,36,1,0.0,0.0
1001,530,24-09-2019 05:18:00,0,3285.0,2499.0,0.761,15.711,188,126,95,31,62,42,20,57,0.0,0.0
1001,531,24-09-2019 05:20:00,0,3474.0,2651.0,0.763,16.624,150,103,49,54,47,2,45,106,0.0,0.0
1001,532,24-09-2019 05:22:00,0,3749.0,2943.0,0.785,18.029,175,123,70,53,52,2,50,80,0.0,0.0
1001,533,24-09-2019 05:24:00,0,3736.0,2979.0,0.797,18.018,204,136,94,42,68,23,45,54,0.0,0.0
1001,534,24-09-2019 05:26:00,0,3940.0,3150.0,0.8,19.01,208,150,98,52,58,13,45,83,0.0,0.0
1001,535,24-09-2019 05:28:00,0,3967.0,3079.0,0.776,19.037,196,125,81,44,71,30,41,56,0.0,0.0
1001,536,24-09-2019 05:30:00,0,3943.0,3075.0,0.78,18.941,358,229,184,45,129,87,42,54,0.0,0.0
1001,537,24-09-2019 05:32:00,0,2890.0,2244.0,0.777,13.87,249,169,127,42,80,56,24,26,0.0,0.0
1001,538,24-09-2019 05:34:00,0,3390.0,2576.0,0.76,16.21,294,197,153,44,97,55,42,53,0.0,0.0
1001,539,24-09-2019 05:36:00,0,3684.0,2803.0,0.761,17.618,150,104,68,36,46,6,40,77,0.0,0.0
1001,540,24-09-2019 05:38:00,0,3972.0,2974.0,0.749,18.943,109,63,38,25,46,9,37,70,0.0,0.0
1001,541,24-09-2019 05:40:00,0,3936.0,3082.0,0.783,18.921,269,171,115,56,98,36,62,82,0.0,0.0
1001,542,24-09-2019 05:42:00,0,4142.0,3296.0,0.796,19.969,113,79,48,31,34,10,24,64,0.0,0.01
1001,543,24-09-2019 05:44:00,0,3961.0,3081.0,0.778,19.017,141,98,58,40,43,9,34,68,0.0,0.0
1001,544,24-09-2019 05:46:00,0,4045.5,3202.0,0.7915,19.484,290,208,151,57,82,38,44,72,0.0,0.0
1001,545,24-09-2019 05:48:00,0,4130.0,3323.0,0.805,19.951,108,68,41,27,40,3,37,69,0.0,0.0
1001,546,24-09-2019 05:50:00,0,4127.0,3308.0,0.802,19.923,133,80,50,30,53,10,43,48,0.0,0.0
1001,547,24-09-2019 05:52:00,0,4138.0,3286.0,0.794,19.944,167,97,63,34,70,34,36,46,0.0,0.0
1001,548,24-09-2019 05:54:00,0,3859.0,3003.0,0.778,18.529,269,182,138,44,87,55,32,20,0.0,0.0
1001,549,24-09-2019 05:56:00,0,3263.0,2579.0,0.791,15.711,190,119,84,35,71,41,30,12,0.0,0.0
1001,550,24-09-2019 05:58:00,0,2991.0,2331.0,0.779,14.367,164,120,78,42,44,19,25,58,0.0,0.07
1001,551,24-09-2019 06:00:00,1,3752.0,2955.0,0.787,18.056,220,135,98,37,85,53,32,44,0.0,0.0
1001,552,24-09-2019 06:02:00,1,3469.0,2688.0,0.775,16.645,451,254,195,59,197,150,47,25,0.0,0.0
1001,553,24-09-2019 06:04:00,1,3265.0,2583.0,0.791,15.725,297,215,164,51,82,55,27,31,0.0,0.0
1001,554,24-09-2019 06:06:00,1,3455.0,2714.0,0.786,16.618,182,133,98,35,49,33,16,39,0.0,0.0
1001,555,24-09-2019 06:08:00,1,3449.0,2733.0,0.792,16.615,147,95,54,41,52,12,40,72,0.01,0.0
1001,556,24-09-2019 06:10:00,1,4137.0,3281.0,0.793,19.932,81,47,27,20,34,4,30,53,0.0,0.0
1001,557,24-09-2019 06:12:00,1,4109.0,3312.0,0.806,19.856,109,52,29,23,57,2,55,56,0.0,0.0
1001,558,24-09-2019 06:14:00,1,4120.0,3269.0,0.793,19.853,88,51,29,22,37,6,31,35,0.0,0.0
1001,559,24-09-2019 06:16:00,1,3925.0,3167.0,0.807,18.973,184,107,75,32,77,46,31,22,0.0,0.0
1001,560,24-09-2019 06:18:00,1,3244.0,2660.0,0.82,15.728,274,168,118,50,106,66,40,47,0.0,0.03
1001,561,24-09-2019 06:20:00,1,3682.5,2981.5,0.811,17.811,161,93,57,36,68,29,39,72,0.0,0.0
1001,562,24-09-2019 06:22:00,1,4121.0,3303.0,0.802,19.894,137,104,77,27,33,19,14,41,0.0,0.0
1001,563,24-09-2019 06:24:00,1,3463.0,2751.0,0.794,16.69,113,58,33,25,55,30,25,5,0.0,0.0
1001,564,24-09-2019 06:26:00,1,2770.0,2290.0,0.827,13.451,106,42,28,14,64,41,23,0,0.0,0.0
1001,565,24-09-2019 06:28:00,1,2789.0,2127.0,0.763,13.345,210,151,104,47,59,40,19,2,0.0,0.03
1001,566,24-09-2019 06:30:00,1,3171.0,2512.0,0.792,15.276,165,119,79,40,46,13,33,56,0.0,0.0
1001,567,24-09-2019 06:32:00,1,3631.0,2952.0,0.813,17.575,187,112,75,37,75,44,31,43,0.0,0.0
1001,568,24-09-2019 06:34:00,1,3470.0,2775.0,0.8,16.743,206,136,100,36,70,44,26,35,0.0,0.0
1001,569,24-09-2019 06:36:00,1,3426.0,2810.0,0.82,16.608,76,59,39,20,17,13,4,6,0.0,0.0
1001,570,24-09-2019 06:38:00,1,2793.0,2182.0,0.781,13.421,118,66,42,24,52,39,13,8,0.0,0.0
1001,571,24-09-2019 06:40:00,1,2606.0,2021.0,0.775,12.507,166,100,74,26,66,38,28,30,0.0,0.0
1001,572,24-09-2019 06:42:00,1,2880.0,2304.0,0.8,13.897,138,102,69,33,36,23,13,45,0.0,0.0
1001,573,24-09-2019 06:44:00,1,3644.0,2877.0,0.79,17.542,180,128,91,37,52,22,30,36,0.0,0.0
1001,574,24-09-2019 06:46:00,1,3270.0,2624.0,0.802,15.789,87,44,32,12,43,27,16,2,0.0,0.0
1001,575,24-09-2019 06:48:00,1,2598.0,2062.0,0.794,12.518,42,21,11,10,21,12,9,0,0.0,0.0
1001,576,24-09-2019 06:50:00,1,2636.0,1928.0,0.731,12.52,0,0,0,0,0,0,0,0,0.0,0.0
1001,577,24-09-2019 06:52:00,1,2413.0,1867.0,0.773,11.576,1,1,0,1,0,0,0,0,0.0,0.0
1001,578,24-09-2019 06:54:00,1,2373.5,1806.5,0.7605,11.3535,0,0,0,0,0,0,0,0,0.0,0.0
1001,579,24-09-2019 06:56:00,1,2334.0,1746.0,0.748,11.131,23,18,13,5,5,3,2,0,0.0,0.0
1001,580,24-09-2019 06:58:00,1,2327.0,1749.0,0.752,11.105,0,0,0,0,0,0,0,0,0.0,0.0
1001,581,24-09-2019 07:00:00,1,2424.0,1815.0,0.748,11.562,0,0,0,0,0,0,0,0,0.0,0.0
1001,582,24-09-2019 07:02:00,1,2605.0,2012.0,0.772,12.49,1,1,0,1,0,0,0,0,0.0,0.0
1001,583,24-09-2019 07:04:00,1,2818.0,2118.0,0.752,13.446,1,1,1,0,0,0,0,0,0.0,0.0
1001,584,24-09-2019 07:06:00,1,2817.0,2153.0,0.764,13.484,262,165,118,47,97,64,33,24,0.0,0.0
1001,585,24-09-2019 07:08:00,1,2945.0,2412.0,0.819,14.276,185,77,43,34,108,66,42,22,0.0,0.0
1001,586,24-09-2019 07:10:00,1,3279.0,2586.0,0.789,15.781,272,167,116,51,105,68,37,32,0.0,0.0
1001,587,24-09-2019 07:12:00,1,3277.0,2625.0,0.801,15.817,201,118,94,24,83,52,31,7,0.0,0.0
1001,588,24-09-2019 07:14:00,1,3371.0,2675.0,0.793,16.245,53,24,4,20,29,0,29,1,0.0,0.0
1001,589,24-09-2019 07:16:00,1,3240.0,2636.0,0.814,15.683,144,105,57,48,39,5,34,57,0.0,0.0
1001,590,24-09-2019 07:18:00,1,3475.0,2711.0,0.78,16.695,108,70,38,32,38,11,27,45,0.0,0.0
1001,591,24-09-2019 07:20:00,1,3263.0,2591.0,0.794,15.725,110,63,31,32,47,19,28,45,0.0,0.0
1001,592,24-09-2019 07:22:00,1,3177.0,2518.0,0.793,15.306,119,84,56,28,35,8,27,48,0.0,0.0
1001,593,24-09-2019 07:24:00,1,3480.0,2694.0,0.774,16.694,132,63,36,27,69,38,31,46,0.0,0.0
1001,594,24-09-2019 07:26:00,1,3442.0,2746.0,0.798,16.601,138,61,34,27,77,40,37,39,0.0,0.0
1001,595,24-09-2019 07:28:00,1,3158.0,2511.5,0.795,15.2235,138,92,73,19,46,31,15,11,0.0,0.02
1001,596,24-09-2019 07:30:00,1,2874.0,2277.0,0.792,13.846,188,125,88,37,63,30,33,51,0.0,0.01
1001,597,24-09-2019 07:32:00,1,3377.0,2649.0,0.784,16.237,122,86,63,23,36,18,18,18,0.0,0.0
1001,598,24-09-2019 07:34:00,1,2769.0,2240.0,0.809,13.388,42,27,17,10,15,3,12,0,0.0,0.0
1001,599,24-09-2019 07:36:00,1,2609.0,2053.0,0.787,12.554,0,0,0,0,0,0,0,0,0.0,0.0
1001,600,24-09-2019 07:38:00,1,2529.0,1887.0,0.746,12.052,3,1,0,1,2,1,1,0,0.0,0.0
1001,601,24-09-2019 07:40:00,1,2333.0,1729.0,0.741,11.105,0,0,0,0,0,0,0,0,0.0,0.0
1001,602,24-09-2019 07:42:00,1,2242.0,1670.0,0.745,10.683,89,63,50,13,26,20,6,4,0.0,0.0
1001,603,24-09-2019 07:44:00,1,2538.0,1869.0,0.736,12.069,186,122,82,40,64,27,37,25,0.0,0.0
1001,604,24-09-2019 07:46:00,1,2808.0,2141.0,0.763,13.434,164,98,57,41,66,32,34,29,0.0,0.0
1001,605,24-09-2019 07:48:00,1,2965.0,2381.0,0.803,14.317,169,119,87,32,50,25,25,24,0.0,0.0
1001,606,24-09-2019 07:50:00,1,2964.0,2457.0,0.829,14.397,141,100,79,21,41,23,18,24,0.0,0.0
1001,607,24-09-2019 07:52:00,1,2590.0,2050.0,0.791,12.476,61,29,18,11,32,16,16,0,0.0,0.0
1001,608,24-09-2019 07:54:00,1,2542.0,1854.0,0.729,12.068,24,19,9,10,5,0,5,0,0.0,0.0
1001,609,24-09-2019 07:56:00,1,2795.0,2200.0,0.787,13.45,40,28,13,15,12,6,6,0,0.0,0.0
1001,610,24-09-2019 07:58:00,1,2989.0,2341.0,0.783,14.37,60,52,27,25,8,1,7,0,0.0,0.0
1001,611,24-09-2019 08:00:00,1,3260.0,2580.0,0.792,15.701,11,9,4,5,2,0,2,0,0.0,0.0
1001,612,24-09-2019 08:02:00,1,3107.5,2492.5,0.803,15.004,0,0,0,0,0,0,0,0,0.0,0.0
1001,613,24-09-2019 08:04:00,1,2955.0,2405.0,0.814,14.307,6,6,1,5,0,0,0,0,0.0,0.02
1001,614,24-09-2019 08:06:00,1,3000.0,2290.0,0.763,14.355,12,8,0,8,4,0,4,0,0.0,0.0
1001,615,24-09-2019 08:08:00,1,2801.0,2195.0,0.783,13.468,21,10,6,4,11,6,5,0,0.0,0.0
1001,616,24-09-2019 08:10:00,1,2824.0,2091.0,0.74,13.443,11,9,3,6,2,2,0,0,0.0,0.0
1001,617,24-09-2019 08:12:00,1,2614.0,2000.0,0.765,12.514,0,0,0,0,0,0,0,0,0.0,0.0
1001,618,24-09-2019 08:14:00,1,2531.0,1890.0,0.747,12.064,0,0,0,0,0,0,0,0,0.0,0.0
1001,619,24-09-2019 08:16:00,1,2318.0,1809.0,0.78,11.137,2,1,0,1,1,1,0,0,0.0,0.0
1001,620,24-09-2019 08:18:00,1,2326.0,1728.0,0.743,11.077,0,0,0,0,0,0,0,0,0.0,0.0
1001,621,24-09-2019 08:20:00,1,2238.0,1675.0,0.748,10.67,0,0,0,0,0,0,0,0,0.0,0.0
1001,622,24-09-2019 08:22:00,1,2143.0,1594.0,0.744,10.21,0,0,0,0,0,0,0,0,0.0,0.0
1001,623,24-09-2019 08:24:00,1,2143.0,1582.0,0.738,10.195,2,2,0,2,0,0,0,0,0.0,0.0
1001,624,24-09-2019 08:26:00,1,2142.0,1555.0,0.726,10.162,40,14,5,9,26,12,14,0,0.0,0.01
1001,625,24-09-2019 08:28:00,1,2232.0,1657.0,0.742,10.63,2,2,0,2,0,0,0,0,0.0,0.0
1001,626,24-09-2019 08:30:00,1,2123.0,1654.0,0.779,10.196,1,1,1,0,0,0,0,0,0.0,0.0
1001,627,24-09-2019 08:32:00,1,2128.0,1603.0,0.754,10.159,21,20,1,19,1,0,1,0,0.0,0.0
1001,628,24-09-2019 08:34:00,1,2150.0,1570.0,0.73,10.21,18,18,0,18,0,0,0,0,0.0,0.0
1001,629,24-09-2019 08:36:00,1,2151.0,1559.0,0.725,10.2015,10,9,0,9,1,0,1,0,0.0,0.0
1001,630,24-09-2019 08:38:00,1,2152.0,1548.0,0.72,10.193,0,0,0,0,0,0,0,0,0.0,0.0
1001,631,24-09-2019 08:40:00,1,2154.0,1530.0,0.71,10.179,2,1,1,0,1,0,1,0,0.0,0.0
1001,632,24-09-2019 08:42:00,1,2147.0,1537.0,0.716,10.161,20,15,2,13,5,0,5,0,0.0,0.0
1001,633,24-09-2019 08:44:00,1,2149.0,1557.0,0.724,10.193,9,7,1,6,2,0,2,0,0.0,0.0
1001,634,24-09-2019 08:46:00,1,2141.0,1569.0,0.733,10.173,16,14,0,14,2,0,2,0,0.0,0.0
1001,635,24-09-2019 08:48:00,1,2151.0,1582.0,0.736,10.226,7,6,0,6,1,0,1,0,0.0,0.0
1001,636,24-09-2019 08:50:00,1,2145.0,1580.0,0.737,10.199,7,6,0,6,1,0,1,0,0.0,0.0
1001,637,24-09-2019 08:52:00,1,2142.0,1569.0,0.732,10.176,14,12,0,12,2,0,2,0,0.0,0.0
1001,638,24-09-2019 08:54:00,1,2150.0,1571.0,0.731,10.209,43,40,0,40,3,0,3,0,0.0,0.0
1001,639,24-09-2019 08:56:00,1,2151.0,1575.0,0.732,10.218,20,17,0,17,3,0,3,0,0.0,0.0
1001,640,24-09-2019 08:58:00,1,2147.0,1577.0,0.734,10.205,0,0,0,0,0,0,0,0,0.0,0.0
1001,641,24-09-2019 09:00:00,1,2257.0,1599.0,0.709,10.665,78,42,28,14,36,24,12,0,0.0,0.0
1001,642,24-09-2019 09:02:00,1,2253.0,1609.0,0.714,10.658,240,179,143,36,61,38,23,33,0.0,0.0
1001,643,24-09-2019 09:04:00,1,2341.0,1724.0,0.736,11.131,186,138,82,56,48,20,28,25,0.0,0.02
1001,644,24-09-2019 09:06:00,1,2639.0,1913.0,0.725,12.517,123,74,57,17,49,18,31,18,0.0,0.0
1001,645,24-09-2019 09:08:00,1,2429.0,1772.0,0.729,11.534,229,143,106,37,86,51,35,18,0.0,0.0
1001,646,24-09-2019 09:10:00,1,2629.0,1928.0,0.733,12.4935,88,43,30,13,45,31,14,3,0.0,0.0
1001,647,24-09-2019 09:12:00,1,2829.0,2084.0,0.737,13.453,142,116,73,43,26,7,19,7,0.0,0.0
1001,648,24-09-2019 09:14:00,1,2817.0,2084.0,0.74,13.407,75,35,16,19,40,14,26,0,0.0,0.0
1001,649,24-09-2019 09:16:00,1,2808.0,2106.0,0.75,13.397,147,105,66,39,42,15,27,58,0.0,0.0
1001,650,24-09-2019 09:18:00,1,2808.0,2108.0,0.751,13.398,137,88,60,28,49,22,27,50,0.0,0.0
1001,651,24-09-2019 09:20:00,1,2795.0,2161.0,0.773,13.405,132,72,41,31,60,43,17,8,0.0,0.0
1001,652,24-09-2019 09:22:00,1,2640.0,1877.0,0.711,12.478,134,90,54,36,44,23,21,1,0.0,0.0
1001,653,24-09-2019 09:24:00,1,2820.0,2089.0,0.741,13.423,222,124,88,36,98,62,36,5,0.0,0.0
1001,654,24-09-2019 09:26:00,1,2912.0,2203.0,0.756,13.912,134,96,65,31,38,10,28,5,0.0,0.0
1001,655,24-09-2019 09:28:00,1,3016.0,2228.0,0.739,14.351,15,4,1,3,11,2,9,0,0.01,0.0
1001,656,24-09-2019 09:30:00,1,2907.0,2209.0,0.76,13.9,54,27,9,18,27,1,26,0,0.0,0.0
1001,657,24-09-2019 09:32:00,1,2797.0,2189.0,0.783,13.442,60,53,22,31,7,0,7,1,0.0,0.0
1001,658,24-09-2019 09:34:00,1,2796.0,2179.0,0.779,13.43,20,17,6,11,3,0,3,0,0.0,0.0
1001,659,24-09-2019 09:36:00,1,2795.0,2153.0,0.77,13.397,0,0,0,0,0,0,0,0,0.0,0.0
1001,660,24-09-2019 09:38:00,1,2834.0,2026.0,0.715,13.41,19,17,0,17,2,0,2,0,0.0,0.0
1001,661,24-09-2019 09:40:00,1,2626.0,1915.0,0.729,12.466,45,45,0,45,0,0,0,0,0.0,0.0
1001,662,24-09-2019 09:42:00,1,2540.0,1837.0,0.723,12.041,35,35,0,35,0,0,0,0,0.0,0.0
1001,663,24-09-2019 09:44:00,1,2388.5,1736.5,0.727,11.334,0,0,0,0,0,0,0,0,0.0,0.0
1001,664,24-09-2019 09:46:00,1,2237.0,1636.0,0.731,10.627,0,0,0,0,0,0,0,0,0.0,0.0
1001,665,24-09-2019 09:48:00,1,2128.0,1581.0,0.743,10.136,26,14,5,9,12,3,9,0,0.0,0.0
1001,666,24-09-2019 09:50:00,1,2152.0,1545.0,0.718,10.189,10,10,6,4,0,0,0,0,0.0,0.0
1001,667,24-09-2019 09:52:00,1,2151.0,1533.0,0.713,10.175,10,10,0,10,0,0,0,0,0.0,0.0
1001,668,24-09-2019 09:54:00,1,2156.0,1507.0,0.699,10.164,22,22,1,21,0,0,0,0,0.0,0.03
1001,669,24-09-2019 09:56:00,1,2051.0,1464.0,0.714,9.701,1,1,0,1,0,0,0,0,0.0,0.0
1001,670,24-09-2019 09:58:00,1,1947.0,1434.0,0.737,9.259,10,10,0,10,0,0,0,0,0.0,0.0
1001,671,24-09-2019 10:00:00,1,1941.0,1435.0,0.739,9.234,0,0,0,0,0,0,0,0,0.0,0.0
1001,672,24-09-2019 10:02:00,1,1950.0,1410.0,0.723,9.245,8,0,0,0,8,1,7,0,0.0,0.0
1001,673,24-09-2019 10:04:00,1,1841.0,1391.0,0.756,8.794,2,0,0,0,2,0,2,0,0.0,0.0
1001,674,24-09-2019 10:06:00,1,1835.0,1408.0,0.767,8.791,0,0,0,0,0,0,0,0,0.0,0.0
1001,675,24-09-2019 10:08:00,1,1846.0,1381.0,0.748,8.804,18,15,3,12,3,0,3,0,0.0,0.0
1001,676,24-09-2019 10:10:00,1,1849.0,1361.0,0.736,8.794,12,12,1,11,0,0,0,0,0.0,0.0
1001,677,24-09-2019 10:12:00,1,1842.0,1394.0,0.757,8.801,124,120,82,38,4,0,4,0,0.0,0.0
1001,678,24-09-2019 10:14:00,1,1855.0,1362.0,0.734,8.816,16,12,0,12,4,0,4,0,0.0,0.0
1001,679,24-09-2019 10:16:00,1,1845.0,1377.0,0.746,8.793,17,14,1,13,3,0,3,0,0.0,0.0
1001,680,24-09-2019 10:18:00,1,1900.5,1384.0,0.7285,9.021,4,0,0,0,4,0,4,0,0.0,0.0
1001,681,24-09-2019 10:20:00,1,1956.0,1391.0,0.711,9.249,2,0,0,0,2,0,2,0,0.0,0.0
1001,682,24-09-2019 10:22:00,1,1960.0,1399.0,0.714,9.271,0,0,0,0,0,0,0,0,0.0,0.0
1001,683,24-09-2019 10:24:00,1,1958.0,1402.0,0.716,9.269,1,0,0,0,1,0,1,0,0.01,0.0
1001,684,24-09-2019 10:26:00,1,2066.0,1412.0,0.683,9.704,1,1,0,1,0,0,0,0,0.0,0.0
1001,685,24-09-2019 10:28:00,1,1958.0,1386.0,0.708,9.249,12,12,1,11,0,0,0,0,0.0,0.0
1001,686,24-09-2019 10:30:00,1,1963.0,1377.0,0.702,9.26,6,4,0,4,2,1,1,0,0.0,0.0
1001,687,24-09-2019 10:32:00,1,1965.0,1402.0,0.713,9.293,7,4,2,2,3,0,3,0,0.0,0.0
1001,688,24-09-2019 10:34:00,1,1962.0,1392.0,0.71,9.271,0,0,0,0,0,0,0,0,0.0,0.0
1001,689,24-09-2019 10:36:00,1,2066.0,1413.0,0.684,9.706,0,0,0,0,0,0,0,0,0.0,0.0
1001,690,24-09-2019 10:38:00,1,2072.0,1425.0,0.687,9.743,195,153,113,40,42,22,20,21,0.0,0.0
1001,691,24-09-2019 10:40:00,1,2158.0,1499.0,0.694,10.163,165,112,84,28,53,24,29,44,0.0,0.0
1001,692,24-09-2019 10:42:00,1,2353.0,1643.0,0.698,11.09,54,27,12,15,27,6,21,3,0.0,0.0
1001,693,24-09-2019 10:44:00,1,2342.0,1699.0,0.726,11.108,93,56,20,36,37,9,28,0,0.0,0.0
1001,694,24-09-2019 10:46:00,1,2334.0,1737.0,0.744,11.121,163,115,69,46,48,12,36,11,0.0,0.0
1001,695,24-09-2019 10:48:00,1,2663.0,1837.0,0.69,12.528,243,176,130,46,67,48,19,24,0.0,0.0
1001,696,24-09-2019 10:50:00,1,2544.0,1832.0,0.72,12.051,136,90,52,38,46,22,24,3,0.0,0.0
1001,697,24-09-2019 10:52:00,1,2594.5,1838.0,0.7085,12.2585,68,43,23,20,25,7,18,0,0.0,0.0
1001,698,24-09-2019 10:54:00,1,2645.0,1844.0,0.697,12.466,6,0,0,0,6,0,6,0,0.0,0.0
1001,699,24-09-2019 10:56:00,1,2431.0,1774.0,0.73,11.544,0,0,0,0,0,0,0,0,0.0,0.0
1001,700,24-09-2019 10:58:00,1,2344.0,1683.0,0.718,11.099,1,1,1,0,0,0,0,0,0.0,0.0
1001,701,24-09-2019 11:00:00,1,2125.0,1615.0,0.76,10.159,0,0,0,0,0,0,0,0,0.0,0.0
1001,702,24-09-2019 11:02:00,1,2145.0,1527.0,0.712,10.14,0,0,0,0,0,0,0,0,0.0,0.0
1001,703,24-09-2019 11:04:00,1,2169.0,1479.0,0.682,10.185,4,3,1,2,1,0,1,0,0.0,0.0
1001,704,24-09-2019 11:06:00,1,1940.0,1412.0,0.728,9.205,0,0,0,0,0,0,0,0,0.0,0.0
1001,705,24-09-2019 11:08:00,1,1837.0,1377.0,0.75,8.763,1,0,0,0,1,0,1,0,0.0,0.0
1001,706,24-09-2019 11:10:00,1,1841.0,1372.0,0.745,8.773,0,0,0,0,0,0,0,0,0.0,0.0
1001,707,24-09-2019 11:12:00,1,1852.0,1359.0,0.734,8.802,11,0,0,0,11,0,11,0,0.0,0.0
1001,708,24-09-2019 11:14:00,1,1842.0,1357.0,0.737,8.762,4,1,1,0,3,0,3,0,0.0,0.0
1001,709,24-09-2019 11:16:00,1,1844.0,1345.0,0.729,8.754,232,129,94,35,103,68,35,4,0.0,0.0
1001,710,24-09-2019 11:18:00,1,1944.0,1407.0,0.724,9.219,115,85,58,27,30,15,15,26,0.0,0.0
1001,711,24-09-2019 11:20:00,1,2139.0,1558.0,0.728,10.153,146,95,66,29,51,26,25,12,0.0,0.0
1001,712,24-09-2019 11:22:00,1,2140.0,1579.0,0.738,10.181,52,22,5,17,30,8,22,0,0.0,0.0
1001,713,24-09-2019 11:24:00,1,2358.0,1617.0,0.686,11.083,215,153,105,48,62,39,23,18,0.0,0.0
1001,714,24-09-2019 11:26:00,1,2339.5,1678.5,0.718,11.077,144,100,64,36,44,16,28,0,0.0,0.0
1001,715,24-09-2019 11:28:00,1,2321.0,1740.0,0.75,11.071,54,29,11,18,25,5,20,0,0.0,0.0
1001,716,24-09-2019 11:30:00,1,2539.0,1789.0,0.704,11.986,310,188,137,51,122,84,38,0,0.0,0.0
1001,717,24-09-2019 11:32:00,1,2547.0,1810.0,0.711,12.04,49,40,7,33,9,1,8,0,0.0,0.0
1001,718,24-09-2019 11:34:00,1,2534.0,1808.0,0.713,11.986,162,124,86,38,38,18,20,0,0.0,0.0
1001,719,24-09-2019 11:36:00,1,2647.0,1824.0,0.689,12.448,110,79,45,34,31,6,25,38,0.0,0.0
1001,720,24-09-2019 11:38:00,1,2657.0,1864.0,0.702,12.533,101,63,23,40,38,2,36,64,0.0,0.0
1001,721,24-09-2019 11:40:00,1,2725.0,1982.0,0.727,12.931,50,42,21,21,8,3,5,4,0.0,0.0
1001,722,24-09-2019 11:42:00,1,2641.0,1884.0,0.713,12.494,211,181,127,54,30,8,22,0,0.0,0.06
1001,723,24-09-2019 11:44:00,1,2152.0,1561.0,0.725,10.207,73,59,27,32,14,2,12,0,0.0,0.0
1001,724,24-09-2019 11:46:00,1,2348.0,1686.0,0.718,11.117,26,26,2,24,0,0,0,0,0.0,0.0
1001,725,24-09-2019 11:48:00,1,2623.0,1911.0,0.729,12.45,19,17,8,9,2,0,2,2,0.0,0.0
1001,726,24-09-2019 11:50:00,1,2811.0,2119.0,0.754,13.42,0,0,0,0,0,0,0,0,0.0,0.0
1001,727,24-09-2019 11:52:00,1,2832.0,2009.0,0.71,13.383,1,1,0,1,0,0,0,0,0.0,0.0
1001,728,24-09-2019 11:54:00,1,2625.0,1922.0,0.732,12.472,15,15,0,15,0,0,0,0,0.0,0.0
1001,729,24-09-2019 11:56:00,1,2644.0,1814.0,0.686,12.426,0,0,0,0,0,0,0,0,0.0,0.0
1001,730,24-09-2019 11:58:00,1,2327.0,1724.0,0.741,11.076,9,9,2,7,0,0,0,0,0.0,0.0
1001,731,24-09-2019 12:00:00,1,2233.0,1644.5,0.7365,10.618,3,3,0,3,0,0,0,0,0.0,0.0
1001,732,24-09-2019 12:02:00,1,2139.0,1565.0,0.732,10.16,1,1,0,1,0,0,0,0,0.0,0.0
1001,733,24-09-2019 12:04:00,1,2157.0,1521.0,0.705,10.182,1,1,0,1,0,0,0,0,0.0,0.0
1001,734,24-09-2019 12:06:00,1,2162.0,1467.0,0.678,10.143,2,2,0,2,0,0,0,0,0.0,0.0
1001,735,24-09-2019 12:08:00,1,2059.0,1434.0,0.697,9.699,3,3,0,3,0,0,0,0,0.0,0.0
1001,736,24-09-2019 12:10:00,1,1961.0,1384.0,0.706,9.26,21,13,7,6,8,7,1,0,0.0,0.0
1001,737,24-09-2019 12:12:00,1,1945.0,1424.0,0.732,9.241,2,0,0,0,2,0,2,0,0.0,0.0
1001,738,24-09-2019 12:14:00,1,2069.0,1447.0,0.699,9.755,5,0,0,0,5,0,5,0,0.0,0.0
1001,739,24-09-2019 12:16:00,1,2058.0,1447.0,0.703,9.712,0,0,0,0,0,0,0,0,0.0,0.0
1001,740,24-09-2019 12:18:00,1,2052.0,1459.0,0.711,9.7,0,0,0,0,0,0,0,0,0.0,0.0
1001,741,24-09-2019 12:20:00,1,2061.0,1438.0,0.698,9.713,9,1,0,1,8,0,8,0,0.0,0.0
1001,742,24-09-2019 12:22:00,1,2171.0,1448.0,0.667,10.157,5,0,0,0,5,0,5,0,0.0,0.0
1001,743,24-09-2019 12:24:00,1,2165.0,1453.0,0.671,10.141,5,2,0,2,3,0,3,0,0.0,0.0
1001,744,24-09-2019 12:26:00,1,2064.0,1427.0,0.692,9.712,4,3,0,3,1,0,1,0,0.0,0.0
1001,745,24-09-2019 12:28:00,1,2076.0,1421.0,0.684,9.753,1,1,0,1,0,0,0,0,0.0,0.0
1001,746,24-09-2019 12:30:00,1,2067.0,1414.0,0.684,9.709,2,2,0,2,0,0,0,0,0.0,0.0
1001,747,24-09-2019 12:32:00,1,2062.0,1405.0,0.681,9.682,5,5,2,3,0,0,0,0,0.0,0.0
1001,748,24-09-2019 12:34:00,1,2116.0,1422.0,0.672,9.913,1,1,0,1,0,0,0,0,0.0,0.0
1001,749,24-09-2019 12:36:00,1,2170.0,1439.0,0.663,10.144,1,1,0,1,0,0,0,0,0.0,0.0
1001,750,24-09-2019 12:38:00,1,2174.0,1465.0,0.674,10.187,6,6,1,5,0,0,0,0,0.0,0.0
1001,751,24-09-2019 12:40:00,1,2162.0,1460.0,0.675,10.137,205,133,104,29,72,50,22,8,0.0,0.0
1001,752,24-09-2019 12:42:00,1,2149.0,1529.0,0.711,10.161,17,9,3,6,8,0,8,0,0.0,0.0
1001,753,24-09-2019 12:44:00,1,2147.0,1556.0,0.724,10.183,3,2,0,2,1,0,1,0,0.0,0.0
1001,754,24-09-2019 12:46:00,1,2147.0,1543.0,0.719,10.168,0,0,0,0,0,0,0,0,0.0,0.0
1001,755,24-09-2019 12:48:00,1,2156.0,1501.0,0.696,10.157,3,3,0,3,0,0,0,0,0.0,0.0
1001,756,24-09-2019 12:50:00,1,2156.0,1506.0,0.699,10.162,19,16,10,6,3,0,3,0,0.0,0.0
1001,757,24-09-2019 12:52:00,1,2160.0,1495.0,0.692,10.166,0,0,0,0,0,0,0,0,0.0,0.0
1001,758,24-09-2019 12:54:00,1,2150.0,1502.0,0.699,10.136,2,0,0,0,2,0,2,0,0.0,0.0
1001,759,24-09-2019 12:56:00,1,2171.0,1485.0,0.684,10.198,6,3,1,2,3,0,3,0,0.0,0.0
1001,760,24-09-2019 12:58:00,1,2156.0,1512.0,0.701,10.171,1,0,0,0,1,0,1,0,0.0,0.0
1001,761,24-09-2019 13:00:00,1,2148.0,1528.0,0.711,10.155,6,3,0,3,3,0,3,0,0.0,0.0
1001,762,24-09-2019 13:02:00,1,2152.0,1511.0,0.702,10.15,2,0,0,0,2,0,2,0,0.0,0.0
1001,763,24-09-2019 13:04:00,1,2162.0,1498.0,0.693,10.176,1,0,0,0,1,0,1,0,0.0,0.0
1001,764,24-09-2019 13:06:00,1,2154.0,1511.0,0.702,10.161,27,12,7,5,15,2,13,0,0.0,0.0
1001,765,24-09-2019 13:08:00,1,2157.0,1498.0,0.695,10.159,2,0,0,0,2,0,2,0,0.0,0.0
1001,766,24-09-2019 13:10:00,1,2160.0,1485.0,0.688,10.157,1,0,0,0,1,0,1,0,0.0,0.0
1001,767,24-09-2019 13:12:00,1,2164.0,1492.0,0.69,10.18,0,0,0,0,0,0,0,0,0.0,0.0
1001,768,24-09-2019 13:14:00,1,2162.0,1480.0,0.684,10.159,5,4,1,3,1,1,0,0,0.0,0.0
1001,769,24-09-2019 13:16:00,1,2170.0,1464.0,0.675,10.171,5,3,0,3,2,0,2,0,0.0,0.0
1001,770,24-09-2019 13:18:00,1,2163.0,1477.0,0.683,10.158,3,1,0,1,2,0,2,0,0.0,0.0
1001,771,24-09-2019 13:20:00,1,2152.0,1500.0,0.697,10.14,0,0,0,0,0,0,0,0,0.0,0.0
1001,772,24-09-2019 13:22:00,1,2161.0,1500.0,0.694,10.177,4,2,1,1,2,0,2,0,0.0,0.0
1001,773,24-09-2019 13:24:00,1,2160.0,1502.0,0.695,10.173,118,70,56,14,48,34,14,1,0.0,0.0
1001,774,24-09-2019 13:26:00,1,2149.0,1530.0,0.712,10.16,3,3,0,3,0,0,0,0,0.0,0.0
1001,775,24-09-2019 13:28:00,1,2148.0,1538.0,0.716,10.167,4,4,0,4,0,0,0,0,0.0,0.0
1001,776,24-09-2019 13:30:00,1,2147.0,1538.0,0.716,10.163,0,0,0,0,0,0,0,0,0.0,0.0
1001,777,24-09-2019 13:32:00,1,2148.0,1533.0,0.714,10.163,0,0,0,0,0,0,0,0,0.0,0.0
1001,778,24-09-2019 13:34:00,1,2160.0,1521.0,0.704,10.194,1,1,1,0,0,0,0,0,0.0,0.0
1001,779,24-09-2019 13:36:00,1,2155.0,1513.0,0.702,10.168,1,1,1,0,0,0,0,0,0.0,0.0
1001,780,24-09-2019 13:38:00,1,2166.0,1471.0,0.679,10.164,0,0,0,0,0,0,0,0,0.0,0.0
1001,781,24-09-2019 13:40:00,1,2062.0,1408.0,0.683,9.683,24,16,6,10,8,3,5,0,0.0,0.0
1001,782,24-09-2019 13:42:00,1,1954.5,1389.5,0.7125,9.2395,5,3,0,3,2,0,2,0,0.0,0.0
1001,783,24-09-2019 13:44:00,1,1847.0,1371.0,0.742,8.796,20,19,0,19,1,0,1,0,0.0,0.0
1001,784,24-09-2019 13:46:00,1,1850.0,1343.0,0.726,8.776,5,3,0,3,2,0,2,0,0.0,0.0
1001,785,24-09-2019 13:48:00,1,1862.0,1328.0,0.713,8.805,1,1,1,0,0,0,0,0,0.0,0.0
1001,786,24-09-2019 13:50:00,1,1864.0,1311.0,0.703,8.798,0,0,0,0,0,0,0,0,0.0,0.0
1001,787,24-09-2019 13:52:00,1,1863.0,1303.0,0.699,8.781,10,6,3,3,4,0,4,0,0.0,0.0
1001,788,24-09-2019 13:54:00,1,1868.0,1291.0,0.691,8.79,17,13,8,5,4,3,1,0,0.0,0.0
1001,789,24-09-2019 13:56:00,1,1842.0,1387.0,0.753,8.793,8,4,0,4,4,1,3,0,0.0,0.0
1001,790,24-09-2019 13:58:00,1,1953.0,1431.0,0.733,9.278,2,2,2,0,0,0,0,0,0.0,0.0
1001,791,24-09-2019 14:00:00,1,2054.0,1436.0,0.699,9.681,12,12,0,12,0,0,0,0,0.0,0.0
1001,792,24-09-2019 14:02:00,1,2171.0,1467.0,0.676,10.179,4,1,1,0,3,2,1,0,0.0,0.0
1001,793,24-09-2019 14:04:00,1,2157.0,1520.0,0.705,10.183,2,0,0,0,2,2,0,0,0.0,0.0
1001,794,24-09-2019 14:06:00,1,2155.0,1531.0,0.71,10.186,8,5,1,4,3,0,3,0,0.0,0.0
1001,795,24-09-2019 14:08:00,1,2156.0,1525.0,0.707,10.182,0,0,0,0,0,0,0,0,0.01,0.0
1001,796,24-09-2019 14:10:00,1,2178.0,1458.0,0.669,10.197,7,5,1,4,2,0,2,0,0.0,0.0
1001,797,24-09-2019 14:12:00,1,2061.0,1422.0,0.69,9.697,1,1,1,0,0,0,0,0,0.0,0.0
1001,798,24-09-2019 14:14:00,1,1957.0,1421.0,0.726,9.282,0,0,0,0,0,0,0,0,0.0,0.0
1001,799,24-09-2019 14:16:00,1,1953.0,1411.0,0.7225,9.2565,0,0,0,0,0,0,0,0,0.0,0.0
1001,800,24-09-2019 14:18:00,1,1949.0,1401.0,0.719,9.231,0,0,0,0,0,0,0,0,0.0,0.0
1001,801,24-09-2019 14:20:00,1,2069.0,1418.0,0.685,9.724,0,0,0,0,0,0,0,0,0.0,0.0
1001,802,24-09-2019 14:22:00,1,2174.0,1454.0,0.669,10.175,0,0,0,0,0,0,0,0,0.0,0.0
1001,803,24-09-2019 14:24:00,1,2179.0,1454.0,0.667,10.196,129,102,82,20,27,15,12,9,0.0,0.0
1001,804,24-09-2019 14:26:00,1,2166.0,1466.0,0.677,10.159,53,21,5,16,32,2,30,0,0.0,0.0
1001,805,24-09-2019 14:28:00,1,2132.0,1612.0,0.756,10.186,36,30,9,21,6,2,4,2,0.0,0.0
1001,806,24-09-2019 14:30:00,1,2341.0,1666.0,0.712,11.069,71,37,12,25,34,0,34,0,0.0,0.0
1001,807,24-09-2019 14:32:00,1,2546.0,1818.0,0.714,12.044,10,9,3,6,1,0,1,0,0.0,0.0
1001,808,24-09-2019 14:34:00,1,2431.0,1822.0,0.749,11.596,17,15,2,13,2,0,2,0,0.0,0.0
1001,809,24-09-2019 14:36:00,1,2321.0,1748.0,0.753,11.08,8,8,1,7,0,0,0,0,0.0,0.0
1001,810,24-09-2019 14:38:00,1,2328.0,1739.0,0.747,11.099,83,67,53,14,16,6,10,0,0.0,0.0
1001,811,24-09-2019 14:40:00,1,2329.0,1763.0,0.757,11.128,70,48,41,7,22,10,12,4,0.0,0.0
1001,812,24-09-2019 14:42:00,1,2328.0,1758.0,0.755,11.12,0,0,0,0,0,0,0,0,0.0,0.0
1001,813,24-09-2019 14:44:00,1,2347.0,1694.0,0.722,11.123,1,0,0,0,1,0,1,0,0.0,0.0
1001,814,24-09-2019 14:46:00,1,2249.0,1653.0,0.735,10.692,0,0,0,0,0,0,0,0,0.0,0.0
1001,815,24-09-2019 14:48:00,1,2132.0,1622.0,0.761,10.195,4,0,0,0,4,0,4,0,0.0,0.0
1001,816,24-09-2019 14:50:00,1,2143.0,1579.5,0.7375,10.192,2,2,1,1,0,0,0,0,0.0,0.0
1001,817,24-09-2019 14:52:00,1,2154.0,1537.0,0.714,10.189,9,7,1,6,2,0,2,0,0.0,0.0
1001,818,24-09-2019 14:54:00,1,2152.0,1548.0,0.72,10.193,36,13,1,12,23,0,23,0,0.0,0.0
1001,819,24-09-2019 14:56:00,1,2144.0,1549.0,0.723,10.162,8,6,2,4,2,0,2,0,0.0,0.0
1001,820,24-09-2019 14:58:00,1,2158.0,1541.0,0.714,10.21,8,8,4,4,0,0,0,0,0.0,0.0
1001,821,24-09-2019 15:00:00,1,2160.0,1517.0,0.702,10.191,15,15,6,9,0,0,0,0,0.0,0.0
1001,822,24-09-2019 15:02:00,1,2169.0,1515.0,0.699,10.222,15,9,5,4,6,2,4,0,0.0,0.0
1001,823,24-09-2019 15:04:00,1,2161.0,1515.0,0.701,10.19,18,18,2,16,0,0,0,0,0.0,0.0
1001,824,24-09-2019 15:06:00,1,2165.0,1492.0,0.689,10.18,1,1,0,1,0,0,0,0,0.0,0.0
1001,825,24-09-2019 15:08:00,1,2163.0,1499.0,0.693,10.184,11,10,2,8,1,0,1,0,0.0,0.0
1001,826,24-09-2019 15:10:00,1,2171.0,1489.0,0.686,10.203,6,5,1,4,1,0,1,0,0.0,0.0
1001,827,24-09-2019 15:12:00,1,2185.0,1440.0,0.659,10.202,11,9,5,4,2,0,2,0,0.0,0.0
1001,828,24-09-2019 15:14:00,1,2066.0,1410.0,0.682,9.702,15,7,0,7,8,0,8,0,0.0,0.0
1001,829,24-09-2019 15:16:00,1,1963.0,1365.0,0.695,9.244,1,0,0,0,1,0,1,0,0.0,0.0
1001,830,24-09-2019 15:18:00,1,1857.0,1339.0,0.721,8.798,13,0,0,0,13,0,13,0,0.0,0.0
1001,831,24-09-2019 15:20:00,1,1852.0,1341.0,0.724,8.783,24,15,5,10,9,0,9,0,0.0,0.0
1001,832,24-09-2019 15:22:00,1,1959.0,1384.0,0.706,9.25,35,29,2,27,6,0,6,0,0.0,0.0
1001,833,24-09-2019 15:24:00,1,2064.0,1411.0,0.6845,9.6935,37,36,0,36,1,0,1,0,0.0,0.0
1001,834,24-09-2019 15:26:00,1,2169.0,1438.0,0.663,10.137,34,34,2,32,0,0,0,0,0.0,0.0
1001,835,24-09-2019 15:28:00,1,2160.0,1468.0,0.679,10.137,2,2,0,2,0,0,0,0,0.0,0.0
1001,836,24-09-2019 15:30:00,1,2162.0,1454.0,0.673,10.127,56,39,17,22,17,2,15,0,0.0,0.0
1001,837,24-09-2019 15:32:00,1,2173.0,1432.0,0.659,10.147,226,136,96,40,90,56,34,37,0.0,0.0
1001,838,24-09-2019 15:34:00,1,2356.0,1635.0,0.694,11.094,247,122,95,27,125,78,47,51,0.0,0.0
1001,839,24-09-2019 15:36:00,1,2331.0,1691.0,0.726,11.056,248,181,124,57,67,35,32,61,0.0,0.0
1001,840,24-09-2019 15:38:00,1,2363.0,1660.0,0.702,11.148,62,37,18,19,25,11,14,37,0.0,0.0
1001,841,24-09-2019 15:40:00,1,2652.0,1822.0,0.687,12.466,80,56,28,28,24,11,13,33,0.0,0.0
1001,842,24-09-2019 15:42:00,1,2646.0,1862.0,0.703,12.488,218,152,101,51,66,42,24,42,0.01,0.0
1001,843,24-09-2019 15:44:00,1,2244.0,1619.0,0.722,10.633,31,23,2,21,8,2,6,0,0.0,0.0
1001,844,24-09-2019 15:46:00,1,1848.0,1356.0,0.734,8.784,48,35,11,24,13,0,13,4,0.0,0.0
1001,845,24-09-2019 15:48:00,1,2253.0,1566.0,0.695,10.609,63,35,8,27,28,1,27,1,0.0,0.0
1001,846,24-09-2019 15:50:00,1,2622.0,1886.0,0.719,12.421,47,20,12,8,27,3,24,0,0.0,0.0
1001,847,24-09-2019 15:52:00,1,2806.0,2133.0,0.76,13.419,6,6,0,6,0,0,0,0,0.0,0.0
1001,848,24-09-2019 15:54:00,1,2806.0,2143.0,0.764,13.426,5,5,0,5,0,0,0,0,0.0,0.0
1001,849,24-09-2019 15:56:00,1,2816.0,2088.0,0.742,13.409,7,6,2,4,1,0,1,0,0.0,0.0
1001,850,24-09-2019 15:58:00,1,2727.5,1994.5,0.731,12.956,2,0,0,0,2,0,2,0,0.0,0.0
1001,851,24-09-2019 16:00:00,1,2639.0,1901.0,0.72,12.503,2,0,0,0,2,0,2,0,0.0,0.0
1001,852,24-09-2019 16:02:00,1,2669.0,1812.0,0.679,12.521,1,0,0,0,1,0,1,0,0.0,0.0
1001,853,24-09-2019 16:04:00,1,2334.0,1708.0,0.732,11.087,9,4,3,1,5,0,5,0,0.0,0.0
1001,854,24-09-2019 16:06:00,1,2344.0,1664.0,0.71,11.077,2,0,0,0,2,0,2,0,0.0,0.0
1001,855,24-09-2019 16:08:00,1,2358.0,1641.0,0.696,11.108,1,0,0,0,1,0,1,0,0.0,0.0
1001,856,24-09-2019 16:10:00,1,2243.0,1608.0,0.717,10.617,0,0,0,0,0,0,0,0,0.0,0.0
1001,857,24-09-2019 16:12:00,1,2135.0,1579.0,0.74,10.159,0,0,0,0,0,0,0,0,0.0,0.0
1001,858,24-09-2019 16:14:00,1,2150.0,1579.0,0.734,10.219,0,0,0,0,0,0,0,0,0.0,0.0
1001,859,24-09-2019 16:16:00,1,2150.0,1548.0,0.72,10.187,12,9,2,7,3,0,3,0,0.0,0.0
1001,860,24-09-2019 16:18:00,1,2157.0,1538.0,0.713,10.202,0,0,0,0,0,0,0,0,0.0,0.0
1001,861,24-09-2019 16:20:00,1,2149.0,1526.0,0.71,10.157,3,3,1,2,0,0,0,0,0.0,0.0
1001,862,24-09-2019 16:22:00,1,2155.0,1537.0,0.713,10.194,8,8,2,6,0,0,0,0,0.0,0.0
1001,863,24-09-2019 16:24:00,1,2159.0,1494.0,0.692,10.16,1,1,0,1,0,0,0,0,0.0,0.0
1001,864,24-09-2019 16:26:00,1,2157.0,1470.0,0.681,10.125,0,0,0,0,0,0,0,0,0.0,0.0
1001,865,24-09-2019 16:28:00,1,2162.0,1476.0,0.683,10.154,1,0,0,0,1,0,1,0,0.0,0.0
1001,866,24-09-2019 16:30:00,1,2173.0,1427.0,0.657,10.144,23,12,10,2,11,6,5,2,0.0,0.0
1001,867,24-09-2019 16:32:00,1,2157.0,1496.5,0.694,10.156,207,146,110,36,61,35,26,16,0.0,0.0
1001,868,24-09-2019 16:34:00,1,2141.0,1566.0,0.731,10.168,37,23,16,7,14,7,7,33,0.0,0.01
1001,869,24-09-2019 16:36:00,1,2616.0,1937.0,0.741,12.451,223,135,106,29,88,54,34,48,0.0,0.0
1001,870,24-09-2019 16:38:00,1,2129.0,1606.0,0.755,10.165,156,105,70,35,51,20,31,50,0.0,0.0
1001,871,24-09-2019 16:40:00,1,2351.0,1681.0,0.715,11.123,83,34,9,25,49,20,29,39,0.0,0.0
1001,872,24-09-2019 16:42:00,1,2662.0,1826.0,0.686,12.512,103,65,38,27,38,11,27,59,0.0,0.0
1001,873,24-09-2019 16:44:00,1,2620.0,1904.0,0.727,12.431,86,48,15,33,38,21,17,46,0.0,0.0
1001,874,24-09-2019 16:46:00,1,2628.0,1911.0,0.727,12.471,74,44,17,27,30,1,29,52,0.0,0.0
1001,875,24-09-2019 16:48:00,1,2913.0,2151.0,0.738,13.859,140,88,48,40,52,25,27,67,0.01,0.0
1001,876,24-09-2019 16:50:00,1,2919.0,2135.0,0.732,13.865,111,90,52,38,21,9,12,16,0.0,0.0
1001,877,24-09-2019 16:52:00,1,2135.0,1587.0,0.743,10.171,23,17,3,14,6,1,5,1,0.0,0.0
1001,878,24-09-2019 16:54:00,1,2055.0,1454.0,0.708,9.706,54,33,13,20,21,7,14,2,0.0,0.0
1001,879,24-09-2019 16:56:00,1,2061.0,1419.0,0.688,9.691,9,9,1,8,0,0,0,0,0.0,0.0
1001,880,24-09-2019 16:58:00,1,2173.0,1453.0,0.669,10.169,0,0,0,0,0,0,0,0,0.0,0.0
1001,881,24-09-2019 17:00:00,1,1844.0,1377.0,0.747,8.791,13,5,2,3,8,1,7,0,0.0,0.0
1001,882,24-09-2019 17:02:00,1,1853.0,1320.0,0.712,8.763,8,0,0,0,8,0,8,0,0.0,0.0
1001,883,24-09-2019 17:04:00,1,1869.0,1284.0,0.687,8.787,0,0,0,0,0,0,0,0,0.0,0.0
1001,884,24-09-2019 17:06:00,1,1877.0,1256.0,0.669,8.787,0,0,0,0,0,0,0,0,0.0,0.0
1001,885,24-09-2019 17:08:00,1,1885.0,1228.0,0.651,8.787,0,0,0,0,0,0,0,0,0.0,0.0
1001,886,24-09-2019 17:10:00,1,1874.0,1283.0,0.685,8.804,0,0,0,0,0,0,0,0,0.0,0.0
1001,887,24-09-2019 17:12:00,1,1862.0,1321.0,0.71,8.8,0,0,0,0,0,0,0,0,0.0,0.0
1001,888,24-09-2019 17:14:00,1,1854.0,1338.0,0.721,8.786,0,0,0,0,0,0,0,0,0.0,0.0
1001,889,24-09-2019 17:16:00,1,1959.0,1371.0,0.7,9.236,12,10,7,3,2,2,0,2,0.0,0.0
1001,890,24-09-2019 17:18:00,1,2547.0,1819.0,0.714,12.048,2,2,0,2,0,0,0,0,0.0,0.0
1001,891,24-09-2019 17:20:00,1,2784.0,2178.0,0.782,13.379,5,5,1,4,0,0,0,0,0.0,0.0
1001,892,24-09-2019 17:22:00,1,3023.0,2246.0,0.743,14.398,3,3,3,0,0,0,0,0,0.0,0.0
1001,893,24-09-2019 17:24:00,1,2784.0,2184.0,0.785,13.389,8,8,1,7,0,0,0,0,0.0,0.0
1001,894,24-09-2019 17:26:00,1,2803.0,2144.0,0.765,13.419,12,12,2,10,0,0,0,0,0.0,0.0
1001,895,24-09-2019 17:28:00,1,2809.0,2088.0,0.743,13.378,6,6,4,2,0,0,0,0,0.0,0.0
1001,896,24-09-2019 17:30:00,1,2614.0,2007.0,0.768,12.523,2,2,0,2,0,0,0,0,0.0,0.0
1001,897,24-09-2019 17:32:00,1,2608.0,1959.0,0.751,12.444,13,11,0,11,2,1,1,0,0.0,0.0
1001,898,24-09-2019 17:34:00,1,2626.0,1966.0,0.749,12.525,167,122,85,37,45,23,22,10,0.0,0.0
1001,899,24-09-2019 17:36:00,1,2826.0,2094.0,0.741,13.454,319,209,162,47,110,66,44,60,0.0,0.0
1001,900,24-09-2019 17:38:00,1,2815.0,2081.0,0.739,13.394,98,80,35,45,18,6,12,52,0.0,0.0
1001,901,24-09-2019 17:40:00,1,2868.0,2128.0,0.7415,13.656,75,57,25,32,18,3,15,35,0.0,0.0
1001,902,24-09-2019 17:42:00,1,2921.0,2175.0,0.744,13.918,92,58,26,32,34,0,34,48,0.0,0.0
1001,903,24-09-2019 17:44:00,1,3004.0,2250.0,0.749,14.327,111,79,46,33,32,13,19,60,0.0,0.0
1001,904,24-09-2019 17:46:00,1,3003.0,2262.0,0.753,14.339,109,57,27,30,52,24,28,52,0.0,0.0
1001,905,24-09-2019 17:48:00,1,3187.0,2441.0,0.766,15.261,132,69,47,22,63,35,28,38,0.0,0.0
1001,906,24-09-2019 17:50:00,1,2782.0,2177.0,0.783,13.37,49,34,13,21,15,2,13,2,0.0,0.02
1001,907,24-09-2019 17:52:00,1,2123.0,1635.0,0.77,10.174,76,61,23,38,15,4,11,4,0.0,0.0
1001,908,24-09-2019 17:54:00,1,2133.0,1570.0,0.736,10.143,12,5,2,3,7,1,6,0,0.0,0.02
1001,909,24-09-2019 17:56:00,1,2228.0,1644.0,0.738,10.6,7,5,0,5,2,0,2,0,0.0,0.0
1001,910,24-09-2019 17:58:00,1,2129.0,1614.0,0.758,10.174,3,2,2,0,1,0,1,0,0.0,0.0
1001,911,24-09-2019 18:00:00,0,2136.0,1610.0,0.754,10.198,4,2,0,2,2,0,2,0,0.0,0.0
1001,912,24-09-2019 18:02:00,0,2131.0,1599.0,0.75,10.168,76,40,29,11,36,28,8,0,0.01,0.0
1001,913,24-09-2019 18:04:00,0,2328.0,1767.0,0.759,11.13,475,347,291,56,128,87,41,28,0.0,0.0
1001,914,24-09-2019 18:06:00,0,2584.0,2085.0,0.807,12.49,191,130,99,31,61,37,24,19,0.0,0.01
1001,915,24-09-2019 18:08:00,0,3164.0,2542.0,0.803,15.281,357,274,210,64,83,46,37,55,0.0,0.0
1001,916,24-09-2019 18:10:00,0,2856.0,2363.0,0.827,13.868,230,141,113,28,89,56,33,32,0.0,0.0
1001,917,24-09-2019 18:12:00,0,2872.0,2328.0,0.811,13.892,268,191,143,48,77,45,32,24,0.0,0.0
1001,918,24-09-2019 18:14:00,0,2960.0,2424.0,0.819,14.3455,304,192,134,58,112,75,37,24,0.0,0.0
1001,919,24-09-2019 18:16:00,0,3048.0,2520.0,0.827,14.799,462,308,253,55,154,114,40,89,0.0,0.0
1001,920,24-09-2019 18:18:00,0,2934.0,2513.0,0.856,14.343,127,87,49,38,40,14,26,2,0.0,0.0
1001,921,24-09-2019 18:20:00,0,2415.0,1890.0,0.783,11.606,109,81,52,29,28,12,16,27,0.0,0.0
1001,922,24-09-2019 18:22:00,0,3627.0,2998.0,0.827,17.609,558,376,308,68,182,132,50,59,0.0,0.12
1001,923,24-09-2019 18:24:00,0,3623.0,2967.0,0.819,17.561,648,464,391,73,184,143,41,24,0.02,0.0
1001,924,24-09-2019 18:26:00,0,3534.0,2888.0,0.817,17.121,394,257,193,64,137,121,16,6,0.0,0.0
1001,925,24-09-2019 18:28:00,0,2595.0,2051.0,0.79,12.497,355,184,130,54,171,144,27,64,0.0,0.0
1001,926,24-09-2019 18:30:00,0,3457.0,2753.0,0.796,16.669,291,142,80,62,149,109,40,43,0.0,0.0
1001,927,24-09-2019 18:32:00,0,3640.0,2921.0,0.802,17.577,318,190,129,61,128,90,38,68,0.0,0.0
1001,928,24-09-2019 18:34:00,0,3466.0,2749.0,0.793,16.7,365,140,96,44,225,171,54,64,0.0,0.0
1001,929,24-09-2019 18:36:00,0,3641.0,2934.0,0.806,17.592,523,250,191,59,273,220,53,40,0.0,0.0
1001,930,24-09-2019 18:38:00,0,3286.0,2539.0,0.773,15.76,474,218,172,46,256,205,51,67,0.0,0.0
1001,931,24-09-2019 18:40:00,0,3842.0,3096.0,0.806,18.565,323,215,165,50,108,77,31,50,0.0,0.0
1001,932,24-09-2019 18:42:00,0,2966.0,2422.0,0.817,14.367,440,261,203,58,179,136,43,58,0.0,0.0
1001,933,24-09-2019 18:44:00,0,3351.0,2739.0,0.817,16.237,200,102,80,22,98,69,29,22,0.0,0.0
1001,934,24-09-2019 18:46:00,0,3633.0,2988.0,0.822,17.623,222,148,116,32,74,28,46,64,0.0,0.0
1001,935,24-09-2019 18:48:00,0,3548.0,2869.5,0.808,17.1565,181,99,54,45,82,50,32,83,0.0,0.0
1001,936,24-09-2019 18:50:00,0,3463.0,2751.0,0.794,16.69,294,187,144,43,107,67,40,58,0.0,0.0
1001,937,24-09-2019 18:52:00,0,3465.0,2713.0,0.783,16.656,131,79,39,40,52,16,36,65,0.0,0.0
1001,938,24-09-2019 18:54:00,0,3452.0,2793.0,0.809,16.693,107,75,35,40,32,5,27,64,0.0,0.0
1001,939,24-09-2019 18:56:00,0,3658.0,2887.0,0.789,17.608,139,90,49,41,49,14,35,30,0.0,0.0
1001,940,24-09-2019 18:58:00,0,3676.0,2836.0,0.771,17.626,125,85,50,35,40,11,29,47,0.0,0.0
1001,941,24-09-2019 19:00:00,0,3464.0,2772.0,0.8,16.718,106,78,42,36,28,8,20,42,0.0,0.0
1001,942,24-09-2019 19:02:00,0,3446.0,2784.0,0.808,16.661,136,103,55,48,33,14,19,42,0.0,0.0
1001,943,24-09-2019 19:04:00,0,3446.0,2802.0,0.813,16.679,91,64,37,27,27,15,12,49,0.0,0.0
1001,944,24-09-2019 19:06:00,0,3665.0,2876.0,0.785,17.623,131,76,45,31,55,29,26,48,0.0,0.0
1001,945,24-09-2019 19:08:00,0,3647.0,2925.0,0.802,17.609,143,80,57,23,63,25,38,43,0.0,0.0
1001,946,24-09-2019 19:10:00,0,3620.0,3009.0,0.831,17.595,410,228,176,52,182,137,45,38,0.0,0.0
1001,947,24-09-2019 19:12:00,0,3830.0,3106.0,0.811,18.531,426,260,213,47,166,117,49,48,0.0,0.0
1001,948,24-09-2019 19:14:00,0,3429.0,2868.0,0.836,16.684,351,205,160,45,146,99,47,30,0.0,0.0
1001,949,24-09-2019 19:16:00,0,2940.0,2508.0,0.853,14.359,188,99,68,31,89,61,28,6,0.0,0.0
1001,950,24-09-2019 19:18:00,0,2589.0,2080.0,0.804,12.503,42,29,11,18,13,6,7,0,0.0,0.0
1001,951,24-09-2019 19:20:00,0,2811.0,2137.0,0.76,13.44,162,98,61,37,64,43,21,6,0.0,0.0
1001,952,24-09-2019 19:22:00,0,2792.0,2207.0,0.7905,13.4445,240,142,95,47,98,66,32,2,0.0,0.0
1001,953,24-09-2019 19:24:00,0,2773.0,2277.0,0.821,13.449,279,151,112,39,128,91,37,35,0.0,0.01
1001,954,24-09-2019 19:26:00,0,3527.0,2926.0,0.83,17.135,112,82,39,43,30,6,24,47,0.0,0.0
1001,955,24-09-2019 19:28:00,0,3632.0,2960.0,0.815,17.586,111,89,46,43,22,11,11,40,0.0,0.0
1001,956,24-09-2019 19:30:00,0,3443.0,2803.0,0.814,16.669,130,98,57,41,32,10,22,42,0.0,0.0
1001,957,24-09-2019 19:32:00,0,3431.0,2877.0,0.839,16.705,113,81,43,38,32,10,22,42,0.0,0.0
1001,958,24-09-2019 19:34:00,0,3653.0,2931.0,0.802,17.637,85,34,14,20,51,25,26,44,0.0,0.0
1001,959,24-09-2019 19:36:00,0,3644.0,2927.0,0.803,17.599,105,34,10,24,71,34,37,49,0.0,0.0
1001,960,24-09-2019 19:38:00,0,3807.0,3138.0,0.824,18.475,83,47,26,21,36,16,20,29,0.0,0.07
1001,961,24-09-2019 19:40:00,0,3623.0,3035.0,0.838,17.634,119,73,55,18,46,28,18,19,0.0,0.02
1001,962,24-09-2019 19:42:00,0,3878.0,3380.0,0.872,19.022,257,163,129,34,94,69,25,24,0.0,0.0
1001,963,24-09-2019 19:44:00,0,3248.0,2638.0,0.812,15.716,23,18,12,6,5,1,4,0,0.0,0.0
1001,964,24-09-2019 19:46:00,0,2965.0,2402.0,0.81,14.343,3,3,3,0,0,0,0,0,0.0,0.0
1001,965,24-09-2019 19:48:00,0,2780.0,2246.0,0.808,13.439,15,9,7,2,6,2,4,0,0.0,0.0
1001,966,24-09-2019 19:50:00,0,2802.0,2178.0,0.777,13.452,29,20,12,8,9,5,4,0,0.0,0.01
1001,967,24-09-2019 19:52:00,0,2597.0,2071.0,0.797,12.524,9,8,2,6,1,0,1,0,0.0,0.0
1001,968,24-09-2019 19:54:00,0,2399.0,1942.0,0.809,11.603,4,2,0,2,2,0,2,0,0.0,0.0
1001,969,24-09-2019 19:56:00,0,2353.5,1890.0,0.8025,11.3655,10,7,3,4,3,0,3,0,0.0,0.0
1001,970,24-09-2019 19:58:00,0,2308.0,1838.0,0.796,11.128,4,2,0,2,2,0,2,0,0.0,0.0
1001,971,24-09-2019 20:00:00,0,2298.0,1838.0,0.8,11.09,242,142,110,32,100,61,39,16,0.0,0.0
1001,972,24-09-2019 20:02:00,0,2680.0,2157.0,0.805,12.948,184,108,67,41,76,47,29,23,0.0,0.0
1001,973,24-09-2019 20:04:00,0,2660.0,2232.0,0.839,12.952,141,78,48,30,63,29,34,4,0.0,0.24
1001,974,24-09-2019 20:06:00,0,3203.0,2776.0,0.867,15.692,320,195,157,38,125,92,33,67,0.0,0.0
1001,975,24-09-2019 20:08:00,0,3666.0,3290.0,0.897,18.085,116,78,42,36,38,20,18,62,0.0,0.0
1001,976,24-09-2019 20:10:00,0,3388.0,2949.0,0.87,16.615,82,57,29,28,25,5,20,43,0.0,0.0
1001,977,24-09-2019 20:12:00,0,3591.0,3116.0,0.868,17.598,109,66,38,28,43,10,33,49,0.0,0.0
1001,978,24-09-2019 20:14:00,0,3571.0,3220.0,0.902,17.633,114,66,35,31,48,15,33,43,0.0,0.0
1001,979,24-09-2019 20:16:00,0,3780.0,3313.0,0.877,18.563,108,54,27,27,54,28,26,48,0.0,0.0
1001,980,24-09-2019 20:18:00,0,3758.0,3313.0,0.882,18.473,136,83,62,21,53,27,26,20,0.0,0.0
1001,981,24-09-2019 20:20:00,0,3477.0,3098.0,0.891,17.13,37,24,13,11,13,5,8,0,0.0,0.0
1001,982,24-09-2019 20:22:00,0,2909.0,2579.0,0.887,14.316,255,174,131,43,81,52,29,13,0.24,0.0
1001,983,24-09-2019 20:24:00,0,3421.0,2934.0,0.858,16.726,403,278,222,56,125,92,33,14,0.04,0.0
1001,984,24-09-2019 20:26:00,0,3859.0,3373.0,0.874,18.938,481,322,257,65,159,136,23,14,0.22,0.0
1001,985,24-09-2019 20:28:00,0,3878.0,3375.0,0.87,19.017,491,287,224,63,204,152,52,25,0.12,0.0
1001,986,24-09-2019 20:30:00,0,3878.5,3381.5,0.8715,19.0245,307,139,97,42,168,110,58,38,0.08,0.0
1001,987,24-09-2019 20:32:00,0,3879.0,3388.0,0.873,19.032,121,67,38,29,54,28,26,46,0.0,0.0
1001,988,24-09-2019 20:34:00,0,3848.0,3457.0,0.898,18.989,107,69,42,27,38,13,25,62,0.0,0.0
1001,989,24-09-2019 20:36:00,0,4038.0,3619.0,0.896,19.917,77,40,25,15,37,17,20,44,0.0,0.09
1001,990,24-09-2019 20:38:00,0,4247.0,3795.0,0.894,20.934,46,19,15,4,27,8,19,48,0.0,0.08
1001,991,24-09-2019 20:40:00,0,4316.0,3917.0,0.908,21.34,298,196,158,38,102,66,36,35,0.3,0.01
1001,992,24-09-2019 20:42:00,0,4321.0,3824.0,0.885,21.256,328,197,148,49,131,98,33,14,0.27,0.05
1001,993,24-09-2019 20:44:00,0,3843.0,3536.0,0.92,19.055,303,212,165,47,91,55,36,29,0.0,0.0
1001,994,24-09-2019 20:46:00,0,3592.0,3178.0,0.885,17.671,18,3,0,3,15,0,15,1,0.0,0.0
1001,995,24-09-2019 20:48:00,0,2908.0,2594.0,0.892,14.329,62,40,13,27,22,3,19,8,0.0,0.0
1001,996,24-09-2019 20:50:00,0,2949.0,2514.0,0.853,14.401,89,84,41,43,5,1,4,1,0.0,0.0
1001,997,24-09-2019 20:52:00,0,2930.0,2520.0,0.86,14.336,28,26,4,22,2,0,2,0,0.0,0.0
1001,998,24-09-2019 20:54:00,0,3041.0,2619.0,0.861,14.882,147,109,70,39,38,25,13,2,0.12,0.01
1001,999,24-09-2019 20:56:00,0,4315.0,3964.0,0.919,21.39,97,68,35,33,29,5,24,46,0.01,0.03
1001,1000,24-09-2019 20:58:00,0,4497.0,4176.0,0.929,22.341,45,27,18,9,18,1,17,62,0.0,0.05
1001,1001,24-09-2019 21:00:00,0,4690.0,4255.0,0.907,23.189,107,66,51,15,41,17,24,69,0.0,0.33
1001,1002,24-09-2019 21:02:00,0,4282.0,3948.0,0.922,21.241,8,8,0,8,0,0,0,0,0.0,0.07
1001,1003,24-09-2019 21:04:00,0,3748.5,3387.5,0.9005,18.519,2,0,0,0,2,1,1,0,0.0,0.0
1001,1004,24-09-2019 21:06:00,0,3215.0,2827.0,0.879,15.797,406,263,206,57,143,105,38,8,0.25,0.0
1001,1005,24-09-2019 21:08:00,0,4574.0,4278.0,0.935,22.76,368,206,161,45,162,121,41,37,0.0,0.0
1001,1006,24-09-2019 21:10:00,0,4687.0,4343.0,0.927,23.275,34,26,24,2,8,4,4,0,0.0,0.0
1001,1007,24-09-2019 21:12:00,0,3566.0,3226.0,0.904,17.623,163,114,77,37,49,18,31,3,0.01,0.0
1001,1008,24-09-2019 21:14:00,0,3590.0,3179.0,0.886,17.666,358,224,174,50,134,98,36,6,0.16,0.0
1001,1009,24-09-2019 21:16:00,0,4286.0,3917.0,0.914,21.224,277,196,138,58,81,48,33,1,0.0,0.0
1001,1010,24-09-2019 21:18:00,0,3407.0,2990.0,0.878,16.736,511,315,230,85,196,137,59,3,0.01,0.02
1001,1011,24-09-2019 21:20:00,0,3581.0,3198.0,0.893,17.649,447,292,229,63,155,111,44,9,0.17,0.0
1001,1012,24-09-2019 21:22:00,0,4494.0,4146.0,0.923,22.297,211,113,82,31,98,59,39,17,0.01,0.0
1001,1013,24-09-2019 21:24:00,0,3311.0,2921.0,0.882,16.28,32,31,5,26,1,0,1,0,0.0,0.0
1001,1014,24-09-2019 21:26:00,0,2918.0,2536.0,0.869,14.305,65,34,4,30,31,0,31,1,0.0,0.0
1001,1015,24-09-2019 21:28:00,0,3606.0,3088.0,0.856,17.628,34,27,15,12,7,0,7,0,0.0,0.0
1001,1016,24-09-2019 21:30:00,0,3325.0,2846.0,0.856,16.25,2,0,0,0,2,0,2,0,0.0,0.0
1001,1017,24-09-2019 21:32:00,0,2942.0,2516.0,0.855,14.378,0,0,0,0,0,0,0,0,0.0,0.0
1001,1018,24-09-2019 21:34:00,0,2962.0,2453.0,0.828,14.386,5,1,0,1,4,0,4,0,0.0,0.0
1001,1019,24-09-2019 21:36:00,0,2734.0,2354.0,0.861,13.377,27,13,9,4,14,3,11,0,0.0,0.0
1001,1020,24-09-2019 21:38:00,0,2751.0,2326.5,0.846,13.4135,23,0,0,0,23,0,23,0,0.0,0.0
1001,1021,24-09-2019 21:40:00,0,2768.0,2299.0,0.831,13.45,0,0,0,0,0,0,0,0,0.0,0.0
1001,1022,24-09-2019 21:42:00,0,2766.0,2277.0,0.823,13.419,0,0,0,0,0,0,0,0,0.0,0.0
1001,1023,24-09-2019 21:44:00,0,2657.0,2235.0,0.841,12.945,0,0,0,0,0,0,0,0,0.0,0.0
1001,1024,24-09-2019 21:46:00,0,2557.0,2229.0,0.871,12.544,11,11,1,10,0,0,0,0,0.0,0.0
1001,1025,24-09-2019 21:48:00,0,2548.0,2193.0,0.861,12.467,45,32,18,14,13,5,8,0,0.0,0.0
1001,1026,24-09-2019 21:50:00,0,2560.0,2188.0,0.854,12.511,0,0,0,0,0,0,0,0,0.0,0.0
1001,1027,24-09-2019 21:52:00,0,3372.0,3087.0,0.915,16.705,0,0,0,0,0,0,0,0,0.0,0.0
1001,1028,24-09-2019 21:54:00,0,3339.0,3178.0,0.952,16.672,13,13,0,13,0,0,0,0,0.0,0.0
1001,1029,24-09-2019 21:56:00,0,3983.0,3838.0,0.964,19.944,0,0,0,0,0,0,0,0,0.01,0.0
1001,1030,24-09-2019 21:58:00,0,3790.0,3716.0,0.98,19.047,0,0,0,0,0,0,0,0,0.0,0.0
1001,1031,24-09-2019 22:00:00,0,3613.0,3529.0,0.977,18.141,0,0,0,0,0,0,0,0,0.0,0.0
1001,1032,24-09-2019 22:02:00,0,3424.0,3296.0,0.962,17.14,266,181,142,39,85,53,32,18,0.0,0.0
1001,1033,24-09-2019 22:04:00,0,3326.0,3253.0,0.978,16.704,188,103,73,30,85,58,27,56,0.0,0.0
1001,1034,24-09-2019 22:06:00,0,3530.0,3367.0,0.954,17.636,152,80,58,22,72,39,33,38,0.0,0.0
1001,1035,24-09-2019 22:08:00,0,3587.0,3546.0,0.988,18.059,191,99,61,38,92,49,43,67,0.0,0.0
1001,1036,24-09-2019 22:10:00,0,3613.0,3500.0,0.969,18.112,104,72,34,38,32,1,31,60,0.0,0.0
1001,1037,24-09-2019 22:12:00,0,3705.5,3575.5,0.965,18.5585,118,80,44,36,38,5,33,76,0.0,0.0
1001,1038,24-09-2019 22:14:00,0,3798.0,3651.0,0.961,19.005,116,59,26,33,57,8,49,61,0.0,0.0
1001,1039,24-09-2019 22:16:00,0,4014.0,3728.0,0.929,19.944,94,38,17,21,56,10,46,60,0.0,0.0
1001,1040,24-09-2019 22:18:00,0,4170.0,3932.0,0.943,20.784,120,67,33,34,53,10,43,58,0.0,0.08
1001,1041,24-09-2019 22:20:00,0,4278.0,4004.0,0.936,21.29,76,43,25,18,33,0,33,68,0.0,0.07
1001,1042,24-09-2019 22:22:00,0,4302.0,3994.0,0.929,21.371,221,150,112,38,71,35,36,52,0.0,0.0
1001,1043,24-09-2019 22:24:00,0,3823.0,3610.0,0.944,19.057,339,220,170,50,119,89,30,4,0.24,0.0
1001,1044,24-09-2019 22:26:00,0,3976.0,3879.0,0.975,19.96,353,237,184,53,116,88,28,19,0.02,0.0
1001,1045,24-09-2019 22:28:00,0,4034.0,3682.0,0.913,19.969,97,73,45,28,24,5,19,44,0.0,0.0
1001,1046,24-09-2019 22:30:00,0,3819.0,3618.0,0.947,19.054,96,51,27,24,45,17,28,49,0.0,0.0
1001,1047,24-09-2019 22:32:00,0,4024.0,3682.0,0.915,19.932,122,37,26,11,85,41,44,44,0.0,0.07
1001,1048,24-09-2019 22:34:00,0,3986.0,3866.0,0.97,19.986,227,123,97,26,104,61,43,34,0.21,0.04
1001,1049,24-09-2019 22:36:00,0,3996.0,3755.0,0.94,19.902,197,122,84,38,75,35,40,54,0.02,0.0
1001,1050,24-09-2019 22:38:00,0,4295.0,3925.0,0.914,21.267,148,104,61,43,44,7,37,36,0.0,0.0
1001,1051,24-09-2019 22:40:00,0,4273.0,4038.0,0.945,21.305,127,83,55,28,44,24,20,17,0.0,0.0
1001,1052,24-09-2019 22:42:00,0,3620.0,3429.0,0.947,18.06,52,31,3,28,21,0,21,5,0.0,0.0
1001,1053,24-09-2019 22:44:00,0,3375.0,3035.0,0.899,16.656,17,11,0,11,6,0,6,0,0.0,0.0
1001,1054,24-09-2019 22:46:00,0,3145.5,2810.5,0.893,15.504,2,1,0,1,1,0,1,0,0.0,0.0
1001,1055,24-09-2019 22:48:00,0,2916.0,2586.0,0.887,14.352,1,0,0,0,1,0,1,0,0.0,0.0
1001,1056,24-09-2019 22:50:00,0,2713.0,2475.0,0.912,13.431,1,1,0,1,0,0,0,0,0.0,0.0
1001,1057,24-09-2019 22:52:00,0,2719.0,2406.0,0.885,13.376,1,0,0,0,1,0,1,0,0.0,0.0
1001,1058,24-09-2019 22:54:00,0,2740.0,2340.0,0.854,13.386,1,1,1,0,0,0,0,0,0.0,0.0
1001,1059,24-09-2019 22:56:00,0,2747.0,2338.0,0.851,13.411,1,1,1,0,0,0,0,0,0.0,0.0
1001,1060,24-09-2019 22:58:00,0,2644.0,2279.0,0.862,12.939,232,160,131,29,72,48,24,29,0.0,0.0
1001,1061,24-09-2019 23:00:00,0,3542.0,3277.0,0.925,17.584,241,127,85,42,114,77,37,19,0.0,0.08
1001,1062,24-09-2019 23:02:00,0,3195.0,2912.0,0.911,15.812,322,177,140,37,145,102,43,43,0.05,0.0
1001,1063,24-09-2019 23:04:00,0,3827.0,3583.0,0.936,19.044,324,191,141,50,133,93,40,42,0.07,0.0
1001,1064,24-09-2019 23:06:00,0,4008.0,3787.0,0.945,19.985,145,96,53,43,49,6,43,72,0.01,0.0
1001,1065,24-09-2019 23:08:00,0,3980.0,3874.0,0.973,19.97,108,73,43,30,35,5,30,30,0.01,0.0
1001,1066,24-09-2019 23:10:00,0,4004.0,3714.0,0.928,19.887,133,93,55,38,40,7,33,47,0.0,0.0
1001,1067,24-09-2019 23:12:00,0,4009.0,3774.0,0.941,19.973,142,55,29,26,87,47,40,49,0.0,0.0
1001,1068,24-09-2019 23:14:00,0,4284.0,4027.0,0.94,21.336,96,52,31,21,44,5,39,47,0.0,0.0
1001,1069,24-09-2019 23:16:00,0,4287.0,4062.0,0.948,21.387,158,114,72,42,44,19,25,36,0.0,0.0
1001,1070,24-09-2019 23:18:00,0,4280.0,4076.0,0.952,21.377,82,36,13,23,46,9,37,48,0.0,0.0
1001,1071,24-09-2019 23:20:00,0,4461.5,4271.0,0.957,22.3085,156,87,62,25,69,26,43,48,0.0,0.0
1001,1072,24-09-2019 23:22:00,0,4643.0,4466.0,0.962,23.24,206,140,97,43,66,44,22,38,0.23,0.05
1001,1073,24-09-2019 23:24:00,0,4454.0,4294.0,0.964,22.304,104,49,25,24,55,27,28,61,0.01,0.02
1001,1074,24-09-2019 23:26:00,0,4372.0,4116.0,0.941,21.78,127,82,55,27,45,0,45,69,0.0,0.05
1001,1075,24-09-2019 23:28:00,0,4634.0,4453.0,0.961,23.188,179,101,67,34,78,46,32,35,0.0,0.08
1001,1076,24-09-2019 23:30:00,0,4369.0,4097.0,0.938,21.75,84,36,14,22,48,17,31,14,0.0,0.0
1001,1077,24-09-2019 23:32:00,0,3453.0,3210.0,0.93,17.157,292,189,139,50,103,70,33,46,0.1,0.0
1001,1078,24-09-2019 23:34:00,0,4468.0,4149.0,0.929,22.198,123,69,40,29,54,21,33,49,0.0,0.0
1001,1079,24-09-2019 23:36:00,0,4538.0,4322.0,0.952,22.667,117,50,31,19,67,29,38,55,0.0,0.03
1001,1080,24-09-2019 23:38:00,0,4938.0,4585.0,0.928,24.533,131,88,42,46,43,10,33,66,0.0,0.06
1001,1081,24-09-2019 23:40:00,0,4439.0,4261.0,0.96,22.207,180,105,73,32,75,46,29,24,0.0,0.09
1001,1082,24-09-2019 23:42:00,0,4369.0,4114.0,0.942,21.767,170,87,54,33,83,60,23,3,0.0,0.0
1001,1083,24-09-2019 23:44:00,0,3547.0,3327.0,0.938,17.656,140,98,54,44,42,17,25,9,0.0,0.0
1001,1084,24-09-2019 23:46:00,0,3299.0,2953.0,0.895,16.266,189,128,90,38,61,45,16,24,0.06,0.03
1001,1085,24-09-2019 23:48:00,0,5306.0,5037.0,0.949,26.481,229,166,124,42,63,31,32,54,0.0,0.0
1001,1086,24-09-2019 23:50:00,0,4479.0,4180.0,0.933,22.273,154,91,48,43,63,27,36,46,0.0,0.0
1001,1087,24-09-2019 23:52:00,0,4385.0,4090.0,0.933,21.805,69,30,17,13,39,16,23,30,0.0,0.03
1001,1088,24-09-2019 23:54:00,0,4421.5,4187.0,0.947,22.0565,118,69,42,27,49,22,27,36,0.0,0.04
1001,1089,24-09-2019 23:56:00,0,4458.0,4284.0,0.961,22.308,338,146,103,43,192,136,56,4,0.18,0.0
1001,1090,24-09-2019 23:58:00,0,3853.0,3504.0,0.91,19.059,391,209,158,51,182,122,60,4,0.0,0.0
1001,1091,25-09-2019 00:00:00,0,3544.0,3310.0,0.934,17.627,329,198,151,47,131,97,34,37,0.0,0.03
1001,1092,25-09-2019 00:02:00,0,4280.0,4025.0,0.94,21.32,69,34,18,16,35,16,19,39,0.0,0.0
1001,1093,25-09-2019 00:04:00,0,4573.0,4309.0,0.942,22.789,123,57,34,23,66,35,31,59,0.0,0.02
1001,1094,25-09-2019 00:06:00,0,4448.0,4245.0,0.954,22.225,166,103,74,29,63,31,32,47,0.0,0.02
1001,1095,25-09-2019 00:08:00,0,4292.0,4051.0,0.944,21.396,92,62,36,26,30,23,7,4,0.0,0.0
1001,1096,25-09-2019 00:10:00,0,3547.0,3343.0,0.942,17.676,48,33,9,24,15,3,12,5,0.0,0.0
1001,1097,25-09-2019 00:12:00,0,3383.0,3062.0,0.905,16.718,11,8,3,5,3,1,2,0,0.0,0.01
1001,1098,25-09-2019 00:14:00,0,3371.0,3073.0,0.911,16.685,27,23,7,16,4,3,1,0,0.01,0.02
1001,1099,25-09-2019 00:16:00,0,3199.0,2848.0,0.89,15.758,0,0,0,0,0,0,0,0,0.0,0.0
1001,1100,25-09-2019 00:18:00,0,3121.0,2728.0,0.874,15.316,1,1,0,1,0,0,0,0,0.0,0.01
1001,1101,25-09-2019 00:20:00,0,2922.0,2597.0,0.889,14.387,1,0,0,0,1,1,0,0,0.0,0.0
1001,1102,25-09-2019 00:22:00,0,2921.0,2538.0,0.869,14.319,7,7,0,7,0,0,0,0,0.0,0.0
1001,1103,25-09-2019 00:24:00,0,2821.0,2482.0,0.88,13.864,11,8,0,8,3,0,3,0,0.0,0.0
1001,1104,25-09-2019 00:26:00,0,2722.0,2436.0,0.895,13.424,15,8,6,2,7,2,5,0,0.0,0.0
1001,1105,25-09-2019 00:28:00,0,2631.0,2350.5,0.893,12.9705,0,0,0,0,0,0,0,0,0.0,0.0
1001,1106,25-09-2019 00:30:00,0,2540.0,2265.0,0.891,12.517,6,6,1,5,0,0,0,0,0.0,0.0
1001,1107,25-09-2019 00:32:00,0,2559.0,2206.0,0.862,12.525,35,35,0,35,0,0,0,0,0.0,0.0
1001,1108,25-09-2019 00:34:00,0,2573.0,2158.0,0.839,12.528,41,33,20,13,8,4,4,0,0.0,0.0
1001,1109,25-09-2019 00:36:00,0,2568.0,2176.0,0.847,12.527,0,0,0,0,0,0,0,0,0.0,0.0
1001,1110,25-09-2019 00:38:00,0,2566.0,2127.0,0.829,12.464,19,5,0,5,14,2,12,0,0.0,0.0
1001,1111,25-09-2019 00:40:00,0,2575.0,2159.0,0.839,12.537,14,4,0,4,10,0,10,0,0.01,0.0
1001,1112,25-09-2019 00:42:00,0,2555.0,2218.0,0.868,12.521,107,95,60,35,12,6,6,2,0.0,0.0
1001,1113,25-09-2019 00:44:00,0,2989.0,2742.0,0.917,14.814,399,251,191,60,148,104,44,43,0.0,0.02
1001,1114,25-09-2019 00:46:00,0,3498.0,3453.0,0.987,17.605,269,129,84,45,140,92,48,29,0.0,0.0
1001,1115,25-09-2019 00:48:00,0,4243.0,4173.0,0.984,21.336,178,118,84,34,60,32,28,84,0.0,0.0
1001,1116,25-09-2019 00:50:00,0,4053.0,4051.0,0.999,20.453,101,67,30,37,34,1,33,71,0.0,0.0
1001,1117,25-09-2019 00:52:00,0,3945.0,3996.0,1.013,19.966,86,55,32,23,31,4,27,71,0.0,0.0
1001,1118,25-09-2019 00:54:00,0,3975.0,3869.0,0.973,19.946,125,67,17,50,58,30,28,46,0.0,0.0
1001,1119,25-09-2019 00:56:00,0,3974.0,3827.0,0.963,19.895,63,27,10,17,36,7,29,38,0.0,0.03
1001,1120,25-09-2019 00:58:00,0,3960.0,3896.0,0.984,19.918,45,13,7,6,32,13,19,29,0.0,0.0
1001,1121,25-09-2019 01:00:00,0,4277.0,4023.0,0.941,21.305,69,40,18,22,29,5,24,34,0.0,0.1
1001,1122,25-09-2019 01:02:00,0,4228.5,3974.5,0.94,21.06,114,57,25,32,57,41,16,42,0.0,0.03
1001,1123,25-09-2019 01:04:00,0,4180.0,3926.0,0.939,20.815,226,103,77,26,123,85,38,17,0.0,0.06
1001,1124,25-09-2019 01:06:00,0,3809.0,3546.0,0.931,18.932,880,488,384,104,392,299,93,12,0.21,0.0
1001,1125,25-09-2019 01:08:00,0,3542.0,3308.0,0.934,17.619,693,470,368,102,223,168,55,10,0.0,0.01
1001,1126,25-09-2019 01:10:00,0,3331.0,3195.0,0.959,16.659,592,429,347,82,163,114,49,19,0.0,0.0
1001,1127,25-09-2019 01:12:00,0,4009.0,3752.0,0.936,19.947,480,320,262,58,160,115,45,45,0.05,0.03
1001,1128,25-09-2019 01:14:00,0,4445.0,4332.0,0.975,22.308,364,180,133,47,184,129,55,76,0.12,0.0
1001,1129,25-09-2019 01:16:00,0,3975.0,3814.0,0.959,19.885,126,88,51,37,38,4,34,100,0.0,0.0
1001,1130,25-09-2019 01:18:00,0,4355.0,4138.0,0.95,21.741,199,130,89,41,69,43,26,52,0.0,0.03
1001,1131,25-09-2019 01:20:00,0,4358.0,4199.0,0.963,21.819,47,35,16,19,12,5,7,64,0.0,0.0
1001,1132,25-09-2019 01:22:00,0,4383.0,4140.0,0.945,21.853,114,54,26,28,60,31,29,41,0.0,0.03
1001,1133,25-09-2019 01:24:00,0,4458.0,4264.0,0.956,22.283,305,174,128,46,131,92,39,24,0.0,0.05
1001,1134,25-09-2019 01:26:00,0,3821.0,3547.0,0.928,18.981,182,122,78,44,60,30,30,0,0.0,0.02
1001,1135,25-09-2019 01:28:00,0,3362.0,3157.0,0.939,16.74,58,34,8,26,24,0,24,0,0.0,0.0
1001,1136,25-09-2019 01:30:00,0,3201.0,2821.0,0.881,15.735,220,122,70,52,98,52,46,9,0.0,0.0
1001,1137,25-09-2019 01:32:00,0,3212.0,2841.0,0.885,15.8,92,57,25,32,35,11,24,5,0.0,0.0
1001,1138,25-09-2019 01:34:00,0,3205.0,2823.0,0.881,15.753,58,29,11,18,29,5,24,3,0.0,0.0
1001,1139,25-09-2019 01:36:00,0,3201.0,2840.0,0.8875,15.755,151,107,60,47,44,0,44,1,0.0,0.0
1001,1140,25-09-2019 01:38:00,0,3197.0,2857.0,0.894,15.757,91,62,35,27,29,0,29,0,0.0,0.0
1001,1141,25-09-2019 01:40:00,0,3393.0,2997.0,0.883,16.686,0,0,0,0,0,0,0,0,0.0,0.0
1001,1142,25-09-2019 01:42:00,0,3188.0,2909.0,0.913,15.78,14,6,4,2,8,0,8,0,0.01,0.0
1001,1143,25-09-2019 01:44:00,0,3210.0,2806.0,0.874,15.753,11,9,1,8,2,0,2,0,0.0,0.0
1001,1144,25-09-2019 01:46:00,0,3010.0,2731.0,0.907,14.883,3,0,0,0,3,1,2,0,0.0,0.0
1001,1145,25-09-2019 01:48:00,0,2931.0,2562.0,0.874,14.384,23,14,6,8,9,3,6,0,0.0,0.0
1001,1146,25-09-2019 01:50:00,0,2824.0,2491.0,0.882,13.886,0,0,0,0,0,0,0,0,0.0,0.0
1001,1147,25-09-2019 01:52:00,0,2738.0,2398.0,0.876,13.445,0,0,0,0,0,0,0,0,0.0,0.0
1001,1148,25-09-2019 01:54:00,0,2720.0,2407.0,0.885,13.383,0,0,0,0,0,0,0,0,0.0,0.0
1001,1149,25-09-2019 01:56:00,0,2739.0,2423.0,0.885,13.473,4,4,2,2,0,0,0,0,0.0,0.0
1001,1150,25-09-2019 01:58:00,0,2983.0,2765.0,0.927,14.816,467,325,258,67,142,102,40,1,0.0,0.0
1001,1151,25-09-2019 02:00:00,0,4245.0,4195.0,0.988,21.37,748,530,435,95,218,158,60,8,0.0,0.0
1001,1152,25-09-2019 02:02:00,0,4240.0,4187.0,0.988,21.339,667,463,384,79,204,150,54,43,0.0,0.0
1001,1153,25-09-2019 02:04:00,0,4418.0,4429.0,1.002,22.308,212,182,143,39,30,12,18,51,0.01,0.0
1001,1154,25-09-2019 02:06:00,0,3972.0,3944.0,0.993,20.016,202,133,82,51,69,39,30,35,0.0,0.0
1001,1155,25-09-2019 02:08:00,0,4242.0,4142.0,0.976,21.299,421,273,227,46,148,102,46,25,0.04,0.02
1001,1156,25-09-2019 02:10:00,0,4264.0,4117.0,0.9655,21.3585,114,81,43,38,33,19,14,11,0.01,0.0
1001,1157,25-09-2019 02:12:00,0,4286.0,4092.0,0.955,21.418,23,16,2,14,7,2,5,8,0.0,0.0
1001,1158,25-09-2019 02:14:00,0,4229.0,4159.0,0.984,21.266,56,37,8,29,19,0,19,6,0.0,0.0
1001,1159,25-09-2019 02:16:00,0,4230.0,4192.0,0.991,21.307,64,35,8,27,29,7,22,7,0.0,0.0
1001,1160,25-09-2019 02:18:00,0,4347.0,4201.0,0.967,21.776,194,118,92,26,76,46,30,7,0.15,0.0
1001,1161,25-09-2019 02:20:00,0,4259.0,4097.0,0.962,21.315,80,49,36,13,31,24,7,0,0.0,0.0
1001,1162,25-09-2019 02:22:00,0,4273.0,4086.0,0.956,21.358,107,82,40,42,25,4,21,3,0.0,0.0
1001,1163,25-09-2019 02:24:00,0,4274.0,4020.0,0.941,21.291,81,72,52,20,9,0,9,3,0.0,0.0
1001,1164,25-09-2019 02:26:00,0,3956.0,3858.0,0.975,19.856,4,3,1,2,1,0,1,0,0.0,0.0
1001,1165,25-09-2019 02:28:00,0,3785.0,3690.0,0.975,18.998,8,7,1,6,1,0,1,0,0.0,0.0
1001,1166,25-09-2019 02:30:00,0,3710.0,3498.0,0.943,18.49,1,1,1,0,0,0,0,0,0.0,0.0
1001,1167,25-09-2019 02:32:00,0,3523.0,3310.0,0.94,17.545,2,2,0,2,0,0,0,0,0.0,0.0
1001,1168,25-09-2019 02:34:00,0,3344.0,3191.0,0.954,16.706,1,1,0,1,0,0,0,0,0.0,0.0
1001,1169,25-09-2019 02:36:00,0,3360.0,3077.0,0.916,16.646,76,48,26,22,28,9,19,0,0.0,0.0
1001,1170,25-09-2019 02:38:00,0,3385.0,3045.0,0.899,16.708,7,7,1,6,0,0,0,0,0.0,0.0
1001,1171,25-09-2019 02:40:00,0,3163.0,2965.0,0.938,15.746,4,4,0,4,0,0,0,0,0.0,0.0
1001,1172,25-09-2019 02:42:00,0,3069.0,2862.0,0.933,15.261,3,3,0,3,0,0,0,0,0.0,0.0
1001,1173,25-09-2019 02:44:00,0,2925.0,2750.5,0.941,14.569,8,7,4,3,1,0,1,0,0.0,0.0
1001,1174,25-09-2019 02:46:00,0,2781.0,2639.0,0.949,13.877,19,19,5,14,0,0,0,0,0.0,0.0
1001,1175,25-09-2019 02:48:00,0,2677.0,2634.0,0.984,13.464,21,21,6,15,0,0,0,0,0.0,0.0
1001,1176,25-09-2019 02:50:00,0,2574.0,2597.0,1.009,13.016,31,31,5,26,0,0,0,0,0.0,0.0
1001,1177,25-09-2019 02:52:00,0,2599.0,2513.0,0.967,13.02,0,0,0,0,0,0,0,0,0.0,0.0
1001,1178,25-09-2019 02:54:00,0,2613.0,2427.0,0.929,12.981,50,35,24,11,15,5,10,0,0.0,0.0
1001,1179,25-09-2019 02:56:00,0,2618.0,2448.0,0.935,13.024,95,66,39,27,29,4,25,63,0.0,0.0
1001,1180,25-09-2019 02:58:00,0,2567.0,2633.0,1.026,13.029,31,26,9,17,5,1,4,64,0.0,0.0
1001,1181,25-09-2019 03:00:00,0,2759.0,2788.0,1.011,13.956,89,47,14,33,42,3,39,57,0.0,0.0
1001,1182,25-09-2019 03:02:00,0,3148.0,3050.0,0.969,15.781,73,47,19,28,26,9,17,64,0.0,0.0
1001,1183,25-09-2019 03:04:00,0,3261.0,3104.0,0.952,16.286,109,62,20,42,47,9,38,65,0.0,0.01
1001,1184,25-09-2019 03:06:00,0,3243.0,3159.0,0.974,16.276,92,57,27,30,35,17,18,65,0.0,0.0
1001,1185,25-09-2019 03:08:00,0,3411.0,3392.0,0.995,17.193,85,11,4,7,74,43,31,46,0.0,0.0
1001,1186,25-09-2019 03:10:00,0,3724.0,3532.0,0.948,18.583,77,34,10,24,43,23,20,29,0.0,0.16
1001,1187,25-09-2019 03:12:00,0,3707.0,3575.0,0.964,18.564,51,6,0,6,45,17,28,6,0.0,0.3
1001,1188,25-09-2019 03:14:00,0,3234.0,3179.0,0.983,16.26,3,0,0,0,3,0,3,0,0.0,0.01
1001,1189,25-09-2019 03:16:00,0,3422.0,3325.0,0.971,17.164,158,95,72,23,63,48,15,5,0.0,0.0
1001,1190,25-09-2019 03:18:00,0,3514.0,3404.5,0.9685,17.6135,328,212,151,61,116,86,30,16,0.2,0.01
1001,1191,25-09-2019 03:20:00,0,3606.0,3484.0,0.966,18.063,523,269,204,65,254,185,69,19,0.0,0.0
1001,1192,25-09-2019 03:22:00,0,3358.0,3085.0,0.919,16.644,521,340,281,59,181,138,43,54,0.15,0.03
1001,1193,25-09-2019 03:24:00,0,3429.0,3254.0,0.949,17.111,176,113,90,23,63,44,19,5,0.0,0.0
1001,1194,25-09-2019 03:26:00,0,3789.0,3682.0,0.972,19.006,713,453,376,77,260,191,69,15,0.0,0.0
1001,1195,25-09-2019 03:28:00,0,3349.0,3209.0,0.958,16.746,494,381,294,87,113,77,36,16,0.0,0.02
1001,1196,25-09-2019 03:30:00,0,3171.0,2924.0,0.922,15.731,519,365,294,71,154,107,47,9,0.0,0.0
1001,1197,25-09-2019 03:32:00,0,3978.0,3813.0,0.959,19.897,536,264,209,55,272,203,69,7,0.0,0.0
1001,1198,25-09-2019 03:34:00,0,3544.0,3283.0,0.927,17.597,507,309,250,59,198,150,48,23,0.09,0.0
1001,1199,25-09-2019 03:36:00,0,4247.0,4148.0,0.977,21.325,258,159,116,43,99,68,31,12,0.0,0.0
1001,1200,25-09-2019 03:38:00,0,3441.0,3265.0,0.949,17.17,86,64,27,37,22,2,20,6,0.0,0.0
1001,1201,25-09-2019 03:40:00,0,2982.0,2740.0,0.919,14.781,97,68,32,36,29,0,29,0,0.0,0.0
1001,1202,25-09-2019 03:42:00,0,3113.0,2713.0,0.872,15.268,81,53,24,29,28,2,26,0,0.0,0.0
1001,1203,25-09-2019 03:44:00,0,3983.0,3808.0,0.956,19.909,115,67,34,33,48,25,23,11,0.0,0.0
1001,1204,25-09-2019 03:46:00,0,4279.0,4034.0,0.943,21.325,7,4,2,2,3,0,3,0,0.0,0.0
1001,1205,25-09-2019 03:48:00,0,3838.0,3544.0,0.924,19.044,1,1,0,1,0,0,0,0,0.0,0.0
1001,1206,25-09-2019 03:50:00,0,3540.0,3373.0,0.953,17.683,3,3,0,3,0,0,0,0,0.0,0.0
1001,1207,25-09-2019 03:52:00,0,3541.5,3327.5,0.9395,17.639,2,1,0,1,1,0,1,0,0.0,0.0
1001,1208,25-09-2019 03:54:00,0,3543.0,3282.0,0.926,17.595,1,1,0,1,0,0,0,0,0.0,0.0
1001,1209,25-09-2019 03:56:00,0,3537.0,3305.0,0.934,17.595,7,5,2,3,2,0,2,0,0.01,0.0
1001,1210,25-09-2019 03:58:00,0,3536.0,3272.0,0.925,17.555,0,0,0,0,0,0,0,0,0.0,0.0
1001,1211,25-09-2019 04:00:00,0,3519.0,3385.0,0.962,17.614,10,10,1,9,0,0,0,0,0.01,0.0
1001,1212,25-09-2019 04:02:00,0,3418.0,3283.0,0.961,17.104,108,81,57,24,27,12,15,1,0.0,0.0
1001,1213,25-09-2019 04:04:00,0,3328.0,3178.0,0.955,16.632,620,453,366,87,167,113,54,24,0.0,0.0
1001,1214,25-09-2019 04:06:00,0,3528.0,3329.0,0.944,17.584,613,497,401,96,116,72,44,16,0.0,0.0
1001,1215,25-09-2019 04:08:00,0,3519.0,3319.0,0.943,17.54,450,370,300,70,80,49,31,21,0.0,0.0
1001,1216,25-09-2019 04:10:00,0,3504.0,3428.0,0.978,17.602,43,42,19,23,1,0,1,8,0.0,0.0
1001,1217,25-09-2019 04:12:00,0,3603.0,3484.0,0.967,18.055,8,8,0,8,0,0,0,0,0.0,0.0
1001,1218,25-09-2019 04:14:00,0,3810.0,3574.0,0.938,18.969,2,2,0,2,0,0,0,0,0.0,0.0
1001,1219,25-09-2019 04:16:00,0,3611.0,3476.0,0.963,18.074,0,0,0,0,0,0,0,0,0.0,0.0
1001,1220,25-09-2019 04:18:00,0,3556.0,3308.0,0.93,17.671,9,9,0,9,0,0,0,0,0.0,0.0
1001,1221,25-09-2019 04:20:00,0,3344.0,3151.0,0.942,16.663,12,10,4,6,2,1,1,0,0.0,0.0
1001,1222,25-09-2019 04:22:00,0,3273.0,3027.0,0.925,16.246,8,8,2,6,0,0,0,0,0.0,0.0
1001,1223,25-09-2019 04:24:00,0,3153.0,2983.0,0.946,15.726,0,0,0,0,0,0,0,0,0.0,0.0
1001,1224,25-09-2019 04:26:00,0,2949.5,2884.5,0.9805,14.814,0,0,0,0,0,0,0,0,0.0,0.0
1001,1225,25-09-2019 04:28:00,0,2746.0,2786.0,1.015,13.902,4,4,0,4,0,0,0,0,0.0,0.0
1001,1226,25-09-2019 04:30:00,0,2772.0,2720.0,0.981,13.931,16,15,7,8,1,1,0,0,0.0,0.0
1001,1227,25-09-2019 04:32:00,0,2792.0,2655.0,0.951,13.938,15,14,6,8,1,1,0,0,0.0,0.0
1001,1228,25-09-2019 04:34:00,0,2778.0,2718.0,0.979,13.953,30,29,12,17,1,0,1,4,0.0,0.0
1001,1229,25-09-2019 04:36:00,0,2850.0,2870.0,1.007,14.407,20,19,10,9,1,1,0,0,0.0,0.0
1001,1230,25-09-2019 04:38:00,0,2852.0,2861.0,1.003,14.405,3,3,0,3,0,0,0,0,0.0,0.0
1001,1231,25-09-2019 04:40:00,0,2740.0,2766.0,1.01,13.859,18,18,0,18,0,0,0,0,0.0,0.0
1001,1232,25-09-2019 04:42:00,0,2783.0,2707.0,0.973,13.961,0,0,0,0,0,0,0,0,0.0,0.0
1001,1233,25-09-2019 04:44:00,0,2679.0,2627.0,0.98,13.464,21,21,6,15,0,0,0,0,0.0,0.0
1001,1234,25-09-2019 04:46:00,0,2571.0,2611.0,1.016,13.021,0,0,0,0,0,0,0,0,0.0,0.0
1001,1235,25-09-2019 04:48:00,0,2597.0,2547.0,0.981,13.051,0,0,0,0,0,0,0,0,0.0,0.0
1001,1236,25-09-2019 04:50:00,0,2580.0,2508.0,0.972,12.943,0,0,0,0,0,0,0,0,0.0,0.0
1001,1237,25-09-2019 04:52:00,0,2613.0,2461.0,0.942,13.019,18,17,5,12,1,0,1,0,0.0,0.0
1001,1238,25-09-2019 04:54:00,0,2601.0,2516.0,0.967,13.035,0,0,0,0,0,0,0,0,0.0,0.0
1001,1239,25-09-2019 04:56:00,0,2589.0,2545.0,0.983,13.017,0,0,0,0,0,0,0,0,0.0,0.0
1001,1240,25-09-2019 04:58:00,0,2576.0,2517.0,0.977,12.937,0,0,0,0,0,0,0,0,0.0,0.0
1001,1241,25-09-2019 05:00:00,0,2648.5,2494.5,0.9425,13.198,3,3,1,2,0,0,0,0,0.0,0.0
1001,1242,25-09-2019 05:02:00,0,2721.0,2472.0,0.908,13.459,56,44,31,13,12,10,2,0,0.0,0.0
1001,1243,25-09-2019 05:04:00,0,2702.0,2497.0,0.924,13.411,224,163,126,37,61,35,26,38,0.0,0.0
1001,1244,25-09-2019 05:06:00,0,2670.0,2643.0,0.99,13.445,155,132,97,35,23,3,20,4,0.0,0.0
1001,1245,25-09-2019 05:08:00,0,2852.0,2793.0,0.979,14.329,91,54,21,33,37,0,37,0,0.0,0.0
1001,1246,25-09-2019 05:10:00,0,3073.0,2928.0,0.953,15.35,68,53,25,28,15,0,15,15,0.0,0.0
1001,1247,25-09-2019 05:12:00,0,3250.0,3102.0,0.954,16.239,98,63,29,34,35,12,23,9,0.0,0.0
1001,1248,25-09-2019 05:14:00,0,3331.0,3248.0,0.975,16.72,375,202,151,51,173,130,43,32,0.0,0.0
1001,1249,25-09-2019 05:16:00,0,3525.0,3397.0,0.964,17.649,196,116,82,34,80,49,31,47,0.14,0.0
1001,1250,25-09-2019 05:18:00,0,3529.0,3353.0,0.95,17.618,78,42,20,22,36,3,33,72,0.0,0.0
1001,1251,25-09-2019 05:20:00,0,3505.0,3397.0,0.969,17.569,225,135,96,39,90,59,31,73,0.0,0.0
1001,1252,25-09-2019 05:22:00,0,3432.0,3242.0,0.944,17.113,216,137,96,41,79,45,34,37,0.0,0.01
1001,1253,25-09-2019 05:24:00,0,2891.0,2666.0,0.922,14.341,242,161,122,39,81,50,31,55,0.12,0.0
1001,1254,25-09-2019 05:26:00,0,3814.0,3538.0,0.928,18.945,176,111,63,48,65,20,45,84,0.01,0.0
1001,1255,25-09-2019 05:28:00,0,3809.0,3598.0,0.945,18.99,102,52,17,35,50,13,37,49,0.0,0.0
1001,1256,25-09-2019 05:30:00,0,3997.0,3747.0,0.937,19.897,149,78,44,34,71,42,29,41,0.0,0.07
1001,1257,25-09-2019 05:32:00,0,3710.0,3485.0,0.939,18.476,609,359,295,64,250,191,59,25,0.2,0.03
1001,1258,25-09-2019 05:34:00,0,3653.0,3489.0,0.9555,18.2555,624,303,255,48,321,242,79,37,0.01,0.01
1001,1259,25-09-2019 05:36:00,0,3596.0,3493.0,0.972,18.035,244,104,75,29,140,103,37,9,0.0,0.01
1001,1260,25-09-2019 05:38:00,0,3157.0,3006.0,0.952,15.769,316,168,128,40,148,112,36,19,0.0,0.0
1001,1261,25-09-2019 05:40:00,0,2778.0,2667.0,0.96,13.898,266,180,132,48,86,61,25,21,0.0,0.0
1001,1262,25-09-2019 05:42:00,0,3865.0,3829.0,0.991,19.468,133,70,27,43,63,39,24,51,0.0,0.0
1001,1263,25-09-2019 05:44:00,0,3882.0,3811.0,0.982,19.515,110,63,39,24,47,19,28,68,0.0,0.0
1001,1264,25-09-2019 05:46:00,0,4162.0,4092.0,0.983,20.928,232,145,96,49,87,52,35,67,0.0,0.0
1001,1265,25-09-2019 05:48:00,0,3892.0,3789.0,0.974,19.528,489,282,226,56,207,163,44,26,0.18,0.0
1001,1266,25-09-2019 05:50:00,0,4154.0,4005.0,0.964,20.801,114,82,54,28,32,7,25,69,0.0,0.09
1001,1267,25-09-2019 05:52:00,0,4340.0,4161.0,0.959,21.704,113,80,51,29,33,4,29,60,0.0,0.0
1001,1268,25-09-2019 05:54:00,0,4262.0,4144.0,0.972,21.381,64,35,24,11,29,9,20,65,0.01,0.05
1001,1269,25-09-2019 05:56:00,0,4312.0,4296.0,0.996,21.743,105,75,58,17,30,5,25,60,0.0,0.05
1001,1270,25-09-2019 05:58:00,0,4162.0,3981.0,0.956,20.804,187,141,93,48,46,21,25,18,0.0,0.0
1001,1271,25-09-2019 06:00:00,1,3331.0,3267.0,0.981,16.74,51,40,22,18,11,2,9,1,0.0,0.01
1001,1272,25-09-2019 06:02:00,1,3150.0,3059.0,0.971,15.797,122,56,42,14,66,46,20,9,0.0,0.0
1001,1273,25-09-2019 06:04:00,1,2863.0,2817.0,0.984,14.399,46,26,11,15,20,10,10,0,0.0,0.0
1001,1274,25-09-2019 06:06:00,1,2876.0,2767.0,0.962,14.396,74,50,7,43,24,1,23,0,0.0,0.0
1001,1275,25-09-2019 06:08:00,1,3032.5,2816.5,0.9305,15.0665,146,82,43,39,64,38,26,9,0.0,0.01
1001,1276,25-09-2019 06:10:00,1,3189.0,2866.0,0.899,15.737,19,2,0,2,17,0,17,0,0.0,0.0
1001,1277,25-09-2019 06:12:00,1,3005.0,2729.0,0.908,14.86,0,0,0,0,0,0,0,0,0.0,0.0
1001,1278,25-09-2019 06:14:00,1,2902.0,2641.0,0.91,14.359,11,9,5,4,2,1,1,0,0.0,0.0
1001,1279,25-09-2019 06:16:00,1,2933.0,2545.0,0.867,14.374,0,0,0,0,0,0,0,0,0.0,0.0
1001,1280,25-09-2019 06:18:00,1,2932.0,2512.0,0.857,14.331,0,0,0,0,0,0,0,0,0.0,0.0
1001,1281,25-09-2019 06:20:00,1,2936.0,2516.0,0.857,14.355,14,14,8,6,0,0,0,0,0.0,0.0
1001,1282,25-09-2019 06:22:00,1,3114.0,2712.0,0.871,15.27,82,36,24,12,46,3,43,1,0.01,0.0
1001,1283,25-09-2019 06:24:00,1,3991.0,3846.0,0.964,19.98,300,186,147,39,114,78,36,52,0.0,0.0
1001,1284,25-09-2019 06:26:00,1,3790.0,3634.0,0.959,18.955,187,76,56,20,111,78,33,50,0.0,0.0
1001,1285,25-09-2019 06:28:00,1,3971.0,3874.0,0.976,19.934,126,68,44,24,58,38,20,57,0.0,0.06
1001,1286,25-09-2019 06:30:00,1,3963.0,3899.0,0.984,19.933,327,204,150,54,123,73,50,35,0.0,0.0
1001,1287,25-09-2019 06:32:00,1,3260.0,3062.0,0.94,16.233,544,328,256,72,216,156,60,25,0.0,0.0
1001,1288,25-09-2019 06:34:00,1,3631.0,3458.0,0.952,18.133,526,340,279,61,186,140,46,38,0.0,0.0
1001,1289,25-09-2019 06:36:00,1,3837.0,3584.0,0.934,19.084,364,285,218,67,79,51,28,9,0.0,0.0
1001,1290,25-09-2019 06:38:00,1,3639.0,3410.0,0.937,18.115,207,138,90,48,69,43,26,32,0.0,0.0
1001,1291,25-09-2019 06:40:00,1,4015.0,3734.0,0.93,19.953,139,110,65,45,29,2,27,38,0.0,0.0
1001,1292,25-09-2019 06:42:00,1,3452.0,3203.0,0.9275,17.1465,181,144,100,44,37,16,21,21,0.0,0.01
1001,1293,25-09-2019 06:44:00,1,2889.0,2672.0,0.925,14.34,95,57,34,23,38,10,28,1,0.0,0.02
1001,1294,25-09-2019 06:46:00,1,2738.0,2345.0,0.857,13.384,265,189,136,53,76,51,25,2,0.0,0.0
1001,1295,25-09-2019 06:48:00,1,3201.0,2846.0,0.889,15.765,570,298,226,72,272,204,68,5,0.0,0.06
1001,1296,25-09-2019 06:50:00,1,3728.0,3442.0,0.923,18.497,160,141,93,48,19,6,13,5,0.0,0.0
1001,1297,25-09-2019 06:52:00,1,3367.0,3082.0,0.916,16.677,14,6,0,6,8,1,7,0,0.0,0.0
1001,1298,25-09-2019 06:54:00,1,3547.0,3260.0,0.919,17.584,33,2,0,2,31,0,31,0,0.0,0.0
1001,1299,25-09-2019 06:56:00,1,3800.0,3658.0,0.963,19.023,22,1,0,1,21,0,21,0,0.0,0.0
1001,1300,25-09-2019 06:58:00,1,3820.0,3531.0,0.924,18.961,26,17,7,10,9,4,5,0,0.0,0.0
1001,1301,25-09-2019 07:00:00,1,3653.0,3440.0,0.942,18.202,20,11,4,7,9,2,7,0,0.0,0.0
1001,1302,25-09-2019 07:02:00,1,3544.0,3319.0,0.936,17.636,0,0,0,0,0,0,0,0,0.0,0.0
1001,1303,25-09-2019 07:04:00,1,3345.0,3204.0,0.958,16.727,0,0,0,0,0,0,0,0,0.0,0.0
1001,1304,25-09-2019 07:06:00,1,3362.0,3075.0,0.915,16.652,6,0,0,0,6,0,6,0,0.0,0.0
1001,1305,25-09-2019 07:08:00,1,3177.0,2946.0,0.927,15.779,5,4,3,1,1,0,1,0,0.0,0.0
1001,1306,25-09-2019 07:10:00,1,3083.0,2829.0,0.918,15.279,0,0,0,0,0,0,0,0,0.0,0.0
1001,1307,25-09-2019 07:12:00,1,2881.0,2729.0,0.947,14.373,3,1,0,1,2,1,1,0,0.0,0.0
1001,1308,25-09-2019 07:14:00,1,2906.0,2630.0,0.905,14.362,0,0,0,0,0,0,0,0,0.0,0.0
1001,1309,25-09-2019 07:16:00,1,2818.5,2534.0,0.899,13.9105,1,0,0,0,1,0,1,0,0.0,0.0
1001,1310,25-09-2019 07:18:00,1,2731.0,2438.0,0.893,13.459,5,3,0,3,2,0,2,0,0.0,0.0
1001,1311,25-09-2019 07:20:00,1,2746.0,2352.0,0.857,13.424,20,14,5,9,6,3,3,0,0.0,0.0
1001,1312,25-09-2019 07:22:00,1,2717.0,2429.0,0.894,13.395,1,1,1,0,0,0,0,0,0.0,0.0
1001,1313,25-09-2019 07:24:00,1,2615.0,2409.0,0.921,12.971,0,0,0,0,0,0,0,0,0.0,0.0
1001,1314,25-09-2019 07:26:00,1,2512.0,2349.0,0.935,12.5,0,0,0,0,0,0,0,0,0.0,0.0
1001,1315,25-09-2019 07:28:00,1,2519.0,2371.0,0.941,12.55,0,0,0,0,0,0,0,0,0.0,0.0
1001,1316,25-09-2019 07:30:00,1,2530.0,2338.0,0.924,12.557,2,0,0,0,2,0,2,0,0.0,0.0
1001,1317,25-09-2019 07:32:00,1,2518.0,2355.0,0.935,12.528,0,0,0,0,0,0,0,0,0.0,0.0
1001,1318,25-09-2019 07:34:00,1,2618.0,2387.0,0.912,12.955,9,9,0,9,0,0,0,0,0.0,0.0
1001,1319,25-09-2019 07:36:00,1,2540.0,2312.0,0.91,12.565,1,1,0,1,0,0,0,0,0.0,0.0
1001,1320,25-09-2019 07:38:00,1,2539.0,2303.0,0.907,12.554,5,5,1,4,0,0,0,0,0.0,0.0
1001,1321,25-09-2019 07:40:00,1,2531.0,2230.0,0.881,12.442,0,0,0,0,0,0,0,0,0.0,0.0
1001,1322,25-09-2019 07:42:00,1,2560.0,2225.0,0.869,12.551,0,0,0,0,0,0,0,0,0.0,0.0
1001,1323,25-09-2019 07:44:00,1,2447.0,2165.0,0.885,12.038,14,7,3,4,7,3,4,0,0.0,0.0
1001,1324,25-09-2019 07:46:00,1,2442.0,2182.0,0.894,12.036,0,0,0,0,0,0,0,0,0.0,0.0
1001,1325,25-09-2019 07:48:00,1,2454.0,2197.0,0.895,12.103,18,18,1,17,0,0,0,0,0.0,0.0
1001,1326,25-09-2019 07:50:00,1,2347.0,2150.0,0.917,11.628,7,7,0,7,0,0,0,0,0.0,0.0
1001,1327,25-09-2019 07:52:00,1,2240.0,2103.0,0.939,11.153,0,0,0,0,0,0,0,0,0.0,0.0
1001,1328,25-09-2019 07:54:00,1,2243.0,2093.0,0.933,11.153,65,57,20,37,8,3,5,3,0.0,0.0
1001,1329,25-09-2019 07:56:00,1,2531.0,2277.0,0.9,12.491,14,7,1,6,7,1,6,0,0.0,0.0
1001,1330,25-09-2019 07:58:00,1,2709.0,2532.0,0.934,13.478,0,0,0,0,0,0,0,0,0.0,0.0
1001,1331,25-09-2019 08:00:00,1,2685.0,2603.0,0.97,13.461,0,0,0,0,0,0,0,0,0.0,0.0
1001,1332,25-09-2019 08:02:00,1,2913.0,2672.0,0.918,14.435,35,25,2,23,10,0,10,2,0.0,0.0
1001,1333,25-09-2019 08:04:00,1,2863.0,2779.0,0.971,14.358,0,0,0,0,0,0,0,0,0.0,0.0
1001,1334,25-09-2019 08:06:00,1,2967.0,2811.0,0.948,14.801,132,110,79,31,22,6,16,29,0.0,0.0
1001,1335,25-09-2019 08:08:00,1,3141.0,3029.0,0.964,15.729,150,70,41,29,80,48,32,31,0.0,0.0
1001,1336,25-09-2019 08:10:00,1,3369.0,3101.0,0.92,16.705,153,94,64,30,59,40,19,16,0.0,0.0
1001,1337,25-09-2019 08:12:00,1,3381.0,3074.0,0.909,16.723,61,34,21,13,27,0,27,40,0.0,0.0
1001,1338,25-09-2019 08:14:00,1,3365.0,3168.0,0.941,16.766,63,56,28,28,7,0,7,1,0.0,0.0
1001,1339,25-09-2019 08:16:00,1,2897.0,2618.0,0.904,14.312,19,14,1,13,5,2,3,0,0.0,0.0
1001,1340,25-09-2019 08:18:00,1,3211.0,2830.0,0.881,15.785,5,1,1,0,4,1,3,0,0.0,0.0
1001,1341,25-09-2019 08:20:00,1,3347.0,3199.0,0.956,16.729,0,0,0,0,0,0,0,0,0.0,0.0
1001,1342,25-09-2019 08:22:00,1,3273.0,3011.0,0.92,16.228,0,0,0,0,0,0,0,0,0.0,0.0
1001,1343,25-09-2019 08:24:00,1,3018.0,2880.5,0.9575,15.079,0,0,0,0,0,0,0,0,0.0,0.0
1001,1344,25-09-2019 08:26:00,1,2763.0,2750.0,0.995,13.93,0,0,0,0,0,0,0,0,0.0,0.0
1001,1345,25-09-2019 08:28:00,1,2786.0,2639.0,0.947,13.9,4,0,0,0,4,1,3,0,0.0,0.0
1001,1346,25-09-2019 08:30:00,1,2578.0,2569.0,0.997,12.999,1,0,0,0,1,0,1,0,0.0,0.0
1001,1347,25-09-2019 08:32:00,1,2598.0,2476.0,0.953,12.977,0,0,0,0,0,0,0,0,0.01,0.0
1001,1348,25-09-2019 08:34:00,1,2630.0,2388.0,0.908,13.004,1,0,0,0,1,0,1,0,0.0,0.0
1001,1349,25-09-2019 08:36:00,1,2417.0,2303.0,0.953,12.074,20,11,6,5,9,0,9,0,0.0,0.0
1001,1350,25-09-2019 08:38:00,1,2409.0,2328.0,0.966,12.069,0,0,0,0,0,0,0,0,0.0,0.0
1001,1351,25-09-2019 08:40:00,1,2399.0,2348.0,0.979,12.052,0,0,0,0,0,0,0,0,0.0,0.0
1001,1352,25-09-2019 08:42:00,1,2409.0,2343.0,0.973,12.083,0,0,0,0,0,0,0,0,0.0,0.0
1001,1353,25-09-2019 08:44:00,1,2405.0,2306.0,0.959,12.029,0,0,0,0,0,0,0,0,0.0,0.0
1001,1354,25-09-2019 08:46:00,1,2405.0,2329.0,0.968,12.052,6,6,4,2,0,0,0,1,0.0,0.0
1001,1355,25-09-2019 08:48:00,1,2431.0,2293.0,0.943,12.118,57,47,24,23,10,2,8,17,0.0,0.0
1001,1356,25-09-2019 08:50:00,1,2580.0,2536.0,0.983,12.971,29,27,6,21,2,0,2,1,0.0,0.0
1001,1357,25-09-2019 08:52:00,1,2787.0,2613.0,0.937,13.875,19,19,0,19,0,0,0,0,0.0,0.0
1001,1358,25-09-2019 08:54:00,1,2780.0,2625.0,0.944,13.86,23,23,0,23,0,0,0,0,0.0,0.0
1001,1359,25-09-2019 08:56:00,1,2776.0,2684.0,0.967,13.908,1,1,0,1,0,0,0,0,0.0,0.0
1001,1360,25-09-2019 08:58:00,1,2680.0,2603.5,0.9715,13.44,17,9,5,4,8,1,7,0,0.0,0.0
1001,1361,25-09-2019 09:00:00,1,2584.0,2523.0,0.976,12.972,1,1,0,1,0,0,0,0,0.0,0.0
1001,1362,25-09-2019 09:02:00,1,2588.0,2528.0,0.977,12.994,1,1,0,1,0,0,0,0,0.0,0.0
1001,1363,25-09-2019 09:04:00,1,2597.0,2457.0,0.946,12.953,4,3,0,3,1,0,1,0,0.0,0.0
1001,1364,25-09-2019 09:06:00,1,2612.0,2416.0,0.925,12.966,2,1,0,1,1,0,1,0,0.0,0.0
1001,1365,25-09-2019 09:08:00,1,2502.0,2381.0,0.951,12.494,18,12,4,8,6,0,6,0,0.0,0.0
1001,1366,25-09-2019 09:10:00,1,2390.0,2351.0,0.984,12.021,7,3,0,3,4,0,4,0,0.0,0.0
1001,1367,25-09-2019 09:12:00,1,2399.0,2342.0,0.976,12.046,38,22,0,22,16,0,16,0,0.0,0.0
1001,1368,25-09-2019 09:14:00,1,2402.0,2331.0,0.97,12.045,16,4,0,4,12,2,10,0,0.0,0.0
1001,1369,25-09-2019 09:16:00,1,2418.0,2277.0,0.941,12.048,39,18,10,8,21,2,19,1,0.0,0.0
1001,1370,25-09-2019 09:18:00,1,2409.0,2300.0,0.955,12.038,27,25,0,25,2,0,2,0,0.0,0.0
1001,1371,25-09-2019 09:20:00,1,2407.0,2313.0,0.961,12.045,18,7,2,5,11,0,11,0,0.0,0.0
1001,1372,25-09-2019 09:22:00,1,2408.0,2331.0,0.968,12.066,18,18,0,18,0,0,0,0,0.0,0.0
1001,1373,25-09-2019 09:24:00,1,2510.0,2361.0,0.94,12.504,163,96,55,41,67,45,22,8,0.0,0.0
1001,1374,25-09-2019 09:26:00,1,2615.0,2429.0,0.929,12.991,732,394,323,71,338,261,77,32,0.0,0.0
1001,1375,25-09-2019 09:28:00,1,2692.0,2589.0,0.962,13.472,332,187,135,52,145,107,38,58,0.0,0.0
1001,1376,25-09-2019 09:30:00,1,3089.0,2841.0,0.92,15.316,383,227,179,48,156,107,49,49,0.0,0.0
1001,1377,25-09-2019 09:32:00,1,3135.5,2891.0,0.922,15.5545,473,304,244,60,169,112,57,42,0.0,0.0
1001,1378,25-09-2019 09:34:00,1,3182.0,2941.0,0.924,15.793,179,131,95,36,48,25,23,27,0.0,0.0
1001,1379,25-09-2019 09:36:00,1,2919.0,2613.0,0.895,14.394,22,10,3,7,12,5,7,0,0.0,0.0
1001,1380,25-09-2019 09:38:00,1,3220.0,2811.0,0.873,15.801,16,10,0,10,6,2,4,4,0.0,0.0
1001,1381,25-09-2019 09:40:00,1,3384.0,3024.0,0.894,16.683,22,13,1,12,9,2,7,4,0.0,0.0
1001,1382,25-09-2019 09:42:00,1,3340.0,3132.0,0.938,16.626,30,22,5,17,8,2,6,4,0.0,0.0
1001,1383,25-09-2019 09:44:00,1,3352.0,3148.0,0.939,16.693,13,9,2,7,4,2,2,1,0.0,0.0
1001,1384,25-09-2019 09:46:00,1,3364.0,3100.0,0.921,16.688,1,0,0,0,1,0,1,0,0.0,0.0
1001,1385,25-09-2019 09:48:00,1,3176.0,2936.0,0.924,15.765,7,1,0,1,6,2,4,0,0.0,0.0
1001,1386,25-09-2019 09:50:00,1,3110.0,2786.0,0.896,15.336,0,0,0,0,0,0,0,0,0.0,0.0
1001,1387,25-09-2019 09:52:00,1,2895.0,2683.0,0.927,14.378,11,6,0,6,5,0,5,0,0.0,0.0
1001,1388,25-09-2019 09:54:00,1,2803.0,2541.0,0.907,13.856,4,2,0,2,2,0,2,0,0.0,0.0
1001,1389,25-09-2019 09:56:00,1,2710.0,2457.0,0.907,13.397,9,2,0,2,7,0,7,0,0.0,0.0
1001,1390,25-09-2019 09:58:00,1,2742.0,2379.0,0.868,13.436,0,0,0,0,0,0,0,0,0.0,0.0
1001,1391,25-09-2019 10:00:00,1,2535.0,2280.0,0.899,12.512,3,0,0,0,3,0,3,0,0.0,0.0
1001,1392,25-09-2019 10:02:00,1,2560.0,2206.0,0.862,12.529,6,0,0,0,6,0,6,0,0.0,0.0
1001,1393,25-09-2019 10:04:00,1,2565.0,2167.0,0.845,12.505,0,0,0,0,0,0,0,0,0.0,0.0
1001,1394,25-09-2019 10:06:00,1,2465.0,2121.0,0.861,12.059,1,1,0,1,0,0,0,0,0.0,0.0
1001,1395,25-09-2019 10:08:00,1,2365.0,2075.0,0.877,11.613,0,0,0,0,0,0,0,0,0.0,0.0
1001,1396,25-09-2019 10:10:00,1,2363.0,2076.0,0.878,11.609,9,9,0,9,0,0,0,0,0.0,0.0
1001,1397,25-09-2019 10:12:00,1,2255.0,2051.0,0.91,11.156,7,7,0,7,0,0,0,0,0.0,0.0
1001,1398,25-09-2019 10:14:00,1,2253.0,2029.0,0.9,11.123,1,1,0,1,0,0,0,0,0.0,0.0
1001,1399,25-09-2019 10:16:00,1,2255.0,2032.0,0.901,11.133,0,0,0,0,0,0,0,0,0.0,0.0
1001,1400,25-09-2019 10:18:00,1,2264.0,1996.0,0.882,11.132,6,4,2,2,2,0,2,0,0.0,0.0
1001,1401,25-09-2019 10:20:00,1,2271.0,2001.0,0.881,11.161,0,0,0,0,0,0,0,0,0.0,0.0
1001,1402,25-09-2019 10:22:00,1,2243.0,2055.0,0.916,11.114,0,0,0,0,0,0,0,0,0.0,0.0
1001,1403,25-09-2019 10:24:00,1,2357.0,2081.0,0.883,11.59,0,0,0,0,0,0,0,0,0.0,0.0
1001,1404,25-09-2019 10:26:00,1,2464.0,2097.0,0.851,12.028,0,0,0,0,0,0,0,0,0.0,0.0
1001,1405,25-09-2019 10:28:00,1,2462.0,2114.0,0.858,12.042,29,17,7,10,12,2,10,5,0.0,0.0
1001,1406,25-09-2019 10:30:00,1,2542.0,2243.0,0.882,12.497,413,315,242,73,98,66,32,29,0.0,0.0
1001,1407,25-09-2019 10:32:00,1,2730.0,2400.0,0.879,13.413,93,69,32,37,24,4,20,9,0.0,0.0
1001,1408,25-09-2019 10:34:00,1,2934.0,2565.0,0.874,14.4,664,418,342,76,246,186,60,39,0.0,0.0
1001,1409,25-09-2019 10:36:00,1,3005.0,2721.0,0.905,14.853,437,256,194,62,181,132,49,62,0.0,0.01
1001,1410,25-09-2019 10:38:00,1,3212.0,2772.0,0.863,15.726,183,117,79,38,66,37,29,60,0.0,0.0
1001,1411,25-09-2019 10:40:00,1,3332.5,2972.0,0.891,16.4215,111,65,39,26,46,16,30,49,0.0,0.0
1001,1412,25-09-2019 10:42:00,1,3453.0,3172.0,0.919,17.117,102,68,43,25,34,4,30,36,0.0,0.0
1001,1413,25-09-2019 10:44:00,1,3400.0,2949.0,0.867,16.663,142,97,68,29,45,14,31,43,0.0,0.05
1001,1414,25-09-2019 10:46:00,1,2734.0,2399.0,0.877,13.43,349,283,211,72,66,33,33,4,0.0,0.0
1001,1415,25-09-2019 10:48:00,1,2563.0,2177.0,0.849,12.508,736,509,408,101,227,161,66,31,0.0,0.0
1001,1416,25-09-2019 10:50:00,1,2948.0,2506.0,0.85,14.391,485,304,237,67,181,124,57,11,0.18,0.0
1001,1417,25-09-2019 10:52:00,1,3289.0,2950.0,0.897,16.224,624,353,282,71,271,205,66,25,0.0,0.04
1001,1418,25-09-2019 10:54:00,1,3474.0,3145.0,0.905,17.17,632,368,294,74,264,197,67,41,0.05,0.0
1001,1419,25-09-2019 10:56:00,1,3356.0,3123.0,0.931,16.681,101,60,40,20,41,25,16,11,0.0,0.0
1001,1420,25-09-2019 10:58:00,1,3472.0,3146.0,0.906,17.163,97,49,13,36,48,7,41,0,0.01,0.0
1001,1421,25-09-2019 11:00:00,1,3565.0,3242.0,0.909,17.637,74,33,6,27,41,14,27,1,0.0,0.0
1001,1422,25-09-2019 11:02:00,1,3759.0,3394.0,0.903,18.568,80,58,24,34,22,1,21,0,0.0,0.0
1001,1423,25-09-2019 11:04:00,1,3654.0,3344.0,0.915,18.098,26,12,3,9,14,1,13,0,0.0,0.0
1001,1424,25-09-2019 11:06:00,1,3559.0,3269.0,0.919,17.64,3,1,1,0,2,0,2,0,0.0,0.0
1001,1425,25-09-2019 11:08:00,1,3357.0,3102.0,0.924,16.662,17,14,11,3,3,0,3,0,0.0,0.0
1001,1426,25-09-2019 11:10:00,1,3298.0,2957.0,0.897,16.266,228,224,179,45,4,0,4,0,0.0,0.0
1001,1427,25-09-2019 11:12:00,1,3198.0,2811.0,0.879,15.711,2,0,0,0,2,0,2,0,0.0,0.0
1001,1428,25-09-2019 11:14:00,1,3010.5,2648.0,0.88,14.792,5,0,0,0,5,0,5,0,0.0,0.0
1001,1429,25-09-2019 11:16:00,1,2823.0,2485.0,0.881,13.873,29,21,10,11,8,2,6,0,0.0,0.0
1001,1430,25-09-2019 11:18:00,1,2731.0,2447.0,0.896,13.467,2,2,0,2,0,0,0,0,0.0,0.0
1001,1431,25-09-2019 11:20:00,1,2754.0,2365.0,0.859,13.47,9,0,0,0,9,0,9,0,0.0,0.0
1001,1432,25-09-2019 11:22:00,1,2541.0,2281.0,0.898,12.536,18,12,3,9,6,0,6,0,0.0,0.0
1001,1433,25-09-2019 11:24:00,1,2563.0,2216.0,0.865,12.55,4,3,1,2,1,0,1,0,0.0,0.0
1001,1434,25-09-2019 11:26:00,1,2542.0,2192.0,0.863,12.442,2,2,0,2,0,0,0,0,0.0,0.0
1001,1435,25-09-2019 11:28:00,1,2559.0,2146.0,0.839,12.461,5,4,0,4,1,0,1,0,0.01,0.0
1001,1436,25-09-2019 11:30:00,1,2471.0,2116.0,0.856,12.079,4,1,0,1,3,0,3,0,0.0,0.0
1001,1437,25-09-2019 11:32:00,1,2463.0,2118.0,0.86,12.05,10,0,0,0,10,0,10,0,0.0,0.0
1001,1438,25-09-2019 11:34:00,1,2362.0,2047.0,0.867,11.574,0,0,0,0,0,0,0,0,0.0,0.0
1001,1439,25-09-2019 11:36:00,1,2366.0,2011.0,0.85,11.55,1,0,0,0,1,0,1,0,0.0,0.0
1001,1440,25-09-2019 11:38:00,1,2269.0,1988.0,0.876,11.14,4,1,0,1,3,0,3,0,0.0,0.0
1001,1441,25-09-2019 11:40:00,1,2273.0,1993.0,0.877,11.16,1,0,0,0,1,0,1,0,0.0,0.0
1001,1442,25-09-2019 11:42:00,1,2286.0,1903.0,0.833,11.114,13,0,0,0,13,0,13,0,0.0,0.0
1001,1443,25-09-2019 11:44:00,1,2299.0,1856.0,0.807,11.112,1,1,1,0,0,0,0,0,0.0,0.0
1001,1444,25-09-2019 11:46:00,1,2299.0,1844.0,0.802,11.099,0,0,0,0,0,0,0,0,0.0,0.0
1001,1445,25-09-2019 11:48:00,1,2195.0,1784.5,0.8135,10.6235,0,0,0,0,0,0,0,0,0.0,0.0
1001,1446,25-09-2019 11:50:00,1,2091.0,1725.0,0.825,10.148,101,83,42,41,18,5,13,3,0.0,0.0
1001,1447,25-09-2019 11:52:00,1,2275.0,1942.0,0.853,11.114,481,334,255,79,147,110,37,46,0.0,0.0
1001,1448,25-09-2019 11:54:00,1,2583.0,2107.0,0.816,12.512,738,431,335,96,307,237,70,88,0.0,0.0
1001,1449,25-09-2019 11:56:00,1,2756.0,2308.0,0.837,13.414,613,244,178,66,369,282,87,69,0.0,0.0
1001,1450,25-09-2019 11:58:00,1,2945.0,2496.0,0.847,14.368,310,217,160,57,93,63,30,22,0.0,0.0
1001,1451,25-09-2019 12:00:00,1,2838.0,2426.0,0.855,13.868,458,356,278,78,102,69,33,18,0.0,0.0
1001,1452,25-09-2019 12:02:00,1,2922.0,2606.0,0.892,14.398,151,107,74,33,44,20,24,3,0.03,0.0
1001,1453,25-09-2019 12:04:00,1,3134.0,2665.0,0.85,15.299,7,6,2,4,1,0,1,0,0.0,0.0
1001,1454,25-09-2019 12:06:00,1,3233.0,2685.0,0.83,15.711,13,13,1,12,0,0,0,0,0.0,0.0
1001,1455,25-09-2019 12:08:00,1,3243.0,2721.0,0.839,15.79,23,23,4,19,0,0,0,2,0.0,0.0
1001,1456,25-09-2019 12:10:00,1,3207.0,2747.0,0.857,15.677,0,0,0,0,0,0,0,0,0.0,0.0
1001,1457,25-09-2019 12:12:00,1,2930.0,2589.0,0.884,14.409,1,1,1,0,0,0,0,0,0.0,0.0
1001,1458,25-09-2019 12:14:00,1,2956.0,2454.0,0.83,14.366,11,11,0,11,0,0,0,0,0.0,0.0
1001,1459,25-09-2019 12:16:00,1,2762.0,2294.0,0.83,13.422,4,4,0,4,0,0,0,0,0.0,0.0
1001,1460,25-09-2019 12:18:00,1,2566.0,2159.0,0.841,12.5,3,3,1,2,0,0,0,0,0.0,0.0
1001,1461,25-09-2019 12:20:00,1,2588.0,2089.0,0.807,12.509,0,0,0,0,0,0,0,0,0.0,0.0
1001,1462,25-09-2019 12:22:00,1,2443.0,1991.0,0.8155,11.8305,0,0,0,0,0,0,0,0,0.0,0.0
1001,1463,25-09-2019 12:24:00,1,2298.0,1893.0,0.824,11.152,0,0,0,0,0,0,0,0,0.0,0.0
1001,1464,25-09-2019 12:26:00,1,2303.0,1827.0,0.793,11.097,0,0,0,0,0,0,0,0,0.0,0.0
1001,1465,25-09-2019 12:28:00,1,2197.0,1809.0,0.823,10.659,0,0,0,0,0,0,0,0,0.0,0.0
1001,1466,25-09-2019 12:30:00,1,2084.0,1770.0,0.849,10.17,4,4,0,4,0,0,0,0,0.0,0.0
1001,1467,25-09-2019 12:32:00,1,2089.0,1754.0,0.839,10.174,0,0,0,0,0,0,0,0,0.0,0.0
1001,1468,25-09-2019 12:34:00,1,2107.0,1735.0,0.823,10.221,0,0,0,0,0,0,0,0,0.0,0.0
1001,1469,25-09-2019 12:36:00,1,2111.0,1722.0,0.816,10.223,20,13,9,4,7,2,5,0,0.0,0.0
1001,1470,25-09-2019 12:38:00,1,2303.0,1816.0,0.788,11.084,3,0,0,0,3,0,3,0,0.0,0.0
1001,1471,25-09-2019 12:40:00,1,2288.0,1874.0,0.819,11.091,29,0,0,0,29,0,29,0,0.0,0.0
1001,1472,25-09-2019 12:42:00,1,2271.0,1944.0,0.856,11.1,3,0,0,0,3,0,3,0,0.0,0.0
1001,1473,25-09-2019 12:44:00,1,2390.0,1936.0,0.81,11.559,10,6,0,6,4,0,4,0,0.0,0.0
1001,1474,25-09-2019 12:46:00,1,2393.0,1926.0,0.805,11.56,5,3,0,3,2,0,2,0,0.0,0.0
1001,1475,25-09-2019 12:48:00,1,2301.0,1853.0,0.805,11.119,6,2,0,2,4,0,4,0,0.0,0.0
1001,1476,25-09-2019 12:50:00,1,2308.0,1800.0,0.78,11.086,5,0,0,0,5,0,5,0,0.0,0.0
1001,1477,25-09-2019 12:52:00,1,2319.0,1799.0,0.776,11.128,0,0,0,0,0,0,0,0,0.0,0.0
1001,1478,25-09-2019 12:54:00,1,2319.0,1775.0,0.765,11.103,21,15,11,4,6,1,5,0,0.0,0.0
1001,1479,25-09-2019 12:56:00,1,2308.5,1820.5,0.7885,11.1115,0,0,0,0,0,0,0,0,0.0,0.0
1001,1480,25-09-2019 12:58:00,1,2298.0,1866.0,0.812,11.12,0,0,0,0,0,0,0,0,0.0,0.0
1001,1481,25-09-2019 13:00:00,1,2274.0,1902.0,0.836,11.066,0,0,0,0,0,0,0,0,0.0,0.0
1001,1482,25-09-2019 13:02:00,1,2286.0,1907.0,0.834,11.117,0,0,0,0,0,0,0,0,0.0,0.0
1001,1483,25-09-2019 13:04:00,1,2396.0,1911.0,0.798,11.556,0,0,0,0,0,0,0,0,0.0,0.0
1001,1484,25-09-2019 13:06:00,1,2302.0,1856.0,0.806,11.125,0,0,0,0,0,0,0,0,0.0,0.0
1001,1485,25-09-2019 13:08:00,1,2307.0,1823.0,0.79,11.108,0,0,0,0,0,0,0,0,0.0,0.0
1001,1486,25-09-2019 13:10:00,1,2209.0,1750.0,0.792,10.64,0,0,0,0,0,0,0,0,0.0,0.0
1001,1487,25-09-2019 13:12:00,1,2111.0,1691.0,0.801,10.189,0,0,0,0,0,0,0,0,0.0,0.0
1001,1488,25-09-2019 13:14:00,1,2123.0,1626.0,0.766,10.164,21,14,5,9,7,0,7,2,0.0,0.0
1001,1489,25-09-2019 13:16:00,1,2199.0,1778.0,0.809,10.631,32,26,11,15,6,0,6,5,0.0,0.0
1001,1490,25-09-2019 13:18:00,1,2616.0,2004.0,0.766,12.528,39,35,3,32,4,0,4,0,0.0,0.0
1001,1491,25-09-2019 13:20:00,1,2569.0,2148.0,0.836,12.5,59,54,22,32,5,0,5,6,0.0,0.0
1001,1492,25-09-2019 13:22:00,1,2750.0,2300.0,0.836,13.382,37,37,20,17,0,0,0,1,0.0,0.0
1001,1493,25-09-2019 13:24:00,1,2731.0,2411.0,0.883,13.428,106,96,66,30,10,0,10,28,0.0,0.0
1001,1494,25-09-2019 13:26:00,1,3189.0,2858.0,0.896,15.73,313,239,180,59,74,46,28,62,0.0,0.0
1001,1495,25-09-2019 13:28:00,1,2927.0,2558.0,0.874,14.364,84,69,39,30,15,8,7,48,0.0,0.0
1001,1496,25-09-2019 13:30:00,1,3173.0,2726.0,0.86,15.5205,102,85,52,33,17,4,13,63,0.0,0.0
1001,1497,25-09-2019 13:32:00,1,3419.0,2894.0,0.846,16.677,48,46,25,21,2,0,2,58,0.0,0.03
1001,1498,25-09-2019 13:34:00,1,3619.0,3039.0,0.84,17.623,47,43,14,29,4,0,4,55,0.0,0.0
1001,1499,25-09-2019 13:36:00,1,3580.0,3144.0,0.878,17.584,47,45,24,21,2,0,2,54,0.0,0.08
1001,1500,25-09-2019 13:38:00,1,3574.0,3224.0,0.902,17.651,50,50,21,29,0,0,0,61,0.0,0.02
1001,1501,25-09-2019 13:40:00,1,3568.0,3250.0,0.911,17.655,32,32,6,26,0,0,0,60,0.0,0.0
1001,1502,25-09-2019 13:42:00,1,3665.0,3316.0,0.905,18.111,33,33,11,22,0,0,0,49,0.0,0.0
1001,1503,25-09-2019 13:44:00,1,3676.0,3292.0,0.895,18.129,203,121,92,29,82,68,14,38,0.0,0.11
1001,1504,25-09-2019 13:46:00,1,3196.0,2890.0,0.904,15.792,1145,764,632,132,381,293,88,51,0.21,0.01
1001,1505,25-09-2019 13:48:00,1,2909.0,2640.0,0.907,14.385,590,386,305,81,204,163,41,25,0.0,0.0
1001,1506,25-09-2019 13:50:00,1,2747.0,2379.0,0.866,13.456,9,9,1,8,0,0,0,2,0.01,0.0
1001,1507,25-09-2019 13:52:00,1,2560.0,2182.0,0.852,12.501,16,16,0,16,0,0,0,0,0.0,0.0
1001,1508,25-09-2019 13:54:00,1,2572.0,2145.0,0.834,12.508,25,25,3,22,0,0,0,2,0.0,0.0
1001,1509,25-09-2019 13:56:00,1,2742.0,2367.0,0.863,13.424,5,5,1,4,0,0,0,0,0.0,0.0
1001,1510,25-09-2019 13:58:00,1,2935.0,2503.0,0.853,14.334,0,0,0,0,0,0,0,0,0.0,0.0
1001,1511,25-09-2019 14:00:00,1,2740.0,2399.0,0.875,13.453,0,0,0,0,0,0,0,0,0.0,0.0
1001,1512,25-09-2019 14:02:00,1,2732.0,2409.0,0.882,13.429,0,0,0,0,0,0,0,0,0.0,0.0
1001,1513,25-09-2019 14:04:00,1,2813.5,2548.0,0.905,13.9055,0,0,0,0,0,0,0,0,0.0,0.0
1001,1514,25-09-2019 14:06:00,1,2895.0,2687.0,0.928,14.382,37,37,4,33,0,0,0,0,0.0,0.0
1001,1515,25-09-2019 14:08:00,1,3525.0,3308.0,0.938,17.551,0,0,0,0,0,0,0,0,0.0,0.0
1001,1516,25-09-2019 14:10:00,1,3355.0,3128.0,0.932,16.681,0,0,0,0,0,0,0,0,0.0,0.0
1001,1517,25-09-2019 14:12:00,1,3389.0,3020.0,0.891,16.697,0,0,0,0,0,0,0,0,0.0,0.0
1001,1518,25-09-2019 14:14:00,1,3182.0,2944.0,0.925,15.796,3,3,0,3,0,0,0,0,0.0,0.0
1001,1519,25-09-2019 14:16:00,1,3097.0,2828.0,0.913,15.332,2,2,0,2,0,0,0,0,0.0,0.0
1001,1520,25-09-2019 14:18:00,1,2868.0,2779.0,0.969,14.377,2,2,0,2,0,0,0,0,0.0,0.0
1001,1521,25-09-2019 14:20:00,1,2892.0,2725.0,0.942,14.413,0,0,0,0,0,0,0,0,0.0,0.0
1001,1522,25-09-2019 14:22:00,1,2898.0,2713.0,0.936,14.422,1,1,0,1,0,0,0,0,0.0,0.0
1001,1523,25-09-2019 14:24:00,1,2915.0,2632.0,0.903,14.398,0,0,0,0,0,0,0,0,0.0,0.0
1001,1524,25-09-2019 14:26:00,1,2909.0,2644.0,0.909,14.39,0,0,0,0,0,0,0,0,0.0,0.0
1001,1525,25-09-2019 14:28:00,1,2687.0,2609.0,0.971,13.475,1,1,0,1,0,0,0,0,0.0,0.0
1001,1526,25-09-2019 14:30:00,1,2705.0,2550.0,0.943,13.481,2,2,0,2,0,0,0,0,0.0,0.0
1001,1527,25-09-2019 14:32:00,1,2717.0,2497.0,0.919,13.468,10,10,4,6,0,0,0,0,0.0,0.0
1001,1528,25-09-2019 14:34:00,1,2703.0,2510.0,0.929,13.428,1,1,0,1,0,0,0,0,0.0,0.0
1001,1529,25-09-2019 14:36:00,1,2723.0,2476.0,0.909,13.471,1,1,0,1,0,0,0,0,0.0,0.0
1001,1530,25-09-2019 14:38:00,1,2677.0,2425.0,0.906,13.2325,0,0,0,0,0,0,0,0,0.0,0.0
1001,1531,25-09-2019 14:40:00,1,2631.0,2374.0,0.903,12.994,2,2,0,2,0,0,0,0,0.0,0.0
1001,1532,25-09-2019 14:42:00,1,2507.0,2364.0,0.943,12.495,0,0,0,0,0,0,0,0,0.0,0.0
1001,1533,25-09-2019 14:44:00,1,2531.0,2344.0,0.926,12.568,169,154,110,44,15,11,4,1,0.0,0.0
1001,1534,25-09-2019 14:46:00,1,2727.0,2427.0,0.89,13.431,88,88,65,23,0,0,0,66,0.0,0.0
1001,1535,25-09-2019 14:48:00,1,2889.0,2696.0,0.933,14.366,52,52,34,18,0,0,0,16,0.0,0.0
1001,1536,25-09-2019 14:50:00,1,2610.0,2421.0,0.928,12.963,12,12,2,10,0,0,0,0,0.0,0.0
1001,1537,25-09-2019 14:52:00,1,2715.0,2483.0,0.914,13.447,6,6,1,5,0,0,0,0,0.01,0.01
1001,1538,25-09-2019 14:54:00,1,3088.0,2875.0,0.931,15.351,5,5,1,4,0,0,0,0,0.0,0.0
1001,1539,25-09-2019 14:56:00,1,2868.0,2720.0,0.948,14.313,33,33,0,33,0,0,0,0,0.0,0.0
1001,1540,25-09-2019 14:58:00,1,2906.0,2610.0,0.898,14.338,0,0,0,0,0,0,0,0,0.0,0.0
1001,1541,25-09-2019 15:00:00,1,2701.0,2489.0,0.921,13.397,0,0,0,0,0,0,0,0,0.0,0.0
1001,1542,25-09-2019 15:02:00,1,2743.0,2388.0,0.871,13.45,7,7,0,7,0,0,0,0,0.0,0.0
1001,1543,25-09-2019 15:04:00,1,2533.0,2294.0,0.906,12.522,2,2,0,2,0,0,0,0,0.0,0.0
1001,1544,25-09-2019 15:06:00,1,2539.0,2220.0,0.874,12.463,6,6,4,2,0,0,0,2,0.0,0.0
1001,1545,25-09-2019 15:08:00,1,2550.0,2203.0,0.864,12.486,0,0,0,0,0,0,0,0,0.0,0.0
1001,1546,25-09-2019 15:10:00,1,2453.0,2176.0,0.887,12.072,0,0,0,0,0,0,0,0,0.0,0.0
1001,1547,25-09-2019 15:12:00,1,2450.5,2165.5,0.8835,12.052,0,0,0,0,0,0,0,0,0.0,0.0
1001,1548,25-09-2019 15:14:00,1,2448.0,2155.0,0.88,12.032,0,0,0,0,0,0,0,0,0.01,0.0
1001,1549,25-09-2019 15:16:00,1,2449.0,2158.0,0.881,12.038,0,0,0,0,0,0,0,0,0.0,0.0
1001,1550,25-09-2019 15:18:00,1,2566.0,2178.0,0.849,12.522,0,0,0,0,0,0,0,0,0.0,0.0
1001,1551,25-09-2019 15:20:00,1,2448.0,2141.0,0.875,12.017,0,0,0,0,0,0,0,0,0.0,0.0
1001,1552,25-09-2019 15:22:00,1,2457.0,2140.0,0.871,12.049,0,0,0,0,0,0,0,0,0.0,0.0
1001,1553,25-09-2019 15:24:00,1,2245.0,2094.0,0.933,11.164,0,0,0,0,0,0,0,0,0.0,0.0
1001,1554,25-09-2019 15:26:00,1,2247.0,2081.0,0.926,11.156,0,0,0,0,0,0,0,0,0.0,0.0
1001,1555,25-09-2019 15:28:00,1,2246.0,2017.0,0.898,11.083,1,1,0,1,0,0,0,0,0.0,0.0
1001,1556,25-09-2019 15:30:00,1,2257.0,1985.0,0.879,11.09,15,15,0,15,0,0,0,0,0.0,0.0
1001,1557,25-09-2019 15:32:00,1,2278.0,1962.0,0.862,11.146,43,43,10,33,0,0,0,3,0.0,0.0
1001,1558,25-09-2019 15:34:00,1,2231.0,2057.0,0.922,11.068,44,44,21,23,0,0,0,0,0.0,0.0
1001,1559,25-09-2019 15:36:00,1,2563.0,2207.0,0.861,12.541,27,27,7,20,0,0,0,1,0.0,0.0
1001,1560,25-09-2019 15:38:00,1,2624.0,2395.0,0.913,12.988,173,149,109,40,24,10,14,53,0.0,0.0
1001,1561,25-09-2019 15:40:00,1,2712.0,2501.0,0.922,13.454,11,11,6,5,0,0,0,48,0.0,0.0
1001,1562,25-09-2019 15:42:00,1,2981.0,2805.0,0.941,14.851,29,29,17,12,0,0,0,56,0.0,0.0
1001,1563,25-09-2019 15:44:00,1,3177.0,2980.0,0.938,15.818,32,32,15,17,0,0,0,63,0.0,0.0
1001,1564,25-09-2019 15:46:00,1,3255.0,3079.0,0.946,16.2335,32,32,12,20,0,0,0,52,0.0,0.11
1001,1565,25-09-2019 15:48:00,1,3333.0,3178.0,0.954,16.649,42,42,19,23,0,0,0,59,0.0,0.06
1001,1566,25-09-2019 15:50:00,1,3353.0,3213.0,0.958,16.766,22,22,10,12,0,0,0,59,0.0,0.0
1001,1567,25-09-2019 15:52:00,1,3446.0,3264.0,0.947,17.191,292,180,128,52,112,79,33,15,0.0,0.12
1001,1568,25-09-2019 15:54:00,1,2892.0,2711.0,0.937,14.396,673,461,379,82,212,161,51,43,0.09,0.0
1001,1569,25-09-2019 15:56:00,1,3719.0,3515.0,0.945,18.546,214,130,86,44,84,54,30,14,0.15,0.0
1001,1570,25-09-2019 15:58:00,1,2734.0,2410.0,0.881,13.441,64,64,27,37,0,0,0,0,0.0,0.0
1001,1571,25-09-2019 16:00:00,1,2355.0,2122.0,0.901,11.628,18,18,0,18,0,0,0,0,0.0,0.0
1001,1572,25-09-2019 16:02:00,1,2249.0,2064.0,0.917,11.147,3,3,2,1,0,0,0,0,0.0,0.0
1001,1573,25-09-2019 16:04:00,1,2257.0,2033.0,0.901,11.142,1,1,1,0,0,0,0,0,0.0,0.0
1001,1574,25-09-2019 16:06:00,1,2480.0,2082.0,0.84,12.077,4,4,0,4,0,0,0,0,0.0,0.0
1001,1575,25-09-2019 16:08:00,1,2576.0,2145.0,0.833,12.527,2,2,0,2,0,0,0,0,0.0,0.0
1001,1576,25-09-2019 16:10:00,1,2921.0,2590.0,0.887,14.375,1,1,0,1,0,0,0,0,0.0,0.0
1001,1577,25-09-2019 16:12:00,1,3427.0,3242.0,0.946,17.091,14,14,10,4,0,0,0,0,0.01,0.0
1001,1578,25-09-2019 16:14:00,1,3350.0,3219.0,0.961,16.762,0,0,0,0,0,0,0,0,0.0,0.0
1001,1579,25-09-2019 16:16:00,1,3365.0,3117.0,0.926,16.707,3,3,1,2,0,0,0,0,0.0,0.0
1001,1580,25-09-2019 16:18:00,1,3167.0,2982.0,0.942,15.779,0,0,0,0,0,0,0,0,0.0,0.0
1001,1581,25-09-2019 16:20:00,1,3019.0,2880.0,0.9545,15.0825,7,7,3,4,0,0,0,0,0.0,0.0
1001,1582,25-09-2019 16:22:00,1,2871.0,2778.0,0.967,14.386,1,1,0,1,0,0,0,0,0.0,0.0
1001,1583,25-09-2019 16:24:00,1,2878.0,2756.0,0.957,14.391,0,0,0,0,0,0,0,0,0.0,0.0
1001,1584,25-09-2019 16:26:00,1,2786.0,2653.0,0.952,13.914,13,13,7,6,0,0,0,0,0.0,0.0
1001,1585,25-09-2019 16:28:00,1,2662.0,2671.0,1.003,13.446,2,2,1,1,0,0,0,0,0.0,0.0
1001,1586,25-09-2019 16:30:00,1,2662.0,2643.0,0.993,13.413,3,3,0,3,0,0,0,0,0.0,0.0
1001,1587,25-09-2019 16:32:00,1,2675.0,2626.0,0.982,13.448,26,25,16,9,1,0,1,4,0.0,0.0
1001,1588,25-09-2019 16:34:00,1,2682.0,2615.0,0.975,13.46,0,0,0,0,0,0,0,0,0.0,0.0
1001,1589,25-09-2019 16:36:00,1,2695.0,2584.0,0.959,13.478,3,3,1,2,0,0,0,0,0.0,0.0
1001,1590,25-09-2019 16:38:00,1,2702.0,2523.0,0.934,13.441,16,16,0,16,0,0,0,0,0.0,0.0
1001,1591,25-09-2019 16:40:00,1,2714.0,2496.0,0.919,13.457,6,6,0,6,0,0,0,0,0.0,0.0
1001,1592,25-09-2019 16:42:00,1,2601.0,2499.0,0.961,13.014,14,14,0,14,0,0,0,0,0.0,0.0
1001,1593,25-09-2019 16:44:00,1,2498.0,2449.0,0.981,12.554,4,4,1,3,0,0,0,0,0.0,0.0
1001,1594,25-09-2019 16:46:00,1,2488.0,2406.0,0.967,12.467,0,0,0,0,0,0,0,0,0.0,0.0
1001,1595,25-09-2019 16:48:00,1,2514.0,2401.0,0.955,12.562,0,0,0,0,0,0,0,0,0.0,0.0
1001,1596,25-09-2019 16:50:00,1,2517.0,2381.0,0.946,12.554,0,0,0,0,0,0,0,0,0.0,0.0
1001,1597,25-09-2019 16:52:00,1,2515.0,2371.0,0.943,12.533,0,0,0,0,0,0,0,0,0.0,0.0
1001,1598,25-09-2019 16:54:00,1,2504.5,2425.0,0.9685,12.553,16,15,9,6,1,0,1,0,0.0,0.0
1001,1599,25-09-2019 16:56:00,1,2494.0,2479.0,0.994,12.573,0,0,0,0,0,0,0,0,0.0,0.0
1001,1600,25-09-2019 16:58:00,1,2503.0,2423.0,0.968,12.544,8,7,3,4,1,0,1,0,0.0,0.0
1001,1601,25-09-2019 17:00:00,1,2489.0,2474.0,0.994,12.544,2,2,1,1,0,0,0,0,0.0,0.0
1001,1602,25-09-2019 17:02:00,1,2496.0,2438.0,0.977,12.533,0,0,0,0,0,0,0,0,0.0,0.0
1001,1603,25-09-2019 17:04:00,1,2498.0,2402.0,0.962,12.502,1,1,0,1,0,0,0,0,0.0,0.0
1001,1604,25-09-2019 17:06:00,1,2503.0,2413.0,0.964,12.532,76,43,30,13,33,13,20,48,0.0,0.0
1001,1605,25-09-2019 17:08:00,1,2664.0,2658.0,0.998,13.44,46,17,3,14,29,0,29,48,0.0,0.0
1001,1606,25-09-2019 17:10:00,1,2956.0,2928.0,0.991,14.887,55,45,13,32,10,0,10,47,0.0,0.12
1001,1607,25-09-2019 17:12:00,1,2932.0,2943.0,1.004,14.808,65,65,29,36,0,0,0,40,0.0,0.06
1001,1608,25-09-2019 17:14:00,1,3162.0,3002.0,0.949,15.783,32,30,12,18,2,0,2,27,0.0,0.04
1001,1609,25-09-2019 17:16:00,1,3141.0,3125.0,0.995,15.835,81,71,47,24,10,0,10,13,0.0,0.01
1001,1610,25-09-2019 17:18:00,1,2488.0,2466.0,0.991,12.531,44,43,13,30,1,0,1,2,0.0,0.04
1001,1611,25-09-2019 17:20:00,1,2227.0,2108.0,0.946,11.11,108,108,78,30,0,0,0,2,0.0,0.03
1001,1612,25-09-2019 17:22:00,1,2528.0,2326.0,0.92,12.535,47,47,21,26,0,0,0,1,0.0,0.0
1001,1613,25-09-2019 17:24:00,1,3064.0,2908.0,0.949,15.29,49,49,16,33,0,0,0,1,0.0,0.0
1001,1614,25-09-2019 17:26:00,1,3520.0,3446.0,0.979,17.682,1,1,0,1,0,0,0,0,0.0,0.0
1001,1615,25-09-2019 17:28:00,1,3417.0,3344.0,0.9785,17.1645,0,0,0,0,0,0,0,0,0.0,0.0
1001,1616,25-09-2019 17:30:00,1,3314.0,3242.0,0.978,16.647,27,27,0,27,0,0,0,0,0.0,0.0
1001,1617,25-09-2019 17:32:00,1,3316.0,3299.0,0.995,16.719,5,5,0,5,0,0,0,0,0.0,0.0
1001,1618,25-09-2019 17:34:00,1,3331.0,3188.0,0.957,16.654,9,9,1,8,0,0,0,0,0.0,0.0
1001,1619,25-09-2019 17:36:00,1,3348.0,3141.0,0.938,16.668,3,3,0,3,0,0,0,0,0.01,0.0
1001,1620,25-09-2019 17:38:00,1,3141.0,3033.0,0.965,15.734,3,3,2,1,0,0,0,0,0.0,0.01
1001,1621,25-09-2019 17:40:00,1,3157.0,3017.0,0.956,15.778,0,0,0,0,0,0,0,0,0.0,0.0
1001,1622,25-09-2019 17:42:00,1,2946.0,2924.0,0.992,14.844,0,0,0,0,0,0,0,0,0.0,0.0
1001,1623,25-09-2019 17:44:00,1,2848.0,2890.0,1.015,14.422,2,2,0,2,0,0,0,0,0.0,0.0
1001,1624,25-09-2019 17:46:00,1,2852.0,2853.0,1.0,14.395,3,3,1,2,0,0,0,0,0.0,0.0
1001,1625,25-09-2019 17:48:00,1,2864.0,2829.0,0.988,14.416,3,3,0,3,0,0,0,0,0.0,0.0
1001,1626,25-09-2019 17:50:00,1,2880.0,2772.0,0.962,14.414,3,3,0,3,0,0,0,0,0.0,0.0
1001,1627,25-09-2019 17:52:00,1,2875.0,2744.0,0.954,14.367,4,4,0,4,0,0,0,0,0.0,0.0
1001,1628,25-09-2019 17:54:00,1,2757.0,2741.0,0.994,13.897,1,1,0,1,0,0,0,0,0.0,0.0
1001,1629,25-09-2019 17:56:00,1,2764.0,2725.0,0.986,13.907,76,65,30,35,11,3,8,12,0.0,0.0
1001,1630,25-09-2019 17:58:00,1,2847.0,2872.0,1.009,14.396,201,135,92,43,66,43,23,41,0.0,0.29
1001,1631,25-09-2019 18:00:00,0,3047.0,3000.0,0.984,15.327,34,26,1,25,8,0,8,0,0.0,0.0
1001,1632,25-09-2019 18:02:00,0,3187.0,3117.5,0.978,16.0085,62,35,0,35,27,0,27,0,0.0,0.0
1001,1633,25-09-2019 18:04:00,0,3327.0,3235.0,0.972,16.69,607,373,311,62,234,171,63,78,0.0,0.0
1001,1634,25-09-2019 18:06:00,0,3214.0,3184.0,0.991,16.186,470,293,240,53,177,118,59,48,0.05,0.0
1001,1635,25-09-2019 18:08:00,0,3314.0,3283.0,0.991,16.69,34,10,5,5,24,1,23,7,0.0,0.0
1001,1636,25-09-2019 18:10:00,0,3512.0,3461.0,0.985,17.669,249,167,138,29,82,64,18,20,0.04,0.02
1001,1637,25-09-2019 18:12:00,0,3778.0,3711.0,0.982,18.994,237,148,107,41,89,58,31,20,0.01,0.0
1001,1638,25-09-2019 18:14:00,0,3476.0,3526.0,1.014,17.596,598,328,276,52,270,201,69,18,0.12,0.0
1001,1639,25-09-2019 18:16:00,0,3688.0,3633.0,0.985,18.552,264,184,130,54,80,49,31,14,0.0,0.0
1001,1640,25-09-2019 18:18:00,0,3797.0,3638.0,0.958,18.986,20,18,0,18,2,0,2,0,0.0,0.0
1001,1641,25-09-2019 18:20:00,0,3796.0,3629.0,0.956,18.975,45,24,5,19,21,0,21,5,0.0,0.0
1001,1642,25-09-2019 18:22:00,0,3787.0,3659.0,0.966,18.972,28,27,1,26,1,0,1,2,0.0,0.0
1001,1643,25-09-2019 18:24:00,0,3773.0,3740.0,0.991,19.007,37,25,10,15,12,0,12,0,0.0,0.0
1001,1644,25-09-2019 18:26:00,0,3769.0,3740.0,0.992,18.991,16,5,1,4,11,0,11,0,0.0,0.0
1001,1645,25-09-2019 18:28:00,0,3768.0,3769.0,1.0,19.019,81,68,52,16,13,7,6,8,0.0,0.0
1001,1646,25-09-2019 18:30:00,0,3811.0,3655.0,0.959,19.063,221,134,89,45,87,44,43,16,0.0,0.0
1001,1647,25-09-2019 18:32:00,0,3763.0,3791.0,1.007,19.021,293,195,146,49,98,61,37,39,0.02,0.0
1001,1648,25-09-2019 18:34:00,0,3794.0,3711.0,0.978,19.057,66,56,25,31,10,1,9,7,0.0,0.0
1001,1649,25-09-2019 18:36:00,0,3886.5,3771.5,0.9705,19.489,31,13,1,12,18,0,18,1,0.0,0.0
1001,1650,25-09-2019 18:38:00,0,3979.0,3832.0,0.963,19.921,54,32,18,14,22,7,15,1,0.0,0.0
1001,1651,25-09-2019 18:40:00,0,3765.0,3785.0,1.005,19.026,10,4,1,3,6,4,2,0,0.0,0.0
1001,1652,25-09-2019 18:42:00,0,3801.0,3691.0,0.971,19.063,0,0,0,0,0,0,0,0,0.0,0.0
1001,1653,25-09-2019 18:44:00,0,3600.0,3545.0,0.985,18.106,0,0,0,0,0,0,0,0,0.0,0.0
1001,1654,25-09-2019 18:46:00,0,3512.0,3424.0,0.975,17.627,5,2,0,2,3,1,2,0,0.0,0.0
1001,1655,25-09-2019 18:48:00,0,3304.0,3305.0,1.0,16.678,1,1,0,1,0,0,0,0,0.0,0.0
1001,1656,25-09-2019 18:50:00,0,3340.0,3176.0,0.951,16.674,31,12,4,8,19,1,18,2,0.0,0.0
1001,1657,25-09-2019 18:52:00,0,3338.0,3179.0,0.952,16.671,184,122,90,32,62,38,24,13,0.0,0.0
1001,1658,25-09-2019 18:54:00,0,3321.0,3251.0,0.979,16.682,191,115,88,27,76,58,18,17,0.0,0.0
1001,1659,25-09-2019 18:56:00,0,3513.0,3375.0,0.96,17.578,79,67,26,41,12,3,9,15,0.0,0.0
1001,1660,25-09-2019 18:58:00,0,3505.0,3413.0,0.974,17.589,59,49,15,34,10,1,9,0,0.0,0.0
1001,1661,25-09-2019 19:00:00,0,3604.0,3562.0,0.988,18.143,112,100,53,47,12,0,12,0,0.0,0.0
1001,1662,25-09-2019 19:02:00,0,3714.0,3587.0,0.966,18.602,88,72,32,40,16,4,12,1,0.0,0.0
1001,1663,25-09-2019 19:04:00,0,3825.0,3620.0,0.947,19.077,98,85,52,33,13,3,10,3,0.0,0.0
1001,1664,25-09-2019 19:06:00,0,3786.0,3672.0,0.97,18.981,35,23,1,22,12,0,12,0,0.0,0.0
1001,1665,25-09-2019 19:08:00,0,3778.0,3727.0,0.986,19.011,7,6,0,6,1,0,1,0,0.0,0.0
1001,1666,25-09-2019 19:10:00,0,3644.0,3587.0,0.984,18.3285,17,17,4,13,0,0,0,0,0.0,0.0
1001,1667,25-09-2019 19:12:00,0,3510.0,3447.0,0.982,17.646,27,24,3,21,3,1,2,0,0.0,0.0
1001,1668,25-09-2019 19:14:00,0,3526.0,3350.0,0.95,17.602,27,26,5,21,1,0,1,0,0.0,0.0
1001,1669,25-09-2019 19:16:00,0,3340.0,3210.0,0.961,16.713,128,100,64,36,28,4,24,68,0.0,0.0
1001,1670,25-09-2019 19:18:00,0,3538.0,3312.0,0.936,17.607,133,100,66,34,33,4,29,66,0.0,0.0
1001,1671,25-09-2019 19:20:00,0,3504.0,3430.0,0.979,17.602,210,123,87,36,87,40,47,67,0.0,0.04
1001,1672,25-09-2019 19:22:00,0,3703.0,3561.0,0.962,18.532,176,77,58,19,99,68,31,38,0.0,0.0
1001,1673,25-09-2019 19:24:00,0,3504.0,3430.0,0.979,17.602,113,73,40,33,40,8,32,69,0.0,0.06
1001,1674,25-09-2019 19:26:00,0,3874.0,3786.0,0.977,19.453,227,147,97,50,80,49,31,60,0.19,0.0
1001,1675,25-09-2019 19:28:00,0,3771.0,3702.0,0.982,18.954,259,173,132,41,86,67,19,47,0.01,0.03
1001,1676,25-09-2019 19:30:00,0,3531.0,3382.0,0.958,17.656,108,85,47,38,23,8,15,1,0.02,0.05
1001,1677,25-09-2019 19:32:00,0,2676.0,2643.0,0.987,13.47,6,6,1,5,0,0,0,0,0.0,0.0
1001,1678,25-09-2019 19:34:00,0,2699.0,2561.0,0.949,13.47,12,3,1,2,9,0,9,0,0.0,0.0
1001,1679,25-09-2019 19:36:00,0,2629.0,2392.0,0.91,13.006,6,4,2,2,2,0,2,0,0.0,0.0
1001,1680,25-09-2019 19:38:00,0,2550.0,2249.0,0.882,12.538,6,4,1,3,2,0,2,0,0.0,0.0
1001,1681,25-09-2019 19:40:00,0,2538.0,2255.0,0.888,12.497,12,8,2,6,4,0,4,0,0.0,0.0
1001,1682,25-09-2019 19:42:00,0,2539.0,2307.0,0.909,12.556,2,1,0,1,1,0,1,0,0.0,0.0
1001,1683,25-09-2019 19:44:00,0,3258.5,3102.5,0.9445,16.2715,161,126,81,45,35,11,24,62,0.0,0.0
1001,1684,25-09-2019 19:46:00,0,3978.0,3898.0,0.98,19.987,94,63,41,22,31,7,24,85,0.0,0.0
1001,1685,25-09-2019 19:48:00,0,4277.0,4074.0,0.953,21.36,111,58,30,28,53,8,45,84,0.0,0.0
1001,1686,25-09-2019 19:50:00,0,4426.0,4315.0,0.975,22.216,214,138,94,44,76,50,26,55,0.11,0.1
1001,1687,25-09-2019 19:52:00,0,4041.0,4007.0,0.992,20.359,151,94,63,31,57,36,21,22,0.01,0.0
1001,1688,25-09-2019 19:54:00,0,3340.0,3175.0,0.951,16.674,10,10,0,10,0,0,0,0,0.0,0.0
1001,1689,25-09-2019 19:56:00,0,2852.0,2818.0,0.988,14.358,18,17,1,16,1,1,0,0,0.0,0.0
1001,1690,25-09-2019 19:58:00,0,2670.0,2611.0,0.978,13.411,6,6,0,6,0,0,0,0,0.0,0.0
1001,1691,25-09-2019 20:00:00,0,2725.0,2427.0,0.891,13.422,127,110,90,20,17,9,8,28,0.0,0.0
1001,1692,25-09-2019 20:02:00,0,3354.0,3084.0,0.919,16.628,97,39,19,20,58,35,23,46,0.0,0.0
1001,1693,25-09-2019 20:04:00,0,3979.0,3833.0,0.964,19.919,98,48,24,24,50,16,34,51,0.0,0.0
1001,1694,25-09-2019 20:06:00,0,4253.0,4137.0,0.973,21.336,127,76,43,33,51,17,34,54,0.0,0.13
1001,1695,25-09-2019 20:08:00,0,4337.0,4214.0,0.972,21.754,96,63,32,31,33,16,17,50,0.0,0.07
1001,1696,25-09-2019 20:10:00,0,4461.0,4288.0,0.961,22.322,191,93,71,22,98,73,25,32,0.0,0.05
1001,1697,25-09-2019 20:12:00,0,4246.0,4205.0,0.99,21.384,430,187,135,52,243,180,63,13,0.15,0.02
1001,1698,25-09-2019 20:14:00,0,3577.0,3534.0,0.988,18.005,273,131,91,40,142,97,45,21,0.0,0.01
1001,1699,25-09-2019 20:16:00,0,3962.0,3973.0,1.003,20.007,29,4,2,2,25,3,22,2,0.0,0.0
1001,1700,25-09-2019 20:18:00,0,3964.5,3941.0,0.9945,19.9815,73,56,42,14,17,5,12,11,0.0,0.0
1001,1701,25-09-2019 20:20:00,0,3967.0,3909.0,0.986,19.956,171,110,78,32,61,38,23,60,0.08,0.0
1001,1702,25-09-2019 20:22:00,0,4431.0,4322.0,0.975,22.242,126,72,42,30,54,21,33,68,0.0,0.0
1001,1703,25-09-2019 20:24:00,0,4417.0,4379.0,0.991,22.252,117,39,21,18,78,41,37,42,0.0,0.11
1001,1704,25-09-2019 20:26:00,0,4397.0,4398.0,1.0,22.195,148,84,53,31,64,31,33,32,0.11,0.07
1001,1705,25-09-2019 20:28:00,0,4416.0,4343.0,0.983,22.208,107,57,33,24,50,20,30,3,0.02,0.01
1001,1706,25-09-2019 20:30:00,0,3505.0,3420.0,0.976,17.596,32,30,4,26,2,0,2,2,0.0,0.0
1001,1707,25-09-2019 20:32:00,0,3421.0,3322.0,0.971,17.154,120,81,42,39,39,13,26,15,0.0,0.0
1001,1708,25-09-2019 20:34:00,0,3440.0,3275.0,0.952,17.18,120,71,45,26,49,32,17,7,0.0,0.0
1001,1709,25-09-2019 20:36:00,0,3313.0,3232.0,0.976,16.63,0,0,0,0,0,0,0,0,0.0,0.0
1001,1710,25-09-2019 20:38:00,0,3357.0,3109.0,0.926,16.669,0,0,0,0,0,0,0,0,0.0,0.0
1001,1711,25-09-2019 20:40:00,0,3168.0,2918.0,0.921,15.712,0,0,0,0,0,0,0,0,0.0,0.0
1001,1712,25-09-2019 20:42:00,0,2969.0,2822.0,0.951,14.822,0,0,0,0,0,0,0,0,0.0,0.0
1001,1713,25-09-2019 20:44:00,0,2884.0,2750.0,0.954,14.408,2,0,0,0,2,1,1,0,0.0,0.0
1001,1714,25-09-2019 20:46:00,0,2895.0,2686.0,0.928,14.381,39,20,13,7,19,10,9,0,0.0,0.0
1001,1715,25-09-2019 20:48:00,0,2921.0,2593.0,0.888,14.378,0,0,0,0,0,0,0,0,0.0,0.0
1001,1716,25-09-2019 20:50:00,0,2925.0,2632.0,0.9,14.436,27,24,2,22,3,2,1,0,0.0,0.0
1001,1717,25-09-2019 20:52:00,0,2812.5,2571.0,0.915,13.9275,19,18,0,18,1,0,1,0,0.0,0.0
1001,1718,25-09-2019 20:54:00,0,2700.0,2510.0,0.93,13.419,4,1,0,1,3,0,3,0,0.02,0.0
1001,1719,25-09-2019 20:56:00,0,2711.0,2522.0,0.93,13.473,7,1,1,0,6,0,6,0,0.0,0.0
1001,1720,25-09-2019 20:58:00,0,2705.0,2552.0,0.943,13.481,4,3,0,3,1,0,1,0,0.0,0.0
1001,1721,25-09-2019 21:00:00,0,2875.0,2790.0,0.97,14.418,4,2,0,2,2,0,2,0,0.0,0.0
1001,1722,25-09-2019 21:02:00,0,3589.0,3560.0,0.992,18.081,26,19,4,15,7,1,6,0,0.0,0.0
1001,1723,25-09-2019 21:04:00,0,4407.0,4482.0,1.017,22.325,192,132,96,36,60,27,33,50,0.0,0.0
1001,1724,25-09-2019 21:06:00,0,4351.0,4659.0,1.071,22.298,376,128,97,31,248,185,63,27,0.0,0.0
1001,1725,25-09-2019 21:08:00,0,3840.0,3928.0,1.023,19.477,282,162,127,35,120,82,38,55,0.0,0.0
1001,1726,25-09-2019 21:10:00,0,4402.0,4406.0,1.001,22.222,115,76,40,36,39,6,33,83,0.0,0.0
1001,1727,25-09-2019 21:12:00,0,4581.0,4628.0,1.01,23.172,129,80,34,46,49,2,47,80,0.0,0.0
1001,1728,25-09-2019 21:14:00,0,4567.0,4682.0,1.025,23.175,103,65,31,34,38,0,38,67,0.0,0.08
1001,1729,25-09-2019 21:16:00,0,4400.0,4461.0,1.014,22.273,199,118,80,38,81,53,28,50,0.0,0.06
1001,1730,25-09-2019 21:18:00,0,4214.0,4182.0,0.993,21.231,320,169,130,39,151,113,38,40,0.14,0.02
1001,1731,25-09-2019 21:20:00,0,4222.0,4244.0,1.005,21.332,185,116,91,25,69,38,31,74,0.0,0.01
1001,1732,25-09-2019 21:22:00,0,4412.0,4383.0,0.993,22.234,430,254,203,51,176,131,45,43,0.01,0.03
1001,1733,25-09-2019 21:24:00,0,3788.0,3680.0,0.972,18.999,125,59,39,20,66,30,36,1,0.0,0.04
1001,1734,25-09-2019 21:26:00,0,3320.0,3229.5,0.973,16.6565,50,28,12,16,22,8,14,2,0.0,0.01
1001,1735,25-09-2019 21:28:00,0,2852.0,2779.0,0.974,14.314,70,53,28,25,17,1,16,3,0.0,0.0
1001,1736,25-09-2019 21:30:00,0,3368.0,3024.0,0.898,16.617,195,119,84,35,76,42,34,18,0.0,0.0
1001,1737,25-09-2019 21:32:00,0,4376.0,4468.0,1.021,22.186,222,143,105,38,79,42,37,61,0.0,0.0
1001,1738,25-09-2019 21:34:00,0,4593.0,4698.0,1.023,23.297,153,73,40,33,80,45,35,43,0.0,0.0
1001,1739,25-09-2019 21:36:00,0,4572.0,4666.0,1.02,23.178,233,132,97,35,101,65,36,64,0.0,0.03
1001,1740,25-09-2019 21:38:00,0,4567.0,4680.0,1.025,23.173,226,137,97,40,89,61,28,16,0.17,0.04
1001,1741,25-09-2019 21:40:00,0,3778.0,3714.0,0.983,18.998,13,13,3,10,0,0,0,0,0.01,0.0
1001,1742,25-09-2019 21:42:00,0,3306.0,3324.0,1.005,16.706,13,13,2,11,0,0,0,0,0.0,0.0
1001,1743,25-09-2019 21:44:00,0,3174.0,2972.0,0.936,15.797,6,6,2,4,0,0,0,0,0.0,0.0
1001,1744,25-09-2019 21:46:00,0,2885.0,2742.0,0.95,14.403,10,10,5,5,0,0,0,0,0.0,0.04
1001,1745,25-09-2019 21:48:00,0,2910.0,2575.0,0.885,14.318,16,16,0,16,0,0,0,0,0.0,0.0
1001,1746,25-09-2019 21:50:00,0,2886.0,2689.0,0.932,14.348,7,6,2,4,1,1,0,0,0.0,0.0
1001,1747,25-09-2019 21:52:00,0,2986.0,2813.0,0.942,14.88,0,0,0,0,0,0,0,0,0.0,0.0
1001,1748,25-09-2019 21:54:00,0,2872.0,2803.0,0.976,14.418,2,1,0,1,1,0,1,0,0.0,0.0
1001,1749,25-09-2019 21:56:00,0,2872.0,2778.0,0.967,14.391,5,3,1,2,2,0,2,0,0.0,0.0
1001,1750,25-09-2019 21:58:00,0,2886.0,2757.0,0.955,14.424,35,22,14,8,13,4,9,0,0.0,0.0
1001,1751,25-09-2019 22:00:00,0,3396.0,3419.5,1.0,17.1655,4,4,2,2,0,0,0,0,0.0,0.0
1001,1752,25-09-2019 22:02:00,0,3906.0,4082.0,1.045,19.907,3,3,1,2,0,0,0,0,0.01,0.0
1001,1753,25-09-2019 22:04:00,0,4182.0,4393.0,1.05,21.338,1,1,0,1,0,0,0,0,0.0,0.0
1001,1754,25-09-2019 22:06:00,0,4242.0,4241.0,1.0,21.409,12,12,1,11,0,0,0,0,0.0,0.0
1001,1755,25-09-2019 22:08:00,0,3937.0,3980.0,1.011,19.919,131,66,34,32,65,38,27,8,0.0,0.0
1001,1756,25-09-2019 22:10:00,0,3918.0,4102.0,1.047,19.978,109,77,33,44,32,13,19,21,0.0,0.0
1001,1757,25-09-2019 22:12:00,0,3905.0,4094.0,1.048,19.917,53,45,17,28,8,0,8,9,0.0,0.0
1001,1758,25-09-2019 22:14:00,0,4135.0,4184.0,1.012,20.925,163,107,69,38,56,29,27,42,0.0,0.0
1001,1759,25-09-2019 22:16:00,0,3924.0,4067.0,1.036,19.964,81,79,38,41,2,1,1,65,0.0,0.0
1001,1760,25-09-2019 22:18:00,0,4221.0,4234.0,1.003,21.32,67,60,28,32,7,1,6,41,0.0,0.03
1001,1761,25-09-2019 22:20:00,0,4134.0,4103.0,0.992,20.831,79,56,30,26,23,5,18,44,0.0,0.12
1001,1762,25-09-2019 22:22:00,0,4252.0,4128.0,0.971,21.324,187,109,68,41,78,50,28,44,0.0,0.04
1001,1763,25-09-2019 22:24:00,0,3703.0,3614.0,0.976,18.592,454,279,229,50,175,124,51,19,0.13,0.0
1001,1764,25-09-2019 22:26:00,0,3763.0,3737.0,0.993,18.962,140,90,61,29,50,24,26,34,0.01,0.0
1001,1765,25-09-2019 22:28:00,0,4220.0,4223.0,1.001,21.303,191,130,93,37,61,36,25,62,0.0,0.0
1001,1766,25-09-2019 22:30:00,0,4234.0,4211.0,0.995,21.342,107,57,29,28,50,22,28,54,0.0,0.0
1001,1767,25-09-2019 22:32:00,0,4518.0,4488.0,0.993,22.769,49,26,5,21,23,12,11,39,0.0,0.16
1001,1768,25-09-2019 22:34:00,0,4348.0,4262.0,0.9795,21.849,419,252,196,56,167,121,46,37,0.22,0.0
1001,1769,25-09-2019 22:36:00,0,4178.0,4036.0,0.966,20.929,129,62,32,30,67,40,27,54,0.0,0.0
1001,1770,25-09-2019 22:38:00,0,4631.0,4537.0,0.98,23.267,103,77,59,18,26,18,8,1,0.0,0.04
1001,1771,25-09-2019 22:40:00,0,3524.0,3410.0,0.968,17.661,111,62,40,22,49,31,18,11,0.0,0.01
1001,1772,25-09-2019 22:42:00,0,3141.0,3037.0,0.967,15.739,285,172,133,39,113,81,32,37,0.03,0.0
1001,1773,25-09-2019 22:44:00,0,4453.0,4327.0,0.972,22.336,115,49,20,29,66,31,35,63,0.02,0.0
1001,1774,25-09-2019 22:46:00,0,4691.0,4675.0,0.996,23.659,134,89,56,33,45,12,33,70,0.0,0.0
1001,1775,25-09-2019 22:48:00,0,4890.0,4868.0,0.996,24.654,115,62,28,34,53,29,24,66,0.0,0.0
1001,1776,25-09-2019 22:50:00,0,4812.0,4722.0,0.981,24.187,107,69,41,28,38,18,20,49,0.0,0.16
1001,1777,25-09-2019 22:52:00,0,4901.0,4716.0,0.962,24.533,448,272,208,64,176,134,42,20,0.2,0.04
1001,1778,25-09-2019 22:54:00,0,4448.0,4304.0,0.968,22.291,241,164,122,42,77,44,33,5,0.0,0.0
1001,1779,25-09-2019 22:56:00,0,3780.0,3719.0,0.984,19.012,253,72,42,30,181,129,52,13,0.0,0.0
1001,1780,25-09-2019 22:58:00,0,3487.0,3444.0,0.988,17.55,178,103,68,35,75,42,33,41,0.0,0.01
1001,1781,25-09-2019 23:00:00,0,4629.0,4518.0,0.976,23.241,128,82,47,35,46,21,25,50,0.0,0.07
1001,1782,25-09-2019 23:02:00,0,4892.0,4742.0,0.969,24.525,195,128,84,44,67,37,30,73,0.0,0.07
1001,1783,25-09-2019 23:04:00,0,4333.0,4254.0,0.982,21.78,453,278,215,63,175,125,50,17,0.0,0.0
1001,1784,25-09-2019 23:06:00,0,3786.0,3666.0,0.968,18.975,13,13,0,13,0,0,0,0,0.0,0.0
1001,1785,25-09-2019 23:08:00,0,3655.0,3522.0,0.9635,18.2995,117,74,42,32,43,22,21,17,0.0,0.01
1001,1786,25-09-2019 23:10:00,0,3524.0,3378.0,0.959,17.624,293,150,110,40,143,107,36,87,0.0,0.0
1001,1787,25-09-2019 23:12:00,0,4370.0,4175.0,0.955,21.842,646,351,276,75,295,234,61,33,0.07,0.0
1001,1788,25-09-2019 23:14:00,0,4890.0,4791.0,0.98,24.571,625,420,344,76,205,158,47,50,0.02,0.01
1001,1789,25-09-2019 23:16:00,0,5650.0,5809.0,1.028,28.69,315,206,163,43,109,67,42,49,0.0,0.0
1001,1790,25-09-2019 23:18:00,0,3885.0,3778.0,0.972,19.491,189,92,61,31,97,53,44,12,0.0,0.0
1001,1791,25-09-2019 23:20:00,0,3905.0,3707.0,0.949,19.489,256,175,128,47,81,49,32,22,0.12,0.0
1001,1792,25-09-2019 23:22:00,0,4902.0,4848.0,0.989,24.681,181,121,77,44,60,38,22,7,0.02,0.0
1001,1793,25-09-2019 23:24:00,0,4279.0,4096.0,0.957,21.394,22,10,5,5,12,2,10,1,0.01,0.0
1001,1794,25-09-2019 23:26:00,0,4425.0,4395.0,0.993,22.301,43,20,5,15,23,6,17,1,0.0,0.0
1001,1795,25-09-2019 23:28:00,0,5024.0,5134.0,1.022,25.478,45,35,17,18,10,5,5,5,0.0,0.0
1001,1796,25-09-2019 23:30:00,0,5059.0,5063.0,1.001,25.537,131,97,59,38,34,9,25,1,0.0,0.0
1001,1797,25-09-2019 23:32:00,0,4874.0,4888.0,1.003,24.615,18,9,6,3,9,0,9,1,0.0,0.0
1001,1798,25-09-2019 23:34:00,0,4586.0,4658.0,1.016,23.226,9,9,5,4,0,0,0,1,0.0,0.0
1001,1799,25-09-2019 23:36:00,0,4413.0,4408.0,0.999,22.266,0,0,0,0,0,0,0,0,0.0,0.0
1001,1800,25-09-2019 23:38:00,0,4252.0,4158.0,0.978,21.358,0,0,0,0,0,0,0,0,0.0,0.0
1001,1801,25-09-2019 23:40:00,0,3951.0,4015.0,1.016,20.01,41,20,8,12,21,2,19,0,0.0,0.0
1001,1802,25-09-2019 23:42:00,0,3873.5,3847.0,0.9925,19.5185,6,0,0,0,6,0,6,0,0.0,0.0
1001,1803,25-09-2019 23:44:00,0,3796.0,3679.0,0.969,19.027,0,0,0,0,0,0,0,0,0.0,0.0
1001,1804,25-09-2019 23:46:00,0,3614.0,3526.0,0.976,18.141,4,2,0,2,2,0,2,0,0.0,0.0
1001,1805,25-09-2019 23:48:00,0,3505.0,3446.0,0.983,17.624,3,3,3,0,0,0,0,0,0.0,0.0
1001,1806,25-09-2019 23:50:00,0,3422.0,3343.0,0.977,17.183,5,5,0,5,0,0,0,0,0.01,0.0
1001,1807,25-09-2019 23:52:00,0,3310.0,3257.0,0.984,16.647,4,4,0,4,0,0,0,0,0.0,0.0
1001,1808,25-09-2019 23:54:00,0,3331.0,3197.0,0.96,16.662,1,1,0,1,0,0,0,0,0.0,0.0
1001,1809,25-09-2019 23:56:00,0,3123.0,3115.0,0.997,15.753,2,1,0,1,1,1,0,0,0.0,0.0
1001,1810,25-09-2019 23:58:00,0,3137.0,3031.0,0.966,15.717,0,0,0,0,0,0,0,0,0.0,0.0
1001,1811,26-09-2019 00:00:00,0,3159.0,3002.0,0.95,15.768,6,4,1,3,2,1,1,0,0.0,0.0
1001,1812,26-09-2019 00:02:00,0,2949.0,2960.0,1.004,14.897,1,0,0,0,1,1,0,0,0.0,0.0
1001,1813,26-09-2019 00:04:00,0,3052.0,2965.0,0.971,15.309,0,0,0,0,0,0,0,0,0.0,0.0
1001,1814,26-09-2019 00:06:00,0,2839.0,2920.0,1.028,14.42,0,0,0,0,0,0,0,0,0.0,0.0
1001,1815,26-09-2019 00:08:00,0,2839.0,2907.0,1.024,14.404,0,0,0,0,0,0,0,0,0.0,0.0
1001,1816,26-09-2019 00:10:00,0,2949.0,2943.0,0.998,14.877,9,2,1,1,7,0,7,0,0.0,0.0
1001,1817,26-09-2019 00:12:00,0,2835.0,2931.0,1.034,14.413,11,2,0,2,9,0,9,0,0.0,0.0
1001,1818,26-09-2019 00:14:00,0,2850.0,2860.0,1.004,14.395,46,27,10,17,19,2,17,0,0.0,0.0
1001,1819,26-09-2019 00:16:00,0,2999.0,2944.5,0.983,15.076,77,62,19,43,15,4,11,1,0.0,0.0
1001,1820,26-09-2019 00:18:00,0,3148.0,3029.0,0.962,15.757,49,13,2,11,36,4,32,2,0.0,0.0
1001,1821,26-09-2019 00:20:00,0,3232.0,3181.0,0.984,16.254,45,25,7,18,20,2,18,11,0.0,0.0
1001,1822,26-09-2019 00:22:00,0,3303.0,3341.0,1.012,16.711,53,35,11,24,18,0,18,0,0.0,0.0
1001,1823,26-09-2019 00:24:00,0,3509.0,3482.0,0.992,17.679,178,113,75,38,65,41,24,59,0.0,0.0
1001,1824,26-09-2019 00:26:00,0,3489.0,3504.0,1.004,17.627,95,46,20,26,49,13,36,55,0.0,0.0
1001,1825,26-09-2019 00:28:00,0,3784.0,3686.0,0.974,18.989,110,73,42,31,37,15,22,61,0.0,0.35
1001,1826,26-09-2019 00:30:00,0,3976.0,3900.0,0.981,19.984,28,24,0,24,4,2,2,0,0.0,0.01
1001,1827,26-09-2019 00:32:00,0,3750.0,3852.0,1.027,19.038,1,0,0,0,1,0,1,0,0.0,0.0
1001,1828,26-09-2019 00:34:00,0,3746.0,3842.0,1.026,19.014,414,229,176,53,185,139,46,26,0.03,0.01
1001,1829,26-09-2019 00:36:00,0,3750.0,3853.0,1.027,19.041,707,399,321,78,308,232,76,27,0.01,0.0
1001,1830,26-09-2019 00:38:00,0,4038.0,4086.0,1.012,20.432,800,493,407,86,307,241,66,59,0.08,0.0
1001,1831,26-09-2019 00:40:00,0,3948.0,3944.0,0.999,19.921,635,402,319,83,233,175,58,30,0.06,0.0
1001,1832,26-09-2019 00:42:00,0,4232.0,4225.0,0.998,21.353,600,377,304,73,223,170,53,67,0.0,0.04
1001,1833,26-09-2019 00:44:00,0,4231.0,4204.0,0.994,21.324,291,247,189,58,44,10,34,99,0.0,0.0
1001,1834,26-09-2019 00:46:00,0,4432.0,4334.0,0.978,22.261,199,159,113,46,40,9,31,58,0.0,0.0
1001,1835,26-09-2019 00:48:00,0,4131.0,4089.0,0.99,20.804,105,77,41,36,28,11,17,6,0.0,0.0
1001,1836,26-09-2019 00:50:00,0,4056.5,3972.0,0.979,20.3805,475,310,231,79,165,114,51,34,0.0,0.0
1001,1837,26-09-2019 00:52:00,0,3982.0,3855.0,0.968,19.957,266,143,103,40,123,77,46,30,0.0,0.0
1001,1838,26-09-2019 00:54:00,0,3973.0,3920.0,0.987,19.991,289,171,125,46,118,76,42,20,0.0,0.0
1001,1839,26-09-2019 00:56:00,0,4431.0,4271.0,0.964,22.188,222,119,84,35,103,66,37,3,0.0,0.0
1001,1840,26-09-2019 00:58:00,0,4318.0,4254.0,0.985,21.724,119,77,47,30,42,9,33,72,0.11,0.0
1001,1841,26-09-2019 01:00:00,0,4419.0,4404.0,0.997,22.286,99,57,28,29,42,2,40,62,0.0,0.0
1001,1842,26-09-2019 01:02:00,0,4390.0,4433.0,1.01,22.202,122,63,31,32,59,6,53,74,0.01,0.0
1001,1843,26-09-2019 01:04:00,0,4568.0,4631.0,1.014,23.125,112,85,64,21,27,11,16,24,0.0,0.06
1001,1844,26-09-2019 01:06:00,0,3552.0,3331.0,0.938,17.684,4,3,2,1,1,0,1,0,0.0,0.0
1001,1845,26-09-2019 01:08:00,0,2857.0,2764.0,0.967,14.318,12,12,0,12,0,0,0,0,0.0,0.0
1001,1846,26-09-2019 01:10:00,0,2813.0,2585.0,0.919,13.945,15,15,0,15,0,0,0,0,0.0,0.0
1001,1847,26-09-2019 01:12:00,0,3190.0,2890.0,0.906,15.767,0,0,0,0,0,0,0,0,0.0,0.0
1001,1848,26-09-2019 01:14:00,0,3514.0,3424.0,0.974,17.636,1,0,0,0,1,0,1,0,0.0,0.0
1001,1849,26-09-2019 01:16:00,0,3880.0,3822.0,0.985,19.519,257,178,120,58,79,47,32,6,0.0,0.0
1001,1850,26-09-2019 01:18:00,0,4238.0,4179.0,0.986,21.324,832,509,407,102,323,241,82,40,0.0,0.01
1001,1851,26-09-2019 01:20:00,0,4243.0,4212.0,0.993,21.381,456,315,242,73,141,86,55,23,0.0,0.01
1001,1852,26-09-2019 01:22:00,0,4231.0,4247.0,1.004,21.37,932,545,457,88,387,304,83,68,0.0,0.0
1001,1853,26-09-2019 01:24:00,0,4084.0,4122.5,1.01,20.653,769,534,443,91,235,179,56,43,0.13,0.01
1001,1854,26-09-2019 01:26:00,0,3937.0,3998.0,1.016,19.936,123,74,43,31,49,17,32,6,0.02,0.0
1001,1855,26-09-2019 01:28:00,0,4158.0,4082.0,0.982,20.903,109,74,40,34,35,7,28,2,0.0,0.0
1001,1856,26-09-2019 01:30:00,0,4253.0,4103.0,0.965,21.298,152,80,48,32,72,37,35,6,0.0,0.0
1001,1857,26-09-2019 01:32:00,0,4248.0,4148.0,0.977,21.33,106,64,29,35,42,4,38,66,0.0,0.0
1001,1858,26-09-2019 01:34:00,0,4142.0,4039.0,0.975,20.789,78,53,35,18,25,8,17,40,0.0,0.0
1001,1859,26-09-2019 01:36:00,0,4177.0,4032.0,0.965,20.92,95,46,23,23,49,0,49,50,0.0,0.0
1001,1860,26-09-2019 01:38:00,0,4233.0,4201.0,0.993,21.327,518,361,289,72,157,114,43,55,0.01,0.13
1001,1861,26-09-2019 01:40:00,0,3961.0,3951.0,0.997,19.981,314,190,141,49,124,92,32,16,0.03,0.0
1001,1862,26-09-2019 01:42:00,0,3531.0,3388.0,0.96,17.663,685,450,364,86,235,186,49,34,0.01,0.0
1001,1863,26-09-2019 01:44:00,0,3722.0,3530.0,0.948,18.573,665,460,358,102,205,158,47,35,0.0,0.0
1001,1864,26-09-2019 01:46:00,0,3547.0,3325.0,0.937,17.657,113,67,38,29,46,23,23,4,0.0,0.0
1001,1865,26-09-2019 01:48:00,0,3337.0,3240.0,0.971,16.733,111,97,53,44,14,1,13,0,0.0,0.0
1001,1866,26-09-2019 01:50:00,0,3989.0,3860.0,0.968,19.992,73,40,16,24,33,5,28,2,0.0,0.0
1001,1867,26-09-2019 01:52:00,0,4431.0,4320.0,0.975,22.24,50,22,5,17,28,2,26,0,0.0,0.0
1001,1868,26-09-2019 01:54:00,0,4206.0,4222.0,1.004,21.245,1,0,0,0,1,0,1,0,0.0,0.0
1001,1869,26-09-2019 01:56:00,0,4153.0,4077.0,0.982,20.874,0,0,0,0,0,0,0,0,0.01,0.0
1001,1870,26-09-2019 01:58:00,0,3972.0,3882.0,0.9775,19.946,2,1,0,1,1,0,1,0,0.0,0.0
1001,1871,26-09-2019 02:00:00,0,3791.0,3687.0,0.973,19.018,2,1,0,1,1,0,1,0,0.0,0.0
1001,1872,26-09-2019 02:02:00,0,3596.0,3580.0,0.996,18.131,3,3,0,3,0,0,0,0,0.0,0.0
1001,1873,26-09-2019 02:04:00,0,3504.0,3421.0,0.976,17.593,6,4,0,4,2,0,2,0,0.0,0.0
1001,1874,26-09-2019 02:06:00,0,3407.0,3349.0,0.983,17.132,11,11,0,11,0,0,0,0,0.0,0.0
1001,1875,26-09-2019 02:08:00,0,3319.0,3252.0,0.98,16.676,3,1,0,1,2,0,2,0,0.0,0.0
1001,1876,26-09-2019 02:10:00,0,3220.0,3152.0,0.979,16.176,8,8,1,7,0,0,0,0,0.0,0.0
1001,1877,26-09-2019 02:12:00,0,3123.0,3108.0,0.995,15.747,1,1,0,1,0,0,0,0,0.0,0.0
1001,1878,26-09-2019 02:14:00,0,3144.0,3047.0,0.969,15.76,0,0,0,0,0,0,0,0,0.0,0.0
1001,1879,26-09-2019 02:16:00,0,3145.0,3012.0,0.958,15.727,4,2,1,1,2,0,2,0,0.0,0.0
1001,1880,26-09-2019 02:18:00,0,3061.0,3005.0,0.982,15.387,19,16,9,7,3,2,1,0,0.0,0.0
1001,1881,26-09-2019 02:20:00,0,3040.0,2986.0,0.982,15.282,9,9,0,9,0,0,0,0,0.0,0.0
1001,1882,26-09-2019 02:22:00,0,2946.0,2971.0,1.008,14.897,6,6,3,3,0,0,0,0,0.0,0.01
1001,1883,26-09-2019 02:24:00,0,3047.0,2968.0,0.974,15.29,5,5,2,3,0,0,0,0,0.0,0.0
1001,1884,26-09-2019 02:26:00,0,2939.0,2934.0,0.998,14.829,6,4,2,2,2,0,2,0,0.0,0.0
1001,1885,26-09-2019 02:28:00,0,2829.0,2911.0,1.029,14.37,2,1,0,1,1,0,1,0,0.0,0.0
1001,1886,26-09-2019 02:30:00,0,2839.0,2866.0,1.009,14.36,9,3,3,0,6,0,6,0,0.0,0.0
1001,1887,26-09-2019 02:32:00,0,2853.0,2838.0,0.9945,14.384,2,0,0,0,2,0,2,0,0.0,0.0
1001,1888,26-09-2019 02:34:00,0,2867.0,2810.0,0.98,14.408,0,0,0,0,0,0,0,0,0.0,0.0
1001,1889,26-09-2019 02:36:00,0,2832.0,2898.0,1.023,14.365,3,3,2,1,0,0,0,0,0.0,0.0
1001,1890,26-09-2019 02:38:00,0,2939.0,2980.0,1.014,14.879,0,0,0,0,0,0,0,0,0.0,0.0
1001,1891,26-09-2019 02:40:00,0,2847.0,2905.0,1.02,14.432,149,80,51,29,69,46,23,7,0.0,0.0
1001,1892,26-09-2019 02:42:00,0,3041.0,3017.0,0.992,15.321,66,50,15,35,16,0,16,5,0.0,0.01
1001,1893,26-09-2019 02:44:00,0,3125.0,3146.0,1.007,15.795,37,16,1,15,21,0,21,0,0.0,0.0
1001,1894,26-09-2019 02:46:00,0,3328.0,3249.0,0.976,16.71,184,123,76,47,61,37,24,14,0.0,0.0
1001,1895,26-09-2019 02:48:00,0,3308.0,3319.0,1.003,16.709,135,72,37,35,63,30,33,70,0.0,0.0
1001,1896,26-09-2019 02:50:00,0,3312.0,3337.0,1.007,16.745,119,76,38,38,43,15,28,55,0.0,0.0
1001,1897,26-09-2019 02:52:00,0,3487.0,3562.0,1.021,17.683,143,61,28,33,82,46,36,58,0.0,0.0
1001,1898,26-09-2019 02:54:00,0,3506.0,3501.0,0.999,17.688,129,42,19,23,87,52,35,42,0.0,0.07
1001,1899,26-09-2019 02:56:00,0,3806.0,3653.0,0.96,19.04,267,151,111,40,116,79,37,45,0.0,0.04
1001,1900,26-09-2019 02:58:00,0,2942.0,2932.0,0.997,14.836,716,446,363,83,270,222,48,54,0.11,0.03
1001,1901,26-09-2019 03:00:00,0,3688.0,3671.0,0.995,18.596,339,198,130,68,141,101,40,22,0.01,0.0
1001,1902,26-09-2019 03:02:00,0,2695.0,2547.0,0.945,13.44,268,153,118,35,115,81,34,21,0.0,0.0
1001,1903,26-09-2019 03:04:00,0,3348.0,3164.0,0.945,16.695,433,255,189,66,178,129,49,60,0.05,0.0
1001,1904,26-09-2019 03:06:00,0,3808.5,3627.5,0.9515,19.021,135,81,46,35,54,16,38,70,0.0,0.0
1001,1905,26-09-2019 03:08:00,0,4269.0,4091.0,0.958,21.347,121,59,22,37,62,30,32,52,0.0,0.0
1001,1906,26-09-2019 03:10:00,0,4266.0,4133.0,0.969,21.385,179,107,62,45,72,32,40,49,0.0,0.07
1001,1907,26-09-2019 03:12:00,0,3331.0,3261.0,0.979,16.736,71,42,20,22,29,13,16,0,0.0,0.0
1001,1908,26-09-2019 03:14:00,0,3175.0,2987.0,0.941,15.817,27,2,2,0,25,0,25,0,0.0,0.0
1001,1909,26-09-2019 03:16:00,0,2865.0,2798.0,0.977,14.384,5,1,0,1,4,0,4,0,0.0,0.0
1001,1910,26-09-2019 03:18:00,0,2692.0,2574.0,0.956,13.457,2,2,0,2,0,0,0,0,0.0,0.0
1001,1911,26-09-2019 03:20:00,0,2710.0,2510.0,0.926,13.457,3,3,2,1,0,0,0,0,0.0,0.0
1001,1912,26-09-2019 03:22:00,0,2923.0,2613.0,0.894,14.41,1,0,0,0,1,0,1,0,0.0,0.0
1001,1913,26-09-2019 03:24:00,0,2914.0,2653.0,0.91,14.417,6,3,2,1,3,0,3,0,0.0,0.0
1001,1914,26-09-2019 03:26:00,0,2970.0,2841.0,0.956,14.846,0,0,0,0,0,0,0,0,0.0,0.0
1001,1915,26-09-2019 03:28:00,0,3075.0,2902.0,0.944,15.327,0,0,0,0,0,0,0,0,0.0,0.0
1001,1916,26-09-2019 03:30:00,0,3335.0,3202.0,0.96,16.682,21,13,5,8,8,4,4,0,0.0,0.0
1001,1917,26-09-2019 03:32:00,0,3571.0,3648.0,1.022,18.107,9,7,1,6,2,1,1,0,0.0,0.0
1001,1918,26-09-2019 03:34:00,0,3777.0,3774.0,0.999,19.058,3,1,0,1,2,0,2,0,0.0,0.0
1001,1919,26-09-2019 03:36:00,0,3678.0,3716.0,1.01,18.606,15,13,0,13,2,0,2,0,0.0,0.0
1001,1920,26-09-2019 03:38:00,0,3474.0,3605.0,1.038,17.678,69,46,23,23,23,10,13,1,0.0,0.0
1001,1921,26-09-2019 03:40:00,0,3388.5,3491.5,1.0305,17.215,6,2,1,1,4,1,3,0,0.0,0.0
1001,1922,26-09-2019 03:42:00,0,3303.0,3378.0,1.023,16.752,4,1,0,1,3,0,3,0,0.0,0.0
1001,1923,26-09-2019 03:44:00,0,3317.0,3243.0,0.978,16.66,0,0,0,0,0,0,0,0,0.0,0.0
1001,1924,26-09-2019 03:46:00,0,3129.0,3122.0,0.998,15.784,5,3,0,3,2,0,2,0,0.0,0.0
1001,1925,26-09-2019 03:48:00,0,3038.0,3024.0,0.995,15.317,6,3,0,3,3,0,3,0,0.0,0.0
1001,1926,26-09-2019 03:50:00,0,2942.0,2942.0,1.0,14.849,1,0,0,0,1,0,1,0,0.0,0.0
1001,1927,26-09-2019 03:52:00,0,2859.0,2838.0,0.993,14.404,2,1,0,1,1,0,1,0,0.0,0.0
1001,1928,26-09-2019 03:54:00,0,2876.0,2786.0,0.969,14.416,5,1,0,1,4,0,4,0,0.0,0.0
1001,1929,26-09-2019 03:56:00,0,2769.0,2714.0,0.98,13.915,6,3,0,3,3,0,3,0,0.0,0.0
1001,1930,26-09-2019 03:58:00,0,2655.0,2674.0,1.007,13.42,4,3,0,3,1,0,1,0,0.0,0.0
1001,1931,26-09-2019 04:00:00,0,2677.0,2602.0,0.972,13.427,0,0,0,0,0,0,0,0,0.0,0.0
1001,1932,26-09-2019 04:02:00,0,2700.0,2573.0,0.953,13.486,5,5,0,5,0,0,0,0,0.0,0.0
1001,1933,26-09-2019 04:04:00,0,2704.0,2500.0,0.925,13.42,48,39,16,23,9,0,9,1,0.0,0.0
1001,1934,26-09-2019 04:06:00,0,2761.0,2722.0,0.986,13.891,206,111,59,52,95,73,22,29,0.0,0.0
1001,1935,26-09-2019 04:08:00,0,3041.0,2997.0,0.986,15.299,320,190,148,42,130,85,45,31,0.0,0.0
1001,1936,26-09-2019 04:10:00,0,2929.0,2989.0,1.02,14.85,737,403,319,84,334,261,73,42,0.0,0.0
1001,1937,26-09-2019 04:12:00,0,3147.0,3034.0,0.964,15.759,422,297,227,70,125,91,34,36,0.0,0.05
1001,1938,26-09-2019 04:14:00,0,3238.5,3118.0,0.9625,16.2125,98,57,33,24,41,26,15,26,0.0,0.0
1001,1939,26-09-2019 04:16:00,0,3330.0,3202.0,0.961,16.666,42,38,12,26,4,0,4,6,0.0,0.0
1001,1940,26-09-2019 04:18:00,0,3300.0,3292.0,0.998,16.646,97,74,45,29,23,7,16,26,0.0,0.0
1001,1941,26-09-2019 04:20:00,0,3504.0,3398.0,0.97,17.568,868,537,455,82,331,264,67,76,0.0,0.0
1001,1942,26-09-2019 04:22:00,0,3391.0,3401.0,1.003,17.126,487,252,186,66,235,174,61,37,0.0,0.0
1001,1943,26-09-2019 04:24:00,0,3488.0,3471.0,0.995,17.586,156,138,94,44,18,3,15,54,0.0,0.0
1001,1944,26-09-2019 04:26:00,0,3519.0,3435.0,0.976,17.669,94,60,24,36,34,6,28,49,0.0,0.0
1001,1945,26-09-2019 04:28:00,0,3499.0,3413.0,0.975,17.566,91,64,24,40,27,14,13,52,0.0,0.0
1001,1946,26-09-2019 04:30:00,0,3495.0,3453.0,0.988,17.593,134,47,13,34,87,48,39,58,0.0,0.0
1001,1947,26-09-2019 04:32:00,0,3509.0,3455.0,0.984,17.65,116,35,14,21,81,36,45,57,0.0,0.0
1001,1948,26-09-2019 04:34:00,0,3703.0,3556.0,0.96,18.528,70,29,1,28,41,7,34,47,0.0,0.0
1001,1949,26-09-2019 04:36:00,0,3872.0,3776.0,0.975,19.436,59,29,0,29,30,2,28,48,0.0,0.11
1001,1950,26-09-2019 04:38:00,0,3795.0,3658.0,0.964,19.003,349,271,207,64,78,45,33,27,0.0,0.05
1001,1951,26-09-2019 04:40:00,0,2845.0,2833.0,0.996,14.346,818,476,377,99,342,266,76,45,0.0,0.0
1001,1952,26-09-2019 04:42:00,0,2867.0,2804.0,0.978,14.401,404,227,178,49,177,117,60,23,0.01,0.0
1001,1953,26-09-2019 04:44:00,0,2893.0,2741.0,0.948,14.433,696,453,373,80,243,184,59,44,0.12,0.0
1001,1954,26-09-2019 04:46:00,0,3785.0,3690.0,0.975,18.997,120,79,62,17,41,30,11,1,0.0,0.0
1001,1955,26-09-2019 04:48:00,0,3378.5,3234.5,0.955,16.8915,0,0,0,0,0,0,0,0,0.0,0.0
1001,1956,26-09-2019 04:50:00,0,2972.0,2779.0,0.935,14.786,48,46,14,32,2,1,1,1,0.0,0.0
1001,1957,26-09-2019 04:52:00,0,3540.0,3320.0,0.938,17.622,10,10,1,9,0,0,0,0,0.0,0.0
1001,1958,26-09-2019 04:54:00,0,3807.0,3576.0,0.939,18.957,22,20,5,15,2,0,2,1,0.0,0.0
1001,1959,26-09-2019 04:56:00,0,4230.0,4234.0,1.001,21.352,17,17,4,13,0,0,0,0,0.0,0.0
1001,1960,26-09-2019 04:58:00,0,3922.0,4018.0,1.024,19.902,0,0,0,0,0,0,0,0,0.01,0.0
1001,1961,26-09-2019 05:00:00,0,3927.0,4006.0,1.02,19.907,5,5,2,3,0,0,0,0,0.0,0.0
1001,1962,26-09-2019 05:02:00,0,3965.0,3877.0,0.978,19.913,6,6,2,4,0,0,0,0,0.0,0.0
1001,1963,26-09-2019 05:04:00,0,3782.0,3697.0,0.977,18.994,1,1,0,1,0,0,0,0,0.0,0.0
1001,1964,26-09-2019 05:06:00,0,3593.0,3512.0,0.977,18.045,8,8,4,4,0,0,0,0,0.0,0.0
1001,1965,26-09-2019 05:08:00,0,3507.0,3408.0,0.972,17.588,0,0,0,0,0,0,0,0,0.0,0.0
1001,1966,26-09-2019 05:10:00,0,3325.0,3260.0,0.98,16.712,6,6,1,5,0,0,0,0,0.0,0.0
1001,1967,26-09-2019 05:12:00,0,3241.0,3134.0,0.967,16.241,2,2,0,2,0,0,0,0,0.0,0.0
1001,1968,26-09-2019 05:14:00,0,3148.0,3047.0,0.968,15.779,0,0,0,0,0,0,0,0,0.0,0.0
1001,1969,26-09-2019 05:16:00,0,3059.0,2938.0,0.961,15.303,0,0,0,0,0,0,0,0,0.01,0.0
1001,1970,26-09-2019 05:18:00,0,2847.0,2882.0,1.012,14.409,0,0,0,0,0,0,0,0,0.0,0.0
1001,1971,26-09-2019 05:20:00,0,2849.0,2840.0,0.997,14.37,0,0,0,0,0,0,0,0,0.0,0.0
1001,1972,26-09-2019 05:22:00,0,2855.5,2822.0,0.988,14.376,20,20,10,10,0,0,0,0,0.0,0.0
1001,1973,26-09-2019 05:24:00,0,2862.0,2804.0,0.979,14.382,0,0,0,0,0,0,0,0,0.0,0.0
1001,1974,26-09-2019 05:26:00,0,2868.0,2807.0,0.979,14.409,0,0,0,0,0,0,0,0,0.0,0.0
1001,1975,26-09-2019 05:28:00,0,2881.0,2736.0,0.949,14.38,1,1,0,1,0,0,0,0,0.0,0.0
1001,1976,26-09-2019 05:30:00,0,2668.0,2685.0,1.007,13.483,0,0,0,0,0,0,0,0,0.0,0.0
1001,1977,26-09-2019 05:32:00,0,2666.0,2677.0,1.004,13.47,0,0,0,0,0,0,0,0,0.0,0.0
1001,1978,26-09-2019 05:34:00,0,2676.0,2645.0,0.988,13.47,0,0,0,0,0,0,0,0,0.0,0.0
1001,1979,26-09-2019 05:36:00,0,2666.0,2636.0,0.989,13.421,7,7,2,5,0,0,0,1,0.0,0.0
1001,1980,26-09-2019 05:38:00,0,2864.0,2742.0,0.957,14.321,65,43,32,11,22,17,5,25,0.0,0.0
1001,1981,26-09-2019 05:40:00,0,3160.0,3015.0,0.954,15.787,377,223,157,66,154,101,53,79,0.0,0.0
1001,1982,26-09-2019 05:42:00,0,3357.0,3171.0,0.945,16.736,570,345,268,77,225,172,53,106,0.0,0.0
1001,1983,26-09-2019 05:44:00,0,3327.0,3225.0,0.969,16.678,311,161,119,42,150,116,34,50,0.0,0.0
1001,1984,26-09-2019 05:46:00,0,3339.0,3186.0,0.954,16.681,89,50,13,37,39,27,12,61,0.0,0.0
1001,1985,26-09-2019 05:48:00,0,3309.0,3245.0,0.98,16.631,70,62,19,43,8,7,1,53,0.0,0.0
1001,1986,26-09-2019 05:50:00,0,3521.0,3391.0,0.963,17.627,75,60,27,33,15,7,8,48,0.0,0.0
1001,1987,26-09-2019 05:52:00,0,3613.0,3497.0,0.968,18.106,85,57,23,34,28,16,12,63,0.0,0.0
1001,1988,26-09-2019 05:54:00,0,3831.0,3574.0,0.933,19.052,307,180,123,57,127,89,38,56,0.0,0.24
1001,1989,26-09-2019 05:56:00,0,3686.5,3461.5,0.939,18.3575,805,472,383,89,333,251,82,77,0.12,0.0
1001,1990,26-09-2019 05:58:00,0,3542.0,3349.0,0.945,17.663,578,444,360,84,134,96,38,59,0.0,0.0
1001,1991,26-09-2019 06:00:00,1,3450.0,3223.0,0.934,17.161,628,403,332,71,225,164,61,67,0.01,0.0
1001,1992,26-09-2019 06:02:00,1,3794.0,3619.0,0.954,18.956,397,237,188,49,160,112,48,36,0.0,0.0
1001,1993,26-09-2019 06:04:00,1,3408.0,3324.0,0.975,17.105,394,254,198,56,140,97,43,25,0.0,0.0
1001,1994,26-09-2019 06:06:00,1,3608.0,3473.0,0.963,18.059,315,195,150,45,120,83,37,27,0.0,0.0
1001,1995,26-09-2019 06:08:00,1,3890.0,3810.0,0.979,19.546,181,64,48,16,117,83,34,9,0.0,0.0
1001,1996,26-09-2019 06:10:00,1,4242.0,4107.0,0.968,21.261,381,203,155,48,178,129,49,6,0.0,0.0
1001,1997,26-09-2019 06:12:00,1,4351.0,4273.0,0.982,21.873,335,169,129,40,166,116,50,12,0.0,0.0
1001,1998,26-09-2019 06:14:00,1,4251.0,4134.0,0.973,21.324,86,61,25,36,25,11,14,3,0.0,0.0
1001,1999,26-09-2019 06:16:00,1,4242.0,4149.0,0.978,21.306,67,46,15,31,21,6,15,3,0.0,0.0
1001,2000,26-09-2019 06:18:00,1,4250.0,4063.0,0.956,21.244,25,24,5,19,1,0,1,0,0.0,0.0
1001,2001,26-09-2019 06:20:00,1,4055.0,3970.0,0.979,20.37,12,8,0,8,4,0,4,0,0.0,0.0
1001,2002,26-09-2019 06:22:00,1,3964.0,3879.0,0.979,19.91,25,13,2,11,12,0,12,0,0.0,0.0
1001,2003,26-09-2019 06:24:00,1,3976.0,3853.0,0.969,19.933,70,58,36,22,12,3,9,2,0.0,0.0
1001,2004,26-09-2019 06:26:00,1,3971.0,3848.0,0.969,19.907,30,13,1,12,17,0,17,0,0.0,0.0
1001,2005,26-09-2019 06:28:00,1,3889.0,3783.0,0.973,19.512,8,0,0,0,8,0,8,0,0.0,0.0
1001,2006,26-09-2019 06:30:00,1,3710.0,3600.0,0.9705,18.604,1,0,0,0,1,0,1,0,0.0,0.0
1001,2007,26-09-2019 06:32:00,1,3531.0,3417.0,0.968,17.696,4,2,1,1,2,1,1,0,0.0,0.0
1001,2008,26-09-2019 06:34:00,1,3338.0,3235.0,0.969,16.731,1,1,0,1,0,0,0,0,0.0,0.0
1001,2009,26-09-2019 06:36:00,1,3252.0,3058.0,0.941,16.197,2,2,0,2,0,0,0,0,0.0,0.0
1001,2010,26-09-2019 06:38:00,1,3185.0,2919.0,0.916,15.781,1,1,0,1,0,0,0,0,0.0,0.0
1001,2011,26-09-2019 06:40:00,1,2853.0,2802.0,0.982,14.341,7,5,2,3,2,0,2,0,0.0,0.0
1001,2012,26-09-2019 06:42:00,1,2883.0,2707.0,0.939,14.357,2,1,0,1,1,0,1,0,0.0,0.0
1001,2013,26-09-2019 06:44:00,1,2793.0,2659.0,0.952,13.948,20,15,9,6,5,1,4,0,0.0,0.0
1001,2014,26-09-2019 06:46:00,1,2685.0,2547.0,0.949,13.397,2,2,2,0,0,0,0,0,0.0,0.0
1001,2015,26-09-2019 06:48:00,1,2685.0,2539.0,0.946,13.389,5,5,0,5,0,0,0,0,0.0,0.0
1001,2016,26-09-2019 06:50:00,1,2698.0,2512.0,0.931,13.412,7,7,0,7,0,0,0,0,0.0,0.0
1001,2017,26-09-2019 06:52:00,1,2702.0,2495.0,0.923,13.408,0,0,0,0,0,0,0,0,0.0,0.0
1001,2018,26-09-2019 06:54:00,1,2705.0,2494.0,0.922,13.418,9,5,3,2,4,1,3,0,0.0,0.0
1001,2019,26-09-2019 06:56:00,1,2716.0,2476.0,0.912,13.441,2,0,0,0,2,0,2,0,0.0,0.0
1001,2020,26-09-2019 06:58:00,1,2704.0,2464.0,0.911,13.381,3,2,0,2,1,0,1,0,0.0,0.0
1001,2021,26-09-2019 07:00:00,1,2712.0,2470.0,0.911,13.418,3,2,1,1,1,0,1,0,0.0,0.0
1001,2022,26-09-2019 07:02:00,1,2723.0,2501.0,0.919,13.496,0,0,0,0,0,0,0,0,0.0,0.0
1001,2023,26-09-2019 07:04:00,1,2707.5,2513.5,0.929,13.449,29,21,7,14,8,0,8,0,0.0,0.0
1001,2024,26-09-2019 07:06:00,1,2692.0,2526.0,0.939,13.402,121,83,55,28,38,16,22,2,0.0,0.0
1001,2025,26-09-2019 07:08:00,1,2908.0,2682.0,0.922,14.428,270,156,116,40,114,74,40,54,0.0,0.0
1001,2026,26-09-2019 07:10:00,1,2889.0,2730.0,0.945,14.404,46,18,1,17,28,0,28,0,0.0,0.0
1001,2027,26-09-2019 07:12:00,1,3185.0,2930.0,0.92,15.792,67,35,6,29,32,2,30,4,0.0,0.0
1001,2028,26-09-2019 07:14:00,1,3153.0,2982.0,0.946,15.725,116,74,43,31,42,20,22,55,0.0,0.0
1001,2029,26-09-2019 07:16:00,1,3387.0,3047.0,0.9,16.716,53,48,13,35,5,1,4,39,0.0,0.01
1001,2030,26-09-2019 07:18:00,1,3384.0,3064.0,0.906,16.724,74,57,26,31,17,11,6,58,0.0,0.0
1001,2031,26-09-2019 07:20:00,1,3357.0,3186.0,0.949,16.755,79,50,23,27,29,17,12,56,0.0,0.13
1001,2032,26-09-2019 07:22:00,1,3543.0,3262.0,0.921,17.571,376,261,206,55,115,86,29,42,0.0,0.07
1001,2033,26-09-2019 07:24:00,1,3155.0,2992.0,0.948,15.744,436,308,239,69,128,87,41,26,0.0,0.0
1001,2034,26-09-2019 07:26:00,1,2899.0,2654.0,0.916,14.361,731,456,360,96,275,209,66,57,0.0,0.01
1001,2035,26-09-2019 07:28:00,1,3541.0,3291.0,0.929,17.595,346,217,162,55,129,88,41,11,0.09,0.04
1001,2036,26-09-2019 07:30:00,1,3704.0,3498.0,0.944,18.468,327,184,136,48,143,103,40,17,0.01,0.0
1001,2037,26-09-2019 07:32:00,1,3527.0,3422.0,0.97,17.684,33,24,3,21,9,3,6,1,0.01,0.0
1001,2038,26-09-2019 07:34:00,1,3707.0,3516.0,0.948,18.498,14,14,0,14,0,0,0,0,0.0,0.0
1001,2039,26-09-2019 07:36:00,1,3823.0,3538.0,0.925,18.981,3,3,0,3,0,0,0,0,0.0,0.0
1001,2040,26-09-2019 07:38:00,1,3685.5,3429.0,0.9305,18.317,0,0,0,0,0,0,0,0,0.0,0.0
1001,2041,26-09-2019 07:40:00,1,3548.0,3320.0,0.936,17.653,0,0,0,0,0,0,0,0,0.0,0.0
1001,2042,26-09-2019 07:42:00,1,3345.0,3222.0,0.963,16.748,3,2,0,2,1,1,0,0,0.0,0.0
1001,2043,26-09-2019 07:44:00,1,3357.0,3133.0,0.933,16.695,10,8,5,3,2,2,0,0,0.0,0.0
1001,2044,26-09-2019 07:46:00,1,3141.0,3010.0,0.958,15.708,4,3,2,1,1,0,1,0,0.0,0.0
1001,2045,26-09-2019 07:48:00,1,3164.0,3029.0,0.957,15.818,2,2,1,1,0,0,0,0,0.0,0.0
1001,2046,26-09-2019 07:50:00,1,3069.0,2889.0,0.941,15.291,3,3,1,2,0,0,0,0,0.0,0.0
1001,2047,26-09-2019 07:52:00,1,2875.0,2754.0,0.958,14.378,11,10,3,7,1,1,0,0,0.0,0.0
1001,2048,26-09-2019 07:54:00,1,2887.0,2707.0,0.938,14.374,0,0,0,0,0,0,0,0,0.01,0.0
1001,2049,26-09-2019 07:56:00,1,2672.0,2620.0,0.98,13.429,5,5,0,5,0,0,0,0,0.0,0.0
1001,2050,26-09-2019 07:58:00,1,2695.0,2590.0,0.961,13.485,14,14,0,14,0,0,0,0,0.0,0.0
1001,2051,26-09-2019 08:00:00,1,2699.0,2514.0,0.932,13.418,1,1,0,1,0,0,0,0,0.0,0.0
1001,2052,26-09-2019 08:02:00,1,2725.0,2484.0,0.912,13.486,6,4,0,4,2,1,1,0,0.0,0.0
1001,2053,26-09-2019 08:04:00,1,2717.0,2446.0,0.9,13.413,0,0,0,0,0,0,0,0,0.0,0.0
1001,2054,26-09-2019 08:06:00,1,2509.0,2413.0,0.962,12.555,0,0,0,0,0,0,0,0,0.0,0.0
1001,2055,26-09-2019 08:08:00,1,2515.0,2368.0,0.942,12.53,0,0,0,0,0,0,0,0,0.0,0.0
1001,2056,26-09-2019 08:10:00,1,2524.0,2329.0,0.923,12.523,0,0,0,0,0,0,0,0,0.0,0.0
1001,2057,26-09-2019 08:12:00,1,2508.5,2392.0,0.954,12.531,38,25,7,18,13,3,10,0,0.0,0.0
1001,2058,26-09-2019 08:14:00,1,2493.0,2455.0,0.985,12.539,20,14,4,10,6,1,5,0,0.0,0.0
1001,2059,26-09-2019 08:16:00,1,2695.0,2516.0,0.934,13.403,83,64,35,29,19,3,16,7,0.0,0.0
1001,2060,26-09-2019 08:18:00,1,2674.0,2624.0,0.981,13.44,8,6,3,3,2,1,1,0,0.0,0.0
1001,2061,26-09-2019 08:20:00,1,2674.0,2651.0,0.992,13.47,2,2,0,2,0,0,0,0,0.0,0.0
1001,2062,26-09-2019 08:22:00,1,2673.0,2603.0,0.974,13.414,1,0,0,0,1,1,0,0,0.0,0.0
1001,2063,26-09-2019 08:24:00,1,2707.0,2548.0,0.941,13.484,17,0,0,0,17,0,17,0,0.0,0.0
1001,2064,26-09-2019 08:26:00,1,2492.0,2484.0,0.997,12.569,3,0,0,0,3,0,3,0,0.0,0.0
1001,2065,26-09-2019 08:28:00,1,2495.0,2435.0,0.976,12.526,4,2,1,1,2,0,2,0,0.0,0.0
1001,2066,26-09-2019 08:30:00,1,2491.0,2462.0,0.988,12.54,3,3,0,3,0,0,0,0,0.0,0.0
1001,2067,26-09-2019 08:32:00,1,2594.0,2460.0,0.948,12.942,2,2,0,2,0,0,0,0,0.0,0.0
1001,2068,26-09-2019 08:34:00,1,2493.0,2440.0,0.979,12.525,2,2,0,2,0,0,0,0,0.0,0.0
1001,2069,26-09-2019 08:36:00,1,2495.0,2443.0,0.979,12.533,0,0,0,0,0,0,0,0,0.0,0.0
1001,2070,26-09-2019 08:38:00,1,2600.0,2439.0,0.938,12.945,29,16,10,6,13,9,4,0,0.0,0.0
1001,2071,26-09-2019 08:40:00,1,2499.0,2408.0,0.963,12.513,35,21,11,10,14,4,10,0,0.0,0.0
1001,2072,26-09-2019 08:42:00,1,2787.0,2659.0,0.954,13.923,13,0,0,0,13,1,12,0,0.0,0.0
1001,2073,26-09-2019 08:44:00,1,2787.0,2660.0,0.954,13.926,55,26,14,12,29,12,17,0,0.0,0.0
1001,2074,26-09-2019 08:46:00,1,2829.0,2697.5,0.9535,14.132,22,22,5,17,0,0,0,0,0.0,0.0
1001,2075,26-09-2019 08:48:00,1,2871.0,2735.0,0.953,14.338,36,19,3,16,17,0,17,0,0.0,0.0
1001,2076,26-09-2019 08:50:00,1,2967.0,2864.0,0.965,14.86,33,22,4,18,11,0,11,2,0.0,0.0
1001,2077,26-09-2019 08:52:00,1,3176.0,2926.0,0.921,15.751,10,8,0,8,2,1,1,0,0.0,0.0
1001,2078,26-09-2019 08:54:00,1,3163.0,2962.0,0.936,15.741,1,0,0,0,1,0,1,0,0.0,0.0
1001,2079,26-09-2019 08:56:00,1,2964.0,2835.0,0.956,14.816,0,0,0,0,0,0,0,0,0.0,0.0
1001,2080,26-09-2019 08:58:00,1,2880.0,2710.0,0.941,14.346,5,4,2,2,1,0,1,0,0.0,0.0
1001,2081,26-09-2019 09:00:00,1,2889.0,2665.0,0.922,14.332,0,0,0,0,0,0,0,0,0.0,0.0
1001,2082,26-09-2019 09:02:00,1,2688.0,2594.0,0.965,13.464,50,31,15,16,19,9,10,0,0.0,0.0
1001,2083,26-09-2019 09:04:00,1,2702.0,2567.0,0.95,13.487,3,2,0,2,1,0,1,0,0.0,0.0
1001,2084,26-09-2019 09:06:00,1,2715.0,2505.0,0.923,13.469,2,1,0,1,1,0,1,0,0.0,0.0
1001,2085,26-09-2019 09:08:00,1,2627.0,2408.0,0.917,13.017,0,0,0,0,0,0,0,0,0.0,0.0
1001,2086,26-09-2019 09:10:00,1,2529.0,2334.0,0.923,12.55,1,1,0,1,0,0,0,0,0.0,0.0
1001,2087,26-09-2019 09:12:00,1,2544.0,2294.0,0.902,12.565,0,0,0,0,0,0,0,0,0.0,0.0
1001,2088,26-09-2019 09:14:00,1,2538.0,2248.0,0.886,12.487,34,18,5,13,16,2,14,0,0.0,0.0
1001,2089,26-09-2019 09:16:00,1,2531.0,2276.0,0.899,12.491,369,188,145,43,181,132,49,11,0.0,0.0
1001,2090,26-09-2019 09:18:00,1,2720.0,2508.0,0.922,13.492,666,382,312,70,284,225,59,63,0.0,0.0
1001,2091,26-09-2019 09:20:00,1,2802.5,2617.0,0.9335,13.939,111,66,36,30,45,17,28,40,0.0,0.0
1001,2092,26-09-2019 09:22:00,1,2885.0,2726.0,0.945,14.386,76,46,7,39,30,0,30,35,0.0,0.02
1001,2093,26-09-2019 09:24:00,1,3178.0,2936.0,0.924,15.772,93,62,22,40,31,15,16,53,0.0,0.06
1001,2094,26-09-2019 09:26:00,1,3156.0,2988.0,0.947,15.743,346,237,173,64,109,80,29,37,0.0,0.01
1001,2095,26-09-2019 09:28:00,1,2700.0,2518.0,0.932,13.426,776,504,409,95,272,207,65,69,0.09,0.01
1001,2096,26-09-2019 09:30:00,1,2950.0,2865.0,0.971,14.794,242,108,62,46,134,85,49,17,0.01,0.06
1001,2097,26-09-2019 09:32:00,1,3179.0,2932.0,0.922,15.771,21,17,4,13,4,2,2,3,0.0,0.0
1001,2098,26-09-2019 09:34:00,1,3320.0,3226.0,0.972,16.65,403,270,194,76,133,94,39,23,0.0,0.0
1001,2099,26-09-2019 09:36:00,1,3529.0,3344.0,0.948,17.605,623,389,306,83,234,182,52,50,0.03,0.0
1001,2100,26-09-2019 09:38:00,1,3616.0,3482.0,0.963,18.102,687,428,345,83,259,207,52,38,0.2,0.0
1001,2101,26-09-2019 09:40:00,1,3493.0,3497.0,1.001,17.634,56,49,35,14,7,3,4,1,0.0,0.0
1001,2102,26-09-2019 09:42:00,1,3834.0,3567.0,0.93,19.056,0,0,0,0,0,0,0,0,0.0,0.0
1001,2103,26-09-2019 09:44:00,1,3723.0,3526.0,0.947,18.572,55,43,20,23,12,4,8,3,0.0,0.0
1001,2104,26-09-2019 09:46:00,1,3616.0,3490.0,0.965,18.112,16,16,1,15,0,0,0,0,0.01,0.0
1001,2105,26-09-2019 09:48:00,1,3612.0,3450.0,0.955,18.05,5,5,0,5,0,0,0,0,0.0,0.0
1001,2106,26-09-2019 09:50:00,1,3531.0,3392.0,0.961,17.666,55,30,12,18,25,2,23,2,0.0,0.0
1001,2107,26-09-2019 09:52:00,1,3522.0,3366.0,0.956,17.604,52,27,15,12,25,6,19,2,0.0,0.0
1001,2108,26-09-2019 09:54:00,1,3524.0,3348.5,0.9505,17.5915,41,26,9,17,15,2,13,1,0.0,0.0
1001,2109,26-09-2019 09:56:00,1,3526.0,3331.0,0.945,17.579,0,0,0,0,0,0,0,0,0.0,0.0
1001,2110,26-09-2019 09:58:00,1,3330.0,3213.0,0.965,16.676,0,0,0,0,0,0,0,0,0.0,0.0
1001,2111,26-09-2019 10:00:00,1,3255.0,3065.0,0.942,16.218,0,0,0,0,0,0,0,0,0.0,0.0
1001,2112,26-09-2019 10:02:00,1,3178.0,2901.0,0.913,15.734,0,0,0,0,0,0,0,0,0.0,0.0
1001,2113,26-09-2019 10:04:00,1,2859.0,2786.0,0.974,14.349,3,2,0,2,1,0,1,0,0.0,0.0
1001,2114,26-09-2019 10:06:00,1,2902.0,2678.0,0.923,14.398,0,0,0,0,0,0,0,0,0.0,0.0
1001,2115,26-09-2019 10:08:00,1,2678.0,2573.0,0.961,13.4,4,4,2,2,0,0,0,0,0.0,0.0
1001,2116,26-09-2019 10:10:00,1,2698.0,2497.0,0.926,13.397,13,7,1,6,6,2,4,0,0.0,0.0
1001,2117,26-09-2019 10:12:00,1,2703.0,2469.0,0.913,13.381,10,9,1,8,1,0,1,0,0.0,0.0
1001,2118,26-09-2019 10:14:00,1,2621.0,2420.0,0.923,13.007,1,0,0,0,1,0,1,0,0.0,0.0
1001,2119,26-09-2019 10:16:00,1,2512.0,2389.0,0.951,12.544,8,6,4,2,2,0,2,0,0.0,0.0
1001,2120,26-09-2019 10:18:00,1,2508.0,2367.0,0.944,12.503,5,5,1,4,0,0,0,0,0.0,0.0
1001,2121,26-09-2019 10:20:00,1,2515.0,2336.0,0.929,12.495,29,17,9,8,12,4,8,2,0.0,0.0
1001,2122,26-09-2019 10:22:00,1,2721.0,2454.0,0.902,13.436,2,0,0,0,2,0,2,0,0.0,0.0
1001,2123,26-09-2019 10:24:00,1,2625.0,2399.0,0.914,12.997,10,0,0,0,10,0,10,0,0.0,0.0
1001,2124,26-09-2019 10:26:00,1,2626.0,2359.0,0.898,12.958,16,6,3,3,10,0,10,0,0.0,0.0
1001,2125,26-09-2019 10:28:00,1,2584.0,2330.0,0.9015,12.7615,19,1,0,1,18,0,18,0,0.0,0.0
1001,2126,26-09-2019 10:30:00,1,2542.0,2301.0,0.905,12.565,9,1,0,1,8,0,8,0,0.0,0.0
1001,2127,26-09-2019 10:32:00,1,2538.0,2246.0,0.885,12.485,15,1,0,1,14,0,14,0,0.0,0.0
1001,2128,26-09-2019 10:34:00,1,2534.0,2257.0,0.891,12.483,1,1,0,1,0,0,0,0,0.0,0.0
1001,2129,26-09-2019 10:36:00,1,2546.0,2233.0,0.877,12.503,125,87,56,31,38,22,16,2,0.0,0.0
1001,2130,26-09-2019 10:38:00,1,2634.0,2357.0,0.895,12.988,32,28,9,19,4,0,4,0,0.01,0.0
1001,2131,26-09-2019 10:40:00,1,2728.0,2474.0,0.907,13.486,35,35,22,13,0,0,0,1,0.0,0.0
1001,2132,26-09-2019 10:42:00,1,2711.0,2528.0,0.933,13.479,0,0,0,0,0,0,0,0,0.0,0.0
1001,2133,26-09-2019 10:44:00,1,2736.0,2415.0,0.883,13.454,2,1,1,0,1,0,1,0,0.0,0.0
1001,2134,26-09-2019 10:46:00,1,2536.0,2313.0,0.912,12.55,2,2,0,2,0,0,0,0,0.0,0.0
1001,2135,26-09-2019 10:48:00,1,2526.0,2303.0,0.912,12.502,0,0,0,0,0,0,0,0,0.0,0.0
1001,2136,26-09-2019 10:50:00,1,2547.0,2254.0,0.885,12.529,42,27,15,12,15,9,6,2,0.0,0.0
1001,2137,26-09-2019 10:52:00,1,2560.0,2242.0,0.876,12.567,6,6,2,4,0,0,0,0,0.0,0.0
1001,2138,26-09-2019 10:54:00,1,2561.0,2191.0,0.856,12.516,0,0,0,0,0,0,0,0,0.0,0.0
1001,2139,26-09-2019 10:56:00,1,2561.0,2157.0,0.842,12.477,0,0,0,0,0,0,0,0,0.0,0.0
1001,2140,26-09-2019 10:58:00,1,2582.0,2129.0,0.825,12.53,17,16,11,5,1,1,0,0,0.0,0.0
1001,2141,26-09-2019 11:00:00,1,2364.0,2061.0,0.872,11.598,2,1,1,0,1,0,1,0,0.0,0.0
1001,2142,26-09-2019 11:02:00,1,2415.0,2080.0,0.8615,11.8195,4,4,1,3,0,0,0,0,0.0,0.0
1001,2143,26-09-2019 11:04:00,1,2466.0,2099.0,0.851,12.041,181,95,60,35,86,63,23,25,0.0,0.0
1001,2144,26-09-2019 11:06:00,1,2558.0,2175.0,0.85,12.486,160,69,44,25,91,48,43,50,0.01,0.0
1001,2145,26-09-2019 11:08:00,1,2916.0,2620.0,0.898,14.389,40,19,11,8,21,8,13,19,0.0,0.31
1001,2146,26-09-2019 11:10:00,1,2901.0,2605.0,0.898,14.313,1,1,1,0,0,0,0,0,0.0,0.0
1001,2147,26-09-2019 11:12:00,1,3101.0,2742.0,0.884,15.254,0,0,0,0,0,0,0,0,0.0,0.01
1001,2148,26-09-2019 11:14:00,1,3206.0,2858.0,0.891,15.798,252,200,166,34,52,33,19,4,0.0,0.01
1001,2149,26-09-2019 11:16:00,1,3280.0,2952.0,0.9,16.192,563,376,294,82,187,128,59,35,0.0,0.01
1001,2150,26-09-2019 11:18:00,1,3377.0,3015.0,0.893,16.643,538,335,262,73,203,145,58,25,0.0,0.0
1001,2151,26-09-2019 11:20:00,1,3371.0,3118.0,0.925,16.735,946,627,533,94,319,248,71,56,0.14,0.0
1001,2152,26-09-2019 11:22:00,1,3322.0,3196.0,0.962,16.628,145,130,98,32,15,7,8,0,0.0,0.0
1001,2153,26-09-2019 11:24:00,1,3452.0,3240.0,0.939,17.188,19,19,2,17,0,0,0,2,0.0,0.0
1001,2154,26-09-2019 11:26:00,1,3544.0,3333.0,0.941,17.651,25,25,0,25,0,0,0,1,0.0,0.0
1001,2155,26-09-2019 11:28:00,1,3525.0,3339.0,0.947,17.584,3,3,0,3,0,0,0,0,0.0,0.0
1001,2156,26-09-2019 11:30:00,1,3538.0,3330.0,0.941,17.626,12,11,2,9,1,1,0,1,0.0,0.0
1001,2157,26-09-2019 11:32:00,1,3536.0,3291.0,0.931,17.574,0,0,0,0,0,0,0,0,0.01,0.0
1001,2158,26-09-2019 11:34:00,1,3339.0,3222.0,0.965,16.724,1,1,0,1,0,0,0,0,0.0,0.0
1001,2159,26-09-2019 11:36:00,1,3254.5,3100.5,0.9525,16.2555,0,0,0,0,0,0,0,0,0.0,0.0
1001,2160,26-09-2019 11:38:00,1,3170.0,2979.0,0.94,15.787,0,0,0,0,0,0,0,0,0.0,0.0
1001,2161,26-09-2019 11:40:00,1,3073.0,2918.0,0.95,15.337,9,8,0,8,1,0,1,0,0.0,0.0
1001,2162,26-09-2019 11:42:00,1,2867.0,2836.0,0.989,14.437,1,1,0,1,0,0,0,0,0.0,0.0
1001,2163,26-09-2019 11:44:00,1,2865.0,2764.0,0.965,14.348,0,0,0,0,0,0,0,0,0.0,0.0
1001,2164,26-09-2019 11:46:00,1,2785.0,2706.0,0.972,13.97,0,0,0,0,0,0,0,0,0.0,0.0
1001,2165,26-09-2019 11:48:00,1,2676.0,2663.0,0.995,13.492,0,0,0,0,0,0,0,0,0.0,0.0
1001,2166,26-09-2019 11:50:00,1,2688.0,2609.0,0.97,13.48,0,0,0,0,0,0,0,0,0.0,0.0
1001,2167,26-09-2019 11:52:00,1,2689.0,2564.0,0.954,13.432,33,33,1,32,0,0,0,0,0.0,0.0
1001,2168,26-09-2019 11:54:00,1,2669.0,2655.0,0.995,13.455,8,8,3,5,0,0,0,0,0.0,0.0
1001,2169,26-09-2019 11:56:00,1,2670.0,2632.0,0.986,13.432,0,0,0,0,0,0,0,0,0.0,0.0
1001,2170,26-09-2019 11:58:00,1,2672.0,2639.0,0.987,13.45,4,4,0,4,0,0,0,0,0.0,0.0
1001,2171,26-09-2019 12:00:00,1,2674.0,2621.0,0.98,13.435,1,1,0,1,0,0,0,0,0.0,0.0
1001,2172,26-09-2019 12:02:00,1,2677.0,2632.0,0.983,13.462,16,16,2,14,0,0,0,0,0.0,0.0
1001,2173,26-09-2019 12:04:00,1,2685.0,2598.0,0.968,13.455,4,4,2,2,0,0,0,0,0.0,0.0
1001,2174,26-09-2019 12:06:00,1,2684.0,2624.0,0.977,13.481,1,1,1,0,0,0,0,0,0.0,0.0
1001,2175,26-09-2019 12:08:00,1,2683.0,2582.0,0.962,13.431,0,0,0,0,0,0,0,0,0.0,0.0
1001,2176,26-09-2019 12:10:00,1,2688.0,2585.0,0.9615,13.453,0,0,0,0,0,0,0,0,0.0,0.0
1001,2177,26-09-2019 12:12:00,1,2693.0,2588.0,0.961,13.475,11,11,5,6,0,0,0,0,0.0,0.0
1001,2178,26-09-2019 12:14:00,1,2679.0,2632.0,0.982,13.467,55,48,26,22,7,4,3,13,0.0,0.0
1001,2179,26-09-2019 12:16:00,1,2875.0,2770.0,0.964,14.395,369,248,195,53,121,86,35,54,0.0,0.02
1001,2180,26-09-2019 12:18:00,1,2837.0,2846.0,1.003,14.329,575,358,277,81,217,156,61,49,0.0,0.0
1001,2181,26-09-2019 12:20:00,1,3043.0,2988.0,0.982,15.297,409,271,223,48,138,91,47,20,0.0,0.0
1001,2182,26-09-2019 12:22:00,1,3157.0,3018.0,0.956,15.779,61,44,26,18,17,4,13,0,0.0,0.0
1001,2183,26-09-2019 12:24:00,1,3146.0,3050.0,0.97,15.771,41,38,5,33,3,0,3,0,0.0,0.0
1001,2184,26-09-2019 12:26:00,1,3152.0,3054.0,0.969,15.799,34,34,2,32,0,0,0,0,0.0,0.0
1001,2185,26-09-2019 12:28:00,1,3064.0,2949.0,0.962,15.337,12,12,1,11,0,0,0,0,0.01,0.0
1001,2186,26-09-2019 12:30:00,1,2848.0,2812.0,0.987,14.333,1,1,0,1,0,0,0,0,0.0,0.0
1001,2187,26-09-2019 12:32:00,1,2781.0,2678.0,0.963,13.919,0,0,0,0,0,0,0,0,0.0,0.0
1001,2188,26-09-2019 12:34:00,1,2682.0,2572.0,0.959,13.414,0,0,0,0,0,0,0,0,0.0,0.0
1001,2189,26-09-2019 12:36:00,1,2714.0,2490.0,0.917,13.45,4,4,0,4,0,0,0,0,0.0,0.0
1001,2190,26-09-2019 12:38:00,1,2619.0,2445.0,0.934,13.026,0,0,0,0,0,0,0,0,0.0,0.0
1001,2191,26-09-2019 12:40:00,1,2513.0,2384.0,0.949,12.539,0,0,0,0,0,0,0,0,0.0,0.0
1001,2192,26-09-2019 12:42:00,1,2525.0,2323.0,0.92,12.519,3,2,0,2,1,0,1,0,0.0,0.0
1001,2193,26-09-2019 12:44:00,1,2526.5,2309.0,0.914,12.51,2,2,0,2,0,0,0,0,0.0,0.0
1001,2194,26-09-2019 12:46:00,1,2528.0,2295.0,0.908,12.501,4,4,0,4,0,0,0,0,0.0,0.0
1001,2195,26-09-2019 12:48:00,1,2542.0,2253.0,0.886,12.511,1,1,0,1,0,0,0,0,0.0,0.0
1001,2196,26-09-2019 12:50:00,1,2540.0,2279.0,0.897,12.532,0,0,0,0,0,0,0,0,0.0,0.0
1001,2197,26-09-2019 12:52:00,1,2546.0,2265.0,0.889,12.54,0,0,0,0,0,0,0,0,0.0,0.0
1001,2198,26-09-2019 12:54:00,1,2536.0,2254.0,0.889,12.487,4,3,2,1,1,0,1,0,0.0,0.0
1001,2199,26-09-2019 12:56:00,1,2541.0,2253.0,0.887,12.505,0,0,0,0,0,0,0,0,0.0,0.0
1001,2200,26-09-2019 12:58:00,1,2549.0,2264.0,0.888,12.55,0,0,0,0,0,0,0,0,0.0,0.0
1001,2201,26-09-2019 13:00:00,1,2534.0,2279.0,0.899,12.507,1,1,1,0,0,0,0,0,0.0,0.0
1001,2202,26-09-2019 13:02:00,1,2552.0,2204.0,0.863,12.496,76,48,22,26,28,7,21,2,0.0,0.0
1001,2203,26-09-2019 13:04:00,1,2713.0,2463.0,0.908,13.415,71,46,16,30,25,4,21,1,0.0,0.0
1001,2204,26-09-2019 13:06:00,1,2679.0,2612.0,0.975,13.449,86,30,5,25,56,29,27,0,0.0,0.0
1001,2205,26-09-2019 13:08:00,1,2866.0,2770.0,0.966,14.36,329,238,192,46,91,54,37,54,0.0,0.0
1001,2206,26-09-2019 13:10:00,1,2869.0,2808.0,0.979,14.412,460,275,215,60,185,129,56,77,0.0,0.0
1001,2207,26-09-2019 13:12:00,1,3173.0,2966.0,0.935,15.786,238,183,137,46,55,28,27,62,0.0,0.0
1001,2208,26-09-2019 13:14:00,1,3194.0,2913.0,0.912,15.811,308,264,192,72,44,28,16,35,0.0,0.01
1001,2209,26-09-2019 13:16:00,1,2702.0,2563.0,0.949,13.482,473,353,269,84,120,66,54,55,0.0,0.0
1001,2210,26-09-2019 13:18:00,1,3025.0,2854.5,0.9445,15.077,517,393,310,83,124,85,39,35,0.0,0.01
1001,2211,26-09-2019 13:20:00,1,3348.0,3146.0,0.94,16.672,270,103,75,28,167,126,41,16,0.0,0.01
1001,2212,26-09-2019 13:22:00,1,3332.0,3230.0,0.969,16.702,39,34,4,30,5,0,5,0,0.0,0.0
1001,2213,26-09-2019 13:24:00,1,3339.0,3217.0,0.963,16.718,26,11,4,7,15,0,15,0,0.0,0.0
1001,2214,26-09-2019 13:26:00,1,3448.0,3256.0,0.944,17.191,36,22,1,21,14,0,14,0,0.0,0.0
1001,2215,26-09-2019 13:28:00,1,3337.0,3205.0,0.961,16.695,36,29,5,24,7,4,3,2,0.0,0.0
1001,2216,26-09-2019 13:30:00,1,3346.0,3168.0,0.947,16.69,3,3,1,2,0,0,0,0,0.0,0.0
1001,2217,26-09-2019 13:32:00,1,3372.0,3061.0,0.908,16.673,5,2,0,2,3,1,2,0,0.0,0.0
1001,2218,26-09-2019 13:34:00,1,3170.0,2940.0,0.927,15.743,13,13,0,13,0,0,0,0,0.0,0.0
1001,2219,26-09-2019 13:36:00,1,2859.0,2808.0,0.982,14.373,10,6,1,5,4,1,3,0,0.0,0.0
1001,2220,26-09-2019 13:38:00,1,2876.0,2717.0,0.945,14.339,3,3,1,2,0,0,0,0,0.0,0.0
1001,2221,26-09-2019 13:40:00,1,2893.0,2670.0,0.923,14.353,0,0,0,0,0,0,0,0,0.0,0.0
1001,2222,26-09-2019 13:42:00,1,2784.0,2617.0,0.94,13.865,1,1,1,0,0,0,0,0,0.0,0.0
1001,2223,26-09-2019 13:44:00,1,2798.0,2614.0,0.934,13.917,0,0,0,0,0,0,0,0,0.0,0.0
1001,2224,26-09-2019 13:46:00,1,2806.0,2618.0,0.933,13.954,0,0,0,0,0,0,0,0,0.0,0.0
1001,2225,26-09-2019 13:48:00,1,2699.0,2559.0,0.948,13.467,18,14,6,8,4,1,3,0,0.0,0.0
1001,2226,26-09-2019 13:50:00,1,2703.0,2536.0,0.938,13.457,50,47,18,29,3,0,3,8,0.0,0.0
1001,2227,26-09-2019 13:52:00,1,2787.0,2643.0,0.948,13.9065,23,23,6,17,0,0,0,0,0.0,0.0
1001,2228,26-09-2019 13:54:00,1,2871.0,2750.0,0.958,14.356,5,5,0,5,0,0,0,0,0.0,0.0
1001,2229,26-09-2019 13:56:00,1,2977.0,2777.0,0.933,14.802,5,1,0,1,4,0,4,0,0.0,0.0
1001,2230,26-09-2019 13:58:00,1,2975.0,2770.0,0.931,14.789,47,35,12,23,12,4,8,4,0.0,0.0
1001,2231,26-09-2019 14:00:00,1,3168.0,2921.0,0.922,15.717,47,30,13,17,17,1,16,1,0.0,0.0
1001,2232,26-09-2019 14:02:00,1,3177.0,2958.0,0.931,15.79,142,98,55,43,44,20,24,29,0.0,0.02
1001,2233,26-09-2019 14:04:00,1,3193.0,2895.0,0.906,15.786,223,117,82,35,106,75,31,57,0.0,0.07
1001,2234,26-09-2019 14:06:00,1,3093.0,2841.0,0.919,15.332,159,109,75,34,50,28,22,38,0.0,0.0
1001,2235,26-09-2019 14:08:00,1,3089.0,2837.0,0.919,15.31,346,269,199,70,77,40,37,4,0.0,0.0
1001,2236,26-09-2019 14:10:00,1,2884.0,2702.0,0.937,14.356,773,481,399,82,292,220,72,35,0.08,0.0
1001,2237,26-09-2019 14:12:00,1,3368.0,3098.0,0.92,16.699,178,135,101,34,43,19,24,3,0.01,0.0
1001,2238,26-09-2019 14:14:00,1,3281.0,3008.0,0.917,16.257,24,21,3,18,3,0,3,0,0.0,0.0
1001,2239,26-09-2019 14:16:00,1,3375.0,3067.0,0.909,16.695,27,22,1,21,5,0,5,0,0.0,0.0
1001,2240,26-09-2019 14:18:00,1,3364.0,3089.0,0.918,16.675,39,39,9,30,0,0,0,1,0.0,0.0
1001,2241,26-09-2019 14:20:00,1,3359.0,3103.0,0.924,16.671,0,0,0,0,0,0,0,0,0.0,0.0
1001,2242,26-09-2019 14:22:00,1,3276.0,2968.0,0.906,16.192,0,0,0,0,0,0,0,0,0.0,0.0
1001,2243,26-09-2019 14:24:00,1,3193.0,2841.0,0.89,15.724,9,9,4,5,0,0,0,0,0.0,0.0
1001,2244,26-09-2019 14:26:00,1,2994.5,2710.0,0.906,14.7975,0,0,0,0,0,0,0,0,0.0,0.0
1001,2245,26-09-2019 14:28:00,1,2796.0,2579.0,0.922,13.871,23,19,10,9,4,2,2,0,0.0,0.0
1001,2246,26-09-2019 14:30:00,1,2805.0,2586.0,0.922,13.916,2,2,0,2,0,0,0,0,0.0,0.0
1001,2247,26-09-2019 14:32:00,1,2713.0,2535.0,0.934,13.496,0,0,0,0,0,0,0,0,0.0,0.0
1001,2248,26-09-2019 14:34:00,1,2717.0,2490.0,0.917,13.461,12,12,0,12,0,0,0,0,0.0,0.0
1001,2249,26-09-2019 14:36:00,1,2719.0,2473.0,0.91,13.45,1,1,0,1,0,0,0,0,0.0,0.0
1001,2250,26-09-2019 14:38:00,1,2730.0,2434.0,0.891,13.452,16,16,0,16,0,0,0,0,0.0,0.0
1001,2251,26-09-2019 14:40:00,1,2741.0,2382.0,0.869,13.435,0,0,0,0,0,0,0,0,0.0,0.0
1001,2252,26-09-2019 14:42:00,1,2742.0,2378.0,0.868,13.435,0,0,0,0,0,0,0,0,0.0,0.0
1001,2253,26-09-2019 14:44:00,1,2745.0,2358.0,0.859,13.427,11,10,7,3,1,0,1,0,0.0,0.0
1001,2254,26-09-2019 14:46:00,1,2755.0,2356.0,0.855,13.463,5,5,3,2,0,0,0,0,0.0,0.0
1001,2255,26-09-2019 14:48:00,1,2746.0,2317.0,0.844,13.385,0,0,0,0,0,0,0,0,0.0,0.0
1001,2256,26-09-2019 14:50:00,1,2747.0,2330.0,0.848,13.404,24,0,0,0,24,0,24,0,0.0,0.0
1001,2257,26-09-2019 14:52:00,1,2748.0,2317.0,0.843,13.39,11,2,1,1,9,0,9,0,0.0,0.0
1001,2258,26-09-2019 14:54:00,1,2758.0,2302.0,0.835,13.414,0,0,0,0,0,0,0,0,0.02,0.0
1001,2259,26-09-2019 14:56:00,1,2758.0,2265.0,0.821,13.375,0,0,0,0,0,0,0,0,0.0,0.0
1001,2260,26-09-2019 14:58:00,1,2666.0,2242.0,0.841,12.986,0,0,0,0,0,0,0,0,0.0,0.0
1001,2261,26-09-2019 15:00:00,1,2665.0,2234.0,0.838,12.973,3,3,0,3,0,0,0,0,0.0,0.0
1001,2262,26-09-2019 15:02:00,1,2664.0,2226.0,0.835,12.96,3,3,0,3,0,0,0,0,0.0,0.0
1001,2263,26-09-2019 15:04:00,1,2656.0,2230.0,0.84,12.932,4,4,1,3,0,0,0,0,0.0,0.0
1001,2264,26-09-2019 15:06:00,1,2667.0,2219.0,0.832,12.966,28,23,7,16,5,0,5,0,0.0,0.0
1001,2265,26-09-2019 15:08:00,1,2771.0,2287.0,0.825,13.448,1,0,0,0,1,0,1,0,0.0,0.0
1001,2266,26-09-2019 15:10:00,1,2677.0,2212.0,0.826,12.995,56,52,24,28,4,0,4,3,0.0,0.0
1001,2267,26-09-2019 15:12:00,1,2664.0,2226.0,0.836,12.959,69,46,22,24,23,10,13,0,0.0,0.0
1001,2268,26-09-2019 15:14:00,1,2750.0,2388.0,0.868,13.476,180,139,93,46,41,15,26,25,0.0,0.0
1001,2269,26-09-2019 15:16:00,1,2731.0,2451.0,0.898,13.473,51,27,12,15,24,0,24,44,0.0,0.0
1001,2270,26-09-2019 15:18:00,1,2909.0,2577.0,0.886,14.315,85,60,31,29,25,8,17,60,0.0,0.0
1001,2271,26-09-2019 15:20:00,1,3223.0,2826.0,0.877,15.827,275,203,166,37,72,47,25,40,0.0,0.08
1001,2272,26-09-2019 15:22:00,1,2908.0,2605.0,0.896,14.342,701,388,322,66,313,241,72,40,0.0,0.0
1001,2273,26-09-2019 15:24:00,1,2888.0,2711.0,0.939,14.38,78,61,40,21,17,7,10,0,0.0,0.0
1001,2274,26-09-2019 15:26:00,1,2545.0,2215.0,0.871,12.478,5,5,3,2,0,0,0,0,0.0,0.01
1001,2275,26-09-2019 15:28:00,1,2729.0,2433.0,0.892,13.445,33,32,13,19,1,0,1,0,0.0,0.0
1001,2276,26-09-2019 15:30:00,1,3204.0,2855.0,0.891,15.785,5,5,0,5,0,0,0,0,0.0,0.0
1001,2277,26-09-2019 15:32:00,1,3383.0,3047.0,0.901,16.702,1,1,0,1,0,0,0,0,0.0,0.0
1001,2278,26-09-2019 15:34:00,1,3230.0,2947.5,0.913,15.989,1,1,0,1,0,0,0,0,0.0,0.01
1001,2279,26-09-2019 15:36:00,1,3077.0,2848.0,0.925,15.276,11,11,1,10,0,0,0,0,0.0,0.0
1001,2280,26-09-2019 15:38:00,1,2869.0,2746.0,0.957,14.344,1,1,0,1,0,0,0,0,0.0,0.0
1001,2281,26-09-2019 15:40:00,1,2855.0,2766.0,0.969,14.312,0,0,0,0,0,0,0,0,0.0,0.0
1001,2282,26-09-2019 15:42:00,1,2882.0,2736.0,0.949,14.382,20,20,1,19,0,0,0,0,0.0,0.0
1001,2283,26-09-2019 15:44:00,1,2888.0,2757.0,0.955,14.429,15,12,2,10,3,1,2,0,0.0,0.0
1001,2284,26-09-2019 15:46:00,1,2876.0,2683.0,0.933,14.302,4,4,3,1,0,0,0,1,0.0,0.0
1001,2285,26-09-2019 15:48:00,1,2875.0,2736.0,0.951,14.357,0,0,0,0,0,0,0,0,0.0,0.0
1001,2286,26-09-2019 15:50:00,1,2870.0,2749.0,0.958,14.353,10,10,6,4,0,0,0,0,0.0,0.0
1001,2287,26-09-2019 15:52:00,1,2879.0,2722.0,0.946,14.357,1,1,0,1,0,0,0,0,0.0,0.0
1001,2288,26-09-2019 15:54:00,1,2884.0,2685.0,0.931,14.337,0,0,0,0,0,0,0,0,0.0,0.0
1001,2289,26-09-2019 15:56:00,1,2886.0,2679.0,0.928,14.338,0,0,0,0,0,0,0,0,0.0,0.0
1001,2290,26-09-2019 15:58:00,1,2907.0,2649.0,0.911,14.385,7,7,1,6,0,0,0,0,0.0,0.0
1001,2291,26-09-2019 16:00:00,1,2689.0,2579.0,0.959,13.45,1,1,0,1,0,0,0,0,0.0,0.0
1001,2292,26-09-2019 16:02:00,1,2698.0,2573.0,0.954,13.479,4,4,1,3,0,0,0,0,0.0,0.0
1001,2293,26-09-2019 16:04:00,1,2713.0,2535.0,0.934,13.494,14,14,9,5,0,0,0,0,0.0,0.0
1001,2294,26-09-2019 16:06:00,1,2721.0,2503.0,0.92,13.49,0,0,0,0,0,0,0,0,0.0,0.0
1001,2295,26-09-2019 16:08:00,1,2719.0,2497.0,0.9185,13.4755,9,9,4,5,0,0,0,0,0.0,0.0
1001,2296,26-09-2019 16:10:00,1,2717.0,2491.0,0.917,13.461,16,16,3,13,0,0,0,0,0.0,0.0
1001,2297,26-09-2019 16:12:00,1,2701.0,2506.0,0.928,13.416,10,9,3,6,1,0,1,0,0.0,0.0
1001,2298,26-09-2019 16:14:00,1,2719.0,2492.0,0.917,13.472,27,26,18,8,1,0,1,1,0.0,0.0
1001,2299,26-09-2019 16:16:00,1,2706.0,2528.0,0.934,13.46,8,8,0,8,0,0,0,0,0.0,0.0
1001,2300,26-09-2019 16:18:00,1,2712.0,2482.0,0.915,13.434,0,0,0,0,0,0,0,0,0.0,0.0
1001,2301,26-09-2019 16:20:00,1,2709.0,2479.0,0.915,13.417,33,27,10,17,6,4,2,1,0.0,0.0
1001,2302,26-09-2019 16:22:00,1,2692.0,2536.0,0.942,13.413,57,55,20,35,2,1,1,2,0.0,0.0
1001,2303,26-09-2019 16:24:00,1,2888.0,2708.0,0.938,14.375,91,84,53,31,7,1,6,28,0.0,0.01
1001,2304,26-09-2019 16:26:00,1,2869.0,2823.0,0.984,14.428,56,30,17,13,26,1,25,57,0.0,0.0
1001,2305,26-09-2019 16:28:00,1,3085.0,2848.0,0.923,15.307,42,25,14,11,17,2,15,49,0.0,0.01
1001,2306,26-09-2019 16:30:00,1,3158.0,2974.0,0.942,15.734,43,24,6,18,19,3,16,52,0.0,0.06
1001,2307,26-09-2019 16:32:00,1,3155.0,2975.0,0.943,15.724,51,30,3,27,21,0,21,47,0.0,0.11
1001,2308,26-09-2019 16:34:00,1,3356.0,3186.0,0.949,16.751,398,309,247,62,89,63,26,22,0.0,0.0
1001,2309,26-09-2019 16:36:00,1,2781.0,2626.0,0.944,13.865,883,612,509,103,271,209,62,43,0.0,0.0
1001,2310,26-09-2019 16:38:00,1,3351.0,3162.0,0.943,16.705,362,259,212,47,103,78,25,39,0.06,0.04
1001,2311,26-09-2019 16:40:00,1,3160.0,3022.0,0.956,15.797,40,38,24,14,2,1,1,2,0.0,0.01
1001,2312,26-09-2019 16:42:00,1,3175.5,2943.5,0.927,15.77,23,23,6,17,0,0,0,3,0.0,0.0
1001,2313,26-09-2019 16:44:00,1,3191.0,2865.0,0.898,15.743,6,6,1,5,0,0,0,0,0.0,0.0
1001,2314,26-09-2019 16:46:00,1,3179.0,2922.0,0.919,15.759,4,4,0,4,0,0,0,0,0.0,0.0
1001,2315,26-09-2019 16:48:00,1,3380.0,3099.0,0.917,16.75,1,1,0,1,0,0,0,0,0.0,0.0
1001,2316,26-09-2019 16:50:00,1,3330.0,3193.0,0.959,16.653,3,3,0,3,0,0,0,0,0.01,0.0
1001,2317,26-09-2019 16:52:00,1,3319.0,3282.0,0.989,16.709,3,3,0,3,0,0,0,0,0.0,0.0
1001,2318,26-09-2019 16:54:00,1,3332.0,3243.0,0.973,16.718,3,3,0,3,0,0,0,0,0.0,0.0
1001,2319,26-09-2019 16:56:00,1,3237.0,3128.0,0.966,16.216,8,8,4,4,0,0,0,0,0.0,0.0
1001,2320,26-09-2019 16:58:00,1,3122.0,3121.0,1.0,15.755,6,6,1,5,0,0,0,0,0.0,0.0
1001,2321,26-09-2019 17:00:00,1,3152.0,3025.0,0.959,15.769,0,0,0,0,0,0,0,0,0.0,0.0
1001,2322,26-09-2019 17:02:00,1,3049.0,2991.0,0.981,15.324,1,1,0,1,0,0,0,0,0.0,0.0
1001,2323,26-09-2019 17:04:00,1,3143.0,3050.0,0.97,15.759,4,4,0,4,0,0,0,0,0.0,0.0
1001,2324,26-09-2019 17:06:00,1,3045.0,2975.0,0.977,15.289,2,2,0,2,0,0,0,0,0.02,0.0
1001,2325,26-09-2019 17:08:00,1,3043.0,2950.0,0.97,15.254,1,1,0,1,0,0,0,0,0.0,0.0
1001,2326,26-09-2019 17:10:00,1,2936.0,2954.0,1.006,14.837,3,3,0,3,0,0,0,0,0.0,0.0
1001,2327,26-09-2019 17:12:00,1,2825.0,2901.0,1.027,14.344,1,1,0,1,0,0,0,0,0.0,0.0
1001,2328,26-09-2019 17:14:00,1,2834.0,2894.0,1.021,14.37,19,19,7,12,0,0,0,0,0.0,0.0
1001,2329,26-09-2019 17:16:00,1,2852.0,2848.0,0.9985,14.3885,0,0,0,0,0,0,0,0,0.0,0.0
1001,2330,26-09-2019 17:18:00,1,2870.0,2802.0,0.976,14.407,4,4,2,2,0,0,0,0,0.0,0.0
1001,2331,26-09-2019 17:20:00,1,2892.0,2745.0,0.949,14.432,72,72,46,26,0,0,0,48,0.0,0.0
1001,2332,26-09-2019 17:22:00,1,3169.0,2992.0,0.944,15.798,22,22,12,10,0,0,0,54,0.0,0.0
1001,2333,26-09-2019 17:24:00,1,3365.0,3128.0,0.93,16.723,21,9,3,6,12,0,12,54,0.0,0.0
1001,2334,26-09-2019 17:26:00,1,3329.0,3174.0,0.953,16.631,193,118,85,33,75,52,23,47,0.0,0.11
1001,2335,26-09-2019 17:28:00,1,2878.0,2776.0,0.965,14.411,311,239,191,48,72,48,24,6,0.0,0.0
1001,2336,26-09-2019 17:30:00,1,2510.0,2362.0,0.941,12.504,53,51,18,33,2,1,1,6,0.0,0.0
1001,2337,26-09-2019 17:32:00,1,2624.0,2405.0,0.916,13.003,88,87,50,37,1,1,0,0,0.0,0.0
1001,2338,26-09-2019 17:34:00,1,2971.0,2820.0,0.949,14.827,33,33,11,22,0,0,0,0,0.0,0.0
1001,2339,26-09-2019 17:36:00,1,3248.0,3084.0,0.95,16.21,2,2,0,2,0,0,0,0,0.0,0.0
1001,2340,26-09-2019 17:38:00,1,3349.0,3192.0,0.953,16.728,0,0,0,0,0,0,0,0,0.0,0.0
1001,2341,26-09-2019 17:40:00,1,3307.0,3275.0,0.99,16.653,0,0,0,0,0,0,0,0,0.0,0.0
1001,2342,26-09-2019 17:42:00,1,3529.0,3380.0,0.958,17.645,0,0,0,0,0,0,0,0,0.0,0.0
1001,2343,26-09-2019 17:44:00,1,3308.0,3341.0,1.01,16.732,4,4,1,3,0,0,0,0,0.0,0.0
1001,2344,26-09-2019 17:46:00,1,3321.0,3250.0,0.979,16.682,1,1,0,1,0,0,0,0,0.0,0.0
1001,2345,26-09-2019 17:48:00,1,3337.0,3218.0,0.964,16.709,0,0,0,0,0,0,0,0,0.0,0.0
1001,2346,26-09-2019 17:50:00,1,3239.5,3156.0,0.9745,16.256,26,26,8,18,0,0,0,0,0.0,0.0
1001,2347,26-09-2019 17:52:00,1,3142.0,3094.0,0.985,15.803,41,36,19,17,5,2,3,0,0.0,0.0
1001,2348,26-09-2019 17:54:00,1,3317.0,3293.0,0.993,16.713,13,13,3,10,0,0,0,0,0.0,0.0
1001,2349,26-09-2019 17:56:00,1,3275.0,3393.0,1.036,16.66,16,15,6,9,1,1,0,0,0.0,0.01
1001,2350,26-09-2019 17:58:00,1,3477.0,3490.0,1.004,17.563,5,5,0,5,0,0,0,0,0.0,0.0
1001,2351,26-09-2019 18:00:00,0,3505.0,3472.0,0.99,17.653,42,42,19,23,0,0,0,3,0.0,0.01
1001,2352,26-09-2019 18:02:00,0,3484.0,3482.0,0.999,17.583,418,318,252,66,100,80,20,47,0.0,0.0
1001,2353,26-09-2019 18:04:00,0,3665.0,3678.0,1.003,18.512,391,302,253,49,89,61,28,55,0.0,0.0
1001,2354,26-09-2019 18:06:00,0,3763.0,3768.0,1.001,18.998,284,199,149,50,85,69,16,14,0.0,0.0
1001,2355,26-09-2019 18:08:00,0,3790.0,3691.0,0.974,19.017,71,70,39,31,1,1,0,4,0.0,0.0
1001,2356,26-09-2019 18:10:00,0,3779.0,3722.0,0.985,19.009,51,51,13,38,0,0,0,0,0.0,0.0
1001,2357,26-09-2019 18:12:00,0,3764.0,3766.0,1.0,19.0,215,194,151,43,21,18,3,13,0.0,0.0
1001,2358,26-09-2019 18:14:00,0,3976.0,3880.0,0.976,19.962,21,16,8,8,5,1,4,0,0.0,0.0
1001,2359,26-09-2019 18:16:00,0,3764.0,3776.0,1.003,19.011,4,3,2,1,1,0,1,0,0.0,0.0
1001,2360,26-09-2019 18:18:00,0,3820.0,3610.0,0.945,19.046,1,1,1,0,0,0,0,0,0.0,0.0
1001,2361,26-09-2019 18:20:00,0,3510.0,3463.0,0.987,17.664,6,5,0,5,1,0,1,0,0.0,0.0
1001,2362,26-09-2019 18:22:00,0,3533.0,3331.0,0.943,17.607,4,3,0,3,1,0,1,0,0.0,0.0
1001,2363,26-09-2019 18:24:00,0,3536.5,3329.0,0.9415,17.6195,270,212,169,43,58,48,10,19,0.0,0.0
1001,2364,26-09-2019 18:26:00,0,3540.0,3327.0,0.94,17.632,319,235,199,36,84,56,28,15,0.0,0.0
1001,2365,26-09-2019 18:28:00,0,3520.0,3358.0,0.954,17.585,46,45,14,31,1,0,1,11,0.0,0.0
1001,2366,26-09-2019 18:30:00,0,3720.0,3503.0,0.942,18.535,291,217,163,54,74,57,17,16,0.0,0.0
1001,2367,26-09-2019 18:32:00,0,3825.0,3582.0,0.936,19.037,249,152,117,35,97,67,30,30,0.0,0.0
1001,2368,26-09-2019 18:34:00,0,3814.0,3589.0,0.941,18.998,251,189,148,41,62,40,22,23,0.0,0.0
1001,2369,26-09-2019 18:36:00,0,3810.0,3604.0,0.946,19.002,306,227,187,40,79,53,26,16,0.0,0.0
1001,2370,26-09-2019 18:38:00,0,3821.0,3566.0,0.933,19.004,527,363,303,60,164,127,37,39,0.0,0.0
1001,2371,26-09-2019 18:40:00,0,3807.0,3588.0,0.943,18.971,324,194,157,37,130,97,33,26,0.0,0.0
1001,2372,26-09-2019 18:42:00,0,3823.0,3520.0,0.921,18.958,151,100,58,42,51,30,21,17,0.0,0.0
1001,2373,26-09-2019 18:44:00,0,3810.0,3553.0,0.932,18.944,338,212,178,34,126,97,29,21,0.0,0.0
1001,2374,26-09-2019 18:46:00,0,3854.0,3504.0,0.909,19.064,240,126,96,30,114,74,40,13,0.0,0.0
1001,2375,26-09-2019 18:48:00,0,3854.0,3449.0,0.895,19.002,72,40,17,23,32,2,30,9,0.0,0.0
1001,2376,26-09-2019 18:50:00,0,3860.0,3424.0,0.887,18.999,303,240,181,59,63,46,17,33,0.0,0.0
1001,2377,26-09-2019 18:52:00,0,3861.0,3459.0,0.896,19.04,507,381,303,78,126,81,45,40,0.0,0.0
1001,2378,26-09-2019 18:54:00,0,3840.0,3465.0,0.902,18.967,283,221,163,58,62,41,21,11,0.0,0.0
1001,2379,26-09-2019 18:56:00,0,3884.0,3315.0,0.853,18.974,113,86,59,27,27,7,20,11,0.0,0.0
1001,2380,26-09-2019 18:58:00,0,3886.0,3338.5,0.859,19.0075,93,38,16,22,55,16,39,2,0.0,0.0
1001,2381,26-09-2019 19:00:00,0,3888.0,3362.0,0.865,19.041,91,37,11,26,54,32,22,0,0.0,0.0
1001,2382,26-09-2019 19:02:00,0,3893.0,3319.0,0.853,19.015,124,39,7,32,85,41,44,7,0.0,0.0
1001,2383,26-09-2019 19:04:00,0,3875.0,3309.0,0.854,18.929,305,172,126,46,133,91,42,15,0.0,0.0
1001,2384,26-09-2019 19:06:00,0,3879.0,3281.0,0.846,18.917,127,90,74,16,37,20,17,19,0.0,0.0
1001,2385,26-09-2019 19:08:00,0,3804.0,3213.0,0.845,18.544,54,52,26,26,2,0,2,8,0.0,0.0
1001,2386,26-09-2019 19:10:00,0,3917.0,3232.0,0.825,19.01,182,123,75,48,59,42,17,12,0.0,0.0
1001,2387,26-09-2019 19:12:00,0,3815.0,3192.0,0.837,18.565,102,82,59,23,20,7,13,3,0.0,0.0
1001,2388,26-09-2019 19:14:00,0,3710.0,3113.0,0.839,18.065,11,11,4,7,0,0,0,0,0.01,0.0
1001,2389,26-09-2019 19:16:00,0,3631.0,2971.0,0.818,17.595,11,11,0,11,0,0,0,0,0.0,0.0
1001,2390,26-09-2019 19:18:00,0,3418.0,2827.0,0.827,16.597,16,10,7,3,6,3,3,0,0.0,0.0
1001,2391,26-09-2019 19:20:00,0,3232.0,2692.0,0.833,15.713,0,0,0,0,0,0,0,0,0.0,0.0
1001,2392,26-09-2019 19:22:00,0,3264.0,2578.0,0.79,15.715,5,5,2,3,0,0,0,0,0.0,0.0
1001,2393,26-09-2019 19:24:00,0,2952.0,2484.0,0.841,14.382,2,2,1,1,0,0,0,0,0.0,0.0
1001,2394,26-09-2019 19:26:00,0,2989.0,2357.0,0.789,14.386,9,5,4,1,4,2,2,0,0.0,0.0
1001,2395,26-09-2019 19:28:00,0,2775.0,2272.0,0.819,13.45,0,0,0,0,0,0,0,0,0.0,0.0
1001,2396,26-09-2019 19:30:00,0,2792.0,2197.0,0.787,13.433,0,0,0,0,0,0,0,0,0.0,0.0
1001,2397,26-09-2019 19:32:00,0,2684.5,2137.5,0.7965,12.9435,1,1,1,0,0,0,0,0,0.0,0.0
1001,2398,26-09-2019 19:34:00,0,2577.0,2078.0,0.806,12.454,6,6,2,4,0,0,0,0,0.0,0.0
1001,2399,26-09-2019 19:36:00,0,2587.0,2030.0,0.785,12.441,462,324,261,63,138,106,32,16,0.0,0.0
1001,2400,26-09-2019 19:38:00,0,2792.0,2200.0,0.788,13.435,407,280,222,58,127,95,32,42,0.0,0.0
1001,2401,26-09-2019 19:40:00,0,2987.0,2336.0,0.782,14.355,113,80,47,33,33,13,20,7,0.0,0.0
1001,2402,26-09-2019 19:42:00,0,2975.0,2391.0,0.804,14.371,207,129,86,43,78,60,18,8,0.0,0.0
1001,2403,26-09-2019 19:44:00,0,3180.0,2465.0,0.775,15.257,260,221,164,57,39,23,16,19,0.0,0.0
1001,2404,26-09-2019 19:46:00,0,3275.0,2523.0,0.77,15.697,67,65,33,32,2,0,2,11,0.0,0.0
1001,2405,26-09-2019 19:48:00,0,3379.0,2593.0,0.768,16.185,157,154,95,59,3,0,3,7,0.0,0.0
1001,2406,26-09-2019 19:50:00,0,3453.0,2771.0,0.802,16.671,322,280,207,73,42,22,20,29,0.0,0.0
1001,2407,26-09-2019 19:52:00,0,3671.0,2871.0,0.782,17.644,345,247,187,60,98,67,31,26,0.0,0.0
1001,2408,26-09-2019 19:54:00,0,3563.0,2781.0,0.781,17.115,263,191,140,51,72,44,28,31,0.0,0.0
1001,2409,26-09-2019 19:56:00,0,3467.0,2739.0,0.79,16.694,217,161,106,55,56,28,28,5,0.0,0.0
1001,2410,26-09-2019 19:58:00,0,3668.0,2819.0,0.769,17.571,127,68,32,36,59,29,30,0,0.0,0.0
1001,2411,26-09-2019 20:00:00,0,3655.0,2839.0,0.777,17.545,260,140,87,53,120,75,45,5,0.0,0.0
1001,2412,26-09-2019 20:02:00,0,3654.0,2865.0,0.784,17.569,183,96,47,49,87,43,44,1,0.0,0.0
1001,2413,26-09-2019 20:04:00,0,3659.0,2912.0,0.796,17.639,157,78,51,27,79,46,33,0,0.0,0.0
1001,2414,26-09-2019 20:06:00,0,3703.5,2939.0,0.7935,17.8455,254,118,91,27,136,86,50,5,0.13,0.0
1001,2415,26-09-2019 20:08:00,0,3748.0,2966.0,0.791,18.052,183,115,74,41,68,41,27,16,0.02,0.0
1001,2416,26-09-2019 20:10:00,0,3625.0,2922.0,0.806,17.516,90,43,14,29,47,18,29,0,0.0,0.0
1001,2417,26-09-2019 20:12:00,0,3624.0,2956.0,0.816,17.553,214,138,91,47,76,40,36,11,0.05,0.0
1001,2418,26-09-2019 20:14:00,0,3979.0,3060.0,0.769,19.065,140,44,27,17,96,47,49,1,0.0,0.0
1001,2419,26-09-2019 20:16:00,0,3641.0,2953.0,0.811,17.616,295,173,131,42,122,86,36,62,0.0,0.0
1001,2420,26-09-2019 20:18:00,0,3748.0,2999.0,0.8,18.086,255,138,97,41,117,76,41,27,0.0,0.0
1001,2421,26-09-2019 20:20:00,0,3647.0,2959.0,0.811,17.643,389,229,182,47,160,119,41,79,0.0,0.0
1001,2422,26-09-2019 20:22:00,0,3728.0,3071.0,0.824,18.087,514,360,301,59,154,118,36,119,0.0,0.0
1001,2423,26-09-2019 20:24:00,0,3931.0,3140.0,0.799,18.967,309,196,155,41,113,84,29,38,0.0,0.0
1001,2424,26-09-2019 20:26:00,0,3733.0,3046.0,0.816,18.082,131,70,45,25,61,40,21,11,0.0,0.0
1001,2425,26-09-2019 20:28:00,0,3854.0,3038.0,0.788,18.547,262,123,82,41,139,85,54,12,0.0,0.0
1001,2426,26-09-2019 20:30:00,0,3750.0,3013.0,0.803,18.113,337,248,189,59,89,60,29,72,0.0,0.0
1001,2427,26-09-2019 20:32:00,0,3840.0,3063.0,0.798,18.521,120,84,62,22,36,29,7,75,0.0,0.0
1001,2428,26-09-2019 20:34:00,0,3746.0,3003.0,0.802,18.082,10,8,2,6,2,0,2,2,0.0,0.0
1001,2429,26-09-2019 20:36:00,0,3739.0,2986.0,0.798,18.037,171,131,93,38,40,12,28,83,0.0,0.0
1001,2430,26-09-2019 20:38:00,0,3930.0,3176.0,0.808,19.001,177,80,51,29,97,60,37,19,0.0,0.0
1001,2431,26-09-2019 20:40:00,0,3784.5,3046.5,0.8045,18.285,93,39,13,26,54,21,33,1,0.0,0.0
1001,2432,26-09-2019 20:42:00,0,3639.0,2917.0,0.801,17.569,394,255,206,49,139,102,37,108,0.0,0.0
1001,2433,26-09-2019 20:44:00,0,3961.0,3090.0,0.78,19.029,328,265,188,77,63,44,19,63,0.0,0.0
1001,2434,26-09-2019 20:46:00,0,3944.0,3097.0,0.785,18.97,437,335,251,84,102,71,31,34,0.0,0.0
1001,2435,26-09-2019 20:48:00,0,4032.0,3175.0,0.787,19.401,535,441,350,91,94,67,27,99,0.0,0.0
1001,2436,26-09-2019 20:50:00,0,4039.0,3188.0,0.789,19.445,225,137,101,36,88,63,25,41,0.11,0.0
1001,2437,26-09-2019 20:52:00,0,3656.0,2844.0,0.778,17.553,240,175,123,52,65,45,20,30,0.0,0.0
1001,2438,26-09-2019 20:54:00,0,3963.0,3116.0,0.786,19.064,310,235,167,68,75,47,28,57,0.0,0.0
1001,2439,26-09-2019 20:56:00,0,3953.0,3109.0,0.787,19.016,165,69,48,21,96,55,41,2,0.0,0.0
1001,2440,26-09-2019 20:58:00,0,3946.0,3077.0,0.78,18.955,163,79,50,29,84,43,41,1,0.0,0.0
1001,2441,26-09-2019 21:00:00,0,3873.0,2937.0,0.758,18.51,171,83,46,37,88,42,46,0,0.06,0.0
1001,2442,26-09-2019 21:02:00,0,4054.0,3119.0,0.769,19.426,152,59,31,28,93,59,34,2,0.0,0.0
1001,2443,26-09-2019 21:04:00,0,3972.0,3001.0,0.756,18.973,204,146,99,47,58,32,26,3,0.03,0.0
1001,2444,26-09-2019 21:06:00,0,3651.0,2878.0,0.788,17.57,274,150,100,50,124,77,47,25,0.0,0.0
1001,2445,26-09-2019 21:08:00,0,3956.0,2999.0,0.758,18.907,363,243,192,51,120,80,40,85,0.0,0.0
1001,2446,26-09-2019 21:10:00,0,3939.0,3091.0,0.785,18.942,277,167,121,46,110,75,35,76,0.0,0.0
1001,2447,26-09-2019 21:12:00,0,3744.0,2943.0,0.786,18.008,64,42,19,23,22,13,9,7,0.0,0.0
1001,2448,26-09-2019 21:14:00,0,3860.5,2975.5,0.771,18.503,150,77,48,29,73,42,31,43,0.0,0.0
1001,2449,26-09-2019 21:16:00,0,3977.0,3008.0,0.756,18.998,398,233,188,45,165,120,45,110,0.01,0.0
1001,2450,26-09-2019 21:18:00,0,3873.0,2970.0,0.767,18.548,79,79,53,26,0,0,0,14,0.0,0.0
1001,2451,26-09-2019 21:20:00,0,3975.0,2975.0,0.748,18.956,324,194,151,43,130,88,42,59,0.0,0.0
1001,2452,26-09-2019 21:22:00,0,3862.0,2944.0,0.762,18.475,140,69,39,30,71,36,35,16,0.0,0.0
1001,2453,26-09-2019 21:24:00,0,3769.0,2912.0,0.773,18.073,96,54,27,27,42,8,34,2,0.0,0.0
1001,2454,26-09-2019 21:26:00,0,3645.0,2867.0,0.787,17.535,182,82,62,20,100,65,35,15,0.0,0.0
1001,2455,26-09-2019 21:28:00,0,3654.0,2912.0,0.797,17.622,279,164,121,43,115,67,48,6,0.1,0.0
1001,2456,26-09-2019 21:30:00,0,3648.0,2844.0,0.78,17.521,157,99,60,39,58,44,14,14,0.04,0.0
1001,2457,26-09-2019 21:32:00,0,3666.0,2893.0,0.789,17.646,214,145,95,50,69,37,32,88,0.0,0.0
1001,2458,26-09-2019 21:34:00,0,3979.0,2993.0,0.752,18.993,536,372,284,88,164,115,49,86,0.0,0.0
1001,2459,26-09-2019 21:36:00,0,3960.0,3026.0,0.764,18.952,524,355,268,87,169,116,53,59,0.0,0.0
1001,2460,26-09-2019 21:38:00,0,4048.0,3105.0,0.767,19.386,459,262,192,70,197,142,55,23,0.05,0.0
1001,2461,26-09-2019 21:40:00,0,3954.0,3093.0,0.782,19.002,450,308,227,81,142,97,45,45,0.01,0.0
1001,2462,26-09-2019 21:42:00,0,4045.0,3101.0,0.767,19.37,207,134,81,53,73,36,37,12,0.04,0.0
1001,2463,26-09-2019 21:44:00,0,3966.0,3010.0,0.759,18.959,140,65,29,36,75,30,45,0,0.01,0.0
1001,2464,26-09-2019 21:46:00,0,3970.0,3089.0,0.778,19.061,151,53,20,33,98,52,46,2,0.0,0.0
1001,2465,26-09-2019 21:48:00,0,3980.0,3038.0,0.7635,19.0455,169,66,33,33,103,63,40,1,0.08,0.0
1001,2466,26-09-2019 21:50:00,0,3990.0,2987.0,0.749,19.03,254,154,100,54,100,49,51,13,0.01,0.0
1001,2467,26-09-2019 21:52:00,0,3688.0,2741.0,0.743,17.567,174,100,50,50,74,40,34,2,0.0,0.0
1001,2468,26-09-2019 21:54:00,0,3666.0,2816.0,0.768,17.562,296,145,102,43,151,103,48,12,0.0,0.0
1001,2469,26-09-2019 21:56:00,0,3965.0,2976.0,0.75,18.918,225,103,64,39,122,90,32,31,0.0,0.0
1001,2470,26-09-2019 21:58:00,0,3869.0,2929.0,0.757,18.487,271,121,80,41,150,102,48,41,0.0,0.0
1001,2471,26-09-2019 22:00:00,0,3976.0,3007.0,0.756,18.996,288,181,130,51,107,68,39,73,0.0,0.0
1001,2472,26-09-2019 22:02:00,0,3993.0,2964.0,0.742,19.012,160,119,85,34,41,28,13,5,0.0,0.0
1001,2473,26-09-2019 22:04:00,0,3990.0,2955.0,0.741,18.992,137,82,42,40,55,34,21,4,0.0,0.0
1001,2474,26-09-2019 22:06:00,0,3998.0,2922.0,0.731,18.989,197,116,85,31,81,50,31,21,0.04,0.0
1001,2475,26-09-2019 22:08:00,0,3762.0,2881.0,0.766,18.012,384,225,172,53,159,109,50,89,0.0,0.0
1001,2476,26-09-2019 22:10:00,0,3989.0,2912.0,0.73,18.94,431,243,180,63,188,131,57,31,0.0,0.0
1001,2477,26-09-2019 22:12:00,0,3989.0,2887.0,0.724,18.915,181,71,43,28,110,69,41,6,0.05,0.0
1001,2478,26-09-2019 22:14:00,0,3972.0,2962.0,0.746,18.932,189,87,59,28,102,74,28,3,0.0,0.0
1001,2479,26-09-2019 22:16:00,0,3785.0,2854.0,0.754,18.073,178,101,64,37,77,50,27,34,0.02,0.0
1001,2480,26-09-2019 22:18:00,0,3772.0,2847.0,0.755,18.016,212,93,54,39,119,76,43,3,0.0,0.0
1001,2481,26-09-2019 22:20:00,0,3767.0,2853.0,0.757,18.001,522,275,218,57,247,182,65,65,0.1,0.0
1001,2482,26-09-2019 22:22:00,0,3876.5,2922.0,0.7535,18.508,553,319,243,76,234,171,63,58,0.0,0.0
1001,2483,26-09-2019 22:24:00,0,3986.0,2991.0,0.75,19.015,233,116,76,40,117,82,35,7,0.0,0.0
1001,2484,26-09-2019 22:26:00,0,3687.0,2783.0,0.755,17.61,119,67,24,43,52,26,26,0,0.0,0.0
1001,2485,26-09-2019 22:28:00,0,3656.0,2767.0,0.757,17.468,80,59,26,33,21,6,15,0,0.0,0.0
1001,2486,26-09-2019 22:30:00,0,3680.0,2786.0,0.757,17.582,164,71,35,36,93,46,47,28,0.0,0.0
1001,2487,26-09-2019 22:32:00,0,3986.0,2942.0,0.738,18.963,335,204,158,46,131,79,52,21,0.0,0.0
1001,2488,26-09-2019 22:34:00,0,3683.0,2802.0,0.761,17.615,203,140,99,41,63,43,20,26,0.0,0.0
1001,2489,26-09-2019 22:36:00,0,3782.0,2864.0,0.757,18.074,248,102,71,31,146,100,46,14,0.04,0.0
1001,2490,26-09-2019 22:38:00,0,3672.0,2786.0,0.759,17.553,70,44,23,21,26,8,18,1,0.0,0.0
1001,2491,26-09-2019 22:40:00,0,3794.0,2847.0,0.75,18.102,498,258,204,54,240,179,61,44,0.0,0.0
1001,2492,26-09-2019 22:42:00,0,3770.0,2872.0,0.762,18.034,233,147,111,36,86,64,22,133,0.0,0.0
1001,2493,26-09-2019 22:44:00,0,3676.0,2775.0,0.755,17.556,78,50,25,25,28,9,19,0,0.0,0.0
1001,2494,26-09-2019 22:46:00,0,3680.0,2749.0,0.747,17.544,80,37,15,22,43,20,23,0,0.0,0.0
1001,2495,26-09-2019 22:48:00,0,3679.0,2796.0,0.76,17.592,109,58,30,28,51,22,29,0,0.0,0.0
1001,2496,26-09-2019 22:50:00,0,3699.0,2757.0,0.745,17.627,113,73,39,34,40,14,26,0,0.0,0.0
1001,2497,26-09-2019 22:52:00,0,3695.0,2762.0,0.747,17.618,260,163,113,50,97,65,32,20,0.0,0.0
1001,2498,26-09-2019 22:54:00,0,3673.0,2790.0,0.76,17.563,511,219,161,58,292,218,74,28,0.04,0.0
1001,2499,26-09-2019 22:56:00,0,3683.0,2753.0,0.7475,17.561,268,125,79,46,143,98,45,7,0.0,0.0
1001,2500,26-09-2019 22:58:00,0,3693.0,2716.0,0.735,17.559,262,133,84,49,129,86,43,21,0.0,0.0
1001,2501,26-09-2019 23:00:00,0,3696.0,2729.0,0.738,17.585,217,149,104,45,68,38,30,26,0.0,0.0
1001,2502,26-09-2019 23:02:00,0,3705.0,2715.0,0.733,17.606,146,89,44,45,57,26,31,4,0.01,0.0
1001,2503,26-09-2019 23:04:00,0,3780.0,2845.0,0.753,18.043,403,205,160,45,198,153,45,52,0.1,0.0
1001,2504,26-09-2019 23:06:00,0,3686.0,2711.0,0.736,17.524,463,268,217,51,195,147,48,217,0.0,0.0
1001,2505,26-09-2019 23:08:00,0,3890.0,2866.0,0.737,18.501,323,204,164,40,119,96,23,154,0.0,0.0
1001,2506,26-09-2019 23:10:00,0,3683.0,2798.0,0.76,17.611,196,113,71,42,83,53,30,7,0.04,0.0
1001,2507,26-09-2019 23:12:00,0,3699.0,2721.0,0.736,17.586,92,69,37,32,23,16,7,2,0.0,0.0
1001,2508,26-09-2019 23:14:00,0,3702.0,2736.0,0.739,17.614,297,166,129,37,131,85,46,21,0.0,0.0
1001,2509,26-09-2019 23:16:00,0,3675.0,2794.0,0.76,17.574,129,71,51,20,58,38,20,7,0.0,0.0
1001,2510,26-09-2019 23:18:00,0,3692.0,2737.0,0.741,17.579,118,66,50,16,52,32,20,3,0.01,0.0
1001,2511,26-09-2019 23:20:00,0,3489.0,2622.0,0.752,16.65,328,154,113,41,174,119,55,54,0.0,0.0
1001,2512,26-09-2019 23:22:00,0,3975.0,2989.0,0.752,18.972,444,243,188,55,201,141,60,82,0.01,0.0
1001,2513,26-09-2019 23:24:00,0,3480.0,2639.0,0.758,16.634,87,31,11,20,56,30,26,24,0.01,0.0
1001,2514,26-09-2019 23:26:00,0,3785.0,2790.0,0.737,18.001,62,42,25,17,20,8,12,9,0.0,0.0
1001,2515,26-09-2019 23:28:00,0,3789.0,2820.0,0.744,18.051,46,39,12,27,7,2,5,6,0.0,0.0
1001,2516,26-09-2019 23:30:00,0,3739.5,2782.5,0.744,17.8145,83,43,27,16,40,8,32,5,0.0,0.0
1001,2517,26-09-2019 23:32:00,0,3690.0,2745.0,0.744,17.578,53,25,14,11,28,12,16,6,0.0,0.0
1001,2518,26-09-2019 23:34:00,0,3693.0,2699.0,0.731,17.541,343,163,120,43,180,139,41,46,0.0,0.0
1001,2519,26-09-2019 23:36:00,0,3602.0,2650.0,0.736,17.128,479,297,214,83,182,130,52,48,0.07,0.0
1001,2520,26-09-2019 23:38:00,0,3796.0,2797.0,0.737,18.055,396,185,126,59,211,163,48,25,0.0,0.0
1001,2521,26-09-2019 23:40:00,0,3693.0,2727.0,0.738,17.569,16,7,2,5,9,0,9,0,0.0,0.0
1001,2522,26-09-2019 23:42:00,0,3685.0,2738.0,0.743,17.549,28,17,12,5,11,6,5,0,0.0,0.0
1001,2523,26-09-2019 23:44:00,0,3689.0,2751.0,0.746,17.581,43,33,16,17,10,3,7,3,0.0,0.0
1001,2524,26-09-2019 23:46:00,0,3684.0,2740.0,0.744,17.55,67,37,21,16,30,9,21,5,0.0,0.0
1001,2525,26-09-2019 23:48:00,0,3699.0,2681.0,0.725,17.542,97,57,33,24,40,23,17,4,0.0,0.0
1001,2526,26-09-2019 23:50:00,0,3607.0,2643.0,0.733,17.138,32,28,10,18,4,1,3,0,0.0,0.0
1001,2527,26-09-2019 23:52:00,0,3506.0,2613.0,0.745,16.707,163,122,79,43,41,21,20,21,0.0,0.0
1001,2528,26-09-2019 23:54:00,0,3515.0,2563.0,0.729,16.686,299,165,125,40,134,88,46,41,0.07,0.0
1001,2529,26-09-2019 23:56:00,0,3506.0,2551.0,0.728,16.637,368,235,174,61,133,85,48,80,0.02,0.0
1001,2530,26-09-2019 23:58:00,0,3502.0,2588.0,0.739,16.665,461,281,210,71,180,131,49,23,0.0,0.0
1001,2531,27-09-2019 00:00:00,0,3692.0,2709.0,0.734,17.547,400,222,163,59,178,128,50,14,0.0,0.0
1001,2532,27-09-2019 00:02:00,0,3691.0,2754.0,0.746,17.592,484,278,197,81,206,156,50,29,0.01,0.0
1001,2533,27-09-2019 00:04:00,0,3704.0,2735.0,0.7385,17.623,341,184,138,46,157,108,49,13,0.0,0.0
1001,2534,27-09-2019 00:06:00,0,3717.0,2716.0,0.731,17.654,89,42,23,19,47,23,24,0,0.08,0.0
1001,2535,27-09-2019 00:08:00,0,3543.0,2469.0,0.697,16.695,62,38,4,34,24,3,21,0,0.01,0.0
1001,2536,27-09-2019 00:10:00,0,3516.0,2476.0,0.704,16.596,81,45,15,30,36,6,30,4,0.0,0.0
1001,2537,27-09-2019 00:12:00,0,3411.0,2456.0,0.72,16.158,103,73,47,26,30,16,14,13,0.01,0.0
1001,2538,27-09-2019 00:14:00,0,3710.0,2646.0,0.713,17.549,78,77,35,42,1,0,1,11,0.0,0.0
1001,2539,27-09-2019 00:16:00,0,3494.0,2621.0,0.75,16.667,20,20,3,17,0,0,0,0,0.0,0.0
1001,2540,27-09-2019 00:18:00,0,3516.0,2528.0,0.719,16.655,0,0,0,0,0,0,0,0,0.0,0.0
1001,2541,27-09-2019 00:20:00,0,3310.0,2390.0,0.722,15.688,0,0,0,0,0,0,0,0,0.0,0.0
1001,2542,27-09-2019 00:22:00,0,3113.0,2273.0,0.73,14.781,0,0,0,0,0,0,0,0,0.0,0.0
1001,2543,27-09-2019 00:24:00,0,3030.0,2164.0,0.714,14.336,0,0,0,0,0,0,0,0,0.0,0.0
1001,2544,27-09-2019 00:26:00,0,2808.0,2083.0,0.742,13.37,0,0,0,0,0,0,0,0,0.0,0.0
1001,2545,27-09-2019 00:28:00,0,2833.0,2005.0,0.708,13.383,16,15,10,5,1,0,1,1,0.0,0.0
1001,2546,27-09-2019 00:30:00,0,2738.0,1930.0,0.705,12.924,1,1,0,1,0,0,0,0,0.0,0.0
1001,2547,27-09-2019 00:32:00,0,2634.0,1882.0,0.715,12.464,0,0,0,0,0,0,0,0,0.0,0.0
1001,2548,27-09-2019 00:34:00,0,2663.0,1820.0,0.683,12.507,0,0,0,0,0,0,0,0,0.0,0.0
1001,2549,27-09-2019 00:36:00,0,2555.0,1763.0,0.69,12.021,0,0,0,0,0,0,0,0,0.0,0.0
1001,2550,27-09-2019 00:38:00,0,2451.0,1721.5,0.703,11.564,2,2,1,1,0,0,0,0,0.0,0.0
1001,2551,27-09-2019 00:40:00,0,2347.0,1680.0,0.716,11.107,4,4,0,4,0,0,0,0,0.0,0.0
1001,2552,27-09-2019 00:42:00,0,2366.0,1619.0,0.684,11.113,22,18,9,9,4,2,2,2,0.0,0.0
1001,2553,27-09-2019 00:44:00,0,2259.0,1582.0,0.701,10.651,201,108,76,32,93,61,32,3,0.0,0.0
1001,2554,27-09-2019 00:46:00,0,2551.0,1816.0,0.712,12.062,393,251,199,52,142,111,31,108,0.0,0.0
1001,2555,27-09-2019 00:48:00,0,2538.0,1822.0,0.718,12.019,122,87,55,32,35,19,16,42,0.0,0.0
1001,2556,27-09-2019 00:50:00,0,2736.0,1961.0,0.717,12.949,81,71,40,31,10,0,10,27,0.0,0.0
1001,2557,27-09-2019 00:52:00,0,2825.0,2060.0,0.729,13.412,71,39,20,19,32,18,14,3,0.0,0.0
1001,2558,27-09-2019 00:54:00,0,2916.0,2130.0,0.73,13.846,206,119,90,29,87,56,31,79,0.0,0.0
1001,2559,27-09-2019 00:56:00,0,3017.0,2208.0,0.732,14.33,192,87,60,27,105,72,33,63,0.0,0.0
1001,2560,27-09-2019 00:58:00,0,3339.0,2320.0,0.695,15.727,300,129,84,45,171,125,46,2,0.0,0.0
1001,2561,27-09-2019 01:00:00,0,3235.0,2303.0,0.712,15.297,170,97,62,35,73,41,32,8,0.0,0.0
1001,2562,27-09-2019 01:02:00,0,3230.0,2346.0,0.726,15.324,300,124,100,24,176,133,43,58,0.0,0.0
1001,2563,27-09-2019 01:04:00,0,3330.0,2358.0,0.708,15.733,253,147,102,45,106,75,31,53,0.0,0.0
1001,2564,27-09-2019 01:06:00,0,3320.0,2382.0,0.717,15.718,205,122,92,30,83,54,29,13,0.0,0.0
1001,2565,27-09-2019 01:08:00,0,3329.0,2371.0,0.712,15.744,21,11,6,5,10,0,10,0,0.0,0.0
1001,2566,27-09-2019 01:10:00,0,3313.0,2367.0,0.715,15.674,73,43,28,15,30,14,16,4,0.0,0.0
1001,2567,27-09-2019 01:12:00,0,3275.5,2339.0,0.7145,15.4955,204,101,61,40,103,58,45,8,0.0,0.0
1001,2568,27-09-2019 01:14:00,0,3238.0,2311.0,0.714,15.317,295,197,145,52,98,66,32,56,0.0,0.0
1001,2569,27-09-2019 01:16:00,0,3319.0,2429.0,0.732,15.767,74,49,28,21,25,19,6,7,0.0,0.0
1001,2570,27-09-2019 01:18:00,0,3318.0,2388.0,0.72,15.716,172,121,78,43,51,31,20,5,0.0,0.0
1001,2571,27-09-2019 01:20:00,0,3323.0,2386.0,0.718,15.736,235,119,86,33,116,75,41,23,0.0,0.0
1001,2572,27-09-2019 01:22:00,0,3308.0,2391.0,0.723,15.682,178,95,64,31,83,61,22,60,0.0,0.0
1001,2573,27-09-2019 01:24:00,0,3534.0,2442.0,0.691,16.63,265,213,153,60,52,30,22,29,0.09,0.0
1001,2574,27-09-2019 01:26:00,0,3512.0,2486.0,0.708,16.59,341,220,169,51,121,86,35,26,0.01,0.0
1001,2575,27-09-2019 01:28:00,0,3521.0,2474.0,0.703,16.613,35,23,6,17,12,4,8,0,0.0,0.0
1001,2576,27-09-2019 01:30:00,0,3520.0,2533.0,0.72,16.673,44,22,4,18,22,14,8,0,0.0,0.0
1001,2577,27-09-2019 01:32:00,0,3527.0,2519.0,0.714,16.687,30,13,2,11,17,8,9,0,0.0,0.0
1001,2578,27-09-2019 01:34:00,0,3424.0,2428.0,0.709,16.178,142,108,80,28,34,19,15,11,0.0,0.0
1001,2579,27-09-2019 01:36:00,0,3302.0,2421.0,0.733,15.691,39,33,17,16,6,2,4,0,0.0,0.0
1001,2580,27-09-2019 01:38:00,0,3331.0,2378.0,0.714,15.758,1,1,0,1,0,0,0,0,0.0,0.0
1001,2581,27-09-2019 01:40:00,0,3111.0,2261.0,0.727,14.762,0,0,0,0,0,0,0,0,0.0,0.0
1001,2582,27-09-2019 01:42:00,0,3040.0,2167.0,0.713,14.375,1,1,0,1,0,0,0,0,0.0,0.0
1001,2583,27-09-2019 01:44:00,0,2819.0,2065.0,0.733,13.392,0,0,0,0,0,0,0,0,0.0,0.0
1001,2584,27-09-2019 01:46:00,0,2737.0,1980.5,0.7235,12.9765,1,1,0,1,0,0,0,0,0.0,0.0
1001,2585,27-09-2019 01:48:00,0,2655.0,1896.0,0.714,12.561,3,3,0,3,0,0,0,0,0.0,0.0
1001,2586,27-09-2019 01:50:00,0,2648.0,1821.0,0.688,12.451,3,3,0,3,0,0,0,0,0.0,0.0
1001,2587,27-09-2019 01:52:00,0,2561.0,1763.0,0.688,12.044,0,0,0,0,0,0,0,0,0.0,0.0
1001,2588,27-09-2019 01:54:00,0,2332.0,1710.0,0.733,11.084,0,0,0,0,0,0,0,0,0.0,0.0
1001,2589,27-09-2019 01:56:00,0,2348.0,1666.0,0.71,11.094,0,0,0,0,0,0,0,0,0.0,0.0
1001,2590,27-09-2019 01:58:00,0,2353.0,1621.0,0.689,11.066,0,0,0,0,0,0,0,0,0.0,0.0
1001,2591,27-09-2019 02:00:00,0,2249.0,1583.0,0.704,10.615,0,0,0,0,0,0,0,0,0.0,0.0
1001,2592,27-09-2019 02:02:00,0,2145.0,1562.0,0.728,10.182,0,0,0,0,0,0,0,0,0.0,0.0
1001,2593,27-09-2019 02:04:00,0,2155.0,1534.0,0.712,10.19,1,1,0,1,0,0,0,0,0.0,0.0
1001,2594,27-09-2019 02:06:00,0,2153.0,1496.0,0.695,10.139,3,3,0,3,0,0,0,0,0.0,0.0
1001,2595,27-09-2019 02:08:00,0,2176.0,1478.0,0.679,10.212,241,169,128,41,72,44,28,41,0.0,0.0
1001,2596,27-09-2019 02:10:00,0,2129.0,1578.0,0.741,10.138,238,185,125,60,53,32,21,34,0.0,0.0
1001,2597,27-09-2019 02:12:00,0,2327.0,1727.0,0.742,11.081,111,48,20,28,63,31,32,27,0.0,0.0
1001,2598,27-09-2019 02:14:00,0,2438.0,1768.0,0.725,11.562,257,137,102,35,120,83,37,19,0.0,0.0
1001,2599,27-09-2019 02:16:00,0,2657.0,1823.0,0.686,12.489,105,67,41,26,38,19,19,29,0.0,0.0
1001,2600,27-09-2019 02:18:00,0,2648.0,1871.0,0.707,12.504,79,43,24,19,36,12,24,23,0.0,0.0
1001,2601,27-09-2019 02:20:00,0,2741.5,1955.0,0.713,12.9665,304,224,171,53,80,48,32,23,0.0,0.0
1001,2602,27-09-2019 02:22:00,0,2835.0,2039.0,0.719,13.429,272,176,138,38,96,69,27,83,0.05,0.0
1001,2603,27-09-2019 02:24:00,0,2838.0,2045.0,0.721,13.446,156,101,66,35,55,33,22,39,0.07,0.0
1001,2604,27-09-2019 02:26:00,0,2822.0,2081.0,0.737,13.423,101,44,14,30,57,30,27,12,0.0,0.0
1001,2605,27-09-2019 02:28:00,0,2822.0,2056.0,0.728,13.396,35,29,1,28,6,2,4,12,0.0,0.0
1001,2606,27-09-2019 02:30:00,0,2829.0,2072.0,0.733,13.44,260,159,116,43,101,70,31,48,0.0,0.0
1001,2607,27-09-2019 02:32:00,0,2817.0,2080.0,0.738,13.404,135,76,53,23,59,39,20,22,0.01,0.0
1001,2608,27-09-2019 02:34:00,0,3039.0,2144.0,0.706,14.349,73,44,25,19,29,3,26,8,0.0,0.0
1001,2609,27-09-2019 02:36:00,0,3033.0,2117.0,0.698,14.295,76,48,24,24,28,5,23,6,0.0,0.0
1001,2610,27-09-2019 02:38:00,0,3034.0,2120.0,0.699,14.301,128,67,27,40,61,29,32,3,0.07,0.0
1001,2611,27-09-2019 02:40:00,0,3323.0,2343.0,0.705,15.687,316,184,147,37,132,103,29,53,0.03,0.0
1001,2612,27-09-2019 02:42:00,0,2816.0,2103.0,0.747,13.425,216,150,112,38,66,46,20,0,0.01,0.0
1001,2613,27-09-2019 02:44:00,0,3047.0,2120.0,0.696,14.354,41,34,7,27,7,0,7,0,0.0,0.0
1001,2614,27-09-2019 02:46:00,0,3049.0,2118.0,0.695,14.359,10,0,0,0,10,0,10,0,0.0,0.0
1001,2615,27-09-2019 02:48:00,0,2834.0,2029.0,0.716,13.414,1,0,0,0,1,0,1,0,0.0,0.0
1001,2616,27-09-2019 02:50:00,0,2860.0,1937.0,0.677,13.415,15,2,0,2,13,0,13,0,0.0,0.0
1001,2617,27-09-2019 02:52:00,0,2646.0,1841.0,0.696,12.464,4,2,0,2,2,0,2,0,0.0,0.0
1001,2618,27-09-2019 02:54:00,0,2600.5,1792.0,0.689,12.2305,5,4,2,2,1,0,1,0,0.0,0.0
1001,2619,27-09-2019 02:56:00,0,2555.0,1743.0,0.682,11.997,0,0,0,0,0,0,0,0,0.0,0.0
1001,2620,27-09-2019 02:58:00,0,2339.0,1699.0,0.726,11.097,35,22,5,17,13,2,11,0,0.0,0.0
1001,2621,27-09-2019 03:00:00,0,2332.0,1704.0,0.731,11.074,108,89,46,43,19,3,16,6,0.0,0.0
1001,2622,27-09-2019 03:02:00,0,2555.0,1788.0,0.7,12.049,413,295,237,58,118,86,32,16,0.0,0.0
1001,2623,27-09-2019 03:04:00,0,2653.0,1833.0,0.691,12.482,571,331,256,75,240,177,63,39,0.0,0.0
1001,2624,27-09-2019 03:06:00,0,2827.0,2084.0,0.737,13.448,309,179,132,47,130,85,45,111,0.0,0.0
1001,2625,27-09-2019 03:08:00,0,2936.0,2113.0,0.72,13.91,269,154,117,37,115,85,30,57,0.14,0.0
1001,2626,27-09-2019 03:10:00,0,2633.0,1878.0,0.713,12.455,2,2,1,1,0,0,0,0,0.0,0.0
1001,2627,27-09-2019 03:12:00,0,2651.0,1837.0,0.693,12.478,1,1,0,1,0,0,0,0,0.0,0.0
1001,2628,27-09-2019 03:14:00,0,2660.0,1772.0,0.666,12.441,0,0,0,0,0,0,0,0,0.0,0.0
1001,2629,27-09-2019 03:16:00,0,2447.0,1711.0,0.699,11.536,11,11,0,11,0,0,0,0,0.0,0.0
1001,2630,27-09-2019 03:18:00,0,2349.0,1664.0,0.708,11.098,0,0,0,0,0,0,0,0,0.0,0.0
1001,2631,27-09-2019 03:20:00,0,2358.0,1624.0,0.689,11.091,0,0,0,0,0,0,0,0,0.0,0.0
1001,2632,27-09-2019 03:22:00,0,2252.0,1572.0,0.698,10.613,0,0,0,0,0,0,0,0,0.0,0.0
1001,2633,27-09-2019 03:24:00,0,2158.0,1529.0,0.708,10.196,2,2,1,1,0,0,0,0,0.0,0.0
1001,2634,27-09-2019 03:26:00,0,2166.0,1478.0,0.682,10.173,0,0,0,0,0,0,0,0,0.0,0.0
1001,2635,27-09-2019 03:28:00,0,2173.5,1445.5,0.665,10.1665,0,0,0,0,0,0,0,0,0.0,0.0
1001,2636,27-09-2019 03:30:00,0,2181.0,1413.0,0.648,10.16,2,2,0,2,0,0,0,0,0.0,0.0
1001,2637,27-09-2019 03:32:00,0,2075.0,1381.0,0.665,9.707,1,1,0,1,0,0,0,0,0.0,0.0
1001,2638,27-09-2019 03:34:00,0,1968.0,1361.0,0.692,9.26,1,1,0,1,0,0,0,0,0.01,0.0
1001,2639,27-09-2019 03:36:00,0,1856.0,1336.0,0.72,8.793,2,2,0,2,0,0,0,0,0.0,0.0
1001,2640,27-09-2019 03:38:00,0,1859.0,1323.0,0.712,8.788,0,0,0,0,0,0,0,0,0.0,0.0
1001,2641,27-09-2019 03:40:00,0,1865.0,1295.0,0.694,8.784,0,0,0,0,0,0,0,0,0.0,0.0
1001,2642,27-09-2019 03:42:00,0,1865.0,1284.0,0.688,8.772,1,1,0,1,0,0,0,0,0.0,0.0
1001,2643,27-09-2019 03:44:00,0,1873.0,1257.0,0.671,8.772,105,60,35,25,45,26,19,16,0.0,0.0
1001,2644,27-09-2019 03:46:00,0,2177.0,1429.0,0.657,10.159,303,187,155,32,116,87,29,68,0.0,0.0
1001,2645,27-09-2019 03:48:00,0,2159.0,1520.0,0.704,10.192,116,96,57,39,20,9,11,7,0.0,0.0
1001,2646,27-09-2019 03:50:00,0,2136.0,1565.0,0.733,10.149,19,7,4,3,12,0,12,0,0.0,0.0
1001,2647,27-09-2019 03:52:00,0,2357.0,1612.0,0.684,11.074,71,60,32,28,11,0,11,4,0.0,0.0
1001,2648,27-09-2019 03:54:00,0,2345.0,1708.0,0.728,11.132,69,56,23,33,13,0,13,2,0.0,0.0
1001,2649,27-09-2019 03:56:00,0,2655.0,1810.0,0.682,12.466,62,54,32,22,8,0,8,1,0.0,0.0
1001,2650,27-09-2019 03:58:00,0,2661.0,1831.0,0.688,12.511,6,3,2,1,3,0,3,0,0.0,0.0
1001,2651,27-09-2019 04:00:00,0,2642.0,1854.0,0.702,12.463,35,14,5,9,21,1,20,0,0.0,0.0
1001,2652,27-09-2019 04:02:00,0,2746.5,1897.5,0.6915,12.9225,351,184,137,47,167,122,45,31,0.0,0.0
1001,2653,27-09-2019 04:04:00,0,2851.0,1941.0,0.681,13.382,261,146,120,26,115,88,27,94,0.0,0.0
1001,2654,27-09-2019 04:06:00,0,2750.0,1917.0,0.697,12.957,0,0,0,0,0,0,0,11,0.0,0.0
1001,2655,27-09-2019 04:08:00,0,2640.0,1873.0,0.709,12.476,0,0,0,0,0,0,0,9,0.0,0.0
1001,2656,27-09-2019 04:10:00,0,2648.0,1820.0,0.687,12.45,0,0,0,0,0,0,0,0,0.0,0.0
1001,2657,27-09-2019 04:12:00,0,2676.0,1767.0,0.66,12.502,1,1,0,1,0,0,0,0,0.0,0.0
1001,2658,27-09-2019 04:14:00,0,2450.0,1707.0,0.697,11.542,1,1,0,1,0,0,0,0,0.0,0.0
1001,2659,27-09-2019 04:16:00,0,2347.0,1647.0,0.702,11.073,6,6,0,6,0,0,0,0,0.0,0.0
1001,2660,27-09-2019 04:18:00,0,2368.0,1606.0,0.678,11.109,10,10,0,10,0,0,0,0,0.0,0.0
1001,2661,27-09-2019 04:20:00,0,2255.0,1559.0,0.691,10.609,22,22,0,22,0,0,0,0,0.0,0.0
1001,2662,27-09-2019 04:22:00,0,2159.0,1523.0,0.705,10.195,20,10,2,8,10,7,3,0,0.0,0.0
1001,2663,27-09-2019 04:24:00,0,2173.0,1486.0,0.684,10.206,4,3,1,2,1,0,1,0,0.0,0.0
1001,2664,27-09-2019 04:26:00,0,2178.0,1461.0,0.671,10.201,10,10,2,8,0,0,0,0,0.01,0.0
1001,2665,27-09-2019 04:28:00,0,2174.0,1431.0,0.658,10.151,1,0,0,0,1,0,1,0,0.0,0.0
1001,2666,27-09-2019 04:30:00,0,2070.0,1425.0,0.688,9.736,2,1,0,1,1,0,1,0,0.0,0.0
1001,2667,27-09-2019 04:32:00,0,2068.0,1409.0,0.681,9.709,4,3,0,3,1,0,1,0,0.0,0.0
1001,2668,27-09-2019 04:34:00,0,1960.0,1377.0,0.702,9.249,2,2,1,1,0,0,0,0,0.0,0.0
1001,2669,27-09-2019 04:36:00,0,1908.5,1359.0,0.712,9.026,5,5,0,5,0,0,0,0,0.0,0.0
1001,2670,27-09-2019 04:38:00,0,1857.0,1341.0,0.722,8.803,10,1,0,1,9,0,9,0,0.0,0.0
1001,2671,27-09-2019 04:40:00,0,1851.0,1345.0,0.726,8.781,2,0,0,0,2,0,2,0,0.0,0.0
1001,2672,27-09-2019 04:42:00,0,1849.0,1337.0,0.723,8.766,78,66,40,26,12,6,6,18,0.0,0.0
1001,2673,27-09-2019 04:44:00,0,2176.0,1450.0,0.667,10.18,128,78,60,18,50,32,18,21,0.0,0.0
1001,2674,27-09-2019 04:46:00,0,2368.0,1612.0,0.681,11.117,200,120,82,38,80,53,27,27,0.0,0.0
1001,2675,27-09-2019 04:48:00,0,2356.0,1641.0,0.697,11.1,87,64,30,34,23,7,16,0,0.0,0.0
1001,2676,27-09-2019 04:50:00,0,2653.0,1847.0,0.696,12.498,170,101,63,38,69,41,28,17,0.0,0.0
1001,2677,27-09-2019 04:52:00,0,2533.0,1800.0,0.711,11.971,230,137,99,38,93,62,31,54,0.0,0.0
1001,2678,27-09-2019 04:54:00,0,2655.0,1848.0,0.696,12.507,97,27,11,16,70,54,16,0,0.0,0.0
1001,2679,27-09-2019 04:56:00,0,2741.0,1903.0,0.694,12.909,202,132,91,41,70,50,20,16,0.0,0.0
1001,2680,27-09-2019 04:58:00,0,2859.0,1967.0,0.688,13.443,345,234,183,51,111,67,44,16,0.0,0.0
1001,2681,27-09-2019 05:00:00,0,2861.0,1940.0,0.678,13.422,347,184,140,44,163,126,37,152,0.08,0.0
1001,2682,27-09-2019 05:02:00,0,2847.0,1992.0,0.7,13.422,257,135,104,31,122,91,31,9,0.01,0.0
1001,2683,27-09-2019 05:04:00,0,2847.0,1978.0,0.695,13.407,2,0,0,0,2,0,2,0,0.0,0.0
1001,2684,27-09-2019 05:06:00,0,2853.0,1969.0,0.69,13.42,3,0,0,0,3,0,3,0,0.0,0.0
1001,2685,27-09-2019 05:08:00,0,2641.0,1882.0,0.713,12.49,1,0,0,0,1,0,1,0,0.0,0.0
1001,2686,27-09-2019 05:10:00,0,2658.0,1806.5,0.68,12.473,0,0,0,0,0,0,0,0,0.0,0.0
1001,2687,27-09-2019 05:12:00,0,2675.0,1731.0,0.647,12.456,0,0,0,0,0,0,0,0,0.0,0.0
1001,2688,27-09-2019 05:14:00,0,2346.0,1699.0,0.724,11.126,1,0,0,0,1,0,1,0,0.0,0.0
1001,2689,27-09-2019 05:16:00,0,2348.0,1649.0,0.702,11.075,0,0,0,0,0,0,0,0,0.0,0.0
1001,2690,27-09-2019 05:18:00,0,2377.0,1598.0,0.672,11.137,0,0,0,0,0,0,0,0,0.0,0.0
1001,2691,27-09-2019 05:20:00,0,2143.0,1534.0,0.716,10.143,0,0,0,0,0,0,0,0,0.0,0.0
1001,2692,27-09-2019 05:22:00,0,2166.0,1501.0,0.693,10.197,2,1,1,0,1,0,1,0,0.0,0.0
1001,2693,27-09-2019 05:24:00,0,2172.0,1474.0,0.678,10.189,0,0,0,0,0,0,0,0,0.0,0.0
1001,2694,27-09-2019 05:26:00,0,2173.0,1437.0,0.661,10.154,0,0,0,0,0,0,0,0,0.0,0.0
1001,2695,27-09-2019 05:28:00,0,2175.0,1404.0,0.646,10.126,0,0,0,0,0,0,0,0,0.0,0.0
1001,2696,27-09-2019 05:30:00,0,2070.0,1402.0,0.677,9.707,0,0,0,0,0,0,0,0,0.0,0.0
1001,2697,27-09-2019 05:32:00,0,2068.0,1396.0,0.675,9.695,0,0,0,0,0,0,0,0,0.0,0.0
1001,2698,27-09-2019 05:34:00,0,1966.0,1356.0,0.69,9.248,12,11,3,8,1,0,1,0,0.0,0.0
1001,2699,27-09-2019 05:36:00,0,2183.0,1430.0,0.655,10.187,284,201,163,38,83,54,29,43,0.0,0.0
1001,2700,27-09-2019 05:38:00,0,2428.0,1796.0,0.74,11.555,263,169,126,43,94,62,32,41,0.0,0.0
1001,2701,27-09-2019 05:40:00,0,2358.0,1634.0,0.693,11.1,15,6,4,2,9,8,1,1,0.0,0.0
1001,2702,27-09-2019 05:42:00,0,2347.0,1699.0,0.724,11.131,21,17,6,11,4,4,0,0,0.0,0.0
1001,2703,27-09-2019 05:44:00,0,2452.5,1738.5,0.7095,11.5885,233,133,97,36,100,75,25,60,0.06,0.0
1001,2704,27-09-2019 05:46:00,0,2558.0,1778.0,0.695,12.046,46,20,11,9,26,8,18,1,0.0,0.0
1001,2705,27-09-2019 05:48:00,0,2658.0,1811.0,0.681,12.479,13,4,2,2,9,0,9,0,0.01,0.0
1001,2706,27-09-2019 05:50:00,0,2648.0,1828.0,0.691,12.457,15,2,1,1,13,0,13,0,0.01,0.0
1001,2707,27-09-2019 05:52:00,0,2668.0,1804.0,0.676,12.51,3,1,0,1,2,0,2,0,0.0,0.0
1001,2708,27-09-2019 05:54:00,0,2553.0,1749.0,0.685,11.997,1,0,0,0,1,0,1,0,0.0,0.0
1001,2709,27-09-2019 05:56:00,0,2337.0,1686.0,0.721,11.075,4,0,0,0,4,0,4,0,0.0,0.0
1001,2710,27-09-2019 05:58:00,0,2356.0,1630.0,0.692,11.086,6,1,1,0,5,0,5,0,0.0,0.0
1001,2711,27-09-2019 06:00:00,1,2250.0,1585.0,0.704,10.618,0,0,0,0,0,0,0,0,0.0,0.0
1001,2712,27-09-2019 06:02:00,1,2156.0,1565.0,0.726,10.227,18,8,5,3,10,2,8,0,0.0,0.0
1001,2713,27-09-2019 06:04:00,1,2159.0,1513.0,0.701,10.182,11,0,0,0,11,0,11,0,0.0,0.0
1001,2714,27-09-2019 06:06:00,1,2171.0,1429.0,0.658,10.137,11,1,0,1,10,0,10,0,0.0,0.0
1001,2715,27-09-2019 06:08:00,1,1961.0,1395.0,0.711,9.273,0,0,0,0,0,0,0,0,0.0,0.0
1001,2716,27-09-2019 06:10:00,1,1861.0,1340.0,0.72,8.818,0,0,0,0,0,0,0,0,0.0,0.0
1001,2717,27-09-2019 06:12:00,1,1866.0,1297.0,0.695,8.79,0,0,0,0,0,0,0,0,0.0,0.0
1001,2718,27-09-2019 06:14:00,1,1874.0,1256.0,0.671,8.773,19,10,2,8,9,2,7,0,0.0,0.0
1001,2719,27-09-2019 06:16:00,1,1879.0,1257.0,0.669,8.794,80,38,0,38,42,0,42,0,0.0,0.0
1001,2720,27-09-2019 06:18:00,1,1826.0,1229.5,0.6735,8.5555,19,15,0,15,4,0,4,0,0.0,0.0
1001,2721,27-09-2019 06:20:00,1,1773.0,1202.0,0.678,8.317,33,33,0,33,0,0,0,0,0.0,0.0
1001,2722,27-09-2019 06:22:00,1,1669.0,1175.0,0.704,7.875,10,10,0,10,0,0,0,0,0.0,0.0
1001,2723,27-09-2019 06:24:00,1,1672.0,1142.0,0.683,7.853,11,11,0,11,0,0,0,0,0.0,0.0
1001,2724,27-09-2019 06:26:00,1,1673.0,1164.0,0.696,7.88,7,7,0,7,0,0,0,0,0.0,0.0
1001,2725,27-09-2019 06:28:00,1,1678.0,1140.0,0.679,7.872,3,2,0,2,1,0,1,0,0.0,0.0
1001,2726,27-09-2019 06:30:00,1,1671.0,1139.0,0.682,7.844,0,0,0,0,0,0,0,0,0.0,0.0
1001,2727,27-09-2019 06:32:00,1,1681.0,1126.0,0.67,7.87,0,0,0,0,0,0,0,0,0.0,0.0
1001,2728,27-09-2019 06:34:00,1,1678.0,1097.0,0.654,7.827,0,0,0,0,0,0,0,0,0.0,0.0
1001,2729,27-09-2019 06:36:00,1,1692.0,1081.0,0.639,7.863,4,0,0,0,4,0,4,0,0.0,0.0
1001,2730,27-09-2019 06:38:00,1,1699.0,1069.0,0.629,7.877,108,76,40,36,32,14,18,44,0.0,0.0
1001,2731,27-09-2019 06:40:00,1,1959.0,1401.0,0.715,9.27,61,25,4,21,36,0,36,48,0.0,0.0
1001,2732,27-09-2019 06:42:00,1,2554.0,1746.0,0.684,11.997,66,47,20,27,19,3,16,48,0.0,0.0
1001,2733,27-09-2019 06:44:00,1,2934.0,2114.0,0.72,13.9,61,50,16,34,11,3,8,48,0.0,0.1
1001,2734,27-09-2019 06:46:00,1,3336.0,2358.0,0.707,15.755,90,73,23,50,17,0,17,41,0.0,0.05
1001,2735,27-09-2019 06:48:00,1,3531.0,2534.0,0.718,16.717,84,54,23,31,30,9,21,57,0.0,0.09
1001,2736,27-09-2019 06:50:00,1,3696.0,2740.0,0.741,17.595,65,45,19,26,20,1,19,57,0.0,0.0
1001,2737,27-09-2019 06:52:00,1,3681.0,2767.5,0.7515,17.5675,14,8,6,2,6,1,5,3,0.0,0.31
1001,2738,27-09-2019 06:54:00,1,3666.0,2795.0,0.762,17.54,0,0,0,0,0,0,0,0,0.0,0.03
1001,2739,27-09-2019 06:56:00,1,3623.0,2946.0,0.813,17.535,150,89,70,19,61,45,16,18,0.0,0.01
1001,2740,27-09-2019 06:58:00,1,3645.0,2979.0,0.817,17.661,420,247,196,51,173,132,41,44,0.26,0.0
1001,2741,27-09-2019 07:00:00,1,3928.0,3135.0,0.798,18.948,298,181,147,34,117,80,37,71,0.26,0.01
1001,2742,27-09-2019 07:02:00,1,3944.0,3120.0,0.791,18.993,80,65,38,27,15,4,11,55,0.0,0.0
1001,2743,27-09-2019 07:04:00,1,4136.0,3320.0,0.803,19.974,113,83,48,35,30,2,28,51,0.01,0.18
1001,2744,27-09-2019 07:06:00,1,3889.0,3315.0,0.852,18.994,0,0,0,0,0,0,0,0,0.0,0.01
1001,2745,27-09-2019 07:08:00,1,3922.0,3198.0,0.815,18.992,78,43,33,10,35,15,20,5,0.3,0.0
1001,2746,27-09-2019 07:10:00,1,3906.0,3208.0,0.821,18.941,322,197,157,40,125,94,31,79,0.15,0.0
1001,2747,27-09-2019 07:12:00,1,3885.0,3378.0,0.87,19.047,293,143,105,38,150,115,35,64,0.02,0.0
1001,2748,27-09-2019 07:14:00,1,3876.0,3405.0,0.879,19.042,39,34,22,12,5,2,3,35,0.0,0.01
1001,2749,27-09-2019 07:16:00,1,4351.0,3709.0,0.852,21.25,72,42,18,24,30,13,17,36,0.0,0.09
1001,2750,27-09-2019 07:18:00,1,4020.0,3624.0,0.902,19.849,76,43,24,19,33,12,21,43,0.26,0.02
1001,2751,27-09-2019 07:20:00,1,4149.0,3679.0,0.887,20.42,94,61,35,26,33,4,29,76,0.0,0.0
1001,2752,27-09-2019 07:22:00,1,4032.0,3583.0,0.889,19.851,72,29,12,17,43,2,41,58,0.01,0.04
1001,2753,27-09-2019 07:24:00,1,4358.0,3793.0,0.87,21.37,114,67,41,26,47,23,24,61,0.0,0.0
1001,2754,27-09-2019 07:26:00,1,3795.5,3275.5,0.8615,18.582,88,64,33,31,24,16,8,1,0.14,0.04
1001,2755,27-09-2019 07:28:00,1,3233.0,2758.0,0.853,15.794,108,62,48,14,46,28,18,32,0.1,0.03
1001,2756,27-09-2019 07:30:00,1,4044.0,3573.0,0.884,19.89,68,37,21,16,31,4,27,71,0.0,0.0
1001,2757,27-09-2019 07:32:00,1,4335.0,3835.0,0.885,21.325,141,74,45,29,67,53,14,24,0.12,0.06
1001,2758,27-09-2019 07:34:00,1,4330.0,3827.0,0.884,21.297,417,241,177,64,176,134,42,34,0.0,0.1
1001,2759,27-09-2019 07:36:00,1,3947.0,3557.0,0.901,19.491,192,152,95,57,40,17,23,58,0.01,0.0
1001,2760,27-09-2019 07:38:00,1,4331.0,3840.0,0.886,21.317,145,63,34,29,82,39,43,24,0.0,0.15
1001,2761,27-09-2019 07:40:00,1,4040.0,3692.0,0.914,20.005,158,52,26,26,106,66,40,37,0.01,0.0
1001,2762,27-09-2019 07:42:00,1,4018.0,3729.0,0.928,19.96,95,36,20,16,59,30,29,30,0.0,0.0
1001,2763,27-09-2019 07:44:00,1,4323.0,3869.0,0.895,21.318,192,107,70,37,85,49,36,58,0.1,0.0
1001,2764,27-09-2019 07:46:00,1,3829.0,3575.0,0.934,19.045,410,309,230,79,101,64,37,8,0.01,0.0
1001,2765,27-09-2019 07:48:00,1,3403.0,2965.0,0.871,16.69,809,566,462,104,243,176,67,56,0.09,0.0
1001,2766,27-09-2019 07:50:00,1,3930.0,3589.0,0.913,19.457,65,34,14,20,31,8,23,0,0.01,0.0
1001,2767,27-09-2019 07:52:00,1,3172.0,2881.0,0.908,15.689,84,77,40,37,7,1,6,0,0.0,0.0
1001,2768,27-09-2019 07:54:00,1,3211.0,2849.0,0.887,15.805,129,54,10,44,75,61,14,0,0.0,0.0
1001,2769,27-09-2019 07:56:00,1,3600.0,3120.0,0.866,17.64,33,32,18,14,1,0,1,0,0.0,0.0
1001,2770,27-09-2019 07:58:00,1,3391.0,2986.0,0.881,16.665,19,19,1,18,0,0,0,0,0.0,0.0
1001,2771,27-09-2019 08:00:00,1,3494.0,3048.5,0.873,17.1415,5,5,1,4,0,0,0,0,0.01,0.0
1001,2772,27-09-2019 08:02:00,1,3597.0,3111.0,0.865,17.618,0,0,0,0,0,0,0,0,0.0,0.0
1001,2773,27-09-2019 08:04:00,1,3578.0,3189.0,0.891,17.626,0,0,0,0,0,0,0,0,0.0,0.0
1001,2774,27-09-2019 08:06:00,1,3645.0,3378.0,0.927,18.102,4,4,2,2,0,0,0,0,0.0,0.0
1001,2775,27-09-2019 08:08:00,1,3616.0,3402.0,0.941,18.012,4,2,1,1,2,1,1,0,0.0,0.0
1001,2776,27-09-2019 08:10:00,1,3526.0,3362.0,0.954,17.613,2,2,0,2,0,0,0,0,0.0,0.0
1001,2777,27-09-2019 08:12:00,1,3529.0,3332.0,0.944,17.594,1,1,0,1,0,0,0,0,0.0,0.0
1001,2778,27-09-2019 08:14:00,1,3455.0,3229.0,0.935,17.19,6,3,0,3,3,1,2,0,0.0,0.0
1001,2779,27-09-2019 08:16:00,1,3361.0,3079.0,0.916,16.651,0,0,0,0,0,0,0,0,0.0,0.0
1001,2780,27-09-2019 08:18:00,1,3158.0,3015.0,0.955,15.78,23,14,10,4,9,2,7,1,0.0,0.0
1001,2781,27-09-2019 08:20:00,1,3185.0,2937.0,0.922,15.802,6,5,3,2,1,1,0,0,0.0,0.0
1001,2782,27-09-2019 08:22:00,1,2957.0,2844.0,0.962,14.801,3,3,1,2,0,0,0,0,0.0,0.0
1001,2783,27-09-2019 08:24:00,1,2864.0,2788.0,0.974,14.37,0,0,0,0,0,0,0,0,0.0,0.0
1001,2784,27-09-2019 08:26:00,1,2874.0,2738.0,0.953,14.355,37,37,2,35,0,0,0,0,0.0,0.0
1001,2785,27-09-2019 08:28:00,1,2889.0,2671.0,0.924,14.34,46,42,4,38,4,1,3,0,0.0,0.0
1001,2786,27-09-2019 08:30:00,1,2686.0,2617.0,0.975,13.479,37,30,19,11,7,0,7,0,0.0,0.0
1001,2787,27-09-2019 08:32:00,1,2689.0,2586.0,0.961,13.458,3,2,0,2,1,0,1,0,0.0,0.0
1001,2788,27-09-2019 08:34:00,1,2695.0,2576.0,0.9555,13.47,1,1,0,1,0,0,0,0,0.0,0.0
1001,2789,27-09-2019 08:36:00,1,2701.0,2566.0,0.95,13.482,5,1,0,1,4,0,4,0,0.0,0.0
1001,2790,27-09-2019 08:38:00,1,2697.0,2507.0,0.93,13.399,60,38,24,14,22,7,15,2,0.0,0.0
1001,2791,27-09-2019 08:40:00,1,2708.0,2507.0,0.926,13.446,24,21,1,20,3,1,2,4,0.0,0.0
1001,2792,27-09-2019 08:42:00,1,2887.0,2715.0,0.94,14.382,69,58,32,26,11,0,11,10,0.0,0.0
1001,2793,27-09-2019 08:44:00,1,2867.0,2805.0,0.978,14.403,66,59,17,42,7,0,7,11,0.0,0.0
1001,2794,27-09-2019 08:46:00,1,3167.0,2964.0,0.936,15.759,9,3,1,2,6,0,6,0,0.0,0.0
1001,2795,27-09-2019 08:48:00,1,3062.0,2908.0,0.95,15.286,0,0,0,0,0,0,0,0,0.0,0.0
1001,2796,27-09-2019 08:50:00,1,2955.0,2852.0,0.965,14.801,9,8,1,7,1,0,1,0,0.0,0.0
1001,2797,27-09-2019 08:52:00,1,2871.0,2776.0,0.967,14.385,4,3,1,2,1,0,1,0,0.0,0.0
1001,2798,27-09-2019 08:54:00,1,2893.0,2704.0,0.935,14.391,9,6,3,3,3,1,2,0,0.0,0.0
1001,2799,27-09-2019 08:56:00,1,2894.0,2664.0,0.921,14.35,1,0,0,0,1,0,1,0,0.0,0.0
1001,2800,27-09-2019 08:58:00,1,2682.0,2596.0,0.968,13.443,1,0,0,0,1,0,1,0,0.0,0.0
1001,2801,27-09-2019 09:00:00,1,2697.0,2555.0,0.947,13.456,61,45,32,13,16,5,11,18,0.0,0.0
1001,2802,27-09-2019 09:02:00,1,2692.0,2557.0,0.95,13.438,132,57,27,30,75,37,38,67,0.0,0.0
1001,2803,27-09-2019 09:04:00,1,3181.0,2932.0,0.922,15.78,138,81,45,36,57,11,46,93,0.01,0.0
1001,2804,27-09-2019 09:06:00,1,3349.0,3185.0,0.951,16.722,81,40,13,27,41,17,24,51,0.0,0.0
1001,2805,27-09-2019 09:08:00,1,3440.0,3285.5,0.955,17.192,103,39,19,20,64,33,31,43,0.0,0.0
1001,2806,27-09-2019 09:10:00,1,3531.0,3386.0,0.959,17.662,139,67,29,38,72,23,49,64,0.0,0.0
1001,2807,27-09-2019 09:12:00,1,3834.0,3585.0,0.935,19.073,98,49,19,30,49,25,24,41,0.0,0.0
1001,2808,27-09-2019 09:14:00,1,3510.0,3429.0,0.977,17.627,211,139,93,46,72,37,35,40,0.16,0.16
1001,2809,27-09-2019 09:16:00,1,3520.0,3388.0,0.963,17.618,66,30,16,14,36,9,27,53,0.0,0.16
1001,2810,27-09-2019 09:18:00,1,3969.0,3881.0,0.978,19.936,73,22,12,10,51,20,31,30,0.01,0.0
1001,2811,27-09-2019 09:20:00,1,3808.0,3647.0,0.958,19.041,168,95,59,36,73,41,32,54,0.08,0.0
1001,2812,27-09-2019 09:22:00,1,3987.0,3806.0,0.955,19.921,181,121,83,38,60,38,22,64,0.09,0.0
1001,2813,27-09-2019 09:24:00,1,3965.0,3909.0,0.986,19.949,171,102,59,43,69,32,37,71,0.06,0.0
1001,2814,27-09-2019 09:26:00,1,4234.0,4114.0,0.972,21.237,116,78,37,41,38,8,30,57,0.0,0.0
1001,2815,27-09-2019 09:28:00,1,4281.0,4045.0,0.945,21.346,117,52,25,27,65,25,40,56,0.01,0.0
1001,2816,27-09-2019 09:30:00,1,4284.0,4072.0,0.951,21.388,107,30,13,17,77,37,40,33,0.0,0.13
1001,2817,27-09-2019 09:32:00,1,4287.0,4003.0,0.934,21.323,427,253,193,60,174,129,45,26,0.09,0.0
1001,2818,27-09-2019 09:34:00,1,4176.0,3983.0,0.954,20.864,171,94,59,35,77,38,39,40,0.0,0.0
1001,2819,27-09-2019 09:36:00,1,4276.0,4114.0,0.962,21.402,98,48,19,29,50,26,24,40,0.0,0.0
1001,2820,27-09-2019 09:38:00,1,4480.0,4215.0,0.941,22.315,69,27,9,18,42,24,18,32,0.0,0.66
1001,2821,27-09-2019 09:40:00,1,4441.0,4367.0,0.983,22.331,74,40,19,21,34,18,16,49,0.0,0.0
1001,2822,27-09-2019 09:42:00,1,4132.5,3957.0,0.9555,20.661,369,181,137,44,188,143,45,16,0.05,0.0
1001,2823,27-09-2019 09:44:00,1,3824.0,3547.0,0.928,18.991,774,483,378,105,291,208,83,28,0.0,0.0
1001,2824,27-09-2019 09:46:00,1,3554.0,3298.0,0.928,17.653,169,139,94,45,30,15,15,0,0.0,0.0
1001,2825,27-09-2019 09:48:00,1,3439.0,3281.0,0.954,17.181,38,29,3,26,9,1,8,1,0.0,0.0
1001,2826,27-09-2019 09:50:00,1,3262.0,3033.0,0.93,16.209,71,37,5,32,34,2,32,0,0.0,0.0
1001,2827,27-09-2019 09:52:00,1,3372.0,3068.0,0.91,16.682,75,51,24,27,24,2,22,0,0.0,0.0
1001,2828,27-09-2019 09:54:00,1,3351.0,3190.0,0.952,16.735,22,17,8,9,5,0,5,0,0.0,0.0
1001,2829,27-09-2019 09:56:00,1,3284.0,2985.0,0.909,16.245,3,3,2,1,0,0,0,0,0.0,0.0
1001,2830,27-09-2019 09:58:00,1,3442.0,3186.0,0.926,17.088,2,2,0,2,0,0,0,0,0.0,0.0
1001,2831,27-09-2019 10:00:00,1,3335.0,3150.0,0.944,16.627,0,0,0,0,0,0,0,0,0.0,0.0
1001,2832,27-09-2019 10:02:00,1,3562.0,3255.0,0.914,17.639,0,0,0,0,0,0,0,0,0.0,0.0
1001,2833,27-09-2019 10:04:00,1,3553.0,3297.0,0.928,17.649,20,8,3,5,12,2,10,0,0.0,0.0
1001,2834,27-09-2019 10:06:00,1,3540.0,3374.0,0.953,17.682,0,0,0,0,0,0,0,0,0.0,0.0
1001,2835,27-09-2019 10:08:00,1,3512.0,3408.0,0.97,17.611,0,0,0,0,0,0,0,0,0.0,0.0
1001,2836,27-09-2019 10:10:00,1,3527.0,3373.0,0.956,17.631,0,0,0,0,0,0,0,0,0.0,0.0
1001,2837,27-09-2019 10:12:00,1,3527.0,3325.0,0.943,17.578,0,0,0,0,0,0,0,0,0.0,0.0
1001,2838,27-09-2019 10:14:00,1,3316.0,3275.0,0.987,16.691,0,0,0,0,0,0,0,0,0.0,0.0
1001,2839,27-09-2019 10:16:00,1,3334.5,3230.5,0.9685,16.714,12,9,5,4,3,0,3,0,0.0,0.0
1001,2840,27-09-2019 10:18:00,1,3353.0,3186.0,0.95,16.737,5,3,2,1,2,0,2,0,0.0,0.0
1001,2841,27-09-2019 10:20:00,1,3242.0,3157.0,0.974,16.27,5,5,0,5,0,0,0,0,0.0,0.0
1001,2842,27-09-2019 10:22:00,1,3146.0,3058.0,0.972,15.781,11,11,1,10,0,0,0,0,0.0,0.0
1001,2843,27-09-2019 10:24:00,1,3054.0,2969.0,0.972,15.319,10,10,3,7,0,0,0,0,0.0,0.0
1001,2844,27-09-2019 10:26:00,1,2842.0,2866.0,1.008,14.371,17,15,4,11,2,0,2,0,0.0,0.0
1001,2845,27-09-2019 10:28:00,1,2870.0,2842.0,0.99,14.453,9,4,2,2,5,0,5,0,0.0,0.0
1001,2846,27-09-2019 10:30:00,1,2879.0,2793.0,0.97,14.435,2,2,1,1,0,0,0,0,0.0,0.0
1001,2847,27-09-2019 10:32:00,1,2660.0,2674.0,1.005,13.44,43,28,6,22,15,2,13,0,0.0,0.0
1001,2848,27-09-2019 10:34:00,1,2652.0,2694.0,1.016,13.429,151,117,57,60,34,3,31,1,0.0,0.0
1001,2849,27-09-2019 10:36:00,1,2852.0,2839.0,0.995,14.382,49,33,10,23,16,2,14,0,0.0,0.0
1001,2850,27-09-2019 10:38:00,1,3051.0,2976.0,0.975,15.316,11,6,0,6,5,0,5,0,0.0,0.0
1001,2851,27-09-2019 10:40:00,1,2937.0,2978.0,1.014,14.868,5,3,1,2,2,0,2,0,0.0,0.0
1001,2852,27-09-2019 10:42:00,1,2840.0,2890.0,1.018,14.387,1,1,0,1,0,0,0,0,0.0,0.0
1001,2853,27-09-2019 10:44:00,1,2856.0,2809.0,0.983,14.363,72,44,33,11,28,22,6,7,0.0,0.0
1001,2854,27-09-2019 10:46:00,1,2770.0,2752.0,0.994,13.959,98,51,18,33,47,25,22,73,0.0,0.0
1001,2855,27-09-2019 10:48:00,1,2831.0,2864.0,1.012,14.324,90,34,12,22,56,19,37,61,0.0,0.0
1001,2856,27-09-2019 10:50:00,1,3081.5,3046.0,0.9905,15.513,92,41,14,27,51,18,33,51,0.0,0.0
1001,2857,27-09-2019 10:52:00,1,3332.0,3228.0,0.969,16.702,66,16,5,11,50,27,23,42,0.0,0.0
1001,2858,27-09-2019 10:54:00,1,3525.0,3429.0,0.973,17.684,97,22,6,16,75,39,36,43,0.0,0.0
1001,2859,27-09-2019 10:56:00,1,3509.0,3453.0,0.984,17.646,575,383,313,70,192,146,46,32,0.14,0.0
1001,2860,27-09-2019 10:58:00,1,2844.0,2800.0,0.985,14.305,218,144,97,47,74,46,28,51,0.0,0.0
1001,2861,27-09-2019 11:00:00,1,3832.0,3598.0,0.939,19.082,143,60,28,32,83,48,35,52,0.0,0.0
1001,2862,27-09-2019 11:02:00,1,3695.0,3548.0,0.96,18.488,100,56,20,36,44,16,28,49,0.0,0.0
1001,2863,27-09-2019 11:04:00,1,3610.0,3528.0,0.977,18.127,104,58,26,32,46,16,30,43,0.0,0.0
1001,2864,27-09-2019 11:06:00,1,3797.0,3643.0,0.96,18.992,200,111,73,38,89,48,41,42,0.11,0.0
1001,2865,27-09-2019 11:08:00,1,3686.0,3588.0,0.974,18.493,879,512,410,102,367,281,86,31,0.11,0.0
1001,2866,27-09-2019 11:10:00,1,3777.0,3714.0,0.983,18.994,672,390,317,73,282,219,63,63,0.0,0.0
1001,2867,27-09-2019 11:12:00,1,3770.0,3724.0,0.988,18.977,183,130,88,42,53,36,17,88,0.0,0.0
1001,2868,27-09-2019 11:14:00,1,3769.0,3722.0,0.987,18.971,89,61,24,37,28,15,13,46,0.01,0.0
1001,2869,27-09-2019 11:16:00,1,4189.0,3988.0,0.952,20.921,263,169,118,51,94,49,45,44,0.05,0.0
1001,2870,27-09-2019 11:18:00,1,3601.0,3551.0,0.986,18.118,191,150,99,51,41,20,21,0,0.0,0.0
1001,2871,27-09-2019 11:20:00,1,2954.0,2895.0,0.98,14.843,41,35,16,19,6,1,5,0,0.0,0.0
1001,2872,27-09-2019 11:22:00,1,2886.0,2722.0,0.943,14.386,11,2,0,2,9,0,9,0,0.0,0.0
1001,2873,27-09-2019 11:24:00,1,2795.5,2641.0,0.945,13.9385,10,8,5,3,2,0,2,0,0.01,0.0
1001,2874,27-09-2019 11:26:00,1,2705.0,2560.0,0.947,13.491,23,10,5,5,13,0,13,0,0.0,0.0
1001,2875,27-09-2019 11:28:00,1,2912.0,2639.0,0.906,14.395,6,6,2,4,0,0,0,0,0.0,0.0
1001,2876,27-09-2019 11:30:00,1,2900.0,2688.0,0.927,14.401,4,4,3,1,0,0,0,0,0.0,0.0
1001,2877,27-09-2019 11:32:00,1,2968.0,2787.0,0.939,14.778,1,1,0,1,0,0,0,0,0.0,0.0
1001,2878,27-09-2019 11:34:00,1,3347.0,3094.0,0.924,16.611,0,0,0,0,0,0,0,0,0.0,0.0
1001,2879,27-09-2019 11:36:00,1,3425.0,3303.0,0.964,17.149,0,0,0,0,0,0,0,0,0.0,0.0
1001,2880,27-09-2019 11:38:00,1,3533.0,3370.0,0.954,17.65,0,0,0,0,0,0,0,0,0.0,0.0
1001,2881,27-09-2019 11:40:00,1,3526.0,3423.0,0.971,17.681,1,1,0,1,0,0,0,0,0.0,0.0
1001,2882,27-09-2019 11:42:00,1,3300.0,3296.0,0.999,16.651,0,0,0,0,0,0,0,0,0.0,0.0
1001,2883,27-09-2019 11:44:00,1,3319.0,3304.0,0.996,16.733,0,0,0,0,0,0,0,0,0.0,0.0
1001,2884,27-09-2019 11:46:00,1,3338.0,3200.0,0.959,16.695,0,0,0,0,0,0,0,0,0.0,0.0
1001,2885,27-09-2019 11:48:00,1,3354.0,3178.0,0.947,16.734,0,0,0,0,0,0,0,0,0.0,0.0
1001,2886,27-09-2019 11:50:00,1,3142.0,3077.0,0.979,15.788,1,1,0,1,0,0,0,0,0.0,0.0
1001,2887,27-09-2019 11:52:00,1,2939.0,2924.0,0.995,14.817,72,22,14,8,50,7,43,0,0.0,0.0
1001,2888,27-09-2019 11:54:00,1,2942.0,2969.0,1.009,14.88,150,93,60,33,57,26,31,28,0.0,0.0
1001,2889,27-09-2019 11:56:00,1,3036.0,3044.0,1.002,15.332,20,13,10,3,7,2,5,0,0.0,0.0
1001,2890,27-09-2019 11:58:00,1,2936.0,2994.5,1.02,14.8835,4,0,0,0,4,0,4,0,0.0,0.0
1001,2891,27-09-2019 12:00:00,1,2836.0,2945.0,1.038,14.435,12,0,0,0,12,0,12,0,0.0,0.0
1001,2892,27-09-2019 12:02:00,1,2827.0,2938.0,1.039,14.392,1,0,0,0,1,0,1,0,0.0,0.0
1001,2893,27-09-2019 12:04:00,1,2840.0,2885.0,1.016,14.382,9,7,1,6,2,0,2,0,0.0,0.0
1001,2894,27-09-2019 12:06:00,1,2867.0,2799.0,0.976,14.393,10,4,0,4,6,0,6,0,0.0,0.0
1001,2895,27-09-2019 12:08:00,1,2759.0,2765.0,1.002,13.932,75,60,38,22,15,6,9,0,0.0,0.0
1001,2896,27-09-2019 12:10:00,1,2855.0,2804.0,0.982,14.352,0,0,0,0,0,0,0,0,0.0,0.0
1001,2897,27-09-2019 12:12:00,1,2861.0,2786.0,0.974,14.356,0,0,0,0,0,0,0,0,0.0,0.0
1001,2898,27-09-2019 12:14:00,1,2646.0,2758.0,1.042,13.479,0,0,0,0,0,0,0,0,0.0,0.0
1001,2899,27-09-2019 12:16:00,1,2664.0,2683.0,1.007,13.466,0,0,0,0,0,0,0,0,0.0,0.0
1001,2900,27-09-2019 12:18:00,1,2671.0,2633.0,0.986,13.436,9,5,3,2,4,2,2,0,0.0,0.0
1001,2901,27-09-2019 12:20:00,1,2687.0,2581.0,0.961,13.444,5,1,0,1,4,0,4,0,0.0,0.0
1001,2902,27-09-2019 12:22:00,1,2585.0,2535.0,0.981,12.99,8,6,2,4,2,0,2,0,0.0,0.0
1001,2903,27-09-2019 12:24:00,1,2481.0,2478.0,0.998,12.52,149,86,54,32,63,25,38,7,0.0,0.0
1001,2904,27-09-2019 12:26:00,1,2518.0,2368.0,0.94,12.543,96,53,26,27,43,8,35,58,0.0,0.0
1001,2905,27-09-2019 12:28:00,1,2862.0,2786.0,0.974,14.359,70,45,17,28,25,3,22,32,0.0,0.0
1001,2906,27-09-2019 12:30:00,1,3149.0,2998.0,0.952,15.724,76,54,16,38,22,13,9,38,0.0,0.01
1001,2907,27-09-2019 12:32:00,1,3237.5,3097.0,0.9565,16.183,108,68,28,40,40,12,28,41,0.0,0.0
1001,2908,27-09-2019 12:34:00,1,3326.0,3196.0,0.961,16.642,76,45,21,24,31,13,18,28,0.0,0.15
1001,2909,27-09-2019 12:36:00,1,3307.0,3294.0,0.996,16.676,67,42,19,23,25,7,18,18,0.0,0.07
1001,2910,27-09-2019 12:38:00,1,3323.0,3259.0,0.981,16.699,513,318,252,66,195,144,51,32,0.11,0.0
1001,2911,27-09-2019 12:40:00,1,3311.0,3364.0,1.016,16.77,257,169,117,52,88,59,29,0,0.0,0.03
1001,2912,27-09-2019 12:42:00,1,2862.0,2804.0,0.98,14.379,76,58,20,38,18,8,10,0,0.0,0.0
1001,2913,27-09-2019 12:44:00,1,3052.0,2925.0,0.958,15.264,32,24,8,16,8,2,6,0,0.0,0.0
1001,2914,27-09-2019 12:46:00,1,3318.0,3330.0,1.004,16.76,9,7,1,6,2,0,2,0,0.0,0.0
1001,2915,27-09-2019 12:48:00,1,3314.0,3263.0,0.985,16.669,1,1,0,1,0,0,0,0,0.0,0.0
1001,2916,27-09-2019 12:50:00,1,3529.0,3350.0,0.949,17.613,15,15,0,15,0,0,0,0,0.01,0.0
1002,1,23-09-2019 11:40:00,1,3864.5,2875.5,0.743,18.41,125,65,41,24,60,54,6,6,0.01,0.02
1002,2,23-09-2019 11:42:00,1,3684.0,2645.0,0.718,17.444,288,134,95,39,154,144,10,17,0.0,0.0
1002,3,23-09-2019 11:44:00,1,3959.0,2938.0,0.742,18.851,115,42,31,11,73,67,6,9,0.0,0.0
1002,4,23-09-2019 11:46:00,1,3948.0,2951.0,0.747,18.822,150,67,40,27,83,79,4,0,0.0,0.0
1002,5,23-09-2019 11:48:00,1,3738.0,2868.0,0.767,17.905,10,10,1,9,0,0,0,0,0.0,0.0
1002,6,23-09-2019 11:50:00,1,3340.0,2462.0,0.737,15.885,7,7,0,7,0,0,0,0,0.0,0.0
1002,7,23-09-2019 11:52:00,1,3055.0,2236.0,0.732,14.513,22,22,0,22,0,0,0,0,0.0,0.0
1002,8,23-09-2019 11:54:00,1,3094.0,2121.0,0.685,14.54,61,54,27,27,7,6,1,5,0.0,0.0
1002,9,23-09-2019 11:56:00,1,3228.0,2462.0,0.763,15.444,63,51,27,24,12,10,2,4,0.0,0.0
1002,10,23-09-2019 11:58:00,1,3070.0,2242.0,0.73,14.577,50,35,18,17,15,13,2,3,0.0,0.0
1002,11,23-09-2019 12:00:00,1,3078.0,2119.0,0.688,14.475,3,3,1,2,0,0,0,0,0.0,0.0
1002,12,23-09-2019 12:02:00,1,2976.0,2090.0,0.702,14.04,0,0,0,0,0,0,0,0,0.0,0.0
1002,13,23-09-2019 12:04:00,1,2747.0,1983.0,0.722,13.021,0,0,0,0,0,0,0,0,0.0,0.0
1002,14,23-09-2019 12:06:00,1,2768.0,1966.0,0.71,13.081,5,5,3,2,0,0,0,0,0.0,0.1
1002,15,23-09-2019 12:08:00,1,2736.0,1997.0,0.73,12.989,97,59,30,29,38,36,2,12,0.0,0.0
1002,16,23-09-2019 12:10:00,1,3080.0,2177.0,0.707,14.545,231,110,81,29,121,108,13,16,0.0,0.0
1002,17,23-09-2019 12:12:00,1,3063.0,2129.0,0.695,14.426,330,161,125,36,169,151,18,17,0.0,0.0
1002,18,23-09-2019 12:14:00,1,3267.0,2310.5,0.7065,15.431,162,89,56,33,73,72,1,18,0.0,0.0
1002,19,23-09-2019 12:16:00,1,3471.0,2492.0,0.718,16.436,151,78,42,36,73,67,6,5,0.0,0.0
1002,20,23-09-2019 12:18:00,1,3054.0,2236.0,0.732,14.508,80,44,24,20,36,34,2,0,0.0,0.0
1002,21,23-09-2019 12:20:00,1,3450.0,2535.0,0.735,16.402,86,79,47,32,7,7,0,2,0.0,0.0
1002,22,23-09-2019 12:22:00,1,3272.0,2332.0,0.713,15.473,76,72,37,35,4,4,0,0,0.0,0.0
1002,23,23-09-2019 12:24:00,1,3063.0,2226.0,0.727,14.532,72,65,24,41,7,6,1,2,0.0,0.0
1002,24,23-09-2019 12:26:00,1,3046.0,2280.0,0.749,14.527,51,51,15,36,0,0,0,0,0.0,0.0
1002,25,23-09-2019 12:28:00,1,2739.0,2028.0,0.74,13.037,18,18,4,14,0,0,0,2,0.0,0.0
1002,26,23-09-2019 12:30:00,1,2784.0,1926.0,0.692,13.104,42,35,20,15,7,6,1,0,0.0,0.0
1002,27,23-09-2019 12:32:00,1,2540.0,1811.0,0.713,12.012,2,2,0,2,0,0,0,0,0.0,0.0
1002,28,23-09-2019 12:34:00,1,2347.0,1689.0,0.72,11.115,2,1,1,0,1,0,1,0,0.0,0.0
1002,29,23-09-2019 12:36:00,1,2365.0,1632.0,0.69,11.126,0,0,0,0,0,0,0,0,0.0,0.0
1002,30,23-09-2019 12:38:00,1,2359.0,1621.0,0.687,11.089,0,0,0,0,0,0,0,0,0.0,0.0
1002,31,23-09-2019 12:40:00,1,2146.0,1540.0,0.717,10.161,0,0,0,0,0,0,0,0,0.0,0.0
1002,32,23-09-2019 12:42:00,1,2148.0,1539.0,0.716,10.169,0,0,0,0,0,0,0,0,0.0,0.0
1002,33,23-09-2019 12:44:00,1,2143.0,1529.0,0.714,10.135,0,0,0,0,0,0,0,0,0.0,0.0
1002,34,23-09-2019 12:46:00,1,2031.0,1494.0,0.736,9.655,4,4,3,1,0,0,0,0,0.0,0.0
1002,35,23-09-2019 12:48:00,1,2028.5,1520.0,0.7495,9.6735,5,4,0,4,1,0,1,0,0.0,0.0
1002,36,23-09-2019 12:50:00,1,2026.0,1546.0,0.763,9.692,0,0,0,0,0,0,0,0,0.0,0.0
1002,37,23-09-2019 12:52:00,1,2034.0,1506.0,0.74,9.682,3,3,0,3,0,0,0,0,0.0,0.0
1002,38,23-09-2019 12:54:00,1,2040.0,1466.0,0.719,9.661,3,3,0,3,0,0,0,0,0.0,0.0
1002,39,23-09-2019 12:56:00,1,2041.0,1474.0,0.722,9.674,0,0,0,0,0,0,0,0,0.0,0.0
1002,40,23-09-2019 12:58:00,1,2047.0,1421.0,0.694,9.639,2,1,0,1,1,0,1,0,0.0,0.0
1002,41,23-09-2019 13:00:00,1,2050.0,1430.0,0.697,9.659,66,34,14,20,32,30,2,2,0.0,0.0
1002,42,23-09-2019 13:02:00,1,2554.0,1837.0,0.719,12.097,67,42,23,19,25,21,4,3,0.0,0.0
1002,43,23-09-2019 13:04:00,1,2559.0,1830.0,0.715,12.108,182,113,84,29,69,63,6,14,0.0,0.0
1002,44,23-09-2019 13:06:00,1,2343.0,1677.0,0.716,11.09,255,120,84,36,135,126,9,7,0.0,0.0
1002,45,23-09-2019 13:08:00,1,2752.0,2006.0,0.729,13.064,39,36,24,12,3,3,0,0,0.0,0.0
1002,46,23-09-2019 13:10:00,1,2558.0,1808.0,0.707,12.081,70,62,31,31,8,8,0,6,0.0,0.0
1002,47,23-09-2019 13:12:00,1,2567.0,1790.0,0.697,12.094,126,59,34,25,67,63,4,3,0.0,0.0
1002,48,23-09-2019 13:14:00,1,3044.0,2246.0,0.738,14.481,106,48,27,21,58,53,5,0,0.0,0.0
1002,49,23-09-2019 13:16:00,1,2347.0,1695.0,0.722,11.123,2,1,1,0,1,0,1,0,0.0,0.0
1002,50,23-09-2019 13:18:00,1,2355.0,1615.0,0.686,11.069,85,81,59,22,4,2,2,1,0.0,0.0
1002,51,23-09-2019 13:20:00,1,2349.0,1702.0,0.725,11.14,69,47,29,18,22,19,3,0,0.0,0.0
1002,52,23-09-2019 13:22:00,1,2242.0,1650.5,0.737,10.662,5,5,1,4,0,0,0,0,0.0,0.0
1002,53,23-09-2019 13:24:00,1,2135.0,1599.0,0.749,10.184,0,0,0,0,0,0,0,0,0.0,0.0
1002,54,23-09-2019 13:26:00,1,2030.0,1475.0,0.726,9.632,0,0,0,0,0,0,0,0,0.0,0.0
1002,55,23-09-2019 13:28:00,1,2041.0,1465.0,0.718,9.662,0,0,0,0,0,0,0,0,0.0,0.0
1002,56,23-09-2019 13:30:00,1,2050.0,1439.0,0.702,9.67,0,0,0,0,0,0,0,0,0.0,0.0
1002,57,23-09-2019 13:32:00,1,2055.0,1421.0,0.692,9.669,34,26,17,9,8,7,1,0,0.0,0.0
1002,58,23-09-2019 13:34:00,1,2029.0,1548.0,0.763,9.708,0,0,0,0,0,0,0,0,0.0,0.0
1002,59,23-09-2019 13:36:00,1,2033.0,1467.0,0.722,9.633,2,0,0,0,2,0,2,0,0.0,0.0
1002,60,23-09-2019 13:38:00,1,1939.0,1407.0,0.726,9.198,0,0,0,0,0,0,0,0,0.0,0.0
1002,61,23-09-2019 13:40:00,1,1818.0,1389.0,0.764,8.702,0,0,0,0,0,0,0,0,0.0,0.0
1002,62,23-09-2019 13:42:00,1,1821.0,1376.0,0.756,8.697,0,0,0,0,0,0,0,0,0.0,0.0
1002,63,23-09-2019 13:44:00,1,1830.0,1345.0,0.735,8.701,30,24,14,10,6,6,0,0,0.0,0.0
1002,64,23-09-2019 13:46:00,1,1827.0,1369.0,0.749,8.716,0,0,0,0,0,0,0,0,0.0,0.0
1002,65,23-09-2019 13:48:00,1,1830.0,1354.0,0.74,8.708,5,5,3,2,0,0,0,0,0.0,0.0
1002,66,23-09-2019 13:50:00,1,1831.0,1338.0,0.731,8.695,50,34,24,10,16,14,2,0,0.0,0.0
1002,67,23-09-2019 13:52:00,1,2050.0,1440.0,0.703,9.67,0,0,0,0,0,0,0,0,0.0,0.0
1002,68,23-09-2019 13:54:00,1,1822.0,1367.0,0.75,8.693,0,0,0,0,0,0,0,0,0.0,0.0
1002,69,23-09-2019 13:56:00,1,1833.0,1338.0,0.73,8.7045,0,0,0,0,0,0,0,0,0.0,0.0
1002,70,23-09-2019 13:58:00,1,1844.0,1309.0,0.71,8.716,59,51,34,17,8,7,1,0,0.0,0.0
1002,71,23-09-2019 14:00:00,1,2030.0,1504.0,0.741,9.665,0,0,0,0,0,0,0,0,0.0,0.0
1002,72,23-09-2019 14:02:00,1,1822.0,1384.0,0.759,8.712,0,0,0,0,0,0,0,0,0.0,0.0
1002,73,23-09-2019 14:04:00,1,1830.0,1361.0,0.743,8.717,15,15,0,15,0,0,0,0,0.0,0.0
1002,74,23-09-2019 14:06:00,1,1839.0,1312.0,0.714,8.697,22,22,0,22,0,0,0,0,0.0,0.0
1002,75,23-09-2019 14:08:00,1,1839.0,1324.0,0.72,8.711,31,31,8,23,0,0,0,0,0.0,0.0
1002,76,23-09-2019 14:10:00,1,1843.0,1287.0,0.698,8.687,17,17,5,12,0,0,0,0,0.0,0.0
1002,77,23-09-2019 14:12:00,1,1842.0,1301.0,0.706,8.699,78,78,48,30,0,0,0,0,0.0,0.0
1002,78,23-09-2019 14:14:00,1,1850.0,1274.0,0.689,8.701,0,0,0,0,0,0,0,0,0.0,0.0
1002,79,23-09-2019 14:16:00,1,1837.0,1315.0,0.716,8.692,0,0,0,0,0,0,0,0,0.0,0.0
1002,80,23-09-2019 14:18:00,1,1829.0,1347.0,0.737,8.697,0,0,0,0,0,0,0,0,0.0,0.0
1002,81,23-09-2019 14:20:00,1,1838.0,1338.0,0.728,8.724,68,49,30,19,19,17,2,1,0.0,0.0
1002,82,23-09-2019 14:22:00,1,2044.0,1440.0,0.705,9.647,6,6,1,5,0,0,0,0,0.0,0.0
1002,83,23-09-2019 14:24:00,1,1930.0,1415.0,0.733,9.169,17,17,7,10,0,0,0,0,0.0,0.0
1002,84,23-09-2019 14:26:00,1,1935.0,1391.0,0.719,9.165,7,7,5,2,0,0,0,0,0.0,0.0
1002,85,23-09-2019 14:28:00,1,1936.0,1418.0,0.732,9.198,2,2,0,2,0,0,0,0,0.0,0.0
1002,86,23-09-2019 14:30:00,1,1935.0,1407.0,0.7265,9.182,4,4,1,3,0,0,0,0,0.0,0.0
1002,87,23-09-2019 14:32:00,1,1934.0,1396.0,0.721,9.166,0,0,0,0,0,0,0,0,0.0,0.0
1002,88,23-09-2019 14:34:00,1,2057.0,1428.0,0.694,9.684,20,20,13,7,0,0,0,0,0.0,0.0
1002,89,23-09-2019 14:36:00,1,2162.0,1484.0,0.686,10.161,136,128,80,48,8,8,0,0,0.0,0.0
1002,90,23-09-2019 14:38:00,1,2154.0,1511.0,0.701,10.162,52,52,15,37,0,0,0,0,0.0,0.0
1002,91,23-09-2019 14:40:00,1,2142.0,1581.0,0.738,10.192,62,62,34,28,0,0,0,0,0.0,0.0
1002,92,23-09-2019 14:42:00,1,2463.0,1687.0,0.685,11.572,60,60,23,37,0,0,0,3,0.0,0.0
1002,93,23-09-2019 14:44:00,1,2761.0,1969.0,0.713,13.061,85,74,39,35,11,11,0,3,0.0,0.0
1002,94,23-09-2019 14:46:00,1,2855.0,2073.0,0.726,13.542,3,0,0,0,3,2,1,0,0.0,0.0
1002,95,23-09-2019 14:48:00,1,2444.0,1796.0,0.735,11.618,0,0,0,0,0,0,0,0,0.0,0.0
1002,96,23-09-2019 14:50:00,1,2239.0,1622.0,0.724,10.619,0,0,0,0,0,0,0,0,0.0,0.0
1002,97,23-09-2019 14:52:00,1,2141.0,1580.0,0.738,10.185,0,0,0,0,0,0,0,0,0.0,0.0
1002,98,23-09-2019 14:54:00,1,2152.0,1490.0,0.692,10.131,1,1,1,0,0,0,0,0,0.0,0.0
1002,99,23-09-2019 14:56:00,1,2166.0,1448.0,0.669,10.136,39,39,25,14,0,0,0,0,0.0,0.0
1002,100,23-09-2019 14:58:00,1,2161.0,1477.0,0.683,10.151,15,15,7,8,0,0,0,0,0.0,0.0
1002,101,23-09-2019 15:00:00,1,2153.0,1489.0,0.692,10.131,0,0,0,0,0,0,0,0,0.0,0.0
1002,102,23-09-2019 15:02:00,1,2164.0,1477.0,0.683,10.161,5,3,1,2,2,2,0,0,0.0,0.0
1002,103,23-09-2019 15:04:00,1,2162.5,1489.5,0.689,10.169,0,0,0,0,0,0,0,0,0.0,0.0
1002,104,23-09-2019 15:06:00,1,2161.0,1502.0,0.695,10.177,11,11,0,11,0,0,0,0,0.0,0.0
1002,105,23-09-2019 15:08:00,1,2157.0,1501.0,0.696,10.163,8,8,0,8,0,0,0,0,0.0,0.0
1002,106,23-09-2019 15:10:00,1,2151.0,1481.0,0.689,10.114,5,5,0,5,0,0,0,0,0.0,0.0
1002,107,23-09-2019 15:12:00,1,2158.0,1522.0,0.705,10.188,50,50,22,28,0,0,0,0,0.0,0.0
1002,108,23-09-2019 15:14:00,1,2150.0,1494.0,0.695,10.126,28,28,0,28,0,0,0,0,0.0,0.0
1002,109,23-09-2019 15:16:00,1,2245.0,1604.0,0.714,10.623,7,7,1,6,0,0,0,0,0.0,0.0
1002,110,23-09-2019 15:18:00,1,2150.0,1553.0,0.722,10.19,0,0,0,0,0,0,0,0,0.0,0.0
1002,111,23-09-2019 15:20:00,1,2129.0,1559.0,0.732,10.112,0,0,0,0,0,0,0,0,0.0,0.0
1002,112,23-09-2019 15:22:00,1,2151.0,1501.0,0.698,10.136,12,12,1,11,0,0,0,0,0.0,0.0
1002,113,23-09-2019 15:24:00,1,2159.0,1512.0,0.7,10.18,15,15,0,15,0,0,0,0,0.0,0.0
1002,114,23-09-2019 15:26:00,1,2133.0,1545.0,0.724,10.116,29,29,0,29,0,0,0,0,0.0,0.0
1002,115,23-09-2019 15:28:00,1,2146.0,1548.0,0.721,10.171,51,51,4,47,0,0,0,0,0.0,0.0
1002,116,23-09-2019 15:30:00,1,2138.0,1550.0,0.725,10.141,0,0,0,0,0,0,0,0,0.0,0.0
1002,117,23-09-2019 15:32:00,1,2252.0,1593.0,0.707,10.636,2,2,0,2,0,0,0,0,0.0,0.0
1002,118,23-09-2019 15:34:00,1,2130.0,1585.0,0.744,10.146,2,2,0,2,0,0,0,0,0.0,0.0
1002,119,23-09-2019 15:36:00,1,2134.0,1557.0,0.73,10.132,85,69,29,40,16,14,2,1,0.0,0.0
1002,120,23-09-2019 15:38:00,1,2135.5,1549.5,0.726,10.1295,45,44,22,22,1,1,0,0,0.0,0.0
1002,121,23-09-2019 15:40:00,1,2137.0,1542.0,0.722,10.127,0,0,0,0,0,0,0,0,0.0,0.0
1002,122,23-09-2019 15:42:00,1,2146.0,1529.0,0.712,10.149,12,12,6,6,0,0,0,0,0.0,0.0
1002,123,23-09-2019 15:44:00,1,2163.0,1481.0,0.684,10.164,2,2,0,2,0,0,0,0,0.0,0.0
1002,124,23-09-2019 15:46:00,1,2155.0,1485.0,0.689,10.134,12,12,5,7,0,0,0,0,0.0,0.0
1002,125,23-09-2019 15:48:00,1,2148.0,1543.0,0.718,10.173,26,26,4,22,0,0,0,0,0.0,0.0
1002,126,23-09-2019 15:50:00,1,2153.0,1485.0,0.69,10.127,19,19,12,7,0,0,0,0,0.0,0.0
1002,127,23-09-2019 15:52:00,1,2156.0,1504.0,0.698,10.161,11,11,0,11,0,0,0,0,0.0,0.0
1002,128,23-09-2019 15:54:00,1,2148.0,1528.0,0.711,10.156,25,25,1,24,0,0,0,0,0.0,0.0
1002,129,23-09-2019 15:56:00,1,2137.0,1541.0,0.721,10.127,26,26,3,23,0,0,0,0,0.0,0.0
1002,130,23-09-2019 15:58:00,1,2145.0,1563.0,0.728,10.182,23,23,0,23,0,0,0,0,0.0,0.0
1002,131,23-09-2019 16:00:00,1,2147.0,1508.0,0.703,10.128,6,6,0,6,0,0,0,0,0.0,0.0
1002,132,23-09-2019 16:02:00,1,2055.0,1441.0,0.701,9.691,14,14,1,13,0,0,0,0,0.0,0.0
1002,133,23-09-2019 16:04:00,1,2159.0,1453.0,0.673,10.116,21,21,1,20,0,0,0,0,0.0,0.0
1002,134,23-09-2019 16:06:00,1,2158.0,1446.0,0.67,10.105,12,12,3,9,0,0,0,0,0.0,0.0
1002,135,23-09-2019 16:08:00,1,2053.0,1460.0,0.711,9.706,41,41,20,21,0,0,0,0,0.0,0.0
1002,136,23-09-2019 16:10:00,1,2047.0,1447.0,0.707,9.666,7,7,0,7,0,0,0,0,0.0,0.0
1002,137,23-09-2019 16:12:00,1,1993.0,1429.5,0.7175,9.434,0,0,0,0,0,0,0,0,0.0,0.0
1002,138,23-09-2019 16:14:00,1,1939.0,1412.0,0.728,9.202,0,0,0,0,0,0,0,0,0.0,0.0
1002,139,23-09-2019 16:16:00,1,2049.0,1432.0,0.699,9.66,1,1,0,1,0,0,0,0,0.0,0.0
1002,140,23-09-2019 16:18:00,1,2045.0,1447.0,0.708,9.659,6,6,1,5,0,0,0,0,0.0,0.0
1002,141,23-09-2019 16:20:00,1,2150.0,1505.0,0.7,10.136,4,4,1,3,0,0,0,0,0.0,0.0
1002,142,23-09-2019 16:22:00,1,2158.0,1490.0,0.69,10.152,4,4,0,4,0,0,0,0,0.0,0.0
1002,143,23-09-2019 16:24:00,1,2151.0,1511.0,0.703,10.148,2,2,0,2,0,0,0,0,0.0,0.0
1002,144,23-09-2019 16:26:00,1,2141.0,1534.0,0.716,10.135,83,79,53,26,4,4,0,2,0.0,0.0
1002,145,23-09-2019 16:28:00,1,2646.0,1942.0,0.734,12.576,95,84,48,36,11,10,1,4,0.0,0.0
1002,146,23-09-2019 16:30:00,1,2773.0,1899.0,0.685,13.029,103,87,55,32,16,15,1,6,0.0,0.0
1002,147,23-09-2019 16:32:00,1,2945.0,2205.0,0.749,14.044,122,74,41,33,48,48,0,4,0.0,0.0
1002,148,23-09-2019 16:34:00,1,3332.0,2536.0,0.761,15.936,69,41,19,22,28,27,1,1,0.0,0.0
1002,149,23-09-2019 16:36:00,1,2655.0,1876.0,0.706,12.538,49,32,2,30,17,16,1,0,0.0,0.0
1002,150,23-09-2019 16:38:00,1,2652.0,1896.0,0.715,12.547,106,18,8,10,88,82,6,0,0.0,0.0
1002,151,23-09-2019 16:40:00,1,2767.0,1949.0,0.704,13.061,126,113,77,36,13,12,1,6,0.0,0.0
1002,152,23-09-2019 16:42:00,1,2869.0,2021.0,0.704,13.541,285,86,53,33,199,183,16,10,0.0,0.0
1002,153,23-09-2019 16:44:00,1,3175.0,2209.0,0.696,14.958,291,110,75,35,181,174,7,2,0.0,0.0
1002,154,23-09-2019 16:46:00,1,3273.5,2314.5,0.707,15.461,188,71,51,20,117,111,6,0,0.0,0.0
1002,155,23-09-2019 16:48:00,1,3372.0,2420.0,0.718,15.964,79,49,24,25,30,28,2,0,0.0,0.0
1002,156,23-09-2019 16:50:00,1,2231.0,1627.0,0.729,10.592,26,12,5,7,14,13,1,2,0.0,0.0
1002,157,23-09-2019 16:52:00,1,2845.0,2110.0,0.741,13.546,89,72,42,30,17,15,2,0,0.0,0.0
1002,158,23-09-2019 16:54:00,1,2960.0,2168.0,0.733,14.061,27,13,7,6,14,13,1,0,0.0,0.0
1002,159,23-09-2019 16:56:00,1,2855.0,2053.0,0.719,13.522,70,28,14,14,42,40,2,0,0.0,0.0
1002,160,23-09-2019 16:58:00,1,3146.0,2296.0,0.73,14.938,180,98,53,45,82,77,5,0,0.0,0.0
1002,161,23-09-2019 17:00:00,1,3368.0,2434.0,0.722,15.966,54,50,23,27,4,4,0,2,0.0,0.0
1002,162,23-09-2019 17:02:00,1,3171.0,2254.0,0.711,14.989,71,58,16,42,13,13,0,0,0.0,0.0
1002,163,23-09-2019 17:04:00,1,2956.0,2148.0,0.727,14.024,20,9,5,4,11,10,1,0,0.0,0.0
1002,164,23-09-2019 17:06:00,1,2859.0,2052.0,0.718,13.536,15,15,1,14,0,0,0,0,0.0,0.0
1002,165,23-09-2019 17:08:00,1,2851.0,2104.0,0.738,13.562,45,44,0,44,1,1,0,0,0.0,0.0
1002,166,23-09-2019 17:10:00,1,2548.0,1815.0,0.712,12.049,36,36,0,36,0,0,0,0,0.0,0.0
1002,167,23-09-2019 17:12:00,1,2555.0,1827.0,0.715,12.091,39,39,0,39,0,0,0,0,0.0,0.0
1002,168,23-09-2019 17:14:00,1,2466.0,1709.0,0.693,11.61,14,13,0,13,1,0,1,0,0.0,0.0
1002,169,23-09-2019 17:16:00,1,2341.0,1669.0,0.713,11.073,37,27,11,16,10,10,0,0,0.0,0.0
1002,170,23-09-2019 17:18:00,1,1745.0,1192.0,0.683,8.196,8,8,0,8,0,0,0,0,0.0,0.0
1002,171,23-09-2019 17:20:00,1,1589.0,1103.5,0.6955,7.4825,2,2,0,2,0,0,0,0,0.0,0.0
1002,172,23-09-2019 17:22:00,1,1433.0,1015.0,0.708,6.769,2,2,0,2,0,0,0,0,0.0,0.0
1002,173,23-09-2019 17:24:00,1,1661.0,1053.0,0.634,7.712,10,9,1,8,1,0,1,0,0.0,0.0
1002,174,23-09-2019 17:26:00,1,1783.0,1072.0,0.601,8.214,4,4,0,4,0,0,0,0,0.0,0.0
1002,175,23-09-2019 17:28:00,1,1769.0,1129.0,0.638,8.22,2,2,1,1,0,0,0,0,0.0,0.0
1002,176,23-09-2019 17:30:00,1,1760.0,1131.0,0.643,8.187,0,0,0,0,0,0,0,0,0.0,0.0
1002,177,23-09-2019 17:32:00,1,1760.0,1162.0,0.66,8.222,0,0,0,0,0,0,0,0,0.0,0.0
1002,178,23-09-2019 17:34:00,1,1754.0,1180.0,0.673,8.219,0,0,0,0,0,0,0,0,0.0,0.0
1002,179,23-09-2019 17:36:00,1,1749.0,1178.0,0.674,8.195,0,0,0,0,0,0,0,0,0.0,0.0
1002,180,23-09-2019 17:38:00,1,1744.0,1239.0,0.711,8.242,15,9,1,8,6,6,0,0,0.0,0.0
1002,181,23-09-2019 17:40:00,1,1852.0,1265.0,0.683,8.697,32,32,2,30,0,0,0,0,0.0,0.0
1002,182,23-09-2019 17:42:00,1,1734.0,1218.0,0.702,8.181,28,16,0,16,12,12,0,0,0.01,0.0
1002,183,23-09-2019 17:44:00,1,1856.0,1243.0,0.67,8.689,18,17,7,10,1,1,0,0,0.0,0.0
1002,184,23-09-2019 17:46:00,1,1980.0,1275.0,0.644,9.212,0,0,0,0,0,0,0,0,0.0,0.0
1002,185,23-09-2019 17:48:00,1,1847.0,1257.0,0.68,8.67,1,1,0,1,0,0,0,0,0.0,0.0
1002,186,23-09-2019 17:50:00,1,1865.0,1240.0,0.665,8.723,8,6,3,3,2,0,2,0,0.0,0.0
1002,187,23-09-2019 17:52:00,1,2046.0,1456.0,0.712,9.676,31,19,9,10,12,3,9,0,0.0,0.0
1002,188,23-09-2019 17:54:00,1,2562.5,1813.5,0.7085,12.106,48,37,17,20,11,11,0,2,0.0,0.0
1002,189,23-09-2019 17:56:00,1,3079.0,2171.0,0.705,14.536,69,59,23,36,10,9,1,5,0.0,0.0
1002,190,23-09-2019 17:58:00,1,3173.0,2202.0,0.694,14.942,33,33,9,24,0,0,0,2,0.0,0.0
1002,191,23-09-2019 18:00:00,0,2755.0,1975.0,0.717,13.043,10,9,1,8,1,0,1,0,0.0,0.0
1002,192,23-09-2019 18:02:00,0,2445.0,1799.0,0.736,11.623,2,2,0,2,0,0,0,0,0.0,0.0
1002,193,23-09-2019 18:04:00,0,2453.0,1697.0,0.692,11.546,38,37,14,23,1,0,1,0,0.0,0.0
1002,194,23-09-2019 18:06:00,0,2130.0,1630.0,0.765,10.195,6,6,0,6,0,0,0,0,0.0,0.0
1002,195,23-09-2019 18:08:00,0,2112.0,1620.0,0.767,10.115,0,0,0,0,0,0,0,0,0.0,0.0
1002,196,23-09-2019 18:10:00,0,2437.0,1785.0,0.732,11.579,1,1,0,1,0,0,0,0,0.0,0.0
1002,197,23-09-2019 18:12:00,0,2131.0,1620.0,0.76,10.192,0,0,0,0,0,0,0,0,0.0,0.0
1002,198,23-09-2019 18:14:00,0,2345.0,1669.0,0.712,11.088,0,0,0,0,0,0,0,0,0.0,0.0
1002,199,23-09-2019 18:16:00,0,2143.0,1569.0,0.732,10.182,0,0,0,0,0,0,0,0,0.0,0.0
1002,200,23-09-2019 18:18:00,0,2437.0,1763.0,0.723,11.555,342,153,115,38,189,174,15,8,0.0,0.0
1002,201,23-09-2019 18:20:00,0,2860.0,2049.0,0.716,13.538,438,182,140,42,256,231,25,25,0.0,0.0
1002,202,23-09-2019 18:22:00,0,3194.0,2153.0,0.674,14.968,672,206,169,37,466,414,52,38,0.0,0.0
1002,203,23-09-2019 18:24:00,0,3144.0,2304.0,0.733,14.938,382,135,105,30,247,210,37,18,0.0,0.0
1002,204,23-09-2019 18:26:00,0,2143.0,1586.0,0.74,10.198,352,89,61,28,263,237,26,23,0.0,0.0
1002,205,23-09-2019 18:28:00,0,3022.5,2137.0,0.7145,14.2745,485,157,122,35,328,288,40,30,0.0,0.0
1002,206,23-09-2019 18:30:00,0,3902.0,2688.0,0.689,18.351,259,139,104,35,120,101,19,42,0.0,0.0
1002,207,23-09-2019 18:32:00,0,3496.0,2389.0,0.683,16.421,391,132,96,36,259,233,26,36,0.0,0.0
1002,208,23-09-2019 18:34:00,0,3684.0,2616.0,0.71,17.411,192,117,80,37,75,69,6,41,0.0,0.0
1002,209,23-09-2019 18:36:00,0,3370.0,2429.0,0.721,15.968,184,101,68,33,83,77,6,12,0.0,0.0
1002,210,23-09-2019 18:38:00,0,3671.0,2599.0,0.708,17.343,66,64,33,31,2,2,0,0,0.0,0.0
1002,211,23-09-2019 18:40:00,0,3895.0,2751.0,0.706,18.393,466,209,158,51,257,226,31,68,0.0,0.0
1002,212,23-09-2019 18:42:00,0,3889.0,2752.0,0.708,18.371,449,202,158,44,247,213,34,41,0.0,0.0
1002,213,23-09-2019 18:44:00,0,3884.0,2705.0,0.696,18.299,260,122,85,37,138,127,11,39,0.0,0.0
1002,214,23-09-2019 18:46:00,0,3677.0,2680.0,0.729,17.457,186,89,52,37,97,90,7,17,0.0,0.0
1002,215,23-09-2019 18:48:00,0,3955.0,2941.0,0.744,18.839,285,125,89,36,160,149,11,28,0.0,0.0
1002,216,23-09-2019 18:50:00,0,3346.0,2506.0,0.749,15.956,302,61,27,34,241,224,17,5,0.0,0.0
1002,217,23-09-2019 18:52:00,0,3567.0,2588.0,0.726,16.917,126,63,29,34,63,55,8,0,0.0,0.0
1002,218,23-09-2019 18:54:00,0,3361.0,2460.0,0.732,15.965,85,59,18,41,26,23,3,0,0.0,0.0
1002,219,23-09-2019 18:56:00,0,3441.0,2619.0,0.761,16.457,209,82,62,20,127,117,10,15,0.0,0.0
1002,220,23-09-2019 18:58:00,0,3765.0,2765.0,0.735,17.896,171,84,58,26,87,84,3,25,0.0,0.0
1002,221,23-09-2019 19:00:00,0,3833.0,2933.0,0.765,18.35,276,112,83,29,164,153,11,27,0.0,0.0
1002,222,23-09-2019 19:02:00,0,3835.5,2922.5,0.762,18.3475,358,67,45,22,291,270,21,44,0.0,0.0
1002,223,23-09-2019 19:04:00,0,3838.0,2912.0,0.759,18.345,340,47,15,32,293,284,9,40,0.0,0.0
1002,224,23-09-2019 19:06:00,0,3545.0,2697.0,0.761,16.953,238,89,59,30,149,142,7,7,0.0,0.0
1002,225,23-09-2019 19:08:00,0,3352.0,2461.0,0.734,15.932,143,46,22,24,97,87,10,0,0.0,0.0
1002,226,23-09-2019 19:10:00,0,3544.0,2667.0,0.753,16.915,475,121,87,34,354,324,30,55,0.0,0.0
1002,227,23-09-2019 19:12:00,0,4037.0,3078.0,0.762,19.313,296,117,83,34,179,167,12,56,0.0,0.0
1002,228,23-09-2019 19:14:00,0,3994.0,3255.0,0.815,19.34,270,80,52,28,190,177,13,34,0.0,0.0
1002,229,23-09-2019 19:16:00,0,3128.0,2400.0,0.767,14.983,223,114,81,33,109,100,9,9,0.0,0.0
1002,230,23-09-2019 19:18:00,0,3128.0,2417.0,0.773,15.001,406,179,142,37,227,203,24,35,0.0,0.0
1002,231,23-09-2019 19:20:00,0,3834.0,2962.0,0.772,18.386,364,141,107,34,223,202,21,82,0.0,0.0
1002,232,23-09-2019 19:22:00,0,3801.0,3025.0,0.796,18.324,448,181,136,45,267,239,28,51,0.0,0.0
1002,233,23-09-2019 19:24:00,0,4006.0,3242.0,0.809,19.374,177,103,72,31,74,67,7,16,0.0,0.0
1002,234,23-09-2019 19:26:00,0,3921.0,3133.0,0.799,18.919,343,173,134,39,170,153,17,18,0.0,0.0
1002,235,23-09-2019 19:28:00,0,3509.0,2830.0,0.807,16.958,283,92,49,43,191,171,20,0,0.0,0.0
1002,236,23-09-2019 19:30:00,0,3789.0,3125.0,0.825,18.389,113,70,39,31,43,39,4,0,0.0,0.0
1002,237,23-09-2019 19:32:00,0,4014.0,3241.0,0.807,19.403,111,58,34,24,53,51,2,23,0.0,0.0
1002,238,23-09-2019 19:34:00,0,3787.0,3148.0,0.831,18.405,358,147,109,38,211,197,14,35,0.0,0.0
1002,239,23-09-2019 19:36:00,0,3804.5,3058.0,0.804,18.3755,355,116,85,31,239,213,26,37,0.0,0.0
1002,240,23-09-2019 19:38:00,0,3822.0,2968.0,0.777,18.346,120,86,48,38,34,30,4,9,0.0,0.0
1002,241,23-09-2019 19:40:00,0,3518.0,2799.0,0.795,16.961,256,98,73,25,158,141,17,45,0.0,0.0
1002,242,23-09-2019 19:42:00,0,3613.0,2885.0,0.798,17.428,299,107,77,30,192,173,19,23,0.0,0.0
1002,243,23-09-2019 19:44:00,0,3830.0,2975.0,0.777,18.386,333,59,30,29,274,260,14,47,0.0,0.0
1002,244,23-09-2019 19:46:00,0,4043.0,3139.0,0.777,19.404,392,76,51,25,316,297,19,50,0.0,0.0
1002,245,23-09-2019 19:48:00,0,3726.0,2887.0,0.775,17.878,230,100,75,25,130,124,6,24,0.0,0.0
1002,246,23-09-2019 19:50:00,0,3912.0,3152.0,0.806,18.902,191,61,40,21,130,119,11,18,0.0,0.0
1002,247,23-09-2019 19:52:00,0,3506.0,2798.0,0.798,16.91,31,3,2,1,28,24,4,0,0.0,0.0
1002,248,23-09-2019 19:54:00,0,3308.0,2658.0,0.804,15.975,17,9,5,4,8,8,0,0,0.0,0.0
1002,249,23-09-2019 19:56:00,0,3127.0,2424.0,0.775,15.006,7,2,2,0,5,4,1,0,0.0,0.0
1002,250,23-09-2019 19:58:00,0,3131.0,2379.0,0.76,14.971,182,88,54,34,94,92,2,35,0.0,0.0
1002,251,23-09-2019 20:00:00,0,3283.0,2743.0,0.836,15.971,484,145,100,45,339,312,27,50,0.0,0.01
1002,252,23-09-2019 20:02:00,0,3314.0,2620.0,0.791,15.956,303,100,68,32,203,186,17,39,0.0,0.0
1002,253,23-09-2019 20:04:00,0,3304.0,2639.0,0.799,15.941,537,206,157,49,331,299,32,20,0.0,0.0
1002,254,23-09-2019 20:06:00,0,3110.0,2498.0,0.803,15.021,184,87,51,36,97,90,7,23,0.0,0.0
1002,255,23-09-2019 20:08:00,0,3498.0,2807.0,0.802,16.891,108,37,19,18,71,70,1,13,0.0,0.0
1002,256,23-09-2019 20:10:00,0,3494.0,2830.5,0.81,16.902,221,127,80,47,94,88,6,30,0.0,0.0
1002,257,23-09-2019 20:12:00,0,3490.0,2854.0,0.818,16.913,384,134,99,35,250,221,29,13,0.01,0.01
1002,258,23-09-2019 20:14:00,0,3088.0,2555.0,0.828,14.995,224,107,80,27,117,109,8,78,0.0,0.0
1002,259,23-09-2019 20:16:00,0,3797.0,3107.0,0.818,18.402,151,109,63,46,42,40,2,45,0.0,0.0
1002,260,23-09-2019 20:18:00,0,3982.0,3270.0,0.821,19.309,227,109,66,43,118,111,7,48,0.0,0.0
1002,261,23-09-2019 20:20:00,0,3776.0,3188.0,0.844,18.409,393,156,120,36,237,217,20,95,0.0,0.07
1002,262,23-09-2019 20:22:00,0,3293.0,2686.0,0.816,15.948,515,240,189,51,275,245,30,177,0.0,0.0
1002,263,23-09-2019 20:24:00,0,3712.0,2958.0,0.797,17.901,255,126,93,33,129,111,18,9,0.0,0.01
1002,264,23-09-2019 20:26:00,0,3372.0,2851.0,0.846,16.441,724,259,212,47,465,419,46,22,0.0,0.0
1002,265,23-09-2019 20:28:00,0,3277.0,2724.0,0.831,15.927,427,190,158,32,237,211,26,40,0.05,0.07
1002,266,23-09-2019 20:30:00,0,3500.0,2885.0,0.824,16.984,131,91,50,41,40,35,5,2,0.03,0.0
1002,267,23-09-2019 20:32:00,0,3774.0,3173.0,0.841,18.384,405,168,124,44,237,216,21,29,0.0,0.0
1002,268,23-09-2019 20:34:00,0,3762.0,3193.0,0.849,18.358,265,95,54,41,170,160,10,56,0.0,0.0
1002,269,23-09-2019 20:36:00,0,3958.0,3467.0,0.876,19.432,286,89,57,32,197,185,12,61,0.0,0.0
1002,270,23-09-2019 20:38:00,0,4170.0,3571.0,0.856,20.384,465,154,117,37,311,281,30,103,0.0,0.0
1002,271,23-09-2019 20:40:00,0,3267.0,2811.0,0.86,15.982,336,138,89,49,198,181,17,54,0.01,0.0
1002,272,23-09-2019 20:42:00,0,3941.0,3398.0,0.862,19.291,109,49,33,16,60,56,4,9,0.0,0.0
1002,273,23-09-2019 20:44:00,0,3238.0,2670.5,0.814,15.714,44,2,0,2,42,37,5,0,0.0,0.0
1002,274,23-09-2019 20:46:00,0,2535.0,1943.0,0.766,12.137,10,1,0,1,9,7,2,0,0.0,0.0
1002,275,23-09-2019 20:48:00,0,2520.0,1943.0,0.771,12.079,27,5,2,3,22,20,2,0,0.0,0.0
1002,276,23-09-2019 20:50:00,0,2489.0,2072.0,0.832,12.101,56,30,18,12,26,25,1,7,0.0,0.0
1002,277,23-09-2019 20:52:00,0,3163.0,2744.0,0.868,15.502,142,82,42,40,60,59,1,37,0.0,0.0
1002,278,23-09-2019 20:54:00,0,3871.0,3322.0,0.858,18.93,407,186,126,60,221,205,16,53,0.0,0.0
1002,279,23-09-2019 20:56:00,0,4149.0,3657.0,0.881,20.397,277,109,62,47,168,161,7,60,0.0,0.05
1002,280,23-09-2019 20:58:00,0,3537.0,3103.0,0.877,17.372,563,248,200,48,315,283,32,106,0.0,0.0
1002,281,23-09-2019 21:00:00,0,3175.0,2727.0,0.859,15.529,407,152,113,39,255,226,29,84,0.0,0.0
1002,282,23-09-2019 21:02:00,0,3843.0,3374.0,0.878,18.875,182,96,63,33,86,81,5,51,0.0,0.03
1002,283,23-09-2019 21:04:00,0,3528.0,3161.0,0.896,17.398,757,203,150,53,554,508,46,26,0.06,0.0
1002,284,23-09-2019 21:06:00,0,3751.0,3296.0,0.879,18.426,437,187,142,45,250,225,25,24,0.08,0.04
1002,285,23-09-2019 21:08:00,0,3994.0,3682.0,0.922,19.811,356,133,93,40,223,203,20,51,0.01,0.06
1002,286,23-09-2019 21:10:00,0,4029.0,3656.0,0.908,19.922,193,102,65,37,91,87,4,43,0.0,0.0
1002,287,23-09-2019 21:12:00,0,3810.0,3473.0,0.912,18.854,369,164,127,37,205,182,23,143,0.0,0.0
1002,288,23-09-2019 21:14:00,0,3875.0,3299.0,0.851,18.921,370,122,84,38,248,226,22,33,0.01,0.0
1002,289,23-09-2019 21:16:00,0,3520.0,3175.0,0.902,17.382,195,99,67,32,96,84,12,11,0.0,0.0
1002,290,23-09-2019 21:18:00,0,3929.0,3484.5,0.888,19.337,228,78,46,32,150,142,8,43,0.0,0.0
1002,291,23-09-2019 21:20:00,0,4338.0,3794.0,0.874,21.292,178,98,64,34,80,78,2,61,0.0,0.0
1002,292,23-09-2019 21:22:00,0,4633.0,4027.0,0.869,22.713,183,99,59,40,84,77,7,41,0.0,0.0
1002,293,23-09-2019 21:24:00,0,3948.0,3483.0,0.882,19.41,329,141,103,38,188,169,19,107,0.0,0.02
1002,294,23-09-2019 21:26:00,0,3987.0,3263.0,0.818,19.319,313,108,66,42,205,187,18,5,0.12,0.0
1002,295,23-09-2019 21:28:00,0,3918.0,3529.0,0.901,19.343,423,170,113,57,253,225,28,50,0.0,0.0
1002,296,23-09-2019 21:30:00,0,4124.0,3672.0,0.89,20.313,187,105,72,33,82,80,2,68,0.0,0.0
1002,297,23-09-2019 21:32:00,0,4252.0,3738.0,0.879,20.891,230,103,67,36,127,121,6,54,0.0,0.0
1002,298,23-09-2019 21:34:00,0,4119.0,3702.0,0.899,20.327,215,113,66,47,102,100,2,59,0.01,0.0
1002,299,23-09-2019 21:36:00,0,4755.0,4086.0,0.859,23.258,303,114,68,46,189,171,18,18,0.04,0.11
1002,300,23-09-2019 21:38:00,0,3641.0,3227.0,0.886,17.918,346,149,109,40,197,179,18,50,0.06,0.0
1002,301,23-09-2019 21:40:00,0,3455.0,3026.0,0.876,16.963,92,58,34,24,34,31,3,0,0.0,0.0
1002,302,23-09-2019 21:42:00,0,3463.0,2984.0,0.862,16.948,238,150,105,45,88,81,7,32,0.0,0.0
1002,303,23-09-2019 21:44:00,0,3950.0,3442.0,0.871,19.374,562,159,116,43,403,361,42,38,0.11,0.0
1002,304,23-09-2019 21:46:00,0,4327.0,3837.0,0.887,21.297,238,121,78,43,117,112,5,55,0.0,0.0
1002,305,23-09-2019 21:48:00,0,4638.0,4041.0,0.871,22.748,251,134,93,41,117,115,2,54,0.0,0.0
1002,306,23-09-2019 21:50:00,0,4857.0,4196.0,0.864,23.784,229,130,83,47,99,97,2,49,0.01,0.0
1002,307,23-09-2019 21:52:00,0,4641.0,4059.0,0.875,22.78,208,94,49,45,114,110,4,50,0.0,0.06
1002,308,23-09-2019 21:54:00,0,4425.0,3922.0,0.886,21.776,501,222,173,49,279,259,20,50,0.22,0.01
1002,309,23-09-2019 21:56:00,0,3953.0,3421.0,0.865,19.364,602,263,200,63,339,297,42,76,0.0,0.02
1002,310,23-09-2019 21:58:00,0,3645.0,3216.0,0.882,17.922,370,145,96,49,225,211,14,66,0.0,0.1
1002,311,23-09-2019 22:00:00,0,4111.0,3743.0,0.91,20.34,261,123,78,45,138,132,6,52,0.0,0.0
1002,312,23-09-2019 22:02:00,0,4019.0,3642.0,0.906,19.867,156,60,30,30,96,87,9,0,0.0,0.0
1002,313,23-09-2019 22:04:00,0,4311.0,3884.0,0.901,21.286,195,99,60,39,96,88,8,11,0.0,0.0
1002,314,23-09-2019 22:06:00,0,4431.0,3913.0,0.883,21.788,185,93,52,41,92,90,2,46,0.0,0.0
1002,315,23-09-2019 22:08:00,0,4912.0,4416.0,0.899,24.241,211,77,43,34,134,127,7,51,0.0,0.0
1002,316,23-09-2019 22:10:00,0,4610.0,4137.0,0.897,22.745,414,145,101,44,269,248,21,46,0.07,0.0
1002,317,23-09-2019 22:12:00,0,4647.0,4012.0,0.863,22.752,572,189,140,49,383,353,30,26,0.05,0.0
1002,318,23-09-2019 22:14:00,0,3256.0,2822.0,0.867,15.952,158,93,52,41,65,61,4,0,0.0,0.0
1002,319,23-09-2019 22:16:00,0,3914.0,3587.0,0.916,19.394,346,188,138,50,158,140,18,135,0.0,0.01
1002,320,23-09-2019 22:18:00,0,4220.0,3732.0,0.884,20.757,381,131,93,38,250,220,30,44,0.0,0.0
1002,321,23-09-2019 22:20:00,0,3948.0,3436.0,0.87,19.359,321,168,126,42,153,135,18,21,0.0,0.0
1002,322,23-09-2019 22:22:00,0,3524.0,3201.0,0.909,17.428,375,170,125,45,205,186,19,60,0.0,0.0
1002,323,23-09-2019 22:24:00,0,4621.0,4095.0,0.886,22.742,201,107,68,39,94,93,1,46,0.0,0.0
1002,324,23-09-2019 22:26:00,0,4575.5,4056.5,0.8865,22.519,198,95,56,39,103,101,2,51,0.0,0.0
1002,325,23-09-2019 22:28:00,0,4530.0,4018.0,0.887,22.296,205,93,54,39,112,106,6,52,0.0,0.04
1002,326,23-09-2019 22:30:00,0,4015.0,3641.0,0.907,19.849,142,71,44,27,71,63,8,0,0.1,0.0
1002,327,23-09-2019 22:32:00,0,3449.0,3047.0,0.883,16.962,205,71,37,34,134,129,5,35,0.0,0.0
1002,328,23-09-2019 22:34:00,0,4324.0,3909.0,0.904,21.364,189,100,60,40,89,88,1,49,0.0,0.03
1002,329,23-09-2019 22:36:00,0,4905.0,4397.0,0.897,24.193,195,121,77,44,74,73,1,50,0.0,0.06
1002,330,23-09-2019 22:38:00,0,4638.0,4049.0,0.873,22.758,511,170,137,33,341,311,30,138,0.14,0.05
1002,331,23-09-2019 22:40:00,0,4727.0,4167.0,0.881,23.239,556,190,142,48,366,306,60,41,0.05,0.0
1002,332,23-09-2019 22:42:00,0,3631.0,3260.0,0.898,17.914,410,155,118,37,255,208,47,20,0.0,0.0
1002,333,23-09-2019 22:44:00,0,3620.0,3337.0,0.922,17.957,207,93,50,43,114,99,15,8,0.0,0.0
1002,334,23-09-2019 22:46:00,0,3174.0,2710.0,0.854,15.508,506,141,96,45,365,334,31,17,0.0,0.0
1002,335,23-09-2019 22:48:00,0,3556.0,3083.0,0.867,17.424,441,197,146,51,244,220,24,49,0.0,0.0
1002,336,23-09-2019 22:50:00,0,4844.0,4201.0,0.867,23.735,197,117,63,54,80,79,1,57,0.01,0.02
1002,337,23-09-2019 22:52:00,0,5005.0,4461.0,0.891,24.66,206,118,76,42,88,85,3,51,0.0,0.03
1002,338,23-09-2019 22:54:00,0,4734.0,4189.0,0.885,23.291,386,159,115,44,227,204,23,74,0.0,0.02
1002,339,23-09-2019 22:56:00,0,5002.0,4485.0,0.897,24.673,217,89,53,36,128,118,10,50,0.0,0.05
1002,340,23-09-2019 22:58:00,0,4997.0,4469.0,0.894,24.638,262,113,71,42,149,133,16,14,0.07,0.04
1002,341,23-09-2019 23:00:00,0,4905.5,4382.5,0.893,24.181,337,124,79,45,213,190,23,20,0.06,0.02
1002,342,23-09-2019 23:02:00,0,4814.0,4296.0,0.892,23.724,489,195,152,43,294,248,46,18,0.0,0.0
1002,343,23-09-2019 23:04:00,0,4032.0,3598.0,0.893,19.869,474,193,144,49,281,227,54,42,0.0,0.0
1002,344,23-09-2019 23:06:00,0,3426.0,3066.0,0.895,16.893,506,168,131,37,338,282,56,30,0.04,0.0
1002,345,23-09-2019 23:08:00,0,4896.0,4408.0,0.9,24.171,210,86,55,31,124,78,46,38,0.01,0.0
1002,346,23-09-2019 23:10:00,0,5050.0,4746.0,0.94,25.153,222,79,50,29,143,79,64,48,0.0,0.01
1002,347,23-09-2019 23:12:00,0,4981.0,4550.0,0.914,24.664,285,65,27,38,220,147,73,51,0.0,0.01
1002,348,23-09-2019 23:14:00,0,5279.0,4938.0,0.935,26.265,385,93,63,30,292,210,82,63,0.0,0.05
1002,349,23-09-2019 23:16:00,0,4293.0,3935.0,0.917,21.271,234,80,42,38,154,89,65,56,0.06,0.0
1002,350,23-09-2019 23:18:00,0,4732.0,4233.0,0.895,23.329,219,60,29,31,159,101,58,50,0.0,0.06
1002,351,23-09-2019 23:20:00,0,4524.0,4055.0,0.896,22.313,359,152,110,42,207,134,73,34,0.01,0.06
1002,352,23-09-2019 23:22:00,0,4698.0,4239.0,0.902,23.201,380,170,130,40,210,151,59,17,0.09,0.0
1002,353,23-09-2019 23:24:00,0,4498.0,4106.0,0.913,22.268,379,171,129,42,208,149,59,28,0.0,0.0
1002,354,23-09-2019 23:26:00,0,3232.0,2900.0,0.897,15.945,287,92,46,46,195,173,22,1,0.0,0.03
1002,355,23-09-2019 23:28:00,0,3763.0,3258.0,0.866,18.434,522,191,142,49,331,288,43,47,0.0,0.0
1002,356,23-09-2019 23:30:00,0,4095.0,3727.0,0.91,20.261,152,80,48,32,72,68,4,73,0.0,0.0
1002,357,23-09-2019 23:32:00,0,4786.0,4360.0,0.911,23.683,149,84,54,30,65,61,4,52,0.0,0.02
1002,358,23-09-2019 23:34:00,0,4451.0,4056.5,0.9115,22.028,131,53,27,26,78,75,3,50,0.0,0.07
1002,359,23-09-2019 23:36:00,0,4116.0,3753.0,0.912,20.373,221,87,56,31,134,120,14,22,0.12,0.02
1002,360,23-09-2019 23:38:00,0,3923.0,3508.0,0.894,19.342,706,279,216,63,427,372,55,145,0.07,0.0
1002,361,23-09-2019 23:40:00,0,4614.0,4123.0,0.894,22.745,441,164,125,39,277,245,32,35,0.0,0.05
1002,362,23-09-2019 23:42:00,0,4902.0,4414.0,0.9,24.199,225,54,35,19,171,146,25,2,0.0,0.08
1002,363,23-09-2019 23:44:00,0,4711.0,4220.0,0.896,23.232,162,21,10,11,141,132,9,0,0.0,0.0
1002,364,23-09-2019 23:46:00,0,4316.0,4005.0,0.928,21.437,353,130,88,42,223,208,15,41,0.0,0.0
1002,365,23-09-2019 23:48:00,0,4290.0,3973.0,0.926,21.301,555,174,133,41,381,347,34,17,0.0,0.0
1002,366,23-09-2019 23:50:00,0,3048.0,2666.0,0.875,14.961,347,126,92,34,221,196,25,30,0.0,0.0
1002,367,23-09-2019 23:52:00,0,4828.0,4285.0,0.888,23.764,102,57,23,34,45,44,1,68,0.0,0.0
1002,368,23-09-2019 23:54:00,0,4511.0,4034.0,0.894,22.241,109,65,30,35,44,41,3,52,0.0,0.0
1002,369,23-09-2019 23:56:00,0,4423.0,4010.0,0.906,21.867,175,76,47,29,99,93,6,62,0.0,0.06
1002,370,23-09-2019 23:58:00,0,4786.0,4382.0,0.916,23.706,175,49,33,16,126,97,29,2,0.11,0.02
1002,371,24-09-2019 00:00:00,0,3933.0,3482.0,0.885,19.352,448,193,158,35,255,219,36,89,0.0,0.0
1002,372,24-09-2019 00:02:00,0,4596.0,4214.0,0.917,22.776,525,218,173,45,307,263,44,73,0.0,0.0
1002,373,24-09-2019 00:04:00,0,4616.0,4107.0,0.89,22.732,617,210,163,47,407,347,60,79,0.07,0.0
1002,374,24-09-2019 00:06:00,0,4417.0,3941.0,0.892,21.767,221,100,70,30,121,104,17,53,0.0,0.0
1002,375,24-09-2019 00:08:00,0,4555.5,4085.5,0.8965,22.4715,41,15,11,4,26,25,1,5,0.0,0.36
1002,376,24-09-2019 00:10:00,0,4694.0,4230.0,0.901,23.176,13,0,0,0,13,2,11,0,0.01,0.01
1002,377,24-09-2019 00:12:00,0,4783.0,4422.0,0.924,23.739,515,184,141,43,331,258,73,85,0.11,0.0
1002,378,24-09-2019 00:14:00,0,4591.0,4259.0,0.928,22.803,518,202,161,41,316,253,63,59,0.0,0.0
1002,379,24-09-2019 00:16:00,0,3919.0,3543.0,0.904,19.362,564,267,211,56,297,225,72,47,0.0,0.03
1002,380,24-09-2019 00:18:00,0,3989.0,3713.0,0.931,19.827,520,232,168,64,288,207,81,80,0.0,0.0
1002,381,24-09-2019 00:20:00,0,4497.0,4082.0,0.908,22.239,444,174,130,44,270,200,70,54,0.0,0.02
1002,382,24-09-2019 00:22:00,0,3421.0,3140.0,0.918,16.957,437,164,123,41,273,233,40,8,0.0,0.0
1002,383,24-09-2019 00:24:00,0,2981.0,2542.0,0.853,14.561,718,230,176,54,488,437,51,15,0.0,0.0
1002,384,24-09-2019 00:26:00,0,3991.0,3741.0,0.937,19.865,693,197,154,43,496,442,54,83,0.14,0.0
1002,385,24-09-2019 00:28:00,0,4770.0,4397.0,0.922,23.661,468,199,164,35,269,226,43,107,0.08,0.0
1002,386,24-09-2019 00:30:00,0,4692.0,4295.0,0.915,23.24,322,143,108,35,179,121,58,2,0.0,0.0
1002,387,24-09-2019 00:32:00,0,4621.0,4103.0,0.888,22.749,282,102,70,32,180,124,56,65,0.0,0.0
1002,388,24-09-2019 00:34:00,0,3938.0,3507.0,0.89,19.399,367,169,128,41,198,153,45,49,0.0,0.0
1002,389,24-09-2019 00:36:00,0,3990.0,3739.0,0.937,19.86,140,59,38,21,81,32,49,11,0.0,0.0
1002,390,24-09-2019 00:38:00,0,2562.0,2262.0,0.883,12.599,360,209,157,52,151,103,48,1,0.0,0.0
1002,391,24-09-2019 00:40:00,0,4772.0,4395.0,0.921,23.668,325,118,78,40,207,156,51,0,0.0,0.0
1002,392,24-09-2019 00:42:00,0,4006.5,3647.5,0.908,19.8235,543,198,143,55,345,262,83,14,0.0,0.0
1002,393,24-09-2019 00:44:00,0,3241.0,2900.0,0.895,15.979,417,153,102,51,264,190,74,31,0.11,0.0
1002,394,24-09-2019 00:46:00,0,4510.0,4088.0,0.906,22.297,447,146,112,34,301,233,68,4,0.0,0.0
1002,395,24-09-2019 00:48:00,0,3658.0,3175.0,0.868,17.93,355,149,105,44,206,148,58,22,0.0,0.03
1002,396,24-09-2019 00:50:00,0,5050.0,4835.0,0.957,25.25,129,39,17,22,90,62,28,0,0.06,0.0
1002,397,24-09-2019 00:52:00,0,5424.0,5119.0,0.944,27.039,358,176,135,41,182,141,41,7,0.01,0.0
1002,398,24-09-2019 00:54:00,0,4873.0,4597.0,0.943,24.288,336,122,90,32,214,151,63,7,0.0,0.0
1002,399,24-09-2019 00:56:00,0,3281.0,2763.0,0.842,15.987,374,158,112,46,216,159,57,25,0.0,0.0
1002,400,24-09-2019 00:58:00,0,5477.0,5033.0,0.919,27.152,355,130,93,37,225,170,55,42,0.01,0.0
1002,401,24-09-2019 01:00:00,0,3839.0,3401.0,0.886,18.891,373,165,118,47,208,162,46,40,0.05,0.0
1002,402,24-09-2019 01:02:00,0,4954.0,4701.0,0.949,24.722,318,165,122,43,153,116,37,23,0.01,0.0
1002,403,24-09-2019 01:04:00,0,5250.0,4972.0,0.947,26.19,428,184,131,53,244,179,65,16,0.0,0.0
1002,404,24-09-2019 01:06:00,0,5045.0,4835.0,0.958,25.229,303,138,102,36,165,122,43,31,0.0,0.0
1002,405,24-09-2019 01:08:00,0,5337.0,5008.0,0.938,26.571,324,151,109,42,173,130,43,11,0.0,0.0
1002,406,24-09-2019 01:10:00,0,5617.0,5411.0,0.963,28.122,532,191,143,48,341,259,82,36,0.0,0.0
1002,407,24-09-2019 01:12:00,0,4763.0,4490.0,0.943,23.737,506,167,125,42,339,281,58,43,0.0,0.0
1002,408,24-09-2019 01:14:00,0,4930.0,4744.0,0.962,24.675,548,157,111,46,391,310,81,14,0.12,0.0
1002,409,24-09-2019 01:16:00,0,5098.5,4839.0,0.9495,25.445,275,119,82,37,156,109,47,35,0.0,0.0
1002,410,24-09-2019 01:18:00,0,5267.0,4934.0,0.937,26.215,206,52,30,22,154,125,29,0,0.04,0.0
1002,411,24-09-2019 01:20:00,0,5469.0,5045.0,0.922,27.134,123,70,50,20,53,39,14,56,0.0,0.0
1002,412,24-09-2019 01:22:00,0,4384.0,4072.0,0.929,21.783,363,191,143,48,172,120,52,24,0.0,0.0
1002,413,24-09-2019 01:24:00,0,4956.0,4656.0,0.939,24.682,218,105,62,43,113,85,28,7,0.0,0.0
1002,414,24-09-2019 01:26:00,0,4947.0,4680.0,0.946,24.674,242,186,126,60,56,40,16,6,0.0,0.0
1002,415,24-09-2019 01:28:00,0,4950.0,4705.0,0.951,24.712,246,193,130,63,53,30,23,6,0.0,0.0
1002,416,24-09-2019 01:30:00,0,4948.0,4763.0,0.963,24.768,193,97,66,31,96,59,37,28,0.0,0.0
1002,417,24-09-2019 01:32:00,0,4783.0,4429.0,0.926,23.749,583,199,148,51,384,318,66,42,0.0,0.0
1002,418,24-09-2019 01:34:00,0,4994.0,4537.0,0.909,24.698,170,55,40,15,115,99,16,4,0.0,0.0
1002,419,24-09-2019 01:36:00,0,5358.0,4953.0,0.924,26.595,302,138,105,33,164,146,18,34,0.0,0.0
1002,420,24-09-2019 01:38:00,0,4809.0,4321.0,0.898,23.733,217,51,26,25,166,140,26,3,0.0,0.0
1002,421,24-09-2019 01:40:00,0,4950.0,4744.0,0.958,24.757,232,56,34,22,176,154,22,0,0.04,0.0
1002,422,24-09-2019 01:42:00,0,4789.0,4457.0,0.931,23.803,293,97,67,30,196,166,30,64,0.02,0.0
1002,423,24-09-2019 01:44:00,0,4961.0,4662.0,0.94,24.707,412,191,147,44,221,190,31,16,0.0,0.0
1002,424,24-09-2019 01:46:00,0,4281.0,3982.0,0.93,21.276,526,215,160,55,311,282,29,36,0.0,0.0
1002,425,24-09-2019 01:48:00,0,3606.0,3367.0,0.934,17.934,668,278,202,76,390,346,44,3,0.0,0.0
1002,426,24-09-2019 01:50:00,0,4213.0,3843.0,0.915,20.854,399,178,139,39,221,198,23,34,0.0,0.0
1002,427,24-09-2019 01:52:00,0,4820.0,4319.0,0.896,23.774,445,178,131,47,267,235,32,50,0.0,0.0
1002,428,24-09-2019 01:54:00,0,5075.0,4757.0,0.937,25.264,389,201,142,59,188,135,53,10,0.04,0.0
1002,429,24-09-2019 01:56:00,0,4767.0,4379.0,0.919,23.629,87,72,47,25,15,2,13,50,0.01,0.0
1002,430,24-09-2019 01:58:00,0,4829.0,4335.0,0.898,23.825,193,107,74,33,86,63,23,17,0.0,0.0
1002,431,24-09-2019 02:00:00,0,4782.0,4453.0,0.931,23.77,101,65,41,24,36,20,16,3,0.0,0.0
1002,432,24-09-2019 02:02:00,0,4881.0,4450.0,0.912,24.158,89,33,17,16,56,32,24,0,0.0,0.0
1002,433,24-09-2019 02:04:00,0,4985.0,4554.0,0.914,24.685,45,14,9,5,31,18,13,0,0.0,0.0
1002,434,24-09-2019 02:06:00,0,4581.0,4191.0,0.915,22.688,147,56,29,27,91,65,26,3,0.0,0.0
1002,435,24-09-2019 02:08:00,0,4425.0,3986.0,0.901,21.846,389,157,117,40,232,188,44,13,0.0,0.0
1002,436,24-09-2019 02:10:00,0,3432.0,3068.0,0.894,16.919,262,140,101,39,122,103,19,64,0.0,0.0
1002,437,24-09-2019 02:12:00,0,3865.0,3327.0,0.861,18.91,222,85,49,36,137,127,10,62,0.0,0.0
1002,438,24-09-2019 02:14:00,0,4654.0,4060.0,0.872,22.832,165,58,36,22,107,98,9,34,0.01,0.0
1002,439,24-09-2019 02:16:00,0,4418.0,3935.0,0.891,21.764,231,104,64,40,127,107,20,8,0.0,0.0
1002,440,24-09-2019 02:18:00,0,4816.0,4260.0,0.884,23.693,277,124,88,36,153,137,16,30,0.0,0.0
1002,441,24-09-2019 02:20:00,0,4086.0,3805.0,0.931,20.311,150,65,31,34,85,84,1,37,0.0,0.0
1002,442,24-09-2019 02:22:00,0,4317.0,3885.0,0.9,21.31,116,49,32,17,67,61,6,43,0.0,0.0
1002,443,24-09-2019 02:24:00,0,4574.5,4040.5,0.884,22.4975,39,11,6,5,28,21,7,8,0.0,0.0
1002,444,24-09-2019 02:26:00,0,4832.0,4196.0,0.868,23.685,87,20,11,9,67,56,11,0,0.0,0.0
1002,445,24-09-2019 02:28:00,0,4728.0,4158.0,0.879,23.231,100,42,28,14,58,51,7,0,0.0,0.0
1002,446,24-09-2019 02:30:00,0,4640.0,4069.0,0.877,22.787,233,72,47,25,161,143,18,6,0.0,0.0
1002,447,24-09-2019 02:32:00,0,4297.0,3884.0,0.904,21.229,273,113,75,38,160,141,19,9,0.0,0.0
1002,448,24-09-2019 02:34:00,0,3456.0,3090.0,0.894,17.037,460,139,99,40,321,281,40,37,0.0,0.0
1002,449,24-09-2019 02:36:00,0,4817.0,4229.0,0.878,23.66,312,81,60,21,231,198,33,35,0.0,0.0
1002,450,24-09-2019 02:38:00,0,3477.0,2963.0,0.852,16.98,342,123,92,31,219,195,24,29,0.0,0.0
1002,451,24-09-2019 02:40:00,0,4316.0,3845.0,0.891,21.26,365,83,57,26,282,242,40,30,0.0,0.0
1002,452,24-09-2019 02:42:00,0,4082.0,3826.0,0.937,20.32,17,2,1,1,15,7,8,0,0.0,0.0
1002,453,24-09-2019 02:44:00,0,4135.0,3703.0,0.895,20.39,65,21,12,9,44,31,13,0,0.01,0.0
1002,454,24-09-2019 02:46:00,0,4117.0,3666.0,0.89,20.278,266,42,24,18,224,198,26,0,0.0,0.0
1002,455,24-09-2019 02:48:00,0,3914.0,3531.0,0.902,19.331,571,103,57,46,468,422,46,1,0.0,0.0
1002,456,24-09-2019 02:50:00,0,3972.0,3402.0,0.857,19.415,289,33,11,22,256,187,69,0,0.0,0.0
1002,457,24-09-2019 02:52:00,0,3660.0,3190.0,0.872,17.954,74,39,7,32,35,18,17,0,0.0,0.0
1002,458,24-09-2019 02:54:00,0,3757.0,3235.0,0.861,18.383,269,123,93,30,146,91,55,8,0.0,0.0
1002,459,24-09-2019 02:56:00,0,4547.0,3922.0,0.863,22.257,182,52,28,24,130,91,39,13,0.0,0.0
1002,460,24-09-2019 02:58:00,0,4239.0,3708.0,0.876,20.807,57,8,4,4,49,14,35,0,0.0,0.0
1002,461,24-09-2019 03:00:00,0,3931.0,3494.0,0.889,19.357,35,0,0,0,35,0,35,0,0.0,0.0
1002,462,24-09-2019 03:02:00,0,3982.0,3318.0,0.833,19.361,29,0,0,0,29,0,29,0,0.0,0.0
1002,463,24-09-2019 03:04:00,0,3746.0,3243.0,0.866,18.35,47,0,0,0,47,0,47,0,0.0,0.0
1002,464,24-09-2019 03:06:00,0,3660.0,3146.0,0.86,17.903,40,0,0,0,40,0,40,0,0.0,0.0
1002,465,24-09-2019 03:08:00,0,3437.0,3091.0,0.899,16.963,175,36,23,13,139,83,56,2,0.01,0.0
1002,466,24-09-2019 03:10:00,0,3432.0,3089.0,0.9,16.941,318,119,81,38,199,126,73,37,0.0,0.0
1002,467,24-09-2019 03:12:00,0,3463.0,2938.0,0.848,16.899,362,102,69,33,260,189,71,17,0.0,0.0
1002,468,24-09-2019 03:14:00,0,2994.0,2470.0,0.825,14.529,128,42,16,26,86,55,31,2,0.0,0.0
1002,469,24-09-2019 03:16:00,0,3283.0,2719.0,0.828,15.946,137,74,47,27,63,39,24,7,0.0,0.0
1002,470,24-09-2019 03:18:00,0,3753.0,3274.0,0.872,18.412,266,139,102,37,127,89,38,3,0.0,0.0
1002,471,24-09-2019 03:20:00,0,3549.0,3145.0,0.886,17.465,185,97,66,31,88,63,25,0,0.0,0.0
1002,472,24-09-2019 03:22:00,0,3624.0,3269.0,0.902,17.897,137,77,46,31,60,37,23,0,0.0,0.0
1002,473,24-09-2019 03:24:00,0,3640.0,3196.0,0.878,17.88,95,54,34,20,41,21,20,0,0.0,0.0
1002,474,24-09-2019 03:26:00,0,4148.0,3648.0,0.88,20.38,51,14,4,10,37,12,25,0,0.0,0.0
1002,475,24-09-2019 03:28:00,0,4808.0,4328.0,0.9,23.737,44,7,0,7,37,16,21,0,0.0,0.0
1002,476,24-09-2019 03:30:00,0,4213.0,3794.0,0.901,20.798,129,23,5,18,106,69,37,0,0.0,0.0
1002,477,24-09-2019 03:32:00,0,4112.0,3729.0,0.907,20.3295,23,0,0,0,23,12,11,0,0.0,0.0
1002,478,24-09-2019 03:34:00,0,4011.0,3664.0,0.913,19.861,51,14,6,8,37,13,24,0,0.0,0.0
1002,479,24-09-2019 03:36:00,0,3334.0,3020.0,0.906,16.478,44,17,3,14,27,7,20,0,0.0,0.0
1002,480,24-09-2019 03:38:00,0,3152.0,2795.0,0.887,15.513,22,0,0,0,22,0,22,0,0.0,0.0
1002,481,24-09-2019 03:40:00,0,3174.0,2660.0,0.838,15.449,197,92,54,38,105,55,50,0,0.0,0.04
1002,482,24-09-2019 03:42:00,0,2952.0,2605.0,0.883,14.514,59,11,3,8,48,15,33,0,0.0,0.0
1002,483,24-09-2019 03:44:00,0,3171.0,2699.0,0.851,15.48,89,37,16,21,52,20,32,0,0.0,0.0
1002,484,24-09-2019 03:46:00,0,3155.0,2758.0,0.874,15.486,80,11,3,8,69,24,45,0,0.0,0.0
1002,485,24-09-2019 03:48:00,0,3244.0,2923.0,0.901,16.017,69,7,2,5,62,24,38,0,0.0,0.0
1002,486,24-09-2019 03:50:00,0,3143.0,2817.0,0.896,15.503,321,124,77,47,197,140,57,4,0.0,0.0
1002,487,24-09-2019 03:52:00,0,3059.0,2626.0,0.858,14.959,209,111,70,41,98,55,43,8,0.0,0.0
1002,488,24-09-2019 03:54:00,0,3073.0,2632.0,0.857,15.022,139,26,10,16,113,76,37,0,0.0,0.0
1002,489,24-09-2019 03:56:00,0,3164.0,2812.0,0.889,15.579,61,22,13,9,39,11,28,0,0.0,0.0
1002,490,24-09-2019 03:58:00,0,3061.0,2630.0,0.859,14.971,80,8,2,6,72,46,26,0,0.0,0.0
1002,491,24-09-2019 04:00:00,0,3176.0,2732.0,0.86,15.537,147,56,28,28,91,51,40,0,0.0,0.0
1002,492,24-09-2019 04:02:00,0,3170.0,2711.0,0.855,15.492,308,16,4,12,292,242,50,0,0.0,0.0
1002,493,24-09-2019 04:04:00,0,3161.0,2686.0,0.85,15.428,163,20,11,9,143,94,49,0,0.0,0.0
1002,494,24-09-2019 04:06:00,0,3157.5,2715.0,0.86,15.4455,240,140,105,35,100,65,35,0,0.0,0.0
1002,495,24-09-2019 04:08:00,0,3154.0,2744.0,0.87,15.463,176,83,52,31,93,60,33,0,0.0,0.0
1002,496,24-09-2019 04:10:00,0,3346.0,2967.0,0.887,16.467,76,18,12,6,58,37,21,0,0.0,0.0
1002,497,24-09-2019 04:12:00,0,3250.0,2871.0,0.883,15.983,175,91,56,35,84,60,24,11,0.0,0.0
1002,498,24-09-2019 04:14:00,0,3147.0,2769.0,0.88,15.466,80,39,17,22,41,15,26,50,0.0,0.0
1002,499,24-09-2019 04:16:00,0,3156.0,2793.0,0.885,15.527,67,20,6,14,47,12,35,50,0.0,0.0
1002,500,24-09-2019 04:18:00,0,3132.0,2832.0,0.904,15.477,609,338,261,77,271,207,64,8,0.0,0.05
1002,501,24-09-2019 04:20:00,0,3755.0,3285.0,0.875,18.431,344,203,154,49,141,102,39,8,0.0,0.0
1002,502,24-09-2019 04:22:00,0,3141.0,2827.0,0.9,15.505,376,183,132,51,193,138,55,16,0.0,0.0
1002,503,24-09-2019 04:24:00,0,3770.0,3198.0,0.848,18.396,198,83,56,27,115,75,40,66,0.0,0.0
1002,504,24-09-2019 04:26:00,0,3838.0,3412.0,0.889,18.899,118,42,19,23,76,37,39,41,0.0,0.0
1002,505,24-09-2019 04:28:00,0,3946.0,3460.0,0.877,19.376,127,52,30,22,75,44,31,63,0.0,0.03
1002,506,24-09-2019 04:30:00,0,4008.0,3698.0,0.923,19.886,150,53,34,19,97,82,15,6,0.0,0.1
1002,507,24-09-2019 04:32:00,0,4456.0,3815.0,0.856,21.781,0,0,0,0,0,0,0,0,0.0,0.0
1002,508,24-09-2019 04:34:00,0,4047.0,3464.0,0.856,19.78,0,0,0,0,0,0,0,0,0.0,0.0
1002,509,24-09-2019 04:36:00,0,3836.0,3376.0,0.88,18.849,163,57,30,27,106,85,21,3,0.0,0.0
1002,510,24-09-2019 04:38:00,0,3767.0,3214.0,0.853,18.4,76,58,29,29,18,17,1,24,0.0,0.0
1002,511,24-09-2019 04:40:00,0,3572.0,3030.0,0.848,17.428,22,14,5,9,8,8,0,0,0.0,0.0
1002,512,24-09-2019 04:42:00,0,3377.0,2846.0,0.843,16.456,0,0,0,0,0,0,0,0,0.0,0.0
1002,513,24-09-2019 04:44:00,0,3151.0,2792.0,0.886,15.506,0,0,0,0,0,0,0,0,0.0,0.0
1002,514,24-09-2019 04:46:00,0,3174.0,2727.0,0.859,15.525,56,34,19,15,22,21,1,0,0.0,0.0
1002,515,24-09-2019 04:48:00,0,3166.0,2722.0,0.86,15.488,104,67,38,29,37,35,2,10,0.0,0.0
1002,516,24-09-2019 04:50:00,0,3356.0,2978.0,0.887,16.52,366,100,69,31,266,231,35,51,0.0,0.0
1002,517,24-09-2019 04:52:00,0,3880.0,3261.0,0.841,18.899,380,127,83,44,253,231,22,1,0.0,0.0
1002,518,24-09-2019 04:54:00,0,3557.0,3110.0,0.874,17.458,108,53,39,14,55,43,12,11,0.0,0.0
1002,519,24-09-2019 04:56:00,0,3844.0,3318.0,0.863,18.82,116,7,3,4,109,98,11,0,0.0,0.0
1002,520,24-09-2019 04:58:00,0,3846.0,3420.0,0.889,18.938,185,102,66,36,83,52,31,0,0.0,0.0
1002,521,24-09-2019 05:00:00,0,3186.0,2646.0,0.83,15.482,114,33,19,14,81,46,35,1,0.0,0.0
1002,522,24-09-2019 05:02:00,0,3100.0,2569.0,0.829,15.059,1065,635,508,127,430,315,115,3,0.0,0.0
1002,523,24-09-2019 05:04:00,0,3340.0,2983.0,0.893,16.461,362,237,173,64,125,95,30,56,0.0,0.0
1002,524,24-09-2019 05:06:00,0,3194.0,2620.0,0.82,15.486,16,14,10,4,2,1,1,0,0.0,0.0
1002,525,24-09-2019 05:08:00,0,2481.0,2075.0,0.836,12.074,54,24,14,10,30,6,24,0,0.0,0.0
1002,526,24-09-2019 05:10:00,0,2410.0,1924.0,0.798,11.627,47,0,0,0,47,0,47,0,0.0,0.0
1002,527,24-09-2019 05:12:00,0,2483.0,2062.0,0.831,12.065,223,127,82,45,96,53,43,0,0.0,0.02
1002,528,24-09-2019 05:14:00,0,3075.0,2601.0,0.8435,14.9945,97,51,26,25,46,25,21,0,0.0,0.0
1002,529,24-09-2019 05:16:00,0,3667.0,3140.0,0.856,17.924,10,0,0,0,10,0,10,0,0.0,0.0
1002,530,24-09-2019 05:18:00,0,3454.0,2981.0,0.863,16.909,9,0,0,0,9,0,9,0,0.0,0.0
1002,531,24-09-2019 05:20:00,0,3372.0,2878.0,0.854,16.472,5,0,0,0,5,0,5,0,0.01,0.0
1002,532,24-09-2019 05:22:00,0,3161.0,2756.0,0.872,15.504,3,0,0,0,3,0,3,0,0.0,0.0
1002,533,24-09-2019 05:24:00,0,3191.0,2650.0,0.83,15.507,1,0,0,0,1,0,1,0,0.0,0.0
1002,534,24-09-2019 05:26:00,0,3204.0,2585.0,0.807,15.485,36,17,13,4,19,11,8,0,0.0,0.0
1002,535,24-09-2019 05:28:00,0,3276.0,2769.0,0.845,15.972,60,46,25,21,14,8,6,0,0.0,0.0
1002,536,24-09-2019 05:30:00,0,3102.0,2543.0,0.82,15.039,22,21,7,14,1,0,1,0,0.0,0.0
1002,537,24-09-2019 05:32:00,0,3201.0,2615.0,0.817,15.507,97,94,62,32,3,2,1,0,0.0,0.0
1002,538,24-09-2019 05:34:00,0,3199.0,2563.0,0.801,15.444,4,4,0,4,0,0,0,0,0.0,0.02
1002,539,24-09-2019 05:36:00,0,3211.0,2526.0,0.787,15.449,0,0,0,0,0,0,0,0,0.0,0.0
1002,540,24-09-2019 05:38:00,0,3009.0,2442.0,0.811,14.56,0,0,0,0,0,0,0,0,0.0,0.0
1002,541,24-09-2019 05:40:00,0,2888.0,2362.0,0.818,13.995,12,11,0,11,1,0,1,0,0.0,0.52
1002,542,24-09-2019 05:42:00,0,2906.0,2322.0,0.799,14.021,0,0,0,0,0,0,0,0,0.0,0.0
1002,543,24-09-2019 05:44:00,0,2920.0,2270.0,0.777,14.018,0,0,0,0,0,0,0,0,0.0,0.0
1002,544,24-09-2019 05:46:00,0,2815.0,2228.0,0.791,13.559,0,0,0,0,0,0,0,0,0.0,0.0
1002,545,24-09-2019 05:48:00,0,2873.5,2237.0,0.7785,13.8,48,46,23,23,2,1,1,3,0.0,0.0
1002,546,24-09-2019 05:50:00,0,2932.0,2246.0,0.766,14.041,57,52,31,21,5,4,1,3,0.0,0.0
1002,547,24-09-2019 05:52:00,0,3008.0,2388.0,0.794,14.495,34,34,7,27,0,0,0,0,0.0,0.0
1002,548,24-09-2019 05:54:00,0,3010.0,2389.0,0.794,14.505,14,14,0,14,0,0,0,0,0.0,0.0
1002,549,24-09-2019 05:56:00,0,2924.0,2319.0,0.793,14.09,19,19,0,19,0,0,0,0,0.0,0.0
1002,550,24-09-2019 05:58:00,0,2824.0,2180.0,0.772,13.543,48,43,29,14,5,2,3,2,0.0,0.0
1002,551,24-09-2019 06:00:00,1,2930.0,2255.0,0.77,14.039,206,121,90,31,85,65,20,19,0.0,0.0
1002,552,24-09-2019 06:02:00,1,3248.0,2446.0,0.753,15.505,415,205,158,47,210,164,46,68,0.0,0.0
1002,553,24-09-2019 06:04:00,1,3001.0,2372.0,0.79,14.449,360,247,203,44,113,75,38,67,0.0,0.0
1002,554,24-09-2019 06:06:00,1,3320.0,2624.0,0.79,15.988,146,84,63,21,62,34,28,53,0.0,0.0
1002,555,24-09-2019 06:08:00,1,3631.0,2893.0,0.797,17.508,147,96,60,36,51,27,24,42,0.0,0.0
1002,556,24-09-2019 06:10:00,1,3935.0,2958.0,0.752,18.781,152,100,63,37,52,22,30,47,0.0,0.0
1002,557,24-09-2019 06:12:00,1,3935.0,3024.0,0.769,18.851,134,121,75,46,13,3,10,8,0.0,0.0
1002,558,24-09-2019 06:14:00,1,3422.0,2663.0,0.778,16.432,56,49,30,19,7,0,7,3,0.0,0.0
1002,559,24-09-2019 06:16:00,1,3228.0,2491.0,0.772,15.476,115,96,61,35,19,9,10,3,0.01,0.0
1002,560,24-09-2019 06:18:00,1,3027.0,2358.0,0.779,14.538,83,53,30,23,30,14,16,0,0.0,0.0
1002,561,24-09-2019 06:20:00,1,3324.0,2596.0,0.781,15.971,130,83,56,27,47,23,24,0,0.0,0.0
1002,562,24-09-2019 06:22:00,1,3469.0,2734.0,0.788,16.696,90,49,31,18,41,18,23,0,0.0,0.0
1002,563,24-09-2019 06:24:00,1,3614.0,2872.0,0.795,17.421,94,71,38,33,23,14,9,0,0.0,0.0
1002,564,24-09-2019 06:26:00,1,3242.0,2418.0,0.746,15.451,10,10,6,4,0,0,0,0,0.0,0.0
1002,565,24-09-2019 06:28:00,1,3128.0,2380.0,0.761,14.96,2,2,1,1,0,0,0,0,0.0,0.0
1002,566,24-09-2019 06:30:00,1,2893.0,2338.0,0.808,13.987,4,4,3,1,0,0,0,0,0.0,0.0
1002,567,24-09-2019 06:32:00,1,2913.0,2345.0,0.805,14.073,14,14,1,13,0,0,0,0,0.0,0.0
1002,568,24-09-2019 06:34:00,1,2923.0,2285.0,0.782,14.047,11,11,4,7,0,0,0,0,0.0,0.0
1002,569,24-09-2019 06:36:00,1,2927.0,2239.0,0.765,14.013,3,3,2,1,0,0,0,0,0.0,0.0
1002,570,24-09-2019 06:38:00,1,2704.0,2215.0,0.819,13.106,0,0,0,0,0,0,0,0,0.0,0.0
1002,571,24-09-2019 06:40:00,1,2712.0,2148.0,0.792,13.062,0,0,0,0,0,0,0,0,0.0,0.0
1002,572,24-09-2019 06:42:00,1,2718.0,2133.0,0.785,13.069,1,1,0,1,0,0,0,0,0.0,0.0
1002,573,24-09-2019 06:44:00,1,2708.0,2149.0,0.794,13.048,0,0,0,0,0,0,0,0,0.0,0.0
1002,574,24-09-2019 06:46:00,1,2709.0,2167.0,0.8,13.073,0,0,0,0,0,0,0,0,0.0,0.0
1002,575,24-09-2019 06:48:00,1,2716.0,2122.0,0.781,13.052,4,4,3,1,0,0,0,0,0.0,0.0
1002,576,24-09-2019 06:50:00,1,2713.0,2115.0,0.779,13.03,2,2,0,2,0,0,0,0,0.0,0.13
1002,577,24-09-2019 06:52:00,1,2496.0,2035.0,0.815,12.089,34,33,19,14,1,1,0,0,0.0,0.0
1002,578,24-09-2019 06:54:00,1,2933.0,2247.0,0.766,14.045,65,65,40,25,0,0,0,1,0.0,0.0
1002,579,24-09-2019 06:56:00,1,2879.5,2203.0,0.765,13.7855,19,19,9,10,0,0,0,0,0.0,0.0
1002,580,24-09-2019 06:58:00,1,2826.0,2159.0,0.764,13.526,7,7,4,3,0,0,0,0,0.0,0.0
1002,581,24-09-2019 07:00:00,1,2738.0,2058.0,0.752,13.065,0,0,0,0,0,0,0,0,0.0,0.0
1002,582,24-09-2019 07:02:00,1,2644.0,1936.0,0.732,12.563,3,3,1,2,0,0,0,0,0.0,0.0
1002,583,24-09-2019 07:04:00,1,2544.0,1863.0,0.732,12.087,1,1,0,1,0,0,0,0,0.0,0.0
1002,584,24-09-2019 07:06:00,1,2437.0,1822.0,0.748,11.621,5,5,1,4,0,0,0,0,0.0,0.0
1002,585,24-09-2019 07:08:00,1,2444.0,1809.0,0.74,11.634,28,28,1,27,0,0,0,0,0.0,0.0
1002,586,24-09-2019 07:10:00,1,2558.0,1818.0,0.711,12.092,45,45,0,45,0,0,0,0,0.0,0.0
1002,587,24-09-2019 07:12:00,1,2441.0,1808.0,0.741,11.621,37,37,1,36,0,0,0,0,0.0,0.0
1002,588,24-09-2019 07:14:00,1,2440.0,1787.0,0.732,11.591,29,28,15,13,1,1,0,0,0.0,0.0
1002,589,24-09-2019 07:16:00,1,2668.0,1862.0,0.698,12.573,21,19,9,10,2,0,2,0,0.0,0.0
1002,590,24-09-2019 07:18:00,1,2864.0,2007.0,0.701,13.506,18,18,2,16,0,0,0,0,0.0,0.0
1002,591,24-09-2019 07:20:00,1,2862.0,2063.0,0.721,13.562,11,11,0,11,0,0,0,0,0.0,0.0
1002,592,24-09-2019 07:22:00,1,2755.0,1992.0,0.723,13.059,2,2,0,2,0,0,0,0,0.0,0.0
1002,593,24-09-2019 07:24:00,1,2648.0,1950.0,0.736,12.594,0,0,0,0,0,0,0,0,0.0,0.0
1002,594,24-09-2019 07:26:00,1,2882.0,1976.0,0.686,13.543,0,0,0,0,0,0,0,0,0.0,0.0
1002,595,24-09-2019 07:28:00,1,2886.0,1971.0,0.683,13.555,8,7,5,2,1,1,0,0,0.0,0.0
1002,596,24-09-2019 07:30:00,1,2723.5,1879.0,0.6905,12.8125,4,4,1,3,0,0,0,0,0.0,0.0
1002,597,24-09-2019 07:32:00,1,2561.0,1787.0,0.698,12.07,0,0,0,0,0,0,0,0,0.0,0.0
1002,598,24-09-2019 07:34:00,1,2460.0,1749.0,0.711,11.629,1,1,0,1,0,0,0,0,0.0,0.0
1002,599,24-09-2019 07:36:00,1,2451.0,1766.0,0.721,11.614,2,2,1,1,0,0,0,0,0.0,0.0
1002,600,24-09-2019 07:38:00,1,2557.0,1803.0,0.705,12.073,0,0,0,0,0,0,0,0,0.0,0.0
1002,601,24-09-2019 07:40:00,1,2558.0,1802.0,0.704,12.076,1,1,1,0,0,0,0,0,0.0,0.0
1002,602,24-09-2019 07:42:00,1,2579.0,1772.0,0.687,12.123,0,0,0,0,0,0,0,0,0.0,0.0
1002,603,24-09-2019 07:44:00,1,2546.0,1788.0,0.702,12.011,1,1,0,1,0,0,0,0,0.01,0.0
1002,604,24-09-2019 07:46:00,1,2558.0,1810.0,0.708,12.082,16,16,0,16,0,0,0,0,0.0,0.0
1002,605,24-09-2019 07:48:00,1,2579.0,1732.0,0.672,12.078,7,7,0,7,0,0,0,0,0.0,0.0
1002,606,24-09-2019 07:50:00,1,2462.0,1741.0,0.707,11.63,44,42,23,19,2,1,1,6,0.0,0.0
1002,607,24-09-2019 07:52:00,1,2769.0,1922.0,0.694,13.04,8,8,2,6,0,0,0,0,0.0,0.0
1002,608,24-09-2019 07:54:00,1,2774.0,1899.0,0.685,13.035,0,0,0,0,0,0,0,0,0.0,0.0
1002,609,24-09-2019 07:56:00,1,2566.0,1791.0,0.698,12.095,0,0,0,0,0,0,0,0,0.0,0.0
1002,610,24-09-2019 07:58:00,1,2445.0,1729.0,0.707,11.547,0,0,0,0,0,0,0,0,0.0,0.0
1002,611,24-09-2019 08:00:00,1,2470.0,1720.0,0.696,11.635,3,3,2,1,0,0,0,0,0.0,0.0
1002,612,24-09-2019 08:02:00,1,2470.0,1712.0,0.693,11.627,0,0,0,0,0,0,0,0,0.0,0.0
1002,613,24-09-2019 08:04:00,1,2471.0,1715.0,0.694,11.635,3,3,1,2,0,0,0,0,0.0,0.0
1002,614,24-09-2019 08:06:00,1,2472.0,1718.0,0.695,11.643,34,34,1,33,0,0,0,0,0.0,0.0
1002,615,24-09-2019 08:08:00,1,2347.0,1683.0,0.717,11.11,12,12,0,12,0,0,0,0,0.0,0.0
1002,616,24-09-2019 08:10:00,1,2457.0,1744.0,0.71,11.611,3,3,1,2,0,0,0,0,0.0,0.0
1002,617,24-09-2019 08:12:00,1,2570.0,1741.0,0.677,12.056,3,3,1,2,0,0,0,0,0.0,0.0
1002,618,24-09-2019 08:14:00,1,2579.0,1748.0,0.678,12.098,1,1,0,1,0,0,0,0,0.0,0.0
1002,619,24-09-2019 08:16:00,1,2575.0,1730.0,0.672,12.061,29,29,2,27,0,0,0,0,0.0,0.0
1002,620,24-09-2019 08:18:00,1,2468.0,1739.0,0.704,11.65,35,33,21,12,2,0,2,1,0.0,0.0
1002,621,24-09-2019 08:20:00,1,2743.0,1990.0,0.725,13.013,109,102,68,34,7,3,4,2,0.0,0.0
1002,622,24-09-2019 08:22:00,1,2870.0,2005.0,0.698,13.53,81,51,36,15,30,21,9,11,0.0,0.0
1002,623,24-09-2019 08:24:00,1,2956.0,2114.0,0.715,13.989,165,132,94,38,33,16,17,14,0.0,0.0
1002,624,24-09-2019 08:26:00,1,3275.0,2270.0,0.693,15.416,142,102,60,42,40,23,17,18,0.0,0.0
1002,625,24-09-2019 08:28:00,1,3056.0,2216.0,0.725,14.492,114,90,58,32,24,13,11,6,0.0,0.0
1002,626,24-09-2019 08:30:00,1,3048.0,2197.0,0.721,14.443,68,46,29,17,22,5,17,16,0.0,0.0
1002,627,24-09-2019 08:32:00,1,3252.0,2382.0,0.732,15.451,41,26,13,13,15,11,4,0,0.0,0.0
1002,628,24-09-2019 08:34:00,1,3269.0,2406.0,0.736,15.542,89,51,16,35,38,20,18,1,0.0,0.0
1002,629,24-09-2019 08:36:00,1,2972.0,2083.0,0.701,14.018,88,36,14,22,52,23,29,0,0.0,0.0
1002,630,24-09-2019 08:38:00,1,2926.5,2046.5,0.6995,13.7975,66,37,22,15,29,18,11,0,0.0,0.0
1002,631,24-09-2019 08:40:00,1,2881.0,2010.0,0.698,13.577,51,36,21,15,15,8,7,0,0.0,0.0
1002,632,24-09-2019 08:42:00,1,2743.0,2010.0,0.733,13.031,33,10,6,4,23,8,15,0,0.0,0.0
1002,633,24-09-2019 08:44:00,1,2756.0,1954.0,0.709,13.022,60,31,20,11,29,13,16,0,0.0,0.0
1002,634,24-09-2019 08:46:00,1,2976.0,2090.0,0.702,14.041,20,5,0,5,15,4,11,0,0.0,0.0
1002,635,24-09-2019 08:48:00,1,2968.0,2079.0,0.7,13.994,3,1,0,1,2,1,1,0,0.0,0.0
1002,636,24-09-2019 08:50:00,1,2981.0,2019.0,0.677,13.983,0,0,0,0,0,0,0,0,0.0,0.0
1002,637,24-09-2019 08:52:00,1,2773.0,1887.0,0.68,13.015,1,1,0,1,0,0,0,0,0.0,0.0
1002,638,24-09-2019 08:54:00,1,2560.0,1823.0,0.712,12.107,43,26,0,26,17,4,13,0,0.0,0.0
1002,639,24-09-2019 08:56:00,1,2747.0,1987.0,0.723,13.025,17,11,3,8,6,4,2,0,0.0,0.0
1002,640,24-09-2019 08:58:00,1,2772.0,1953.0,0.704,13.085,0,0,0,0,0,0,0,0,0.0,0.0
1002,641,24-09-2019 09:00:00,1,2657.0,1878.0,0.707,12.549,6,0,0,0,6,0,6,0,0.0,0.0
1002,642,24-09-2019 09:02:00,1,2558.0,1772.0,0.693,12.042,20,0,0,0,20,0,20,0,0.0,0.0
1002,643,24-09-2019 09:04:00,1,2465.0,1722.0,0.699,11.621,18,0,0,0,18,0,18,0,0.0,0.0
1002,644,24-09-2019 09:06:00,1,2355.0,1652.0,0.702,11.108,16,6,1,5,10,0,10,0,0.0,0.0
1002,645,24-09-2019 09:08:00,1,2235.0,1626.0,0.727,10.608,8,2,0,2,6,5,1,0,0.0,0.0
1002,646,24-09-2019 09:10:00,1,2248.0,1586.0,0.706,10.613,0,0,0,0,0,0,0,0,0.0,0.0
1002,647,24-09-2019 09:12:00,1,2317.5,1572.5,0.6795,10.872,4,2,1,1,2,0,2,0,0.0,0.0
1002,648,24-09-2019 09:14:00,1,2387.0,1559.0,0.653,11.131,39,18,3,15,21,10,11,0,0.0,0.0
1002,649,24-09-2019 09:16:00,1,2385.0,1559.0,0.654,11.122,16,9,0,9,7,6,1,0,0.0,0.0
1002,650,24-09-2019 09:18:00,1,2386.0,1550.0,0.65,11.116,18,7,1,6,11,0,11,0,0.0,0.0
1002,651,24-09-2019 09:20:00,1,2385.0,1576.0,0.661,11.143,11,11,4,7,0,0,0,0,0.0,0.0
1002,652,24-09-2019 09:22:00,1,2379.0,1580.0,0.664,11.123,1,0,0,0,1,0,1,0,0.0,0.0
1002,653,24-09-2019 09:24:00,1,2393.0,1560.0,0.652,11.158,22,0,0,0,22,0,22,0,0.0,0.0
1002,654,24-09-2019 09:26:00,1,2381.0,1537.0,0.645,11.085,40,4,0,4,36,8,28,0,0.0,0.0
1002,655,24-09-2019 09:28:00,1,2368.0,1597.0,0.674,11.097,123,0,0,0,123,87,36,0,0.0,0.0
1002,656,24-09-2019 09:30:00,1,2369.0,1612.0,0.681,11.12,109,0,0,0,109,81,28,0,0.01,0.0
1002,657,24-09-2019 09:32:00,1,2391.0,1521.0,0.636,11.104,73,0,0,0,73,37,36,0,0.0,0.0
1002,658,24-09-2019 09:34:00,1,2158.0,1441.0,0.668,10.098,23,1,0,1,22,5,17,0,0.0,0.0
1002,659,24-09-2019 09:36:00,1,2157.0,1463.0,0.678,10.117,68,0,0,0,68,54,14,0,0.0,0.0
1002,660,24-09-2019 09:38:00,1,2169.0,1439.0,0.663,10.14,10,1,0,1,9,0,9,0,0.0,0.0
1002,661,24-09-2019 09:40:00,1,2160.0,1454.0,0.673,10.122,27,13,3,10,14,7,7,0,0.0,0.0
1002,662,24-09-2019 09:42:00,1,2169.0,1443.0,0.666,10.143,18,5,3,2,13,8,5,0,0.0,0.0
1002,663,24-09-2019 09:44:00,1,2167.0,1462.0,0.675,10.155,93,55,37,18,38,26,12,0,0.0,0.0
1002,664,24-09-2019 09:46:00,1,2423.5,1645.5,0.6785,11.37,0,0,0,0,0,0,0,0,0.0,0.0
1002,665,24-09-2019 09:48:00,1,2680.0,1829.0,0.682,12.585,0,0,0,0,0,0,0,0,0.0,0.0
1002,666,24-09-2019 09:50:00,1,2691.0,1769.0,0.657,12.56,0,0,0,0,0,0,0,0,0.0,0.0
1002,667,24-09-2019 09:52:00,1,2466.0,1673.0,0.678,11.571,4,4,0,4,0,0,0,0,0.0,0.0
1002,668,24-09-2019 09:54:00,1,2372.0,1592.0,0.671,11.11,1,1,0,1,0,0,0,0,0.0,0.0
1002,669,24-09-2019 09:56:00,1,2364.0,1613.0,0.682,11.099,59,31,21,10,28,17,11,0,0.0,0.0
1002,670,24-09-2019 09:58:00,1,2586.0,1711.0,0.662,12.086,5,5,0,5,0,0,0,0,0.0,0.0
1002,671,24-09-2019 10:00:00,1,2368.0,1631.0,0.689,11.137,1,1,0,1,0,0,0,0,0.0,0.0
1002,672,24-09-2019 10:02:00,1,2379.0,1564.0,0.657,11.107,2,2,0,2,0,0,0,0,0.0,0.0
1002,673,24-09-2019 10:04:00,1,2371.0,1568.0,0.661,11.08,9,9,4,5,0,0,0,0,0.0,0.0
1002,674,24-09-2019 10:06:00,1,2367.0,1618.0,0.683,11.119,0,0,0,0,0,0,0,0,0.0,0.0
1002,675,24-09-2019 10:08:00,1,2390.0,1545.0,0.647,11.129,1,1,0,1,0,0,0,0,0.0,0.0
1002,676,24-09-2019 10:10:00,1,2376.0,1567.0,0.66,11.098,4,4,2,2,0,0,0,0,0.0,0.0
1002,677,24-09-2019 10:12:00,1,2387.0,1551.0,0.65,11.12,4,4,0,4,0,0,0,0,0.0,0.0
1002,678,24-09-2019 10:14:00,1,2396.0,1524.0,0.636,11.128,2,2,0,2,0,0,0,0,0.0,0.0
1002,679,24-09-2019 10:16:00,1,2384.0,1530.0,0.642,11.089,0,0,0,0,0,0,0,0,0.0,0.0
1002,680,24-09-2019 10:18:00,1,2388.0,1504.0,0.63,11.076,12,1,0,1,11,0,11,0,0.0,0.0
1002,681,24-09-2019 10:20:00,1,2384.0,1521.5,0.6385,11.0785,0,0,0,0,0,0,0,0,0.0,0.0
1002,682,24-09-2019 10:22:00,1,2380.0,1539.0,0.647,11.081,10,8,1,7,2,1,1,0,0.0,0.0
1002,683,24-09-2019 10:24:00,1,2382.0,1545.0,0.649,11.097,47,41,0,41,6,0,6,0,0.0,0.0
1002,684,24-09-2019 10:26:00,1,2376.0,1572.0,0.662,11.101,54,46,0,46,8,0,8,0,0.0,0.0
1002,685,24-09-2019 10:28:00,1,2396.0,1537.0,0.642,11.144,42,4,1,3,38,0,38,0,0.0,0.0
1002,686,24-09-2019 10:30:00,1,2166.0,1449.0,0.669,10.137,42,26,3,23,16,0,16,0,0.0,0.0
1002,687,24-09-2019 10:32:00,1,2173.0,1425.0,0.656,10.139,39,26,5,21,13,3,10,0,0.0,0.0
1002,688,24-09-2019 10:34:00,1,2267.0,1522.0,0.671,10.616,90,26,17,9,64,32,32,0,0.0,0.0
1002,689,24-09-2019 10:36:00,1,2383.0,1550.0,0.65,11.107,24,7,0,7,17,0,17,0,0.0,0.0
1002,690,24-09-2019 10:38:00,1,2161.0,1483.0,0.686,10.156,38,18,9,9,20,5,15,0,0.0,0.0
1002,691,24-09-2019 10:40:00,1,2182.0,1386.0,0.635,10.134,0,0,0,0,0,0,0,0,0.0,0.0
1002,692,24-09-2019 10:42:00,1,2206.0,1317.0,0.597,10.15,0,0,0,0,0,0,0,0,0.0,0.0
1002,693,24-09-2019 10:44:00,1,2093.0,1286.0,0.614,9.67,0,0,0,0,0,0,0,0,0.0,0.0
1002,694,24-09-2019 10:46:00,1,2088.0,1274.0,0.61,9.636,0,0,0,0,0,0,0,0,0.0,0.0
1002,695,24-09-2019 10:48:00,1,2201.0,1291.0,0.586,10.101,0,0,0,0,0,0,0,0,0.0,0.0
1002,696,24-09-2019 10:50:00,1,2097.0,1283.0,0.612,9.682,0,0,0,0,0,0,0,0,0.0,0.0
1002,697,24-09-2019 10:52:00,1,2088.0,1273.0,0.609,9.637,50,13,7,6,37,24,13,0,0.0,0.0
1002,698,24-09-2019 10:54:00,1,2140.5,1323.5,0.6175,9.9005,24,15,8,7,9,3,6,0,0.0,0.0
1002,699,24-09-2019 10:56:00,1,2193.0,1374.0,0.626,10.164,1,1,0,1,0,0,0,0,0.0,0.0
1002,700,24-09-2019 10:58:00,1,2201.0,1312.0,0.596,10.127,2,2,0,2,0,0,0,0,0.0,0.0
1002,701,24-09-2019 11:00:00,1,2199.0,1318.0,0.599,10.125,0,0,0,0,0,0,0,0,0.0,0.0
1002,702,24-09-2019 11:02:00,1,2203.0,1328.0,0.603,10.148,0,0,0,0,0,0,0,0,0.0,0.0
1002,703,24-09-2019 11:04:00,1,2207.0,1302.0,0.59,10.14,18,11,3,8,7,3,4,0,0.0,0.0
1002,704,24-09-2019 11:06:00,1,2199.0,1309.0,0.595,10.113,4,3,2,1,1,0,1,0,0.0,0.0
1002,705,24-09-2019 11:08:00,1,2203.0,1320.0,0.599,10.142,1,1,0,1,0,0,0,0,0.0,0.0
1002,706,24-09-2019 11:10:00,1,2197.0,1312.0,0.597,10.11,1,1,0,1,0,0,0,0,0.0,0.0
1002,707,24-09-2019 11:12:00,1,2198.0,1337.0,0.608,10.141,19,19,2,17,0,0,0,0,0.0,0.0
1002,708,24-09-2019 11:14:00,1,2195.0,1377.0,0.627,10.176,0,0,0,0,0,0,0,0,0.0,0.0
1002,709,24-09-2019 11:16:00,1,2180.0,1400.0,0.642,10.139,3,2,0,2,1,0,1,0,0.0,0.0
1002,710,24-09-2019 11:18:00,1,2165.0,1434.0,0.663,10.118,2,1,1,0,1,0,1,0,0.0,0.0
1002,711,24-09-2019 11:20:00,1,2169.0,1459.0,0.673,10.161,13,6,3,3,7,3,4,0,0.0,0.0
1002,712,24-09-2019 11:22:00,1,2173.0,1429.0,0.658,10.143,2,2,1,1,0,0,0,0,0.0,0.0
1002,713,24-09-2019 11:24:00,1,2171.0,1435.0,0.661,10.142,1,1,0,1,0,0,0,0,0.0,0.0
1002,714,24-09-2019 11:26:00,1,2175.0,1410.0,0.648,10.132,96,32,19,13,64,44,20,0,0.0,0.0
1002,715,24-09-2019 11:28:00,1,2263.0,1522.0,0.6715,10.6015,5,0,0,0,5,1,4,0,0.0,0.0
1002,716,24-09-2019 11:30:00,1,2351.0,1634.0,0.695,11.071,7,0,0,0,7,0,7,0,0.0,0.0
1002,717,24-09-2019 11:32:00,1,2482.0,1681.0,0.677,11.642,10,2,0,2,8,0,8,0,0.0,0.0
1002,718,24-09-2019 11:34:00,1,2694.0,1764.0,0.655,12.569,17,7,4,3,10,0,10,0,0.0,0.0
1002,719,24-09-2019 11:36:00,1,2701.0,1737.0,0.643,12.565,1,0,0,0,1,0,1,0,0.01,0.0
1002,720,24-09-2019 11:38:00,1,2709.0,1736.0,0.641,12.597,14,3,0,3,11,0,11,0,0.0,0.0
1002,721,24-09-2019 11:40:00,1,2357.0,1663.0,0.706,11.13,23,12,0,12,11,0,11,0,0.0,0.0
1002,722,24-09-2019 11:42:00,1,2274.0,1487.0,0.654,10.606,23,7,3,4,16,3,13,0,0.0,0.0
1002,723,24-09-2019 11:44:00,1,2165.0,1474.0,0.681,10.162,170,38,22,16,132,91,41,2,0.0,0.0
1002,724,24-09-2019 11:46:00,1,2682.0,1789.0,0.667,12.547,15,1,1,0,14,8,6,0,0.0,0.0
1002,725,24-09-2019 11:48:00,1,2666.0,1843.0,0.691,12.545,274,25,0,25,249,228,21,0,0.0,0.0
1002,726,24-09-2019 11:50:00,1,2886.0,1938.0,0.672,13.516,90,26,0,26,64,44,20,0,0.0,0.0
1002,727,24-09-2019 11:52:00,1,2891.0,1969.0,0.681,13.572,37,13,0,13,24,1,23,0,0.0,0.0
1002,728,24-09-2019 11:54:00,1,2864.0,1993.0,0.696,13.491,18,11,3,8,7,0,7,0,0.0,0.0
1002,729,24-09-2019 11:56:00,1,2779.0,1878.0,0.676,13.03,4,0,0,0,4,0,4,0,0.0,0.0
1002,730,24-09-2019 11:58:00,1,2895.0,1952.0,0.674,13.569,6,3,1,2,3,1,2,0,0.0,0.0
1002,731,24-09-2019 12:00:00,1,2882.0,1936.0,0.672,13.499,61,49,24,25,12,0,12,0,0.0,0.0
1002,732,24-09-2019 12:02:00,1,2939.0,1976.5,0.6725,13.7675,107,68,26,42,39,11,28,0,0.0,0.0
1002,733,24-09-2019 12:04:00,1,2996.0,2017.0,0.673,14.036,59,47,13,34,12,0,12,0,0.0,0.0
1002,734,24-09-2019 12:06:00,1,2882.0,1951.0,0.677,13.515,73,45,16,29,28,5,23,0,0.0,0.0
1002,735,24-09-2019 12:08:00,1,2900.0,1907.0,0.658,13.536,15,0,0,0,15,0,15,0,0.0,0.0
1002,736,24-09-2019 12:10:00,1,2683.0,1839.0,0.686,12.606,33,3,0,3,30,0,30,0,0.0,0.0
1002,737,24-09-2019 12:12:00,1,2897.0,1906.0,0.658,13.525,3,2,0,2,1,0,1,0,0.0,0.0
1002,738,24-09-2019 12:14:00,1,2662.0,1869.0,0.702,12.559,9,1,0,1,8,0,8,0,0.0,0.0
1002,739,24-09-2019 12:16:00,1,2673.0,1843.0,0.69,12.571,9,0,0,0,9,0,9,0,0.0,0.0
1002,740,24-09-2019 12:18:00,1,2672.0,1834.0,0.686,12.559,14,9,2,7,5,0,5,0,0.0,0.0
1002,741,24-09-2019 12:20:00,1,2694.0,1784.0,0.662,12.589,125,72,35,37,53,28,25,0,0.0,0.0
1002,742,24-09-2019 12:22:00,1,2885.0,2006.0,0.695,13.587,23,18,9,9,5,3,2,0,0.0,0.0
1002,743,24-09-2019 12:24:00,1,2664.0,1868.0,0.701,12.565,82,37,19,18,45,26,19,0,0.0,0.0
1002,744,24-09-2019 12:26:00,1,2895.0,1921.0,0.664,13.535,94,34,21,13,60,41,19,6,0.0,0.0
1002,745,24-09-2019 12:28:00,1,3104.0,2059.0,0.663,14.508,88,16,6,10,72,51,21,2,0.0,0.0
1002,746,24-09-2019 12:30:00,1,3113.0,2063.0,0.663,14.549,229,135,86,49,94,66,28,14,0.0,0.0
1002,747,24-09-2019 12:32:00,1,2681.0,1799.0,0.671,12.558,269,145,97,48,124,90,34,39,0.0,0.0
1002,748,24-09-2019 12:34:00,1,2781.0,1885.0,0.678,13.045,253,148,105,43,105,68,37,20,0.0,0.0
1002,749,24-09-2019 12:36:00,1,3100.0,2069.5,0.6685,14.5065,245,84,64,20,161,112,49,9,0.0,0.0
1002,750,24-09-2019 12:38:00,1,3419.0,2254.0,0.659,15.968,198,83,47,36,115,76,39,0,0.0,0.0
1002,751,24-09-2019 12:40:00,1,3179.0,2180.0,0.686,14.939,475,323,248,75,152,94,58,0,0.0,0.0
1002,752,24-09-2019 12:42:00,1,3076.0,2182.0,0.709,14.536,441,255,192,63,186,128,58,2,0.01,0.0
1002,753,24-09-2019 12:44:00,1,3067.0,2159.0,0.704,14.473,392,222,159,63,170,120,50,0,0.0,0.0
1002,754,24-09-2019 12:46:00,1,3304.0,2209.0,0.669,15.465,507,321,245,76,186,132,54,2,0.0,0.0
1002,755,24-09-2019 12:48:00,1,3409.0,2246.0,0.659,15.918,497,257,185,72,240,176,64,0,0.0,0.0
1002,756,24-09-2019 12:50:00,1,3408.0,2263.0,0.664,15.935,356,214,150,64,142,97,45,9,0.0,0.0
1002,757,24-09-2019 12:52:00,1,3419.0,2248.0,0.657,15.961,169,61,37,24,108,66,42,4,0.0,0.0
1002,758,24-09-2019 12:54:00,1,3077.0,2081.0,0.676,14.43,243,83,51,32,160,105,55,1,0.0,0.0
1002,759,24-09-2019 12:56:00,1,3086.0,2129.0,0.69,14.517,189,61,27,34,128,85,43,0,0.0,0.0
1002,760,24-09-2019 12:58:00,1,3095.0,2080.0,0.672,14.497,50,0,0,0,50,6,44,0,0.0,0.0
1002,761,24-09-2019 13:00:00,1,2987.0,2007.0,0.672,13.992,35,0,0,0,35,2,33,0,0.0,0.0
1002,762,24-09-2019 13:02:00,1,2883.0,1983.0,0.688,13.556,54,37,19,18,17,7,10,0,0.0,0.0
1002,763,24-09-2019 13:04:00,1,3098.0,2069.0,0.668,14.498,45,22,14,8,23,12,11,0,0.0,0.0
1002,764,24-09-2019 13:06:00,1,2665.0,1857.0,0.697,12.555,10,3,1,2,7,1,6,0,0.0,0.0
1002,765,24-09-2019 13:08:00,1,2690.0,1771.0,0.658,12.558,0,0,0,0,0,0,0,0,0.0,0.0
1002,766,24-09-2019 13:10:00,1,2685.0,1798.5,0.6695,12.5695,14,0,0,0,14,1,13,0,0.0,0.0
1002,767,24-09-2019 13:12:00,1,2680.0,1826.0,0.681,12.581,8,5,2,3,3,0,3,0,0.0,0.0
1002,768,24-09-2019 13:14:00,1,2687.0,1815.0,0.675,12.598,0,0,0,0,0,0,0,0,0.0,0.0
1002,769,24-09-2019 13:16:00,1,2337.0,1693.0,0.725,11.081,1,1,1,0,0,0,0,0,0.0,0.0
1002,770,24-09-2019 13:18:00,1,2368.0,1622.0,0.685,11.125,0,0,0,0,0,0,0,0,0.0,0.0
1002,771,24-09-2019 13:20:00,1,2370.0,1574.0,0.664,11.081,0,0,0,0,0,0,0,0,0.0,0.0
1002,772,24-09-2019 13:22:00,1,2169.0,1460.0,0.673,10.164,26,12,6,6,14,1,13,0,0.0,0.0
1002,773,24-09-2019 13:24:00,1,2378.0,1611.0,0.677,11.155,42,40,12,28,2,0,2,0,0.0,0.0
1002,774,24-09-2019 13:26:00,1,2357.0,1664.0,0.706,11.128,28,21,8,13,7,0,7,0,0.0,0.0
1002,775,24-09-2019 13:28:00,1,2384.0,1571.0,0.659,11.133,0,0,0,0,0,0,0,0,0.0,0.0
1002,776,24-09-2019 13:30:00,1,2148.0,1499.0,0.698,10.124,0,0,0,0,0,0,0,0,0.0,0.0
1002,777,24-09-2019 13:32:00,1,2164.0,1466.0,0.678,10.149,9,5,2,3,4,0,4,0,0.0,0.0
1002,778,24-09-2019 13:34:00,1,2162.0,1478.0,0.684,10.153,0,0,0,0,0,0,0,0,0.0,0.0
1002,779,24-09-2019 13:36:00,1,2162.0,1433.0,0.663,10.106,26,10,2,8,16,4,12,0,0.0,0.0
1002,780,24-09-2019 13:38:00,1,2377.0,1579.0,0.664,11.116,0,0,0,0,0,0,0,0,0.0,0.0
1002,781,24-09-2019 13:40:00,1,2370.0,1608.0,0.678,11.12,4,4,1,3,0,0,0,0,0.0,0.0
1002,782,24-09-2019 13:42:00,1,2371.0,1607.0,0.678,11.12,27,15,0,15,12,1,11,0,0.0,0.0
1002,783,24-09-2019 13:44:00,1,2367.5,1612.0,0.681,11.113,47,18,1,17,29,17,12,0,0.0,0.0
1002,784,24-09-2019 13:46:00,1,2364.0,1617.0,0.684,11.106,1,0,0,0,1,0,1,0,0.0,0.0
1002,785,24-09-2019 13:48:00,1,2384.0,1546.0,0.648,11.107,1,0,0,0,1,1,0,0,0.0,0.0
1002,786,24-09-2019 13:50:00,1,2145.0,1477.0,0.689,10.089,4,2,0,2,2,1,1,0,0.0,0.0
1002,787,24-09-2019 13:52:00,1,2163.0,1480.0,0.684,10.159,3,3,0,3,0,0,0,0,0.0,0.0
1002,788,24-09-2019 13:54:00,1,2173.0,1445.0,0.665,10.162,23,13,0,13,10,4,6,0,0.0,0.0
1002,789,24-09-2019 13:56:00,1,2146.0,1501.0,0.7,10.119,1,0,0,0,1,0,1,0,0.0,0.0
1002,790,24-09-2019 13:58:00,1,2153.0,1510.0,0.701,10.155,10,10,0,10,0,0,0,0,0.0,0.0
1002,791,24-09-2019 14:00:00,1,2148.0,1509.0,0.703,10.136,6,6,0,6,0,0,0,0,0.0,0.0
1002,792,24-09-2019 14:02:00,1,2153.0,1497.0,0.695,10.141,1,0,0,0,1,1,0,0,0.0,0.0
1002,793,24-09-2019 14:04:00,1,2164.0,1469.0,0.679,10.153,64,32,14,18,32,16,16,0,0.0,0.0
1002,794,24-09-2019 14:06:00,1,2163.0,1489.0,0.689,10.17,6,3,1,2,3,0,3,0,0.0,0.0
1002,795,24-09-2019 14:08:00,1,2155.0,1473.0,0.684,10.12,1,0,0,0,1,0,1,0,0.0,0.0
1002,796,24-09-2019 14:10:00,1,2179.0,1410.0,0.647,10.145,1,0,0,0,1,0,1,0,0.0,0.0
1002,797,24-09-2019 14:12:00,1,2177.0,1394.0,0.64,10.121,5,2,0,2,3,0,3,0,0.0,0.0
1002,798,24-09-2019 14:14:00,1,2166.0,1467.0,0.677,10.16,0,0,0,0,0,0,0,0,0.0,0.0
1002,799,24-09-2019 14:16:00,1,2154.0,1491.0,0.692,10.139,0,0,0,0,0,0,0,0,0.0,0.0
1002,800,24-09-2019 14:18:00,1,2210.5,1499.5,0.6785,10.3715,0,0,0,0,0,0,0,0,0.0,0.0
1002,801,24-09-2019 14:20:00,1,2267.0,1508.0,0.665,10.604,0,0,0,0,0,0,0,0,0.0,0.0
1002,802,24-09-2019 14:22:00,1,2153.0,1514.0,0.703,10.158,0,0,0,0,0,0,0,0,0.0,0.0
1002,803,24-09-2019 14:24:00,1,2169.0,1459.0,0.673,10.16,0,0,0,0,0,0,0,0,0.0,0.0
1002,804,24-09-2019 14:26:00,1,2166.0,1448.0,0.669,10.138,37,20,13,7,17,10,7,0,0.01,0.0
1002,805,24-09-2019 14:28:00,1,2390.0,1541.0,0.645,11.124,2,0,0,0,2,1,1,0,0.0,0.0
1002,806,24-09-2019 14:30:00,1,2150.0,1509.0,0.702,10.142,3,0,0,0,3,0,3,0,0.0,0.0
1002,807,24-09-2019 14:32:00,1,2156.0,1483.0,0.688,10.135,16,1,0,1,15,4,11,0,0.0,0.0
1002,808,24-09-2019 14:34:00,1,2170.0,1450.0,0.668,10.157,34,0,0,0,34,25,9,0,0.0,0.0
1002,809,24-09-2019 14:36:00,1,2162.0,1468.0,0.679,10.145,121,0,0,0,121,111,10,0,0.0,0.0
1002,810,24-09-2019 14:38:00,1,2161.0,1470.0,0.68,10.142,4,0,0,0,4,2,2,0,0.0,0.0
1002,811,24-09-2019 14:40:00,1,2169.0,1488.0,0.686,10.194,0,0,0,0,0,0,0,0,0.0,0.0
1002,812,24-09-2019 14:42:00,1,2079.0,1321.0,0.635,9.654,5,0,0,0,5,0,5,0,0.0,0.0
1002,813,24-09-2019 14:44:00,1,2184.0,1373.0,0.629,10.124,32,12,5,7,20,14,6,0,0.0,0.0
1002,814,24-09-2019 14:46:00,1,2163.0,1478.0,0.683,10.158,0,0,0,0,0,0,0,0,0.0,0.0
1002,815,24-09-2019 14:48:00,1,2177.0,1440.0,0.661,10.171,0,0,0,0,0,0,0,0,0.0,0.0
1002,816,24-09-2019 14:50:00,1,2168.0,1407.0,0.649,10.101,0,0,0,0,0,0,0,0,0.0,0.0
1002,817,24-09-2019 14:52:00,1,2179.0,1395.5,0.6405,10.131,0,0,0,0,0,0,0,0,0.0,0.0
1002,818,24-09-2019 14:54:00,1,2190.0,1384.0,0.632,10.161,7,5,1,4,2,1,1,0,0.0,0.0
1002,819,24-09-2019 14:56:00,1,2152.0,1490.0,0.692,10.131,8,7,1,6,1,0,1,0,0.0,0.0
1002,820,24-09-2019 14:58:00,1,2167.0,1468.0,0.678,10.162,12,3,1,2,9,0,9,0,0.0,0.0
1002,821,24-09-2019 15:00:00,1,2271.0,1530.0,0.674,10.642,5,0,0,0,5,0,5,0,0.0,0.0
1002,822,24-09-2019 15:02:00,1,2171.0,1436.0,0.661,10.142,13,11,4,7,2,1,1,0,0.0,0.0
1002,823,24-09-2019 15:04:00,1,2263.0,1536.0,0.679,10.618,1,1,0,1,0,0,0,0,0.0,0.0
1002,824,24-09-2019 15:06:00,1,2384.0,1566.0,0.657,11.129,0,0,0,0,0,0,0,0,0.0,0.0
1002,825,24-09-2019 15:08:00,1,2265.0,1534.0,0.677,10.623,1,1,0,1,0,0,0,0,0.0,0.0
1002,826,24-09-2019 15:10:00,1,2266.0,1541.0,0.68,10.634,3,3,0,3,0,0,0,0,0.0,0.0
1002,827,24-09-2019 15:12:00,1,2384.0,1570.0,0.659,11.132,1,1,0,1,0,0,0,0,0.0,0.0
1002,828,24-09-2019 15:14:00,1,2152.0,1511.0,0.702,10.151,4,2,0,2,2,1,1,0,0.0,0.0
1002,829,24-09-2019 15:16:00,1,2267.0,1526.0,0.673,10.621,12,6,0,6,6,0,6,0,0.0,0.0
1002,830,24-09-2019 15:18:00,1,2156.0,1492.0,0.692,10.146,0,0,0,0,0,0,0,0,0.0,0.0
1002,831,24-09-2019 15:20:00,1,2178.0,1420.0,0.652,10.155,6,5,1,4,1,0,1,0,0.0,0.0
1002,832,24-09-2019 15:22:00,1,2177.0,1402.0,0.644,10.133,61,32,7,25,29,17,12,0,0.0,0.0
1002,833,24-09-2019 15:24:00,1,2378.0,1566.0,0.659,11.104,44,19,11,8,25,8,17,0,0.0,0.0
1002,834,24-09-2019 15:26:00,1,2270.5,1519.0,0.67,10.6285,70,14,2,12,56,35,21,0,0.0,0.0
1002,835,24-09-2019 15:28:00,1,2163.0,1472.0,0.681,10.153,6,3,1,2,3,0,3,0,0.0,0.0
1002,836,24-09-2019 15:30:00,1,2385.0,1563.0,0.655,11.13,107,41,27,14,66,42,24,1,0.0,0.0
1002,837,24-09-2019 15:32:00,1,2453.0,1720.0,0.701,11.569,88,61,42,19,27,8,19,0,0.0,0.0
1002,838,24-09-2019 15:34:00,1,2175.0,1428.0,0.657,10.151,117,49,38,11,68,49,19,15,0.0,0.0
1002,839,24-09-2019 15:36:00,1,2349.0,1701.0,0.724,11.139,216,99,67,32,117,75,42,2,0.0,0.0
1002,840,24-09-2019 15:38:00,1,2868.0,2075.0,0.723,13.598,437,271,210,61,166,124,42,11,0.0,0.0
1002,841,24-09-2019 15:40:00,1,2851.0,2071.0,0.727,13.525,661,390,308,82,271,203,68,9,0.0,0.0
1002,842,24-09-2019 15:42:00,1,3089.0,2120.0,0.686,14.519,159,65,38,27,94,68,26,41,0.0,0.0
1002,843,24-09-2019 15:44:00,1,3051.0,2220.0,0.728,14.478,477,289,215,74,188,140,48,9,0.0,0.0
1002,844,24-09-2019 15:46:00,1,3074.0,2192.0,0.713,14.537,341,184,143,41,157,117,40,6,0.0,0.0
1002,845,24-09-2019 15:48:00,1,3091.0,2085.0,0.675,14.486,31,31,0,31,0,0,0,0,0.0,0.0
1002,846,24-09-2019 15:50:00,1,3094.0,2075.0,0.67,14.49,70,28,9,19,42,16,26,0,0.0,0.0
1002,847,24-09-2019 15:52:00,1,3090.0,2084.0,0.674,14.484,50,31,1,30,19,0,19,0,0.0,0.0
1002,848,24-09-2019 15:54:00,1,3091.0,2083.0,0.674,14.485,64,42,12,30,22,2,20,0,0.0,0.0
1002,849,24-09-2019 15:56:00,1,2866.0,2014.0,0.703,13.522,137,134,89,45,3,1,2,0,0.0,0.0
1002,850,24-09-2019 15:58:00,1,2859.0,2018.0,0.706,13.498,1,1,0,1,0,0,0,0,0.0,0.0
1002,851,24-09-2019 16:00:00,1,2662.5,1873.0,0.7035,12.564,1,0,0,0,1,0,1,0,0.0,0.0
1002,852,24-09-2019 16:02:00,1,2466.0,1728.0,0.701,11.63,1,1,0,1,0,0,0,0,0.0,0.0
1002,853,24-09-2019 16:04:00,1,2345.0,1686.0,0.719,11.105,6,6,0,6,0,0,0,0,0.0,0.0
1002,854,24-09-2019 16:06:00,1,2367.0,1631.0,0.689,11.131,25,24,0,24,1,0,1,0,0.0,0.0
1002,855,24-09-2019 16:08:00,1,2356.0,1628.0,0.691,11.087,5,4,0,4,1,0,1,0,0.0,0.0
1002,856,24-09-2019 16:10:00,1,2358.0,1648.0,0.699,11.117,0,0,0,0,0,0,0,0,0.0,0.0
1002,857,24-09-2019 16:12:00,1,2366.0,1593.0,0.673,11.087,7,5,0,5,2,0,2,0,0.0,0.0
1002,858,24-09-2019 16:14:00,1,2377.0,1569.0,0.66,11.104,4,2,0,2,2,0,2,0,0.0,0.0
1002,859,24-09-2019 16:16:00,1,2274.0,1544.0,0.679,10.668,0,0,0,0,0,0,0,0,0.0,0.0
1002,860,24-09-2019 16:18:00,1,2148.0,1490.0,0.693,10.114,3,2,1,1,1,0,1,0,0.0,0.0
1002,861,24-09-2019 16:20:00,1,2377.0,1585.0,0.667,11.12,38,9,4,5,29,10,19,0,0.0,0.0
1002,862,24-09-2019 16:22:00,1,2354.0,1629.0,0.692,11.077,16,9,2,7,7,0,7,0,0.0,0.0
1002,863,24-09-2019 16:24:00,1,2386.0,1574.0,0.66,11.143,5,2,2,0,3,0,3,0,0.0,0.0
1002,864,24-09-2019 16:26:00,1,2160.0,1483.0,0.687,10.153,16,9,1,8,7,0,7,0,0.0,0.0
1002,865,24-09-2019 16:28:00,1,2161.0,1459.0,0.675,10.132,24,13,5,8,11,3,8,0,0.0,0.0
1002,866,24-09-2019 16:30:00,1,2151.0,1497.0,0.696,10.13,30,5,2,3,25,0,25,0,0.0,0.0
1002,867,24-09-2019 16:32:00,1,2160.0,1494.0,0.692,10.163,34,0,0,0,34,0,34,0,0.0,0.0
1002,868,24-09-2019 16:34:00,1,2270.0,1534.5,0.677,10.6425,14,10,3,7,4,0,4,0,0.0,0.0
1002,869,24-09-2019 16:36:00,1,2380.0,1575.0,0.662,11.122,6,5,3,2,1,0,1,0,0.0,0.0
1002,870,24-09-2019 16:38:00,1,2379.0,1609.0,0.676,11.156,3,0,0,0,3,0,3,0,0.0,0.0
1002,871,24-09-2019 16:40:00,1,2371.0,1615.0,0.681,11.128,31,9,6,3,22,0,22,0,0.0,0.0
1002,872,24-09-2019 16:42:00,1,2374.0,1589.0,0.67,11.114,2,2,0,2,0,0,0,0,0.0,0.0
1002,873,24-09-2019 16:44:00,1,2172.0,1476.0,0.679,10.193,0,0,0,0,0,0,0,0,0.0,0.0
1002,874,24-09-2019 16:46:00,1,2160.0,1453.0,0.673,10.12,3,3,0,3,0,0,0,0,0.0,0.0
1002,875,24-09-2019 16:48:00,1,2169.0,1436.0,0.662,10.136,0,0,0,0,0,0,0,0,0.0,0.0
1002,876,24-09-2019 16:50:00,1,2187.0,1396.0,0.638,10.162,6,0,0,0,6,1,5,0,0.0,0.0
1002,877,24-09-2019 16:52:00,1,2188.0,1371.0,0.626,10.14,5,4,2,2,1,0,1,0,0.0,0.0
1002,878,24-09-2019 16:54:00,1,2195.0,1372.0,0.625,10.167,15,13,5,8,2,1,1,0,0.0,0.0
1002,879,24-09-2019 16:56:00,1,2175.0,1415.0,0.651,10.136,19,13,3,10,6,4,2,0,0.0,0.0
1002,880,24-09-2019 16:58:00,1,2170.0,1400.0,0.645,10.103,1,1,0,1,0,0,0,0,0.0,0.0
1002,881,24-09-2019 17:00:00,1,2193.0,1386.0,0.632,10.176,0,0,0,0,0,0,0,0,0.0,0.0
1002,882,24-09-2019 17:02:00,1,2191.0,1366.0,0.623,10.144,0,0,0,0,0,0,0,0,0.0,0.0
1002,883,24-09-2019 17:04:00,1,2175.0,1401.0,0.644,10.121,1,0,0,0,1,1,0,0,0.0,0.0
1002,884,24-09-2019 17:06:00,1,2183.0,1432.0,0.656,10.188,2,1,0,1,1,0,1,0,0.0,0.0
1002,885,24-09-2019 17:08:00,1,2181.5,1409.0,0.646,10.155,1,0,0,0,1,0,1,0,0.0,0.0
1002,886,24-09-2019 17:10:00,1,2180.0,1386.0,0.636,10.122,6,4,0,4,2,0,2,0,0.0,0.0
1002,887,24-09-2019 17:12:00,1,2179.0,1430.0,0.656,10.17,25,7,4,3,18,5,13,0,0.0,0.0
1002,888,24-09-2019 17:14:00,1,2152.0,1508.0,0.701,10.147,9,2,0,2,7,0,7,0,0.0,0.0
1002,889,24-09-2019 17:16:00,1,2155.0,1482.0,0.687,10.133,3,3,0,3,0,0,0,0,0.0,0.0
1002,890,24-09-2019 17:18:00,1,2170.0,1490.0,0.687,10.198,4,4,0,4,0,0,0,0,0.0,0.0
1002,891,24-09-2019 17:20:00,1,2155.0,1476.0,0.685,10.127,10,6,0,6,4,0,4,0,0.0,0.0
1002,892,24-09-2019 17:22:00,1,2177.0,1386.0,0.636,10.114,11,0,0,0,11,0,11,0,0.0,0.0
1002,893,24-09-2019 17:24:00,1,2082.0,1302.0,0.626,9.643,5,2,0,2,3,0,3,0,0.0,0.0
1002,894,24-09-2019 17:26:00,1,1964.0,1274.0,0.648,9.151,31,0,0,0,31,15,16,0,0.0,0.0
1002,895,24-09-2019 17:28:00,1,2193.0,1323.0,0.603,10.108,47,0,0,0,47,8,39,0,0.0,0.0
1002,896,24-09-2019 17:30:00,1,2199.0,1366.0,0.621,10.177,57,5,4,1,52,18,34,0,0.0,0.0
1002,897,24-09-2019 17:32:00,1,2156.0,1492.0,0.692,10.146,18,3,1,2,15,1,14,0,0.0,0.0
1002,898,24-09-2019 17:34:00,1,2163.0,1455.0,0.673,10.133,3,3,2,1,0,0,0,0,0.0,0.0
1002,899,24-09-2019 17:36:00,1,2159.0,1483.0,0.687,10.147,5,0,0,0,5,0,5,0,0.0,0.0
1002,900,24-09-2019 17:38:00,1,2154.0,1511.0,0.701,10.161,26,0,0,0,26,0,26,0,0.0,0.0
1002,901,24-09-2019 17:40:00,1,2142.0,1553.0,0.725,10.16,4,0,0,0,4,0,4,0,0.0,0.0
1002,902,24-09-2019 17:42:00,1,2242.0,1630.5,0.727,10.639,19,13,0,13,6,3,3,0,0.0,0.0
1002,903,24-09-2019 17:44:00,1,2342.0,1708.0,0.729,11.118,66,32,8,24,34,15,19,0,0.0,0.0
1002,904,24-09-2019 17:46:00,1,2359.0,1679.0,0.712,11.153,42,7,0,7,35,15,20,0,0.0,0.0
1002,905,24-09-2019 17:48:00,1,2367.0,1577.0,0.666,11.073,17,2,0,2,15,4,11,0,0.0,0.0
1002,906,24-09-2019 17:50:00,1,2136.0,1545.0,0.723,10.128,42,0,0,0,42,2,40,0,0.0,0.0
1002,907,24-09-2019 17:52:00,1,2149.0,1531.0,0.712,10.161,30,5,1,4,25,6,19,0,0.0,0.0
1002,908,24-09-2019 17:54:00,1,2164.0,1458.0,0.673,10.142,37,1,1,0,36,3,33,0,0.0,0.0
1002,909,24-09-2019 17:56:00,1,2160.0,1484.0,0.687,10.154,4,4,0,4,0,0,0,0,0.0,0.0
1002,910,24-09-2019 17:58:00,1,2149.0,1493.0,0.695,10.121,44,11,0,11,33,9,24,0,0.0,0.0
1002,911,24-09-2019 18:00:00,0,2148.0,1533.0,0.714,10.161,89,30,2,28,59,27,32,0,0.0,0.0
1002,912,24-09-2019 18:02:00,0,2366.0,1622.0,0.686,11.119,91,43,16,27,48,28,20,1,0.0,0.0
1002,913,24-09-2019 18:04:00,0,2434.0,1797.0,0.738,11.581,357,194,155,39,163,114,49,82,0.0,0.0
1002,914,24-09-2019 18:06:00,0,2959.0,2067.0,0.699,13.948,262,127,91,36,135,96,39,47,0.0,0.0
1002,915,24-09-2019 18:08:00,0,3059.0,2198.0,0.719,14.486,308,164,133,31,144,108,36,31,0.01,0.0
1002,916,24-09-2019 18:10:00,0,3587.0,2545.0,0.71,16.95,159,59,34,25,100,77,23,52,0.0,0.0
1002,917,24-09-2019 18:12:00,0,3352.0,2443.0,0.729,15.912,72,57,32,25,15,9,6,40,0.0,0.0
1002,918,24-09-2019 18:14:00,0,3478.0,2465.0,0.709,16.432,88,54,30,24,34,16,18,57,0.0,0.0
1002,919,24-09-2019 18:16:00,0,3527.0,2504.5,0.71,16.6685,85,53,36,17,32,19,13,48,0.0,0.0
1002,920,24-09-2019 18:18:00,0,3576.0,2544.0,0.711,16.905,92,55,42,13,37,20,17,40,0.0,0.0
1002,921,24-09-2019 18:20:00,0,3552.0,2662.0,0.749,16.944,111,53,29,24,58,26,32,57,0.0,0.0
1002,922,24-09-2019 18:22:00,0,3450.0,2591.0,0.751,16.461,91,59,34,25,32,2,30,41,0.0,0.0
1002,923,24-09-2019 18:24:00,0,3444.0,2605.0,0.756,16.452,81,63,33,30,18,5,13,40,0.0,0.0
1002,924,24-09-2019 18:26:00,0,3527.0,2725.0,0.773,16.914,205,133,95,38,72,43,29,41,0.0,0.0
1002,925,24-09-2019 18:28:00,0,3531.0,2740.0,0.776,16.948,466,235,184,51,231,165,66,78,0.0,0.0
1002,926,24-09-2019 18:30:00,0,3725.0,2888.0,0.775,17.877,212,109,75,34,103,73,30,14,0.0,0.0
1002,927,24-09-2019 18:32:00,0,4011.0,3188.0,0.795,19.333,101,38,23,15,63,45,18,7,0.0,0.0
1002,928,24-09-2019 18:34:00,0,3304.0,2654.0,0.803,15.956,85,25,10,15,60,35,25,0,0.0,0.0
1002,929,24-09-2019 18:36:00,0,3408.0,2684.0,0.788,16.399,105,7,0,7,98,64,34,0,0.0,0.0
1002,930,24-09-2019 18:38:00,0,3521.0,2741.0,0.778,16.908,83,29,8,21,54,33,21,0,0.03,0.0
1002,931,24-09-2019 18:40:00,0,3480.0,2882.0,0.828,16.9,46,21,7,14,25,6,19,0,0.09,0.0
1002,932,24-09-2019 18:42:00,0,3504.0,2868.0,0.818,16.983,41,23,1,22,18,0,18,0,0.0,0.0
1002,933,24-09-2019 18:44:00,0,3491.0,2891.0,0.828,16.954,42,10,7,3,32,17,15,0,0.01,0.0
1002,934,24-09-2019 18:46:00,0,3696.0,3043.0,0.823,17.93,0,0,0,0,0,0,0,0,0.0,0.0
1002,935,24-09-2019 18:48:00,0,3461.0,2946.0,0.851,16.9,13,11,4,7,2,1,1,0,0.0,0.0
1002,936,24-09-2019 18:50:00,0,3469.5,2918.5,0.841,16.9015,76,35,16,19,41,19,22,0,0.0,0.0
1002,937,24-09-2019 18:52:00,0,3478.0,2891.0,0.831,16.903,84,54,21,33,30,10,20,4,0.0,0.0
1002,938,24-09-2019 18:54:00,0,3690.0,3058.0,0.829,17.926,131,68,43,25,63,38,25,53,0.01,0.0
1002,939,24-09-2019 18:56:00,0,3777.0,3162.0,0.837,18.384,114,78,50,28,36,20,16,68,0.0,0.0
1002,940,24-09-2019 18:58:00,0,3776.0,3195.0,0.846,18.417,314,181,132,49,133,90,43,48,0.0,0.0
1002,941,24-09-2019 19:00:00,0,3494.0,2899.0,0.83,16.977,234,144,102,42,90,61,29,70,0.01,0.0
1002,942,24-09-2019 19:02:00,0,3692.0,3035.0,0.822,17.908,97,59,35,24,38,21,17,54,0.0,0.0
1002,943,24-09-2019 19:04:00,0,3978.0,3307.0,0.831,19.336,252,129,86,43,123,73,50,60,0.0,0.0
1002,944,24-09-2019 19:06:00,0,3982.0,3333.0,0.837,19.381,149,74,47,27,75,54,21,9,0.09,0.0
1002,945,24-09-2019 19:08:00,0,3679.0,3059.0,0.832,17.883,262,163,127,36,99,74,25,82,0.0,0.0
1002,946,24-09-2019 19:10:00,0,3965.0,3337.0,0.841,19.317,142,32,14,18,110,63,47,51,0.0,0.0
1002,947,24-09-2019 19:12:00,0,4050.0,3522.0,0.869,19.858,181,75,43,32,106,72,34,40,0.0,0.0
1002,948,24-09-2019 19:14:00,0,3981.0,3339.0,0.839,19.383,198,118,86,32,80,61,19,29,0.0,0.0
1002,949,24-09-2019 19:16:00,0,3993.0,3314.0,0.83,19.403,134,72,41,31,62,35,27,26,0.05,0.0
1002,950,24-09-2019 19:18:00,0,3953.0,3433.0,0.869,19.375,191,124,89,35,67,46,21,89,0.01,0.0
1002,951,24-09-2019 19:20:00,0,3978.0,3333.0,0.838,19.362,191,138,104,34,53,16,37,70,0.0,0.0
1002,952,24-09-2019 19:22:00,0,3938.0,3474.0,0.882,19.363,137,91,56,35,46,9,37,60,0.0,0.0
1002,953,24-09-2019 19:24:00,0,4145.5,3632.0,0.8765,20.355,92,64,36,28,28,3,25,61,0.0,0.0
1002,954,24-09-2019 19:26:00,0,4353.0,3790.0,0.871,21.347,98,64,35,29,34,12,22,45,0.0,0.0
1002,955,24-09-2019 19:28:00,0,4304.0,3848.0,0.894,21.22,169,60,36,24,109,70,39,5,0.19,0.0
1002,956,24-09-2019 19:30:00,0,3781.0,3256.0,0.861,18.503,411,215,174,41,196,148,48,80,0.01,0.0
1002,957,24-09-2019 19:32:00,0,3468.0,2943.0,0.848,16.923,245,137,101,36,108,79,29,59,0.0,0.0
1002,958,24-09-2019 19:34:00,0,4423.0,3927.0,0.888,21.773,150,116,82,34,34,13,21,67,0.0,0.0
1002,959,24-09-2019 19:36:00,0,4354.0,3823.0,0.878,21.388,115,99,58,41,16,4,12,53,0.0,0.1
1002,960,24-09-2019 19:38:00,0,4414.0,3902.0,0.884,21.712,234,122,91,31,112,83,29,34,0.12,0.06
1002,961,24-09-2019 19:40:00,0,4108.0,3706.0,0.902,20.289,141,72,41,31,69,30,39,0,0.1,0.0
1002,962,24-09-2019 19:42:00,0,3885.0,3290.0,0.847,18.948,61,28,4,24,33,10,23,0,0.0,0.0
1002,963,24-09-2019 19:44:00,0,4327.0,3819.0,0.883,21.275,67,35,11,24,32,9,23,0,0.0,0.0
1002,964,24-09-2019 19:46:00,0,4146.0,3582.0,0.864,20.3,78,45,12,33,33,11,22,0,0.0,0.0
1002,965,24-09-2019 19:48:00,0,4133.0,3659.0,0.885,20.336,78,53,26,27,25,2,23,0,0.01,0.0
1002,966,24-09-2019 19:50:00,0,4152.0,3667.0,0.883,20.418,107,48,22,26,59,25,34,0,0.0,0.0
1002,967,24-09-2019 19:52:00,0,4212.0,3810.0,0.905,20.814,403,193,143,50,210,155,55,4,0.0,0.0
1002,968,24-09-2019 19:54:00,0,4633.0,4078.0,0.88,22.77,410,255,194,61,155,113,42,32,0.0,0.0
1002,969,24-09-2019 19:56:00,0,4542.0,3993.0,0.879,22.316,258,135,98,37,123,77,46,52,0.0,0.0
1002,970,24-09-2019 19:58:00,0,4330.5,3858.0,0.8915,21.3335,69,22,16,6,47,31,16,7,0.0,0.0
1002,971,24-09-2019 20:00:00,0,4119.0,3723.0,0.904,20.351,150,55,34,21,95,62,33,0,0.06,0.0
1002,972,24-09-2019 20:02:00,0,4117.0,3623.0,0.88,20.232,58,15,9,6,43,15,28,0,0.06,0.0
1002,973,24-09-2019 20:04:00,0,4120.0,3704.0,0.899,20.333,104,29,12,17,75,48,27,0,0.01,0.0
1002,974,24-09-2019 20:06:00,0,4152.0,3664.0,0.883,20.413,27,9,2,7,18,5,13,0,0.0,0.0
1002,975,24-09-2019 20:08:00,0,3961.0,3413.0,0.862,19.387,11,5,0,5,6,0,6,0,0.0,0.01
1002,976,24-09-2019 20:10:00,0,3625.0,3243.0,0.894,17.873,80,20,7,13,60,38,22,0,0.0,0.0
1002,977,24-09-2019 20:12:00,0,3748.0,3308.0,0.883,18.43,148,15,2,13,133,107,26,0,0.0,0.0
1002,978,24-09-2019 20:14:00,0,3545.0,3159.0,0.891,17.466,16,4,1,3,12,5,7,0,0.0,0.0
1002,979,24-09-2019 20:16:00,0,3429.0,3099.0,0.904,16.94,24,12,1,11,12,5,7,0,0.0,0.0
1002,980,24-09-2019 20:18:00,0,3423.0,3134.0,0.915,16.956,0,0,0,0,0,0,0,0,0.0,0.0
1002,981,24-09-2019 20:20:00,0,3436.0,3060.0,0.891,16.926,1,1,0,1,0,0,0,0,0.0,0.0
1002,982,24-09-2019 20:22:00,0,3255.0,2878.0,0.884,16.009,1,1,0,1,0,0,0,0,0.0,0.0
1002,983,24-09-2019 20:24:00,0,3280.0,2739.0,0.835,15.954,125,18,0,18,107,78,29,0,0.0,0.0
1002,984,24-09-2019 20:26:00,0,3280.0,2735.0,0.834,15.952,271,62,28,34,209,161,48,0,0.0,0.0
1002,985,24-09-2019 20:28:00,0,3442.0,3061.0,0.889,16.95,408,207,160,47,201,142,59,19,0.0,0.03
1002,986,24-09-2019 20:30:00,0,3439.0,3069.0,0.892,16.948,69,55,11,44,14,6,8,0,0.0,0.0
1002,987,24-09-2019 20:32:00,0,3341.5,2978.5,0.891,16.4645,84,36,22,14,48,23,25,0,0.0,0.0
1002,988,24-09-2019 20:34:00,0,3244.0,2888.0,0.89,15.981,11,0,0,0,11,1,10,0,0.0,0.0
1002,989,24-09-2019 20:36:00,0,3283.0,2774.0,0.845,16.007,0,0,0,0,0,0,0,0,0.0,0.0
1002,990,24-09-2019 20:38:00,0,3047.0,2669.0,0.876,14.959,49,20,12,8,29,5,24,0,0.0,0.0
1002,991,24-09-2019 20:40:00,0,3273.0,2765.0,0.845,15.955,11,4,2,2,7,2,5,0,0.0,0.0
1002,992,24-09-2019 20:42:00,0,2941.0,2653.0,0.902,14.526,2,0,0,0,2,0,2,0,0.0,0.0
1002,993,24-09-2019 20:44:00,0,2977.0,2515.0,0.845,14.513,117,63,31,32,54,27,27,2,0.0,0.0
1002,994,24-09-2019 20:46:00,0,3049.0,2700.0,0.886,15.004,132,59,24,35,73,36,37,1,0.0,0.0
1002,995,24-09-2019 20:48:00,0,3255.0,2838.0,0.872,15.966,232,75,42,33,157,99,58,1,0.0,0.0
1002,996,24-09-2019 20:50:00,0,3243.0,2877.0,0.887,15.964,22,12,0,12,10,2,8,0,0.0,0.0
1002,997,24-09-2019 20:52:00,0,2966.0,2580.0,0.87,14.543,0,0,0,0,0,0,0,0,0.0,0.0
1002,998,24-09-2019 20:54:00,0,2973.0,2516.0,0.846,14.499,11,2,0,2,9,2,7,0,0.0,0.0
1002,999,24-09-2019 20:56:00,0,2972.0,2514.0,0.846,14.492,56,18,11,7,38,25,13,0,0.01,0.0
1002,1000,24-09-2019 20:58:00,0,2978.0,2553.0,0.857,14.558,4,1,1,0,3,2,1,0,0.0,0.0
1002,1001,24-09-2019 21:00:00,0,2772.0,2404.0,0.868,13.582,2,0,0,0,2,0,2,0,0.0,0.0
1002,1002,24-09-2019 21:02:00,0,2795.0,2313.0,0.827,13.573,27,12,6,6,15,2,13,0,0.0,0.0
1002,1003,24-09-2019 21:04:00,0,2677.0,2290.0,0.855,13.081,12,10,3,7,2,1,1,0,0.0,0.0
1002,1004,24-09-2019 21:06:00,0,2620.0,2275.5,0.8685,12.8415,8,2,1,1,6,3,3,0,0.0,0.0
1002,1005,24-09-2019 21:08:00,0,2563.0,2261.0,0.882,12.602,141,58,26,32,83,41,42,0,0.0,0.0
1002,1006,24-09-2019 21:10:00,0,2748.0,2471.0,0.899,13.564,116,15,8,7,101,60,41,0,0.0,0.0
1002,1007,24-09-2019 21:12:00,0,2768.0,2418.0,0.873,13.584,42,13,0,13,29,16,13,0,0.0,0.0
1002,1008,24-09-2019 21:14:00,0,2953.0,2579.0,0.873,14.488,51,5,2,3,46,10,36,0,0.0,0.0
1002,1009,24-09-2019 21:16:00,0,2773.0,2371.0,0.855,13.552,41,11,6,5,30,8,22,0,0.0,0.0
1002,1010,24-09-2019 21:18:00,0,2977.0,2510.0,0.843,14.51,4,4,0,4,0,0,0,0,0.0,0.0
1002,1011,24-09-2019 21:20:00,0,2868.0,2474.0,0.863,14.04,56,36,19,17,20,13,7,1,0.0,0.0
1002,1012,24-09-2019 21:22:00,0,2959.0,2588.0,0.875,14.524,106,71,38,33,35,8,27,50,0.0,0.01
1002,1013,24-09-2019 21:24:00,0,3448.0,3016.0,0.875,16.923,90,63,31,32,27,4,23,41,0.0,0.09
1002,1014,24-09-2019 21:26:00,0,3402.0,3151.0,0.926,16.891,25,19,12,7,6,1,5,14,0.0,0.28
1002,1015,24-09-2019 21:28:00,0,3436.0,3108.0,0.905,16.979,0,0,0,0,0,0,0,0,0.01,0.0
1002,1016,24-09-2019 21:30:00,0,3419.0,3147.0,0.921,16.954,276,138,107,31,138,107,31,51,0.0,0.0
1002,1017,24-09-2019 21:32:00,0,3218.0,2984.0,0.927,15.982,284,154,119,35,130,92,38,66,0.08,0.0
1002,1018,24-09-2019 21:34:00,0,3644.0,3229.0,0.886,17.932,277,29,7,22,248,194,54,5,0.0,0.0
1002,1019,24-09-2019 21:36:00,0,3724.0,3362.0,0.903,18.395,223,45,18,27,178,115,63,3,0.0,0.0
1002,1020,24-09-2019 21:38:00,0,3930.0,3515.0,0.894,19.376,265,157,112,45,108,75,33,51,0.0,0.0
1002,1021,24-09-2019 21:40:00,0,3913.5,3599.5,0.9195,19.4035,83,36,26,10,47,32,15,10,0.0,0.0
1002,1022,24-09-2019 21:42:00,0,3897.0,3684.0,0.945,19.431,243,152,122,30,91,62,29,50,0.05,0.0
1002,1023,24-09-2019 21:44:00,0,3215.0,2962.0,0.921,15.948,151,104,71,33,47,28,19,13,0.0,0.0
1002,1024,24-09-2019 21:46:00,0,4103.0,3789.0,0.924,20.359,250,120,96,24,130,88,42,54,0.07,0.0
1002,1025,24-09-2019 21:48:00,0,3547.0,3168.0,0.893,17.483,273,183,141,42,90,65,25,61,0.0,0.0
1002,1026,24-09-2019 21:50:00,0,4084.0,3788.0,0.928,20.283,486,264,219,45,222,166,56,198,0.0,0.0
1002,1027,24-09-2019 21:52:00,0,4103.0,3827.0,0.933,20.403,271,157,111,46,114,82,32,105,0.06,0.0
1002,1028,24-09-2019 21:54:00,0,4287.0,3939.0,0.919,21.251,241,120,84,36,121,82,39,79,0.0,0.0
1002,1029,24-09-2019 21:56:00,0,4618.0,4103.0,0.889,22.735,210,90,55,35,120,71,49,45,0.0,0.01
1002,1030,24-09-2019 21:58:00,0,4311.0,3956.0,0.918,21.364,309,142,108,34,167,111,56,50,0.0,0.0
1002,1031,24-09-2019 22:00:00,0,4297.0,3910.0,0.91,21.257,184,109,76,33,75,49,26,58,0.0,0.03
1002,1032,24-09-2019 22:02:00,0,4276.0,3956.0,0.925,21.228,262,105,75,30,157,113,44,51,0.03,0.01
1002,1033,24-09-2019 22:04:00,0,4556.0,3973.0,0.872,22.348,142,77,45,32,65,30,35,47,0.07,0.01
1002,1034,24-09-2019 22:06:00,0,4625.0,4044.0,0.874,22.699,142,64,39,25,78,44,34,57,0.01,0.0
1002,1035,24-09-2019 22:08:00,0,3866.0,3305.0,0.855,18.892,200,87,67,20,113,81,32,27,0.0,0.03
1002,1036,24-09-2019 22:10:00,0,3271.0,2816.0,0.861,16.006,166,101,75,26,65,44,21,97,0.0,0.0
1002,1037,24-09-2019 22:12:00,0,4078.0,3787.0,0.929,20.262,258,126,93,33,132,99,33,24,0.04,0.0
1002,1038,24-09-2019 22:14:00,0,4354.0,3909.5,0.9,21.4835,210,141,91,50,69,37,32,27,0.0,0.01
1002,1039,24-09-2019 22:16:00,0,4630.0,4032.0,0.871,22.705,187,77,44,33,110,69,41,11,0.0,0.0
1002,1040,24-09-2019 22:18:00,0,4699.0,4236.0,0.901,23.203,101,28,13,15,73,44,29,2,0.0,0.0
1002,1041,24-09-2019 22:20:00,0,4617.0,4195.0,0.908,22.836,190,63,29,34,127,82,45,3,0.0,0.0
1002,1042,24-09-2019 22:22:00,0,4703.0,4225.0,0.899,23.206,142,86,48,38,56,27,29,65,0.0,0.0
1002,1043,24-09-2019 22:24:00,0,4809.0,4330.0,0.9,23.741,113,77,42,35,36,4,32,58,0.0,0.0
1002,1044,24-09-2019 22:26:00,0,4813.0,4320.0,0.898,23.745,110,74,48,26,36,7,29,48,0.0,0.06
1002,1045,24-09-2019 22:28:00,0,4602.0,4121.0,0.895,22.694,194,99,63,36,95,57,38,34,0.0,0.0
1002,1046,24-09-2019 22:30:00,0,4644.0,4074.0,0.877,22.808,101,57,31,26,44,11,33,36,0.1,0.03
1002,1047,24-09-2019 22:32:00,0,4203.0,3894.0,0.926,20.873,173,84,52,32,89,53,36,2,0.01,0.0
1002,1048,24-09-2019 22:34:00,0,4104.0,3704.0,0.902,20.27,76,23,14,9,53,34,19,0,0.01,0.0
1002,1049,24-09-2019 22:36:00,0,4099.0,3763.0,0.918,20.317,23,23,2,21,0,0,0,0,0.0,0.0
1002,1050,24-09-2019 22:38:00,0,4430.0,3973.0,0.897,21.852,32,14,4,10,18,6,12,0,0.0,0.0
1002,1051,24-09-2019 22:40:00,0,3917.0,3626.0,0.926,19.448,2,2,0,2,0,0,0,0,0.0,0.0
1002,1052,24-09-2019 22:42:00,0,3933.0,3498.0,0.889,19.37,3,3,2,1,0,0,0,0,0.0,0.0
1002,1053,24-09-2019 22:44:00,0,3732.0,3345.0,0.896,18.406,0,0,0,0,0,0,0,0,0.0,0.0
1002,1054,24-09-2019 22:46:00,0,3625.0,3241.0,0.894,17.872,115,0,0,0,115,100,15,0,0.0,0.0
1002,1055,24-09-2019 22:48:00,0,3774.0,3388.0,0.8975,18.621,288,82,45,37,206,162,44,12,0.01,0.0
1002,1056,24-09-2019 22:50:00,0,3923.0,3535.0,0.901,19.37,51,41,23,18,10,1,9,50,0.0,0.0
1002,1057,24-09-2019 22:52:00,0,4121.0,3711.0,0.9,20.344,117,85,52,33,32,11,21,42,0.0,0.0
1002,1058,24-09-2019 22:54:00,0,3958.0,3492.0,0.882,19.459,235,122,91,31,113,63,50,78,0.0,0.02
1002,1059,24-09-2019 22:56:00,0,4089.0,3789.0,0.927,20.307,129,81,49,32,48,21,27,32,0.08,0.05
1002,1060,24-09-2019 22:58:00,0,4102.0,3779.0,0.921,20.347,109,84,57,27,25,4,21,66,0.0,0.0
1002,1061,24-09-2019 23:00:00,0,4219.0,3916.0,0.928,20.959,123,85,54,31,38,5,33,53,0.0,0.05
1002,1062,24-09-2019 23:02:00,0,4081.0,3746.0,0.918,20.227,198,129,90,39,69,49,20,60,0.08,0.05
1002,1063,24-09-2019 23:04:00,0,3730.0,3375.0,0.905,18.433,351,198,148,50,153,127,26,76,0.0,0.03
1002,1064,24-09-2019 23:06:00,0,3180.0,2673.0,0.841,15.49,278,151,107,44,127,96,31,40,0.0,0.04
1002,1065,24-09-2019 23:08:00,0,4038.0,3526.0,0.873,19.811,242,131,98,33,111,87,24,78,0.0,0.0
1002,1066,24-09-2019 23:10:00,0,4630.0,4052.0,0.875,22.729,161,58,37,21,103,64,39,10,0.01,0.0
1002,1067,24-09-2019 23:12:00,0,4108.0,3754.0,0.914,20.343,193,75,54,21,118,85,33,36,0.0,0.0
1002,1068,24-09-2019 23:14:00,0,3068.0,2647.0,0.863,15.017,212,124,79,45,88,53,35,50,0.0,0.0
1002,1069,24-09-2019 23:16:00,0,4615.0,4139.0,0.897,22.764,84,62,38,24,22,4,18,43,0.0,0.0
1002,1070,24-09-2019 23:18:00,0,4904.0,4438.0,0.905,24.234,69,36,26,10,33,12,21,49,0.0,0.0
1002,1071,24-09-2019 23:20:00,0,5002.0,4531.0,0.906,24.726,103,58,34,24,45,13,32,44,0.03,0.0
1002,1072,24-09-2019 23:22:00,0,4479.0,3961.0,0.8815,22.0345,211,88,54,34,123,82,41,14,0.09,0.0
1002,1073,24-09-2019 23:24:00,0,3956.0,3391.0,0.857,19.343,272,152,119,33,120,87,33,110,0.0,0.0
1002,1074,24-09-2019 23:26:00,0,4625.0,4117.0,0.89,22.779,450,260,211,49,190,145,45,195,0.0,0.01
1002,1075,24-09-2019 23:28:00,0,3849.0,3376.0,0.877,18.904,368,193,138,55,175,125,50,81,0.0,0.0
1002,1076,24-09-2019 23:30:00,0,3463.0,2973.0,0.859,16.935,376,178,131,47,198,142,56,28,0.04,0.02
1002,1077,24-09-2019 23:32:00,0,5196.0,4752.0,0.915,25.734,310,165,126,39,145,112,33,155,0.0,0.0
1002,1078,24-09-2019 23:34:00,0,4286.0,3980.0,0.929,21.294,425,251,199,52,174,137,37,156,0.0,0.0
1002,1079,24-09-2019 23:36:00,0,5308.0,4777.0,0.9,26.203,93,59,34,25,34,16,18,65,0.0,0.0
1002,1080,24-09-2019 23:38:00,0,4940.0,4703.0,0.952,24.669,221,99,55,44,122,76,46,2,0.0,0.01
1002,1081,24-09-2019 23:40:00,0,4609.0,4103.0,0.89,22.703,273,125,92,33,148,97,51,21,0.0,0.02
1002,1082,24-09-2019 23:42:00,0,4970.0,4599.0,0.925,24.673,308,141,102,39,167,122,45,57,0.09,0.0
1002,1083,24-09-2019 23:44:00,0,4807.0,4321.0,0.899,23.722,54,37,15,22,17,3,14,50,0.0,0.0
1002,1084,24-09-2019 23:46:00,0,5482.0,5002.0,0.912,27.138,82,45,25,20,37,8,29,41,0.0,0.0
1002,1085,24-09-2019 23:48:00,0,5264.0,4914.0,0.934,26.182,173,96,73,23,77,48,29,32,0.02,0.02
1002,1086,24-09-2019 23:50:00,0,4799.0,4372.0,0.911,23.747,141,62,31,31,79,41,38,7,0.05,0.0
1002,1087,24-09-2019 23:52:00,0,4634.0,4085.0,0.881,22.782,88,56,32,24,32,11,21,0,0.0,0.0
1002,1088,24-09-2019 23:54:00,0,4129.0,3699.0,0.896,20.365,140,79,33,46,61,31,30,0,0.0,0.0
1002,1089,24-09-2019 23:56:00,0,4393.5,3858.0,0.879,21.5825,123,58,26,32,65,40,25,0,0.0,0.0
1002,1090,24-09-2019 23:58:00,0,4658.0,4017.0,0.862,22.8,55,17,2,15,38,21,17,1,0.0,0.0
1002,1091,25-09-2019 00:00:00,0,3900.0,3590.0,0.921,19.341,29,14,2,12,15,8,7,0,0.0,0.01
1002,1092,25-09-2019 00:02:00,0,3979.0,3366.0,0.846,19.404,6,4,0,4,2,0,2,0,0.0,0.0
1002,1093,25-09-2019 00:04:00,0,3734.0,3338.0,0.894,18.407,7,5,0,5,2,0,2,0,0.0,0.0
1002,1094,25-09-2019 00:06:00,0,3623.0,3282.0,0.906,17.907,203,103,61,42,100,60,40,0,0.0,0.0
1002,1095,25-09-2019 00:08:00,0,4009.0,3652.0,0.911,19.841,396,229,177,52,167,127,40,72,0.0,0.0
1002,1096,25-09-2019 00:10:00,0,4413.0,3968.0,0.899,21.779,279,155,120,35,124,81,43,69,0.0,0.0
1002,1097,25-09-2019 00:12:00,0,4518.0,4029.0,0.892,22.263,54,36,22,14,18,6,12,57,0.0,0.03
1002,1098,25-09-2019 00:14:00,0,4640.0,4069.0,0.877,22.785,80,61,46,15,19,7,12,63,0.0,0.0
1002,1099,25-09-2019 00:16:00,0,4083.0,3865.0,0.947,20.364,188,60,37,23,128,94,34,12,0.0,0.02
1002,1100,25-09-2019 00:18:00,0,3959.0,3391.0,0.857,19.351,156,61,28,33,95,61,34,7,0.0,0.0
1002,1101,25-09-2019 00:20:00,0,3954.0,3446.0,0.871,19.395,46,24,6,18,22,3,19,0,0.0,0.0
1002,1102,25-09-2019 00:22:00,0,3914.0,3600.0,0.92,19.406,75,38,26,12,37,15,22,2,0.0,0.0
1002,1103,25-09-2019 00:24:00,0,3938.0,3511.0,0.891,19.403,51,19,11,8,32,15,17,0,0.0,0.0
1002,1104,25-09-2019 00:26:00,0,3624.0,3307.0,0.913,17.94,107,16,7,9,91,59,32,0,0.0,0.0
1002,1105,25-09-2019 00:28:00,0,3627.0,3270.0,0.902,17.909,31,15,5,10,16,6,10,0,0.0,0.01
1002,1106,25-09-2019 00:30:00,0,3740.0,3331.0,0.891,18.422,215,65,29,36,150,95,55,9,0.0,0.0
1002,1107,25-09-2019 00:32:00,0,3853.0,3392.0,0.88,18.935,397,175,128,47,222,161,61,27,0.0,0.0
1002,1108,25-09-2019 00:34:00,0,3619.0,3291.0,0.909,17.902,99,32,8,24,67,29,38,62,0.0,0.0
1002,1109,25-09-2019 00:36:00,0,4112.0,3729.0,0.907,20.33,94,25,5,20,69,21,48,50,0.0,0.0
1002,1110,25-09-2019 00:38:00,0,4085.0,3773.0,0.924,20.272,66,21,7,14,45,13,32,36,0.0,0.03
1002,1111,25-09-2019 00:40:00,0,4126.0,3692.0,0.895,20.345,88,33,14,19,55,22,33,45,0.0,0.05
1002,1112,25-09-2019 00:42:00,0,3925.0,3554.0,0.905,19.399,74,32,19,13,42,20,22,48,0.0,0.05
1002,1113,25-09-2019 00:44:00,0,3924.0,3489.0,0.889,19.324,111,47,15,32,64,41,23,48,0.0,0.0
1002,1114,25-09-2019 00:46:00,0,4075.0,3908.0,0.959,20.381,77,53,26,27,24,10,14,56,0.0,0.07
1002,1115,25-09-2019 00:48:00,0,3940.0,3460.0,0.878,19.353,89,69,47,22,20,4,16,50,0.0,0.07
1002,1116,25-09-2019 00:50:00,0,3849.0,3368.0,0.875,18.892,176,76,52,24,100,67,33,106,0.09,0.05
1002,1117,25-09-2019 00:52:00,0,3054.0,2640.0,0.865,14.954,337,184,144,40,153,112,41,98,0.0,0.0
1002,1118,25-09-2019 00:54:00,0,3554.0,3153.0,0.887,17.494,312,162,121,41,150,113,37,36,0.0,0.0
1002,1119,25-09-2019 00:56:00,0,4118.0,3742.0,0.909,20.366,232,121,82,39,111,74,37,43,0.08,0.0
1002,1120,25-09-2019 00:58:00,0,4108.0,3704.0,0.902,20.285,385,209,155,54,176,137,39,62,0.01,0.01
1002,1121,25-09-2019 01:00:00,0,4033.0,3634.0,0.901,19.913,87,63,44,19,24,5,19,49,0.0,0.0
1002,1122,25-09-2019 01:02:00,0,4818.0,4304.0,0.893,23.75,88,63,41,22,25,9,16,37,0.0,0.12
1002,1123,25-09-2019 01:04:00,0,4565.0,4110.0,0.9005,22.538,168,75,44,31,93,65,28,24,0.12,0.05
1002,1124,25-09-2019 01:06:00,0,4312.0,3916.0,0.908,21.326,111,41,23,18,70,37,33,6,0.08,0.0
1002,1125,25-09-2019 01:08:00,0,4097.0,3841.0,0.937,20.396,379,200,136,64,179,122,57,9,0.0,0.0
1002,1126,25-09-2019 01:10:00,0,3431.0,3083.0,0.899,16.931,351,139,97,42,212,164,48,5,0.0,0.0
1002,1127,25-09-2019 01:12:00,0,4198.0,3878.0,0.924,20.834,282,139,91,48,143,101,42,38,0.0,0.1
1002,1128,25-09-2019 01:14:00,0,4649.0,4135.0,0.889,22.894,296,173,127,46,123,94,29,63,0.0,0.0
1002,1129,25-09-2019 01:16:00,0,3834.0,3332.0,0.869,18.795,239,123,87,36,116,86,30,42,0.0,0.0
1002,1130,25-09-2019 01:18:00,0,4644.0,4088.0,0.88,22.824,153,72,35,37,81,52,29,15,0.0,0.0
1002,1131,25-09-2019 01:20:00,0,4688.0,4209.0,0.898,23.131,72,29,14,15,43,20,23,0,0.0,0.0
1002,1132,25-09-2019 01:22:00,0,4624.0,4081.0,0.883,22.737,80,46,12,34,34,10,24,3,0.0,0.0
1002,1133,25-09-2019 01:24:00,0,4299.0,3927.0,0.913,21.284,100,64,22,42,36,15,21,0,0.01,0.0
1002,1134,25-09-2019 01:26:00,0,4307.0,3895.0,0.904,21.281,89,31,10,21,58,30,28,0,0.0,0.0
1002,1135,25-09-2019 01:28:00,0,4082.0,3831.0,0.938,20.326,141,10,4,6,131,93,38,0,0.0,0.0
1002,1136,25-09-2019 01:30:00,0,3950.0,3466.0,0.878,19.4,28,18,3,15,10,4,6,0,0.0,0.0
1002,1137,25-09-2019 01:32:00,0,3838.0,3318.0,0.864,18.797,12,12,6,6,0,0,0,0,0.0,0.0
1002,1138,25-09-2019 01:34:00,0,3643.0,3246.0,0.891,17.945,28,16,2,14,12,5,7,0,0.0,0.0
1002,1139,25-09-2019 01:36:00,0,3438.0,3121.0,0.908,17.002,0,0,0,0,0,0,0,0,0.0,0.0
1002,1140,25-09-2019 01:38:00,0,3334.0,2993.0,0.8975,16.4505,8,3,1,2,5,4,1,0,0.0,0.0
1002,1141,25-09-2019 01:40:00,0,3230.0,2865.0,0.887,15.899,0,0,0,0,0,0,0,0,0.0,0.0
1002,1142,25-09-2019 01:42:00,0,3262.0,2876.0,0.882,16.035,183,63,26,37,120,72,48,0,0.0,0.0
1002,1143,25-09-2019 01:44:00,0,3516.0,3245.0,0.923,17.444,259,132,99,33,127,85,42,67,0.0,0.0
1002,1144,25-09-2019 01:46:00,0,3920.0,3560.0,0.908,19.385,46,24,10,14,22,2,20,19,0.0,0.23
1002,1145,25-09-2019 01:48:00,0,3944.0,3571.0,0.905,19.491,5,0,0,0,5,0,5,0,0.0,0.01
1002,1146,25-09-2019 01:50:00,0,3904.0,3539.0,0.907,19.298,124,60,43,17,64,43,21,59,0.0,0.0
1002,1147,25-09-2019 01:52:00,0,3815.0,3473.0,0.91,18.877,284,171,132,39,113,95,18,193,0.0,0.04
1002,1148,25-09-2019 01:54:00,0,3905.0,3607.0,0.924,19.379,294,132,101,31,162,111,51,65,0.11,0.0
1002,1149,25-09-2019 01:56:00,0,3899.0,3626.0,0.93,19.376,177,80,43,37,97,63,34,5,0.02,0.0
1002,1150,25-09-2019 01:58:00,0,4085.0,3881.0,0.95,20.393,0,0,0,0,0,0,0,0,0.0,0.0
1002,1151,25-09-2019 02:00:00,0,4089.0,3835.0,0.938,20.357,316,208,154,54,108,80,28,7,0.0,0.0
1002,1152,25-09-2019 02:02:00,0,3613.0,3309.0,0.916,17.899,378,157,115,42,221,159,62,25,0.0,0.0
1002,1153,25-09-2019 02:04:00,0,3429.0,3138.0,0.915,16.986,277,134,97,37,143,109,34,100,0.02,0.0
1002,1154,25-09-2019 02:06:00,0,4096.0,3754.0,0.917,20.297,152,81,40,41,71,42,29,0,0.07,0.0
1002,1155,25-09-2019 02:08:00,0,4100.0,3814.0,0.93,20.376,63,40,13,27,23,13,10,2,0.0,0.0
1002,1156,25-09-2019 02:10:00,0,4118.0,3722.0,0.904,20.344,85,47,26,21,38,14,24,0,0.0,0.0
1002,1157,25-09-2019 02:12:00,0,4113.0,3724.0,0.9055,20.327,70,41,16,25,29,12,17,0,0.0,0.0
1002,1158,25-09-2019 02:14:00,0,4108.0,3726.0,0.907,20.31,115,29,10,19,86,59,27,0,0.0,0.0
1002,1159,25-09-2019 02:16:00,0,4002.0,3679.0,0.919,19.841,75,31,13,18,44,19,25,0,0.0,0.0
1002,1160,25-09-2019 02:18:00,0,3928.0,3570.0,0.909,19.428,44,0,0,0,44,0,44,0,0.0,0.0
1002,1161,25-09-2019 02:20:00,0,3832.0,3385.0,0.883,18.846,42,12,5,7,30,15,15,0,0.0,0.0
1002,1162,25-09-2019 02:22:00,0,3438.0,3060.0,0.89,16.935,5,2,1,1,3,1,2,0,0.0,0.0
1002,1163,25-09-2019 02:24:00,0,3344.0,2963.0,0.886,16.455,38,4,3,1,34,14,20,0,0.0,0.0
1002,1164,25-09-2019 02:26:00,0,3245.0,2880.0,0.888,15.973,15,0,0,0,15,0,15,0,0.0,0.0
1002,1165,25-09-2019 02:28:00,0,3276.0,2801.0,0.855,16.009,31,13,4,9,18,4,14,0,0.0,0.0
1002,1166,25-09-2019 02:30:00,0,3244.0,2906.0,0.896,16.0,3,3,0,3,0,0,0,0,0.0,0.0
1002,1167,25-09-2019 02:32:00,0,3267.0,2838.0,0.869,16.015,2,2,0,2,0,0,0,0,0.0,0.0
1002,1168,25-09-2019 02:34:00,0,3146.0,2750.0,0.874,15.44,60,25,15,10,35,19,16,1,0.0,0.0
1002,1169,25-09-2019 02:36:00,0,3233.0,2886.0,0.893,15.933,6,4,0,4,2,0,2,0,0.0,0.0
1002,1170,25-09-2019 02:38:00,0,3162.0,2756.0,0.871,15.51,15,4,0,4,11,1,10,0,0.0,0.0
1002,1171,25-09-2019 02:40:00,0,2935.0,2719.0,0.926,14.574,5,0,0,0,5,0,5,0,0.0,0.0
1002,1172,25-09-2019 02:42:00,0,2942.0,2658.0,0.903,14.534,67,29,19,10,38,21,17,0,0.0,0.0
1002,1173,25-09-2019 02:44:00,0,3265.0,2820.0,0.864,15.988,8,0,0,0,8,2,6,0,0.0,0.0
1002,1174,25-09-2019 02:46:00,0,3203.0,2808.0,0.877,15.729,100,49,24,25,51,31,20,0,0.0,0.0
1002,1175,25-09-2019 02:48:00,0,3141.0,2796.0,0.89,15.47,456,167,118,49,289,221,68,4,0.0,0.0
1002,1176,25-09-2019 02:50:00,0,3220.0,3015.0,0.936,16.024,337,155,111,44,182,130,52,76,0.0,0.0
1002,1177,25-09-2019 02:52:00,0,3430.0,3129.0,0.912,16.98,290,135,96,39,155,111,44,15,0.0,0.05
1002,1178,25-09-2019 02:54:00,0,3400.0,3270.0,0.962,17.018,228,65,37,28,163,118,45,4,0.0,0.0
1002,1179,25-09-2019 02:56:00,0,3225.0,2972.0,0.922,15.997,91,11,5,6,80,62,18,0,0.01,0.0
1002,1180,25-09-2019 02:58:00,0,3212.0,2985.0,0.929,15.958,57,14,1,13,43,23,20,0,0.0,0.0
1002,1181,25-09-2019 03:00:00,0,3234.0,2905.0,0.898,15.958,29,7,1,6,22,6,16,1,0.0,0.0
1002,1182,25-09-2019 03:02:00,0,3272.0,2803.0,0.857,15.995,107,6,0,6,101,71,30,0,0.0,0.0
1002,1183,25-09-2019 03:04:00,0,3278.0,2775.0,0.847,15.988,41,3,0,3,38,3,35,0,0.0,0.0
1002,1184,25-09-2019 03:06:00,0,2934.0,2695.0,0.918,14.543,53,3,0,3,50,7,43,0,0.0,0.0
1002,1185,25-09-2019 03:08:00,0,2953.0,2619.0,0.887,14.534,39,0,0,0,39,0,39,0,0.0,0.0
1002,1186,25-09-2019 03:10:00,0,2939.0,2666.0,0.907,14.531,168,39,14,25,129,80,49,0,0.0,0.0
1002,1187,25-09-2019 03:12:00,0,3225.0,2923.0,0.906,15.944,94,34,8,26,60,37,23,2,0.0,0.0
1002,1188,25-09-2019 03:14:00,0,3335.0,3036.0,0.91,16.503,79,24,11,13,55,33,22,0,0.0,0.0
1002,1189,25-09-2019 03:16:00,0,3230.0,2970.0,0.919,16.013,12,0,0,0,12,3,9,0,0.0,0.0
1002,1190,25-09-2019 03:18:00,0,3263.0,2801.0,0.858,15.959,20,9,2,7,11,1,10,2,0.0,0.0
1002,1191,25-09-2019 03:20:00,0,3106.5,2729.0,0.8795,15.261,0,0,0,0,0,0,0,0,0.0,0.0
1002,1192,25-09-2019 03:22:00,0,2950.0,2657.0,0.901,14.563,41,40,29,11,1,0,1,0,0.0,0.0
1002,1193,25-09-2019 03:24:00,0,2971.0,2516.0,0.847,14.493,181,172,139,33,9,6,3,1,0.0,0.0
1002,1194,25-09-2019 03:26:00,0,2944.0,2649.0,0.9,14.53,78,20,2,18,58,8,50,0,0.0,0.0
1002,1195,25-09-2019 03:28:00,0,2753.0,2441.0,0.887,13.549,7,2,0,2,5,2,3,0,0.0,0.0
1002,1196,25-09-2019 03:30:00,0,2769.0,2425.0,0.876,13.594,27,1,0,1,26,12,14,0,0.0,0.0
1002,1197,25-09-2019 03:32:00,0,2737.0,2488.0,0.909,13.538,2,0,0,0,2,0,2,0,0.0,0.0
1002,1198,25-09-2019 03:34:00,0,2776.0,2398.0,0.864,13.594,68,9,2,7,59,35,24,0,0.0,0.0
1002,1199,25-09-2019 03:36:00,0,2956.0,2567.0,0.868,14.49,103,32,7,25,71,32,39,0,0.0,0.0
1002,1200,25-09-2019 03:38:00,0,2928.0,2667.0,0.911,14.488,337,142,107,35,195,149,46,63,0.0,0.0
1002,1201,25-09-2019 03:40:00,0,3235.0,2939.0,0.908,16.0,236,134,92,42,102,70,32,43,0.01,0.0
1002,1202,25-09-2019 03:42:00,0,3214.0,2962.0,0.922,15.943,116,52,29,23,64,36,28,7,0.0,0.0
1002,1203,25-09-2019 03:44:00,0,3246.0,2886.0,0.889,15.983,65,32,18,14,33,19,14,4,0.0,0.0
1002,1204,25-09-2019 03:46:00,0,3264.0,2842.0,0.871,16.005,214,20,7,13,194,147,47,2,0.0,0.0
1002,1205,25-09-2019 03:48:00,0,3150.0,2730.0,0.867,15.432,7,1,1,0,6,2,4,0,0.0,0.0
1002,1206,25-09-2019 03:50:00,0,3256.0,2902.0,0.891,16.042,16,1,1,0,15,2,13,0,0.0,0.0
1002,1207,25-09-2019 03:52:00,0,3235.0,2965.0,0.916,16.03,86,3,1,2,83,59,24,0,0.0,0.0
1002,1208,25-09-2019 03:54:00,0,3324.5,3070.5,0.923,16.499,37,0,0,0,37,20,17,0,0.0,0.0
1002,1209,25-09-2019 03:56:00,0,3414.0,3176.0,0.93,16.968,0,0,0,0,0,0,0,0,0.0,0.0
1002,1210,25-09-2019 03:58:00,0,3326.0,3048.0,0.917,16.478,36,17,6,11,19,7,12,0,0.0,0.0
1002,1211,25-09-2019 04:00:00,0,3236.0,2952.0,0.912,16.017,0,0,0,0,0,0,0,0,0.0,0.0
1002,1212,25-09-2019 04:02:00,0,3249.0,2800.0,0.862,15.9,18,2,0,2,16,0,16,0,0.0,0.0
1002,1213,25-09-2019 04:04:00,0,2952.0,2682.0,0.909,14.601,3,0,0,0,3,0,3,0,0.0,0.0
1002,1214,25-09-2019 04:06:00,0,2979.0,2533.0,0.85,14.541,0,0,0,0,0,0,0,0,0.0,0.0
1002,1215,25-09-2019 04:08:00,0,2744.0,2442.0,0.89,13.516,0,0,0,0,0,0,0,0,0.0,0.0
1002,1216,25-09-2019 04:10:00,0,2756.0,2433.0,0.883,13.553,11,8,0,8,3,1,2,0,0.0,0.0
1002,1217,25-09-2019 04:12:00,0,2589.0,2169.0,0.838,12.601,19,3,0,3,16,1,15,0,0.0,0.0
1002,1218,25-09-2019 04:14:00,0,2579.0,2189.0,0.849,12.583,32,1,0,1,31,13,18,0,0.0,0.0
1002,1219,25-09-2019 04:16:00,0,2868.0,2475.0,0.863,14.038,121,49,18,31,72,42,30,0,0.0,0.0
1002,1220,25-09-2019 04:18:00,0,2953.0,2589.0,0.877,14.502,4,1,0,1,3,0,3,0,0.0,0.0
1002,1221,25-09-2019 04:20:00,0,2775.0,2413.0,0.87,13.604,11,4,1,3,7,1,6,0,0.0,0.0
1002,1222,25-09-2019 04:22:00,0,2553.0,2297.0,0.9,12.6,40,2,0,2,38,8,30,0,0.0,0.0
1002,1223,25-09-2019 04:24:00,0,2655.0,2325.0,0.876,13.035,14,0,0,0,14,6,8,0,0.0,0.0
1002,1224,25-09-2019 04:26:00,0,2561.0,2247.0,0.877,12.577,1,0,0,0,1,1,0,0,0.0,0.0
1002,1225,25-09-2019 04:28:00,0,2571.5,2233.5,0.8685,12.6035,4,0,0,0,4,0,4,0,0.0,0.0
1002,1226,25-09-2019 04:30:00,0,2582.0,2220.0,0.86,12.63,69,27,18,9,42,21,21,3,0.0,0.0
1002,1227,25-09-2019 04:32:00,0,2844.0,2549.0,0.896,14.027,202,124,83,41,78,48,30,73,0.0,0.0
1002,1228,25-09-2019 04:34:00,0,3030.0,2755.0,0.909,14.988,63,36,13,23,27,3,24,54,0.0,0.0
1002,1229,25-09-2019 04:36:00,0,3255.0,2887.0,0.887,16.022,79,57,32,25,22,3,19,48,0.0,0.0
1002,1230,25-09-2019 04:38:00,0,3425.0,3114.0,0.909,16.942,65,35,20,15,30,6,24,56,0.0,0.0
1002,1231,25-09-2019 04:40:00,0,3388.0,3222.0,0.951,16.915,253,136,101,35,117,80,37,60,0.0,0.02
1002,1232,25-09-2019 04:42:00,0,3233.0,2971.0,0.919,16.028,259,137,105,32,122,84,38,81,0.0,0.0
1002,1233,25-09-2019 04:44:00,0,3411.0,3242.0,0.95,17.029,241,130,101,29,111,79,32,65,0.0,0.0
1002,1234,25-09-2019 04:46:00,0,3809.0,3448.0,0.905,18.826,160,62,41,21,98,52,46,35,0.0,0.0
1002,1235,25-09-2019 04:48:00,0,3152.0,2788.0,0.884,15.506,193,109,81,28,84,59,25,90,0.0,0.0
1002,1236,25-09-2019 04:50:00,0,3452.0,3035.0,0.879,16.961,202,106,72,34,96,64,32,63,0.07,0.0
1002,1237,25-09-2019 04:52:00,0,3611.0,3355.0,0.929,17.943,141,65,41,24,76,52,24,9,0.0,0.0
1002,1238,25-09-2019 04:54:00,0,2939.0,2638.0,0.897,14.501,107,67,45,22,40,21,19,71,0.0,0.0
1002,1239,25-09-2019 04:56:00,0,3928.0,3593.0,0.915,19.453,96,67,45,22,29,10,19,54,0.0,0.0
1002,1240,25-09-2019 04:58:00,0,4636.0,4088.0,0.882,22.791,220,110,73,37,110,71,39,51,0.13,0.03
1002,1241,25-09-2019 05:00:00,0,3888.0,3642.0,0.937,19.351,207,118,84,34,89,61,28,119,0.0,0.0
1002,1242,25-09-2019 05:02:00,0,4269.0,3852.5,0.9055,21.085,107,82,53,29,25,4,21,53,0.0,0.0
1002,1243,25-09-2019 05:04:00,0,4650.0,4063.0,0.874,22.819,90,65,34,31,25,7,18,55,0.0,0.04
1002,1244,25-09-2019 05:06:00,0,4626.0,4056.0,0.877,22.719,254,138,100,38,116,73,43,20,0.07,0.09
1002,1245,25-09-2019 05:08:00,0,3945.0,3431.0,0.87,19.342,265,134,99,35,131,96,35,157,0.0,0.0
1002,1246,25-09-2019 05:10:00,0,3256.0,2838.0,0.872,15.97,139,69,43,26,70,35,35,17,0.0,0.0
1002,1247,25-09-2019 05:12:00,0,3264.0,2777.0,0.851,15.933,173,112,78,34,61,40,21,38,0.0,0.11
1002,1248,25-09-2019 05:14:00,0,4138.0,3698.0,0.893,20.399,256,123,91,32,133,99,34,93,0.0,0.0
1002,1249,25-09-2019 05:16:00,0,3455.0,2990.0,0.865,16.922,163,103,71,32,60,40,20,110,0.0,0.0
1002,1250,25-09-2019 05:18:00,0,4084.0,3821.0,0.935,20.322,162,59,26,33,103,81,22,2,0.0,0.0
1002,1251,25-09-2019 05:20:00,0,4639.0,4078.0,0.879,22.792,143,75,41,34,68,40,28,4,0.0,0.0
1002,1252,25-09-2019 05:22:00,0,4306.0,3903.0,0.906,21.285,159,46,19,27,113,66,47,1,0.0,0.0
1002,1253,25-09-2019 05:24:00,0,4204.0,3878.0,0.923,20.856,170,72,43,29,98,64,34,0,0.0,0.0
1002,1254,25-09-2019 05:26:00,0,4214.0,3864.0,0.917,20.882,387,221,169,52,166,115,51,8,0.0,0.0
1002,1255,25-09-2019 05:28:00,0,3412.0,3155.0,0.925,16.937,276,116,87,29,160,113,47,36,0.01,0.0
1002,1256,25-09-2019 05:30:00,0,3841.0,3371.0,0.878,18.865,419,242,197,45,177,141,36,98,0.0,0.0
1002,1257,25-09-2019 05:32:00,0,4126.0,3730.0,0.904,20.386,289,214,156,58,75,60,15,5,0.0,0.0
1002,1258,25-09-2019 05:34:00,0,4194.0,3879.0,0.925,20.82,174,79,50,29,95,74,21,0,0.0,0.0
1002,1259,25-09-2019 05:36:00,0,4065.5,3699.5,0.9095,20.114,146,52,29,23,94,56,38,20,0.0,0.0
1002,1260,25-09-2019 05:38:00,0,3937.0,3520.0,0.894,19.408,89,28,6,22,61,39,22,1,0.0,0.0
1002,1261,25-09-2019 05:40:00,0,3955.0,3393.0,0.858,19.338,30,10,1,9,20,12,8,0,0.0,0.0
1002,1262,25-09-2019 05:42:00,0,3757.0,3236.0,0.861,18.385,46,4,2,2,42,25,17,0,0.0,0.0
1002,1263,25-09-2019 05:44:00,0,3748.0,3258.0,0.869,18.375,144,22,4,18,122,100,22,1,0.0,0.0
1002,1264,25-09-2019 05:46:00,0,3663.0,3153.0,0.861,17.924,9,6,2,4,3,0,3,0,0.0,0.0
1002,1265,25-09-2019 05:48:00,0,3424.0,3062.0,0.894,16.881,5,3,0,3,2,1,1,0,0.0,0.0
1002,1266,25-09-2019 05:50:00,0,3478.0,2925.0,0.841,16.94,23,11,2,9,12,1,11,0,0.0,0.0
1002,1267,25-09-2019 05:52:00,0,3308.0,2639.0,0.798,15.954,5,5,0,5,0,0,0,0,0.0,0.0
1002,1268,25-09-2019 05:54:00,0,2995.0,2466.0,0.824,14.53,6,6,3,3,0,0,0,0,0.0,0.0
1002,1269,25-09-2019 05:56:00,0,3032.0,2375.0,0.783,14.577,86,21,7,14,65,45,20,1,0.0,0.0
1002,1270,25-09-2019 05:58:00,0,3073.0,2609.0,0.849,14.996,127,40,7,33,87,61,26,0,0.0,0.0
1002,1271,25-09-2019 06:00:00,1,3281.0,2732.0,0.833,15.951,523,222,172,50,301,232,69,53,0.0,0.0
1002,1272,25-09-2019 06:02:00,1,3279.0,2788.0,0.85,16.004,387,217,167,50,170,119,51,105,0.0,0.0
1002,1273,25-09-2019 06:04:00,1,3458.0,2988.0,0.864,16.934,366,204,160,44,162,116,46,86,0.0,0.0
1002,1274,25-09-2019 06:06:00,1,3676.0,3152.0,0.857,17.973,435,251,204,47,184,133,51,103,0.0,0.0
1002,1275,25-09-2019 06:08:00,1,3646.0,3132.0,0.859,17.835,109,80,52,28,29,8,21,55,0.0,0.0
1002,1276,25-09-2019 06:10:00,1,3810.0,3272.0,0.859,18.635,36,28,16,12,8,1,7,42,0.0,0.0
1002,1277,25-09-2019 06:12:00,1,3974.0,3412.0,0.859,19.435,82,57,31,26,25,7,18,35,0.0,0.0
1002,1278,25-09-2019 06:14:00,1,3975.0,3329.0,0.837,19.347,220,99,62,37,121,79,42,37,0.0,0.0
1002,1279,25-09-2019 06:16:00,1,3653.0,3171.0,0.868,17.905,625,398,324,74,227,168,59,44,0.0,0.0
1002,1280,25-09-2019 06:18:00,1,3450.0,3062.0,0.887,16.984,331,187,139,48,144,108,36,31,0.0,0.0
1002,1281,25-09-2019 06:20:00,1,3444.0,2991.0,0.868,16.882,364,185,139,46,179,129,50,81,0.04,0.0
1002,1282,25-09-2019 06:22:00,1,3771.0,3197.0,0.848,18.397,482,213,166,47,269,204,65,21,0.01,0.01
1002,1283,25-09-2019 06:24:00,1,3948.0,3443.0,0.872,19.367,119,64,47,17,55,45,10,0,0.0,0.34
1002,1284,25-09-2019 06:26:00,1,3756.0,3242.0,0.863,18.387,427,231,173,58,196,145,51,4,0.0,0.0
1002,1285,25-09-2019 06:28:00,1,3371.0,2896.0,0.859,16.487,237,118,81,37,119,85,34,141,0.0,0.0
1002,1286,25-09-2019 06:30:00,1,3666.0,3087.0,0.842,17.863,261,172,124,48,89,61,28,35,0.0,0.0
1002,1287,25-09-2019 06:32:00,1,3678.0,3125.0,0.85,17.949,132,70,32,38,62,39,23,1,0.0,0.0
1002,1288,25-09-2019 06:34:00,1,3872.0,3273.0,0.845,18.878,158,69,43,26,89,51,38,1,0.0,0.0
1002,1289,25-09-2019 06:36:00,1,3774.0,3234.0,0.857,18.449,287,133,86,47,154,106,48,2,0.0,0.0
1002,1290,25-09-2019 06:38:00,1,3655.0,3126.0,0.855,17.861,52,32,23,9,20,10,10,0,0.0,0.0
1002,1291,25-09-2019 06:40:00,1,3666.0,3180.0,0.867,17.967,85,31,13,18,54,28,26,0,0.0,0.0
1002,1292,25-09-2019 06:42:00,1,3452.0,2973.0,0.861,16.892,125,20,3,17,105,62,43,0,0.0,0.0
1002,1293,25-09-2019 06:44:00,1,3406.5,2930.5,0.86,16.666,139,22,7,15,117,72,45,3,0.0,0.0
1002,1294,25-09-2019 06:46:00,1,3361.0,2888.0,0.859,16.44,31,12,4,8,19,3,16,0,0.0,0.0
1002,1295,25-09-2019 06:48:00,1,3158.0,2791.0,0.884,15.534,11,1,0,1,10,0,10,0,0.0,0.0
1002,1296,25-09-2019 06:50:00,1,2980.0,2511.0,0.843,14.523,26,17,2,15,9,2,7,0,0.0,0.0
1002,1297,25-09-2019 06:52:00,1,2971.0,2494.0,0.839,14.468,13,12,0,12,1,0,1,0,0.01,0.0
1002,1298,25-09-2019 06:54:00,1,2894.0,2421.0,0.837,14.082,2,2,0,2,0,0,0,0,0.0,0.0
1002,1299,25-09-2019 06:56:00,1,2907.0,2345.0,0.806,14.052,5,1,0,1,4,1,3,0,0.0,0.0
1002,1300,25-09-2019 06:58:00,1,2668.0,2303.0,0.863,13.062,7,0,0,0,7,3,4,0,0.0,0.0
1002,1301,25-09-2019 07:00:00,1,2695.0,2257.0,0.837,13.118,5,0,0,0,5,0,5,0,0.0,0.0
1002,1302,25-09-2019 07:02:00,1,2495.0,2068.0,0.829,12.121,11,2,1,1,9,0,9,0,0.0,0.0
1002,1303,25-09-2019 07:04:00,1,2492.0,2021.0,0.811,12.057,0,0,0,0,0,0,0,0,0.0,0.0
1002,1304,25-09-2019 07:06:00,1,2389.0,2009.0,0.841,11.638,11,10,3,7,1,0,1,0,0.0,0.0
1002,1305,25-09-2019 07:08:00,1,2663.0,2309.0,0.867,13.049,3,3,2,1,0,0,0,0,0.0,0.0
1002,1306,25-09-2019 07:10:00,1,2673.0,2260.0,0.845,13.033,0,0,0,0,0,0,0,0,0.0,0.0
1002,1307,25-09-2019 07:12:00,1,2458.0,2189.0,0.891,12.108,8,8,0,8,0,0,0,0,0.0,0.0
1002,1308,25-09-2019 07:14:00,1,2697.0,2251.0,0.835,13.118,0,0,0,0,0,0,0,0,0.0,0.0
1002,1309,25-09-2019 07:16:00,1,2561.0,2228.0,0.87,12.556,56,21,11,10,35,16,19,0,0.0,0.0
1002,1310,25-09-2019 07:18:00,1,2626.0,2243.5,0.8545,12.83,75,30,8,22,45,18,27,0,0.0,0.0
1002,1311,25-09-2019 07:20:00,1,2691.0,2259.0,0.839,13.104,312,191,151,40,121,78,43,56,0.0,0.0
1002,1312,25-09-2019 07:22:00,1,2673.0,2262.0,0.846,13.034,221,124,89,35,97,64,33,33,0.0,0.0
1002,1313,25-09-2019 07:24:00,1,2888.0,2412.0,0.835,14.049,121,60,25,35,61,28,33,2,0.0,0.0
1002,1314,25-09-2019 07:26:00,1,2898.0,2334.0,0.805,14.003,563,304,234,70,259,194,65,4,0.0,0.0
1002,1315,25-09-2019 07:28:00,1,2880.0,2446.0,0.849,14.055,249,138,100,38,111,87,24,42,0.0,0.0
1002,1316,25-09-2019 07:30:00,1,3090.0,2515.0,0.814,14.959,121,110,68,42,11,3,8,53,0.0,0.0
1002,1317,25-09-2019 07:32:00,1,3168.0,2712.0,0.856,15.484,244,112,72,40,132,95,37,30,0.0,0.0
1002,1318,25-09-2019 07:34:00,1,2859.0,2492.0,0.872,14.023,390,192,148,44,198,138,60,6,0.0,0.0
1002,1319,25-09-2019 07:36:00,1,2984.0,2494.0,0.836,14.52,163,92,54,38,71,46,25,25,0.0,0.0
1002,1320,25-09-2019 07:38:00,1,2988.0,2488.0,0.833,14.528,114,31,10,21,83,52,31,6,0.0,0.0
1002,1321,25-09-2019 07:40:00,1,3215.0,2550.0,0.793,15.491,76,3,1,2,73,58,15,0,0.0,0.0
1002,1322,25-09-2019 07:42:00,1,2888.0,2400.0,0.831,14.035,119,24,1,23,95,61,34,1,0.0,0.0
1002,1323,25-09-2019 07:44:00,1,2889.0,2393.0,0.828,14.034,94,19,1,18,75,44,31,0,0.0,0.0
1002,1324,25-09-2019 07:46:00,1,2908.0,2342.0,0.805,14.051,17,1,0,1,16,12,4,0,0.0,0.0
1002,1325,25-09-2019 07:48:00,1,2687.0,2188.0,0.814,13.009,45,6,0,6,39,22,17,0,0.0,0.0
1002,1326,25-09-2019 07:50:00,1,2688.0,2237.0,0.832,13.069,10,0,0,0,10,1,9,0,0.0,0.0
1002,1327,25-09-2019 07:52:00,1,2697.0,2201.0,0.816,13.064,13,3,1,2,10,1,9,0,0.0,0.0
1002,1328,25-09-2019 07:54:00,1,2706.0,2165.0,0.8,13.059,28,0,0,0,28,6,22,0,0.0,0.0
1002,1329,25-09-2019 07:56:00,1,2591.0,2142.0,0.827,12.582,34,1,0,1,33,9,24,0,0.0,0.0
1002,1330,25-09-2019 07:58:00,1,2506.0,2009.0,0.802,12.098,1,0,0,0,1,1,0,0,0.0,0.0
1002,1331,25-09-2019 08:00:00,1,2500.0,2025.0,0.81,12.092,51,4,2,2,47,23,24,0,0.0,0.0
1002,1332,25-09-2019 08:02:00,1,2502.0,2032.0,0.812,12.107,1,0,0,0,1,0,1,0,0.0,0.0
1002,1333,25-09-2019 08:04:00,1,2285.0,1937.0,0.847,11.149,52,1,0,1,51,17,34,0,0.0,0.0
1002,1334,25-09-2019 08:06:00,1,2173.0,1843.0,0.848,10.603,33,2,0,2,31,7,24,0,0.0,0.0
1002,1335,25-09-2019 08:08:00,1,2176.0,1900.0,0.873,10.678,4,0,0,0,4,0,4,0,0.0,0.0
1002,1336,25-09-2019 08:10:00,1,2179.0,1853.0,0.85,10.637,6,0,0,0,6,4,2,0,0.0,0.0
1002,1337,25-09-2019 08:12:00,1,2163.0,1912.0,0.884,10.638,31,7,5,2,24,15,9,0,0.0,0.0
1002,1338,25-09-2019 08:14:00,1,2497.0,2051.0,0.822,12.107,33,4,2,2,29,2,27,0,0.0,0.0
1002,1339,25-09-2019 08:16:00,1,2383.0,2011.0,0.844,11.615,14,2,1,1,12,0,12,0,0.0,0.0
1002,1340,25-09-2019 08:18:00,1,2494.0,2045.0,0.82,12.091,11,5,0,5,6,3,3,0,0.0,0.0
1002,1341,25-09-2019 08:20:00,1,2396.0,1994.0,0.832,11.647,6,0,0,0,6,2,4,0,0.01,0.0
1002,1342,25-09-2019 08:22:00,1,2386.0,1979.0,0.829,11.59,0,0,0,0,0,0,0,0,0.0,0.0
1002,1343,25-09-2019 08:24:00,1,2505.0,2020.0,0.806,12.107,4,1,0,1,3,1,2,0,0.0,0.0
1002,1344,25-09-2019 08:26:00,1,2490.0,2078.0,0.8345,12.1115,109,32,9,23,77,49,28,0,0.0,0.0
1002,1345,25-09-2019 08:28:00,1,2475.0,2136.0,0.863,12.116,92,28,14,14,64,29,35,0,0.0,0.0
1002,1346,25-09-2019 08:30:00,1,2690.0,2196.0,0.817,13.029,116,46,21,25,70,35,35,2,0.0,0.0
1002,1347,25-09-2019 08:32:00,1,2584.0,2166.0,0.838,12.577,274,153,121,32,121,84,37,40,0.0,0.0
1002,1348,25-09-2019 08:34:00,1,2794.0,2271.0,0.813,13.524,133,17,5,12,116,83,33,3,0.0,0.0
1002,1349,25-09-2019 08:36:00,1,2678.0,2238.0,0.836,13.027,68,15,2,13,53,30,23,0,0.0,0.0
1002,1350,25-09-2019 08:38:00,1,2708.0,2145.0,0.792,13.043,57,28,12,16,29,2,27,0,0.0,0.0
1002,1351,25-09-2019 08:40:00,1,2603.0,2067.0,0.794,12.544,58,1,1,0,57,26,31,0,0.0,0.0
1002,1352,25-09-2019 08:42:00,1,2506.0,2014.0,0.804,12.105,7,5,2,3,2,0,2,0,0.0,0.0
1002,1353,25-09-2019 08:44:00,1,2534.0,1914.0,0.755,12.105,18,10,0,10,8,2,6,0,0.0,0.0
1002,1354,25-09-2019 08:46:00,1,2295.0,1845.0,0.804,11.086,0,0,0,0,0,0,0,0,0.0,0.0
1002,1355,25-09-2019 08:48:00,1,2202.0,1790.0,0.813,10.659,0,0,0,0,0,0,0,0,0.0,0.0
1002,1356,25-09-2019 08:50:00,1,2209.0,1784.0,0.808,10.678,0,0,0,0,0,0,0,0,0.0,0.0
1002,1357,25-09-2019 08:52:00,1,2194.0,1783.0,0.813,10.619,0,0,0,0,0,0,0,0,0.0,0.0
1002,1358,25-09-2019 08:54:00,1,2183.0,1843.0,0.844,10.64,7,2,0,2,5,0,5,0,0.0,0.0
1002,1359,25-09-2019 08:56:00,1,2525.0,1940.0,0.768,12.098,2,2,1,1,0,0,0,0,0.0,0.0
1002,1360,25-09-2019 08:58:00,1,2503.0,1961.0,0.783,12.033,1,1,0,1,0,0,0,0,0.0,0.0
1002,1361,25-09-2019 09:00:00,1,2515.0,1961.5,0.78,12.0815,6,4,1,3,2,0,2,0,0.0,0.0
1002,1362,25-09-2019 09:02:00,1,2527.0,1962.0,0.777,12.13,2,1,0,1,1,0,1,0,0.0,0.0
1002,1363,25-09-2019 09:04:00,1,2526.0,1930.0,0.764,12.091,0,0,0,0,0,0,0,0,0.0,0.0
1002,1364,25-09-2019 09:06:00,1,2200.0,1752.0,0.796,10.608,2,0,0,0,2,0,2,0,0.0,0.0
1002,1365,25-09-2019 09:08:00,1,2307.0,1832.0,0.794,11.119,0,0,0,0,0,0,0,0,0.0,0.0
1002,1366,25-09-2019 09:10:00,1,2542.0,1895.0,0.745,12.112,0,0,0,0,0,0,0,0,0.0,0.0
1002,1367,25-09-2019 09:12:00,1,2181.0,1835.0,0.842,10.624,0,0,0,0,0,0,0,0,0.0,0.0
1002,1368,25-09-2019 09:14:00,1,2214.0,1752.0,0.791,10.664,7,3,2,1,4,2,2,0,0.0,0.0
1002,1369,25-09-2019 09:16:00,1,2307.0,1824.0,0.79,11.111,0,0,0,0,0,0,0,0,0.0,0.0
1002,1370,25-09-2019 09:18:00,1,2206.0,1767.0,0.801,10.648,0,0,0,0,0,0,0,0,0.0,0.0
1002,1371,25-09-2019 09:20:00,1,2220.0,1723.0,0.776,10.654,2,1,1,0,1,0,1,0,0.0,0.0
1002,1372,25-09-2019 09:22:00,1,2200.0,1746.0,0.794,10.602,14,11,3,8,3,0,3,0,0.0,0.0
1002,1373,25-09-2019 09:24:00,1,2239.0,1673.0,0.748,10.673,1,1,0,1,0,0,0,0,0.0,0.0
1002,1374,25-09-2019 09:26:00,1,2027.0,1544.0,0.762,9.697,22,12,6,6,10,3,7,0,0.0,0.0
1002,1375,25-09-2019 09:28:00,1,2007.0,1556.0,0.776,9.63,4,1,0,1,3,0,3,0,0.0,0.0
1002,1376,25-09-2019 09:30:00,1,2058.0,1420.0,0.69,9.681,24,6,0,6,18,2,16,0,0.0,0.0
1002,1377,25-09-2019 09:32:00,1,2051.0,1433.0,0.699,9.67,24,3,0,3,21,2,19,0,0.0,0.0
1002,1378,25-09-2019 09:34:00,1,2106.5,1464.0,0.6955,9.921,7,0,0,0,7,3,4,0,0.0,0.0
1002,1379,25-09-2019 09:36:00,1,2162.0,1495.0,0.692,10.172,3,0,0,0,3,1,2,0,0.0,0.0
1002,1380,25-09-2019 09:38:00,1,2166.0,1497.0,0.691,10.19,1,0,0,0,1,0,1,0,0.0,0.0
1002,1381,25-09-2019 09:40:00,1,2361.0,1591.0,0.674,11.064,0,0,0,0,0,0,0,0,0.0,0.0
1002,1382,25-09-2019 09:42:00,1,2338.0,1698.0,0.726,11.092,0,0,0,0,0,0,0,0,0.0,0.0
1002,1383,25-09-2019 09:44:00,1,2342.0,1688.0,0.721,11.097,0,0,0,0,0,0,0,0,0.0,0.0
1002,1384,25-09-2019 09:46:00,1,2330.0,1719.0,0.738,11.085,43,12,7,5,31,12,19,0,0.0,0.0
1002,1385,25-09-2019 09:48:00,1,2572.0,1783.0,0.693,12.11,6,2,1,1,4,0,4,0,0.0,0.0
1002,1386,25-09-2019 09:50:00,1,2359.0,1631.0,0.692,11.1,41,10,5,5,31,11,20,0,0.0,0.0
1002,1387,25-09-2019 09:52:00,1,2664.0,1831.0,0.687,12.524,35,17,2,15,18,0,18,0,0.0,0.0
1002,1388,25-09-2019 09:54:00,1,2651.0,1910.0,0.72,12.56,13,8,0,8,5,0,5,0,0.0,0.0
1002,1389,25-09-2019 09:56:00,1,2667.0,1892.0,0.709,12.601,8,0,0,0,8,0,8,0,0.0,0.0
1002,1390,25-09-2019 09:58:00,1,2348.0,1686.0,0.718,11.118,11,1,0,1,10,0,10,0,0.0,0.0
1002,1391,25-09-2019 10:00:00,1,2360.0,1666.0,0.706,11.143,25,13,2,11,12,3,9,0,0.0,0.0
1002,1392,25-09-2019 10:02:00,1,2370.0,1609.0,0.679,11.121,0,0,0,0,0,0,0,0,0.0,0.0
1002,1393,25-09-2019 10:04:00,1,2154.0,1471.0,0.683,10.116,0,0,0,0,0,0,0,0,0.0,0.0
1002,1394,25-09-2019 10:06:00,1,2162.0,1475.0,0.682,10.153,0,0,0,0,0,0,0,0,0.0,0.0
1002,1395,25-09-2019 10:08:00,1,2156.0,1491.5,0.6915,10.147,4,3,0,3,1,0,1,0,0.0,0.0
1002,1396,25-09-2019 10:10:00,1,2150.0,1508.0,0.701,10.141,1,0,0,0,1,0,1,0,0.0,0.0
1002,1397,25-09-2019 10:12:00,1,2147.0,1515.0,0.706,10.136,0,0,0,0,0,0,0,0,0.0,0.0
1002,1398,25-09-2019 10:14:00,1,2148.0,1546.0,0.72,10.177,0,0,0,0,0,0,0,0,0.01,0.0
1002,1399,25-09-2019 10:16:00,1,2144.0,1543.0,0.72,10.158,63,19,6,13,44,31,13,0,0.0,0.0
1002,1400,25-09-2019 10:18:00,1,2459.0,1768.0,0.719,11.646,115,31,3,28,84,57,27,0,0.0,0.0
1002,1401,25-09-2019 10:20:00,1,2688.0,1798.0,0.669,12.581,287,37,9,28,250,210,40,1,0.0,0.0
1002,1402,25-09-2019 10:22:00,1,2637.0,1936.0,0.734,12.535,388,174,128,46,214,154,60,10,0.0,0.0
1002,1403,25-09-2019 10:24:00,1,2863.0,2011.0,0.703,13.506,569,330,259,71,239,181,58,3,0.0,0.0
1002,1404,25-09-2019 10:26:00,1,2760.0,1964.0,0.712,13.048,124,64,43,21,60,38,22,31,0.0,0.0
1002,1405,25-09-2019 10:28:00,1,2963.0,2107.0,0.711,14.008,350,163,120,43,187,141,46,22,0.0,0.0
1002,1406,25-09-2019 10:30:00,1,3055.0,2255.0,0.738,14.533,90,62,27,35,28,5,23,0,0.0,0.0
1002,1407,25-09-2019 10:32:00,1,2860.0,2054.0,0.718,13.542,322,173,130,43,149,100,49,0,0.0,0.0
1002,1408,25-09-2019 10:34:00,1,3064.0,2214.0,0.722,14.523,588,290,229,61,298,225,73,18,0.0,0.0
1002,1409,25-09-2019 10:36:00,1,3272.0,2285.0,0.698,15.424,655,334,264,70,321,253,68,17,0.0,0.0
1002,1410,25-09-2019 10:38:00,1,3375.0,2397.0,0.71,15.953,453,271,217,54,182,133,49,21,0.0,0.0
1002,1411,25-09-2019 10:40:00,1,3379.0,2367.0,0.701,15.936,304,167,132,35,137,101,36,20,0.0,0.0
1002,1412,25-09-2019 10:42:00,1,3380.5,2357.5,0.6975,15.931,541,284,224,60,257,183,74,8,0.0,0.0
1002,1413,25-09-2019 10:44:00,1,3382.0,2348.0,0.694,15.926,408,267,204,63,141,100,41,67,0.0,0.0
1002,1414,25-09-2019 10:46:00,1,3359.0,2449.0,0.729,15.948,202,113,86,27,89,57,32,21,0.0,0.0
1002,1415,25-09-2019 10:48:00,1,3066.0,2196.0,0.716,14.511,112,36,21,15,76,45,31,0,0.02,0.0
1002,1416,25-09-2019 10:50:00,1,3048.0,2236.0,0.734,14.485,243,137,97,40,106,66,40,9,0.01,0.0
1002,1417,25-09-2019 10:52:00,1,3058.0,2227.0,0.728,14.514,45,22,5,17,23,11,12,0,0.0,0.0
1002,1418,25-09-2019 10:54:00,1,3079.0,2120.0,0.689,14.48,22,13,1,12,9,2,7,0,0.0,0.0
1002,1419,25-09-2019 10:56:00,1,2957.0,2072.0,0.7,13.946,104,37,19,18,67,35,32,1,0.0,0.0
1002,1420,25-09-2019 10:58:00,1,3066.0,2216.0,0.723,14.533,62,34,11,23,28,5,23,0,0.0,0.0
1002,1421,25-09-2019 11:00:00,1,3076.0,2129.0,0.692,14.476,7,2,0,2,5,0,5,0,0.0,0.0
1002,1422,25-09-2019 11:02:00,1,2859.0,2017.0,0.705,13.499,40,0,0,0,40,0,40,0,0.0,0.0
1002,1423,25-09-2019 11:04:00,1,2667.0,1877.0,0.704,12.586,29,4,2,2,25,2,23,0,0.0,0.0
1002,1424,25-09-2019 11:06:00,1,2445.0,1772.0,0.725,11.597,40,0,0,0,40,0,40,0,0.0,0.0
1002,1425,25-09-2019 11:08:00,1,2364.0,1625.0,0.687,11.114,25,0,0,0,25,0,25,0,0.0,0.0
1002,1426,25-09-2019 11:10:00,1,2371.0,1590.0,0.671,11.103,48,2,2,0,46,16,30,0,0.0,0.0
1002,1427,25-09-2019 11:12:00,1,2456.0,1743.0,0.71,11.607,33,0,0,0,33,2,31,0,0.0,0.0
1002,1428,25-09-2019 11:14:00,1,2351.0,1680.0,0.715,11.122,20,0,0,0,20,11,9,0,0.0,0.0
1002,1429,25-09-2019 11:16:00,1,2359.5,1630.0,0.691,11.101,8,0,0,0,8,0,8,0,0.0,0.0
1002,1430,25-09-2019 11:18:00,1,2368.0,1580.0,0.667,11.08,0,0,0,0,0,0,0,0,0.0,0.0
1002,1431,25-09-2019 11:20:00,1,2270.0,1561.0,0.688,10.672,0,0,0,0,0,0,0,0,0.0,0.0
1002,1432,25-09-2019 11:22:00,1,2151.0,1509.0,0.701,10.145,2,0,0,0,2,0,2,0,0.0,0.0
1002,1433,25-09-2019 11:24:00,1,2160.0,1478.0,0.684,10.147,22,2,1,1,20,8,12,0,0.0,0.0
1002,1434,25-09-2019 11:26:00,1,2364.0,1627.0,0.688,11.117,18,0,0,0,18,2,16,0,0.0,0.0
1002,1435,25-09-2019 11:28:00,1,2357.0,1652.0,0.701,11.116,36,9,1,8,27,10,17,0,0.0,0.0
1002,1436,25-09-2019 11:30:00,1,2362.0,1591.0,0.673,11.068,18,0,0,0,18,0,18,0,0.0,0.0
1002,1437,25-09-2019 11:32:00,1,2147.0,1512.0,0.704,10.132,44,2,1,1,42,10,32,0,0.0,0.0
1002,1438,25-09-2019 11:34:00,1,2153.0,1513.0,0.703,10.157,30,0,0,0,30,0,30,0,0.0,0.0
1002,1439,25-09-2019 11:36:00,1,2159.0,1504.0,0.696,10.174,41,2,1,1,39,6,33,0,0.0,0.0
1002,1440,25-09-2019 11:38:00,1,2264.0,1554.0,0.686,10.64,45,14,9,5,31,8,23,0,0.0,0.0
1002,1441,25-09-2019 11:40:00,1,2267.0,1558.0,0.687,10.658,8,2,1,1,6,0,6,0,0.0,0.0
1002,1442,25-09-2019 11:42:00,1,2142.0,1531.0,0.715,10.134,0,0,0,0,0,0,0,0,0.0,0.0
1002,1443,25-09-2019 11:44:00,1,2378.0,1584.0,0.666,11.125,0,0,0,0,0,0,0,0,0.0,0.0
1002,1444,25-09-2019 11:46:00,1,2150.0,1534.0,0.714,10.168,20,8,1,7,12,0,12,0,0.0,0.0
1002,1445,25-09-2019 11:48:00,1,2364.0,1597.0,0.676,11.085,21,0,0,0,21,0,21,0,0.0,0.0
1002,1446,25-09-2019 11:50:00,1,2372.5,1587.0,0.669,11.1075,52,18,3,15,34,13,21,0,0.0,0.0
1002,1447,25-09-2019 11:52:00,1,2381.0,1577.0,0.662,11.13,62,27,10,17,35,12,23,1,0.0,0.0
1002,1448,25-09-2019 11:54:00,1,2361.0,1661.0,0.703,11.142,244,41,14,27,203,148,55,5,0.0,0.0
1002,1449,25-09-2019 11:56:00,1,2442.0,1724.0,0.706,11.53,170,34,9,25,136,90,46,0,0.0,0.0
1002,1450,25-09-2019 11:58:00,1,2668.0,1830.0,0.686,12.539,98,61,17,44,37,7,30,1,0.0,0.0
1002,1451,25-09-2019 12:00:00,1,2663.0,1893.0,0.711,12.589,70,19,8,11,51,17,34,0,0.0,0.0
1002,1452,25-09-2019 12:02:00,1,2644.0,1908.0,0.722,12.53,14,8,2,6,6,0,6,0,0.0,0.0
1002,1453,25-09-2019 12:04:00,1,2447.0,1745.0,0.713,11.573,7,4,2,2,3,2,1,0,0.0,0.0
1002,1454,25-09-2019 12:06:00,1,2266.0,1571.0,0.693,10.667,11,10,4,6,1,0,1,0,0.0,0.0
1002,1455,25-09-2019 12:08:00,1,2160.0,1488.0,0.689,10.16,0,0,0,0,0,0,0,0,0.0,0.0
1002,1456,25-09-2019 12:10:00,1,2161.0,1484.0,0.687,10.156,16,16,10,6,0,0,0,0,0.0,0.0
1002,1457,25-09-2019 12:12:00,1,2145.0,1503.0,0.701,10.116,49,23,13,10,26,14,12,0,0.0,0.0
1002,1458,25-09-2019 12:14:00,1,2350.0,1690.0,0.719,11.131,6,0,0,0,6,0,6,0,0.0,0.0
1002,1459,25-09-2019 12:16:00,1,2365.0,1641.0,0.694,11.133,0,0,0,0,0,0,0,0,0.0,0.0
1002,1460,25-09-2019 12:18:00,1,2363.0,1646.0,0.697,11.134,1,0,0,0,1,0,1,0,0.0,0.0
1002,1461,25-09-2019 12:20:00,1,2356.0,1658.0,0.704,11.118,0,0,0,0,0,0,0,0,0.0,0.0
1002,1462,25-09-2019 12:22:00,1,2356.0,1678.0,0.712,11.14,6,2,0,2,4,0,4,0,0.0,0.0
1002,1463,25-09-2019 12:24:00,1,2359.0,1668.5,0.707,11.1425,0,0,0,0,0,0,0,0,0.0,0.0
1002,1464,25-09-2019 12:26:00,1,2362.0,1659.0,0.702,11.145,0,0,0,0,0,0,0,0,0.0,0.0
1002,1465,25-09-2019 12:28:00,1,2358.0,1660.0,0.704,11.13,22,0,0,0,22,0,22,0,0.0,0.0
1002,1466,25-09-2019 12:30:00,1,2378.0,1550.0,0.652,11.087,27,3,0,3,24,0,24,0,0.0,0.0
1002,1467,25-09-2019 12:32:00,1,2387.0,1560.0,0.654,11.133,11,8,0,8,3,0,3,0,0.0,0.0
1002,1468,25-09-2019 12:34:00,1,2148.0,1522.0,0.709,10.15,13,2,0,2,11,0,11,0,0.0,0.0
1002,1469,25-09-2019 12:36:00,1,2174.0,1433.0,0.659,10.152,9,9,0,9,0,0,0,0,0.0,0.0
1002,1470,25-09-2019 12:38:00,1,2182.0,1408.0,0.645,10.156,1,0,0,0,1,0,1,0,0.0,0.0
1002,1471,25-09-2019 12:40:00,1,2168.0,1422.0,0.656,10.116,5,2,0,2,3,0,3,0,0.0,0.0
1002,1472,25-09-2019 12:42:00,1,2175.0,1433.0,0.659,10.156,21,10,3,7,11,2,9,0,0.0,0.0
1002,1473,25-09-2019 12:44:00,1,2194.0,1395.0,0.636,10.187,24,0,0,0,24,0,24,0,0.0,0.0
1002,1474,25-09-2019 12:46:00,1,2188.0,1345.0,0.614,10.112,34,0,0,0,34,0,34,0,0.0,0.0
1002,1475,25-09-2019 12:48:00,1,2197.0,1349.0,0.614,10.152,11,9,4,5,2,0,2,0,0.0,0.0
1002,1476,25-09-2019 12:50:00,1,2188.0,1350.0,0.617,10.118,37,4,2,2,33,4,29,0,0.0,0.0
1002,1477,25-09-2019 12:52:00,1,2085.0,1336.0,0.64,9.695,37,2,0,2,35,4,31,0,0.0,0.0
1002,1478,25-09-2019 12:54:00,1,1958.0,1306.0,0.667,9.161,17,0,0,0,17,0,17,0,0.0,0.0
1002,1479,25-09-2019 12:56:00,1,1967.0,1292.0,0.657,9.18,4,1,0,1,3,0,3,0,0.0,0.0
1002,1480,25-09-2019 12:58:00,1,2169.0,1427.5,0.658,10.126,45,10,4,6,35,16,19,0,0.0,0.0
1002,1481,25-09-2019 13:00:00,1,2371.0,1563.0,0.659,11.072,0,0,0,0,0,0,0,0,0.0,0.0
1002,1482,25-09-2019 13:02:00,1,2365.0,1629.0,0.689,11.123,11,2,0,2,9,0,9,0,0.0,0.0
1002,1483,25-09-2019 13:04:00,1,2350.0,1631.0,0.694,11.067,13,6,4,2,7,0,7,0,0.0,0.0
1002,1484,25-09-2019 13:06:00,1,2385.0,1573.0,0.66,11.138,34,12,4,8,22,10,12,0,0.0,0.0
1002,1485,25-09-2019 13:08:00,1,2160.0,1458.0,0.675,10.125,13,0,0,0,13,0,13,0,0.0,0.0
1002,1486,25-09-2019 13:10:00,1,2192.0,1355.0,0.618,10.139,13,1,0,1,12,0,12,0,0.0,0.0
1002,1487,25-09-2019 13:12:00,1,2208.0,1320.0,0.598,10.162,8,4,0,4,4,0,4,0,0.0,0.0
1002,1488,25-09-2019 13:14:00,1,2187.0,1353.0,0.619,10.116,1,0,0,0,1,0,1,0,0.0,0.0
1002,1489,25-09-2019 13:16:00,1,2200.0,1336.0,0.607,10.147,160,66,33,33,94,58,36,1,0.0,0.0
1002,1490,25-09-2019 13:18:00,1,2365.0,1613.0,0.682,11.104,279,50,24,26,229,195,34,0,0.0,0.0
1002,1491,25-09-2019 13:20:00,1,2448.0,1754.0,0.717,11.587,196,29,5,24,167,120,47,0,0.0,0.0
1002,1492,25-09-2019 13:22:00,1,2457.0,1746.0,0.71,11.615,38,14,6,8,24,11,13,0,0.0,0.0
1002,1493,25-09-2019 13:24:00,1,2688.0,1829.0,0.68,12.617,98,0,0,0,98,54,44,0,0.0,0.0
1002,1494,25-09-2019 13:26:00,1,2359.0,1622.0,0.688,11.089,193,82,50,32,111,75,36,0,0.0,0.0
1002,1495,25-09-2019 13:28:00,1,2678.0,1818.0,0.679,12.563,379,189,146,43,190,137,53,64,0.0,0.0
1002,1496,25-09-2019 13:30:00,1,2667.0,1868.0,0.7,12.577,71,38,20,18,33,11,22,45,0.0,0.0
1002,1497,25-09-2019 13:32:00,1,2881.0,1962.5,0.6825,13.525,102,67,36,31,35,16,19,65,0.0,0.0
1002,1498,25-09-2019 13:34:00,1,3095.0,2057.0,0.665,14.473,66,49,24,25,17,7,10,30,0.0,0.0
1002,1499,25-09-2019 13:36:00,1,3079.0,2134.0,0.693,14.496,105,61,26,35,44,24,20,37,0.0,0.0
1002,1500,25-09-2019 13:38:00,1,3091.0,2146.0,0.694,14.555,704,378,301,77,326,242,84,3,0.0,0.0
1002,1501,25-09-2019 13:40:00,1,3064.0,2164.0,0.706,14.468,470,239,175,64,231,172,59,7,0.0,0.0
1002,1502,25-09-2019 13:42:00,1,3165.0,2276.0,0.719,14.991,485,211,148,63,274,200,74,8,0.0,0.0
1002,1503,25-09-2019 13:44:00,1,2975.0,2085.0,0.701,14.032,427,204,155,49,223,162,61,0,0.0,0.0
1002,1504,25-09-2019 13:46:00,1,3039.0,2272.0,0.748,14.491,186,72,45,27,114,75,39,1,0.0,0.0
1002,1505,25-09-2019 13:48:00,1,3063.0,2193.0,0.716,14.499,107,63,29,34,44,34,10,0,0.0,0.0
1002,1506,25-09-2019 13:50:00,1,2957.0,2131.0,0.72,14.011,306,149,101,48,157,105,52,1,0.05,0.0
1002,1507,25-09-2019 13:52:00,1,3072.0,2165.0,0.705,14.5,463,187,136,51,276,205,71,10,0.0,0.0
1002,1508,25-09-2019 13:54:00,1,3353.0,2446.0,0.729,15.918,317,180,134,46,137,96,41,19,0.0,0.0
1002,1509,25-09-2019 13:56:00,1,3042.0,2282.0,0.75,14.511,27,16,7,9,11,5,6,6,0.0,0.0
1002,1510,25-09-2019 13:58:00,1,2830.0,2152.0,0.761,13.532,26,9,0,9,17,0,17,0,0.0,0.0
1002,1511,25-09-2019 14:00:00,1,2830.0,2148.0,0.759,13.528,97,14,1,13,83,52,31,0,0.0,0.0
1002,1512,25-09-2019 14:02:00,1,3061.0,2217.0,0.724,14.516,45,16,2,14,29,0,29,0,0.0,0.0
1002,1513,25-09-2019 14:04:00,1,3050.0,2280.0,0.748,14.541,51,38,11,27,13,7,6,0,0.0,0.0
1002,1514,25-09-2019 14:06:00,1,2949.5,2185.0,0.741,14.0395,0,0,0,0,0,0,0,0,0.0,0.0
1002,1515,25-09-2019 14:08:00,1,2849.0,2090.0,0.734,13.538,0,0,0,0,0,0,0,0,0.0,0.0
1002,1516,25-09-2019 14:10:00,1,2632.0,1994.0,0.757,12.58,8,4,0,4,4,2,2,0,0.0,0.0
1002,1517,25-09-2019 14:12:00,1,2640.0,1945.0,0.737,12.555,6,1,0,1,5,3,2,0,0.0,0.0
1002,1518,25-09-2019 14:14:00,1,2665.0,1897.0,0.712,12.6,0,0,0,0,0,0,0,0,0.0,0.0
1002,1519,25-09-2019 14:16:00,1,2541.0,1855.0,0.73,12.064,17,2,0,2,15,12,3,0,0.0,0.0
1002,1520,25-09-2019 14:18:00,1,2550.0,1849.0,0.725,12.095,8,2,2,0,6,6,0,0,0.0,0.0
1002,1521,25-09-2019 14:20:00,1,2441.0,1834.0,0.751,11.649,0,0,0,0,0,0,0,0,0.0,0.0
1002,1522,25-09-2019 14:22:00,1,2314.0,1785.0,0.771,11.096,5,1,0,1,4,2,2,0,0.0,0.0
1002,1523,25-09-2019 14:24:00,1,2434.0,1825.0,0.75,11.613,45,1,0,1,44,0,44,0,0.0,0.0
1002,1524,25-09-2019 14:26:00,1,2560.0,1855.0,0.725,12.143,37,24,12,12,13,5,8,0,0.0,0.0
1002,1525,25-09-2019 14:28:00,1,2333.0,1705.0,0.731,11.08,8,6,0,6,2,0,2,0,0.0,0.0
1002,1526,25-09-2019 14:30:00,1,2245.0,1629.0,0.726,10.65,14,13,1,12,1,0,1,0,0.0,0.0
1002,1527,25-09-2019 14:32:00,1,2356.0,1673.0,0.71,11.135,227,227,171,56,0,0,0,0,0.0,0.0
1002,1528,25-09-2019 14:34:00,1,2359.0,1629.0,0.691,11.099,275,266,234,32,9,2,7,0,0.0,0.0
1002,1529,25-09-2019 14:36:00,1,2346.0,1701.0,0.725,11.126,12,10,0,10,2,0,2,0,0.0,0.0
1002,1530,25-09-2019 14:38:00,1,2340.0,1711.0,0.731,11.114,1,1,0,1,0,0,0,0,0.0,0.0
1002,1531,25-09-2019 14:40:00,1,2447.0,1759.5,0.7195,11.59,0,0,0,0,0,0,0,0,0.0,0.0
1002,1532,25-09-2019 14:42:00,1,2554.0,1808.0,0.708,12.066,1,1,0,1,0,0,0,0,0.0,0.0
1002,1533,25-09-2019 14:44:00,1,2557.0,1825.0,0.714,12.096,4,0,0,0,4,0,4,0,0.0,0.0
1002,1534,25-09-2019 14:46:00,1,2442.0,1798.0,0.736,11.612,0,0,0,0,0,0,0,0,0.0,0.0
1002,1535,25-09-2019 14:48:00,1,2329.0,1725.0,0.74,11.087,0,0,0,0,0,0,0,0,0.0,0.0
1002,1536,25-09-2019 14:50:00,1,2353.0,1653.0,0.703,11.101,6,3,1,2,3,2,1,0,0.0,0.0
1002,1537,25-09-2019 14:52:00,1,2340.0,1705.0,0.729,11.107,31,3,0,3,28,0,28,0,0.0,0.0
1002,1538,25-09-2019 14:54:00,1,2349.0,1689.0,0.719,11.125,21,0,0,0,21,0,21,0,0.0,0.0
1002,1539,25-09-2019 14:56:00,1,2354.0,1649.0,0.701,11.099,24,3,0,3,21,0,21,0,0.0,0.0
1002,1540,25-09-2019 14:58:00,1,2361.0,1641.0,0.695,11.121,29,2,0,2,27,0,27,0,0.0,0.0
1002,1541,25-09-2019 15:00:00,1,2244.0,1600.0,0.713,10.613,10,2,1,1,8,0,8,0,0.0,0.0
1002,1542,25-09-2019 15:02:00,1,2142.0,1575.0,0.735,10.185,23,0,0,0,23,0,23,0,0.0,0.0
1002,1543,25-09-2019 15:04:00,1,2139.0,1564.0,0.731,10.161,44,11,1,10,33,0,33,0,0.0,0.0
1002,1544,25-09-2019 15:06:00,1,2143.0,1548.0,0.722,10.159,2,1,0,1,1,0,1,0,0.0,0.0
1002,1545,25-09-2019 15:08:00,1,2158.0,1467.0,0.68,10.127,0,0,0,0,0,0,0,0,0.0,0.0
1002,1546,25-09-2019 15:10:00,1,2169.0,1427.0,0.658,10.128,12,5,3,2,7,2,5,0,0.0,0.0
1002,1547,25-09-2019 15:12:00,1,2243.0,1610.0,0.718,10.62,22,16,8,8,6,2,4,0,0.0,0.0
1002,1548,25-09-2019 15:14:00,1,2279.0,1705.5,0.748,10.867,4,4,2,2,0,0,0,0,0.0,0.0
1002,1549,25-09-2019 15:16:00,1,2315.0,1801.0,0.778,11.114,6,0,0,0,6,0,6,0,0.0,0.0
1002,1550,25-09-2019 15:18:00,1,2328.0,1769.0,0.76,11.13,13,9,5,4,4,0,4,0,0.0,0.0
1002,1551,25-09-2019 15:20:00,1,2336.0,1753.0,0.75,11.147,16,14,3,11,2,0,2,0,0.0,0.0
1002,1552,25-09-2019 15:22:00,1,2337.0,1712.0,0.733,11.104,55,34,14,20,21,1,20,0,0.0,0.0
1002,1553,25-09-2019 15:24:00,1,2364.0,1663.0,0.703,11.157,128,93,55,38,35,18,17,0,0.0,0.0
1002,1554,25-09-2019 15:26:00,1,2347.0,1673.0,0.713,11.1,108,90,46,44,18,0,18,0,0.0,0.0
1002,1555,25-09-2019 15:28:00,1,2321.0,1804.0,0.777,11.144,112,30,8,22,82,57,25,0,0.0,0.0
1002,1556,25-09-2019 15:30:00,1,2330.0,1737.0,0.746,11.105,55,28,0,28,27,12,15,0,0.0,0.0
1002,1557,25-09-2019 15:32:00,1,2343.0,1718.0,0.733,11.134,31,13,0,13,18,1,17,0,0.0,0.0
1002,1558,25-09-2019 15:34:00,1,2442.0,1801.0,0.737,11.615,82,73,32,41,9,3,6,2,0.0,0.0
1002,1559,25-09-2019 15:36:00,1,2546.0,1844.0,0.724,12.074,85,48,27,21,37,8,29,0,0.0,0.0
1002,1560,25-09-2019 15:38:00,1,2441.0,1785.0,0.731,11.594,14,8,0,8,6,2,4,0,0.0,0.0
1002,1561,25-09-2019 15:40:00,1,2337.0,1707.0,0.73,11.1,19,1,0,1,18,2,16,0,0.0,0.0
1002,1562,25-09-2019 15:42:00,1,2359.0,1643.0,0.697,11.115,37,1,1,0,36,0,36,0,0.0,0.0
1002,1563,25-09-2019 15:44:00,1,2132.0,1567.0,0.735,10.134,29,0,0,0,29,0,29,0,0.0,0.0
1002,1564,25-09-2019 15:46:00,1,2145.0,1514.0,0.706,10.129,22,2,0,2,20,9,11,0,0.0,0.0
1002,1565,25-09-2019 15:48:00,1,2196.5,1547.5,0.7045,10.3695,26,3,0,3,23,5,18,0,0.0,0.0
1002,1566,25-09-2019 15:50:00,1,2248.0,1581.0,0.703,10.61,4,2,0,2,2,0,2,0,0.0,0.0
1002,1567,25-09-2019 15:52:00,1,2130.0,1548.0,0.727,10.106,18,6,2,4,12,2,10,0,0.0,0.0
1002,1568,25-09-2019 15:54:00,1,2142.0,1543.0,0.72,10.149,33,15,9,6,18,12,6,0,0.0,0.0
1002,1569,25-09-2019 15:56:00,1,2443.0,1803.0,0.738,11.623,11,3,1,2,8,0,8,0,0.0,0.0
1002,1570,25-09-2019 15:58:00,1,2656.0,1867.0,0.703,12.532,36,0,0,0,36,0,36,0,0.0,0.0
1002,1571,25-09-2019 16:00:00,1,2444.0,1810.0,0.741,11.634,50,3,1,2,47,0,47,0,0.0,0.0
1002,1572,25-09-2019 16:02:00,1,2334.0,1732.0,0.742,11.113,34,3,1,2,31,0,31,0,0.0,0.0
1002,1573,25-09-2019 16:04:00,1,2330.0,1740.0,0.747,11.109,14,0,0,0,14,0,14,0,0.0,0.0
1002,1574,25-09-2019 16:06:00,1,2365.0,1666.0,0.704,11.161,15,3,2,1,12,0,12,0,0.0,0.0
1002,1575,25-09-2019 16:08:00,1,2342.0,1688.0,0.721,11.094,22,5,2,3,17,0,17,0,0.0,0.0
1002,1576,25-09-2019 16:10:00,1,2353.0,1666.0,0.708,11.117,74,35,4,31,39,4,35,0,0.0,0.0
1002,1577,25-09-2019 16:12:00,1,2354.0,1662.0,0.706,11.117,96,44,10,34,52,22,30,0,0.0,0.0
1002,1578,25-09-2019 16:14:00,1,2365.0,1642.0,0.694,11.138,61,18,6,12,43,30,13,0,0.0,0.0
1002,1579,25-09-2019 16:16:00,1,2443.0,1792.0,0.734,11.611,82,29,7,22,53,11,42,0,0.0,0.0
1002,1580,25-09-2019 16:18:00,1,2438.0,1807.0,0.741,11.604,29,6,4,2,23,11,12,0,0.0,0.0
1002,1581,25-09-2019 16:20:00,1,2445.0,1792.0,0.733,11.616,67,27,0,27,40,15,25,0,0.0,0.0
1002,1582,25-09-2019 16:22:00,1,2441.0,1804.5,0.739,11.614,81,26,13,13,55,21,34,0,0.0,0.0
1002,1583,25-09-2019 16:24:00,1,2437.0,1817.0,0.745,11.612,24,11,1,10,13,0,13,0,0.0,0.0
1002,1584,25-09-2019 16:26:00,1,2363.0,1629.0,0.689,11.115,15,0,0,0,15,0,15,0,0.0,0.0
1002,1585,25-09-2019 16:28:00,1,2162.0,1478.0,0.684,10.156,5,0,0,0,5,0,5,0,0.0,0.0
1002,1586,25-09-2019 16:30:00,1,2174.0,1436.0,0.66,10.157,1,0,0,0,1,1,0,0,0.0,0.0
1002,1587,25-09-2019 16:32:00,1,2173.0,1421.0,0.654,10.134,4,1,0,1,3,1,2,0,0.0,0.0
1002,1588,25-09-2019 16:34:00,1,2152.0,1495.0,0.695,10.133,11,7,5,2,4,2,2,1,0.0,0.0
1002,1589,25-09-2019 16:36:00,1,2145.0,1526.0,0.712,10.14,2,0,0,0,2,0,2,0,0.0,0.0
1002,1590,25-09-2019 16:38:00,1,2149.0,1522.0,0.708,10.154,28,0,0,0,28,0,28,0,0.0,0.0
1002,1591,25-09-2019 16:40:00,1,2140.0,1545.0,0.722,10.142,37,8,2,6,29,0,29,0,0.0,0.0
1002,1592,25-09-2019 16:42:00,1,2371.0,1601.0,0.675,11.115,3,1,1,0,2,0,2,0,0.0,0.0
1002,1593,25-09-2019 16:44:00,1,2144.0,1525.0,0.711,10.135,4,3,0,3,1,0,1,0,0.0,0.0
1002,1594,25-09-2019 16:46:00,1,2140.0,1517.0,0.709,10.113,7,7,0,7,0,0,0,0,0.0,0.0
1002,1595,25-09-2019 16:48:00,1,2172.0,1452.0,0.669,10.164,15,0,0,0,15,0,15,0,0.0,0.0
1002,1596,25-09-2019 16:50:00,1,2174.0,1444.0,0.664,10.165,7,0,0,0,7,0,7,0,0.0,0.0
1002,1597,25-09-2019 16:52:00,1,2157.0,1478.0,0.685,10.137,10,9,0,9,1,0,1,0,0.0,0.0
1002,1598,25-09-2019 16:54:00,1,2169.0,1462.0,0.674,10.164,3,3,0,3,0,0,0,0,0.0,0.0
1002,1599,25-09-2019 16:56:00,1,2165.0,1468.5,0.6785,10.1555,2,1,0,1,1,1,0,0,0.0,0.0
1002,1600,25-09-2019 16:58:00,1,2161.0,1475.0,0.683,10.147,0,0,0,0,0,0,0,0,0.0,0.0
1002,1601,25-09-2019 17:00:00,1,2170.0,1446.0,0.666,10.152,16,1,0,1,15,1,14,0,0.0,0.0
1002,1602,25-09-2019 17:02:00,1,2161.0,1475.0,0.683,10.146,4,2,0,2,2,0,2,0,0.0,0.0
1002,1603,25-09-2019 17:04:00,1,2355.0,1637.0,0.695,11.092,101,45,14,31,56,18,38,1,0.0,0.0
1002,1604,25-09-2019 17:06:00,1,2657.0,1900.0,0.715,12.572,87,38,8,30,49,16,33,0,0.0,0.0
1002,1605,25-09-2019 17:08:00,1,2627.0,1999.0,0.761,12.565,163,115,87,28,48,28,20,65,0.0,0.0
1002,1606,25-09-2019 17:10:00,1,3062.0,2227.0,0.727,14.53,104,59,29,30,45,10,35,38,0.0,0.0
1002,1607,25-09-2019 17:12:00,1,3043.0,2307.0,0.758,14.544,75,45,17,28,30,11,19,42,0.0,0.0
1002,1608,25-09-2019 17:14:00,1,3033.0,2288.0,0.754,14.485,97,74,41,33,23,3,20,48,0.0,0.0
1002,1609,25-09-2019 17:16:00,1,3151.0,2341.0,0.743,15.006,65,45,19,26,20,3,17,44,0.0,0.0
1002,1610,25-09-2019 17:18:00,1,3022.0,2352.0,0.778,14.51,515,313,255,58,202,155,47,67,0.0,0.0
1002,1611,25-09-2019 17:20:00,1,3120.0,2400.0,0.769,14.95,640,332,256,76,308,233,75,5,0.0,0.0
1002,1612,25-09-2019 17:22:00,1,3367.0,2436.0,0.724,15.964,291,158,108,50,133,93,40,2,0.04,0.0
1002,1613,25-09-2019 17:24:00,1,3027.0,2322.0,0.767,14.496,104,30,4,26,74,43,31,1,0.0,0.0
1002,1614,25-09-2019 17:26:00,1,3031.0,2336.0,0.771,14.528,63,14,2,12,49,19,30,1,0.0,0.0
1002,1615,25-09-2019 17:28:00,1,3038.0,2259.0,0.744,14.47,71,15,7,8,56,32,24,0,0.0,0.0
1002,1616,25-09-2019 17:30:00,1,3023.0,2320.5,0.768,14.48,84,16,2,14,68,46,22,0,0.0,0.0
1002,1617,25-09-2019 17:32:00,1,3008.0,2382.0,0.792,14.49,11,3,1,2,8,0,8,0,0.0,0.0
1002,1618,25-09-2019 17:34:00,1,2839.0,2172.0,0.765,13.591,7,4,0,4,3,0,3,0,0.0,0.0
1002,1619,25-09-2019 17:36:00,1,2718.0,2092.0,0.77,13.027,37,2,0,2,35,0,35,0,0.0,0.0
1002,1620,25-09-2019 17:38:00,1,2619.0,2029.0,0.775,12.566,29,4,0,4,25,0,25,0,0.0,0.0
1002,1621,25-09-2019 17:40:00,1,2517.0,1944.0,0.772,12.07,7,3,1,2,4,1,3,0,0.0,0.0
1002,1622,25-09-2019 17:42:00,1,2526.0,1976.0,0.782,12.14,0,0,0,0,0,0,0,0,0.0,0.0
1002,1623,25-09-2019 17:44:00,1,2286.0,1902.0,0.832,11.112,8,1,1,0,7,1,6,0,0.0,0.0
1002,1624,25-09-2019 17:46:00,1,2515.0,1983.0,0.788,12.106,7,0,0,0,7,0,7,0,0.02,0.0
1002,1625,25-09-2019 17:48:00,1,2628.0,2036.0,0.775,12.61,9,4,0,4,5,0,5,0,0.0,0.0
1002,1626,25-09-2019 17:50:00,1,2622.0,2031.0,0.775,12.579,2,2,0,2,0,0,0,0,0.0,0.0
1002,1627,25-09-2019 17:52:00,1,2594.0,2170.0,0.837,12.624,57,21,13,8,36,17,19,0,0.0,0.0
1002,1628,25-09-2019 17:54:00,1,2798.0,2258.0,0.807,13.524,15,3,1,2,12,6,6,0,0.0,0.0
1002,1629,25-09-2019 17:56:00,1,2782.0,2302.0,0.827,13.51,79,37,16,21,42,11,31,0,0.0,0.0
1002,1630,25-09-2019 17:58:00,1,3010.0,2429.0,0.807,14.546,66,33,7,26,33,12,21,1,0.0,0.0
1002,1631,25-09-2019 18:00:00,0,2968.0,2512.0,0.846,14.474,114,33,5,28,81,50,31,0,0.0,0.0
1002,1632,25-09-2019 18:02:00,0,2967.0,2554.0,0.861,14.516,323,212,176,36,111,75,36,82,0.0,0.0
1002,1633,25-09-2019 18:04:00,0,3165.0,2696.5,0.8525,15.455,99,63,29,34,36,5,31,61,0.0,0.0
1002,1634,25-09-2019 18:06:00,0,3363.0,2839.0,0.844,16.394,280,174,133,41,106,74,32,79,0.05,0.0
1002,1635,25-09-2019 18:08:00,0,3481.0,2926.0,0.841,16.953,191,136,108,28,55,39,16,120,0.01,0.01
1002,1636,25-09-2019 18:10:00,0,3459.0,2967.0,0.858,16.915,299,111,72,39,188,132,56,17,0.0,0.04
1002,1637,25-09-2019 18:12:00,0,3457.0,2967.0,0.858,16.907,189,102,63,39,87,60,27,6,0.0,0.0
1002,1638,25-09-2019 18:14:00,0,3488.0,2908.0,0.834,16.963,107,57,34,23,50,20,30,0,0.06,0.0
1002,1639,25-09-2019 18:16:00,0,3262.0,2825.0,0.866,15.98,30,17,2,15,13,0,13,0,0.0,0.0
1002,1640,25-09-2019 18:18:00,0,3290.0,2703.0,0.821,15.956,34,12,4,8,22,7,15,0,0.0,0.0
1002,1641,25-09-2019 18:20:00,0,3318.0,2639.0,0.795,15.994,38,8,3,5,30,2,28,0,0.0,0.0
1002,1642,25-09-2019 18:22:00,0,2969.0,2525.0,0.85,14.495,13,9,2,7,4,0,4,0,0.0,0.0
1002,1643,25-09-2019 18:24:00,0,3070.0,2621.0,0.854,14.998,9,2,1,1,7,0,7,0,0.0,0.0
1002,1644,25-09-2019 18:26:00,0,3185.0,2677.0,0.841,15.511,129,82,51,31,47,19,28,53,0.0,0.0
1002,1645,25-09-2019 18:28:00,0,3449.0,3009.0,0.872,16.922,101,77,36,41,24,2,22,60,0.0,0.0
1002,1646,25-09-2019 18:30:00,0,3433.0,3104.0,0.904,16.962,115,94,56,38,21,2,19,56,0.0,0.07
1002,1647,25-09-2019 18:32:00,0,3615.0,3279.0,0.907,17.873,234,132,97,35,102,66,36,72,0.18,0.09
1002,1648,25-09-2019 18:34:00,0,3627.0,3244.0,0.894,17.88,90,62,40,22,28,10,18,50,0.0,0.01
1002,1649,25-09-2019 18:36:00,0,3442.0,3054.0,0.887,16.941,130,59,37,22,71,40,31,31,0.0,0.05
1002,1650,25-09-2019 18:38:00,0,3498.0,3098.5,0.8855,17.212,21,7,1,6,14,6,8,0,0.0,0.01
1002,1651,25-09-2019 18:40:00,0,3554.0,3143.0,0.884,17.483,287,172,129,43,115,81,34,92,0.0,0.0
1002,1652,25-09-2019 18:42:00,0,3846.0,3367.0,0.875,18.879,241,126,91,35,115,80,35,83,0.0,0.0
1002,1653,25-09-2019 18:44:00,0,3985.0,3352.0,0.841,19.412,108,83,56,27,25,2,23,76,0.0,0.04
1002,1654,25-09-2019 18:46:00,0,3915.0,3569.0,0.911,19.378,156,63,40,23,93,57,36,9,0.03,0.05
1002,1655,25-09-2019 18:48:00,0,3430.0,3107.0,0.906,16.953,19,9,4,5,10,7,3,0,0.01,0.0
1002,1656,25-09-2019 18:50:00,0,3537.0,3151.0,0.891,17.424,14,14,0,14,0,0,0,0,0.0,0.0
1002,1657,25-09-2019 18:52:00,0,3443.0,3026.0,0.879,16.915,7,7,3,4,0,0,0,0,0.0,0.0
1002,1658,25-09-2019 18:54:00,0,3433.0,3119.0,0.909,16.979,6,4,2,2,2,1,1,0,0.0,0.0
1002,1659,25-09-2019 18:56:00,0,3336.0,2967.0,0.889,16.427,0,0,0,0,0,0,0,0,0.0,0.0
1002,1660,25-09-2019 18:58:00,0,3346.0,2970.0,0.888,16.469,34,11,6,5,23,4,19,0,0.0,0.0
1002,1661,25-09-2019 19:00:00,0,3247.0,2935.0,0.904,16.042,76,29,14,15,47,27,20,0,0.11,0.01
1002,1662,25-09-2019 19:02:00,0,3213.0,2950.0,0.918,15.924,79,33,9,24,46,23,23,0,0.0,0.0
1002,1663,25-09-2019 19:04:00,0,3408.0,3159.0,0.927,16.924,187,103,67,36,84,49,35,0,0.0,0.0
1002,1664,25-09-2019 19:06:00,0,3626.0,3321.0,0.916,17.962,149,58,31,27,91,56,35,17,0.0,0.32
1002,1665,25-09-2019 19:08:00,0,3421.0,3131.0,0.915,16.943,26,23,1,22,3,0,3,0,0.0,0.01
1002,1666,25-09-2019 19:10:00,0,3444.0,3050.0,0.885,16.946,68,29,6,23,39,15,24,0,0.04,0.0
1002,1667,25-09-2019 19:12:00,0,3427.0,3110.0,0.9075,16.9455,116,62,41,21,54,32,22,27,0.08,0.0
1002,1668,25-09-2019 19:14:00,0,3410.0,3170.0,0.93,16.945,218,118,90,28,100,69,31,45,0.0,0.0
1002,1669,25-09-2019 19:16:00,0,3745.0,3394.0,0.906,18.514,51,22,12,10,29,15,14,0,0.04,0.0
1002,1670,25-09-2019 19:18:00,0,3726.0,3356.0,0.901,18.397,45,20,9,11,25,13,12,0,0.0,0.0
1002,1671,25-09-2019 19:20:00,0,3937.0,3431.0,0.871,19.31,397,219,169,50,178,130,48,98,0.0,0.05
1002,1672,25-09-2019 19:22:00,0,4084.0,3860.0,0.945,20.365,357,141,103,38,216,162,54,9,0.08,0.04
1002,1673,25-09-2019 19:24:00,0,3727.0,3420.0,0.918,18.471,189,78,56,22,111,85,26,21,0.0,0.0
1002,1674,25-09-2019 19:26:00,0,3639.0,3263.0,0.897,17.952,178,113,93,20,65,51,14,75,0.0,0.0
1002,1675,25-09-2019 19:28:00,0,3896.0,3643.0,0.935,19.384,178,103,79,24,75,51,24,75,0.0,0.0
1002,1676,25-09-2019 19:30:00,0,3729.0,3357.0,0.9,18.407,212,104,72,32,108,78,30,30,0.07,0.0
1002,1677,25-09-2019 19:32:00,0,4508.0,4049.0,0.898,22.246,119,49,32,17,70,42,28,55,0.0,0.0
1002,1678,25-09-2019 19:34:00,0,4619.0,4127.0,0.894,22.766,122,42,25,17,80,40,40,47,0.0,0.0
1002,1679,25-09-2019 19:36:00,0,4505.0,4080.0,0.906,22.266,216,155,107,48,61,43,18,63,0.01,0.06
1002,1680,25-09-2019 19:38:00,0,3988.0,3761.0,0.943,19.878,254,123,91,32,131,97,34,10,0.0,0.0
1002,1681,25-09-2019 19:40:00,0,3894.0,3637.0,0.934,19.371,52,18,3,15,34,11,23,0,0.0,0.0
1002,1682,25-09-2019 19:42:00,0,3630.0,3287.0,0.905,17.943,76,48,17,31,28,8,20,0,0.0,0.0
1002,1683,25-09-2019 19:44:00,0,3903.0,3606.0,0.924,19.369,174,67,31,36,107,65,42,0,0.0,0.0
1002,1684,25-09-2019 19:46:00,0,3874.0,3480.5,0.8985,19.1155,73,17,10,7,56,39,17,0,0.0,0.0
1002,1685,25-09-2019 19:48:00,0,3845.0,3355.0,0.873,18.862,147,33,11,22,114,81,33,0,0.0,0.0
1002,1686,25-09-2019 19:50:00,0,3929.0,3499.0,0.891,19.353,114,24,8,16,90,60,30,0,0.01,0.0
1002,1687,25-09-2019 19:52:00,0,3952.0,3453.0,0.874,19.394,42,3,0,3,39,10,29,0,0.0,0.0
1002,1688,25-09-2019 19:54:00,0,3735.0,3325.0,0.89,18.396,58,12,5,7,46,6,40,0,0.0,0.0
1002,1689,25-09-2019 19:56:00,0,3539.0,3179.0,0.898,17.463,39,2,1,1,37,2,35,0,0.0,0.0
1002,1690,25-09-2019 19:58:00,0,3442.0,3071.0,0.892,16.96,71,0,0,0,71,34,37,0,0.0,0.0
1002,1691,25-09-2019 20:00:00,0,3443.0,3056.0,0.887,16.95,20,5,2,3,15,6,9,0,0.0,0.0
1002,1692,25-09-2019 20:02:00,0,3244.0,2892.0,0.891,15.982,11,0,0,0,11,0,11,0,0.0,0.0
1002,1693,25-09-2019 20:04:00,0,3250.0,2873.0,0.884,15.984,36,7,4,3,29,0,29,0,0.0,0.0
1002,1694,25-09-2019 20:06:00,0,3054.0,2717.0,0.89,15.041,29,6,3,3,23,0,23,0,0.0,0.0
1002,1695,25-09-2019 20:08:00,0,2943.0,2666.0,0.906,14.548,11,1,0,1,10,0,10,0,0.0,0.0
1002,1696,25-09-2019 20:10:00,0,3265.0,2781.0,0.852,15.943,347,99,54,45,248,189,59,3,0.0,0.0
1002,1697,25-09-2019 20:12:00,0,3434.0,3120.0,0.909,16.985,187,65,43,22,122,84,38,26,0.03,0.0
1002,1698,25-09-2019 20:14:00,0,3611.0,3305.0,0.915,17.886,290,134,98,36,156,101,55,69,0.0,0.0
1002,1699,25-09-2019 20:16:00,0,3590.0,3383.0,0.942,17.889,416,221,169,52,195,139,56,22,0.0,0.0
1002,1700,25-09-2019 20:18:00,0,3941.0,3473.0,0.881,19.372,130,66,43,23,64,32,32,58,0.0,0.0
1002,1701,25-09-2019 20:20:00,0,3928.0,3521.0,0.8965,19.3735,93,21,5,16,72,28,44,37,0.0,0.0
1002,1702,25-09-2019 20:22:00,0,3915.0,3569.0,0.912,19.375,248,127,96,31,121,81,40,64,0.01,0.03
1002,1703,25-09-2019 20:24:00,0,3446.0,3058.0,0.887,16.962,240,106,68,38,134,82,52,24,0.07,0.01
1002,1704,25-09-2019 20:26:00,0,3932.0,3541.0,0.901,19.414,32,8,6,2,24,0,24,0,0.0,0.0
1002,1705,25-09-2019 20:28:00,0,3700.0,3381.0,0.914,18.322,32,2,0,2,30,2,28,0,0.0,0.0
1002,1706,25-09-2019 20:30:00,0,3513.0,3239.0,0.922,17.427,23,2,0,2,21,0,21,0,0.0,0.0
1002,1707,25-09-2019 20:32:00,0,3324.0,2993.0,0.9,16.41,29,4,1,3,25,2,23,0,0.0,0.0
1002,1708,25-09-2019 20:34:00,0,3245.0,2873.0,0.885,15.967,73,32,13,19,41,23,18,0,0.0,0.0
1002,1709,25-09-2019 20:36:00,0,3044.0,2716.0,0.892,14.999,44,20,0,20,24,0,24,0,0.0,0.0
1002,1710,25-09-2019 20:38:00,0,2948.0,2682.0,0.91,14.585,15,6,3,3,9,0,9,0,0.0,0.0
1002,1711,25-09-2019 20:40:00,0,3041.0,2719.0,0.894,14.992,2,0,0,0,2,1,1,0,0.0,0.0
1002,1712,25-09-2019 20:42:00,0,2931.0,2675.0,0.913,14.509,20,11,3,8,9,4,5,0,0.0,0.0
1002,1713,25-09-2019 20:44:00,0,2952.0,2643.0,0.895,14.559,16,2,0,2,14,1,13,0,0.0,0.0
1002,1714,25-09-2019 20:46:00,0,2955.0,2623.0,0.888,14.549,25,12,0,12,13,0,13,0,0.0,0.0
1002,1715,25-09-2019 20:48:00,0,2967.0,2598.0,0.876,14.567,30,10,6,4,20,9,11,0,0.0,0.0
1002,1716,25-09-2019 20:50:00,0,3041.0,2712.0,0.892,14.986,10,10,0,10,0,0,0,0,0.0,0.0
1002,1717,25-09-2019 20:52:00,0,3050.0,2773.0,0.909,15.085,69,38,22,16,31,14,17,0,0.0,0.0
1002,1718,25-09-2019 20:54:00,0,3148.0,2825.5,0.898,15.5295,133,53,23,30,80,43,37,0,0.0,0.01
1002,1719,25-09-2019 20:56:00,0,3246.0,2878.0,0.887,15.974,206,56,18,38,150,103,47,2,0.0,0.0
1002,1720,25-09-2019 20:58:00,0,3222.0,3007.0,0.933,16.022,92,42,19,23,50,28,22,18,0.0,0.0
1002,1721,25-09-2019 21:00:00,0,3312.0,3081.0,0.93,16.459,122,59,37,22,63,27,36,71,0.0,0.0
1002,1722,25-09-2019 21:02:00,0,3611.0,3331.0,0.923,17.916,199,115,87,28,84,43,41,87,0.0,0.02
1002,1723,25-09-2019 21:04:00,0,3705.0,3429.0,0.925,18.395,107,53,29,24,54,20,34,68,0.0,0.0
1002,1724,25-09-2019 21:06:00,0,3928.0,3504.0,0.892,19.356,171,55,25,30,116,70,46,45,0.0,0.04
1002,1725,25-09-2019 21:08:00,0,3611.0,3350.0,0.928,17.937,149,79,46,33,70,48,22,31,0.0,0.01
1002,1726,25-09-2019 21:10:00,0,3311.0,3058.0,0.924,16.429,226,115,88,27,111,74,37,83,0.01,0.0
1002,1727,25-09-2019 21:12:00,0,3620.0,3295.0,0.91,17.911,249,142,111,31,107,80,27,96,0.04,0.01
1002,1728,25-09-2019 21:14:00,0,3841.0,3448.0,0.898,18.953,130,50,23,27,80,43,37,60,0.0,0.0
1002,1729,25-09-2019 21:16:00,0,4066.0,3832.0,0.942,20.262,158,12,6,6,146,97,49,23,0.01,0.04
1002,1730,25-09-2019 21:18:00,0,3982.0,3790.0,0.952,19.883,206,90,66,24,116,83,33,11,0.0,0.05
1002,1731,25-09-2019 21:20:00,0,2945.0,2665.0,0.905,14.556,289,169,129,40,120,85,35,43,0.0,0.0
1002,1732,25-09-2019 21:22:00,0,3350.0,2930.0,0.875,16.442,299,195,157,38,104,76,28,121,0.0,0.0
1002,1733,25-09-2019 21:24:00,0,2771.0,2442.0,0.881,13.62,77,38,20,18,39,20,19,6,0.0,0.0
1002,1734,25-09-2019 21:26:00,0,2790.0,2305.0,0.826,13.544,234,107,75,32,127,88,39,45,0.04,0.01
1002,1735,25-09-2019 21:28:00,0,3448.5,3033.0,0.871,16.9445,146,76,44,32,70,45,25,0,0.02,0.01
1002,1736,25-09-2019 21:30:00,0,4107.0,3761.0,0.916,20.345,101,38,14,24,63,44,19,0,0.0,0.0
1002,1737,25-09-2019 21:32:00,0,3927.0,3553.0,0.905,19.406,80,32,16,16,48,26,22,0,0.0,0.0
1002,1738,25-09-2019 21:34:00,0,3931.0,3496.0,0.889,19.358,42,0,0,0,42,13,29,0,0.0,0.0
1002,1739,25-09-2019 21:36:00,0,3720.0,3386.0,0.91,18.407,26,0,0,0,26,0,26,0,0.0,0.0
1002,1740,25-09-2019 21:38:00,0,3530.0,3225.0,0.914,17.477,31,8,4,4,23,7,16,0,0.0,0.0
1002,1741,25-09-2019 21:40:00,0,3435.0,3073.0,0.895,16.934,58,18,8,10,40,28,12,0,0.0,0.0
1002,1742,25-09-2019 21:42:00,0,3319.0,3040.0,0.916,16.442,16,1,1,0,15,4,11,0,0.0,0.0
1002,1743,25-09-2019 21:44:00,0,3214.0,3006.0,0.935,15.99,31,2,1,1,29,8,21,0,0.0,0.0
1002,1744,25-09-2019 21:46:00,0,3242.0,2918.0,0.9,16.004,52,21,12,9,31,24,7,0,0.0,0.0
1002,1745,25-09-2019 21:48:00,0,3229.0,2952.0,0.914,15.988,0,0,0,0,0,0,0,0,0.0,0.0
1002,1746,25-09-2019 21:50:00,0,3248.0,2823.0,0.869,15.923,12,12,6,6,0,0,0,0,0.0,0.0
1002,1747,25-09-2019 21:52:00,0,3269.0,2824.0,0.864,16.005,16,8,3,5,8,2,6,0,0.0,0.0
1002,1748,25-09-2019 21:54:00,0,3140.0,2796.0,0.891,15.467,149,84,57,27,65,40,25,0,0.0,0.0
1002,1749,25-09-2019 21:56:00,0,3046.0,2762.0,0.907,15.057,93,37,13,24,56,32,24,0,0.0,0.0
1002,1750,25-09-2019 21:58:00,0,3420.0,3111.0,0.91,16.919,151,61,22,39,90,55,35,12,0.0,0.0
1002,1751,25-09-2019 22:00:00,0,3417.0,3153.0,0.923,16.955,95,51,25,26,44,13,31,49,0.0,0.0
1002,1752,25-09-2019 22:02:00,0,3646.5,3448.5,0.9445,18.186,128,11,5,6,117,68,49,18,0.0,0.07
1002,1753,25-09-2019 22:04:00,0,3876.0,3744.0,0.966,19.417,141,6,0,6,135,81,54,16,0.0,0.0
1002,1754,25-09-2019 22:06:00,0,3884.0,3663.0,0.943,19.359,383,198,154,44,185,130,55,49,0.04,0.09
1002,1755,25-09-2019 22:08:00,0,3451.0,3051.0,0.884,16.974,241,133,102,31,108,75,33,111,0.0,0.0
1002,1756,25-09-2019 22:10:00,0,3935.0,3531.0,0.897,19.413,192,112,80,32,80,55,25,48,0.0,0.03
1002,1757,25-09-2019 22:12:00,0,3819.0,3432.0,0.899,18.845,111,100,52,48,11,1,10,71,0.0,0.0
1002,1758,25-09-2019 22:14:00,0,3924.0,3510.0,0.895,19.345,219,132,93,39,87,42,45,58,0.0,0.08
1002,1759,25-09-2019 22:16:00,0,3247.0,2887.0,0.889,15.989,424,238,198,40,186,144,42,111,0.08,0.01
1002,1760,25-09-2019 22:18:00,0,4099.0,3809.0,0.929,20.365,328,172,130,42,156,116,40,94,0.0,0.0
1002,1761,25-09-2019 22:20:00,0,3428.0,3111.0,0.907,16.95,326,219,172,47,107,82,25,180,0.0,0.01
1002,1762,25-09-2019 22:22:00,0,3916.0,3587.0,0.916,19.403,404,250,202,48,154,117,37,122,0.0,0.0
1002,1763,25-09-2019 22:24:00,0,4182.0,3971.0,0.95,20.872,224,183,146,37,41,19,22,54,0.06,0.0
1002,1764,25-09-2019 22:26:00,0,4781.0,4417.0,0.924,23.728,245,146,108,38,99,67,32,87,0.01,0.05
1002,1765,25-09-2019 22:28:00,0,4493.0,4104.0,0.913,22.246,166,82,60,22,84,57,27,41,0.0,0.0
1002,1766,25-09-2019 22:30:00,0,3459.0,3032.0,0.877,16.984,187,82,55,27,105,76,29,35,0.06,0.0
1002,1767,25-09-2019 22:32:00,0,4057.0,3875.0,0.955,20.274,354,206,157,49,148,113,35,135,0.01,0.0
1002,1768,25-09-2019 22:34:00,0,4760.0,4511.0,0.948,23.749,169,67,45,22,102,54,48,57,0.0,0.04
1002,1769,25-09-2019 22:36:00,0,4851.0,4620.5,0.9525,24.229,114,18,3,15,96,48,48,22,0.0,0.06
1002,1770,25-09-2019 22:38:00,0,4942.0,4730.0,0.957,24.709,85,29,9,20,56,42,14,19,0.0,0.07
1002,1771,25-09-2019 22:40:00,0,4404.0,4018.0,0.912,21.799,182,81,48,33,101,67,34,0,0.1,0.01
1002,1772,25-09-2019 22:42:00,0,3963.0,3435.0,0.867,19.417,42,16,6,10,26,5,21,0,0.05,0.01
1002,1773,25-09-2019 22:44:00,0,3943.0,3467.0,0.879,19.376,331,203,151,52,128,83,45,37,0.0,0.0
1002,1774,25-09-2019 22:46:00,0,3937.0,3479.0,0.884,19.362,238,129,94,35,109,72,37,45,0.01,0.0
1002,1775,25-09-2019 22:48:00,0,3987.0,3735.0,0.937,19.842,172,77,51,26,95,50,45,61,0.0,0.01
1002,1776,25-09-2019 22:50:00,0,4996.0,4556.0,0.912,24.728,116,31,6,25,85,55,30,20,0.0,0.0
1002,1777,25-09-2019 22:52:00,0,5557.0,5250.0,0.945,27.708,125,40,20,20,85,58,27,8,0.07,0.09
1002,1778,25-09-2019 22:54:00,0,3640.0,3209.0,0.882,17.894,154,78,39,39,76,39,37,1,0.05,0.0
1002,1779,25-09-2019 22:56:00,0,3948.0,3468.0,0.879,19.393,84,35,14,21,49,26,23,1,0.0,0.0
1002,1780,25-09-2019 22:58:00,0,4623.0,4137.0,0.895,22.794,162,109,71,38,53,22,31,0,0.0,0.0
1002,1781,25-09-2019 23:00:00,0,4416.0,4023.0,0.911,21.853,151,91,52,39,60,38,22,0,0.0,0.01
1002,1782,25-09-2019 23:02:00,0,4089.0,3814.0,0.933,20.333,10,5,1,4,5,2,3,0,0.0,0.0
1002,1783,25-09-2019 23:04:00,0,4076.0,3900.0,0.957,20.377,22,11,5,6,11,6,5,0,0.0,0.0
1002,1784,25-09-2019 23:06:00,0,4103.0,3733.0,0.91,20.3,1,1,0,1,0,0,0,0,0.0,0.0
1002,1785,25-09-2019 23:08:00,0,3992.0,3777.0,0.946,19.909,5,0,0,0,5,4,1,0,0.0,0.0
1002,1786,25-09-2019 23:10:00,0,3948.0,3725.0,0.9435,19.6785,0,0,0,0,0,0,0,0,0.0,0.0
1002,1787,25-09-2019 23:12:00,0,3904.0,3673.0,0.941,19.448,473,197,136,61,276,204,72,0,0.0,0.02
1002,1788,25-09-2019 23:14:00,0,4092.0,3803.0,0.929,20.334,123,69,43,26,54,29,25,34,0.0,0.08
1002,1789,25-09-2019 23:16:00,0,4263.0,4002.0,0.939,21.227,152,34,15,19,118,69,49,37,0.0,0.0
1002,1790,25-09-2019 23:18:00,0,4074.0,3887.0,0.954,20.353,96,70,31,39,26,9,17,51,0.0,0.0
1002,1791,25-09-2019 23:20:00,0,3903.0,3564.0,0.913,19.322,250,150,109,41,100,70,30,60,0.0,0.0
1002,1792,25-09-2019 23:22:00,0,3820.0,3496.0,0.915,18.922,331,194,156,38,137,105,32,142,0.08,0.0
1002,1793,25-09-2019 23:24:00,0,4054.0,3883.0,0.958,20.273,192,105,75,30,87,63,24,112,0.0,0.01
1002,1794,25-09-2019 23:26:00,0,3614.0,3418.0,0.946,18.024,294,140,101,39,154,112,42,85,0.01,0.0
1002,1795,25-09-2019 23:28:00,0,3928.0,3519.0,0.896,19.372,160,110,75,35,50,38,12,56,0.0,0.0
1002,1796,25-09-2019 23:30:00,0,3438.0,3111.0,0.905,16.988,194,91,69,22,103,72,31,56,0.0,0.0
1002,1797,25-09-2019 23:32:00,0,4003.0,3648.0,0.911,19.811,514,306,246,60,208,157,51,254,0.02,0.0
1002,1798,25-09-2019 23:34:00,0,4889.0,4565.0,0.934,24.315,475,263,209,54,212,164,48,124,0.05,0.0
1002,1799,25-09-2019 23:36:00,0,4779.0,4392.0,0.919,23.691,374,214,163,51,160,127,33,102,0.02,0.01
1002,1800,25-09-2019 23:38:00,0,4794.0,4392.0,0.916,23.75,478,247,188,59,231,178,53,152,0.0,0.0
1002,1801,25-09-2019 23:40:00,0,4784.0,4356.0,0.911,23.671,175,76,50,26,99,56,43,48,0.0,0.0
1002,1802,25-09-2019 23:42:00,0,4770.0,4468.0,0.937,23.741,175,29,15,14,146,91,55,41,0.0,0.0
1002,1803,25-09-2019 23:44:00,0,4687.0,4296.5,0.9165,23.2235,29,8,2,6,21,10,11,7,0.0,0.32
1002,1804,25-09-2019 23:46:00,0,4604.0,4125.0,0.896,22.706,0,0,0,0,0,0,0,0,0.0,0.0
1002,1805,25-09-2019 23:48:00,0,4194.0,3854.0,0.919,20.791,5,1,1,0,4,2,2,0,0.0,0.0
1002,1806,25-09-2019 23:50:00,0,4599.0,4197.0,0.913,22.766,342,183,141,42,159,115,44,107,0.06,0.01
1002,1807,25-09-2019 23:52:00,0,4003.0,3750.0,0.937,19.923,339,162,132,30,177,140,37,72,0.07,0.0
1002,1808,25-09-2019 23:54:00,0,3870.0,3713.0,0.959,19.36,396,265,213,52,131,102,29,154,0.0,0.0
1002,1809,25-09-2019 23:56:00,0,3827.0,3452.0,0.902,18.899,276,102,66,36,174,137,37,12,0.01,0.0
1002,1810,25-09-2019 23:58:00,0,4112.0,3788.0,0.921,20.393,468,264,210,54,204,158,46,156,0.0,0.04
1002,1811,26-09-2019 00:00:00,0,4978.0,4601.0,0.924,24.706,170,106,86,20,64,36,28,19,0.09,0.0
1002,1812,26-09-2019 00:02:00,0,4758.0,4507.0,0.947,23.734,132,69,47,22,63,37,26,25,0.0,0.0
1002,1813,26-09-2019 00:04:00,0,3593.0,3368.0,0.937,17.886,288,152,109,43,136,103,33,71,0.0,0.0
1002,1814,26-09-2019 00:06:00,0,4390.0,4103.0,0.935,21.839,489,274,222,52,215,168,47,158,0.0,0.0
1002,1815,26-09-2019 00:08:00,0,4596.0,4180.0,0.909,22.735,263,176,129,47,87,58,29,105,0.0,0.08
1002,1816,26-09-2019 00:10:00,0,4884.0,4590.0,0.94,24.324,344,186,134,52,158,116,42,63,0.01,0.0
1002,1817,26-09-2019 00:12:00,0,4069.0,3881.0,0.954,20.328,272,129,96,33,143,94,49,33,0.0,0.0
1002,1818,26-09-2019 00:14:00,0,4556.0,4304.0,0.945,22.714,512,299,246,53,213,164,49,169,0.0,0.0
1002,1819,26-09-2019 00:16:00,0,4586.0,4275.0,0.932,22.8,433,254,198,56,179,135,44,116,0.0,0.0
1002,1820,26-09-2019 00:18:00,0,4636.0,4295.5,0.9265,23.021,214,57,28,29,157,103,54,6,0.0,0.0
1002,1821,26-09-2019 00:20:00,0,4686.0,4316.0,0.921,23.242,235,14,6,8,221,163,58,4,0.0,0.0
1002,1822,26-09-2019 00:22:00,0,4578.0,4298.0,0.939,22.793,310,93,56,37,217,163,54,19,0.04,0.0
1002,1823,26-09-2019 00:24:00,0,4585.0,4267.0,0.931,22.788,197,90,69,21,107,77,30,30,0.01,0.0
1002,1824,26-09-2019 00:26:00,0,4389.0,4062.0,0.926,21.789,178,130,78,52,48,25,23,2,0.0,0.0
1002,1825,26-09-2019 00:28:00,0,4082.0,3847.0,0.942,20.343,82,61,24,37,21,8,13,0,0.0,0.0
1002,1826,26-09-2019 00:30:00,0,4122.0,3739.0,0.907,20.379,108,22,5,17,86,62,24,0,0.0,0.0
1002,1827,26-09-2019 00:32:00,0,3911.0,3583.0,0.916,19.377,66,24,0,24,42,16,26,0,0.0,0.0
1002,1828,26-09-2019 00:34:00,0,3915.0,3597.0,0.919,19.408,69,23,16,7,46,29,17,0,0.0,0.0
1002,1829,26-09-2019 00:36:00,0,3911.0,3622.0,0.926,19.418,93,63,28,35,30,10,20,0,0.0,0.0
1002,1830,26-09-2019 00:38:00,0,4104.0,3759.0,0.916,20.331,257,80,44,36,177,122,55,2,0.0,0.0
1002,1831,26-09-2019 00:40:00,0,3879.0,3680.0,0.949,19.358,411,174,126,48,237,174,63,35,0.0,0.0
1002,1832,26-09-2019 00:42:00,0,4110.0,3797.0,0.924,20.398,264,157,106,51,107,77,30,56,0.0,0.0
1002,1833,26-09-2019 00:44:00,0,3983.0,3708.0,0.931,19.797,145,104,65,39,41,23,18,45,0.0,0.0
1002,1834,26-09-2019 00:46:00,0,4100.0,3777.0,0.921,20.335,132,68,35,33,64,38,26,42,0.0,0.0
1002,1835,26-09-2019 00:48:00,0,3823.0,3484.0,0.911,18.921,171,54,20,34,117,85,32,1,0.0,0.0
1002,1836,26-09-2019 00:50:00,0,3612.0,3323.0,0.92,17.911,231,24,7,17,207,164,43,0,0.0,0.0
1002,1837,26-09-2019 00:52:00,0,3670.0,3364.0,0.9165,18.185,100,18,5,13,82,52,30,0,0.0,0.0
1002,1838,26-09-2019 00:54:00,0,3728.0,3405.0,0.913,18.459,215,5,3,2,210,167,43,0,0.0,0.0
1002,1839,26-09-2019 00:56:00,0,3394.0,3199.0,0.943,16.915,171,5,0,5,166,112,54,0,0.0,0.0
1002,1840,26-09-2019 00:58:00,0,3435.0,3099.0,0.902,16.963,41,5,3,2,36,5,31,0,0.01,0.0
1002,1841,26-09-2019 01:00:00,0,3225.0,2955.0,0.916,15.977,1,0,0,0,1,0,1,0,0.0,0.0
1002,1842,26-09-2019 01:02:00,0,3262.0,2767.0,0.848,15.916,59,17,12,5,42,23,19,0,0.0,0.0
1002,1843,26-09-2019 01:04:00,0,3251.0,2866.0,0.882,15.983,0,0,0,0,0,0,0,0,0.0,0.0
1002,1844,26-09-2019 01:06:00,0,3039.0,2728.0,0.898,14.994,21,2,1,1,19,1,18,0,0.0,0.0
1002,1845,26-09-2019 01:08:00,0,3028.0,2751.0,0.909,14.978,27,0,0,0,27,0,27,0,0.0,0.0
1002,1846,26-09-2019 01:10:00,0,2924.0,2725.0,0.932,14.537,6,0,0,0,6,0,6,0,0.0,0.0
1002,1847,26-09-2019 01:12:00,0,3032.0,2749.0,0.907,14.99,50,0,0,0,50,0,50,0,0.0,0.0
1002,1848,26-09-2019 01:14:00,0,2907.0,2757.0,0.948,14.507,53,4,0,4,49,15,34,0,0.0,0.0
1002,1849,26-09-2019 01:16:00,0,3143.0,2802.0,0.891,15.486,248,56,9,47,192,157,35,0,0.0,0.0
1002,1850,26-09-2019 01:18:00,0,3202.0,3014.0,0.941,15.95,251,120,86,34,131,95,36,37,0.0,0.0
1002,1851,26-09-2019 01:20:00,0,3304.0,3092.0,0.936,16.442,331,144,112,32,187,144,43,34,0.0,0.0
1002,1852,26-09-2019 01:22:00,0,3217.0,3003.0,0.934,15.999,510,271,223,48,239,186,53,29,0.0,0.0
1002,1853,26-09-2019 01:24:00,0,3384.0,3256.0,0.962,16.935,164,108,73,35,56,37,19,70,0.0,0.0
1002,1854,26-09-2019 01:26:00,0,3392.5,3222.0,0.9495,16.933,247,121,96,25,126,90,36,89,0.0,0.0
1002,1855,26-09-2019 01:28:00,0,3401.0,3188.0,0.937,16.931,229,115,73,42,114,72,42,8,0.0,0.0
1002,1856,26-09-2019 01:30:00,0,3400.0,3206.0,0.943,16.947,123,55,32,23,68,43,25,9,0.0,0.0
1002,1857,26-09-2019 01:32:00,0,3706.0,3463.0,0.934,18.435,214,158,108,50,56,37,19,100,0.0,0.0
1002,1858,26-09-2019 01:34:00,0,3583.0,3401.0,0.949,17.882,262,153,107,46,109,78,31,60,0.0,0.03
1002,1859,26-09-2019 01:36:00,0,3307.0,3123.0,0.944,16.487,231,132,92,40,99,64,35,24,0.0,0.0
1002,1860,26-09-2019 01:38:00,0,3201.0,3082.0,0.963,16.023,309,211,168,43,98,73,25,83,0.0,0.0
1002,1861,26-09-2019 01:40:00,0,3220.0,3008.0,0.934,16.019,357,220,171,49,137,100,37,73,0.0,0.0
1002,1862,26-09-2019 01:42:00,0,3889.0,3605.0,0.927,19.316,173,76,47,29,97,51,46,66,0.0,0.0
1002,1863,26-09-2019 01:44:00,0,3705.0,3493.0,0.943,18.463,325,186,139,47,139,104,35,76,0.0,0.0
1002,1864,26-09-2019 01:46:00,0,3884.0,3724.0,0.959,19.426,446,280,226,54,166,126,40,176,0.0,0.0
1002,1865,26-09-2019 01:48:00,0,3817.0,3477.0,0.911,18.888,370,219,183,36,151,123,28,187,0.0,0.0
1002,1866,26-09-2019 01:50:00,0,3882.0,3683.0,0.949,19.371,394,227,186,41,167,132,35,172,0.0,0.0
1002,1867,26-09-2019 01:52:00,0,4097.0,3821.0,0.933,20.37,302,200,162,38,102,74,28,121,0.0,0.0
1002,1868,26-09-2019 01:54:00,0,3996.0,3756.0,0.94,19.902,273,153,121,32,120,83,37,91,0.01,0.0
1002,1869,26-09-2019 01:56:00,0,3883.0,3617.0,0.932,19.305,230,95,50,45,135,93,42,15,0.0,0.0
1002,1870,26-09-2019 01:58:00,0,4102.0,3831.0,0.934,20.402,146,88,59,29,58,36,22,47,0.0,0.0
1002,1871,26-09-2019 02:00:00,0,4095.5,3812.0,0.931,20.355,201,129,91,38,72,47,25,79,0.0,0.13
1002,1872,26-09-2019 02:02:00,0,4089.0,3793.0,0.928,20.308,308,177,142,35,131,97,34,152,0.0,0.0
1002,1873,26-09-2019 02:04:00,0,4076.0,3883.0,0.953,20.357,105,60,42,18,45,21,24,46,0.0,0.0
1002,1874,26-09-2019 02:06:00,0,4194.0,3934.0,0.938,20.879,192,102,62,40,90,47,43,12,0.02,0.0
1002,1875,26-09-2019 02:08:00,0,4003.0,3709.0,0.926,19.878,64,37,12,25,27,7,20,0,0.0,0.0
1002,1876,26-09-2019 02:10:00,0,3944.0,3422.0,0.868,19.329,37,24,13,11,13,3,10,0,0.0,0.0
1002,1877,26-09-2019 02:12:00,0,3636.0,3192.0,0.878,17.86,43,25,14,11,18,4,14,0,0.0,0.0
1002,1878,26-09-2019 02:14:00,0,3944.0,3526.0,0.894,19.442,156,78,43,35,78,38,40,0,0.0,0.0
1002,1879,26-09-2019 02:16:00,0,3815.0,3405.0,0.893,18.8,141,96,50,46,45,8,37,0,0.0,0.0
1002,1880,26-09-2019 02:18:00,0,3848.0,3419.0,0.889,18.947,129,101,66,35,28,1,27,0,0.0,0.0
1002,1881,26-09-2019 02:20:00,0,3638.0,3241.0,0.891,17.923,8,8,3,5,0,0,0,0,0.0,0.0
1002,1882,26-09-2019 02:22:00,0,3443.0,3116.0,0.905,17.014,0,0,0,0,0,0,0,0,0.0,0.0
1002,1883,26-09-2019 02:24:00,0,3231.0,2904.0,0.899,15.945,3,3,1,2,0,0,0,0,0.0,0.0
1002,1884,26-09-2019 02:26:00,0,3260.0,2843.0,0.872,15.993,13,13,8,5,0,0,0,0,0.0,0.0
1002,1885,26-09-2019 02:28:00,0,3171.0,2737.0,0.863,15.524,7,6,2,4,1,0,1,0,0.0,0.0
1002,1886,26-09-2019 02:30:00,0,3044.0,2681.0,0.881,14.963,23,12,2,10,11,3,8,0,0.0,0.0
1002,1887,26-09-2019 02:32:00,0,2954.0,2666.0,0.903,14.591,9,6,4,2,3,2,1,0,0.0,0.0
1002,1888,26-09-2019 02:34:00,0,2905.0,2575.0,0.8865,14.2975,41,22,13,9,19,8,11,0,0.0,0.0
1002,1889,26-09-2019 02:36:00,0,2856.0,2484.0,0.87,14.004,20,13,7,6,7,0,7,0,0.01,0.0
1002,1890,26-09-2019 02:38:00,0,2868.0,2479.0,0.865,14.044,6,0,0,0,6,1,5,0,0.0,0.0
1002,1891,26-09-2019 02:40:00,0,2945.0,2654.0,0.901,14.541,21,14,10,4,7,3,4,0,0.0,0.0
1002,1892,26-09-2019 02:42:00,0,2941.0,2691.0,0.915,14.566,4,1,1,0,3,0,3,0,0.0,0.0
1002,1893,26-09-2019 02:44:00,0,2946.0,2631.0,0.893,14.519,17,6,3,3,11,3,8,0,0.0,0.0
1002,1894,26-09-2019 02:46:00,0,2753.0,2485.0,0.903,13.597,23,7,0,7,16,1,15,0,0.0,0.0
1002,1895,26-09-2019 02:48:00,0,2758.0,2387.0,0.866,13.51,16,12,0,12,4,1,3,0,0.0,0.0
1002,1896,26-09-2019 02:50:00,0,2670.0,2342.0,0.877,13.111,3,2,0,2,1,1,0,0,0.0,0.0
1002,1897,26-09-2019 02:52:00,0,2551.0,2282.0,0.895,12.576,85,64,42,22,21,8,13,0,0.0,0.0
1002,1898,26-09-2019 02:54:00,0,2654.0,2337.0,0.88,13.043,4,4,0,4,0,0,0,0,0.0,0.0
1002,1899,26-09-2019 02:56:00,0,2576.0,2173.0,0.844,12.554,4,3,0,3,1,1,0,0,0.0,0.0
1002,1900,26-09-2019 02:58:00,0,2540.0,2327.0,0.916,12.586,0,0,0,0,0,0,0,0,0.0,0.0
1002,1901,26-09-2019 03:00:00,0,2543.0,2319.0,0.912,12.587,8,6,1,5,2,1,1,0,0.0,0.0
1002,1902,26-09-2019 03:02:00,0,2756.0,2418.0,0.877,13.535,20,5,3,2,15,7,8,0,0.0,0.0
1002,1903,26-09-2019 03:04:00,0,2569.0,2277.0,0.886,12.641,178,68,37,31,110,76,34,5,0.0,0.0
1002,1904,26-09-2019 03:06:00,0,2732.0,2502.0,0.916,13.532,162,97,71,26,65,37,28,68,0.0,0.0
1002,1905,26-09-2019 03:08:00,0,2951.5,2629.5,0.8925,14.539,137,55,27,28,82,45,37,61,0.0,0.0
1002,1906,26-09-2019 03:10:00,0,3171.0,2757.0,0.869,15.546,138,73,46,27,65,29,36,63,0.0,0.0
1002,1907,26-09-2019 03:12:00,0,3327.0,3036.0,0.912,16.47,113,57,26,31,56,17,39,56,0.0,0.0
1002,1908,26-09-2019 03:14:00,0,3602.0,3310.0,0.919,17.855,119,61,30,31,58,11,47,57,0.0,0.0
1002,1909,26-09-2019 03:16:00,0,3334.0,3023.0,0.907,16.484,82,46,18,28,36,10,26,44,0.0,0.0
1002,1910,26-09-2019 03:18:00,0,3408.0,3158.0,0.927,16.923,346,205,154,51,141,102,39,121,0.0,0.0
1002,1911,26-09-2019 03:20:00,0,3342.0,2980.0,0.892,16.465,240,126,80,46,114,80,34,40,0.1,0.0
1002,1912,26-09-2019 03:22:00,0,3625.0,3325.0,0.917,17.963,106,50,22,28,56,27,29,7,0.03,0.0
1002,1913,26-09-2019 03:24:00,0,3632.0,3262.0,0.898,17.921,100,48,21,27,52,24,28,1,0.0,0.0
1002,1914,26-09-2019 03:26:00,0,3504.0,3241.0,0.925,17.393,340,174,127,47,166,122,44,19,0.0,0.0
1002,1915,26-09-2019 03:28:00,0,3597.0,3371.0,0.937,17.903,106,61,25,36,45,12,33,73,0.0,0.0
1002,1916,26-09-2019 03:30:00,0,3903.0,3614.0,0.926,19.379,121,52,32,20,69,31,38,53,0.0,0.0
1002,1917,26-09-2019 03:32:00,0,3914.0,3562.0,0.91,19.364,215,62,34,28,153,111,42,21,0.06,0.02
1002,1918,26-09-2019 03:34:00,0,3831.0,3427.0,0.895,18.889,434,246,181,65,188,142,46,22,0.0,0.0
1002,1919,26-09-2019 03:36:00,0,3948.0,3469.0,0.879,19.395,152,89,65,24,63,46,17,22,0.0,0.26
1002,1920,26-09-2019 03:38:00,0,3730.0,3378.0,0.906,18.435,350,191,138,53,159,115,44,123,0.0,0.0
1002,1921,26-09-2019 03:40:00,0,3410.0,3157.0,0.926,16.93,148,69,47,22,79,40,39,62,0.01,0.0
1002,1922,26-09-2019 03:42:00,0,3650.5,3353.5,0.919,18.0955,126,46,26,20,80,47,33,4,0.0,0.0
1002,1923,26-09-2019 03:44:00,0,3891.0,3550.0,0.912,19.261,54,23,6,17,31,20,11,2,0.0,0.0
1002,1924,26-09-2019 03:46:00,0,3910.0,3583.0,0.916,19.372,115,35,14,21,80,56,24,0,0.0,0.0
1002,1925,26-09-2019 03:48:00,0,3916.0,3583.0,0.915,19.394,29,1,0,1,28,12,16,0,0.0,0.0
1002,1926,26-09-2019 03:50:00,0,3712.0,3418.0,0.921,18.409,11,0,0,0,11,0,11,0,0.0,0.0
1002,1927,26-09-2019 03:52:00,0,3414.0,3157.0,0.925,16.946,0,0,0,0,0,0,0,0,0.0,0.0
1002,1928,26-09-2019 03:54:00,0,3215.0,2971.0,0.924,15.955,29,4,2,2,25,22,3,0,0.0,0.0
1002,1929,26-09-2019 03:56:00,0,3260.0,2869.0,0.88,16.019,30,4,2,2,26,24,2,0,0.0,0.0
1002,1930,26-09-2019 03:58:00,0,3277.0,2770.0,0.845,15.976,14,0,0,0,14,1,13,0,0.0,0.0
1002,1931,26-09-2019 04:00:00,0,2954.0,2592.0,0.877,14.51,3,0,0,0,3,0,3,0,0.0,0.0
1002,1932,26-09-2019 04:02:00,0,2950.0,2599.0,0.881,14.499,1,0,0,0,1,0,1,0,0.0,0.0
1002,1933,26-09-2019 04:04:00,0,2941.0,2651.0,0.902,14.521,1,0,0,0,1,0,1,0,0.0,0.0
1002,1934,26-09-2019 04:06:00,0,2954.0,2623.0,0.888,14.541,0,0,0,0,0,0,0,0,0.0,0.0
1002,1935,26-09-2019 04:08:00,0,2970.0,2566.0,0.864,14.544,50,16,12,4,34,21,13,0,0.0,0.0
1002,1936,26-09-2019 04:10:00,0,2968.0,2540.0,0.856,14.506,4,1,1,0,3,2,1,0,0.0,0.0
1002,1937,26-09-2019 04:12:00,0,2975.0,2553.0,0.858,14.546,3,1,0,1,2,1,1,0,0.0,0.0
1002,1938,26-09-2019 04:14:00,0,2862.0,2487.0,0.869,14.032,0,0,0,0,0,0,0,0,0.0,0.0
1002,1939,26-09-2019 04:16:00,0,2916.0,2512.5,0.8615,14.2725,64,33,11,22,31,12,19,0,0.0,0.0
1002,1940,26-09-2019 04:18:00,0,2970.0,2538.0,0.854,14.513,101,36,17,19,65,28,37,4,0.0,0.0
1002,1941,26-09-2019 04:20:00,0,3029.0,2758.0,0.911,14.987,92,44,23,21,48,21,27,0,0.0,0.0
1002,1942,26-09-2019 04:22:00,0,3050.0,2725.0,0.894,15.032,46,19,5,14,27,9,18,0,0.0,0.0
1002,1943,26-09-2019 04:24:00,0,3049.0,2693.0,0.883,14.996,125,42,23,19,83,51,32,0,0.02,0.0
1002,1944,26-09-2019 04:26:00,0,3244.0,2920.0,0.9,16.015,37,18,3,15,19,10,9,0,0.0,0.0
1002,1945,26-09-2019 04:28:00,0,3438.0,3076.0,0.895,16.953,279,97,70,27,182,133,49,20,0.0,0.0
1002,1946,26-09-2019 04:30:00,0,3149.0,2767.0,0.879,15.471,153,81,50,31,72,44,28,59,0.0,0.0
1002,1947,26-09-2019 04:32:00,0,3446.0,3065.0,0.889,16.97,103,58,29,29,45,15,30,62,0.0,0.0
1002,1948,26-09-2019 04:34:00,0,3426.0,3110.0,0.908,16.943,125,41,9,32,84,46,38,48,0.0,0.0
1002,1949,26-09-2019 04:36:00,0,3421.0,3149.0,0.92,16.966,120,48,32,16,72,36,36,59,0.0,0.0
1002,1950,26-09-2019 04:38:00,0,3742.0,3296.0,0.881,18.392,125,33,2,31,92,38,54,50,0.0,0.0
1002,1951,26-09-2019 04:40:00,0,3424.0,3108.0,0.908,16.932,293,153,119,34,140,109,31,79,0.02,0.0
1002,1952,26-09-2019 04:42:00,0,3435.0,3092.0,0.9,16.957,339,208,158,50,131,105,26,178,0.0,0.0
1002,1953,26-09-2019 04:44:00,0,3349.0,2965.0,0.885,16.477,250,143,112,31,107,81,26,138,0.0,0.0
1002,1954,26-09-2019 04:46:00,0,3410.0,3133.0,0.919,16.904,266,162,121,41,104,70,34,120,0.0,0.0
1002,1955,26-09-2019 04:48:00,0,3649.0,3178.0,0.871,17.895,310,184,150,34,126,90,36,163,0.0,0.0
1002,1956,26-09-2019 04:50:00,0,3637.0,3204.0,0.881,17.877,369,170,137,33,199,155,44,101,0.06,0.0
1002,1957,26-09-2019 04:52:00,0,3625.0,3230.0,0.891,17.859,325,196,154,42,129,99,30,158,0.0,0.0
1002,1958,26-09-2019 04:54:00,0,3950.0,3412.0,0.864,19.34,170,109,78,31,61,41,20,107,0.0,0.0
1002,1959,26-09-2019 04:56:00,0,4554.0,3974.0,0.873,22.343,164,82,56,26,82,42,40,65,0.04,0.0
1002,1960,26-09-2019 04:58:00,0,4629.0,4055.0,0.876,22.727,105,38,12,26,67,33,34,1,0.02,0.0
1002,1961,26-09-2019 05:00:00,0,4213.0,3826.0,0.908,20.835,21,7,1,6,14,1,13,0,0.0,0.0
1002,1962,26-09-2019 05:02:00,0,3935.0,3494.0,0.888,19.371,19,5,2,3,14,1,13,0,0.0,0.0
1002,1963,26-09-2019 05:04:00,0,3921.0,3524.0,0.899,19.352,22,11,7,4,11,0,11,0,0.0,0.0
1002,1964,26-09-2019 05:06:00,0,3739.0,3366.0,0.9,18.456,17,12,8,4,5,3,2,0,0.0,0.0
1002,1965,26-09-2019 05:08:00,0,3524.0,3189.0,0.905,17.416,20,3,0,3,17,16,1,0,0.0,0.0
1002,1966,26-09-2019 05:10:00,0,3450.0,3076.0,0.892,16.997,19,8,4,4,11,4,7,0,0.0,0.0
1002,1967,26-09-2019 05:12:00,0,3354.0,2977.0,0.888,16.511,10,4,2,2,6,2,4,0,0.0,0.0
1002,1968,26-09-2019 05:14:00,0,3239.0,2845.0,0.878,15.911,6,1,0,1,5,2,3,0,0.0,0.0
1002,1969,26-09-2019 05:16:00,0,3280.0,2755.0,0.84,15.972,69,31,16,15,38,19,19,0,0.0,0.0
1002,1970,26-09-2019 05:18:00,0,3284.0,2719.0,0.828,15.95,95,29,13,16,66,34,32,1,0.0,0.0
1002,1971,26-09-2019 05:20:00,0,3292.0,2750.0,0.835,16.016,137,57,31,26,80,59,21,14,0.0,0.0
1002,1972,26-09-2019 05:22:00,0,3247.0,2920.0,0.899,16.026,204,120,96,24,84,66,18,71,0.0,0.0
1002,1973,26-09-2019 05:24:00,0,3246.5,2881.5,0.8875,15.9825,124,77,63,14,47,38,9,122,0.0,0.0
1002,1974,26-09-2019 05:26:00,0,3246.0,2843.0,0.876,15.939,372,218,171,47,154,119,35,166,0.0,0.0
1002,1975,26-09-2019 05:28:00,0,3460.0,3077.0,0.889,17.038,426,241,191,50,185,145,40,184,0.0,0.0
1002,1976,26-09-2019 05:30:00,0,3608.0,3292.0,0.912,17.86,301,151,112,39,150,110,40,19,0.0,0.0
1002,1977,26-09-2019 05:32:00,0,3405.0,3159.0,0.928,16.915,440,262,209,53,178,139,39,151,0.0,0.04
1002,1978,26-09-2019 05:34:00,0,3858.0,3390.0,0.879,18.953,455,209,169,40,246,193,53,103,0.0,0.0
1002,1979,26-09-2019 05:36:00,0,3738.0,3357.0,0.898,18.444,464,253,202,51,211,171,40,204,0.0,0.0
1002,1980,26-09-2019 05:38:00,0,3640.0,3229.0,0.887,17.917,345,188,152,36,157,121,36,199,0.0,0.0
1002,1981,26-09-2019 05:40:00,0,4149.0,3652.0,0.88,20.391,314,212,169,43,102,80,22,161,0.0,0.0
1002,1982,26-09-2019 05:42:00,0,4105.0,3697.0,0.9,20.268,272,167,134,33,105,78,27,112,0.0,0.0
1002,1983,26-09-2019 05:44:00,0,4114.0,3736.0,0.908,20.346,319,164,120,44,155,104,51,29,0.0,0.0
1002,1984,26-09-2019 05:46:00,0,4144.0,3708.0,0.895,20.432,342,193,147,46,149,110,39,105,0.0,0.0
1002,1985,26-09-2019 05:48:00,0,4133.0,3618.0,0.875,20.29,272,155,122,33,117,79,38,137,0.0,0.0
1002,1986,26-09-2019 05:50:00,0,4139.0,3671.0,0.887,20.372,134,53,33,20,81,30,51,54,0.0,0.0
1002,1987,26-09-2019 05:52:00,0,4549.0,3890.0,0.855,22.232,115,48,30,18,67,37,30,52,0.0,0.04
1002,1988,26-09-2019 05:54:00,0,4130.0,3712.0,0.899,20.383,388,180,135,45,208,133,75,31,0.11,0.03
1002,1989,26-09-2019 05:56:00,0,3974.0,3348.0,0.843,19.365,451,218,178,40,233,180,53,28,0.0,0.02
1002,1990,26-09-2019 05:58:00,0,4058.5,3480.5,0.8575,19.8445,407,198,158,40,209,158,51,13,0.0,0.0
1002,1991,26-09-2019 06:00:00,1,4143.0,3613.0,0.872,20.324,449,248,184,64,201,154,47,77,0.0,0.0
1002,1992,26-09-2019 06:02:00,1,3971.0,3351.0,0.844,19.357,368,213,166,47,155,122,33,175,0.0,0.0
1002,1993,26-09-2019 06:04:00,1,3963.0,3349.0,0.845,19.321,271,138,113,25,133,107,26,151,0.0,0.0
1002,1994,26-09-2019 06:06:00,1,3956.0,3456.0,0.874,19.411,364,203,156,47,161,115,46,79,0.05,0.0
1002,1995,26-09-2019 06:08:00,1,4128.0,3646.0,0.883,20.3,105,31,18,13,74,35,39,1,0.02,0.0
1002,1996,26-09-2019 06:10:00,1,3935.0,3480.0,0.885,19.356,58,26,0,26,32,18,14,0,0.0,0.0
1002,1997,26-09-2019 06:12:00,1,3955.0,3373.0,0.853,19.318,88,55,26,29,33,14,19,2,0.0,0.0
1002,1998,26-09-2019 06:14:00,1,3982.0,3321.0,0.834,19.364,95,40,14,26,55,42,13,0,0.0,0.0
1002,1999,26-09-2019 06:16:00,1,3963.0,3388.0,0.855,19.367,71,40,19,21,31,15,16,0,0.0,0.0
1002,2000,26-09-2019 06:18:00,1,3994.0,3294.0,0.825,19.383,177,43,22,21,134,109,25,0,0.0,0.0
1002,2001,26-09-2019 06:20:00,1,3659.0,3125.0,0.854,17.876,159,81,42,39,78,49,29,0,0.0,0.0
1002,2002,26-09-2019 06:22:00,1,3679.0,3127.0,0.85,17.958,95,36,9,27,59,37,22,0,0.0,0.0
1002,2003,26-09-2019 06:24:00,1,3462.0,3008.0,0.869,16.971,13,6,0,6,7,0,7,0,0.0,0.0
1002,2004,26-09-2019 06:26:00,1,3273.0,2741.0,0.838,15.932,23,7,2,5,16,2,14,0,0.0,0.0
1002,2005,26-09-2019 06:28:00,1,3317.0,2646.0,0.798,15.998,38,14,1,13,24,0,24,0,0.0,0.0
1002,2006,26-09-2019 06:30:00,1,3220.0,2549.0,0.792,15.511,7,7,1,6,0,0,0,0,0.0,0.0
1002,2007,26-09-2019 06:32:00,1,3112.5,2489.0,0.8,15.02,14,9,2,7,5,1,4,0,0.0,0.0
1002,2008,26-09-2019 06:34:00,1,3005.0,2429.0,0.808,14.529,0,0,0,0,0,0,0,0,0.0,0.0
1002,2009,26-09-2019 06:36:00,1,3012.0,2372.0,0.787,14.494,12,2,0,2,10,1,9,0,0.0,0.0
1002,2010,26-09-2019 06:38:00,1,2773.0,2344.0,0.845,13.519,42,0,0,0,42,10,32,0,0.0,0.0
1002,2011,26-09-2019 06:40:00,1,2795.0,2302.0,0.824,13.563,35,1,0,1,34,9,25,0,0.0,0.0
1002,2012,26-09-2019 06:42:00,1,2810.0,2242.0,0.798,13.553,0,0,0,0,0,0,0,0,0.0,0.0
1002,2013,26-09-2019 06:44:00,1,2606.0,2110.0,0.81,12.602,2,0,0,0,2,1,1,0,0.0,0.0
1002,2014,26-09-2019 06:46:00,1,2600.0,2097.0,0.807,12.564,3,0,0,0,3,1,2,0,0.0,0.0
1002,2015,26-09-2019 06:48:00,1,2606.0,2097.0,0.805,12.588,11,0,0,0,11,2,9,0,0.0,0.0
1002,2016,26-09-2019 06:50:00,1,2585.0,2149.0,0.831,12.562,14,4,3,1,10,5,5,0,0.0,0.0
1002,2017,26-09-2019 06:52:00,1,2614.0,2080.0,0.796,12.602,5,5,2,3,0,0,0,0,0.0,0.0
1002,2018,26-09-2019 06:54:00,1,2605.0,2086.0,0.801,12.573,1,1,0,1,0,0,0,0,0.0,0.0
1002,2019,26-09-2019 06:56:00,1,2594.0,2096.0,0.808,12.541,6,0,0,0,6,1,5,0,0.0,0.0
1002,2020,26-09-2019 06:58:00,1,2831.0,2144.0,0.757,13.531,21,7,0,7,14,2,12,0,0.0,0.0
1002,2021,26-09-2019 07:00:00,1,2610.0,2103.0,0.806,12.611,3,3,0,3,0,0,0,0,0.0,0.0
1002,2022,26-09-2019 07:02:00,1,2608.0,2067.0,0.793,12.563,0,0,0,0,0,0,0,0,0.0,0.0
1002,2023,26-09-2019 07:04:00,1,2615.0,2070.0,0.792,12.593,108,62,26,36,46,20,26,1,0.0,0.0
1002,2024,26-09-2019 07:06:00,1,2710.5,2157.5,0.796,13.066,319,173,127,46,146,107,39,46,0.0,0.0
1002,2025,26-09-2019 07:08:00,1,2806.0,2245.0,0.8,13.539,146,77,47,30,69,30,39,58,0.0,0.0
1002,2026,26-09-2019 07:10:00,1,3014.0,2397.0,0.795,14.528,83,69,32,37,14,4,10,47,0.0,0.0
1002,2027,26-09-2019 07:12:00,1,3319.0,2596.0,0.782,15.95,94,42,25,17,52,7,45,65,0.0,0.0
1002,2028,26-09-2019 07:14:00,1,3295.0,2652.0,0.805,15.919,197,95,71,24,102,58,44,80,0.0,0.07
1002,2029,26-09-2019 07:16:00,1,3333.0,2569.0,0.771,15.977,308,182,134,48,126,87,39,49,0.01,0.01
1002,2030,26-09-2019 07:18:00,1,3218.0,2541.0,0.79,15.492,480,255,198,57,225,164,61,1,0.0,0.0
1002,2031,26-09-2019 07:20:00,1,3331.0,2593.0,0.778,15.997,560,334,264,70,226,166,60,37,0.0,0.0
1002,2032,26-09-2019 07:22:00,1,2988.0,2493.0,0.834,14.534,221,158,128,30,63,48,15,99,0.0,0.0
1002,2033,26-09-2019 07:24:00,1,2980.0,2513.0,0.844,14.523,197,102,81,21,95,77,18,165,0.0,0.0
1002,2034,26-09-2019 07:26:00,1,3268.0,2790.0,0.854,15.964,144,78,62,16,66,40,26,76,0.0,0.0
1002,2035,26-09-2019 07:28:00,1,3282.0,2744.0,0.836,15.97,257,167,136,31,90,63,27,44,0.01,0.0
1002,2036,26-09-2019 07:30:00,1,3566.0,3033.0,0.851,17.407,262,123,79,44,139,97,42,1,0.01,0.03
1002,2037,26-09-2019 07:32:00,1,3562.0,3048.0,0.856,17.408,701,385,311,74,316,250,66,10,0.0,0.04
1002,2038,26-09-2019 07:34:00,1,3464.0,3037.0,0.877,17.013,347,202,151,51,145,100,45,50,0.0,0.02
1002,2039,26-09-2019 07:36:00,1,3485.0,2867.0,0.823,16.905,373,169,118,51,204,151,53,13,0.0,0.0
1002,2040,26-09-2019 07:38:00,1,3490.0,2890.0,0.828,16.952,820,525,429,96,295,219,76,3,0.0,0.0
1002,2041,26-09-2019 07:40:00,1,3486.0,2866.5,0.8225,16.9095,468,279,222,57,189,139,50,52,0.0,0.07
1002,2042,26-09-2019 07:42:00,1,3482.0,2843.0,0.817,16.867,108,60,26,34,48,21,27,0,0.03,0.0
1002,2043,26-09-2019 07:44:00,1,3379.0,2795.0,0.827,16.409,64,41,11,30,23,0,23,0,0.0,0.0
1002,2044,26-09-2019 07:46:00,1,3496.0,2816.0,0.805,16.894,183,119,88,31,64,35,29,0,0.0,0.0
1002,2045,26-09-2019 07:48:00,1,3473.0,2973.0,0.856,16.976,66,5,4,1,61,32,29,0,0.02,0.0
1002,2046,26-09-2019 07:50:00,1,3459.0,2955.0,0.854,16.902,34,1,1,0,33,13,20,0,0.0,0.0
1002,2047,26-09-2019 07:52:00,1,3387.0,2868.0,0.847,16.521,3,0,0,0,3,0,3,0,0.0,0.0
1002,2048,26-09-2019 07:54:00,1,3291.0,2690.0,0.817,15.946,0,0,0,0,0,0,0,0,0.0,0.0
1002,2049,26-09-2019 07:56:00,1,3093.0,2548.0,0.824,15.009,12,0,0,0,12,6,6,0,0.0,0.0
1002,2050,26-09-2019 07:58:00,1,3011.0,2373.0,0.788,14.491,0,0,0,0,0,0,0,0,0.0,0.0
1002,2051,26-09-2019 08:00:00,1,2826.0,2214.0,0.783,13.588,8,0,0,0,8,0,8,0,0.0,0.0
1002,2052,26-09-2019 08:02:00,1,2593.0,2128.0,0.821,12.572,8,0,0,0,8,0,8,0,0.0,0.0
1002,2053,26-09-2019 08:04:00,1,2614.0,2100.0,0.803,12.626,20,0,0,0,20,0,20,0,0.0,0.0
1002,2054,26-09-2019 08:06:00,1,2604.0,2087.0,0.801,12.571,38,0,0,0,38,0,38,0,0.0,0.0
1002,2055,26-09-2019 08:08:00,1,2615.0,2014.0,0.77,12.535,44,1,1,0,43,0,43,0,0.0,0.0
1002,2056,26-09-2019 08:10:00,1,2522.0,1946.0,0.772,12.089,5,0,0,0,5,0,5,0,0.0,0.0
1002,2057,26-09-2019 08:12:00,1,2644.0,1980.0,0.749,12.61,16,0,0,0,16,0,16,0,0.0,0.0
1002,2058,26-09-2019 08:14:00,1,2629.5,2000.5,0.761,12.5755,33,4,2,2,29,3,26,0,0.0,0.0
1002,2059,26-09-2019 08:16:00,1,2615.0,2021.0,0.773,12.541,1,1,0,1,0,0,0,0,0.0,0.0
1002,2060,26-09-2019 08:18:00,1,2648.0,1937.0,0.731,12.58,11,2,1,1,9,0,9,0,0.0,0.0
1002,2061,26-09-2019 08:20:00,1,2540.0,1851.0,0.729,12.059,0,0,0,0,0,0,0,0,0.0,0.0
1002,2062,26-09-2019 08:22:00,1,2436.0,1823.0,0.748,11.618,1,0,0,0,1,1,0,0,0.0,0.0
1002,2063,26-09-2019 08:24:00,1,2665.0,1873.0,0.703,12.575,59,32,22,10,27,16,11,0,0.0,0.0
1002,2064,26-09-2019 08:26:00,1,2642.0,1924.0,0.728,12.541,3,0,0,0,3,1,2,0,0.0,0.0
1002,2065,26-09-2019 08:28:00,1,2652.0,1891.0,0.713,12.544,6,2,0,2,4,0,4,0,0.0,0.0
1002,2066,26-09-2019 08:30:00,1,2661.0,1891.0,0.71,12.579,12,2,0,2,10,2,8,0,0.0,0.0
1002,2067,26-09-2019 08:32:00,1,2659.0,1896.0,0.713,12.577,21,1,0,1,20,0,20,0,0.0,0.0
1002,2068,26-09-2019 08:34:00,1,2663.0,1831.0,0.688,12.519,6,2,0,2,4,1,3,0,0.0,0.0
1002,2069,26-09-2019 08:36:00,1,2681.0,1824.0,0.68,12.581,35,8,4,4,27,18,9,0,0.0,0.0
1002,2070,26-09-2019 08:38:00,1,2680.0,1834.0,0.684,12.592,1,0,0,0,1,1,0,0,0.0,0.0
1002,2071,26-09-2019 08:40:00,1,2560.0,1794.0,0.701,12.072,0,0,0,0,0,0,0,0,0.0,0.0
1002,2072,26-09-2019 08:42:00,1,2676.0,1847.0,0.69,12.588,1,0,0,0,1,1,0,0,0.0,0.0
1002,2073,26-09-2019 08:44:00,1,2685.0,1790.0,0.667,12.563,1,0,0,0,1,0,1,0,0.0,0.0
1002,2074,26-09-2019 08:46:00,1,2695.0,1771.0,0.657,12.581,4,0,0,0,4,0,4,0,0.0,0.0
1002,2075,26-09-2019 08:48:00,1,2687.0,1785.0,0.6645,12.5635,11,2,2,0,9,0,9,0,0.0,0.0
1002,2076,26-09-2019 08:50:00,1,2679.0,1799.0,0.672,12.546,29,0,0,0,29,0,29,0,0.0,0.0
1002,2077,26-09-2019 08:52:00,1,2576.0,1775.0,0.689,12.115,83,44,25,19,39,19,20,0,0.0,0.0
1002,2078,26-09-2019 08:54:00,1,2650.0,1921.0,0.725,12.568,80,59,28,31,21,6,15,0,0.0,0.0
1002,2079,26-09-2019 08:56:00,1,2649.0,1902.0,0.718,12.545,87,27,9,18,60,31,29,0,0.0,0.0
1002,2080,26-09-2019 08:58:00,1,2855.0,2073.0,0.726,13.546,53,23,3,20,30,3,27,0,0.0,0.0
1002,2081,26-09-2019 09:00:00,1,2859.0,2081.0,0.728,13.569,119,17,5,12,102,62,40,1,0.0,0.0
1002,2082,26-09-2019 09:02:00,1,2751.0,2013.0,0.732,13.067,21,10,1,9,11,6,5,0,0.0,0.0
1002,2083,26-09-2019 09:04:00,1,2658.0,1900.0,0.715,12.576,14,9,6,3,5,2,3,0,0.0,0.0
1002,2084,26-09-2019 09:06:00,1,2441.0,1790.0,0.734,11.6,30,22,7,15,8,3,5,0,0.0,0.0
1002,2085,26-09-2019 09:08:00,1,2341.0,1750.0,0.747,11.162,2,0,0,0,2,0,2,0,0.0,0.0
1002,2086,26-09-2019 09:10:00,1,2341.0,1699.0,0.726,11.106,5,0,0,0,5,0,5,0,0.0,0.0
1002,2087,26-09-2019 09:12:00,1,2347.0,1642.0,0.699,11.065,1,0,0,0,1,0,1,0,0.0,0.0
1002,2088,26-09-2019 09:14:00,1,2353.0,1676.0,0.712,11.127,6,6,1,5,0,0,0,0,0.0,0.0
1002,2089,26-09-2019 09:16:00,1,2345.0,1694.0,0.722,11.117,8,3,0,3,5,0,5,0,0.0,0.0
1002,2090,26-09-2019 09:18:00,1,2331.0,1761.0,0.755,11.135,3,2,1,1,1,0,1,0,0.0,0.0
1002,2091,26-09-2019 09:20:00,1,2327.0,1731.0,0.744,11.085,3,3,0,3,0,0,0,0,0.0,0.0
1002,2092,26-09-2019 09:22:00,1,2336.5,1694.0,0.725,11.082,13,13,0,13,0,0,0,0,0.0,0.0
1002,2093,26-09-2019 09:24:00,1,2346.0,1657.0,0.706,11.079,2,2,0,2,0,0,0,0,0.0,0.0
1002,2094,26-09-2019 09:26:00,1,2365.0,1636.0,0.692,11.129,1,0,0,0,1,1,0,0,0.0,0.0
1002,2095,26-09-2019 09:28:00,1,2364.0,1639.0,0.693,11.131,50,30,14,16,20,4,16,1,0.0,0.0
1002,2096,26-09-2019 09:30:00,1,2656.0,1876.0,0.706,12.54,4,0,0,0,4,0,4,0,0.0,0.0
1002,2097,26-09-2019 09:32:00,1,2447.0,1770.0,0.723,11.599,35,0,0,0,35,0,35,0,0.0,0.0
1002,2098,26-09-2019 09:34:00,1,2451.0,1766.0,0.721,11.613,38,0,0,0,38,0,38,0,0.0,0.0
1002,2099,26-09-2019 09:36:00,1,2569.0,1771.0,0.69,12.083,35,0,0,0,35,0,35,0,0.0,0.0
1002,2100,26-09-2019 09:38:00,1,2570.0,1797.0,0.699,12.117,31,0,0,0,31,0,31,0,0.0,0.0
1002,2101,26-09-2019 09:40:00,1,2563.0,1776.0,0.693,12.063,2,0,0,0,2,0,2,0,0.0,0.0
1002,2102,26-09-2019 09:42:00,1,2347.0,1681.0,0.716,11.11,0,0,0,0,0,0,0,0,0.0,0.0
1002,2103,26-09-2019 09:44:00,1,2683.0,1811.0,0.675,12.576,8,7,0,7,1,0,1,0,0.0,0.0
1002,2104,26-09-2019 09:46:00,1,2666.0,1845.0,0.692,12.548,33,3,0,3,30,0,30,0,0.0,0.0
1002,2105,26-09-2019 09:48:00,1,2686.0,1792.0,0.667,12.566,21,4,0,4,17,0,17,0,0.0,0.0
1002,2106,26-09-2019 09:50:00,1,2688.0,1784.0,0.664,12.566,32,9,1,8,23,2,21,0,0.0,0.0
1002,2107,26-09-2019 09:52:00,1,2762.0,1939.0,0.702,13.032,53,6,3,3,47,10,37,0,0.0,0.0
1002,2108,26-09-2019 09:54:00,1,2872.0,1983.0,0.69,13.513,146,56,32,24,90,51,39,45,0.0,0.0
1002,2109,26-09-2019 09:56:00,1,3114.0,2236.5,0.716,14.746,79,36,15,21,43,26,17,48,0.0,0.0
1002,2110,26-09-2019 09:58:00,1,3356.0,2490.0,0.742,15.979,231,117,88,29,114,84,30,48,0.0,0.0
1002,2111,26-09-2019 10:00:00,1,3068.0,2180.0,0.71,14.501,224,112,77,35,112,72,40,30,0.0,0.0
1002,2112,26-09-2019 10:02:00,1,3152.0,2318.0,0.735,14.984,98,49,18,31,49,19,30,3,0.0,0.0
1002,2113,26-09-2019 10:04:00,1,3035.0,2317.0,0.763,14.521,197,93,52,41,104,62,42,0,0.06,0.0
1002,2114,26-09-2019 10:06:00,1,3360.0,2400.0,0.714,15.897,436,240,183,57,196,149,47,2,0.0,0.0
1002,2115,26-09-2019 10:08:00,1,3348.0,2444.0,0.73,15.896,112,58,40,18,54,22,32,1,0.0,0.0
1002,2116,26-09-2019 10:10:00,1,3026.0,2322.0,0.767,14.492,431,221,164,57,210,151,59,7,0.0,0.0
1002,2117,26-09-2019 10:12:00,1,3351.0,2548.0,0.76,16.024,520,269,206,63,251,183,68,11,0.0,0.0
1002,2118,26-09-2019 10:14:00,1,3233.0,2462.0,0.762,15.463,786,535,452,83,251,195,56,31,0.0,0.0
1002,2119,26-09-2019 10:16:00,1,3312.0,2544.0,0.768,15.868,489,319,258,61,170,131,39,103,0.0,0.0
1002,2120,26-09-2019 10:18:00,1,3015.0,2409.0,0.799,14.548,281,165,108,57,116,64,52,7,0.0,0.0
1002,2121,26-09-2019 10:20:00,1,3228.0,2474.0,0.766,15.458,348,185,145,40,163,114,49,0,0.0,0.0
1002,2122,26-09-2019 10:22:00,1,3323.0,2572.0,0.774,15.94,329,223,163,60,106,70,36,2,0.0,0.0
1002,2123,26-09-2019 10:24:00,1,2986.0,2423.0,0.811,14.448,549,293,214,79,256,195,61,10,0.0,0.0
1002,2124,26-09-2019 10:26:00,1,3230.0,2473.0,0.765,15.466,505,322,260,62,183,136,47,12,0.0,0.0
1002,2125,26-09-2019 10:28:00,1,3002.0,2411.0,0.803,14.497,304,177,122,55,127,84,43,9,0.0,0.0
1002,2126,26-09-2019 10:30:00,1,3015.5,2364.5,0.784,14.4995,628,395,321,74,233,171,62,4,0.0,0.0
1002,2127,26-09-2019 10:32:00,1,3029.0,2318.0,0.765,14.502,464,269,204,65,195,149,46,19,0.0,0.0
1002,2128,26-09-2019 10:34:00,1,3008.0,2351.0,0.782,14.457,15,4,2,2,11,5,6,0,0.0,0.0
1002,2129,26-09-2019 10:36:00,1,3053.0,2279.0,0.746,14.552,40,22,8,14,18,0,18,11,0.0,0.0
1002,2130,26-09-2019 10:38:00,1,3352.0,2493.0,0.744,15.966,49,25,12,13,24,4,20,7,0.0,0.0
1002,2131,26-09-2019 10:40:00,1,3026.0,2302.0,0.761,14.47,46,24,5,19,22,0,22,0,0.0,0.0
1002,2132,26-09-2019 10:42:00,1,2927.0,2216.0,0.757,13.987,89,50,21,29,39,2,37,13,0.0,0.0
1002,2133,26-09-2019 10:44:00,1,2841.0,2150.0,0.757,13.573,60,26,16,10,34,5,29,2,0.0,0.0
1002,2134,26-09-2019 10:46:00,1,2940.0,2192.0,0.746,14.009,27,11,1,10,16,0,16,0,0.0,0.0
1002,2135,26-09-2019 10:48:00,1,3053.0,2206.0,0.722,14.473,34,28,2,26,6,0,6,0,0.0,0.0
1002,2136,26-09-2019 10:50:00,1,2829.0,2176.0,0.769,13.557,1,0,0,0,1,0,1,0,0.0,0.0
1002,2137,26-09-2019 10:52:00,1,2847.0,2058.0,0.723,13.497,3,1,0,1,2,2,0,0,0.0,0.0
1002,2138,26-09-2019 10:54:00,1,2641.0,1964.0,0.744,12.579,0,0,0,0,0,0,0,0,0.0,0.0
1002,2139,26-09-2019 10:56:00,1,2656.0,1888.0,0.711,12.553,0,0,0,0,0,0,0,0,0.0,0.0
1002,2140,26-09-2019 10:58:00,1,2433.0,1804.0,0.742,11.582,7,5,2,3,2,0,2,0,0.0,0.0
1002,2141,26-09-2019 11:00:00,1,2314.0,1796.0,0.776,11.107,0,0,0,0,0,0,0,0,0.0,0.0
1002,2142,26-09-2019 11:02:00,1,2323.0,1760.0,0.758,11.1,4,1,1,0,3,0,3,0,0.0,0.0
1002,2143,26-09-2019 11:04:00,1,2324.0,1745.0,0.751,11.089,1,0,0,0,1,0,1,0,0.0,0.0
1002,2144,26-09-2019 11:06:00,1,2325.0,1730.0,0.744,11.078,4,2,1,1,2,0,2,0,0.0,0.0
1002,2145,26-09-2019 11:08:00,1,2325.0,1774.0,0.763,11.124,15,14,0,14,1,0,1,0,0.0,0.0
1002,2146,26-09-2019 11:10:00,1,2550.0,1848.0,0.725,12.094,11,11,1,10,0,0,0,0,0.0,0.0
1002,2147,26-09-2019 11:12:00,1,2435.0,1790.0,0.735,11.575,4,3,2,1,1,0,1,0,0.0,0.0
1002,2148,26-09-2019 11:14:00,1,2443.0,1788.0,0.732,11.605,11,11,1,10,0,0,0,0,0.0,0.0
1002,2149,26-09-2019 11:16:00,1,2337.0,1711.0,0.732,11.104,22,22,0,22,0,0,0,0,0.0,0.0
1002,2150,26-09-2019 11:18:00,1,2360.0,1648.0,0.698,11.123,0,0,0,0,0,0,0,0,0.0,0.0
1002,2151,26-09-2019 11:20:00,1,2259.0,1549.0,0.686,10.616,9,7,1,6,2,0,2,0,0.0,0.0
1002,2152,26-09-2019 11:22:00,1,2266.0,1528.0,0.674,10.621,9,4,1,3,5,0,5,0,0.0,0.0
1002,2153,26-09-2019 11:24:00,1,2373.0,1575.0,0.663,11.094,28,19,11,8,9,2,7,0,0.0,0.0
1002,2154,26-09-2019 11:26:00,1,2362.0,1660.0,0.703,11.144,0,0,0,0,0,0,0,0,0.0,0.0
1002,2155,26-09-2019 11:28:00,1,2361.0,1629.0,0.69,11.107,0,0,0,0,0,0,0,0,0.0,0.0
1002,2156,26-09-2019 11:30:00,1,2357.0,1675.0,0.711,11.141,1,0,0,0,1,0,1,0,0.0,0.0
1002,2157,26-09-2019 11:32:00,1,2341.0,1698.0,0.725,11.103,1,0,0,0,1,0,1,0,0.0,0.0
1002,2158,26-09-2019 11:34:00,1,2355.0,1680.0,0.713,11.138,0,0,0,0,0,0,0,0,0.0,0.0
1002,2159,26-09-2019 11:36:00,1,2351.0,1638.0,0.697,11.078,62,38,28,10,24,13,11,0,0.0,0.0
1002,2160,26-09-2019 11:38:00,1,2347.0,1656.0,0.706,11.083,2,0,0,0,2,0,2,0,0.0,0.0
1002,2161,26-09-2019 11:40:00,1,2343.0,1674.0,0.715,11.088,1,0,0,0,1,0,1,0,0.0,0.0
1002,2162,26-09-2019 11:42:00,1,2451.0,1742.0,0.711,11.585,0,0,0,0,0,0,0,0,0.0,0.0
1002,2163,26-09-2019 11:44:00,1,2364.0,1648.0,0.697,11.14,2,0,0,0,2,0,2,0,0.0,0.0
1002,2164,26-09-2019 11:46:00,1,2366.0,1630.0,0.689,11.129,0,0,0,0,0,0,0,0,0.0,0.0
1002,2165,26-09-2019 11:48:00,1,2148.0,1553.0,0.723,10.184,34,17,6,11,17,2,15,1,0.0,0.0
1002,2166,26-09-2019 11:50:00,1,2459.0,1731.0,0.704,11.605,20,3,0,3,17,0,17,0,0.0,0.0
1002,2167,26-09-2019 11:52:00,1,2347.0,1672.0,0.712,11.097,29,0,0,0,29,0,29,0,0.0,0.0
1002,2168,26-09-2019 11:54:00,1,2360.0,1638.0,0.694,11.113,8,0,0,0,8,0,8,0,0.0,0.0
1002,2169,26-09-2019 11:56:00,1,2364.0,1623.0,0.687,11.112,4,1,0,1,3,0,3,0,0.0,0.0
1002,2170,26-09-2019 11:58:00,1,2368.0,1623.0,0.686,11.127,28,14,5,9,14,7,7,0,0.0,0.0
1002,2171,26-09-2019 12:00:00,1,2162.0,1460.0,0.675,10.137,15,7,0,7,8,0,8,0,0.0,0.0
1002,2172,26-09-2019 12:02:00,1,2162.0,1443.0,0.667,10.115,0,0,0,0,0,0,0,0,0.0,0.0
1002,2173,26-09-2019 12:04:00,1,2165.0,1454.0,0.672,10.139,0,0,0,0,0,0,0,0,0.0,0.0
1002,2174,26-09-2019 12:06:00,1,2173.0,1458.0,0.671,10.175,9,7,3,4,2,0,2,1,0.0,0.0
1002,2175,26-09-2019 12:08:00,1,2164.0,1468.0,0.678,10.152,31,7,4,3,24,19,5,0,0.0,0.0
1002,2176,26-09-2019 12:10:00,1,2146.0,1517.0,0.707,10.133,0,0,0,0,0,0,0,0,0.0,0.0
1002,2177,26-09-2019 12:12:00,1,2262.5,1559.5,0.69,10.64,0,0,0,0,0,0,0,0,0.0,0.0
1002,2178,26-09-2019 12:14:00,1,2379.0,1602.0,0.673,11.147,0,0,0,0,0,0,0,0,0.0,0.0
1002,2179,26-09-2019 12:16:00,1,2370.0,1614.0,0.681,11.126,0,0,0,0,0,0,0,0,0.0,0.0
1002,2180,26-09-2019 12:18:00,1,2377.0,1571.0,0.661,11.105,1,0,0,0,1,0,1,0,0.0,0.0
1002,2181,26-09-2019 12:20:00,1,2258.0,1562.0,0.692,10.625,176,59,32,27,117,79,38,1,0.0,0.0
1002,2182,26-09-2019 12:22:00,1,2368.0,1643.0,0.694,11.149,280,29,8,21,251,205,46,0,0.0,0.0
1002,2183,26-09-2019 12:24:00,1,2342.0,1723.0,0.736,11.134,104,34,16,18,70,36,34,1,0.0,0.0
1002,2184,26-09-2019 12:26:00,1,2559.0,1808.0,0.706,12.084,104,33,10,23,71,33,38,7,0.0,0.0
1002,2185,26-09-2019 12:28:00,1,2673.0,1824.0,0.682,12.551,76,22,10,12,54,21,33,10,0.0,0.0
1002,2186,26-09-2019 12:30:00,1,2639.0,1920.0,0.727,12.525,132,60,30,30,72,34,38,57,0.0,0.0
1002,2187,26-09-2019 12:32:00,1,2973.0,2107.0,0.709,14.047,72,49,18,31,23,6,17,58,0.0,0.0
1002,2188,26-09-2019 12:34:00,1,3163.0,2286.0,0.723,14.993,170,127,86,41,43,26,17,69,0.0,0.0
1002,2189,26-09-2019 12:36:00,1,3374.0,2348.0,0.696,15.892,198,119,94,25,79,58,21,78,0.0,0.0
1002,2190,26-09-2019 12:38:00,1,3059.0,2248.0,0.735,14.541,613,375,311,64,238,186,52,36,0.01,0.1
1002,2191,26-09-2019 12:40:00,1,3381.0,2370.0,0.701,15.946,359,198,154,44,161,119,42,20,0.0,0.0
1002,2192,26-09-2019 12:42:00,1,3071.0,2140.0,0.697,14.47,505,232,172,60,273,208,65,1,0.02,0.0
1002,2193,26-09-2019 12:44:00,1,3147.0,2330.0,0.74,14.98,695,398,317,81,297,226,71,9,0.0,0.0
1002,2194,26-09-2019 12:46:00,1,2992.0,2230.5,0.7455,14.2585,708,391,313,78,317,239,78,16,0.0,0.0
1002,2195,26-09-2019 12:48:00,1,2837.0,2131.0,0.751,13.537,517,307,233,74,210,155,55,5,0.0,0.0
1002,2196,26-09-2019 12:50:00,1,2941.0,2173.0,0.739,13.994,395,223,158,65,172,117,55,3,0.0,0.0
1002,2197,26-09-2019 12:52:00,1,3132.0,2396.0,0.765,14.994,586,343,279,64,243,178,65,10,0.01,0.0
1002,2198,26-09-2019 12:54:00,1,3233.0,2448.0,0.757,15.45,92,37,16,21,55,23,32,9,0.0,0.0
1002,2199,26-09-2019 12:56:00,1,3011.0,2371.0,0.787,14.489,39,11,1,10,28,2,26,0,0.0,0.0
1002,2200,26-09-2019 12:58:00,1,3024.0,2294.0,0.759,14.456,24,9,5,4,15,2,13,4,0.0,0.0
1002,2201,26-09-2019 13:00:00,1,3011.0,2368.0,0.786,14.484,44,12,3,9,32,14,18,0,0.0,0.0
1002,2202,26-09-2019 13:02:00,1,3031.0,2316.0,0.764,14.508,2,0,0,0,2,1,1,0,0.0,0.0
1002,2203,26-09-2019 13:04:00,1,2934.0,2245.0,0.765,14.045,0,0,0,0,0,0,0,0,0.0,0.0
1002,2204,26-09-2019 13:06:00,1,2606.0,2037.0,0.782,12.522,0,0,0,0,0,0,0,0,0.0,0.0
1002,2205,26-09-2019 13:08:00,1,2648.0,1934.0,0.73,12.575,0,0,0,0,0,0,0,0,0.0,0.0
1002,2206,26-09-2019 13:10:00,1,2295.0,1850.0,0.806,11.093,0,0,0,0,0,0,0,0,0.0,0.0
1002,2207,26-09-2019 13:12:00,1,2329.0,1777.0,0.763,11.144,0,0,0,0,0,0,0,0,0.0,0.0
1002,2208,26-09-2019 13:14:00,1,2339.0,1758.0,0.752,11.162,0,0,0,0,0,0,0,0,0.0,0.0
1002,2209,26-09-2019 13:16:00,1,2315.0,1736.0,0.75,11.042,0,0,0,0,0,0,0,0,0.0,0.0
1002,2210,26-09-2019 13:18:00,1,2325.0,1756.0,0.755,11.106,0,0,0,0,0,0,0,0,0.0,0.0
1002,2211,26-09-2019 13:20:00,1,2382.5,1797.5,0.7545,11.378,3,3,2,1,0,0,0,0,0.0,0.0
1002,2212,26-09-2019 13:22:00,1,2440.0,1839.0,0.754,11.65,0,0,0,0,0,0,0,0,0.0,0.0
1002,2213,26-09-2019 13:24:00,1,2311.0,1787.0,0.773,11.085,0,0,0,0,0,0,0,0,0.0,0.0
1002,2214,26-09-2019 13:26:00,1,2329.0,1750.0,0.751,11.113,1,1,0,1,0,0,0,0,0.0,0.0
1002,2215,26-09-2019 13:28:00,1,2342.0,1710.0,0.73,11.122,3,1,0,1,2,1,1,0,0.0,0.0
1002,2216,26-09-2019 13:30:00,1,2337.0,1746.0,0.747,11.142,0,0,0,0,0,0,0,0,0.0,0.0
1002,2217,26-09-2019 13:32:00,1,2346.0,1719.0,0.733,11.149,0,0,0,0,0,0,0,0,0.0,0.0
1002,2218,26-09-2019 13:34:00,1,2347.0,1677.0,0.715,11.104,0,0,0,0,0,0,0,0,0.0,0.0
1002,2219,26-09-2019 13:36:00,1,2240.0,1623.0,0.724,10.622,0,0,0,0,0,0,0,0,0.0,0.0
1002,2220,26-09-2019 13:38:00,1,2244.0,1613.0,0.718,10.629,3,0,0,0,3,2,1,0,0.0,0.0
1002,2221,26-09-2019 13:40:00,1,2244.0,1616.0,0.72,10.629,0,0,0,0,0,0,0,0,0.0,0.0
1002,2222,26-09-2019 13:42:00,1,2259.0,1600.0,0.709,10.672,0,0,0,0,0,0,0,0,0.0,0.0
1002,2223,26-09-2019 13:44:00,1,2133.0,1573.0,0.737,10.147,15,3,3,0,12,2,10,0,0.0,0.0
1002,2224,26-09-2019 13:46:00,1,2351.0,1710.0,0.727,11.155,2,0,0,0,2,0,2,0,0.0,0.0
1002,2225,26-09-2019 13:48:00,1,2350.0,1658.0,0.706,11.093,13,0,0,0,13,2,11,0,0.0,0.0
1002,2226,26-09-2019 13:50:00,1,2343.0,1683.0,0.718,11.094,5,0,0,0,5,0,5,0,0.0,0.0
1002,2227,26-09-2019 13:52:00,1,2347.0,1659.0,0.707,11.086,2,0,0,0,2,1,1,0,0.0,0.0
1002,2228,26-09-2019 13:54:00,1,2344.0,1668.0,0.7115,11.083,8,0,0,0,8,1,7,0,0.0,0.0
1002,2229,26-09-2019 13:56:00,1,2341.0,1677.0,0.716,11.08,7,0,0,0,7,0,7,0,0.0,0.0
1002,2230,26-09-2019 13:58:00,1,2347.0,1690.0,0.72,11.118,8,2,1,1,6,0,6,0,0.0,0.0
1002,2231,26-09-2019 14:00:00,1,2241.0,1609.0,0.718,10.612,1,1,0,1,0,0,0,0,0.0,0.0
1002,2232,26-09-2019 14:02:00,1,2153.0,1509.0,0.701,10.154,2,1,0,1,1,0,1,0,0.0,0.0
1002,2233,26-09-2019 14:04:00,1,2163.0,1476.0,0.683,10.158,2,1,0,1,1,0,1,0,0.0,0.0
1002,2234,26-09-2019 14:06:00,1,2167.0,1467.0,0.677,10.162,6,2,0,2,4,0,4,0,0.0,0.0
1002,2235,26-09-2019 14:08:00,1,2056.0,1400.0,0.681,9.652,2,0,0,0,2,0,2,0,0.0,0.0
1002,2236,26-09-2019 14:10:00,1,1943.0,1360.0,0.7,9.163,3,1,0,1,2,1,1,0,0.0,0.0
1002,2237,26-09-2019 14:12:00,1,1949.0,1340.0,0.688,9.161,58,13,7,6,45,16,29,0,0.0,0.0
1002,2238,26-09-2019 14:14:00,1,2139.0,1558.0,0.728,10.155,19,0,0,0,19,0,19,0,0.0,0.0
1002,2239,26-09-2019 14:16:00,1,2124.0,1584.0,0.746,10.123,23,2,1,1,21,0,21,0,0.0,0.0
1002,2240,26-09-2019 14:18:00,1,2354.0,1661.0,0.706,11.114,8,5,2,3,3,0,3,0,0.0,0.0
1002,2241,26-09-2019 14:20:00,1,2340.0,1717.0,0.734,11.121,5,1,0,1,4,4,0,0,0.0,0.0
1002,2242,26-09-2019 14:22:00,1,2348.0,1707.0,0.727,11.142,24,0,0,0,24,0,24,0,0.0,0.0
1002,2243,26-09-2019 14:24:00,1,2352.0,1716.0,0.73,11.167,53,27,1,26,26,0,26,0,0.0,0.0
1002,2244,26-09-2019 14:26:00,1,2240.0,1600.0,0.714,10.599,78,40,23,17,38,10,28,0,0.0,0.0
1002,2245,26-09-2019 14:28:00,1,2286.0,1679.0,0.734,10.8665,102,60,11,49,42,9,33,1,0.0,0.0
1002,2246,26-09-2019 14:30:00,1,2332.0,1758.0,0.754,11.134,105,20,8,12,85,51,34,6,0.0,0.0
1002,2247,26-09-2019 14:32:00,1,2312.0,1796.0,0.777,11.097,48,25,7,18,23,10,13,0,0.0,0.0
1002,2248,26-09-2019 14:34:00,1,2638.0,1940.0,0.735,12.544,166,74,43,31,92,57,35,39,0.0,0.0
1002,2249,26-09-2019 14:36:00,1,2641.0,1963.0,0.743,12.581,93,31,16,15,62,11,51,39,0.0,0.0
1002,2250,26-09-2019 14:38:00,1,2848.0,2093.0,0.735,13.538,102,43,25,18,59,16,43,48,0.0,0.0
1002,2251,26-09-2019 14:40:00,1,2946.0,2190.0,0.743,14.033,117,80,46,34,37,23,14,57,0.0,0.0
1002,2252,26-09-2019 14:42:00,1,2838.0,2135.0,0.752,13.547,370,225,179,46,145,108,37,74,0.0,0.0
1002,2253,26-09-2019 14:44:00,1,2641.0,1980.0,0.75,12.599,453,208,148,60,245,186,59,14,0.01,0.0
1002,2254,26-09-2019 14:46:00,1,3010.0,2369.0,0.787,14.484,645,369,292,77,276,211,65,21,0.0,0.0
1002,2255,26-09-2019 14:48:00,1,2820.0,2189.0,0.776,13.536,532,332,267,65,200,142,58,23,0.0,0.02
1002,2256,26-09-2019 14:50:00,1,2928.0,2269.0,0.775,14.049,244,146,104,42,98,58,40,1,0.0,0.0
1002,2257,26-09-2019 14:52:00,1,3010.0,2367.0,0.786,14.481,251,143,96,47,108,73,35,0,0.0,0.0
1002,2258,26-09-2019 14:54:00,1,3012.0,2363.0,0.785,14.485,34,31,11,20,3,3,0,5,0.0,0.0
1002,2259,26-09-2019 14:56:00,1,3014.0,2393.0,0.794,14.523,79,64,27,37,15,2,13,6,0.02,0.0
1002,2260,26-09-2019 14:58:00,1,3034.0,2309.0,0.761,14.512,58,57,25,32,1,0,1,2,0.0,0.0
1002,2261,26-09-2019 15:00:00,1,2997.0,2467.0,0.823,14.541,53,22,8,14,31,16,15,1,0.0,0.0
1002,2262,26-09-2019 15:02:00,1,2989.5,2477.0,0.8285,14.5225,65,23,11,12,42,13,29,1,0.0,0.0
1002,2263,26-09-2019 15:04:00,1,2982.0,2487.0,0.834,14.504,1,1,1,0,0,0,0,0,0.0,0.0
1002,2264,26-09-2019 15:06:00,1,3023.0,2322.0,0.768,14.48,0,0,0,0,0,0,0,0,0.0,0.0
1002,2265,26-09-2019 15:08:00,1,2591.0,2115.0,0.816,12.55,0,0,0,0,0,0,0,0,0.0,0.0
1002,2266,26-09-2019 15:10:00,1,2639.0,1979.0,0.75,12.588,4,2,1,1,2,1,1,0,0.0,0.0
1002,2267,26-09-2019 15:12:00,1,2399.0,1949.0,0.812,11.61,0,0,0,0,0,0,0,0,0.0,0.0
1002,2268,26-09-2019 15:14:00,1,2300.0,1865.0,0.811,11.127,0,0,0,0,0,0,0,0,0.0,0.0
1002,2269,26-09-2019 15:16:00,1,2318.0,1803.0,0.778,11.128,0,0,0,0,0,0,0,0,0.0,0.0
1002,2270,26-09-2019 15:18:00,1,2306.0,1828.0,0.793,11.11,1,1,0,1,0,0,0,0,0.0,0.0
1002,2271,26-09-2019 15:20:00,1,2314.0,1799.0,0.777,11.11,0,0,0,0,0,0,0,0,0.0,0.0
1002,2272,26-09-2019 15:22:00,1,2297.0,1910.0,0.831,11.165,0,0,0,0,0,0,0,0,0.0,0.0
1002,2273,26-09-2019 15:24:00,1,2286.0,1918.0,0.839,11.132,0,0,0,0,0,0,0,0,0.0,0.0
1002,2274,26-09-2019 15:26:00,1,2387.0,1988.0,0.833,11.607,6,3,1,2,3,1,2,0,0.0,0.0
1002,2275,26-09-2019 15:28:00,1,2391.0,1958.0,0.819,11.59,0,0,0,0,0,0,0,0,0.0,0.0
1002,2276,26-09-2019 15:30:00,1,2289.0,1910.0,0.834,11.132,7,6,3,3,1,0,1,0,0.0,0.0
1002,2277,26-09-2019 15:32:00,1,2604.0,2126.0,0.816,12.614,0,0,0,0,0,0,0,0,0.0,0.0
1002,2278,26-09-2019 15:34:00,1,2818.0,2213.0,0.785,13.555,3,3,0,3,0,0,0,0,0.0,0.0
1002,2279,26-09-2019 15:36:00,1,2756.5,2189.0,0.794,13.285,0,0,0,0,0,0,0,0,0.0,0.0
1002,2280,26-09-2019 15:38:00,1,2695.0,2165.0,0.803,13.015,0,0,0,0,0,0,0,0,0.0,0.0
1002,2281,26-09-2019 15:40:00,1,2824.0,2185.0,0.774,13.547,0,0,0,0,0,0,0,0,0.0,0.0
1002,2282,26-09-2019 15:42:00,1,2702.0,2137.0,0.791,13.012,0,0,0,0,0,0,0,0,0.0,0.0
1002,2283,26-09-2019 15:44:00,1,2605.0,2115.0,0.812,12.607,0,0,0,0,0,0,0,0,0.0,0.0
1002,2284,26-09-2019 15:46:00,1,2613.0,2075.0,0.794,12.593,0,0,0,0,0,0,0,0,0.0,0.0
1002,2285,26-09-2019 15:48:00,1,2611.0,2081.0,0.797,12.593,0,0,0,0,0,0,0,0,0.0,0.0
1002,2286,26-09-2019 15:50:00,1,2625.0,2042.0,0.778,12.603,0,0,0,0,0,0,0,0,0.0,0.0
1002,2287,26-09-2019 15:52:00,1,2635.0,1963.0,0.745,12.556,0,0,0,0,0,0,0,0,0.0,0.0
1002,2288,26-09-2019 15:54:00,1,2636.0,1925.0,0.73,12.517,24,17,9,8,7,4,3,0,0.0,0.0
1002,2289,26-09-2019 15:56:00,1,2645.0,1940.0,0.733,12.569,0,0,0,0,0,0,0,0,0.0,0.0
1002,2290,26-09-2019 15:58:00,1,2532.0,1911.0,0.755,12.092,1,1,0,1,0,0,0,0,0.0,0.0
1002,2291,26-09-2019 16:00:00,1,2641.0,1943.0,0.736,12.558,3,3,1,2,0,0,0,0,0.0,0.0
1002,2292,26-09-2019 16:02:00,1,2540.0,1931.0,0.76,12.147,0,0,0,0,0,0,0,0,0.0,0.0
1002,2293,26-09-2019 16:04:00,1,2537.0,1896.0,0.747,12.095,3,3,0,3,0,0,0,0,0.0,0.0
1002,2294,26-09-2019 16:06:00,1,2640.0,1934.0,0.733,12.542,0,0,0,0,0,0,0,0,0.0,0.0
1002,2295,26-09-2019 16:08:00,1,2303.0,1878.0,0.815,11.153,27,12,6,6,15,8,7,0,0.0,0.0
1002,2296,26-09-2019 16:10:00,1,2318.5,1810.5,0.781,11.1385,21,8,2,6,13,0,13,0,0.0,0.0
1002,2297,26-09-2019 16:12:00,1,2334.0,1743.0,0.747,11.124,2,0,0,0,2,0,2,0,0.0,0.0
1002,2298,26-09-2019 16:14:00,1,2231.0,1687.0,0.756,10.658,18,14,9,5,4,0,4,0,0.0,0.0
1002,2299,26-09-2019 16:16:00,1,2318.0,1832.0,0.79,11.163,19,16,11,5,3,0,3,0,0.0,0.0
1002,2300,26-09-2019 16:18:00,1,2317.0,1818.0,0.785,11.141,86,68,33,35,18,8,10,2,0.0,0.0
1002,2301,26-09-2019 16:20:00,1,2608.0,2095.0,0.803,12.596,136,46,20,26,90,63,27,3,0.0,0.0
1002,2302,26-09-2019 16:22:00,1,2506.0,1987.0,0.793,12.072,70,52,22,30,18,6,12,2,0.0,0.0
1002,2303,26-09-2019 16:24:00,1,2396.0,1942.0,0.811,11.59,93,49,18,31,44,15,29,6,0.0,0.0
1002,2304,26-09-2019 16:26:00,1,2645.0,1962.0,0.742,12.594,97,13,0,13,84,63,21,5,0.0,0.0
1002,2305,26-09-2019 16:28:00,1,2637.0,1959.0,0.743,12.558,95,42,11,31,53,14,39,5,0.0,0.0
1002,2306,26-09-2019 16:30:00,1,2616.0,2011.0,0.769,12.533,75,33,17,16,42,14,28,1,0.0,0.0
1002,2307,26-09-2019 16:32:00,1,2834.0,2153.0,0.76,13.552,85,70,44,26,15,3,12,0,0.0,0.0
1002,2308,26-09-2019 16:34:00,1,2817.0,2187.0,0.776,13.521,22,1,0,1,21,0,21,0,0.0,0.0
1002,2309,26-09-2019 16:36:00,1,2630.0,2036.0,0.774,12.616,6,6,1,5,0,0,0,0,0.0,0.0
1002,2310,26-09-2019 16:38:00,1,2318.0,1832.0,0.79,11.161,0,0,0,0,0,0,0,0,0.0,0.0
1002,2311,26-09-2019 16:40:00,1,2343.0,1694.0,0.723,11.108,13,13,1,12,0,0,0,0,0.0,0.0
1002,2312,26-09-2019 16:42:00,1,2111.0,1637.0,0.775,10.131,0,0,0,0,0,0,0,0,0.0,0.0
1002,2313,26-09-2019 16:44:00,1,2179.5,1638.5,0.7525,10.4015,1,0,0,0,1,1,0,0,0.0,0.0
1002,2314,26-09-2019 16:46:00,1,2248.0,1640.0,0.73,10.672,26,0,0,0,26,0,26,0,0.0,0.0
1002,2315,26-09-2019 16:48:00,1,2119.0,1602.0,0.756,10.122,8,1,0,1,7,0,7,0,0.0,0.0
1002,2316,26-09-2019 16:50:00,1,2314.0,1790.0,0.774,11.1,1,0,0,0,1,1,0,0,0.0,0.0
1002,2317,26-09-2019 16:52:00,1,2531.0,1875.0,0.741,12.05,0,0,0,0,0,0,0,0,0.0,0.0
1002,2318,26-09-2019 16:54:00,1,2545.0,1852.0,0.728,12.078,0,0,0,0,0,0,0,0,0.0,0.0
1002,2319,26-09-2019 16:56:00,1,2550.0,1858.0,0.729,12.106,9,4,1,3,5,1,4,0,0.0,0.0
1002,2320,26-09-2019 16:58:00,1,2442.0,1810.0,0.741,11.624,26,4,1,3,22,0,22,0,0.0,0.0
1002,2321,26-09-2019 17:00:00,1,2316.0,1784.0,0.77,11.099,36,16,10,6,20,0,20,0,0.0,0.0
1002,2322,26-09-2019 17:02:00,1,2558.0,1837.0,0.718,12.112,15,11,6,5,4,0,4,0,0.0,0.0
1002,2323,26-09-2019 17:04:00,1,2442.0,1815.0,0.743,11.631,113,49,25,24,64,39,25,3,0.0,0.0
1002,2324,26-09-2019 17:06:00,1,2622.0,1988.0,0.758,12.532,272,157,110,47,115,71,44,52,0.0,0.0
1002,2325,26-09-2019 17:08:00,1,2626.0,1981.0,0.754,12.54,204,116,81,35,88,59,29,70,0.0,0.0
1002,2326,26-09-2019 17:10:00,1,3060.0,2190.0,0.716,14.48,75,50,25,25,25,11,14,31,0.0,0.0
1002,2327,26-09-2019 17:12:00,1,3061.0,2234.0,0.73,14.532,194,118,90,28,76,46,30,20,0.0,0.03
1002,2328,26-09-2019 17:14:00,1,3049.0,2220.0,0.728,14.472,25,13,5,8,12,2,10,0,0.0,0.0
1002,2329,26-09-2019 17:16:00,1,3051.0,2236.0,0.733,14.497,156,88,49,39,68,34,34,0,0.0,0.0
1002,2330,26-09-2019 17:18:00,1,2933.5,2194.5,0.7485,13.9885,56,26,4,22,30,5,25,0,0.0,0.0
1002,2331,26-09-2019 17:20:00,1,2816.0,2153.0,0.764,13.48,53,37,3,34,16,2,14,0,0.0,0.0
1002,2332,26-09-2019 17:22:00,1,3038.0,2306.0,0.759,14.523,164,132,80,52,32,7,25,0,0.0,0.0
1002,2333,26-09-2019 17:24:00,1,3018.0,2374.0,0.786,14.52,74,32,9,23,42,23,19,0,0.0,0.0
1002,2334,26-09-2019 17:26:00,1,3119.0,2460.0,0.789,15.012,120,50,28,22,70,39,31,0,0.0,0.0
1002,2335,26-09-2019 17:28:00,1,3012.0,2369.0,0.786,14.492,24,22,5,17,2,1,1,0,0.0,0.0
1002,2336,26-09-2019 17:30:00,1,2809.0,2231.0,0.794,13.538,0,0,0,0,0,0,0,0,0.0,0.0
1002,2337,26-09-2019 17:32:00,1,2726.0,2106.0,0.773,13.072,7,7,2,5,0,0,0,0,0.0,0.0
1002,2338,26-09-2019 17:34:00,1,2619.0,2046.0,0.781,12.583,1,1,0,1,0,0,0,0,0.0,0.0
1002,2339,26-09-2019 17:36:00,1,2622.0,2006.0,0.765,12.554,3,1,0,1,2,1,1,0,0.01,0.0
1002,2340,26-09-2019 17:38:00,1,2620.0,2029.0,0.775,12.569,12,2,0,2,10,5,5,0,0.0,0.0
1002,2341,26-09-2019 17:40:00,1,2620.0,2036.0,0.777,12.576,154,85,59,26,69,46,23,15,0.0,0.0
1002,2342,26-09-2019 17:42:00,1,3031.0,2339.0,0.772,14.532,142,95,61,34,47,14,33,32,0.0,0.0
1002,2343,26-09-2019 17:44:00,1,3350.0,2475.0,0.739,15.938,127,33,16,17,94,41,53,26,0.0,0.0
1002,2344,26-09-2019 17:46:00,1,3302.0,2707.0,0.82,16.008,102,26,10,16,76,29,47,35,0.0,0.0
1002,2345,26-09-2019 17:48:00,1,3279.0,2724.0,0.831,15.935,242,161,109,52,81,53,28,50,0.0,0.09
1002,2346,26-09-2019 17:50:00,1,3008.0,2395.0,0.796,14.506,231,140,94,46,91,60,31,9,0.04,0.01
1002,2347,26-09-2019 17:52:00,1,3148.5,2559.0,0.812,15.239,34,11,3,8,23,7,16,2,0.0,0.01
1002,2348,26-09-2019 17:54:00,1,3289.0,2723.0,0.828,15.972,67,43,13,30,24,0,24,0,0.0,0.0
1002,2349,26-09-2019 17:56:00,1,3399.0,2803.0,0.825,16.496,19,4,0,4,15,1,14,0,0.0,0.0
1002,2350,26-09-2019 17:58:00,1,3281.0,2711.0,0.826,15.928,32,5,2,3,27,3,24,0,0.01,0.0
1002,2351,26-09-2019 18:00:00,0,3298.0,2709.0,0.821,15.992,42,16,9,7,26,19,7,1,0.0,0.0
1002,2352,26-09-2019 18:02:00,0,3300.0,2691.0,0.815,15.982,453,264,219,45,189,148,41,80,0.0,0.0
1002,2353,26-09-2019 18:04:00,0,3657.0,3178.0,0.869,17.926,232,109,84,25,123,86,37,26,0.0,0.0
1002,2354,26-09-2019 18:06:00,0,3459.0,3023.0,0.874,16.976,101,40,27,13,61,34,27,8,0.0,0.0
1002,2355,26-09-2019 18:08:00,0,3452.0,3029.0,0.878,16.953,9,5,3,2,4,0,4,0,0.0,0.0
1002,2356,26-09-2019 18:10:00,0,3486.0,2901.0,0.832,16.947,23,0,0,0,23,3,20,0,0.0,0.0
1002,2357,26-09-2019 18:12:00,0,3272.0,2801.0,0.856,15.992,33,10,5,5,23,9,14,0,0.0,0.0
1002,2358,26-09-2019 18:14:00,0,3292.0,2670.0,0.811,15.926,46,27,2,25,19,7,12,1,0.0,0.0
1002,2359,26-09-2019 18:16:00,0,3261.0,2844.0,0.872,15.998,261,110,83,27,151,98,53,4,0.0,0.0
1002,2360,26-09-2019 18:18:00,0,3254.0,2811.0,0.864,15.932,66,25,14,11,41,20,21,3,0.0,0.0
1002,2361,26-09-2019 18:20:00,0,3270.0,2831.0,0.866,16.02,445,253,197,56,192,145,47,56,0.0,0.0
1002,2362,26-09-2019 18:22:00,0,3252.0,2858.0,0.879,15.979,425,258,199,59,167,131,36,62,0.0,0.0
1002,2363,26-09-2019 18:24:00,0,3469.0,2989.0,0.862,16.977,224,105,80,25,119,83,36,38,0.0,0.0
1002,2364,26-09-2019 18:26:00,0,3478.0,2928.5,0.842,16.9465,204,132,98,34,72,52,20,49,0.01,0.0
1002,2365,26-09-2019 18:28:00,0,3487.0,2868.0,0.822,16.916,50,4,2,2,46,3,43,0,0.0,0.0
1002,2366,26-09-2019 18:30:00,0,3514.0,2821.0,0.803,16.97,41,18,6,12,23,2,21,0,0.0,0.0
1002,2367,26-09-2019 18:32:00,0,3288.0,2712.0,0.825,15.958,17,1,0,1,16,0,16,0,0.0,0.0
1002,2368,26-09-2019 18:34:00,0,3228.0,2530.0,0.784,15.522,123,71,41,30,52,26,26,1,0.0,0.0
1002,2369,26-09-2019 18:36:00,0,3216.0,2509.0,0.78,15.449,525,301,239,62,224,177,47,25,0.0,0.0
1002,2370,26-09-2019 18:38:00,0,3309.0,2676.0,0.809,15.999,122,67,38,29,55,25,30,9,0.0,0.0
1002,2371,26-09-2019 18:40:00,0,3316.0,2574.0,0.776,15.915,221,129,76,53,92,51,41,10,0.0,0.0
1002,2372,26-09-2019 18:42:00,0,3299.0,2675.0,0.811,15.958,504,269,225,44,235,186,49,95,0.0,0.0
1002,2373,26-09-2019 18:44:00,0,3303.0,2664.0,0.806,15.964,452,218,169,49,234,173,61,37,0.0,0.0
1002,2374,26-09-2019 18:46:00,0,3507.0,2776.0,0.792,16.893,304,177,133,44,127,95,32,115,0.0,0.0
1002,2375,26-09-2019 18:48:00,0,3545.0,2743.0,0.774,17.003,79,15,0,15,64,50,14,0,0.0,0.0
1002,2376,26-09-2019 18:50:00,0,3443.0,2595.0,0.754,16.437,20,7,0,7,13,5,8,0,0.0,0.0
1002,2377,26-09-2019 18:52:00,0,3351.0,2401.0,0.717,15.863,14,4,2,2,10,3,7,0,0.0,0.0
1002,2378,26-09-2019 18:54:00,0,3152.0,2365.0,0.75,15.038,19,1,1,0,18,8,10,0,0.0,0.0
1002,2379,26-09-2019 18:56:00,0,3042.0,2232.0,0.734,14.459,161,63,47,16,98,82,16,1,0.0,0.0
1002,2380,26-09-2019 18:58:00,0,3054.0,2270.0,0.743,14.548,71,21,14,7,50,18,32,1,0.0,0.0
1002,2381,26-09-2019 19:00:00,0,3054.5,2244.5,0.7345,14.521,100,58,27,31,42,11,31,1,0.0,0.0
1002,2382,26-09-2019 19:02:00,0,3055.0,2219.0,0.726,14.494,169,37,14,23,132,84,48,1,0.0,0.0
1002,2383,26-09-2019 19:04:00,0,3156.0,2331.0,0.739,15.016,244,122,78,44,122,93,29,7,0.0,0.0
1002,2384,26-09-2019 19:06:00,0,3347.0,2460.0,0.735,15.912,202,127,92,35,75,52,23,5,0.0,0.0
1002,2385,26-09-2019 19:08:00,0,3348.0,2462.0,0.735,15.917,235,106,80,26,129,91,38,17,0.0,0.0
1002,2386,26-09-2019 19:10:00,0,3385.0,2391.0,0.706,15.987,503,302,238,64,201,162,39,83,0.0,0.0
1002,2387,26-09-2019 19:12:00,0,3558.0,2618.0,0.736,16.919,499,310,247,63,189,148,41,52,0.0,0.0
1002,2388,26-09-2019 19:14:00,0,3463.0,2501.0,0.722,16.412,154,83,52,31,71,43,28,18,0.02,0.0
1002,2389,26-09-2019 19:16:00,0,3361.0,2447.0,0.728,15.953,185,140,96,44,45,30,15,8,0.0,0.0
1002,2390,26-09-2019 19:18:00,0,3488.0,2471.0,0.709,16.478,177,93,71,22,84,60,24,11,0.0,0.0
1002,2391,26-09-2019 19:20:00,0,3400.0,2308.0,0.679,15.953,136,52,35,17,84,49,35,7,0.0,0.0
1002,2392,26-09-2019 19:22:00,0,3406.0,2325.0,0.683,15.995,141,55,29,26,86,61,25,0,0.0,0.0
1002,2393,26-09-2019 19:24:00,0,3373.0,2402.0,0.712,15.949,223,125,93,32,98,66,32,66,0.0,0.0
1002,2394,26-09-2019 19:26:00,0,3360.0,2475.0,0.737,15.978,111,81,41,40,30,17,13,2,0.0,0.0
1002,2395,26-09-2019 19:28:00,0,3362.0,2390.0,0.711,15.894,112,79,44,35,33,1,32,0,0.0,0.0
1002,2396,26-09-2019 19:30:00,0,3391.0,2402.0,0.708,16.019,192,122,78,44,70,41,29,2,0.0,0.0
1002,2397,26-09-2019 19:32:00,0,3472.0,2505.0,0.722,16.454,42,7,1,6,35,10,25,0,0.0,0.0
1002,2398,26-09-2019 19:34:00,0,3267.0,2346.5,0.718,15.4715,26,0,0,0,26,0,26,0,0.0,0.0
1002,2399,26-09-2019 19:36:00,0,3062.0,2188.0,0.714,14.489,1,0,0,0,1,0,1,0,0.0,0.0
1002,2400,26-09-2019 19:38:00,0,2862.0,2029.0,0.709,13.522,29,19,8,11,10,3,7,0,0.0,0.0
1002,2401,26-09-2019 19:40:00,0,3091.0,2069.0,0.669,14.471,0,0,0,0,0,0,0,0,0.0,0.0
1002,2402,26-09-2019 19:42:00,0,2856.0,2027.0,0.71,13.497,0,0,0,0,0,0,0,0,0.0,0.0
1002,2403,26-09-2019 19:44:00,0,2652.0,1899.0,0.716,12.551,9,0,0,0,9,0,9,0,0.0,0.0
1002,2404,26-09-2019 19:46:00,0,2662.0,1934.0,0.727,12.629,2,0,0,0,2,0,2,0,0.0,0.0
1002,2405,26-09-2019 19:48:00,0,2680.0,1822.0,0.68,12.578,6,1,0,1,5,0,5,0,0.0,0.0
1002,2406,26-09-2019 19:50:00,0,2562.0,1767.0,0.69,12.051,155,56,31,25,99,73,26,5,0.0,0.0
1002,2407,26-09-2019 19:52:00,0,2668.0,1828.0,0.685,12.538,105,63,44,19,42,29,13,0,0.0,0.0
1002,2408,26-09-2019 19:54:00,0,2869.0,2009.0,0.7,13.53,246,101,78,23,145,103,42,38,0.0,0.0
1002,2409,26-09-2019 19:56:00,0,2888.0,1972.0,0.683,13.561,238,138,96,42,100,62,38,6,0.0,0.0
1002,2410,26-09-2019 19:58:00,0,2971.0,2090.0,0.704,14.02,119,94,57,37,25,19,6,7,0.0,0.0
1002,2411,26-09-2019 20:00:00,0,3178.0,2221.0,0.699,14.98,82,42,28,14,40,19,21,2,0.0,0.0
1002,2412,26-09-2019 20:02:00,0,3166.0,2223.0,0.702,14.935,55,5,2,3,50,38,12,2,0.0,0.0
1002,2413,26-09-2019 20:04:00,0,3171.0,2210.0,0.697,14.94,295,176,129,47,119,93,26,70,0.0,0.0
1002,2414,26-09-2019 20:06:00,0,3183.0,2229.0,0.7,15.01,424,224,183,41,200,156,44,75,0.0,0.0
1002,2415,26-09-2019 20:08:00,0,3380.5,2391.5,0.707,15.9685,56,32,21,11,24,14,10,0,0.0,0.0
1002,2416,26-09-2019 20:10:00,0,3578.0,2554.0,0.714,16.927,381,201,163,38,180,140,40,98,0.0,0.0
1002,2417,26-09-2019 20:12:00,0,3068.0,2152.0,0.701,14.473,116,85,42,43,31,15,16,0,0.0,0.0
1002,2418,26-09-2019 20:14:00,0,3366.0,2411.0,0.716,15.932,405,243,193,50,162,124,38,58,0.0,0.0
1002,2419,26-09-2019 20:16:00,0,3385.0,2357.0,0.696,15.946,201,106,67,39,95,64,31,13,0.0,0.0
1002,2420,26-09-2019 20:18:00,0,3383.0,2369.0,0.7,15.953,146,84,42,42,62,35,27,0,0.0,0.0
1002,2421,26-09-2019 20:20:00,0,3583.0,2491.0,0.695,16.876,252,164,123,41,88,69,19,12,0.0,0.0
1002,2422,26-09-2019 20:22:00,0,3582.0,2514.0,0.702,16.9,267,190,137,53,77,54,23,40,0.0,0.0
1002,2423,26-09-2019 20:24:00,0,3355.0,2453.0,0.731,15.934,93,78,39,39,15,0,15,0,0.0,0.0
1002,2424,26-09-2019 20:26:00,0,3581.0,2532.0,0.707,16.912,265,150,108,42,115,80,35,79,0.0,0.0
1002,2425,26-09-2019 20:28:00,0,3575.0,2524.0,0.706,16.88,351,200,155,45,151,118,33,16,0.0,0.0
1002,2426,26-09-2019 20:30:00,0,3572.0,2573.0,0.72,16.921,289,149,116,33,140,99,41,58,0.1,0.0
1002,2427,26-09-2019 20:32:00,0,3548.0,2660.0,0.75,16.926,348,182,137,45,166,123,43,20,0.0,0.0
1002,2428,26-09-2019 20:34:00,0,3363.0,2394.0,0.712,15.903,257,188,142,46,69,54,15,3,0.0,0.0
1002,2429,26-09-2019 20:36:00,0,3553.0,2608.0,0.734,16.888,602,433,352,81,169,131,38,23,0.0,0.0
1002,2430,26-09-2019 20:38:00,0,3554.0,2631.0,0.74,16.915,607,431,362,69,176,139,37,45,0.0,0.0
1002,2431,26-09-2019 20:40:00,0,3563.0,2623.0,0.736,16.941,533,409,321,88,124,93,31,24,0.0,0.0
1002,2432,26-09-2019 20:42:00,0,3561.5,2626.5,0.7375,16.939,531,396,314,82,135,97,38,24,0.0,0.0
1002,2433,26-09-2019 20:44:00,0,3560.0,2630.0,0.739,16.937,486,416,329,87,70,43,27,20,0.0,0.0
1002,2434,26-09-2019 20:46:00,0,3570.0,2611.0,0.731,16.959,201,146,106,40,55,25,30,3,0.0,0.0
1002,2435,26-09-2019 20:48:00,0,3790.0,2649.0,0.699,17.865,454,239,187,52,215,154,61,6,0.0,0.0
1002,2436,26-09-2019 20:50:00,0,3789.0,2677.0,0.707,17.895,68,25,5,20,43,20,23,0,0.0,0.0
1002,2437,26-09-2019 20:52:00,0,3576.0,2548.0,0.713,16.909,214,116,89,27,98,73,25,19,0.0,0.0
1002,2438,26-09-2019 20:54:00,0,3384.0,2379.0,0.703,15.968,373,241,186,55,132,91,41,104,0.0,0.0
1002,2439,26-09-2019 20:56:00,0,3367.0,2397.0,0.712,15.919,88,66,27,39,22,7,15,0,0.0,0.0
1002,2440,26-09-2019 20:58:00,0,3083.0,2136.0,0.693,14.515,356,218,169,49,138,101,37,79,0.0,0.0
1002,2441,26-09-2019 21:00:00,0,3595.0,2490.0,0.693,16.921,205,86,57,29,119,72,47,2,0.0,0.0
1002,2442,26-09-2019 21:02:00,0,3478.0,2431.0,0.699,16.395,115,96,53,43,19,4,15,0,0.0,0.0
1002,2443,26-09-2019 21:04:00,0,3373.0,2401.0,0.712,15.949,297,232,171,61,65,37,28,6,0.0,0.0
1002,2444,26-09-2019 21:06:00,0,3599.0,2495.0,0.693,16.942,401,310,243,67,91,71,20,10,0.0,0.0
1002,2445,26-09-2019 21:08:00,0,3483.0,2469.0,0.709,16.456,124,102,78,24,22,3,19,2,0.0,0.0
1002,2446,26-09-2019 21:10:00,0,3372.0,2381.0,0.706,15.924,75,58,25,33,17,1,16,0,0.0,0.0
1002,2447,26-09-2019 21:12:00,0,3393.0,2385.0,0.703,16.007,239,132,82,50,107,65,42,5,0.0,0.0
1002,2448,26-09-2019 21:14:00,0,3372.0,2380.0,0.706,15.922,175,91,43,48,84,43,41,21,0.0,0.0
1002,2449,26-09-2019 21:16:00,0,3486.5,2435.0,0.699,16.433,204,151,109,42,53,35,18,7,0.0,0.0
1002,2450,26-09-2019 21:18:00,0,3601.0,2490.0,0.692,16.944,338,261,197,64,77,49,28,21,0.0,0.0
1002,2451,26-09-2019 21:20:00,0,3584.0,2536.0,0.708,16.928,140,91,54,37,49,29,20,3,0.0,0.0
1002,2452,26-09-2019 21:22:00,0,3361.0,2478.0,0.737,15.986,462,366,283,83,96,69,27,8,0.0,0.0
1002,2453,26-09-2019 21:24:00,0,3362.0,2442.0,0.726,15.948,389,313,250,63,76,44,32,21,0.0,0.0
1002,2454,26-09-2019 21:26:00,0,3595.0,2447.0,0.681,16.873,59,6,2,4,53,17,36,0,0.0,0.0
1002,2455,26-09-2019 21:28:00,0,3577.0,2537.0,0.709,16.904,250,132,104,28,118,92,26,77,0.0,0.0
1002,2456,26-09-2019 21:30:00,0,3385.0,2414.0,0.713,16.012,369,247,204,43,122,87,35,118,0.0,0.0
1002,2457,26-09-2019 21:32:00,0,3368.0,2413.0,0.717,15.941,135,86,56,30,49,36,13,9,0.0,0.0
1002,2458,26-09-2019 21:34:00,0,3412.0,2273.0,0.666,15.96,211,148,116,32,63,46,17,60,0.0,0.0
1002,2459,26-09-2019 21:36:00,0,3406.0,2316.0,0.68,15.985,287,121,83,38,166,118,48,21,0.0,0.0
1002,2460,26-09-2019 21:38:00,0,3381.0,2379.0,0.704,15.957,294,155,107,48,139,90,49,13,0.0,0.0
1002,2461,26-09-2019 21:40:00,0,3379.0,2331.0,0.69,15.894,52,25,7,18,27,4,23,0,0.0,0.0
1002,2462,26-09-2019 21:42:00,0,3370.0,2433.0,0.722,15.973,144,79,51,28,65,41,24,2,0.0,0.0
1002,2463,26-09-2019 21:44:00,0,3596.0,2472.0,0.688,16.904,82,44,30,14,38,21,17,15,0.0,0.0
1002,2464,26-09-2019 21:46:00,0,3360.0,2413.0,0.718,15.91,13,1,1,0,12,0,12,0,0.0,0.0
1002,2465,26-09-2019 21:48:00,0,3353.0,2430.0,0.725,15.9,193,111,82,29,82,60,22,7,0.0,0.0
1002,2466,26-09-2019 21:50:00,0,3324.5,2339.5,0.7035,15.6885,214,107,68,39,107,65,42,32,0.0,0.0
1002,2467,26-09-2019 21:52:00,0,3296.0,2249.0,0.682,15.477,228,133,105,28,95,61,34,49,0.0,0.0
1002,2468,26-09-2019 21:54:00,0,3398.0,2304.0,0.678,15.938,496,416,331,85,80,60,20,43,0.0,0.0
1002,2469,26-09-2019 21:56:00,0,3380.0,2363.0,0.699,15.933,462,375,294,81,87,61,26,45,0.0,0.0
1002,2470,26-09-2019 21:58:00,0,3379.0,2396.0,0.709,15.968,110,78,54,24,32,18,14,24,0.0,0.0
1002,2471,26-09-2019 22:00:00,0,3389.0,2311.0,0.682,15.912,206,159,119,40,47,33,14,6,0.0,0.0
1002,2472,26-09-2019 22:02:00,0,3393.0,2339.0,0.689,15.957,243,131,93,38,112,82,30,56,0.1,0.0
1002,2473,26-09-2019 22:04:00,0,3411.0,2285.0,0.67,15.97,234,111,86,25,123,84,39,8,0.01,0.0
1002,2474,26-09-2019 22:06:00,0,3418.0,2253.0,0.659,15.962,171,82,47,35,89,45,44,0,0.0,0.0
1002,2475,26-09-2019 22:08:00,0,3390.0,2334.0,0.689,15.942,53,19,3,16,34,17,17,0,0.0,0.0
1002,2476,26-09-2019 22:10:00,0,3311.0,2205.0,0.666,15.488,9,4,0,4,5,2,3,0,0.0,0.0
1002,2477,26-09-2019 22:12:00,0,3094.0,2044.0,0.661,14.454,10,8,0,8,2,2,0,0,0.0,0.0
1002,2478,26-09-2019 22:14:00,0,2905.0,1947.0,0.67,13.604,3,3,0,3,0,0,0,0,0.0,0.0
1002,2479,26-09-2019 22:16:00,0,2778.0,1850.0,0.666,12.993,65,22,14,8,43,17,26,0,0.0,0.0
1002,2480,26-09-2019 22:18:00,0,2684.0,1765.0,0.657,12.531,29,7,2,5,22,10,12,0,0.0,0.0
1002,2481,26-09-2019 22:20:00,0,2695.0,1718.0,0.637,12.522,0,0,0,0,0,0,0,0,0.0,0.0
1002,2482,26-09-2019 22:22:00,0,2353.0,1659.0,0.705,11.11,0,0,0,0,0,0,0,0,0.0,0.0
1002,2483,26-09-2019 22:24:00,0,2367.5,1602.0,0.677,11.1025,0,0,0,0,0,0,0,0,0.0,0.0
1002,2484,26-09-2019 22:26:00,0,2382.0,1545.0,0.649,11.095,111,51,37,14,60,39,21,2,0.0,0.0
1002,2485,26-09-2019 22:28:00,0,2469.0,1702.0,0.689,11.613,157,81,45,36,76,52,24,13,0.0,0.0
1002,2486,26-09-2019 22:30:00,0,2680.0,1793.0,0.669,12.545,205,149,106,43,56,44,12,67,0.0,0.0
1002,2487,26-09-2019 22:32:00,0,2672.0,1813.0,0.678,12.537,322,189,145,44,133,103,30,68,0.01,0.0
1002,2488,26-09-2019 22:34:00,0,2892.0,1953.0,0.675,13.556,438,316,253,63,122,88,34,144,0.0,0.0
1002,2489,26-09-2019 22:36:00,0,2984.0,2044.0,0.685,14.021,272,181,138,43,91,66,25,56,0.0,0.0
1002,2490,26-09-2019 22:38:00,0,3377.0,2345.0,0.694,15.902,206,74,42,32,132,88,44,12,0.0,0.0
1002,2491,26-09-2019 22:40:00,0,2984.0,2023.0,0.678,13.999,116,77,43,34,39,11,28,0,0.0,0.0
1002,2492,26-09-2019 22:42:00,0,2883.0,1972.0,0.684,13.543,178,126,87,39,52,29,23,3,0.0,0.0
1002,2493,26-09-2019 22:44:00,0,2884.0,2005.0,0.695,13.583,383,219,178,41,164,127,37,92,0.0,0.0
1002,2494,26-09-2019 22:46:00,0,3409.0,2237.0,0.656,15.908,546,345,287,58,201,151,50,103,0.0,0.0
1002,2495,26-09-2019 22:48:00,0,3373.0,2354.0,0.698,15.896,377,313,243,70,64,38,26,52,0.0,0.0
1002,2496,26-09-2019 22:50:00,0,3615.0,2442.0,0.676,16.946,267,228,179,49,39,24,15,35,0.0,0.0
1002,2497,26-09-2019 22:52:00,0,3611.0,2428.0,0.672,16.916,210,193,138,55,17,9,8,7,0.0,0.0
1002,2498,26-09-2019 22:54:00,0,3589.0,2497.0,0.696,16.907,159,100,58,42,59,33,26,3,0.0,0.0
1002,2499,26-09-2019 22:56:00,0,3583.0,2489.0,0.695,16.875,402,247,202,45,155,114,41,71,0.0,0.0
1002,2500,26-09-2019 22:58:00,0,3495.0,2391.5,0.684,16.4195,168,115,77,38,53,42,11,40,0.0,0.0
1002,2501,26-09-2019 23:00:00,0,3407.0,2294.0,0.673,15.964,45,40,10,30,5,0,5,0,0.0,0.0
1002,2502,26-09-2019 23:02:00,0,3398.0,2325.0,0.684,15.965,323,171,134,37,152,100,52,78,0.0,0.0
1002,2503,26-09-2019 23:04:00,0,3589.0,2455.0,0.684,16.86,361,203,152,51,158,109,49,33,0.0,0.0
1002,2504,26-09-2019 23:06:00,0,3622.0,2417.0,0.667,16.948,133,52,31,21,81,47,34,2,0.0,0.0
1002,2505,26-09-2019 23:08:00,0,3573.0,2511.0,0.703,16.86,415,199,165,34,216,170,46,58,0.0,0.0
1002,2506,26-09-2019 23:10:00,0,3630.0,2431.0,0.67,16.994,283,178,129,49,105,78,27,48,0.0,0.0
1002,2507,26-09-2019 23:12:00,0,3609.0,2429.0,0.673,16.908,252,144,112,32,108,82,26,35,0.0,0.0
1002,2508,26-09-2019 23:14:00,0,3603.0,2465.0,0.684,16.927,230,118,85,33,112,80,32,9,0.03,0.0
1002,2509,26-09-2019 23:16:00,0,3595.0,2480.0,0.69,16.913,286,205,152,53,81,58,23,8,0.01,0.0
1002,2510,26-09-2019 23:18:00,0,3611.0,2465.0,0.683,16.959,487,390,307,83,97,60,37,19,0.0,0.0
1002,2511,26-09-2019 23:20:00,0,3605.0,2469.0,0.685,16.939,145,98,69,29,47,17,30,4,0.0,0.0
1002,2512,26-09-2019 23:22:00,0,3784.0,2680.0,0.708,17.879,284,165,123,42,119,79,40,93,0.05,0.0
1002,2513,26-09-2019 23:24:00,0,3302.0,2204.0,0.667,15.449,366,177,131,46,189,139,50,56,0.0,0.0
1002,2514,26-09-2019 23:26:00,0,3407.0,2241.0,0.658,15.907,76,48,20,28,28,16,12,0,0.0,0.0
1002,2515,26-09-2019 23:28:00,0,3411.0,2287.0,0.67,15.972,267,141,110,31,126,88,38,25,0.04,0.0
1002,2516,26-09-2019 23:30:00,0,3375.0,2347.0,0.695,15.895,450,295,222,73,155,113,42,23,0.0,0.0
1002,2517,26-09-2019 23:32:00,0,3489.5,2404.0,0.689,16.411,119,85,59,26,34,13,21,4,0.0,0.0
1002,2518,26-09-2019 23:34:00,0,3604.0,2461.0,0.683,16.927,48,16,9,7,32,15,17,0,0.0,0.0
1002,2519,26-09-2019 23:36:00,0,3310.0,2180.0,0.659,15.455,25,10,5,5,15,4,11,0,0.01,0.0
1002,2520,26-09-2019 23:38:00,0,3125.0,1976.0,0.632,14.5,177,91,50,41,86,50,36,2,0.01,0.0
1002,2521,26-09-2019 23:40:00,0,3193.0,2147.0,0.672,14.958,257,157,116,41,100,70,30,75,0.0,0.0
1002,2522,26-09-2019 23:42:00,0,3416.0,2281.0,0.668,15.985,295,171,143,28,124,96,28,84,0.0,0.0
1002,2523,26-09-2019 23:44:00,0,3403.0,2304.0,0.677,15.958,62,36,20,16,26,19,7,0,0.0,0.0
1002,2524,26-09-2019 23:46:00,0,3385.0,2343.0,0.692,15.931,11,4,0,4,7,0,7,0,0.0,0.0
1002,2525,26-09-2019 23:48:00,0,3401.0,2272.0,0.668,15.918,53,35,17,18,18,4,14,0,0.01,0.0
1002,2526,26-09-2019 23:50:00,0,3402.0,2240.0,0.659,15.884,175,85,64,21,90,59,31,2,0.0,0.0
1002,2527,26-09-2019 23:52:00,0,3411.0,2240.0,0.657,15.918,21,0,0,0,21,0,21,0,0.0,0.0
1002,2528,26-09-2019 23:54:00,0,3426.0,2232.0,0.651,15.97,21,3,1,2,18,2,16,0,0.0,0.0
1002,2529,26-09-2019 23:56:00,0,3311.0,2175.0,0.657,15.456,38,8,5,3,30,5,25,0,0.0,0.0
1002,2530,26-09-2019 23:58:00,0,2904.0,1885.0,0.649,13.53,32,4,1,3,28,0,28,0,0.0,0.0
1002,2531,27-09-2019 00:00:00,0,2691.0,1780.0,0.661,12.573,44,0,0,0,44,0,44,0,0.0,0.0
1002,2532,27-09-2019 00:02:00,0,2699.0,1709.0,0.633,12.526,25,11,1,10,14,0,14,0,0.0,0.0
1002,2533,27-09-2019 00:04:00,0,2360.0,1654.0,0.701,11.13,56,12,7,5,44,14,30,0,0.0,0.0
1002,2534,27-09-2019 00:06:00,0,2361.0,1644.0,0.6965,11.123,13,0,0,0,13,0,13,0,0.0,0.0
1002,2535,27-09-2019 00:08:00,0,2362.0,1634.0,0.692,11.116,10,2,1,1,8,3,5,0,0.0,0.0
1002,2536,27-09-2019 00:10:00,0,2386.0,1553.0,0.651,11.119,12,3,0,3,9,2,7,0,0.0,0.0
1002,2537,27-09-2019 00:12:00,0,2378.0,1561.0,0.656,11.097,25,1,0,1,24,0,24,0,0.0,0.0
1002,2538,27-09-2019 00:14:00,0,2270.0,1519.0,0.669,10.628,35,1,0,1,34,0,34,0,0.0,0.0
1002,2539,27-09-2019 00:16:00,0,2170.0,1471.0,0.678,10.179,18,0,0,0,18,0,18,0,0.0,0.0
1002,2540,27-09-2019 00:18:00,0,2180.0,1402.0,0.643,10.142,73,42,27,15,31,17,14,1,0.01,0.0
1002,2541,27-09-2019 00:20:00,0,2169.0,1434.0,0.661,10.132,344,147,112,35,197,154,43,33,0.0,0.0
1002,2542,27-09-2019 00:22:00,0,2153.0,1498.0,0.696,10.141,99,29,11,18,70,42,28,0,0.0,0.0
1002,2543,27-09-2019 00:24:00,0,2374.0,1600.0,0.674,11.125,175,88,58,30,87,53,34,16,0.0,0.0
1002,2544,27-09-2019 00:26:00,0,2457.0,1717.0,0.699,11.582,299,249,190,59,50,35,15,16,0.0,0.0
1002,2545,27-09-2019 00:28:00,0,2908.0,1901.0,0.654,13.564,112,85,50,35,27,18,9,10,0.0,0.0
1002,2546,27-09-2019 00:30:00,0,2685.0,1790.0,0.667,12.56,128,95,52,43,33,10,23,0,0.0,0.0
1002,2547,27-09-2019 00:32:00,0,2784.0,1892.0,0.68,13.063,189,131,90,41,58,37,21,8,0.0,0.0
1002,2548,27-09-2019 00:34:00,0,2681.0,1773.0,0.661,12.527,272,128,95,33,144,98,46,42,0.0,0.0
1002,2549,27-09-2019 00:36:00,0,2885.0,1928.0,0.668,13.502,174,113,85,28,61,44,17,5,0.01,0.0
1002,2550,27-09-2019 00:38:00,0,3406.0,2328.0,0.684,15.999,36,19,9,10,17,9,8,0,0.0,0.0
1002,2551,27-09-2019 00:40:00,0,2891.0,1948.5,0.672,13.55,134,90,62,28,44,35,9,4,0.0,0.0
1002,2552,27-09-2019 00:42:00,0,2376.0,1569.0,0.66,11.101,94,59,38,21,35,21,14,9,0.0,0.0
1002,2553,27-09-2019 00:44:00,0,2673.0,1833.0,0.686,12.563,87,33,18,15,54,31,23,0,0.0,0.0
1002,2554,27-09-2019 00:46:00,0,2992.0,1987.0,0.664,13.991,234,103,77,26,131,91,40,28,0.01,0.0
1002,2555,27-09-2019 00:48:00,0,2888.0,1955.0,0.677,13.544,362,154,118,36,208,158,50,43,0.05,0.0
1002,2556,27-09-2019 00:50:00,0,3084.0,2113.0,0.685,14.492,320,247,187,60,73,38,35,7,0.0,0.0
1002,2557,27-09-2019 00:52:00,0,3206.0,2178.0,0.679,15.043,393,253,188,65,140,101,39,50,0.0,0.0
1002,2558,27-09-2019 00:54:00,0,3078.0,2161.0,0.702,14.52,108,96,47,49,12,2,10,0,0.0,0.0
1002,2559,27-09-2019 00:56:00,0,3089.0,2019.0,0.654,14.406,18,14,7,7,4,1,3,0,0.0,0.0
1002,2560,27-09-2019 00:58:00,0,3114.0,2049.0,0.658,14.54,156,114,87,27,42,32,10,21,0.0,0.0
1002,2561,27-09-2019 01:00:00,0,3067.0,2144.0,0.699,14.459,202,110,79,31,92,61,31,52,0.0,0.0
1002,2562,27-09-2019 01:02:00,0,3308.0,2188.0,0.661,15.458,70,63,42,21,7,4,3,17,0.0,0.0
1002,2563,27-09-2019 01:04:00,0,3077.0,2127.0,0.691,14.478,171,96,66,30,75,54,21,12,0.0,0.0
1002,2564,27-09-2019 01:06:00,0,3094.0,2116.0,0.684,14.534,260,155,117,38,105,78,27,79,0.0,0.0
1002,2565,27-09-2019 01:08:00,0,3194.0,2149.0,0.673,14.964,396,282,215,67,114,81,33,5,0.0,0.0
1002,2566,27-09-2019 01:10:00,0,3424.0,2228.0,0.651,15.959,277,213,144,69,64,40,24,5,0.0,0.0
1002,2567,27-09-2019 01:12:00,0,3407.0,2305.0,0.677,15.977,127,66,37,29,61,36,25,2,0.03,0.0
1002,2568,27-09-2019 01:14:00,0,3208.5,2137.5,0.6655,15.01,121,38,17,21,83,51,32,0,0.0,0.0
1002,2569,27-09-2019 01:16:00,0,3010.0,1970.0,0.654,14.043,95,47,16,31,48,20,28,0,0.0,0.0
1002,2570,27-09-2019 01:18:00,0,2998.0,1984.0,0.662,14.007,84,64,25,39,20,4,16,0,0.0,0.0
1002,2571,27-09-2019 01:20:00,0,3006.0,1962.0,0.653,14.014,69,61,26,35,8,0,8,0,0.0,0.0
1002,2572,27-09-2019 01:22:00,0,2900.0,1932.0,0.666,13.567,70,65,29,36,5,1,4,0,0.0,0.0
1002,2573,27-09-2019 01:24:00,0,2873.0,1946.0,0.678,13.473,389,245,194,51,144,97,47,61,0.01,0.0
1002,2574,27-09-2019 01:26:00,0,3107.0,2066.0,0.665,14.528,282,165,113,52,117,79,38,88,0.0,0.0
1002,2575,27-09-2019 01:28:00,0,3104.0,2042.0,0.658,14.491,102,57,25,32,45,15,30,0,0.0,0.0
1002,2576,27-09-2019 01:30:00,0,3106.0,2012.0,0.648,14.468,70,31,15,16,39,14,25,0,0.0,0.0
1002,2577,27-09-2019 01:32:00,0,3103.0,2027.0,0.653,14.469,89,54,33,21,35,24,11,5,0.0,0.0
1002,2578,27-09-2019 01:34:00,0,3113.0,1985.0,0.638,14.464,196,103,71,32,93,66,27,12,0.0,0.0
1002,2579,27-09-2019 01:36:00,0,3103.0,2022.0,0.652,14.465,141,62,38,24,79,47,32,0,0.0,0.0
1002,2580,27-09-2019 01:38:00,0,2874.0,1960.0,0.682,13.495,37,24,5,19,13,5,8,0,0.0,0.0
1002,2581,27-09-2019 01:40:00,0,2785.0,1864.0,0.669,13.037,29,29,14,15,0,0,0,0,0.0,0.0
1002,2582,27-09-2019 01:42:00,0,2696.0,1755.0,0.651,12.565,2,2,0,2,0,0,0,0,0.0,0.0
1002,2583,27-09-2019 01:44:00,0,2473.0,1654.0,0.669,11.577,4,4,1,3,0,0,0,0,0.0,0.0
1002,2584,27-09-2019 01:46:00,0,2374.0,1601.0,0.674,11.127,8,8,0,8,0,0,0,0,0.0,0.0
1002,2585,27-09-2019 01:48:00,0,2263.5,1546.0,0.6835,10.63,0,0,0,0,0,0,0,0,0.0,0.0
1002,2586,27-09-2019 01:50:00,0,2153.0,1491.0,0.693,10.133,29,11,3,8,18,13,5,0,0.0,0.0
1002,2587,27-09-2019 01:52:00,0,2175.0,1449.0,0.666,10.177,8,5,2,3,3,0,3,0,0.0,0.0
1002,2588,27-09-2019 01:54:00,0,2179.0,1376.0,0.632,10.109,1,0,0,0,1,0,1,0,0.0,0.0
1002,2589,27-09-2019 01:56:00,0,2067.0,1335.0,0.646,9.622,3,1,0,1,2,0,2,0,0.0,0.0
1002,2590,27-09-2019 01:58:00,0,1960.0,1299.0,0.663,9.161,5,5,4,1,0,0,0,0,0.01,0.0
1002,2591,27-09-2019 02:00:00,0,1974.0,1263.0,0.64,9.178,7,7,4,3,0,0,0,0,0.0,0.0
1002,2592,27-09-2019 02:02:00,0,1977.0,1250.0,0.633,9.174,0,0,0,0,0,0,0,0,0.0,0.0
1002,2593,27-09-2019 02:04:00,0,1986.0,1219.0,0.614,9.174,0,0,0,0,0,0,0,0,0.0,0.0
1002,2594,27-09-2019 02:06:00,0,1994.0,1181.0,0.592,9.164,3,3,2,1,0,0,0,0,0.0,0.0
1002,2595,27-09-2019 02:08:00,0,1879.0,1163.0,0.619,8.694,7,7,4,3,0,0,0,0,0.0,0.0
1002,2596,27-09-2019 02:10:00,0,1758.0,1144.0,0.651,8.196,0,0,0,0,0,0,0,0,0.0,0.0
1002,2597,27-09-2019 02:12:00,0,1766.0,1135.0,0.643,8.216,29,28,16,12,1,0,1,0,0.0,0.0
1002,2598,27-09-2019 02:14:00,0,1652.0,1124.0,0.68,7.752,5,5,3,2,0,0,0,0,0.0,0.0
1002,2599,27-09-2019 02:16:00,0,1655.0,1092.0,0.66,7.729,15,15,8,7,0,0,0,0,0.0,0.0
1002,2600,27-09-2019 02:18:00,0,1656.0,1096.0,0.661,7.739,1,1,0,1,0,0,0,0,0.0,0.0
1002,2601,27-09-2019 02:20:00,0,1655.0,1086.0,0.656,7.725,5,5,3,2,0,0,0,0,0.0,0.0
1002,2602,27-09-2019 02:22:00,0,1543.5,1052.0,0.6835,7.248,7,7,4,3,0,0,0,0,0.0,0.0
1002,2603,27-09-2019 02:24:00,0,1432.0,1018.0,0.711,6.771,3,3,1,2,0,0,0,0,0.0,0.0
1002,2604,27-09-2019 02:26:00,0,1435.0,996.0,0.694,6.755,18,18,10,8,0,0,0,0,0.0,0.0
1002,2605,27-09-2019 02:28:00,0,1432.0,997.0,0.696,6.748,5,0,0,0,5,1,4,0,0.0,0.0
1002,2606,27-09-2019 02:30:00,0,1436.0,1004.0,0.699,6.77,18,12,6,6,6,0,6,0,0.0,0.0
1002,2607,27-09-2019 02:32:00,0,1443.0,990.0,0.686,6.782,2,0,0,0,2,0,2,0,0.0,0.0
1002,2608,27-09-2019 02:34:00,0,1447.0,957.0,0.662,6.762,75,72,48,24,3,0,3,0,0.0,0.0
1002,2609,27-09-2019 02:36:00,0,1442.0,963.0,0.668,6.748,8,6,1,5,2,0,2,0,0.0,0.0
1002,2610,27-09-2019 02:38:00,0,1437.0,978.0,0.681,6.746,5,4,0,4,1,0,1,0,0.0,0.0
1002,2611,27-09-2019 02:40:00,0,1441.0,974.0,0.676,6.755,1,1,0,1,0,0,0,0,0.0,0.0
1002,2612,27-09-2019 02:42:00,0,1445.0,965.0,0.668,6.761,65,41,23,18,24,11,13,8,0.0,0.0
1002,2613,27-09-2019 02:44:00,0,1537.0,1059.0,0.689,7.23,325,169,129,40,156,111,45,45,0.0,0.0
1002,2614,27-09-2019 02:46:00,0,1765.0,1130.0,0.64,8.205,168,93,67,26,75,46,29,20,0.0,0.0
1002,2615,27-09-2019 02:48:00,0,1764.0,1150.0,0.652,8.223,261,166,134,32,95,73,22,106,0.0,0.0
1002,2616,27-09-2019 02:50:00,0,1977.0,1263.0,0.639,9.187,191,103,83,20,88,65,23,54,0.0,0.0
1002,2617,27-09-2019 02:52:00,0,1962.0,1303.0,0.664,9.175,167,91,70,21,76,45,31,66,0.0,0.0
1002,2618,27-09-2019 02:54:00,0,2166.0,1449.0,0.669,10.139,97,47,13,34,50,20,30,7,0.0,0.0
1002,2619,27-09-2019 02:56:00,0,2536.5,1680.5,0.6635,11.8545,139,49,29,20,90,57,33,7,0.0,0.0
1002,2620,27-09-2019 02:58:00,0,2907.0,1912.0,0.658,13.57,90,57,24,33,33,25,8,4,0.0,0.0
1002,2621,27-09-2019 03:00:00,0,2390.0,1527.0,0.639,11.108,63,39,17,22,24,3,21,0,0.0,0.0
1002,2622,27-09-2019 03:02:00,0,2366.0,1593.0,0.673,11.085,152,85,48,37,67,25,42,8,0.0,0.0
1002,2623,27-09-2019 03:04:00,0,2475.0,1637.0,0.661,11.565,147,83,42,41,64,33,31,1,0.0,0.0
1002,2624,27-09-2019 03:06:00,0,2688.0,1731.0,0.644,12.507,287,143,101,42,144,101,43,30,0.0,0.0
1002,2625,27-09-2019 03:08:00,0,2895.0,1917.0,0.662,13.528,360,228,175,53,132,99,33,115,0.0,0.0
1002,2626,27-09-2019 03:10:00,0,3112.0,2020.0,0.649,14.497,331,196,160,36,135,99,36,91,0.0,0.0
1002,2627,27-09-2019 03:12:00,0,3089.0,2069.0,0.67,14.463,179,73,43,30,106,70,36,4,0.0,0.0
1002,2628,27-09-2019 03:14:00,0,3121.0,2002.0,0.642,14.513,84,45,16,29,39,13,26,0,0.0,0.0
1002,2629,27-09-2019 03:16:00,0,3108.0,2051.0,0.66,14.518,259,154,115,39,105,71,34,65,0.0,0.0
1002,2630,27-09-2019 03:18:00,0,3111.0,2035.0,0.654,14.51,502,278,230,48,224,185,39,188,0.0,0.0
1002,2631,27-09-2019 03:20:00,0,3075.0,2116.0,0.688,14.459,389,220,177,43,169,136,33,173,0.0,0.0
1002,2632,27-09-2019 03:22:00,0,3429.0,2201.0,0.642,15.947,359,201,162,39,158,116,42,100,0.0,0.0
1002,2633,27-09-2019 03:24:00,0,3096.0,2040.0,0.659,14.457,149,61,42,19,88,60,28,19,0.0,0.0
1002,2634,27-09-2019 03:26:00,0,3108.0,2063.0,0.664,14.531,173,94,52,42,79,45,34,6,0.0,0.0
1002,2635,27-09-2019 03:28:00,0,3314.0,2190.0,0.661,15.483,84,37,24,13,47,16,31,4,0.0,0.0
1002,2636,27-09-2019 03:30:00,0,3213.5,2089.5,0.65,14.9765,132,50,20,30,82,50,32,1,0.0,0.0
1002,2637,27-09-2019 03:32:00,0,3113.0,1989.0,0.639,14.47,75,44,16,28,31,9,22,0,0.0,0.0
1002,2638,27-09-2019 03:34:00,0,3108.0,2027.0,0.652,14.49,38,10,2,8,28,17,11,0,0.0,0.0
1002,2639,27-09-2019 03:36:00,0,2918.0,1825.0,0.626,13.516,43,0,0,0,43,2,41,0,0.0,0.0
1002,2640,27-09-2019 03:38:00,0,2720.0,1726.0,0.634,12.629,44,0,0,0,44,6,38,0,0.0,0.0
1002,2641,27-09-2019 03:40:00,0,2480.0,1655.0,0.667,11.602,19,1,0,1,18,2,16,0,0.0,0.0
1002,2642,27-09-2019 03:42:00,0,2368.0,1593.0,0.673,11.095,31,0,0,0,31,4,27,0,0.0,0.0
1002,2643,27-09-2019 03:44:00,0,2382.0,1543.0,0.648,11.095,3,0,0,0,3,1,2,0,0.0,0.0
1002,2644,27-09-2019 03:46:00,0,2167.0,1457.0,0.672,10.151,3,0,0,0,3,0,3,0,0.0,0.0
1002,2645,27-09-2019 03:48:00,0,2171.0,1405.0,0.647,10.109,26,0,0,0,26,2,24,0,0.0,0.0
1002,2646,27-09-2019 03:50:00,0,2200.0,1356.0,0.616,10.17,42,0,0,0,42,3,39,0,0.0,0.0
1002,2647,27-09-2019 03:52:00,0,2191.0,1319.0,0.602,10.092,106,48,25,23,58,40,18,1,0.0,0.0
1002,2648,27-09-2019 03:54:00,0,2178.0,1448.0,0.665,10.184,258,138,105,33,120,88,32,63,0.0,0.0
1002,2649,27-09-2019 03:56:00,0,2380.0,1550.0,0.651,11.094,257,161,118,43,96,66,30,6,0.0,0.0
1002,2650,27-09-2019 03:58:00,0,2368.0,1587.0,0.67,11.088,278,130,97,33,148,115,33,4,0.0,0.0
1002,2651,27-09-2019 04:00:00,0,2393.0,1549.0,0.647,11.144,159,77,53,24,82,51,31,8,0.0,0.0
1002,2652,27-09-2019 04:02:00,0,2262.0,1517.0,0.671,10.592,16,0,0,0,16,0,16,0,0.0,0.0
1002,2653,27-09-2019 04:04:00,0,2213.0,1484.0,0.6705,10.3625,4,1,0,1,3,0,3,0,0.0,0.0
1002,2654,27-09-2019 04:06:00,0,2164.0,1451.0,0.67,10.133,44,15,2,13,29,20,9,0,0.0,0.0
1002,2655,27-09-2019 04:08:00,0,2175.0,1466.0,0.674,10.191,0,0,0,0,0,0,0,0,0.0,0.0
1002,2656,27-09-2019 04:10:00,0,2194.0,1393.0,0.635,10.186,0,0,0,0,0,0,0,0,0.0,0.0
1002,2657,27-09-2019 04:12:00,0,2190.0,1345.0,0.614,10.119,2,1,0,1,1,0,1,0,0.0,0.0
1002,2658,27-09-2019 04:14:00,0,1963.0,1295.0,0.66,9.169,43,8,4,4,35,4,31,0,0.0,0.0
1002,2659,27-09-2019 04:16:00,0,1977.0,1262.0,0.638,9.187,46,0,0,0,46,2,44,0,0.0,0.0
1002,2660,27-09-2019 04:18:00,0,1983.0,1216.0,0.613,9.159,16,0,0,0,16,0,16,0,0.0,0.0
1002,2661,27-09-2019 04:20:00,0,2004.0,1175.0,0.587,9.197,5,3,1,2,2,0,2,0,0.0,0.0
1002,2662,27-09-2019 04:22:00,0,1764.0,1123.0,0.637,8.194,25,5,1,4,20,2,18,0,0.0,0.0
1002,2663,27-09-2019 04:24:00,0,1890.0,1148.0,0.607,8.717,34,0,0,0,34,0,34,0,0.0,0.0
1002,2664,27-09-2019 04:26:00,0,1765.0,1120.0,0.634,8.192,25,0,0,0,25,0,25,0,0.0,0.0
1002,2665,27-09-2019 04:28:00,0,1645.0,1114.0,0.677,7.715,17,0,0,0,17,0,17,0,0.0,0.0
1002,2666,27-09-2019 04:30:00,0,1658.0,1081.0,0.652,7.73,20,0,0,0,20,0,20,0,0.0,0.0
1002,2667,27-09-2019 04:32:00,0,1661.0,1059.0,0.637,7.718,38,0,0,0,38,0,38,0,0.0,0.0
1002,2668,27-09-2019 04:34:00,0,1661.0,1043.0,0.628,7.701,22,1,0,1,21,0,21,0,0.0,0.0
1002,2669,27-09-2019 04:36:00,0,1547.0,1035.0,0.669,7.242,6,0,0,0,6,0,6,0,0.0,0.0
1002,2670,27-09-2019 04:38:00,0,1551.0,1029.5,0.664,7.2505,17,8,0,8,9,2,7,0,0.0,0.0
1002,2671,27-09-2019 04:40:00,0,1555.0,1024.0,0.659,7.259,3,0,0,0,3,0,3,0,0.0,0.0
1002,2672,27-09-2019 04:42:00,0,1436.0,992.0,0.691,6.757,10,0,0,0,10,0,10,0,0.0,0.0
1002,2673,27-09-2019 04:44:00,0,1436.0,989.0,0.689,6.753,4,3,1,2,1,0,1,0,0.0,0.0
1002,2674,27-09-2019 04:46:00,0,1446.0,968.0,0.67,6.769,1,0,0,0,1,0,1,0,0.0,0.0
1002,2675,27-09-2019 04:48:00,0,1447.0,963.0,0.665,6.766,11,8,3,5,3,0,3,0,0.0,0.0
1002,2676,27-09-2019 04:50:00,0,1440.0,971.0,0.674,6.751,30,7,3,4,23,0,23,0,0.0,0.0
1002,2677,27-09-2019 04:52:00,0,1442.0,980.0,0.68,6.768,27,9,2,7,18,0,18,0,0.0,0.0
1002,2678,27-09-2019 04:54:00,0,1446.0,967.0,0.669,6.767,70,30,18,12,40,12,28,0,0.0,0.0
1002,2679,27-09-2019 04:56:00,0,1426.0,1038.0,0.727,6.768,244,136,102,34,108,67,41,15,0.0,0.0
1002,2680,27-09-2019 04:58:00,0,1655.0,1110.0,0.671,7.749,131,66,35,31,65,37,28,13,0.0,0.0
1002,2681,27-09-2019 05:00:00,0,1656.0,1098.0,0.663,7.738,16,3,0,3,13,9,4,4,0.0,0.0
1002,2682,27-09-2019 05:02:00,0,1647.0,1115.0,0.677,7.724,81,41,17,24,40,17,23,0,0.0,0.0
1002,2683,27-09-2019 05:04:00,0,1748.0,1170.0,0.669,8.184,276,136,106,30,140,96,44,22,0.0,0.0
1002,2684,27-09-2019 05:06:00,0,1753.0,1183.0,0.674,8.218,32,2,0,2,30,18,12,0,0.0,0.0
1002,2685,27-09-2019 05:08:00,0,1762.0,1154.0,0.655,8.222,6,0,0,0,6,1,5,0,0.0,0.0
1002,2686,27-09-2019 05:10:00,0,1767.0,1148.0,0.65,8.232,69,44,30,14,25,13,12,14,0.0,0.0
1002,2687,27-09-2019 05:12:00,0,1875.5,1188.0,0.6345,8.7035,135,65,36,29,70,39,31,26,0.0,0.0
1002,2688,27-09-2019 05:14:00,0,1984.0,1228.0,0.619,9.175,33,3,1,2,30,9,21,0,0.0,0.0
1002,2689,27-09-2019 05:16:00,0,1962.0,1288.0,0.656,9.158,18,6,3,3,12,2,10,0,0.0,0.0
1002,2690,27-09-2019 05:18:00,0,2188.0,1386.0,0.633,10.155,148,94,76,18,54,38,16,33,0.0,0.0
1002,2691,27-09-2019 05:20:00,0,2179.0,1421.0,0.652,10.158,56,36,16,20,20,2,18,0,0.0,0.0
1002,2692,27-09-2019 05:22:00,0,2186.0,1399.0,0.64,10.16,124,63,37,26,61,28,33,0,0.0,0.0
1002,2693,27-09-2019 05:24:00,0,2179.0,1393.0,0.639,10.128,55,24,3,21,31,0,31,0,0.0,0.0
1002,2694,27-09-2019 05:26:00,0,2177.0,1388.0,0.638,10.115,85,42,8,34,43,14,29,0,0.0,0.0
1002,2695,27-09-2019 05:28:00,0,2180.0,1419.0,0.651,10.161,42,16,8,8,26,9,17,0,0.02,0.0
1002,2696,27-09-2019 05:30:00,0,2196.0,1344.0,0.612,10.143,7,0,0,0,7,0,7,0,0.0,0.0
1002,2697,27-09-2019 05:32:00,0,2085.0,1308.0,0.627,9.663,1,0,0,0,1,0,1,0,0.0,0.0
1002,2698,27-09-2019 05:34:00,0,1977.0,1256.0,0.635,9.179,1,0,0,0,1,0,1,0,0.0,0.0
1002,2699,27-09-2019 05:36:00,0,1983.0,1194.0,0.602,9.136,0,0,0,0,0,0,0,0,0.0,0.0
1002,2700,27-09-2019 05:38:00,0,2003.0,1151.0,0.574,9.167,2,2,1,1,0,0,0,0,0.0,0.0
1002,2701,27-09-2019 05:40:00,0,1774.0,1119.0,0.631,8.227,1,1,0,1,0,0,0,0,0.0,0.0
1002,2702,27-09-2019 05:42:00,0,1653.0,1088.0,0.658,7.718,0,0,0,0,0,0,0,0,0.0,0.0
1002,2703,27-09-2019 05:44:00,0,1657.0,1071.0,0.647,7.713,0,0,0,0,0,0,0,0,0.0,0.0
1002,2704,27-09-2019 05:46:00,0,1667.0,1046.5,0.628,7.727,11,0,0,0,11,0,11,0,0.0,0.0
1002,2705,27-09-2019 05:48:00,0,1677.0,1022.0,0.609,7.741,10,0,0,0,10,0,10,0,0.0,0.0
1002,2706,27-09-2019 05:50:00,0,1564.0,993.0,0.634,7.263,45,14,4,10,31,15,16,0,0.0,0.0
1002,2707,27-09-2019 05:52:00,0,1671.0,1025.0,0.613,7.721,4,1,0,1,3,0,3,0,0.0,0.0
1002,2708,27-09-2019 05:54:00,0,1549.0,1019.0,0.658,7.233,12,2,0,2,10,2,8,0,0.0,0.0
1002,2709,27-09-2019 05:56:00,0,1435.0,1005.0,0.701,6.766,2,0,0,0,2,0,2,0,0.0,0.0
1002,2710,27-09-2019 05:58:00,0,1448.0,984.0,0.68,6.793,1,0,0,0,1,0,1,0,0.0,0.0
1002,2711,27-09-2019 06:00:00,1,1445.0,955.0,0.661,6.752,21,13,4,9,8,4,4,0,0.0,0.0
1002,2712,27-09-2019 06:02:00,1,1533.0,1090.0,0.711,7.246,308,173,136,37,135,94,41,0,0.0,0.0
1002,2713,27-09-2019 06:04:00,1,1864.0,1208.0,0.648,8.683,313,199,155,44,114,97,17,2,0.0,0.0
1002,2714,27-09-2019 06:06:00,1,1962.0,1306.0,0.666,9.176,217,113,75,38,104,74,30,13,0.0,0.01
1002,2715,27-09-2019 06:08:00,1,2264.0,1533.0,0.677,10.62,281,165,129,36,116,81,35,52,0.0,0.0
1002,2716,27-09-2019 06:10:00,1,3112.0,1985.0,0.638,14.461,103,70,39,31,33,14,19,75,0.0,0.0
1002,2717,27-09-2019 06:12:00,1,3406.0,2275.0,0.668,15.941,90,59,31,28,31,8,23,57,0.0,0.0
1002,2718,27-09-2019 06:14:00,1,3627.0,2473.0,0.682,17.03,120,72,43,29,48,10,38,53,0.0,0.0
1002,2719,27-09-2019 06:16:00,1,3784.0,2633.0,0.696,17.823,136,45,19,26,91,36,55,43,0.0,0.0
1002,2720,27-09-2019 06:18:00,1,3878.0,2788.0,0.719,18.367,165,59,39,20,106,61,45,42,0.0,0.18
1002,2721,27-09-2019 06:20:00,1,3969.0,2895.0,0.729,18.8445,128,34,15,19,94,39,55,46,0.0,0.05
1002,2722,27-09-2019 06:22:00,1,4060.0,3002.0,0.739,19.322,119,33,15,18,86,40,46,33,0.0,0.05
1002,2723,27-09-2019 06:24:00,1,4142.0,3086.0,0.745,19.737,139,33,14,19,106,71,35,21,0.0,0.07
1002,2724,27-09-2019 06:26:00,1,4165.0,3145.0,0.755,19.894,156,20,5,15,136,88,48,15,0.31,0.06
1002,2725,27-09-2019 06:28:00,1,3759.0,2747.0,0.731,17.854,344,172,132,40,172,126,46,25,0.2,0.0
1002,2726,27-09-2019 06:30:00,1,4015.0,3209.0,0.799,19.37,127,66,44,22,61,35,26,44,0.0,0.0
1002,2727,27-09-2019 06:32:00,1,4010.0,3166.0,0.79,19.306,127,30,7,23,97,61,36,23,0.0,0.05
1002,2728,27-09-2019 06:34:00,1,4239.0,3335.0,0.787,20.396,168,32,11,21,136,88,48,15,0.0,0.05
1002,2729,27-09-2019 06:36:00,1,3988.0,3209.0,0.805,19.267,297,134,99,35,163,113,50,45,0.24,0.03
1002,2730,27-09-2019 06:38:00,1,4194.0,3432.0,0.818,20.323,111,31,12,19,80,47,33,33,0.0,0.05
1002,2731,27-09-2019 06:40:00,1,4717.0,3733.0,0.791,22.718,80,18,2,16,62,42,20,14,0.18,0.06
1002,2732,27-09-2019 06:42:00,1,4196.0,3481.0,0.83,20.387,226,111,72,39,115,79,36,31,0.0,0.0
1002,2733,27-09-2019 06:44:00,1,4101.0,3315.0,0.808,19.827,51,46,12,34,5,2,3,27,0.01,0.02
1002,2734,27-09-2019 06:46:00,1,4216.0,3346.0,0.794,20.314,201,117,73,44,84,59,25,36,0.03,0.08
1002,2735,27-09-2019 06:48:00,1,4715.0,3762.0,0.798,22.742,365,232,185,47,133,98,35,47,0.15,0.0
1002,2736,27-09-2019 06:50:00,1,3979.0,3308.0,0.831,19.34,145,76,34,42,69,28,41,21,0.01,0.02
1002,2737,27-09-2019 06:52:00,1,4715.0,3799.0,0.806,22.784,116,62,33,29,54,28,26,42,0.01,0.02
1002,2738,27-09-2019 06:54:00,1,4812.5,3877.0,0.806,23.254,162,98,53,45,64,28,36,50,0.0,0.05
1002,2739,27-09-2019 06:56:00,1,4910.0,3955.0,0.806,23.724,170,90,52,38,80,39,41,53,0.12,0.02
1002,2740,27-09-2019 06:58:00,1,4176.0,3518.0,0.842,20.35,152,102,57,45,50,25,25,24,0.08,0.04
1002,2741,27-09-2019 07:00:00,1,4071.0,3397.0,0.834,19.803,224,97,68,29,127,88,39,41,0.05,0.0
1002,2742,27-09-2019 07:02:00,1,4880.0,4037.0,0.827,23.696,162,76,48,28,86,44,42,60,0.0,0.0
1002,2743,27-09-2019 07:04:00,1,4668.0,3890.0,0.833,22.701,162,63,35,28,99,58,41,46,0.0,0.03
1002,2744,27-09-2019 07:06:00,1,5059.0,4240.0,0.838,24.628,191,59,30,29,132,82,50,58,0.0,0.0
1002,2745,27-09-2019 07:08:00,1,4468.0,3818.0,0.855,21.831,8,2,1,1,6,5,1,1,0.0,0.32
1002,2746,27-09-2019 07:10:00,1,4148.0,3664.0,0.883,20.4,22,11,4,7,11,9,2,0,0.01,0.01
1002,2747,27-09-2019 07:12:00,1,4136.0,3634.0,0.879,20.319,345,191,144,47,154,112,42,32,0.23,0.01
1002,2748,27-09-2019 07:14:00,1,3255.0,2841.0,0.873,15.971,203,99,64,35,104,67,37,16,0.0,0.0
1002,2749,27-09-2019 07:16:00,1,3857.0,3246.0,0.842,18.791,74,38,21,17,36,14,22,0,0.02,0.0
1002,2750,27-09-2019 07:18:00,1,3994.0,3355.0,0.84,19.451,113,65,44,21,48,26,22,0,0.01,0.0
1002,2751,27-09-2019 07:20:00,1,4132.0,3660.0,0.886,20.332,380,203,155,48,177,124,53,11,0.0,0.02
1002,2752,27-09-2019 07:22:00,1,3937.0,3473.0,0.882,19.355,178,126,86,40,52,26,26,73,0.0,0.0
1002,2753,27-09-2019 07:24:00,1,4650.0,4044.0,0.87,22.797,157,107,62,45,50,27,23,58,0.0,0.0
1002,2754,27-09-2019 07:26:00,1,4108.0,3761.0,0.916,20.349,391,237,180,57,154,112,42,2,0.08,0.02
1002,2755,27-09-2019 07:28:00,1,4272.0,3829.0,0.8975,21.07,160,95,57,38,65,43,22,50,0.0,0.0
1002,2756,27-09-2019 07:30:00,1,4436.0,3897.0,0.879,21.791,134,86,57,29,48,19,29,61,0.0,0.0
1002,2757,27-09-2019 07:32:00,1,4118.0,3724.0,0.904,20.347,223,123,88,35,100,62,38,30,0.07,0.03
1002,2758,27-09-2019 07:34:00,1,3941.0,3499.0,0.888,19.4,577,317,259,58,260,199,61,2,0.0,0.0
1002,2759,27-09-2019 07:36:00,1,4158.0,3646.0,0.877,20.418,333,232,186,46,101,64,37,35,0.0,0.0
1002,2760,27-09-2019 07:38:00,1,4154.0,3579.0,0.861,20.329,146,117,80,37,29,3,26,54,0.0,0.0
1002,2761,27-09-2019 07:40:00,1,4207.0,3806.0,0.905,20.788,197,48,28,20,149,102,47,8,0.12,0.01
1002,2762,27-09-2019 07:42:00,1,4033.0,3588.0,0.89,19.861,83,60,26,34,23,0,23,0,0.0,0.0
1002,2763,27-09-2019 07:44:00,1,3939.0,3502.0,0.889,19.397,96,56,29,27,40,15,25,0,0.0,0.0
1002,2764,27-09-2019 07:46:00,1,4130.0,3680.0,0.891,20.345,92,10,5,5,82,50,32,0,0.0,0.0
1002,2765,27-09-2019 07:48:00,1,3901.0,3547.0,0.909,19.297,65,14,2,12,51,42,9,0,0.0,0.0
1002,2766,27-09-2019 07:50:00,1,3540.0,3141.0,0.887,17.425,0,0,0,0,0,0,0,0,0.0,0.0
1002,2767,27-09-2019 07:52:00,1,3442.0,3066.0,0.891,16.954,65,34,13,21,31,17,14,0,0.0,0.0
1002,2768,27-09-2019 07:54:00,1,3746.0,3335.0,0.89,18.453,44,3,0,3,41,2,39,0,0.0,0.0
1002,2769,27-09-2019 07:56:00,1,3533.0,3188.0,0.902,17.448,44,0,0,0,44,0,44,0,0.0,0.0
1002,2770,27-09-2019 07:58:00,1,3447.0,3018.0,0.876,16.922,69,22,1,21,47,0,47,0,0.0,0.0
1002,2771,27-09-2019 08:00:00,1,3241.0,2882.0,0.889,15.961,12,9,1,8,3,0,3,0,0.0,0.0
1002,2772,27-09-2019 08:02:00,1,3102.5,2707.0,0.8715,15.2205,7,1,0,1,6,0,6,0,0.0,0.0
1002,2773,27-09-2019 08:04:00,1,2964.0,2532.0,0.854,14.48,92,22,12,10,70,42,28,0,0.0,0.0
1002,2774,27-09-2019 08:06:00,1,2938.0,2650.0,0.902,14.511,44,0,0,0,44,0,44,0,0.0,0.0
1002,2775,27-09-2019 08:08:00,1,2978.0,2536.0,0.852,14.542,29,0,0,0,29,0,29,0,0.0,0.0
1002,2776,27-09-2019 08:10:00,1,2872.0,2473.0,0.861,14.053,38,3,1,2,35,0,35,0,0.0,0.01
1002,2777,27-09-2019 08:12:00,1,2764.0,2398.0,0.868,13.543,42,10,0,10,32,0,32,0,0.0,0.0
1002,2778,27-09-2019 08:14:00,1,2780.0,2359.0,0.848,13.566,29,11,4,7,18,6,12,0,0.0,0.0
1002,2779,27-09-2019 08:16:00,1,2672.0,2316.0,0.867,13.093,10,7,2,5,3,0,3,0,0.0,0.0
1002,2780,27-09-2019 08:18:00,1,2563.0,2218.0,0.865,12.556,22,1,0,1,21,9,12,0,0.0,0.0
1002,2781,27-09-2019 08:20:00,1,2564.0,2230.0,0.869,12.573,24,16,3,13,8,2,6,0,0.0,0.0
1002,2782,27-09-2019 08:22:00,1,2557.0,2248.0,0.879,12.565,132,60,40,20,72,46,26,2,0.0,0.0
1002,2783,27-09-2019 08:24:00,1,2769.0,2398.0,0.866,13.564,67,29,4,25,38,18,20,0,0.0,0.0
1002,2784,27-09-2019 08:26:00,1,2743.0,2467.0,0.899,13.538,85,45,19,26,40,15,25,0,0.0,0.0
1002,2785,27-09-2019 08:28:00,1,2946.0,2629.0,0.892,14.518,144,26,20,6,118,93,25,0,0.0,0.0
1002,2786,27-09-2019 08:30:00,1,2972.0,2569.0,0.865,14.553,0,0,0,0,0,0,0,0,0.0,0.0
1002,2787,27-09-2019 08:32:00,1,2772.0,2370.0,0.855,13.547,10,0,0,0,10,10,0,0,0.0,0.0
1002,2788,27-09-2019 08:34:00,1,2777.0,2373.0,0.855,13.567,14,0,0,0,14,0,14,0,0.0,0.0
1002,2789,27-09-2019 08:36:00,1,2811.5,2440.5,0.868,13.7785,117,61,44,17,56,31,25,29,0.0,0.0
1002,2790,27-09-2019 08:38:00,1,2846.0,2508.0,0.881,13.99,134,46,27,19,88,43,45,52,0.0,0.0
1002,2791,27-09-2019 08:40:00,1,2933.0,2719.0,0.927,14.565,102,65,31,34,37,8,29,70,0.0,0.0
1002,2792,27-09-2019 08:42:00,1,3255.0,2807.0,0.862,15.93,72,42,14,28,30,4,26,58,0.0,0.0
1002,2793,27-09-2019 08:44:00,1,3235.0,2937.0,0.908,15.998,65,39,18,21,26,7,19,59,0.0,0.06
1002,2794,27-09-2019 08:46:00,1,3334.0,3031.0,0.909,16.492,74,51,31,20,23,9,14,54,0.0,0.02
1002,2795,27-09-2019 08:48:00,1,3618.0,3316.0,0.916,17.926,117,80,55,25,37,6,31,65,0.01,0.0
1002,2796,27-09-2019 08:50:00,1,3936.0,3426.0,0.87,19.301,45,26,17,9,19,7,12,52,0.0,0.07
1002,2797,27-09-2019 08:52:00,1,3609.0,3372.0,0.934,17.952,177,79,52,27,98,62,36,24,0.15,0.04
1002,2798,27-09-2019 08:54:00,1,3257.0,2802.0,0.86,15.935,116,72,51,21,44,24,20,25,0.0,0.05
1002,2799,27-09-2019 08:56:00,1,3625.0,3245.0,0.895,17.873,184,100,73,27,84,53,31,40,0.0,0.0
1002,2800,27-09-2019 08:58:00,1,3727.0,3329.0,0.893,18.37,83,57,37,20,26,0,26,59,0.0,0.0
1002,2801,27-09-2019 09:00:00,1,3935.0,3520.0,0.895,19.401,84,65,47,18,19,5,14,69,0.01,0.0
1002,2802,27-09-2019 09:02:00,1,3964.0,3464.0,0.874,19.453,143,72,45,27,71,36,35,30,0.17,0.06
1002,2803,27-09-2019 09:04:00,1,3441.0,3085.0,0.897,16.974,12,4,3,1,8,3,5,0,0.01,0.01
1002,2804,27-09-2019 09:06:00,1,3353.0,2975.0,0.887,16.505,0,0,0,0,0,0,0,0,0.0,0.0
1002,2805,27-09-2019 09:08:00,1,3430.0,3129.0,0.912,16.977,0,0,0,0,0,0,0,0,0.0,0.0
1002,2806,27-09-2019 09:10:00,1,3440.5,3102.0,0.9015,16.9885,48,16,8,8,32,17,15,0,0.0,0.0
1002,2807,27-09-2019 09:12:00,1,3451.0,3075.0,0.891,17.0,12,1,1,0,11,1,10,0,0.0,0.0
1002,2808,27-09-2019 09:14:00,1,3235.0,2856.0,0.883,15.908,9,7,2,5,2,1,1,0,0.0,0.0
1002,2809,27-09-2019 09:16:00,1,3163.0,2710.0,0.857,15.463,2,2,1,1,0,0,0,0,0.0,0.0
1002,2810,27-09-2019 09:18:00,1,2944.0,2643.0,0.898,14.524,0,0,0,0,0,0,0,0,0.0,0.0
1002,2811,27-09-2019 09:20:00,1,2949.0,2600.0,0.882,14.499,0,0,0,0,0,0,0,0,0.0,0.0
1002,2812,27-09-2019 09:22:00,1,2933.0,2670.0,0.91,14.511,0,0,0,0,0,0,0,0,0.0,0.0
1002,2813,27-09-2019 09:24:00,1,2963.0,2585.0,0.872,14.537,0,0,0,0,0,0,0,0,0.0,0.0
1002,2814,27-09-2019 09:26:00,1,2726.0,2497.0,0.916,13.504,11,2,1,1,9,2,7,0,0.01,0.0
1002,2815,27-09-2019 09:28:00,1,2554.0,2330.0,0.912,12.644,15,2,1,1,13,0,13,0,0.0,0.0
1002,2816,27-09-2019 09:30:00,1,2656.0,2378.0,0.895,13.097,0,0,0,0,0,0,0,0,0.0,0.0
1002,2817,27-09-2019 09:32:00,1,2544.0,2326.0,0.914,12.597,1,1,0,1,0,0,0,0,0.0,0.01
1002,2818,27-09-2019 09:34:00,1,2567.0,2257.0,0.88,12.611,0,0,0,0,0,0,0,0,0.0,0.0
1002,2819,27-09-2019 09:36:00,1,2574.0,2175.0,0.845,12.55,149,34,16,18,115,91,24,0,0.0,0.0
1002,2820,27-09-2019 09:38:00,1,2749.0,2497.0,0.908,13.597,286,110,72,38,176,129,47,24,0.0,0.0
1002,2821,27-09-2019 09:40:00,1,2923.0,2711.0,0.927,14.517,119,84,49,35,35,13,22,42,0.0,0.0
1002,2822,27-09-2019 09:42:00,1,3231.0,2913.0,0.902,15.953,67,44,24,20,23,8,15,54,0.0,0.0
1002,2823,27-09-2019 09:44:00,1,3225.0,2940.5,0.912,15.961,45,30,14,16,15,3,12,50,0.0,0.0
1002,2824,27-09-2019 09:46:00,1,3219.0,2968.0,0.922,15.969,109,73,38,35,36,14,22,52,0.0,0.0
1002,2825,27-09-2019 09:48:00,1,3222.0,2976.0,0.924,15.99,60,41,22,19,19,8,11,51,0.0,0.0
1002,2826,27-09-2019 09:50:00,1,3199.0,3032.0,0.948,15.962,107,61,34,27,46,23,23,37,0.1,0.17
1002,2827,27-09-2019 09:52:00,1,3209.0,3065.0,0.955,16.037,354,238,180,58,116,73,43,29,0.02,0.05
1002,2828,27-09-2019 09:54:00,1,3517.0,3187.0,0.906,17.387,702,386,313,73,316,242,74,5,0.0,0.03
1002,2829,27-09-2019 09:56:00,1,3395.0,3222.0,0.949,16.944,763,416,350,66,347,260,87,28,0.0,0.0
1002,2830,27-09-2019 09:58:00,1,3412.0,3198.0,0.937,16.985,86,33,15,18,53,15,38,58,0.0,0.0
1002,2831,27-09-2019 10:00:00,1,3597.0,3368.0,0.936,17.901,165,68,44,24,97,57,40,41,0.05,0.0
1002,2832,27-09-2019 10:02:00,1,3629.0,3278.0,0.903,17.928,536,287,222,65,249,194,55,47,0.01,0.04
1002,2833,27-09-2019 10:04:00,1,3415.0,3190.0,0.934,16.988,276,127,88,39,149,106,43,1,0.0,0.0
1002,2834,27-09-2019 10:06:00,1,3454.0,3058.0,0.885,16.995,536,329,255,74,207,153,54,2,0.0,0.01
1002,2835,27-09-2019 10:08:00,1,3055.0,2721.0,0.89,15.05,89,54,32,22,35,19,16,2,0.0,0.0
1002,2836,27-09-2019 10:10:00,1,3438.0,3065.0,0.891,16.939,205,98,51,47,107,68,39,6,0.0,0.0
1002,2837,27-09-2019 10:12:00,1,3508.0,3269.0,0.932,17.441,37,9,2,7,28,1,27,0,0.0,0.0
1002,2838,27-09-2019 10:14:00,1,3410.0,3194.0,0.937,16.971,65,17,0,17,48,13,35,0,0.0,0.0
1002,2839,27-09-2019 10:16:00,1,3398.0,3206.0,0.943,16.938,99,40,16,24,59,27,32,0,0.0,0.0
1002,2840,27-09-2019 10:18:00,1,3326.0,3019.5,0.9065,16.4485,20,14,2,12,6,0,6,0,0.0,0.0
1002,2841,27-09-2019 10:20:00,1,3254.0,2833.0,0.87,15.959,0,0,0,0,0,0,0,0,0.0,0.0
1002,2842,27-09-2019 10:22:00,1,3172.0,2707.0,0.853,15.496,0,0,0,0,0,0,0,0,0.0,0.0
1002,2843,27-09-2019 10:24:00,1,2952.0,2594.0,0.879,14.503,0,0,0,0,0,0,0,0,0.0,0.0
1002,2844,27-09-2019 10:26:00,1,2970.0,2560.0,0.862,14.535,21,11,3,8,10,2,8,0,0.0,0.0
1002,2845,27-09-2019 10:28:00,1,2956.0,2590.0,0.876,14.516,1,0,0,0,1,0,1,0,0.0,0.0
1002,2846,27-09-2019 10:30:00,1,2985.0,2545.0,0.853,14.58,1,0,0,0,1,0,1,0,0.0,0.0
1002,2847,27-09-2019 10:32:00,1,2762.0,2437.0,0.882,13.58,8,0,0,0,8,2,6,0,0.0,0.0
1002,2848,27-09-2019 10:34:00,1,2749.0,2438.0,0.887,13.531,9,0,0,0,9,0,9,0,0.0,0.0
1002,2849,27-09-2019 10:36:00,1,2778.0,2362.0,0.85,13.56,20,0,0,0,20,1,19,0,0.0,0.0
1002,2850,27-09-2019 10:38:00,1,2545.0,2332.0,0.917,12.608,27,1,0,1,26,12,14,0,0.0,0.0
1002,2851,27-09-2019 10:40:00,1,2563.0,2231.0,0.87,12.568,5,0,0,0,5,3,2,0,0.0,0.0
1002,2852,27-09-2019 10:42:00,1,2468.0,2176.0,0.882,12.133,8,0,0,0,8,0,8,0,0.0,0.0
1002,2853,27-09-2019 10:44:00,1,2351.0,2137.0,0.909,11.627,53,24,16,8,29,10,19,0,0.0,0.0
1002,2854,27-09-2019 10:46:00,1,2545.0,2334.0,0.917,12.613,18,0,0,0,18,0,18,0,0.0,0.0
1002,2855,27-09-2019 10:48:00,1,2333.0,2186.0,0.937,11.612,44,1,0,1,43,4,39,0,0.01,0.0
1002,2856,27-09-2019 10:50:00,1,2233.0,2115.0,0.947,11.139,20,1,1,0,19,2,17,0,0.0,0.0
1002,2857,27-09-2019 10:52:00,1,2293.0,2126.5,0.928,11.388,26,8,6,2,18,9,9,0,0.0,0.0
1002,2858,27-09-2019 10:54:00,1,2353.0,2138.0,0.909,11.637,20,1,0,1,19,1,18,0,0.0,0.0
1002,2859,27-09-2019 10:56:00,1,2439.0,2241.0,0.919,12.093,3,0,0,0,3,0,3,0,0.0,0.0
1002,2860,27-09-2019 10:58:00,1,2430.0,2241.0,0.922,12.054,12,1,0,1,11,2,9,0,0.0,0.0
1002,2861,27-09-2019 11:00:00,1,2446.0,2258.0,0.923,12.136,32,1,0,1,31,0,31,0,0.0,0.0
1002,2862,27-09-2019 11:02:00,1,2331.0,2222.0,0.954,11.643,22,7,5,2,15,8,7,0,0.0,0.0
1002,2863,27-09-2019 11:04:00,1,2433.0,2252.0,0.926,12.081,0,0,0,0,0,0,0,0,0.0,0.0
1002,2864,27-09-2019 11:06:00,1,2216.0,2178.0,0.983,11.144,1,0,0,0,1,0,1,0,0.0,0.0
1002,2865,27-09-2019 11:08:00,1,2243.0,2069.0,0.922,11.127,1,1,0,1,0,0,0,0,0.0,0.0
1002,2866,27-09-2019 11:10:00,1,2268.0,2005.0,0.884,11.154,0,0,0,0,0,0,0,0,0.0,0.0
1002,2867,27-09-2019 11:12:00,1,2264.0,1989.0,0.879,11.122,1,0,0,0,1,0,1,0,0.0,0.0
1002,2868,27-09-2019 11:14:00,1,2034.0,1922.0,0.945,10.144,68,35,20,15,33,17,16,0,0.01,0.0
1002,2869,27-09-2019 11:16:00,1,2217.0,2196.0,0.991,11.165,61,27,7,20,34,11,23,0,0.0,0.0
1002,2870,27-09-2019 11:18:00,1,2540.0,2300.0,0.905,12.554,117,47,21,26,70,32,38,0,0.0,0.0
1002,2871,27-09-2019 11:20:00,1,2737.0,2545.0,0.93,13.602,58,31,13,18,27,11,16,0,0.0,0.0
1002,2872,27-09-2019 11:22:00,1,2730.0,2493.0,0.913,13.517,26,7,2,5,19,4,15,0,0.0,0.0
1002,2873,27-09-2019 11:24:00,1,2546.0,2331.0,0.916,12.614,51,11,0,11,40,0,40,0,0.0,0.0
1002,2874,27-09-2019 11:26:00,1,2639.0,2439.0,0.924,13.0995,69,21,9,12,48,22,26,12,0.0,0.0
1002,2875,27-09-2019 11:28:00,1,2732.0,2547.0,0.932,13.585,62,43,25,18,19,3,16,54,0.0,0.0
1002,2876,27-09-2019 11:30:00,1,2919.0,2735.0,0.937,14.529,54,32,12,20,22,6,16,48,0.0,0.03
1002,2877,27-09-2019 11:32:00,1,3115.0,2862.0,0.919,15.443,57,38,18,20,19,1,18,52,0.0,0.04
1002,2878,27-09-2019 11:34:00,1,3205.0,3040.0,0.949,15.992,49,25,8,17,24,3,21,55,0.0,0.01
1002,2879,27-09-2019 11:36:00,1,3415.0,3180.0,0.931,16.974,65,46,18,28,19,4,15,45,0.0,0.06
1002,2880,27-09-2019 11:38:00,1,3418.0,3147.0,0.921,16.95,141,81,53,28,60,34,26,55,0.11,0.08
1002,2881,27-09-2019 11:40:00,1,3235.0,2943.0,0.91,16.006,167,132,78,54,35,16,19,46,0.0,0.1
1002,2882,27-09-2019 11:42:00,1,3501.0,3267.0,0.933,17.411,87,52,28,24,35,14,21,67,0.02,0.0
1002,2883,27-09-2019 11:44:00,1,3370.0,3296.0,0.978,16.928,35,8,4,4,27,14,13,0,0.1,0.0
1002,2884,27-09-2019 11:46:00,1,3368.0,3308.0,0.982,16.933,260,130,94,36,130,96,34,1,0.01,0.0
1002,2885,27-09-2019 11:48:00,1,3391.0,3268.0,0.964,16.977,802,456,371,85,346,274,72,5,0.0,0.18
1002,2886,27-09-2019 11:50:00,1,3613.0,3405.0,0.942,18.005,544,308,244,64,236,170,66,5,0.07,0.0
1002,2887,27-09-2019 11:52:00,1,3389.0,3283.0,0.969,16.986,85,45,29,16,40,26,14,0,0.0,0.0
1002,2888,27-09-2019 11:54:00,1,3499.0,3330.0,0.952,17.472,253,129,89,40,124,89,35,10,0.0,0.18
1002,2889,27-09-2019 11:56:00,1,3898.0,3679.0,0.944,19.432,86,33,17,16,53,24,29,38,0.0,0.0
1002,2890,27-09-2019 11:58:00,1,3795.0,3485.0,0.918,18.81,85,66,39,27,19,3,16,66,0.0,0.0
1002,2891,27-09-2019 12:00:00,1,3603.5,3321.0,0.9215,17.8745,86,47,24,23,39,23,16,16,0.1,0.0
1002,2892,27-09-2019 12:02:00,1,3412.0,3157.0,0.925,16.939,31,15,0,15,16,1,15,0,0.0,0.0
1002,2893,27-09-2019 12:04:00,1,3450.0,3104.0,0.9,17.03,18,7,2,5,11,3,8,0,0.0,0.0
1002,2894,27-09-2019 12:06:00,1,3434.0,3167.0,0.922,17.034,12,3,1,2,9,0,9,0,0.0,0.0
1002,2895,27-09-2019 12:08:00,1,3215.0,2953.0,0.919,15.934,3,0,0,0,3,0,3,0,0.0,0.0
1002,2896,27-09-2019 12:10:00,1,3255.0,2848.0,0.875,15.979,3,0,0,0,3,0,3,0,0.02,0.0
1002,2897,27-09-2019 12:12:00,1,2935.0,2664.0,0.908,14.513,18,10,7,3,8,2,6,0,0.0,0.0
1002,2898,27-09-2019 12:14:00,1,2939.0,2680.0,0.912,14.548,14,4,1,3,10,4,6,0,0.0,0.0
1002,2899,27-09-2019 12:16:00,1,2850.0,2501.0,0.877,13.996,0,0,0,0,0,0,0,0,0.0,0.0
1002,2900,27-09-2019 12:18:00,1,2750.0,2481.0,0.902,13.58,4,4,0,4,0,0,0,0,0.0,0.0
1002,2901,27-09-2019 12:20:00,1,2762.0,2442.0,0.884,13.584,16,14,7,7,2,0,2,0,0.0,0.0
1002,2902,27-09-2019 12:22:00,1,2737.0,2453.0,0.896,13.501,46,3,1,2,43,2,41,0,0.0,0.0
1002,2903,27-09-2019 12:24:00,1,2783.0,2395.0,0.861,13.615,31,0,0,0,31,0,31,0,0.0,0.0
1002,2904,27-09-2019 12:26:00,1,2662.0,2362.0,0.887,13.103,19,0,0,0,19,0,19,0,0.0,0.0
1002,2905,27-09-2019 12:28:00,1,2554.0,2301.0,0.901,12.611,46,0,0,0,46,0,46,0,0.0,0.0
1002,2906,27-09-2019 12:30:00,1,2568.0,2276.0,0.886,12.638,147,40,22,18,107,64,43,0,0.0,0.0
1002,2907,27-09-2019 12:32:00,1,2826.0,2590.0,0.916,14.002,106,56,34,22,50,24,26,45,0.0,0.0
1002,2908,27-09-2019 12:34:00,1,2858.5,2709.0,0.947,14.2625,281,93,50,43,188,139,49,0,0.07,0.0
1002,2909,27-09-2019 12:36:00,1,2891.0,2828.0,0.978,14.523,567,335,270,65,232,173,59,1,0.03,0.0
1002,2910,27-09-2019 12:38:00,1,3233.0,2974.0,0.92,16.029,587,310,241,69,277,214,63,15,0.0,0.0
1002,2911,27-09-2019 12:40:00,1,3199.0,3044.0,0.952,15.973,57,49,29,20,8,3,5,57,0.0,0.0
1002,2912,27-09-2019 12:42:00,1,3181.0,3127.0,0.983,15.994,81,48,21,27,33,14,19,39,0.0,0.0
1002,2913,27-09-2019 12:44:00,1,3396.0,3194.0,0.941,16.916,52,36,20,16,16,1,15,51,0.0,0.0
1002,2914,27-09-2019 12:46:00,1,3407.0,3239.0,0.951,17.011,313,157,110,47,156,108,48,9,0.07,0.0
1002,2915,27-09-2019 12:48:00,1,3405.0,3143.0,0.923,16.893,435,245,197,48,190,147,43,98,0.0,0.0
1002,2916,27-09-2019 12:50:00,1,2912.0,2820.0,0.968,14.595,480,273,215,58,207,153,54,12,0.01,0.0
1003,1,23-09-2019 11:40:00,1,3914.0,2959.0,0.756,18.699,77,51,25,26,26,5,21,3,0.0,0.0
1003,2,23-09-2019 11:42:00,1,3826.0,2853.0,0.7455,18.234,73,42,19,23,31,5,26,13,0.0,0.05
1003,3,23-09-2019 11:44:00,1,3738.0,2747.0,0.735,17.769,147,122,79,43,25,15,10,13,0.0,0.0
1003,4,23-09-2019 11:46:00,1,3712.0,2830.0,0.762,17.757,180,120,84,36,60,32,28,5,0.0,0.0
1003,5,23-09-2019 11:48:00,1,3192.0,2431.0,0.762,15.27,81,59,33,26,22,3,19,15,0.0,0.0
1003,6,23-09-2019 11:50:00,1,3071.0,2405.0,0.783,14.764,88,62,29,33,26,8,18,11,0.0,0.0
1003,7,23-09-2019 11:52:00,1,2850.0,2312.0,0.811,13.791,62,59,26,33,3,0,3,19,0.0,0.0
1003,8,23-09-2019 11:54:00,1,2850.0,2331.0,0.818,13.81,58,57,36,21,1,0,1,4,0.0,0.04
1003,9,23-09-2019 11:56:00,1,2653.0,2111.0,0.796,12.792,35,23,10,13,12,0,12,0,0.0,0.0
1003,10,23-09-2019 11:58:00,1,2554.0,2002.0,0.784,12.278,31,23,9,14,8,0,8,2,0.0,0.0
1003,11,23-09-2019 12:00:00,1,2570.0,2001.0,0.779,12.341,67,48,22,26,19,4,15,2,0.0,0.0
1003,12,23-09-2019 12:02:00,1,2619.0,2217.0,0.847,12.775,212,155,113,42,57,36,21,11,0.0,0.0
1003,13,23-09-2019 12:04:00,1,2654.0,2129.0,0.802,12.812,10,10,2,8,0,0,0,0,0.0,0.0
1003,14,23-09-2019 12:06:00,1,2455.0,1900.0,0.774,11.776,48,41,12,29,7,0,7,4,0.0,0.0
1003,15,23-09-2019 12:08:00,1,2673.0,2092.0,0.783,12.847,38,18,4,14,20,0,20,0,0.0,0.0
1003,16,23-09-2019 12:10:00,1,2431.0,1968.0,0.81,11.757,43,24,2,22,19,0,19,0,0.0,0.0
1003,17,23-09-2019 12:12:00,1,2446.0,1973.0,0.807,11.82,1,0,0,0,1,0,1,0,0.0,0.0
1003,18,23-09-2019 12:14:00,1,2347.0,1874.0,0.798,11.32,0,0,0,0,0,0,0,0,0.0,0.0
1003,19,23-09-2019 12:16:00,1,2253.5,1762.5,0.781,10.828,29,26,6,20,3,0,3,0,0.0,0.0
1003,20,23-09-2019 12:18:00,1,2160.0,1651.0,0.764,10.336,9,7,0,7,2,0,2,0,0.0,0.0
1003,21,23-09-2019 12:20:00,1,1946.0,1522.0,0.782,9.353,2,1,0,1,1,0,1,0,0.0,0.0
1003,22,23-09-2019 12:22:00,1,1971.0,1449.0,0.735,9.372,2,2,1,1,0,0,0,0,0.0,0.0
1003,23,23-09-2019 12:24:00,1,1963.0,1453.0,0.74,9.344,16,11,3,8,5,0,5,0,0.0,0.0
1003,24,23-09-2019 12:26:00,1,1848.0,1423.0,0.77,8.858,2,1,0,1,1,0,1,0,0.0,0.0
1003,25,23-09-2019 12:28:00,1,1743.0,1378.0,0.791,8.393,2,2,0,2,0,0,0,0,0.0,0.0
1003,26,23-09-2019 12:30:00,1,1732.0,1377.0,0.795,8.349,0,0,0,0,0,0,0,0,0.0,0.0
1003,27,23-09-2019 12:32:00,1,1737.0,1388.0,0.799,8.381,8,7,4,3,1,0,1,0,0.0,0.0
1003,28,23-09-2019 12:34:00,1,2036.0,1660.0,0.815,9.861,121,94,53,41,27,12,15,20,0.0,0.0
1003,29,23-09-2019 12:36:00,1,2665.0,2084.0,0.782,12.808,184,139,105,34,45,29,16,40,0.0,0.0
1003,30,23-09-2019 12:38:00,1,2231.0,1843.0,0.826,10.832,208,129,98,31,79,54,25,135,0.0,0.0
1003,31,23-09-2019 12:40:00,1,1917.0,1631.0,0.851,9.357,223,128,93,35,95,71,24,61,0.0,0.0
1003,32,23-09-2019 12:42:00,1,2756.0,2213.0,0.803,13.307,108,51,34,17,57,28,29,46,0.0,0.0
1003,33,23-09-2019 12:44:00,1,3165.0,2512.0,0.794,15.25,105,63,27,36,42,13,29,47,0.0,0.0
1003,34,23-09-2019 12:46:00,1,3163.0,2466.0,0.78,15.191,106,37,12,25,69,37,32,52,0.0,0.0
1003,35,23-09-2019 12:48:00,1,3264.0,2639.0,0.808,15.783,105,24,12,12,81,30,51,30,0.0,0.0
1003,36,23-09-2019 12:50:00,1,2938.5,2449.0,0.8365,14.289,116,85,59,26,31,18,13,52,0.0,0.0
1003,37,23-09-2019 12:52:00,1,2613.0,2259.0,0.865,12.795,109,59,34,25,50,31,19,15,0.0,0.0
1003,38,23-09-2019 12:54:00,1,2645.0,2171.0,0.821,12.824,146,92,65,27,54,33,21,14,0.0,0.0
1003,39,23-09-2019 12:56:00,1,1926.0,1577.0,0.819,9.337,189,153,119,34,36,24,12,44,0.0,0.0
1003,40,23-09-2019 12:58:00,1,2011.0,1733.0,0.862,9.84,109,46,28,18,63,33,30,6,0.04,0.0
1003,41,23-09-2019 13:00:00,1,1908.0,1672.0,0.877,9.369,161,96,73,23,65,43,22,7,0.0,0.0
1003,42,23-09-2019 13:02:00,1,2093.0,1896.0,0.906,10.345,169,111,75,36,58,40,18,69,0.0,0.0
1003,43,23-09-2019 13:04:00,1,2619.0,2276.0,0.869,12.838,115,86,48,38,29,11,18,11,0.0,0.0
1003,44,23-09-2019 13:06:00,1,2081.0,1931.0,0.928,10.337,121,67,48,19,54,28,26,44,0.0,0.0
1003,45,23-09-2019 13:08:00,1,2012.0,1760.0,0.875,9.876,147,96,58,38,51,30,21,6,0.0,0.01
1003,46,23-09-2019 13:10:00,1,1887.0,1764.0,0.935,9.388,236,138,105,33,98,64,34,23,0.0,0.01
1003,47,23-09-2019 13:12:00,1,2196.0,1975.0,0.899,10.839,78,61,31,30,17,8,9,11,0.0,0.0
1003,48,23-09-2019 13:14:00,1,2412.0,2128.0,0.882,11.861,66,46,18,28,20,3,17,3,0.0,0.0
1003,49,23-09-2019 13:16:00,1,2632.0,2185.0,0.83,12.79,28,23,8,15,5,2,3,2,0.0,0.0
1003,50,23-09-2019 13:18:00,1,2085.0,1963.0,0.942,10.388,32,17,4,13,15,0,15,0,0.0,0.0
1003,51,23-09-2019 13:20:00,1,2084.0,1902.0,0.913,10.319,60,53,23,30,7,1,6,0,0.0,0.0
1003,52,23-09-2019 13:22:00,1,1915.0,1638.0,0.856,9.357,0,0,0,0,0,0,0,0,0.0,0.0
1003,53,23-09-2019 13:24:00,1,1765.5,1498.5,0.8485,8.6145,0,0,0,0,0,0,0,0,0.0,0.0
1003,54,23-09-2019 13:26:00,1,1616.0,1359.0,0.841,7.872,1,1,1,0,0,0,0,0,0.0,0.0
1003,55,23-09-2019 13:28:00,1,1389.0,1292.0,0.93,6.901,0,0,0,0,0,0,0,0,0.0,0.0
1003,56,23-09-2019 13:30:00,1,1510.0,1314.0,0.871,7.404,42,34,24,10,8,4,4,1,0.0,0.0
1003,57,23-09-2019 13:32:00,1,1893.0,1724.0,0.911,9.369,32,31,11,20,1,0,1,4,0.0,0.0
1003,58,23-09-2019 13:34:00,1,2121.0,1833.0,0.864,10.388,48,33,17,16,15,5,10,8,0.0,0.0
1003,59,23-09-2019 13:36:00,1,2086.0,1915.0,0.918,10.34,169,109,84,25,60,39,21,9,0.0,0.0
1003,60,23-09-2019 13:38:00,1,1908.0,1656.0,0.868,9.353,12,12,0,12,0,0,0,0,0.0,0.0
1003,61,23-09-2019 13:40:00,1,1699.0,1525.0,0.898,8.384,7,6,0,6,1,0,1,0,0.0,0.0
1003,62,23-09-2019 13:42:00,1,1595.0,1450.0,0.909,7.889,1,0,0,0,1,1,0,0,0.0,0.0
1003,63,23-09-2019 13:44:00,1,1618.0,1383.0,0.855,7.904,18,2,0,2,16,2,14,0,0.0,0.0
1003,64,23-09-2019 13:46:00,1,1622.0,1346.0,0.83,7.88,21,1,0,1,20,3,17,0,0.0,0.0
1003,65,23-09-2019 13:48:00,1,1624.0,1344.0,0.827,7.887,26,22,9,13,4,0,4,0,0.0,0.0
1003,66,23-09-2019 13:50:00,1,1611.0,1405.0,0.872,7.903,0,0,0,0,0,0,0,0,0.0,0.0
1003,67,23-09-2019 13:52:00,1,1627.0,1340.0,0.824,7.895,0,0,0,0,0,0,0,0,0.0,0.0
1003,68,23-09-2019 13:54:00,1,1618.0,1352.0,0.836,7.871,0,0,0,0,0,0,0,0,0.0,0.0
1003,69,23-09-2019 13:56:00,1,1605.0,1409.0,0.878,7.883,1,0,0,0,1,0,1,0,0.0,0.0
1003,70,23-09-2019 13:58:00,1,1607.5,1400.0,0.871,7.883,1,0,0,0,1,0,1,0,0.0,0.0
1003,71,23-09-2019 14:00:00,1,1610.0,1391.0,0.864,7.883,7,3,0,3,4,0,4,0,0.0,0.0
1003,72,23-09-2019 14:02:00,1,1711.0,1462.0,0.854,8.36,15,7,1,6,8,2,6,0,0.0,0.0
1003,73,23-09-2019 14:04:00,1,1600.0,1432.0,0.895,7.891,47,28,13,15,19,1,18,1,0.0,0.0
1003,74,23-09-2019 14:06:00,1,1703.0,1502.0,0.882,8.375,34,28,15,13,6,0,6,0,0.0,0.0
1003,75,23-09-2019 14:08:00,1,1617.0,1366.0,0.845,7.882,0,0,0,0,0,0,0,0,0.0,0.0
1003,76,23-09-2019 14:10:00,1,1512.0,1323.0,0.875,7.424,0,0,0,0,0,0,0,0,0.0,0.0
1003,77,23-09-2019 14:12:00,1,1392.0,1285.0,0.923,6.908,0,0,0,0,0,0,0,0,0.0,0.0
1003,78,23-09-2019 14:14:00,1,1397.0,1256.0,0.9,6.894,0,0,0,0,0,0,0,0,0.0,0.0
1003,79,23-09-2019 14:16:00,1,1404.0,1227.0,0.874,6.89,0,0,0,0,0,0,0,0,0.0,0.0
1003,80,23-09-2019 14:18:00,1,1407.0,1227.0,0.872,6.904,0,0,0,0,0,0,0,0,0.0,0.0
1003,81,23-09-2019 14:20:00,1,1515.0,1288.0,0.85,7.393,6,6,2,4,0,0,0,0,0.0,0.0
1003,82,23-09-2019 14:22:00,1,1414.0,1188.0,0.841,6.885,3,3,1,2,0,0,0,0,0.0,0.0
1003,83,23-09-2019 14:24:00,1,1321.0,1088.0,0.823,6.41,16,14,8,6,2,0,2,0,0.0,0.0
1003,84,23-09-2019 14:26:00,1,1620.0,1366.0,0.843,7.894,70,54,31,23,16,1,15,20,0.0,0.0
1003,85,23-09-2019 14:28:00,1,2114.0,1825.0,0.863,10.351,104,32,8,24,72,26,46,29,0.0,0.0
1003,86,23-09-2019 14:30:00,1,2646.0,2141.0,0.809,12.796,93,31,11,20,62,25,37,36,0.0,0.0
1003,87,23-09-2019 14:32:00,1,2725.5,2325.5,0.852,13.3125,144,17,5,12,127,69,58,25,0.0,0.0
1003,88,23-09-2019 14:34:00,1,2805.0,2510.0,0.895,13.829,144,81,58,23,63,40,23,22,0.0,0.01
1003,89,23-09-2019 14:36:00,1,1919.0,1620.0,0.844,9.354,141,80,51,29,61,36,25,73,0.0,0.0
1003,90,23-09-2019 14:38:00,1,2604.0,2294.0,0.881,12.799,123,33,11,22,90,52,38,35,0.0,0.01
1003,91,23-09-2019 14:40:00,1,2814.0,2463.0,0.875,13.816,93,28,1,27,65,30,35,14,0.0,0.06
1003,92,23-09-2019 14:42:00,1,2778.0,2599.0,0.936,13.822,115,74,53,21,41,30,11,53,0.0,0.05
1003,93,23-09-2019 14:44:00,1,2563.0,2488.0,0.971,12.851,201,117,84,33,84,64,20,18,0.0,0.0
1003,94,23-09-2019 14:46:00,1,2380.0,2199.0,0.924,11.81,152,108,72,36,44,31,13,91,0.0,0.03
1003,95,23-09-2019 14:48:00,1,2176.0,2061.0,0.947,10.853,108,56,25,31,52,33,19,32,0.0,0.0
1003,96,23-09-2019 14:50:00,1,1904.0,1689.0,0.887,9.371,7,5,1,4,2,1,1,56,0.0,0.0
1003,97,23-09-2019 14:52:00,1,1579.0,1500.0,0.95,7.88,37,20,15,5,17,13,4,53,0.0,0.0
1003,98,23-09-2019 14:54:00,1,1575.0,1532.0,0.973,7.903,0,0,0,0,0,0,0,14,0.0,0.0
1003,99,23-09-2019 14:56:00,1,1681.0,1611.0,0.958,8.409,0,0,0,0,0,0,0,6,0.0,0.0
1003,100,23-09-2019 14:58:00,1,1776.0,1672.0,0.941,8.849,0,0,0,0,0,0,0,0,0.0,0.0
1003,101,23-09-2019 15:00:00,1,2156.0,2145.0,0.995,10.871,0,0,0,0,0,0,0,0,0.0,0.0
1003,102,23-09-2019 15:02:00,1,2038.0,2121.0,1.041,10.376,0,0,0,0,0,0,0,2,0.0,0.0
1003,103,23-09-2019 15:04:00,1,1829.0,1947.0,1.065,9.361,0,0,0,0,0,0,0,1,0.0,0.0
1003,104,23-09-2019 15:06:00,1,1856.5,1848.0,0.997,9.3595,0,0,0,0,0,0,0,0,0.0,0.0
1003,105,23-09-2019 15:08:00,1,1884.0,1749.0,0.929,9.358,0,0,0,0,0,0,0,0,0.0,0.0
1003,106,23-09-2019 15:10:00,1,1673.0,1644.0,0.983,8.41,0,0,0,0,0,0,0,1,0.0,0.0
1003,107,23-09-2019 15:12:00,1,1678.0,1597.0,0.952,8.38,0,0,0,0,0,0,0,0,0.0,0.0
1003,108,23-09-2019 15:14:00,1,1683.0,1584.0,0.941,8.385,0,0,0,0,0,0,0,1,0.0,0.0
1003,109,23-09-2019 15:16:00,1,1681.0,1591.0,0.947,8.385,0,0,0,0,0,0,0,8,0.0,0.0
1003,110,23-09-2019 15:18:00,1,1662.0,1656.0,0.997,8.38,0,0,0,0,0,0,0,10,0.0,0.0
1003,111,23-09-2019 15:20:00,1,1665.0,1641.0,0.985,8.378,0,0,0,0,0,0,0,0,0.0,0.0
1003,112,23-09-2019 15:22:00,1,1686.0,1576.0,0.935,8.39,0,0,0,0,0,0,0,0,0.0,0.0
1003,113,23-09-2019 15:24:00,1,1685.0,1558.0,0.925,8.362,0,0,0,0,0,0,0,1,0.0,0.0
1003,114,23-09-2019 15:26:00,1,1688.0,1553.0,0.92,8.371,0,0,0,0,0,0,0,1,0.0,0.0
1003,115,23-09-2019 15:28:00,1,1701.0,1514.0,0.89,8.376,0,0,0,0,0,0,0,3,0.0,0.0
1003,116,23-09-2019 15:30:00,1,1702.0,1511.0,0.888,8.378,0,0,0,0,0,0,0,17,0.0,0.0
1003,117,23-09-2019 15:32:00,1,1469.0,1449.0,0.987,7.392,0,0,0,0,0,0,0,0,0.0,0.0
1003,118,23-09-2019 15:34:00,1,1475.0,1428.0,0.968,7.394,0,0,0,0,0,0,0,0,0.0,0.0
1003,119,23-09-2019 15:36:00,1,1475.0,1443.0,0.978,7.41,0,0,0,0,0,0,0,1,0.0,0.0
1003,120,23-09-2019 15:38:00,1,1470.0,1460.0,0.993,7.408,0,0,0,0,0,0,0,2,0.0,0.0
1003,121,23-09-2019 15:40:00,1,1470.0,1459.5,0.9925,7.407,0,0,0,0,0,0,0,1,0.0,0.0
1003,122,23-09-2019 15:42:00,1,1470.0,1459.0,0.992,7.406,0,0,0,0,0,0,0,3,0.0,0.0
1003,123,23-09-2019 15:44:00,1,1473.0,1430.0,0.97,7.387,0,0,0,0,0,0,0,15,0.0,0.0
1003,124,23-09-2019 15:46:00,1,1475.0,1446.0,0.98,7.412,0,0,0,0,0,0,0,2,0.0,0.0
1003,125,23-09-2019 15:48:00,1,1487.0,1390.0,0.935,7.398,0,0,0,0,0,0,0,8,0.0,0.0
1003,126,23-09-2019 15:50:00,1,1509.0,1314.0,0.871,7.399,0,0,0,0,0,0,0,3,0.0,0.0
1003,127,23-09-2019 15:52:00,1,1516.0,1294.0,0.853,7.405,0,0,0,0,0,0,0,12,0.0,0.0
1003,128,23-09-2019 15:54:00,1,1497.0,1354.0,0.905,7.396,0,0,0,0,0,0,0,14,0.0,0.0
1003,129,23-09-2019 15:56:00,1,1488.0,1372.0,0.922,7.38,0,0,0,0,0,0,0,7,0.0,0.0
1003,130,23-09-2019 15:58:00,1,1513.0,1305.0,0.863,7.406,0,0,0,0,0,0,0,11,0.0,0.0
1003,131,23-09-2019 16:00:00,1,1505.0,1330.0,0.884,7.401,0,0,0,0,0,0,0,0,0.0,0.0
1003,132,23-09-2019 16:02:00,1,1481.0,1414.0,0.955,7.399,0,0,0,0,0,0,0,0,0.0,0.0
1003,133,23-09-2019 16:04:00,1,1488.0,1368.0,0.919,7.378,0,0,0,0,0,0,0,0,0.0,0.0
1003,134,23-09-2019 16:06:00,1,1476.0,1432.0,0.97,7.401,0,0,0,0,0,0,0,3,0.0,0.0
1003,135,23-09-2019 16:08:00,1,1705.0,1505.0,0.882,8.384,118,80,56,24,38,19,19,13,0.0,0.0
1003,136,23-09-2019 16:10:00,1,1964.0,1924.0,0.98,9.868,71,60,31,29,11,3,8,25,0.0,0.0
1003,137,23-09-2019 16:12:00,1,2082.0,1948.0,0.936,10.358,39,27,11,16,12,5,7,4,0.0,0.0
1003,138,23-09-2019 16:14:00,1,2025.0,1935.5,0.9565,10.12,53,35,9,26,18,1,17,14,0.0,0.0
1003,139,23-09-2019 16:16:00,1,1968.0,1923.0,0.977,9.882,199,127,89,38,72,52,20,78,0.0,0.0
1003,140,23-09-2019 16:18:00,1,2201.0,1950.0,0.886,10.831,89,30,1,29,59,34,25,4,0.0,0.0
1003,141,23-09-2019 16:20:00,1,2692.0,2437.0,0.905,13.303,76,32,7,25,44,17,27,14,0.0,0.0
1003,142,23-09-2019 16:22:00,1,2672.0,2498.0,0.935,13.291,88,26,2,24,62,37,25,10,0.0,0.0
1003,143,23-09-2019 16:24:00,1,2725.0,2339.0,0.858,13.326,88,26,7,19,62,23,39,12,0.0,0.09
1003,144,23-09-2019 16:26:00,1,2782.0,2604.0,0.936,13.842,142,67,43,24,75,50,25,65,0.0,0.02
1003,145,23-09-2019 16:28:00,1,2195.0,1982.0,0.903,10.843,126,67,44,23,59,37,22,39,0.12,0.01
1003,146,23-09-2019 16:30:00,1,1969.0,1917.0,0.974,9.879,39,16,4,12,23,13,10,30,0.0,0.01
1003,147,23-09-2019 16:32:00,1,1583.0,1471.0,0.93,7.864,0,0,0,0,0,0,0,28,0.0,0.0
1003,148,23-09-2019 16:34:00,1,1705.0,1479.0,0.867,8.356,0,0,0,0,0,0,0,31,0.0,0.0
1003,149,23-09-2019 16:36:00,1,1699.0,1530.0,0.9,8.386,0,0,0,0,0,0,0,0,0.0,0.0
1003,150,23-09-2019 16:38:00,1,1698.0,1522.0,0.896,8.374,0,0,0,0,0,0,0,0,0.0,0.01
1003,151,23-09-2019 16:40:00,1,1689.0,1542.0,0.913,8.362,0,0,0,0,0,0,0,0,0.0,0.0
1003,152,23-09-2019 16:42:00,1,1763.0,1762.0,0.999,8.896,0,0,0,0,0,0,0,4,0.0,0.0
1003,153,23-09-2019 16:44:00,1,1763.0,1767.0,1.002,8.901,0,0,0,0,0,0,0,0,0.0,0.0
1003,154,23-09-2019 16:46:00,1,1865.0,1822.0,0.977,9.365,0,0,0,0,0,0,0,9,0.0,0.0
1003,155,23-09-2019 16:48:00,1,1753.5,1774.0,1.014,8.8735,0,0,0,0,0,0,0,9,0.0,0.0
1003,156,23-09-2019 16:50:00,1,1642.0,1726.0,1.051,8.382,0,0,0,0,0,0,0,0,0.0,0.0
1003,157,23-09-2019 16:52:00,1,1657.0,1683.0,1.016,8.392,0,0,0,0,0,0,0,0,0.0,0.0
1003,158,23-09-2019 16:54:00,1,1656.0,1668.0,1.007,8.371,0,0,0,0,0,0,0,15,0.0,0.0
1003,159,23-09-2019 16:56:00,1,1660.0,1663.0,1.002,8.379,0,0,0,0,0,0,0,48,0.0,0.0
1003,160,23-09-2019 16:58:00,1,1669.0,1638.0,0.982,8.39,0,0,0,0,0,0,0,15,0.0,0.0
1003,161,23-09-2019 17:00:00,1,1658.0,1679.0,1.013,8.389,0,0,0,0,0,0,0,0,0.0,0.0
1003,162,23-09-2019 17:02:00,1,1645.0,1687.0,1.025,8.351,78,46,30,16,32,19,13,10,0.0,0.0
1003,163,23-09-2019 17:04:00,1,1940.0,2046.0,1.055,9.91,2,2,0,2,0,0,0,0,0.0,0.0
1003,164,23-09-2019 17:06:00,1,1942.0,2011.0,1.036,9.877,2,2,0,2,0,0,0,0,0.0,0.0
1003,165,23-09-2019 17:08:00,1,1950.0,1971.0,1.011,9.866,11,11,0,11,0,0,0,0,0.0,0.0
1003,166,23-09-2019 17:10:00,1,1975.0,1895.0,0.96,9.878,63,53,32,21,10,2,8,0,0.0,0.0
1003,167,23-09-2019 17:12:00,1,1957.0,1949.0,0.996,9.868,1,0,0,0,1,0,1,0,0.0,0.0
1003,168,23-09-2019 17:14:00,1,1862.0,1849.0,0.993,9.382,2,0,0,0,2,0,2,0,0.0,0.0
1003,169,23-09-2019 17:16:00,1,1971.0,1919.0,0.974,9.89,5,2,1,1,3,0,3,0,0.0,0.0
1003,170,23-09-2019 17:18:00,1,1952.0,1950.0,0.999,9.851,11,4,1,3,7,0,7,0,0.0,0.0
1003,171,23-09-2019 17:20:00,1,1861.0,1853.0,0.996,9.384,26,15,0,15,11,0,11,0,0.0,0.0
1003,172,23-09-2019 17:22:00,1,1968.5,1909.0,0.9715,9.8695,53,41,16,25,12,0,12,3,0.0,0.0
1003,173,23-09-2019 17:24:00,1,2076.0,1965.0,0.947,10.355,48,40,16,24,8,0,8,15,0.0,0.0
1003,174,23-09-2019 17:26:00,1,2070.0,1990.0,0.962,10.358,56,47,35,12,9,6,3,42,0.0,0.0
1003,175,23-09-2019 17:28:00,1,1182.0,1152.0,0.974,5.934,0,0,0,0,0,0,0,31,0.0,0.0
1003,176,23-09-2019 17:30:00,1,1882.0,1766.0,0.938,9.372,0,0,0,0,0,0,0,38,0.0,0.0
1003,177,23-09-2019 17:32:00,1,2076.0,1966.0,0.947,10.356,0,0,0,0,0,0,0,5,0.0,0.0
1003,178,23-09-2019 17:34:00,1,2095.0,1885.0,0.9,10.34,0,0,0,0,0,0,0,3,0.0,0.0
1003,179,23-09-2019 17:36:00,1,1888.0,1756.0,0.93,9.384,0,0,0,0,0,0,0,4,0.0,0.0
1003,180,23-09-2019 17:38:00,1,1796.0,1645.0,0.916,8.898,0,0,0,0,0,0,0,0,0.0,0.0
1003,181,23-09-2019 17:40:00,1,1807.0,1587.0,0.878,8.878,0,0,0,0,0,0,0,0,0.0,0.0
1003,182,23-09-2019 17:42:00,1,1810.0,1576.0,0.87,8.878,0,0,0,0,0,0,0,24,0.0,0.0
1003,183,23-09-2019 17:44:00,1,1798.0,1613.0,0.897,8.872,0,0,0,0,0,0,0,0,0.0,0.0
1003,184,23-09-2019 17:46:00,1,1794.0,1628.0,0.907,8.871,0,0,0,0,0,0,0,0,0.0,0.0
1003,185,23-09-2019 17:48:00,1,1792.0,1628.0,0.909,8.863,0,0,0,0,0,0,0,0,0.0,0.0
1003,186,23-09-2019 17:50:00,1,1796.0,1638.0,0.912,8.892,0,0,0,0,0,0,0,8,0.0,0.0
1003,187,23-09-2019 17:52:00,1,1788.0,1629.0,0.911,8.847,0,0,0,0,0,0,0,20,0.0,0.0
1003,188,23-09-2019 17:54:00,1,1789.0,1668.0,0.933,8.895,0,0,0,0,0,0,0,16,0.0,0.0
1003,189,23-09-2019 17:56:00,1,1804.0,1613.5,0.895,8.8935,0,0,0,0,0,0,0,7,0.0,0.0
1003,190,23-09-2019 17:58:00,1,1819.0,1559.0,0.857,8.892,0,0,0,0,0,0,0,15,0.0,0.0
1003,191,23-09-2019 18:00:00,0,1806.0,1580.0,0.875,8.867,0,0,0,0,0,0,0,9,0.0,0.0
1003,192,23-09-2019 18:02:00,0,1820.0,1531.0,0.841,8.864,0,0,0,0,0,0,0,3,0.0,0.0
1003,193,23-09-2019 18:04:00,0,1589.0,1486.0,0.935,7.906,0,0,0,0,0,0,0,6,0.0,0.0
1003,194,23-09-2019 18:06:00,0,1598.0,1441.0,0.901,7.892,0,0,0,0,0,0,0,2,0.0,0.0
1003,195,23-09-2019 18:08:00,0,1607.0,1396.0,0.869,7.876,0,0,0,0,0,0,0,7,0.0,0.0
1003,196,23-09-2019 18:10:00,0,1605.0,1428.0,0.89,7.906,0,0,0,0,0,0,0,10,0.0,0.0
1003,197,23-09-2019 18:12:00,0,1828.0,1504.0,0.823,8.869,0,0,0,0,0,0,0,0,0.0,0.0
1003,198,23-09-2019 18:14:00,0,1820.0,1523.0,0.837,8.857,0,0,0,0,0,0,0,29,0.0,0.01
1003,199,23-09-2019 18:16:00,0,2140.0,1709.0,0.798,10.324,320,172,135,37,148,115,33,128,0.0,0.0
1003,200,23-09-2019 18:18:00,0,2624.0,2248.0,0.857,12.828,391,208,164,44,183,138,45,84,0.0,0.0
1003,201,23-09-2019 18:20:00,0,2731.0,2328.0,0.853,13.336,295,186,146,40,109,78,31,131,0.0,0.02
1003,202,23-09-2019 18:22:00,0,3012.0,2579.0,0.856,14.724,457,234,182,52,223,162,61,149,0.0,0.0
1003,203,23-09-2019 18:24:00,0,2814.0,2442.0,0.868,13.791,122,78,47,31,44,21,23,54,0.0,0.02
1003,204,23-09-2019 18:26:00,0,3357.0,2782.0,0.829,16.307,209,111,78,33,98,54,44,22,0.0,0.03
1003,205,23-09-2019 18:28:00,0,1913.0,1624.0,0.849,9.337,241,103,68,35,138,88,50,37,0.0,0.0
1003,206,23-09-2019 18:30:00,0,2620.5,2229.0,0.85,12.794,410,247,194,53,163,128,35,95,0.0,0.0
1003,207,23-09-2019 18:32:00,0,3328.0,2834.0,0.851,16.251,388,220,169,51,168,122,46,79,0.0,0.03
1003,208,23-09-2019 18:34:00,0,2599.0,2320.0,0.893,12.811,299,173,124,49,126,99,27,57,0.0,0.0
1003,209,23-09-2019 18:36:00,0,2302.0,2027.0,0.88,11.316,102,82,48,34,20,1,19,16,0.0,0.0
1003,210,23-09-2019 18:38:00,0,1627.0,1345.0,0.827,7.901,126,94,48,46,32,0,32,2,0.0,0.0
1003,211,23-09-2019 18:40:00,0,1831.0,1484.0,0.81,8.859,91,73,28,45,18,3,15,7,0.0,0.0
1003,212,23-09-2019 18:42:00,0,1795.0,1620.0,0.903,8.866,233,138,99,39,95,68,27,69,0.0,0.02
1003,213,23-09-2019 18:44:00,0,3500.0,3145.0,0.899,17.273,131,90,61,29,41,20,21,42,0.0,0.03
1003,214,23-09-2019 18:46:00,0,3585.0,3251.0,0.907,17.726,158,99,80,19,59,43,16,21,0.0,0.0
1003,215,23-09-2019 18:48:00,0,2007.0,1775.0,0.885,9.872,107,50,21,29,57,34,23,0,0.0,0.0
1003,216,23-09-2019 18:50:00,0,1906.0,1702.0,0.893,9.395,268,142,105,37,126,87,39,42,0.0,0.0
1003,217,23-09-2019 18:52:00,0,3286.0,2962.0,0.901,16.225,174,97,72,25,77,52,25,49,0.1,0.01
1003,218,23-09-2019 18:54:00,0,3375.0,3134.0,0.928,16.768,153,69,36,33,84,57,27,18,0.0,0.01
1003,219,23-09-2019 18:56:00,0,1887.0,1751.0,0.928,9.373,82,32,6,26,50,25,25,0,0.0,0.0
1003,220,23-09-2019 18:58:00,0,1802.0,1587.0,0.881,8.855,126,19,5,14,107,59,48,0,0.0,0.0
1003,221,23-09-2019 19:00:00,0,1797.0,1642.0,0.914,8.898,113,59,25,34,54,34,20,10,0.0,0.0
1003,222,23-09-2019 19:02:00,0,2994.0,2736.0,0.914,14.827,141,84,56,28,57,36,21,54,0.0,0.02
1003,223,23-09-2019 19:04:00,0,3040.5,2788.0,0.917,15.0665,410,224,174,50,186,141,45,93,0.0,0.0
1003,224,23-09-2019 19:06:00,0,3087.0,2840.0,0.92,15.306,164,84,51,33,80,54,26,68,0.0,0.0
1003,225,23-09-2019 19:08:00,0,3289.0,3002.0,0.913,16.283,271,158,116,42,113,75,38,64,0.0,0.01
1003,226,23-09-2019 19:10:00,0,2972.0,2815.0,0.947,14.826,83,55,27,28,28,16,12,16,0.0,0.0
1003,227,23-09-2019 19:12:00,0,3062.0,2906.0,0.949,15.28,167,100,78,22,67,43,24,73,0.0,0.02
1003,228,23-09-2019 19:14:00,0,2789.0,2529.0,0.907,13.789,576,331,274,57,245,197,48,104,0.0,0.0
1003,229,23-09-2019 19:16:00,0,2968.0,2823.0,0.951,14.821,653,411,346,65,242,198,44,183,0.0,0.0
1003,230,23-09-2019 19:18:00,0,2923.0,2955.0,1.011,14.788,511,305,255,50,206,158,48,70,0.0,0.02
1003,231,23-09-2019 19:20:00,0,2972.0,2799.0,0.942,14.808,334,224,175,49,110,73,37,54,0.0,0.0
1003,232,23-09-2019 19:22:00,0,2974.0,2808.0,0.944,14.825,240,141,98,43,99,62,37,44,0.0,0.0
1003,233,23-09-2019 19:24:00,0,2477.0,2308.0,0.932,12.316,250,111,73,38,139,94,45,59,0.0,0.02
1003,234,23-09-2019 19:26:00,0,3267.0,3099.0,0.949,16.301,291,172,131,41,119,90,29,37,0.0,0.0
1003,235,23-09-2019 19:28:00,0,2852.0,2763.0,0.969,14.297,267,119,77,42,148,102,46,68,0.0,0.0
1003,236,23-09-2019 19:30:00,0,3363.0,3181.0,0.946,16.771,239,126,86,40,113,76,37,85,0.0,0.0
1003,237,23-09-2019 19:32:00,0,2870.0,2741.0,0.955,14.343,224,121,80,41,103,70,33,40,0.0,0.0
1003,238,23-09-2019 19:34:00,0,1794.0,1629.0,0.908,8.871,208,138,104,34,70,45,25,47,0.02,0.0
1003,239,23-09-2019 19:36:00,0,2764.0,2645.0,0.957,13.818,357,178,140,38,179,144,35,109,0.01,0.0
1003,240,23-09-2019 19:38:00,0,2919.0,2746.5,0.9415,14.542,176,97,68,29,79,55,24,46,0.0,0.09
1003,241,23-09-2019 19:40:00,0,3074.0,2848.0,0.926,15.266,163,24,2,22,139,96,43,14,0.0,0.0
1003,242,23-09-2019 19:42:00,0,3368.0,3166.0,0.94,16.775,33,8,0,8,25,18,7,12,0.0,0.0
1003,243,23-09-2019 19:44:00,0,2969.0,2791.0,0.94,14.786,298,163,122,41,135,97,38,36,0.0,0.04
1003,244,23-09-2019 19:46:00,0,2984.0,2775.0,0.93,14.829,195,88,56,32,107,67,40,69,0.0,0.0
1003,245,23-09-2019 19:48:00,0,2773.0,2638.0,0.951,13.847,265,121,90,31,144,108,36,53,0.12,0.0
1003,246,23-09-2019 19:50:00,0,2752.0,2675.0,0.972,13.805,385,226,178,48,159,116,43,47,0.02,0.03
1003,247,23-09-2019 19:52:00,0,2798.0,2528.0,0.903,13.823,75,32,11,21,43,17,26,7,0.0,0.0
1003,248,23-09-2019 19:54:00,0,2758.0,2662.0,0.965,13.815,214,119,66,53,95,51,44,18,0.0,0.0
1003,249,23-09-2019 19:56:00,0,3053.0,2925.0,0.958,15.267,183,121,90,31,62,45,17,48,0.01,0.0
1003,250,23-09-2019 19:58:00,0,2781.0,2607.0,0.937,13.842,186,104,67,37,82,48,34,54,0.0,0.01
1003,251,23-09-2019 20:00:00,0,3053.0,2939.0,0.963,15.281,104,61,33,28,43,19,24,42,0.0,0.04
1003,252,23-09-2019 20:02:00,0,3046.0,2972.0,0.976,15.293,121,81,52,29,40,19,21,46,0.0,0.06
1003,253,23-09-2019 20:04:00,0,2959.0,2842.0,0.96,14.806,188,103,78,25,85,50,35,27,0.19,0.0
1003,254,23-09-2019 20:06:00,0,2964.0,2849.0,0.961,14.834,112,66,47,19,46,34,12,13,0.0,0.0
1003,255,23-09-2019 20:08:00,0,2380.0,2230.0,0.937,11.846,50,36,25,11,14,8,6,10,0.0,0.0
1003,256,23-09-2019 20:10:00,0,2952.0,2841.0,0.962,14.776,0,0,0,0,0,0,0,0,0.0,0.0
1003,257,23-09-2019 20:12:00,0,2857.0,2732.5,0.956,14.2815,146,64,38,26,82,55,27,39,0.0,0.0
1003,258,23-09-2019 20:14:00,0,2762.0,2624.0,0.95,13.787,194,133,87,46,61,34,27,71,0.0,0.0
1003,259,23-09-2019 20:16:00,0,2844.0,2819.0,0.991,14.324,253,167,122,45,86,51,35,68,0.0,0.0
1003,260,23-09-2019 20:18:00,0,2552.0,2490.0,0.976,12.811,257,150,102,48,107,66,41,75,0.1,0.0
1003,261,23-09-2019 20:20:00,0,2739.0,2736.0,0.999,13.82,93,22,2,20,71,43,28,0,0.02,0.0
1003,262,23-09-2019 20:22:00,0,2930.0,2917.0,0.995,14.775,80,28,13,15,52,27,25,17,0.0,0.01
1003,263,23-09-2019 20:24:00,0,2746.0,2670.0,0.972,13.776,204,111,85,26,93,64,29,31,0.0,0.02
1003,264,23-09-2019 20:26:00,0,2762.0,2640.0,0.956,13.806,84,48,36,12,36,21,15,0,0.0,0.0
1003,265,23-09-2019 20:28:00,0,2088.0,1926.0,0.922,10.361,3,0,0,0,3,0,3,0,0.0,0.0
1003,266,23-09-2019 20:30:00,0,1678.0,1582.0,0.943,8.362,10,1,0,1,9,3,6,0,0.0,0.0
1003,267,23-09-2019 20:32:00,0,1604.0,1407.0,0.877,7.876,312,206,169,37,106,71,35,131,0.0,0.0
1003,268,23-09-2019 20:34:00,0,2588.0,2405.0,0.929,12.86,112,36,16,20,76,39,37,53,0.0,0.0
1003,269,23-09-2019 20:36:00,0,2968.0,2830.0,0.954,14.824,175,77,38,39,98,55,43,62,0.0,0.0
1003,270,23-09-2019 20:38:00,0,2947.0,2869.0,0.973,14.788,246,136,96,40,110,78,32,70,0.0,0.0
1003,271,23-09-2019 20:40:00,0,2955.0,2864.0,0.969,14.812,299,143,103,40,156,116,40,49,0.0,0.0
1003,272,23-09-2019 20:42:00,0,1759.0,1748.0,0.994,8.866,455,231,175,56,224,170,54,33,0.0,0.04
1003,273,23-09-2019 20:44:00,0,2837.0,2815.0,0.992,14.294,534,290,226,64,244,184,60,164,0.0,0.0
1003,274,23-09-2019 20:46:00,0,2605.0,2520.5,0.965,13.0545,505,194,146,48,311,231,80,51,0.0,0.0
1003,275,23-09-2019 20:48:00,0,2373.0,2226.0,0.938,11.815,330,226,174,52,104,71,33,66,0.0,0.0
1003,276,23-09-2019 20:50:00,0,2942.0,2929.0,0.995,14.836,469,240,187,53,229,178,51,136,0.01,0.0
1003,277,23-09-2019 20:52:00,0,2471.0,2355.0,0.953,12.345,154,75,52,23,79,49,30,40,0.0,0.0
1003,278,23-09-2019 20:54:00,0,2937.0,2921.0,0.995,14.804,179,69,33,36,110,64,46,62,0.0,0.0
1003,279,23-09-2019 20:56:00,0,3258.0,3099.0,0.951,16.265,135,58,25,33,77,31,46,66,0.0,0.0
1003,280,23-09-2019 20:58:00,0,3038.0,3005.0,0.989,15.296,112,56,25,31,56,26,30,53,0.0,0.05
1003,281,23-09-2019 21:00:00,0,2950.0,2883.0,0.977,14.812,53,26,16,10,27,4,23,19,0.0,0.32
1003,282,23-09-2019 21:02:00,0,2666.0,2533.0,0.95,13.308,23,0,0,0,23,0,23,0,0.0,0.01
1003,283,23-09-2019 21:04:00,0,2772.0,2590.0,0.934,13.788,30,11,4,7,19,0,19,0,0.0,0.0
1003,284,23-09-2019 21:06:00,0,2846.0,2780.0,0.977,14.292,309,174,129,45,135,95,40,9,0.0,0.0
1003,285,23-09-2019 21:08:00,0,1866.0,1820.0,0.976,9.366,451,260,199,61,191,143,48,13,0.0,0.0
1003,286,23-09-2019 21:10:00,0,2263.0,2190.0,0.968,11.341,311,153,107,46,158,110,48,36,0.18,0.0
1003,287,23-09-2019 21:12:00,0,3252.0,3145.0,0.967,16.293,344,163,118,45,181,131,50,99,0.09,0.0
1003,288,23-09-2019 21:14:00,0,3425.0,3447.0,1.007,17.309,527,280,217,63,247,192,55,140,0.0,0.03
1003,289,23-09-2019 21:16:00,0,3248.0,3088.0,0.951,16.214,517,252,194,58,265,202,63,96,0.02,0.0
1003,290,23-09-2019 21:18:00,0,3741.0,3647.0,0.975,18.778,319,149,106,43,170,123,47,21,0.0,0.0
1003,291,23-09-2019 21:20:00,0,3397.0,3276.0,0.963,17.012,312,176,127,49,136,100,36,39,0.0,0.0
1003,292,23-09-2019 21:22:00,0,3053.0,2905.0,0.951,15.246,540,189,143,46,351,301,50,84,0.0,0.0
1003,293,23-09-2019 21:24:00,0,3051.0,2968.0,0.973,15.305,460,215,158,57,245,182,63,77,0.05,0.0
1003,294,23-09-2019 21:26:00,0,3377.0,3143.0,0.931,16.783,453,178,141,37,275,205,70,82,0.0,0.0
1003,295,23-09-2019 21:28:00,0,3073.0,2914.0,0.948,15.333,384,197,149,48,187,154,33,85,0.04,0.0
1003,296,23-09-2019 21:30:00,0,3595.0,3272.0,0.91,17.785,258,146,120,26,112,74,38,51,0.0,0.01
1003,297,23-09-2019 21:32:00,0,3363.0,3211.0,0.955,16.804,174,83,51,32,91,55,36,59,0.0,0.04
1003,298,23-09-2019 21:34:00,0,3550.0,3397.0,0.957,17.747,310,160,119,41,150,96,54,37,0.03,0.02
1003,299,23-09-2019 21:36:00,0,3853.0,3675.0,0.954,19.248,428,193,143,50,235,176,59,50,0.07,0.0
1003,300,23-09-2019 21:38:00,0,2361.0,2301.0,0.975,11.85,132,35,12,23,97,55,42,2,0.0,0.02
1003,301,23-09-2019 21:40:00,0,2216.0,1907.0,0.861,10.843,46,8,3,5,38,9,29,0,0.0,0.0
1003,302,23-09-2019 21:42:00,0,1881.0,1788.0,0.951,9.391,40,2,1,1,38,21,17,0,0.0,0.0
1003,303,23-09-2019 21:44:00,0,1991.0,1833.0,0.921,9.874,46,10,4,6,36,14,22,0,0.0,0.0
1003,304,23-09-2019 21:46:00,0,1870.0,1803.0,0.964,9.366,75,6,0,6,69,27,42,0,0.0,0.0
1003,305,23-09-2019 21:48:00,0,1888.0,1757.0,0.931,9.384,72,1,0,1,71,47,24,0,0.0,0.0
1003,306,23-09-2019 21:50:00,0,1891.0,1737.0,0.919,9.372,225,89,61,28,136,80,56,31,0.0,0.0
1003,307,23-09-2019 21:52:00,0,1921.0,1620.0,0.843,9.364,273,139,95,44,134,98,36,47,0.0,0.0
1003,308,23-09-2019 21:54:00,0,2631.0,2451.0,0.9125,13.0815,276,176,129,47,100,70,30,146,0.0,0.0
1003,309,23-09-2019 21:56:00,0,3341.0,3282.0,0.982,16.799,337,139,99,40,198,147,51,42,0.0,0.0
1003,310,23-09-2019 21:58:00,0,2375.0,2223.0,0.936,11.82,318,148,106,42,170,124,46,80,0.06,0.0
1003,311,23-09-2019 22:00:00,0,3043.0,2961.0,0.973,15.268,323,194,137,57,129,89,40,137,0.0,0.03
1003,312,23-09-2019 22:02:00,0,3030.0,3058.0,1.009,15.322,160,74,46,28,86,61,25,32,0.0,0.0
1003,313,23-09-2019 22:04:00,0,2879.0,2652.0,0.921,14.281,253,137,95,42,116,88,28,70,0.0,0.0
1003,314,23-09-2019 22:06:00,0,3056.0,2954.0,0.966,15.31,308,173,133,40,135,104,31,214,0.0,0.0
1003,315,23-09-2019 22:08:00,0,3037.0,3021.0,0.995,15.31,290,146,100,46,144,91,53,33,0.0,0.0
1003,316,23-09-2019 22:10:00,0,3350.0,3167.0,0.945,16.704,300,143,110,33,157,107,50,71,0.0,0.0
1003,317,23-09-2019 22:12:00,0,3342.0,3246.0,0.971,16.762,263,109,75,34,154,108,46,5,0.0,0.0
1003,318,23-09-2019 22:14:00,0,2374.0,2243.0,0.945,11.838,372,216,170,46,156,114,42,41,0.0,0.0
1003,319,23-09-2019 22:16:00,0,3063.0,2882.0,0.941,15.257,192,100,69,31,92,62,30,68,0.02,0.0
1003,320,23-09-2019 22:18:00,0,2584.0,2401.0,0.929,12.839,155,48,21,27,107,60,47,5,0.01,0.0
1003,321,23-09-2019 22:20:00,0,2909.0,2593.0,0.891,14.333,381,182,136,46,199,147,52,50,0.0,0.0
1003,322,23-09-2019 22:22:00,0,3034.0,3009.0,0.992,15.285,331,149,107,42,182,128,54,111,0.0,0.0
1003,323,23-09-2019 22:24:00,0,3242.0,3168.0,0.977,16.281,288,151,112,39,137,102,35,53,0.0,0.0
1003,324,23-09-2019 22:26:00,0,3047.0,2998.0,0.984,15.325,339,164,129,35,175,133,42,76,0.07,0.0
1003,325,23-09-2019 22:28:00,0,3101.0,3032.5,0.978,15.576,192,99,67,32,93,67,26,110,0.01,0.0
1003,326,23-09-2019 22:30:00,0,3155.0,3067.0,0.972,15.827,344,173,134,39,171,130,41,97,0.01,0.0
1003,327,23-09-2019 22:32:00,0,2869.0,2704.0,0.943,14.297,249,119,84,35,130,106,24,104,0.0,0.0
1003,328,23-09-2019 22:34:00,0,3063.0,2929.0,0.956,15.312,257,142,112,30,115,74,41,91,0.0,0.0
1003,329,23-09-2019 22:36:00,0,2674.0,2531.0,0.947,13.337,121,46,23,23,75,41,34,14,0.0,0.0
1003,330,23-09-2019 22:38:00,0,2670.0,2527.0,0.947,13.316,79,16,4,12,63,27,36,1,0.0,0.0
1003,331,23-09-2019 22:40:00,0,2786.0,2533.0,0.909,13.78,33,14,8,6,19,9,10,0,0.0,0.0
1003,332,23-09-2019 22:42:00,0,2387.0,2212.0,0.926,11.855,7,6,1,5,1,0,1,0,0.0,0.0
1003,333,23-09-2019 22:44:00,0,2215.0,1915.0,0.864,10.848,90,43,31,12,47,29,18,2,0.0,0.0
1003,334,23-09-2019 22:46:00,0,2212.0,1926.0,0.871,10.847,5,5,2,3,0,0,0,0,0.0,0.0
1003,335,23-09-2019 22:48:00,0,1880.0,1770.0,0.941,9.367,3,1,0,1,2,0,2,0,0.0,0.0
1003,336,23-09-2019 22:50:00,0,1984.0,1848.0,0.931,9.865,10,1,1,0,9,0,9,0,0.0,0.0
1003,337,23-09-2019 22:52:00,0,2210.0,1936.0,0.876,10.851,23,8,0,8,15,1,14,0,0.0,0.0
1003,338,23-09-2019 22:54:00,0,2204.0,1963.0,0.891,10.856,4,3,1,2,1,0,1,0,0.0,0.0
1003,339,23-09-2019 22:56:00,0,1969.0,1906.0,0.968,9.867,8,5,1,4,3,1,2,0,0.01,0.0
1003,340,23-09-2019 22:58:00,0,1968.0,1889.0,0.96,9.844,13,8,4,4,5,2,3,0,0.0,0.0
1003,341,23-09-2019 23:00:00,0,1861.0,1842.0,0.99,9.372,0,0,0,0,0,0,0,0,0.0,0.0
1003,342,23-09-2019 23:02:00,0,1769.0,1728.0,0.976,8.883,0,0,0,0,0,0,0,0,0.0,0.0
1003,343,23-09-2019 23:04:00,0,1677.0,1614.0,0.962,8.394,143,67,34,33,76,43,33,2,0.0,0.0
1003,344,23-09-2019 23:06:00,0,1872.0,1791.0,0.957,9.357,323,172,135,37,151,109,42,71,0.0,0.0
1003,345,23-09-2019 23:08:00,0,2182.0,2041.0,0.935,10.858,200,103,58,45,97,65,32,28,0.0,0.0
1003,346,23-09-2019 23:10:00,0,2164.0,2136.0,0.987,10.891,230,161,118,43,69,46,23,39,0.0,0.0
1003,347,23-09-2019 23:12:00,0,2368.0,2248.0,0.949,11.818,226,160,118,42,66,39,27,42,0.0,0.01
1003,348,23-09-2019 23:14:00,0,2782.0,2561.0,0.921,13.796,384,180,134,46,204,149,55,105,0.0,0.09
1003,349,23-09-2019 23:16:00,0,2666.0,2555.0,0.959,13.332,473,284,225,59,189,139,50,110,0.0,0.0
1003,350,23-09-2019 23:18:00,0,2697.0,2428.0,0.9,13.315,160,97,55,42,63,22,41,74,0.0,0.0
1003,351,23-09-2019 23:20:00,0,2864.0,2722.0,0.951,14.297,241,152,107,45,89,56,33,51,0.01,0.0
1003,352,23-09-2019 23:22:00,0,2590.0,2392.0,0.924,12.854,295,173,126,47,122,83,39,26,0.0,0.0
1003,353,23-09-2019 23:24:00,0,2863.0,2732.0,0.954,14.304,308,192,152,40,116,82,34,19,0.04,0.0
1003,354,23-09-2019 23:26:00,0,2672.0,2500.0,0.935,13.296,140,53,36,17,87,45,42,0,0.0,0.0
1003,355,23-09-2019 23:28:00,0,2405.0,2129.0,0.885,11.834,314,166,130,36,148,107,41,56,0.0,0.0
1003,356,23-09-2019 23:30:00,0,2368.0,2256.0,0.953,11.828,314,154,108,46,160,121,39,82,0.0,0.0
1003,357,23-09-2019 23:32:00,0,2707.0,2421.0,0.894,13.346,245,69,42,27,176,129,47,23,0.0,0.0
1003,358,23-09-2019 23:34:00,0,2888.0,2620.0,0.907,14.281,319,154,114,40,165,126,39,87,0.0,0.0
1003,359,23-09-2019 23:36:00,0,2881.0,2660.5,0.9235,14.297,127,68,42,26,59,34,25,2,0.0,0.0
1003,360,23-09-2019 23:38:00,0,2874.0,2701.0,0.94,14.313,274,168,121,47,106,91,15,95,0.0,0.0
1003,361,23-09-2019 23:40:00,0,2981.0,2745.0,0.921,14.784,52,21,14,7,31,23,8,14,0.06,0.0
1003,362,23-09-2019 23:42:00,0,2865.0,2736.0,0.955,14.315,251,101,66,35,150,108,42,40,0.0,0.0
1003,363,23-09-2019 23:44:00,0,2712.0,2396.0,0.884,13.339,312,158,114,44,154,112,42,30,0.0,0.0
1003,364,23-09-2019 23:46:00,0,3092.0,2751.0,0.89,15.228,58,14,6,8,44,25,19,14,0.0,0.0
1003,365,23-09-2019 23:48:00,0,2883.0,2655.0,0.921,14.3,45,18,6,12,27,11,16,0,0.0,0.0
1003,366,23-09-2019 23:50:00,0,2892.0,2612.0,0.903,14.288,8,4,1,3,4,1,3,6,0.0,0.0
1003,367,23-09-2019 23:52:00,0,2880.0,2617.0,0.908,14.246,38,23,1,22,15,6,9,7,0.0,0.0
1003,368,23-09-2019 23:54:00,0,2917.0,2546.0,0.873,14.313,63,37,16,21,26,13,13,0,0.0,0.0
1003,369,23-09-2019 23:56:00,0,2710.0,2387.0,0.881,13.32,137,53,26,27,84,41,43,8,0.0,0.0
1003,370,23-09-2019 23:58:00,0,2604.0,2308.0,0.886,12.814,263,140,100,40,123,87,36,28,0.0,0.0
1003,371,24-09-2019 00:00:00,0,2418.0,2102.0,0.869,11.856,299,188,136,52,111,81,30,22,0.0,0.0
1003,372,24-09-2019 00:02:00,0,2609.0,2264.0,0.868,12.784,222,146,95,51,76,50,26,52,0.0,0.0
1003,373,24-09-2019 00:04:00,0,2714.0,2383.0,0.878,13.332,246,165,114,51,81,57,24,71,0.0,0.0
1003,374,24-09-2019 00:06:00,0,2923.0,2481.0,0.849,14.263,189,116,74,42,73,26,47,84,0.0,0.0
1003,375,24-09-2019 00:08:00,0,2896.0,2614.0,0.903,14.303,269,169,128,41,100,47,53,69,0.0,0.0
1003,376,24-09-2019 00:10:00,0,2992.0,2683.0,0.897,14.759,212,108,77,31,104,77,27,46,0.0,0.0
1003,377,24-09-2019 00:12:00,0,3088.0,2752.0,0.891,15.215,304,190,140,50,114,78,36,75,0.0,0.0
1003,378,24-09-2019 00:14:00,0,3123.0,2721.0,0.871,15.318,294,180,124,56,114,64,50,63,0.0,0.0
1003,379,24-09-2019 00:16:00,0,2901.0,2580.0,0.889,14.284,197,112,70,42,85,48,37,57,0.0,0.0
1003,380,24-09-2019 00:18:00,0,2883.0,2635.0,0.914,14.276,374,213,161,52,161,120,41,38,0.0,0.0
1003,381,24-09-2019 00:20:00,0,2907.0,2584.0,0.889,14.314,297,173,133,40,124,90,34,38,0.02,0.0
1003,382,24-09-2019 00:22:00,0,2226.0,1850.0,0.831,10.818,195,99,71,28,96,70,26,80,0.0,0.0
1003,383,24-09-2019 00:24:00,0,2004.0,1777.0,0.887,9.863,121,78,52,26,43,33,10,61,0.0,0.0
1003,384,24-09-2019 00:26:00,0,2930.0,2485.0,0.848,14.295,244,138,104,34,106,71,35,81,0.0,0.0
1003,385,24-09-2019 00:28:00,0,2208.0,1920.0,0.87,10.825,31,2,2,0,29,10,19,1,0.01,0.0
1003,386,24-09-2019 00:30:00,0,2231.0,1844.0,0.827,10.831,79,12,7,5,67,40,27,0,0.0,0.0
1003,387,24-09-2019 00:32:00,0,2220.0,1905.0,0.858,10.857,36,10,2,8,26,13,13,5,0.0,0.0
1003,388,24-09-2019 00:34:00,0,2242.0,1809.0,0.807,10.836,38,6,0,6,32,14,18,0,0.0,0.0
1003,389,24-09-2019 00:36:00,0,2247.0,1794.0,0.798,10.84,84,8,0,8,76,33,43,0,0.0,0.0
1003,390,24-09-2019 00:38:00,0,2241.0,1776.0,0.793,10.795,22,2,0,2,20,4,16,0,0.0,0.0
1003,391,24-09-2019 00:40:00,0,2231.0,1835.0,0.822,10.823,5,0,0,0,5,2,3,0,0.0,0.0
1003,392,24-09-2019 00:42:00,0,2209.0,1937.0,0.877,10.848,43,12,8,4,31,14,17,0,0.0,0.0
1003,393,24-09-2019 00:44:00,0,2206.0,1947.5,0.883,10.8475,84,40,12,28,44,10,34,0,0.0,0.0
1003,394,24-09-2019 00:46:00,0,2203.0,1958.0,0.889,10.847,109,32,14,18,77,53,24,0,0.0,0.0
1003,395,24-09-2019 00:48:00,0,2209.0,1921.0,0.87,10.83,23,23,2,21,0,0,0,0,0.0,0.0
1003,396,24-09-2019 00:50:00,0,1999.0,1788.0,0.894,9.854,2,2,1,1,0,0,0,0,0.0,0.0
1003,397,24-09-2019 00:52:00,0,1904.0,1699.0,0.893,9.382,2,2,1,1,0,0,0,0,0.0,0.0
1003,398,24-09-2019 00:54:00,0,1925.0,1592.0,0.827,9.347,25,18,3,15,7,3,4,0,0.0,0.0
1003,399,24-09-2019 00:56:00,0,1930.0,1599.0,0.828,9.375,0,0,0,0,0,0,0,0,0.0,0.0
1003,400,24-09-2019 00:58:00,0,1813.0,1563.0,0.862,8.874,18,13,3,10,5,1,4,0,0.0,0.0
1003,401,24-09-2019 01:00:00,0,1702.0,1536.0,0.902,8.406,26,26,0,26,0,0,0,0,0.0,0.0
1003,402,24-09-2019 01:02:00,0,1707.0,1480.0,0.867,8.363,140,92,58,34,48,25,23,22,0.0,0.0
1003,403,24-09-2019 01:04:00,0,1713.0,1477.0,0.863,8.383,106,41,16,25,65,37,28,9,0.0,0.0
1003,404,24-09-2019 01:06:00,0,1812.0,1562.0,0.862,8.869,81,39,12,27,42,18,24,1,0.0,0.0
1003,405,24-09-2019 01:08:00,0,1932.0,1571.0,0.813,9.352,5,5,0,5,0,0,0,0,0.0,0.0
1003,406,24-09-2019 01:10:00,0,1707.0,1508.0,0.883,8.395,0,0,0,0,0,0,0,0,0.0,0.0
1003,407,24-09-2019 01:12:00,0,1726.0,1431.0,0.829,8.386,8,4,0,4,4,2,2,0,0.0,0.0
1003,408,24-09-2019 01:14:00,0,1747.0,1365.0,0.781,8.397,0,0,0,0,0,0,0,0,0.0,0.0
1003,409,24-09-2019 01:16:00,0,1512.0,1311.0,0.867,7.407,9,0,0,0,9,1,8,0,0.01,0.0
1003,410,24-09-2019 01:18:00,0,1517.0,1282.5,0.8455,7.3965,4,0,0,0,4,1,3,0,0.0,0.0
1003,411,24-09-2019 01:20:00,0,1522.0,1254.0,0.824,7.386,46,26,5,21,20,9,11,0,0.0,0.0
1003,412,24-09-2019 01:22:00,0,1515.0,1291.0,0.852,7.4,3,3,0,3,0,0,0,0,0.0,0.0
1003,413,24-09-2019 01:24:00,0,1519.0,1262.0,0.83,7.383,4,3,0,3,1,0,1,0,0.0,0.0
1003,414,24-09-2019 01:26:00,0,1526.0,1238.0,0.811,7.382,20,11,4,7,9,0,9,0,0.0,0.0
1003,415,24-09-2019 01:28:00,0,1530.0,1236.0,0.808,7.396,6,6,0,6,0,0,0,0,0.0,0.0
1003,416,24-09-2019 01:30:00,0,1529.0,1231.0,0.805,7.388,7,7,0,7,0,0,0,0,0.0,0.0
1003,417,24-09-2019 01:32:00,0,1527.0,1230.0,0.805,7.378,7,4,0,4,3,1,2,0,0.0,0.0
1003,418,24-09-2019 01:34:00,0,1514.0,1269.0,0.838,7.37,5,0,0,0,5,0,5,0,0.0,0.0
1003,419,24-09-2019 01:36:00,0,1521.0,1273.0,0.836,7.403,4,1,1,0,3,0,3,0,0.0,0.0
1003,420,24-09-2019 01:38:00,0,1524.0,1233.0,0.809,7.368,7,4,2,2,3,0,3,0,0.0,0.0
1003,421,24-09-2019 01:40:00,0,1527.0,1244.0,0.814,7.393,0,0,0,0,0,0,0,0,0.0,0.0
1003,422,24-09-2019 01:42:00,0,1525.0,1243.0,0.815,7.385,58,25,15,10,33,16,17,0,0.0,0.0
1003,423,24-09-2019 01:44:00,0,1762.0,1289.0,0.732,8.37,14,2,1,1,12,5,7,0,0.0,0.0
1003,424,24-09-2019 01:46:00,0,1741.0,1353.0,0.777,8.357,0,0,0,0,0,0,0,0,0.0,0.0
1003,425,24-09-2019 01:48:00,0,1740.0,1356.0,0.779,8.355,0,0,0,0,0,0,0,0,0.0,0.0
1003,426,24-09-2019 01:50:00,0,1747.0,1373.0,0.786,8.403,9,5,2,3,4,0,4,0,0.0,0.0
1003,427,24-09-2019 01:52:00,0,1737.5,1385.0,0.797,8.3795,0,0,0,0,0,0,0,0,0.0,0.0
1003,428,24-09-2019 01:54:00,0,1728.0,1397.0,0.808,8.356,23,6,0,6,17,10,7,0,0.0,0.0
1003,429,24-09-2019 01:56:00,0,1725.0,1422.0,0.824,8.372,0,0,0,0,0,0,0,0,0.0,0.0
1003,430,24-09-2019 01:58:00,0,1848.0,1446.0,0.783,8.885,0,0,0,0,0,0,0,0,0.0,0.0
1003,431,24-09-2019 02:00:00,0,1724.0,1423.0,0.825,8.368,7,2,0,2,5,2,3,0,0.0,0.0
1003,432,24-09-2019 02:02:00,0,1736.0,1383.0,0.796,8.373,0,0,0,0,0,0,0,0,0.0,0.0
1003,433,24-09-2019 02:04:00,0,1747.0,1345.0,0.77,8.374,9,1,0,1,8,2,6,0,0.0,0.0
1003,434,24-09-2019 02:06:00,0,1749.0,1322.0,0.756,8.354,10,2,0,2,8,3,5,0,0.0,0.0
1003,435,24-09-2019 02:08:00,0,1759.0,1307.0,0.743,8.379,4,1,0,1,3,0,3,0,0.0,0.0
1003,436,24-09-2019 02:10:00,0,1758.0,1305.0,0.743,8.371,0,0,0,0,0,0,0,0,0.0,0.0
1003,437,24-09-2019 02:12:00,0,1750.0,1310.0,0.749,8.345,12,2,0,2,10,1,9,0,0.0,0.0
1003,438,24-09-2019 02:14:00,0,1748.0,1332.0,0.762,8.361,7,2,1,1,5,2,3,0,0.0,0.0
1003,439,24-09-2019 02:16:00,0,1745.0,1352.0,0.775,8.374,1,0,0,0,1,0,1,0,0.0,0.0
1003,440,24-09-2019 02:18:00,0,1863.0,1386.0,0.744,8.875,3,0,0,0,3,0,3,0,0.0,0.0
1003,441,24-09-2019 02:20:00,0,1979.0,1414.0,0.714,9.361,2,0,0,0,2,0,2,0,0.0,0.0
1003,442,24-09-2019 02:22:00,0,1973.0,1421.0,0.72,9.348,0,0,0,0,0,0,0,0,0.0,0.0
1003,443,24-09-2019 02:24:00,0,1970.0,1422.0,0.722,9.335,0,0,0,0,0,0,0,0,0.0,0.0
1003,444,24-09-2019 02:26:00,0,2015.5,1494.0,0.741,9.595,25,2,1,1,23,5,18,0,0.0,0.0
1003,445,24-09-2019 02:28:00,0,2061.0,1566.0,0.76,9.855,73,21,6,15,52,16,36,0,0.0,0.0
1003,446,24-09-2019 02:30:00,0,2262.0,1730.0,0.765,10.826,143,65,24,41,78,39,39,0,0.0,0.0
1003,447,24-09-2019 02:32:00,0,2350.0,1836.0,0.781,11.29,64,31,13,18,33,19,14,0,0.0,0.0
1003,448,24-09-2019 02:34:00,0,2443.0,1996.0,0.817,11.835,334,195,146,49,139,102,37,84,0.0,0.0
1003,449,24-09-2019 02:36:00,0,2985.0,2280.0,0.764,14.285,267,195,142,53,72,49,23,51,0.0,0.0
1003,450,24-09-2019 02:38:00,0,2668.0,2049.0,0.768,12.78,369,157,110,47,212,148,64,27,0.01,0.0
1003,451,24-09-2019 02:40:00,0,2560.0,2019.0,0.788,12.324,237,162,118,44,75,47,28,19,0.0,0.0
1003,452,24-09-2019 02:42:00,0,2790.0,2075.0,0.744,13.288,376,197,142,55,179,130,49,36,0.0,0.0
1003,453,24-09-2019 02:44:00,0,2879.0,2196.0,0.763,13.776,105,55,41,14,50,28,22,1,0.03,0.0
1003,454,24-09-2019 02:46:00,0,2880.0,2204.0,0.765,13.786,212,144,94,50,68,39,29,80,0.0,0.0
1003,455,24-09-2019 02:48:00,0,2973.0,2300.0,0.774,14.261,250,178,138,40,72,40,32,62,0.0,0.0
1003,456,24-09-2019 02:50:00,0,2960.0,2367.0,0.8,14.283,318,152,113,39,166,120,46,60,0.0,0.0
1003,457,24-09-2019 02:52:00,0,2802.0,2068.0,0.738,13.329,284,139,94,45,145,110,35,50,0.0,0.0
1003,458,24-09-2019 02:54:00,0,2561.0,1988.0,0.776,12.29,349,204,153,51,145,94,51,29,0.0,0.0
1003,459,24-09-2019 02:56:00,0,2978.0,2281.0,0.766,14.258,300,174,132,42,126,87,39,106,0.0,0.0
1003,460,24-09-2019 02:58:00,0,2450.0,1968.0,0.803,11.83,175,66,35,31,109,77,32,19,0.0,0.0
1003,461,24-09-2019 03:00:00,0,2036.5,1652.5,0.8135,9.8535,98,56,15,41,42,24,18,0,0.0,0.0
1003,462,24-09-2019 03:02:00,0,1623.0,1337.0,0.824,7.877,17,11,0,11,6,2,4,0,0.0,0.0
1003,463,24-09-2019 03:04:00,0,1833.0,1493.0,0.815,8.875,37,12,1,11,25,1,24,0,0.0,0.0
1003,464,24-09-2019 03:06:00,0,2157.0,1658.0,0.769,10.336,30,9,2,7,21,0,21,0,0.0,0.0
1003,465,24-09-2019 03:08:00,0,2339.0,1906.0,0.815,11.325,5,1,0,1,4,0,4,0,0.0,0.0
1003,466,24-09-2019 03:10:00,0,2348.0,1861.0,0.793,11.312,2,2,0,2,0,0,0,0,0.0,0.0
1003,467,24-09-2019 03:12:00,0,2136.0,1755.0,0.822,10.358,0,0,0,0,0,0,0,0,0.0,0.0
1003,468,24-09-2019 03:14:00,0,2164.0,1610.0,0.744,10.309,7,6,1,5,1,0,1,0,0.0,0.0
1003,469,24-09-2019 03:16:00,0,1824.0,1510.0,0.828,8.859,33,14,10,4,19,10,9,0,0.0,0.0
1003,470,24-09-2019 03:18:00,0,1726.0,1396.0,0.808,8.346,0,0,0,0,0,0,0,0,0.0,0.0
1003,471,24-09-2019 03:20:00,0,1635.0,1304.0,0.797,7.888,6,0,0,0,6,0,6,0,0.0,0.0
1003,472,24-09-2019 03:22:00,0,1651.0,1239.0,0.751,7.877,7,6,1,5,1,0,1,0,0.0,0.0
1003,473,24-09-2019 03:24:00,0,1538.0,1198.0,0.779,7.384,4,4,0,4,0,0,0,0,0.0,0.0
1003,474,24-09-2019 03:26:00,0,1424.0,1152.0,0.809,6.887,79,24,16,8,55,28,27,0,0.0,0.0
1003,475,24-09-2019 03:28:00,0,1421.0,1173.0,0.825,6.898,29,0,0,0,29,5,24,0,0.0,0.0
1003,476,24-09-2019 03:30:00,0,1432.0,1136.0,0.793,6.898,34,0,0,0,34,0,34,0,0.0,0.0
1003,477,24-09-2019 03:32:00,0,1449.0,1081.0,0.746,6.908,43,0,0,0,43,9,34,0,0.0,0.0
1003,478,24-09-2019 03:34:00,0,1332.5,1046.0,0.7885,6.409,2,0,0,0,2,1,1,0,0.0,0.0
1003,479,24-09-2019 03:36:00,0,1216.0,1011.0,0.831,5.91,7,0,0,0,7,2,5,0,0.0,0.0
1003,480,24-09-2019 03:38:00,0,1225.0,986.0,0.805,5.916,11,0,0,0,11,0,11,0,0.0,0.0
1003,481,24-09-2019 03:40:00,0,1226.0,980.0,0.799,5.914,10,0,0,0,10,0,10,0,0.0,0.0
1003,482,24-09-2019 03:42:00,0,1222.0,985.0,0.806,5.907,13,5,4,1,8,2,6,0,0.0,0.0
1003,483,24-09-2019 03:44:00,0,1342.0,1022.0,0.762,6.418,0,0,0,0,0,0,0,0,0.0,0.0
1003,484,24-09-2019 03:46:00,0,1333.0,1040.0,0.78,6.404,17,0,0,0,17,5,12,0,0.0,0.0
1003,485,24-09-2019 03:48:00,0,1566.0,1069.0,0.682,7.353,8,1,1,0,7,2,5,0,0.0,0.0
1003,486,24-09-2019 03:50:00,0,1559.0,1123.0,0.721,7.384,1,0,0,0,1,0,1,0,0.0,0.0
1003,487,24-09-2019 03:52:00,0,1547.0,1162.0,0.751,7.384,22,0,0,0,22,0,22,0,0.0,0.0
1003,488,24-09-2019 03:54:00,0,1789.0,1190.0,0.665,8.365,4,3,2,1,1,0,1,0,0.0,0.0
1003,489,24-09-2019 03:56:00,0,1781.0,1220.0,0.685,8.367,32,26,20,6,6,2,4,0,0.0,0.0
1003,490,24-09-2019 03:58:00,0,1776.0,1210.0,0.681,8.338,4,3,2,1,1,0,1,0,0.0,0.0
1003,491,24-09-2019 04:00:00,0,1790.0,1182.0,0.66,8.362,8,8,0,8,0,0,0,0,0.0,0.0
1003,492,24-09-2019 04:02:00,0,1675.0,1146.0,0.684,7.87,11,5,2,3,6,3,3,0,0.0,0.0
1003,493,24-09-2019 04:04:00,0,1563.0,1115.0,0.713,7.392,114,61,21,40,53,21,32,0,0.0,0.0
1003,494,24-09-2019 04:06:00,0,1766.0,1278.0,0.724,8.374,180,53,25,28,127,81,46,0,0.0,0.0
1003,495,24-09-2019 04:08:00,0,2331.5,1699.5,0.728,11.0695,215,114,73,41,101,73,28,51,0.01,0.0
1003,496,24-09-2019 04:10:00,0,2897.0,2121.0,0.732,13.765,20,10,0,10,10,1,9,0,0.0,0.0
1003,497,24-09-2019 04:12:00,0,2246.0,1764.0,0.785,10.804,144,96,68,28,48,36,12,33,0.0,0.0
1003,498,24-09-2019 04:14:00,0,2279.0,1672.0,0.734,10.83,167,94,62,32,73,42,31,28,0.0,0.0
1003,499,24-09-2019 04:16:00,0,2470.0,1899.0,0.769,11.833,150,87,58,29,63,43,20,12,0.01,0.0
1003,500,24-09-2019 04:18:00,0,1950.0,1516.0,0.778,9.361,177,87,71,16,90,68,22,19,0.0,0.0
1003,501,24-09-2019 04:20:00,0,1960.0,1481.0,0.755,9.363,179,119,87,32,60,36,24,45,0.0,0.0
1003,502,24-09-2019 04:22:00,0,2363.0,1797.0,0.76,11.3,145,81,58,23,64,36,28,21,0.0,0.0
1003,503,24-09-2019 04:24:00,0,2465.0,1927.0,0.782,11.846,60,19,6,13,41,21,20,0,0.0,0.0
1003,504,24-09-2019 04:26:00,0,2798.0,2009.0,0.718,13.249,163,103,68,35,60,40,20,26,0.0,0.0
1003,505,24-09-2019 04:28:00,0,2581.0,1919.0,0.743,12.294,44,18,5,13,26,16,10,0,0.02,0.0
1003,506,24-09-2019 04:30:00,0,2586.0,1951.0,0.754,12.352,283,139,98,41,144,102,42,30,0.0,0.0
1003,507,24-09-2019 04:32:00,0,1960.0,1460.0,0.745,9.338,48,29,5,24,19,8,11,2,0.0,0.0
1003,508,24-09-2019 04:34:00,0,1750.0,1330.0,0.76,8.367,31,12,4,8,19,5,14,0,0.0,0.0
1003,509,24-09-2019 04:36:00,0,1864.0,1372.0,0.736,8.862,145,48,29,19,97,57,40,0,0.0,0.0
1003,510,24-09-2019 04:38:00,0,2065.0,1542.0,0.747,9.843,59,9,2,7,50,17,33,0,0.0,0.0
1003,511,24-09-2019 04:40:00,0,2286.0,1650.0,0.722,10.832,44,12,1,11,32,2,30,0,0.0,0.0
1003,512,24-09-2019 04:42:00,0,2286.5,1659.0,0.7255,10.845,25,5,0,5,20,2,18,0,0.0,0.0
1003,513,24-09-2019 04:44:00,0,2287.0,1668.0,0.729,10.858,9,1,0,1,8,0,8,0,0.0,0.0
1003,514,24-09-2019 04:46:00,0,2070.0,1528.0,0.738,9.847,35,0,0,0,35,0,35,0,0.0,0.0
1003,515,24-09-2019 04:48:00,0,1966.0,1447.0,0.736,9.349,24,0,0,0,24,0,24,0,0.0,0.0
1003,516,24-09-2019 04:50:00,0,1974.0,1405.0,0.712,9.333,10,0,0,0,10,0,10,0,0.0,0.0
1003,517,24-09-2019 04:52:00,0,1747.0,1335.0,0.764,8.361,18,1,0,1,17,0,17,0,0.0,0.0
1003,518,24-09-2019 04:54:00,0,1766.0,1266.0,0.717,8.358,26,10,4,6,16,9,7,0,0.0,0.0
1003,519,24-09-2019 04:56:00,0,1760.0,1287.0,0.731,8.361,1,0,0,0,1,0,1,0,0.0,0.0
1003,520,24-09-2019 04:58:00,0,1775.0,1235.0,0.696,8.36,23,2,0,2,21,0,21,0,0.0,0.0
1003,521,24-09-2019 05:00:00,0,1545.0,1162.0,0.752,7.374,15,5,1,4,10,2,8,0,0.0,0.0
1003,522,24-09-2019 05:02:00,0,1566.0,1099.0,0.702,7.387,0,0,0,0,0,0,0,0,0.0,0.0
1003,523,24-09-2019 05:04:00,0,1456.0,1043.0,0.716,6.891,33,2,0,2,31,9,22,0,0.0,0.0
1003,524,24-09-2019 05:06:00,0,1343.0,997.0,0.743,6.395,34,0,0,0,34,3,31,0,0.0,0.0
1003,525,24-09-2019 05:08:00,0,1234.0,965.0,0.782,5.931,4,0,0,0,4,0,4,0,0.0,0.0
1003,526,24-09-2019 05:10:00,0,1231.0,954.0,0.775,5.908,0,0,0,0,0,0,0,0,0.0,0.0
1003,527,24-09-2019 05:12:00,0,1222.0,988.0,0.809,5.907,3,0,0,0,3,1,2,0,0.0,0.0
1003,528,24-09-2019 05:14:00,0,1222.0,981.0,0.803,5.899,0,0,0,0,0,0,0,0,0.0,0.0
1003,529,24-09-2019 05:16:00,0,1279.5,992.0,0.7765,6.139,4,0,0,0,4,0,4,0,0.0,0.0
1003,530,24-09-2019 05:18:00,0,1337.0,1003.0,0.75,6.379,0,0,0,0,0,0,0,0,0.0,0.0
1003,531,24-09-2019 05:20:00,0,1343.0,1002.0,0.746,6.402,0,0,0,0,0,0,0,0,0.0,0.0
1003,532,24-09-2019 05:22:00,0,1463.0,1034.0,0.706,6.91,0,0,0,0,0,0,0,0,0.0,0.0
1003,533,24-09-2019 05:24:00,0,1577.0,1066.0,0.676,7.395,8,0,0,0,8,3,5,0,0.0,0.0
1003,534,24-09-2019 05:26:00,0,1559.0,1112.0,0.713,7.372,0,0,0,0,0,0,0,0,0.0,0.0
1003,535,24-09-2019 05:28:00,0,1671.0,1166.0,0.698,7.875,2,0,0,0,2,0,2,0,0.0,0.0
1003,536,24-09-2019 05:30:00,0,1788.0,1203.0,0.673,8.378,5,0,0,0,5,0,5,0,0.0,0.0
1003,537,24-09-2019 05:32:00,0,1780.0,1224.0,0.688,8.367,39,0,0,0,39,0,39,0,0.0,0.0
1003,538,24-09-2019 05:34:00,0,1768.0,1271.0,0.719,8.375,12,0,0,0,12,0,12,0,0.0,0.0
1003,539,24-09-2019 05:36:00,0,1763.0,1307.0,0.741,8.393,13,1,0,1,12,0,12,0,0.0,0.0
1003,540,24-09-2019 05:38:00,0,1760.0,1275.0,0.725,8.347,9,1,1,0,8,3,5,0,0.0,0.0
1003,541,24-09-2019 05:40:00,0,1770.0,1242.0,0.702,8.348,0,0,0,0,0,0,0,0,0.0,0.0
1003,542,24-09-2019 05:42:00,0,1775.0,1249.0,0.703,8.378,29,15,9,6,14,9,5,1,0.0,0.0
1003,543,24-09-2019 05:44:00,0,1785.0,1202.0,0.674,8.364,83,22,11,11,61,27,34,0,0.0,0.0
1003,544,24-09-2019 05:46:00,0,1968.0,1440.0,0.732,9.346,99,39,16,23,60,23,37,0,0.0,0.0
1003,545,24-09-2019 05:48:00,0,2295.0,1608.0,0.701,10.822,125,79,59,20,46,33,13,11,0.0,0.0
1003,546,24-09-2019 05:50:00,0,2277.0,1677.0,0.737,10.8285,79,54,44,10,25,22,3,20,0.0,0.0
1003,547,24-09-2019 05:52:00,0,2259.0,1746.0,0.773,10.835,197,107,85,22,90,73,17,60,0.0,0.0
1003,548,24-09-2019 05:54:00,0,2986.0,2278.0,0.763,14.289,188,147,95,52,41,28,13,54,0.0,0.0
1003,549,24-09-2019 05:56:00,0,3018.0,2144.0,0.71,14.265,78,49,30,19,29,25,4,7,0.0,0.0
1003,550,24-09-2019 05:58:00,0,3022.0,2138.0,0.707,14.275,185,95,67,28,90,65,25,19,0.0,0.0
1003,551,24-09-2019 06:00:00,1,2274.0,1698.0,0.747,10.838,166,94,64,30,72,38,34,91,0.0,0.0
1003,552,24-09-2019 06:02:00,1,2464.0,1895.0,0.769,11.807,360,214,175,39,146,116,30,199,0.0,0.0
1003,553,24-09-2019 06:04:00,1,2690.0,1981.0,0.736,12.793,225,150,110,40,75,52,23,70,0.0,0.0
1003,554,24-09-2019 06:06:00,1,2576.0,1950.0,0.757,12.307,238,134,109,25,104,74,30,74,0.0,0.0
1003,555,24-09-2019 06:08:00,1,3199.0,2377.0,0.743,15.237,111,59,37,22,52,42,10,43,0.0,0.0
1003,556,24-09-2019 06:10:00,1,2484.0,1818.0,0.732,11.801,112,61,37,24,51,29,22,2,0.0,0.0
1003,557,24-09-2019 06:12:00,1,2291.0,1635.0,0.713,10.837,30,15,9,6,15,12,3,48,0.0,0.0
1003,558,24-09-2019 06:14:00,1,2275.0,1655.0,0.727,10.796,11,11,1,10,0,0,0,29,0.0,0.0
1003,559,24-09-2019 06:16:00,1,2265.0,1717.0,0.758,10.827,2,2,0,2,0,0,0,17,0.0,0.0
1003,560,24-09-2019 06:18:00,1,2258.0,1740.0,0.771,10.821,11,9,3,6,2,1,1,15,0.0,0.0
1003,561,24-09-2019 06:20:00,1,2275.0,1671.0,0.735,10.812,3,3,0,3,0,0,0,7,0.0,0.0
1003,562,24-09-2019 06:22:00,1,2270.0,1701.0,0.749,10.828,0,0,0,0,0,0,0,8,0.0,0.0
1003,563,24-09-2019 06:24:00,1,2113.5,1608.0,0.7615,10.1085,0,0,0,0,0,0,0,5,0.0,0.0
1003,564,24-09-2019 06:26:00,1,1957.0,1515.0,0.774,9.389,0,0,0,0,0,0,0,0,0.0,0.0
1003,565,24-09-2019 06:28:00,1,1976.0,1373.0,0.695,9.304,0,0,0,0,0,0,0,13,0.0,0.0
1003,566,24-09-2019 06:30:00,1,1752.0,1328.0,0.758,8.373,0,0,0,0,0,0,0,22,0.0,0.0
1003,567,24-09-2019 06:32:00,1,1776.0,1249.0,0.703,8.379,0,0,0,0,0,0,0,12,0.0,0.0
1003,568,24-09-2019 06:34:00,1,1666.0,1180.0,0.708,7.871,0,0,0,0,0,0,0,4,0.0,0.0
1003,569,24-09-2019 06:36:00,1,1550.0,1138.0,0.735,7.366,0,0,0,0,0,0,0,4,0.0,0.0
1003,570,24-09-2019 06:38:00,1,1575.0,1099.0,0.698,7.421,0,0,0,0,0,0,0,0,0.0,0.0
1003,571,24-09-2019 06:40:00,1,1455.0,1045.0,0.718,6.888,0,0,0,0,0,0,0,1,0.0,0.0
1003,572,24-09-2019 06:42:00,1,1549.0,1149.0,0.742,7.374,0,0,0,0,0,0,0,6,0.0,0.0
1003,573,24-09-2019 06:44:00,1,1548.0,1168.0,0.754,7.393,0,0,0,0,0,0,0,0,0.0,0.0
1003,574,24-09-2019 06:46:00,1,1561.0,1110.0,0.711,7.379,0,0,0,0,0,0,0,2,0.0,0.0
1003,575,24-09-2019 06:48:00,1,1446.0,1073.0,0.742,6.884,0,0,0,0,0,0,0,0,0.0,0.0
1003,576,24-09-2019 06:50:00,1,1446.0,1062.0,0.734,6.875,0,0,0,0,0,0,0,0,0.0,0.0
1003,577,24-09-2019 06:52:00,1,1333.0,1045.0,0.784,6.407,0,0,0,0,0,0,0,8,0.0,0.0
1003,578,24-09-2019 06:54:00,1,1333.0,1043.0,0.783,6.406,0,0,0,0,0,0,0,5,0.0,0.0
1003,579,24-09-2019 06:56:00,1,1331.0,1038.0,0.78,6.393,0,0,0,0,0,0,0,17,0.0,0.0
1003,580,24-09-2019 06:58:00,1,1442.5,1089.0,0.757,6.8885,0,0,0,0,0,0,0,16,0.0,0.0
1003,581,24-09-2019 07:00:00,1,1554.0,1140.0,0.734,7.384,5,5,2,3,0,0,0,29,0.0,0.0
1003,582,24-09-2019 07:02:00,1,1656.0,1214.0,0.733,7.869,6,6,3,3,0,0,0,38,0.0,0.0
1003,583,24-09-2019 07:04:00,1,1761.0,1296.0,0.736,8.375,240,160,128,32,80,53,27,77,0.0,0.0
1003,584,24-09-2019 07:06:00,1,1982.0,1396.0,0.705,9.354,74,38,30,8,36,26,10,55,0.0,0.0
1003,585,24-09-2019 07:08:00,1,1976.0,1419.0,0.718,9.357,2,2,1,1,0,0,0,36,0.0,0.0
1003,586,24-09-2019 07:10:00,1,1748.0,1344.0,0.769,8.374,0,0,0,0,0,0,0,41,0.0,0.0
1003,587,24-09-2019 07:12:00,1,1969.0,1449.0,0.736,9.363,0,0,0,0,0,0,0,11,0.0,0.0
1003,588,24-09-2019 07:14:00,1,1956.0,1465.0,0.749,9.33,0,0,0,0,0,0,0,0,0.0,0.0
1003,589,24-09-2019 07:16:00,1,1867.0,1357.0,0.727,8.857,0,0,0,0,0,0,0,0,0.0,0.0
1003,590,24-09-2019 07:18:00,1,1764.0,1264.0,0.717,8.348,0,0,0,0,0,0,0,0,0.0,0.0
1003,591,24-09-2019 07:20:00,1,1792.0,1191.0,0.665,8.378,0,0,0,0,0,0,0,1,0.0,0.0
1003,592,24-09-2019 07:22:00,1,1567.0,1079.0,0.689,7.368,0,0,0,0,0,0,0,0,0.0,0.0
1003,593,24-09-2019 07:24:00,1,1351.0,980.0,0.726,6.408,0,0,0,0,0,0,0,0,0.0,0.0
1003,594,24-09-2019 07:26:00,1,1235.0,943.0,0.764,5.908,0,0,0,0,0,0,0,1,0.0,0.0
1003,595,24-09-2019 07:28:00,1,1233.0,948.0,0.769,5.909,0,0,0,0,0,0,0,0,0.0,0.0
1003,596,24-09-2019 07:30:00,1,1234.0,940.0,0.762,5.901,0,0,0,0,0,0,0,0,0.0,0.0
1003,597,24-09-2019 07:32:00,1,1233.0,942.0,0.764,5.9005,0,0,0,0,0,0,0,1,0.0,0.0
1003,598,24-09-2019 07:34:00,1,1232.0,944.0,0.766,5.9,0,0,0,0,0,0,0,0,0.0,0.0
1003,599,24-09-2019 07:36:00,1,1240.0,942.0,0.76,5.929,0,0,0,0,0,0,0,0,0.0,0.0
1003,600,24-09-2019 07:38:00,1,1234.0,941.0,0.763,5.903,2,2,1,1,0,0,0,0,0.0,0.0
1003,601,24-09-2019 07:40:00,1,1347.0,972.0,0.722,6.385,0,0,0,0,0,0,0,0,0.0,0.0
1003,602,24-09-2019 07:42:00,1,1340.0,1005.0,0.75,6.391,0,0,0,0,0,0,0,0,0.0,0.0
1003,603,24-09-2019 07:44:00,1,1574.0,1055.0,0.67,7.369,0,0,0,0,0,0,0,0,0.0,0.0
1003,604,24-09-2019 07:46:00,1,1568.0,1084.0,0.691,7.378,0,0,0,0,0,0,0,1,0.0,0.0
1003,605,24-09-2019 07:48:00,1,1579.0,1054.0,0.668,7.388,0,0,0,0,0,0,0,0,0.0,0.0
1003,606,24-09-2019 07:50:00,1,1454.0,1039.0,0.715,6.88,3,3,1,2,0,0,0,0,0.0,0.0
1003,607,24-09-2019 07:52:00,1,1463.0,1012.0,0.692,6.887,0,0,0,0,0,0,0,3,0.0,0.0
1003,608,24-09-2019 07:54:00,1,1581.0,1029.0,0.651,7.369,0,0,0,0,0,0,0,7,0.0,0.0
1003,609,24-09-2019 07:56:00,1,1783.0,1212.0,0.68,8.367,0,0,0,0,0,0,0,0,0.0,0.0
1003,610,24-09-2019 07:58:00,1,1761.0,1279.0,0.726,8.354,0,0,0,0,0,0,0,1,0.0,0.0
1003,611,24-09-2019 08:00:00,1,1762.0,1280.0,0.726,8.359,0,0,0,0,0,0,0,8,0.0,0.0
1003,612,24-09-2019 08:02:00,1,1778.0,1260.0,0.709,8.4,0,0,0,0,0,0,0,1,0.0,0.0
1003,613,24-09-2019 08:04:00,1,1781.0,1209.0,0.679,8.355,0,0,0,0,0,0,0,1,0.0,0.0
1003,614,24-09-2019 08:06:00,1,1783.0,1206.0,0.6765,8.36,0,0,0,0,0,0,0,1,0.0,0.0
1003,615,24-09-2019 08:08:00,1,1785.0,1203.0,0.674,8.365,0,0,0,0,0,0,0,6,0.0,0.0
1003,616,24-09-2019 08:10:00,1,1773.0,1234.0,0.696,8.351,0,0,0,0,0,0,0,0,0.0,0.0
1003,617,24-09-2019 08:12:00,1,1787.0,1190.0,0.666,8.358,3,3,1,2,0,0,0,4,0.0,0.0
1003,618,24-09-2019 08:14:00,1,1789.0,1177.0,0.658,8.353,0,0,0,0,0,0,0,3,0.0,0.0
1003,619,24-09-2019 08:16:00,1,1666.0,1171.0,0.703,7.859,0,0,0,0,0,0,0,0,0.0,0.0
1003,620,24-09-2019 08:18:00,1,1791.0,1199.0,0.669,8.384,1,1,0,1,0,0,0,6,0.0,0.0
1003,621,24-09-2019 08:20:00,1,1580.0,1041.0,0.659,7.378,0,0,0,0,0,0,0,2,0.0,0.0
1003,622,24-09-2019 08:22:00,1,1468.0,998.0,0.68,6.889,0,0,0,0,0,0,0,20,0.0,0.0
1003,623,24-09-2019 08:24:00,1,1465.0,1016.0,0.693,6.899,0,0,0,0,0,0,0,12,0.0,0.0
1003,624,24-09-2019 08:26:00,1,1461.0,1008.0,0.69,6.871,0,0,0,0,0,0,0,7,0.0,0.0
1003,625,24-09-2019 08:28:00,1,1345.0,1009.0,0.75,6.416,0,0,0,0,0,0,0,1,0.0,0.0
1003,626,24-09-2019 08:30:00,1,1464.0,1005.0,0.686,6.882,0,0,0,0,0,0,0,2,0.0,0.0
1003,627,24-09-2019 08:32:00,1,1235.0,951.0,0.77,5.919,0,0,0,0,0,0,0,3,0.0,0.0
1003,628,24-09-2019 08:34:00,1,1239.0,924.0,0.746,5.906,0,0,0,0,0,0,0,3,0.0,0.0
1003,629,24-09-2019 08:36:00,1,1235.0,942.0,0.763,5.907,0,0,0,0,0,0,0,13,0.0,0.0
1003,630,24-09-2019 08:38:00,1,1578.0,1056.0,0.67,7.386,19,18,6,12,1,1,0,42,0.0,0.0
1003,631,24-09-2019 08:40:00,1,1768.0,1281.5,0.7195,8.3855,6,6,1,5,0,0,0,28,0.0,0.0
1003,632,24-09-2019 08:42:00,1,1958.0,1507.0,0.769,9.385,107,73,59,14,34,28,6,46,0.0,0.0
1003,633,24-09-2019 08:44:00,1,1946.0,1524.0,0.783,9.355,98,58,44,14,40,26,14,59,0.0,0.0
1003,634,24-09-2019 08:46:00,1,1946.0,1518.0,0.78,9.348,1,1,0,1,0,0,0,42,0.0,0.0
1003,635,24-09-2019 08:48:00,1,1950.0,1486.0,0.762,9.328,0,0,0,0,0,0,0,45,0.0,0.0
1003,636,24-09-2019 08:50:00,1,2068.0,1548.0,0.748,9.862,12,12,1,11,0,0,0,27,0.0,0.0
1003,637,24-09-2019 08:52:00,1,1945.0,1508.0,0.775,9.335,7,7,0,7,0,0,0,15,0.0,0.0
1003,638,24-09-2019 08:54:00,1,1979.0,1422.0,0.718,9.373,10,2,2,0,8,1,7,11,0.0,0.0
1003,639,24-09-2019 08:56:00,1,1753.0,1320.0,0.753,8.368,0,0,0,0,0,0,0,9,0.0,0.0
1003,640,24-09-2019 08:58:00,1,1769.0,1277.0,0.722,8.382,0,0,0,0,0,0,0,14,0.0,0.0
1003,641,24-09-2019 09:00:00,1,1546.0,1156.0,0.748,7.37,0,0,0,0,0,0,0,1,0.0,0.0
1003,642,24-09-2019 09:02:00,1,1455.0,1031.0,0.709,6.874,0,0,0,0,0,0,0,0,0.0,0.0
1003,643,24-09-2019 09:04:00,1,1233.0,953.0,0.773,5.915,0,0,0,0,0,0,0,3,0.0,0.0
1003,644,24-09-2019 09:06:00,1,1234.0,929.0,0.752,5.892,0,0,0,0,0,0,0,0,0.0,0.0
1003,645,24-09-2019 09:08:00,1,1242.0,931.0,0.75,5.925,0,0,0,0,0,0,0,2,0.0,0.0
1003,646,24-09-2019 09:10:00,1,1232.0,954.0,0.775,5.91,0,0,0,0,0,0,0,1,0.0,0.0
1003,647,24-09-2019 09:12:00,1,1225.0,980.0,0.8,5.914,0,0,0,0,0,0,0,23,0.0,0.0
1003,648,24-09-2019 09:14:00,1,1392.5,1052.0,0.7605,6.652,0,0,0,0,0,0,0,9,0.0,0.0
1003,649,24-09-2019 09:16:00,1,1560.0,1124.0,0.721,7.39,0,0,0,0,0,0,0,0,0.0,0.0
1003,650,24-09-2019 09:18:00,1,1549.0,1148.0,0.741,7.372,0,0,0,0,0,0,0,1,0.0,0.0
1003,651,24-09-2019 09:20:00,1,1671.0,1176.0,0.703,7.886,0,0,0,0,0,0,0,4,0.0,0.0
1003,652,24-09-2019 09:22:00,1,1784.0,1209.0,0.677,8.368,0,0,0,0,0,0,0,1,0.0,0.0
1003,653,24-09-2019 09:24:00,1,1781.0,1201.0,0.674,8.349,0,0,0,0,0,0,0,0,0.0,0.0
1003,654,24-09-2019 09:26:00,1,1668.0,1172.0,0.703,7.87,88,46,37,9,42,35,7,24,0.0,0.0
1003,655,24-09-2019 09:28:00,1,1867.0,1369.0,0.733,8.871,6,6,1,5,0,0,0,65,0.0,0.0
1003,656,24-09-2019 09:30:00,1,1859.0,1384.0,0.745,8.856,0,0,0,0,0,0,0,65,0.0,0.0
1003,657,24-09-2019 09:32:00,1,1868.0,1350.0,0.723,8.854,0,0,0,0,0,0,0,25,0.0,0.0
1003,658,24-09-2019 09:34:00,1,1857.0,1382.0,0.744,8.847,0,0,0,0,0,0,0,0,0.0,0.0
1003,659,24-09-2019 09:36:00,1,1760.0,1307.0,0.743,8.383,0,0,0,0,0,0,0,3,0.0,0.0
1003,660,24-09-2019 09:38:00,1,1550.0,1142.0,0.737,7.371,0,0,0,0,0,0,0,0,0.0,0.0
1003,661,24-09-2019 09:40:00,1,1348.0,996.0,0.739,6.413,0,0,0,0,0,0,0,0,0.0,0.0
1003,662,24-09-2019 09:42:00,1,1220.0,981.0,0.804,5.895,0,0,0,0,0,0,0,0,0.0,0.0
1003,663,24-09-2019 09:44:00,1,1458.0,1037.0,0.711,6.893,0,0,0,0,0,0,0,4,0.0,0.0
1003,664,24-09-2019 09:46:00,1,1573.0,1077.0,0.685,7.392,0,0,0,0,0,0,0,2,0.0,0.0
1003,665,24-09-2019 09:48:00,1,1561.5,1114.5,0.714,7.3865,0,0,0,0,0,0,0,0,0.0,0.0
1003,666,24-09-2019 09:50:00,1,1550.0,1152.0,0.743,7.381,0,0,0,0,0,0,0,1,0.0,0.0
1003,667,24-09-2019 09:52:00,1,1781.0,1198.0,0.673,8.343,0,0,0,0,0,0,0,0,0.0,0.0
1003,668,24-09-2019 09:54:00,1,1664.0,1189.0,0.714,7.873,0,0,0,0,0,0,0,2,0.0,0.0
1003,669,24-09-2019 09:56:00,1,1563.0,1104.0,0.706,7.38,0,0,0,0,0,0,0,1,0.0,0.0
1003,670,24-09-2019 09:58:00,1,1575.0,1063.0,0.675,7.382,0,0,0,0,0,0,0,3,0.0,0.0
1003,671,24-09-2019 10:00:00,1,1456.0,1040.0,0.714,6.888,0,0,0,0,0,0,0,6,0.0,0.0
1003,672,24-09-2019 10:02:00,1,1578.0,1064.0,0.675,7.394,0,0,0,0,0,0,0,0,0.0,0.0
1003,673,24-09-2019 10:04:00,1,1571.0,1065.0,0.678,7.368,0,0,0,0,0,0,0,0,0.0,0.0
1003,674,24-09-2019 10:06:00,1,1563.0,1113.0,0.712,7.389,0,0,0,0,0,0,0,0,0.0,0.0
1003,675,24-09-2019 10:08:00,1,1551.0,1148.0,0.74,7.381,0,0,0,0,0,0,0,4,0.0,0.0
1003,676,24-09-2019 10:10:00,1,1661.0,1190.0,0.716,7.862,0,0,0,0,0,0,0,3,0.0,0.0
1003,677,24-09-2019 10:12:00,1,1767.0,1253.0,0.709,8.351,2,2,1,1,0,0,0,37,0.0,0.0
1003,678,24-09-2019 10:14:00,1,1965.0,1439.0,0.732,9.337,0,0,0,0,0,0,0,2,0.0,0.0
1003,679,24-09-2019 10:16:00,1,1757.0,1304.0,0.742,8.367,0,0,0,0,0,0,0,7,0.0,0.0
1003,680,24-09-2019 10:18:00,1,1661.0,1191.0,0.717,7.863,0,0,0,0,0,0,0,0,0.0,0.0
1003,681,24-09-2019 10:20:00,1,1562.0,1105.0,0.708,7.379,0,0,0,0,0,0,0,1,0.0,0.0
1003,682,24-09-2019 10:22:00,1,1561.0,1106.0,0.709,7.375,0,0,0,0,0,0,0,2,0.0,0.0
1003,683,24-09-2019 10:24:00,1,1560.0,1107.0,0.71,7.371,0,0,0,0,0,0,0,5,0.0,0.0
1003,684,24-09-2019 10:26:00,1,1550.0,1165.0,0.752,7.399,0,0,0,0,0,0,0,9,0.0,0.0
1003,685,24-09-2019 10:28:00,1,1550.0,1142.0,0.737,7.371,0,0,0,0,0,0,0,22,0.0,0.0
1003,686,24-09-2019 10:30:00,1,1548.0,1151.0,0.743,7.373,0,0,0,0,0,0,0,7,0.0,0.0
1003,687,24-09-2019 10:32:00,1,1561.0,1109.0,0.711,7.377,0,0,0,0,0,0,0,1,0.0,0.0
1003,688,24-09-2019 10:34:00,1,1568.0,1107.0,0.706,7.405,0,0,0,0,0,0,0,3,0.0,0.0
1003,689,24-09-2019 10:36:00,1,1554.0,1134.0,0.73,7.378,0,0,0,0,0,0,0,2,0.0,0.0
1003,690,24-09-2019 10:38:00,1,1557.0,1138.0,0.731,7.394,0,0,0,0,0,0,0,0,0.0,0.0
1003,691,24-09-2019 10:40:00,1,1659.0,1201.0,0.724,7.867,0,0,0,0,0,0,0,2,0.0,0.0
1003,692,24-09-2019 10:42:00,1,1552.0,1129.0,0.727,7.365,0,0,0,0,0,0,0,5,0.0,0.0
1003,693,24-09-2019 10:44:00,1,1551.0,1154.0,0.744,7.387,0,0,0,0,0,0,0,3,0.0,0.0
1003,694,24-09-2019 10:46:00,1,1770.0,1257.0,0.71,8.367,0,0,0,0,0,0,0,10,0.0,0.0
1003,695,24-09-2019 10:48:00,1,1549.0,1162.0,0.75,7.39,0,0,0,0,0,0,0,3,0.0,0.0
1003,696,24-09-2019 10:50:00,1,1457.0,1049.0,0.72,6.902,0,0,0,0,0,0,0,0,0.0,0.0
1003,697,24-09-2019 10:52:00,1,1329.0,1040.0,0.783,6.386,0,0,0,0,0,0,0,0,0.0,0.0
1003,698,24-09-2019 10:54:00,1,1445.0,1069.0,0.74,6.877,0,0,0,0,0,0,0,1,0.0,0.0
1003,699,24-09-2019 10:56:00,1,1502.0,1088.5,0.7255,7.1235,0,0,0,0,0,0,0,1,0.0,0.0
1003,700,24-09-2019 10:58:00,1,1559.0,1108.0,0.711,7.37,0,0,0,0,0,0,0,0,0.0,0.0
1003,701,24-09-2019 11:00:00,1,1562.0,1108.0,0.709,7.382,0,0,0,0,0,0,0,6,0.0,0.0
1003,702,24-09-2019 11:02:00,1,1779.0,1218.0,0.684,8.36,0,0,0,0,0,0,0,2,0.0,0.0
1003,703,24-09-2019 11:04:00,1,1657.0,1221.0,0.737,7.882,0,0,0,0,0,0,0,0,0.0,0.0
1003,704,24-09-2019 11:06:00,1,1557.0,1110.0,0.713,7.365,0,0,0,0,0,0,0,0,0.0,0.0
1003,705,24-09-2019 11:08:00,1,1567.0,1085.0,0.693,7.374,0,0,0,0,0,0,0,0,0.0,0.0
1003,706,24-09-2019 11:10:00,1,1559.0,1100.0,0.706,7.363,0,0,0,0,0,0,0,0,0.0,0.0
1003,707,24-09-2019 11:12:00,1,1560.0,1127.0,0.722,7.394,0,0,0,0,0,0,0,9,0.0,0.0
1003,708,24-09-2019 11:14:00,1,1765.0,1295.0,0.734,8.388,8,7,1,6,1,0,1,28,0.0,0.0
1003,709,24-09-2019 11:16:00,1,1961.0,1455.0,0.742,9.337,2,2,1,1,0,0,0,32,0.0,0.0
1003,710,24-09-2019 11:18:00,1,2051.0,1613.0,0.787,9.866,25,15,10,5,10,9,1,34,0.0,0.0
1003,711,24-09-2019 11:20:00,1,1845.0,1433.0,0.777,8.857,279,159,119,40,120,91,29,64,0.0,0.0
1003,712,24-09-2019 11:22:00,1,2276.0,1675.0,0.736,10.822,89,56,42,14,33,19,14,61,0.0,0.0
1003,713,24-09-2019 11:24:00,1,2282.0,1648.0,0.722,10.816,113,60,36,24,53,35,18,9,0.0,0.0
1003,714,24-09-2019 11:26:00,1,2288.0,1641.0,0.717,10.832,98,68,40,28,30,15,15,72,0.0,0.0
1003,715,24-09-2019 11:28:00,1,2053.0,1570.0,0.764,9.827,225,134,98,36,91,63,28,65,0.0,0.0
1003,716,24-09-2019 11:30:00,1,2054.5,1574.5,0.766,9.8375,287,172,134,38,115,77,38,83,0.0,0.0
1003,717,24-09-2019 11:32:00,1,2056.0,1579.0,0.768,9.848,52,38,23,15,14,9,5,2,0.0,0.0
1003,718,24-09-2019 11:34:00,1,2060.0,1553.0,0.754,9.838,79,34,19,15,45,20,25,2,0.0,0.0
1003,719,24-09-2019 11:36:00,1,2056.0,1562.0,0.759,9.832,159,82,54,28,77,43,34,51,0.0,0.0
1003,720,24-09-2019 11:38:00,1,2291.0,1641.0,0.716,10.842,2,2,0,2,0,0,0,39,0.0,0.0
1003,721,24-09-2019 11:40:00,1,2069.0,1515.0,0.732,9.829,3,3,0,3,0,0,0,24,0.0,0.0
1003,722,24-09-2019 11:42:00,1,1968.0,1447.0,0.735,9.357,3,3,2,1,0,0,0,37,0.0,0.0
1003,723,24-09-2019 11:44:00,1,1947.0,1536.0,0.789,9.371,0,0,0,0,0,0,0,33,0.0,0.0
1003,724,24-09-2019 11:46:00,1,2168.0,1607.0,0.742,10.32,0,0,0,0,0,0,0,32,0.0,0.0
1003,725,24-09-2019 11:48:00,1,2168.0,1637.0,0.755,10.356,0,0,0,0,0,0,0,30,0.0,0.0
1003,726,24-09-2019 11:50:00,1,2269.0,1706.0,0.752,10.831,2,2,2,0,0,0,0,21,0.0,0.0
1003,727,24-09-2019 11:52:00,1,2273.0,1719.0,0.756,10.857,8,8,0,8,0,0,0,0,0.0,0.0
1003,728,24-09-2019 11:54:00,1,2055.0,1581.0,0.77,9.846,11,11,0,11,0,0,0,0,0.0,0.0
1003,729,24-09-2019 11:56:00,1,1965.0,1464.0,0.745,9.365,0,0,0,0,0,0,0,7,0.0,0.0
1003,730,24-09-2019 11:58:00,1,1775.0,1238.0,0.698,8.365,0,0,0,0,0,0,0,1,0.0,0.0
1003,731,24-09-2019 12:00:00,1,1658.0,1207.0,0.728,7.867,0,0,0,0,0,0,0,6,0.0,0.0
1003,732,24-09-2019 12:02:00,1,1762.0,1272.0,0.722,8.349,0,0,0,0,0,0,0,1,0.0,0.0
1003,733,24-09-2019 12:04:00,1,1770.0,1254.5,0.709,8.3615,0,0,0,0,0,0,0,0,0.0,0.0
1003,734,24-09-2019 12:06:00,1,1778.0,1237.0,0.696,8.374,0,0,0,0,0,0,0,1,0.0,0.0
1003,735,24-09-2019 12:08:00,1,1771.0,1255.0,0.709,8.367,0,0,0,0,0,0,0,2,0.0,0.0
1003,736,24-09-2019 12:10:00,1,1782.0,1222.0,0.686,8.376,0,0,0,0,0,0,0,0,0.0,0.0
1003,737,24-09-2019 12:12:00,1,1551.0,1149.0,0.74,7.384,0,0,0,0,0,0,0,7,0.0,0.0
1003,738,24-09-2019 12:14:00,1,1547.0,1149.0,0.743,7.369,0,0,0,0,0,0,0,13,0.0,0.0
1003,739,24-09-2019 12:16:00,1,1223.0,1001.0,0.819,5.926,0,0,0,0,0,0,0,4,0.0,0.0
1003,740,24-09-2019 12:18:00,1,1336.0,1019.0,0.762,6.392,0,0,0,0,0,0,0,0,0.0,0.0
1003,741,24-09-2019 12:20:00,1,1215.0,1009.0,0.83,5.906,0,0,0,0,0,0,0,1,0.0,0.0
1003,742,24-09-2019 12:22:00,1,1328.0,1052.0,0.793,6.397,0,0,0,0,0,0,0,3,0.0,0.0
1003,743,24-09-2019 12:24:00,1,1567.0,1089.0,0.695,7.379,0,0,0,0,0,0,0,0,0.0,0.0
1003,744,24-09-2019 12:26:00,1,1558.0,1106.0,0.71,7.365,0,0,0,0,0,0,0,3,0.0,0.0
1003,745,24-09-2019 12:28:00,1,1555.0,1134.0,0.73,7.381,0,0,0,0,0,0,0,1,0.0,0.0
1003,746,24-09-2019 12:30:00,1,1564.0,1092.0,0.698,7.37,0,0,0,0,0,0,0,12,0.0,0.0
1003,747,24-09-2019 12:32:00,1,1334.0,1056.0,0.792,6.423,0,0,0,0,0,0,0,0,0.0,0.0
1003,748,24-09-2019 12:34:00,1,1332.0,1042.0,0.782,6.4,0,0,0,0,0,0,0,23,0.0,0.0
1003,749,24-09-2019 12:36:00,1,1544.0,1179.0,0.763,7.389,0,0,0,0,0,0,0,0,0.0,0.0
1003,750,24-09-2019 12:38:00,1,1600.0,1192.5,0.7455,7.625,0,0,0,0,0,0,0,1,0.0,0.0
1003,751,24-09-2019 12:40:00,1,1656.0,1206.0,0.728,7.861,0,0,0,0,0,0,0,14,0.0,0.0
1003,752,24-09-2019 12:42:00,1,1780.0,1217.0,0.684,8.359,0,0,0,0,0,0,0,18,0.0,0.0
1003,753,24-09-2019 12:44:00,1,1775.0,1227.0,0.691,8.355,0,0,0,0,0,0,0,23,0.0,0.0
1003,754,24-09-2019 12:46:00,1,1770.0,1255.0,0.709,8.363,0,0,0,0,0,0,0,46,0.0,0.0
1003,755,24-09-2019 12:48:00,1,1776.0,1252.0,0.705,8.385,0,0,0,0,0,0,0,11,0.0,0.0
1003,756,24-09-2019 12:50:00,1,1552.0,1131.0,0.729,7.366,0,0,0,0,0,0,0,4,0.0,0.0
1003,757,24-09-2019 12:52:00,1,1444.0,1090.0,0.755,6.896,0,0,0,0,0,0,0,2,0.0,0.0
1003,758,24-09-2019 12:54:00,1,1562.0,1106.0,0.708,7.378,0,0,0,0,0,0,0,6,0.0,0.0
1003,759,24-09-2019 12:56:00,1,1553.0,1146.0,0.738,7.387,0,0,0,0,0,0,0,16,0.0,0.0
1003,760,24-09-2019 12:58:00,1,1770.0,1242.0,0.702,8.348,0,0,0,0,0,0,0,6,0.0,0.0
1003,761,24-09-2019 13:00:00,1,1767.0,1278.0,0.723,8.376,0,0,0,0,0,0,0,0,0.0,0.0
1003,762,24-09-2019 13:02:00,1,1755.0,1278.0,0.728,8.331,0,0,0,0,0,0,0,19,0.0,0.0
1003,763,24-09-2019 13:04:00,1,1552.0,1163.0,0.749,7.401,0,0,0,0,0,0,0,11,0.0,0.0
1003,764,24-09-2019 13:06:00,1,1330.0,1051.0,0.79,6.405,0,0,0,0,0,0,0,3,0.0,0.0
1003,765,24-09-2019 13:08:00,1,1213.0,1007.0,0.829,5.896,0,0,0,0,0,0,0,28,0.0,0.0
1003,766,24-09-2019 13:10:00,1,1332.0,1055.0,0.793,6.415,0,0,0,0,0,0,0,4,0.0,0.0
1003,767,24-09-2019 13:12:00,1,1440.5,1114.5,0.7755,6.9085,0,0,0,0,0,0,0,3,0.0,0.0
1003,768,24-09-2019 13:14:00,1,1549.0,1174.0,0.758,7.402,0,0,0,0,0,0,0,6,0.0,0.0
1003,769,24-09-2019 13:16:00,1,1545.0,1160.0,0.751,7.374,0,0,0,0,0,0,0,0,0.0,0.0
1003,770,24-09-2019 13:18:00,1,1549.0,1147.0,0.74,7.375,0,0,0,0,0,0,0,5,0.0,0.0
1003,771,24-09-2019 13:20:00,1,1323.0,1079.0,0.816,6.407,0,0,0,0,0,0,0,9,0.0,0.0
1003,772,24-09-2019 13:22:00,1,1329.0,1056.0,0.794,6.405,0,0,0,0,0,0,0,12,0.0,0.0
1003,773,24-09-2019 13:24:00,1,1542.0,1167.0,0.757,7.366,0,0,0,0,0,0,0,7,0.0,0.0
1003,774,24-09-2019 13:26:00,1,1550.0,1154.0,0.744,7.385,1,1,0,1,0,0,0,10,0.0,0.0
1003,775,24-09-2019 13:28:00,1,1427.0,1130.0,0.792,6.875,0,0,0,0,0,0,0,0,0.01,0.0
1003,776,24-09-2019 13:30:00,1,1435.0,1108.0,0.772,6.879,0,0,0,0,0,0,0,0,0.0,0.0
1003,777,24-09-2019 13:32:00,1,1434.0,1134.0,0.791,6.907,0,0,0,0,0,0,0,0,0.0,0.0
1003,778,24-09-2019 13:34:00,1,1556.0,1130.0,0.727,7.382,0,0,0,0,0,0,0,38,0.0,0.0
1003,779,24-09-2019 13:36:00,1,1652.0,1243.0,0.752,7.886,0,0,0,0,0,0,0,35,0.0,0.0
1003,780,24-09-2019 13:38:00,1,1750.0,1328.0,0.759,8.366,0,0,0,0,0,0,0,43,0.0,0.0
1003,781,24-09-2019 13:40:00,1,1738.0,1365.0,0.785,8.36,0,0,0,0,0,0,0,36,0.0,0.0
1003,782,24-09-2019 13:42:00,1,1929.0,1575.0,0.816,9.345,1,1,1,0,0,0,0,29,0.0,0.0
1003,783,24-09-2019 13:44:00,1,1937.0,1566.0,0.809,9.365,207,134,111,23,73,51,22,60,0.0,0.0
1003,784,24-09-2019 13:46:00,1,1938.0,1557.5,0.804,9.3595,3,3,2,1,0,0,0,29,0.0,0.0
1003,785,24-09-2019 13:48:00,1,1939.0,1549.0,0.799,9.354,0,0,0,0,0,0,0,10,0.0,0.0
1003,786,24-09-2019 13:50:00,1,1929.0,1580.0,0.819,9.349,0,0,0,0,0,0,0,28,0.0,0.0
1003,787,24-09-2019 13:52:00,1,1953.0,1511.0,0.774,9.366,7,5,2,3,2,2,0,25,0.0,0.0
1003,788,24-09-2019 13:54:00,1,1935.0,1554.0,0.803,9.345,2,2,0,2,0,0,0,35,0.0,0.0
1003,789,24-09-2019 13:56:00,1,2046.0,1613.0,0.789,9.847,0,0,0,0,0,0,0,2,0.0,0.0
1003,790,24-09-2019 13:58:00,1,1731.0,1412.0,0.816,8.383,0,0,0,0,0,0,0,0,0.0,0.0
1003,791,24-09-2019 14:00:00,1,1754.0,1319.0,0.752,8.372,0,0,0,0,0,0,0,2,0.0,0.0
1003,792,24-09-2019 14:02:00,1,1763.0,1276.0,0.724,8.359,0,0,0,0,0,0,0,0,0.0,0.0
1003,793,24-09-2019 14:04:00,1,1662.0,1208.0,0.727,7.886,0,0,0,0,0,0,0,4,0.0,0.0
1003,794,24-09-2019 14:06:00,1,1748.0,1367.0,0.782,8.399,0,0,0,0,0,0,0,0,0.0,0.0
1003,795,24-09-2019 14:08:00,1,1735.0,1371.0,0.79,8.355,0,0,0,0,0,0,0,0,0.0,0.0
1003,796,24-09-2019 14:10:00,1,1752.0,1341.0,0.765,8.386,0,0,0,0,0,0,0,0,0.0,0.0
1003,797,24-09-2019 14:12:00,1,1749.0,1319.0,0.754,8.352,0,0,0,0,0,0,0,0,0.0,0.0
1003,798,24-09-2019 14:14:00,1,1764.0,1288.0,0.73,8.376,0,0,0,0,0,0,0,0,0.0,0.0
1003,799,24-09-2019 14:16:00,1,1763.0,1286.0,0.729,8.372,0,0,0,0,0,0,0,1,0.0,0.0
1003,800,24-09-2019 14:18:00,1,1761.0,1286.0,0.73,8.364,0,0,0,0,0,0,0,2,0.0,0.0
1003,801,24-09-2019 14:20:00,1,1769.0,1265.0,0.715,8.372,0,0,0,0,0,0,0,5,0.0,0.0
1003,802,24-09-2019 14:22:00,1,1777.0,1244.0,0.7,8.38,0,0,0,0,0,0,0,2,0.0,0.0
1003,803,24-09-2019 14:24:00,1,1652.0,1230.0,0.744,7.869,0,0,0,0,0,0,0,6,0.0,0.0
1003,804,24-09-2019 14:26:00,1,1652.0,1230.0,0.744,7.872,0,0,0,0,0,0,0,5,0.0,0.0
1003,805,24-09-2019 14:28:00,1,1755.0,1293.0,0.737,8.346,0,0,0,0,0,0,0,3,0.0,0.0
1003,806,24-09-2019 14:30:00,1,1749.0,1336.0,0.764,8.37,0,0,0,0,0,0,0,0,0.0,0.0
1003,807,24-09-2019 14:32:00,1,1761.0,1308.0,0.743,8.386,0,0,0,0,0,0,0,4,0.0,0.0
1003,808,24-09-2019 14:34:00,1,1755.0,1318.0,0.751,8.373,0,0,0,0,0,0,0,3,0.0,0.0
1003,809,24-09-2019 14:36:00,1,1736.0,1382.0,0.796,8.371,0,0,0,0,0,0,0,1,0.0,0.0
1003,810,24-09-2019 14:38:00,1,1773.0,1237.0,0.698,8.356,0,0,0,0,0,0,0,0,0.0,0.0
1003,811,24-09-2019 14:40:00,1,1540.0,1193.0,0.775,7.387,0,0,0,0,0,0,0,6,0.0,0.0
1003,812,24-09-2019 14:42:00,1,1772.0,1238.0,0.698,8.353,2,1,1,0,1,1,0,22,0.0,0.0
1003,813,24-09-2019 14:44:00,1,1859.0,1393.0,0.749,8.868,0,0,0,0,0,0,0,8,0.0,0.0
1003,814,24-09-2019 14:46:00,1,1959.0,1485.0,0.758,9.363,0,0,0,0,0,0,0,27,0.0,0.0
1003,815,24-09-2019 14:48:00,1,1952.0,1494.0,0.765,9.347,5,5,1,4,0,0,0,19,0.0,0.0
1003,816,24-09-2019 14:50:00,1,1846.0,1426.0,0.773,8.853,6,6,0,6,0,0,0,27,0.0,0.0
1003,817,24-09-2019 14:52:00,1,1844.0,1435.0,0.778,8.856,0,0,0,0,0,0,0,0,0.0,0.0
1003,818,24-09-2019 14:54:00,1,1746.0,1343.5,0.769,8.368,0,0,0,0,0,0,0,2,0.0,0.0
1003,819,24-09-2019 14:56:00,1,1648.0,1252.0,0.76,7.88,0,0,0,0,0,0,0,4,0.0,0.0
1003,820,24-09-2019 14:58:00,1,1323.0,1079.0,0.816,6.406,0,0,0,0,0,0,0,4,0.0,0.0
1003,821,24-09-2019 15:00:00,1,1323.0,1075.0,0.813,6.405,0,0,0,0,0,0,0,32,0.0,0.0
1003,822,24-09-2019 15:02:00,1,1545.0,1156.0,0.749,7.367,0,0,0,0,0,0,0,4,0.0,0.0
1003,823,24-09-2019 15:04:00,1,1738.0,1358.0,0.781,8.353,0,0,0,0,0,0,0,0,0.0,0.0
1003,824,24-09-2019 15:06:00,1,1747.0,1333.0,0.763,8.361,0,0,0,0,0,0,0,0,0.0,0.0
1003,825,24-09-2019 15:08:00,1,1760.0,1301.0,0.739,8.375,0,0,0,0,0,0,0,0,0.0,0.0
1003,826,24-09-2019 15:10:00,1,1758.0,1271.0,0.723,8.335,0,0,0,0,0,0,0,5,0.0,0.0
1003,827,24-09-2019 15:12:00,1,1441.0,1098.0,0.762,6.892,0,0,0,0,0,0,0,2,0.0,0.0
1003,828,24-09-2019 15:14:00,1,1328.0,1051.0,0.792,6.397,0,0,0,0,0,0,0,4,0.0,0.0
1003,829,24-09-2019 15:16:00,1,1552.0,1129.0,0.727,7.366,0,0,0,0,0,0,0,0,0.0,0.0
1003,830,24-09-2019 15:18:00,1,1541.0,1173.0,0.761,7.369,0,0,0,0,0,0,0,1,0.0,0.0
1003,831,24-09-2019 15:20:00,1,1551.0,1160.0,0.748,7.396,0,0,0,0,0,0,0,32,0.0,0.0
1003,832,24-09-2019 15:22:00,1,1654.0,1232.0,0.745,7.881,0,0,0,0,0,0,0,10,0.0,0.0
1003,833,24-09-2019 15:24:00,1,1539.0,1187.0,0.771,7.379,0,0,0,0,0,0,0,3,0.0,0.0
1003,834,24-09-2019 15:26:00,1,1770.0,1245.0,0.703,8.354,0,0,0,0,0,0,0,3,0.0,0.0
1003,835,24-09-2019 15:28:00,1,1767.5,1257.0,0.711,8.3565,0,0,0,0,0,0,0,2,0.0,0.0
1003,836,24-09-2019 15:30:00,1,1765.0,1269.0,0.719,8.359,0,0,0,0,0,0,0,0,0.0,0.0
1003,837,24-09-2019 15:32:00,1,1779.0,1242.0,0.698,8.383,0,0,0,0,0,0,0,15,0.0,0.0
1003,838,24-09-2019 15:34:00,1,1749.0,1330.0,0.76,8.363,1,1,1,0,0,0,0,3,0.01,0.0
1003,839,24-09-2019 15:36:00,1,1767.0,1261.0,0.714,8.359,0,0,0,0,0,0,0,1,0.0,0.0
1003,840,24-09-2019 15:38:00,1,1546.0,1178.0,0.762,7.397,0,0,0,0,0,0,0,0,0.0,0.0
1003,841,24-09-2019 15:40:00,1,1540.0,1191.0,0.773,7.388,0,0,0,0,0,0,0,0,0.0,0.0
1003,842,24-09-2019 15:42:00,1,1539.0,1180.0,0.766,7.37,0,0,0,0,0,0,0,0,0.0,0.0
1003,843,24-09-2019 15:44:00,1,1549.0,1171.0,0.756,7.399,1,1,1,0,0,0,0,12,0.0,0.0
1003,844,24-09-2019 15:46:00,1,1539.0,1202.0,0.781,7.394,0,0,0,0,0,0,0,9,0.0,0.0
1003,845,24-09-2019 15:48:00,1,1542.0,1160.0,0.752,7.358,0,0,0,0,0,0,0,15,0.0,0.0
1003,846,24-09-2019 15:50:00,1,1547.0,1165.0,0.753,7.384,0,0,0,0,0,0,0,31,0.0,0.0
1003,847,24-09-2019 15:52:00,1,1658.0,1223.0,0.738,7.887,0,0,0,0,0,0,0,3,0.0,0.0
1003,848,24-09-2019 15:54:00,1,1542.0,1181.0,0.766,7.384,0,0,0,0,0,0,0,2,0.0,0.0
1003,849,24-09-2019 15:56:00,1,1553.0,1136.0,0.732,7.377,0,0,0,0,0,0,0,19,0.0,0.0
1003,850,24-09-2019 15:58:00,1,1550.0,1137.0,0.733,7.366,0,0,0,0,0,0,0,1,0.0,0.0
1003,851,24-09-2019 16:00:00,1,1550.0,1135.0,0.732,7.363,0,0,0,0,0,0,0,5,0.0,0.0
1003,852,24-09-2019 16:02:00,1,1541.5,1176.0,0.763,7.375,0,0,0,0,0,0,0,25,0.0,0.0
1003,853,24-09-2019 16:04:00,1,1533.0,1217.0,0.794,7.387,0,0,0,0,0,0,0,9,0.0,0.0
1003,854,24-09-2019 16:06:00,1,1655.0,1225.0,0.74,7.876,0,0,0,0,0,0,0,5,0.0,0.0
1003,855,24-09-2019 16:08:00,1,1651.0,1229.0,0.744,7.867,0,0,0,0,0,0,0,2,0.0,0.0
1003,856,24-09-2019 16:10:00,1,1544.0,1177.0,0.763,7.387,0,0,0,0,0,0,0,2,0.0,0.0
1003,857,24-09-2019 16:12:00,1,1554.0,1137.0,0.732,7.38,0,0,0,0,0,0,0,1,0.0,0.0
1003,858,24-09-2019 16:14:00,1,1557.0,1118.0,0.719,7.371,0,0,0,0,0,0,0,13,0.0,0.0
1003,859,24-09-2019 16:16:00,1,1553.0,1163.0,0.749,7.408,0,0,0,0,0,0,0,4,0.0,0.0
1003,860,24-09-2019 16:18:00,1,1544.0,1179.0,0.763,7.389,0,0,0,0,0,0,0,3,0.0,0.0
1003,861,24-09-2019 16:20:00,1,1563.0,1096.0,0.701,7.374,5,4,2,2,1,1,0,58,0.0,0.0
1003,862,24-09-2019 16:22:00,1,1763.0,1287.0,0.73,8.371,0,0,0,0,0,0,0,38,0.0,0.0
1003,863,24-09-2019 16:24:00,1,1728.0,1420.0,0.822,8.38,4,4,2,2,0,0,0,39,0.0,0.0
1003,864,24-09-2019 16:26:00,1,1937.0,1578.0,0.815,9.381,213,118,95,23,95,72,23,95,0.0,0.0
1003,865,24-09-2019 16:28:00,1,1956.0,1469.0,0.751,9.334,0,0,0,0,0,0,0,61,0.0,0.0
1003,866,24-09-2019 16:30:00,1,1966.0,1456.0,0.74,9.359,3,2,1,1,1,0,1,58,0.0,0.0
1003,867,24-09-2019 16:32:00,1,1955.0,1494.0,0.764,9.358,0,0,0,0,0,0,0,28,0.0,0.0
1003,868,24-09-2019 16:34:00,1,2041.0,1630.0,0.799,9.844,0,0,0,0,0,0,0,27,0.0,0.0
1003,869,24-09-2019 16:36:00,1,2045.0,1615.5,0.79,9.8455,2,2,1,1,0,0,0,19,0.0,0.0
1003,870,24-09-2019 16:38:00,1,2049.0,1601.0,0.781,9.847,0,0,0,0,0,0,0,8,0.0,0.0
1003,871,24-09-2019 16:40:00,1,1940.0,1537.0,0.793,9.345,0,0,0,0,0,0,0,1,0.0,0.0
1003,872,24-09-2019 16:42:00,1,1965.0,1457.0,0.741,9.356,0,0,0,0,0,0,0,1,0.0,0.0
1003,873,24-09-2019 16:44:00,1,1736.0,1389.0,0.8,8.378,7,7,0,7,0,0,0,12,0.0,0.0
1003,874,24-09-2019 16:46:00,1,1733.0,1407.0,0.812,8.384,0,0,0,0,0,0,0,0,0.0,0.0
1003,875,24-09-2019 16:48:00,1,1743.0,1351.0,0.775,8.365,0,0,0,0,0,0,0,0,0.0,0.0
1003,876,24-09-2019 16:50:00,1,1748.0,1338.0,0.765,8.368,0,0,0,0,0,0,0,0,0.0,0.0
1003,877,24-09-2019 16:52:00,1,1971.0,1414.0,0.717,9.33,0,0,0,0,0,0,0,0,0.0,0.0
1003,878,24-09-2019 16:54:00,1,1859.0,1373.0,0.739,8.847,0,0,0,0,0,0,0,6,0.0,0.0
1003,879,24-09-2019 16:56:00,1,1978.0,1400.0,0.707,9.345,0,0,0,0,0,0,0,1,0.0,0.0
1003,880,24-09-2019 16:58:00,1,1740.0,1362.0,0.783,8.364,0,0,0,0,0,0,0,1,0.0,0.0
1003,881,24-09-2019 17:00:00,1,1858.0,1374.0,0.739,8.842,0,0,0,0,0,0,0,0,0.0,0.0
1003,882,24-09-2019 17:02:00,1,1747.0,1331.0,0.762,8.356,0,0,0,0,0,0,0,2,0.0,0.0
1003,883,24-09-2019 17:04:00,1,1974.0,1418.0,0.718,9.348,0,0,0,0,0,0,0,16,0.0,0.0
1003,884,24-09-2019 17:06:00,1,1978.0,1404.0,0.71,9.347,17,17,2,15,0,0,0,37,0.0,0.0
1003,885,24-09-2019 17:08:00,1,1957.0,1493.0,0.763,9.364,9,9,3,6,0,0,0,34,0.0,0.0
1003,886,24-09-2019 17:10:00,1,2062.5,1570.0,0.7615,9.864,85,67,39,28,18,11,7,54,0.0,0.0
1003,887,24-09-2019 17:12:00,1,2168.0,1647.0,0.76,10.364,191,122,87,35,69,46,23,82,0.0,0.0
1003,888,24-09-2019 17:14:00,1,2171.0,1601.0,0.737,10.327,77,48,32,16,29,21,8,46,0.0,0.0
1003,889,24-09-2019 17:16:00,1,2058.0,1577.0,0.766,9.856,127,65,46,19,62,40,22,32,0.0,0.0
1003,890,24-09-2019 17:18:00,1,1938.0,1539.0,0.794,9.341,28,8,6,2,20,18,2,54,0.0,0.0
1003,891,24-09-2019 17:20:00,1,1960.0,1474.0,0.752,9.355,0,0,0,0,0,0,0,51,0.0,0.0
1003,892,24-09-2019 17:22:00,1,2072.0,1549.0,0.747,9.881,2,2,1,1,0,0,0,9,0.0,0.0
1003,893,24-09-2019 17:24:00,1,1758.0,1303.0,0.741,8.368,0,0,0,0,0,0,0,30,0.0,0.0
1003,894,24-09-2019 17:26:00,1,1662.0,1196.0,0.72,7.871,0,0,0,0,0,0,0,19,0.0,0.0
1003,895,24-09-2019 17:28:00,1,1547.0,1164.0,0.752,7.383,0,0,0,0,0,0,0,0,0.0,0.0
1003,896,24-09-2019 17:30:00,1,1560.0,1115.0,0.715,7.379,0,0,0,0,0,0,0,1,0.0,0.0
1003,897,24-09-2019 17:32:00,1,1566.0,1100.0,0.703,7.386,0,0,0,0,0,0,0,0,0.0,0.0
1003,898,24-09-2019 17:34:00,1,1563.0,1092.0,0.698,7.368,4,4,0,4,0,0,0,3,0.0,0.0
1003,899,24-09-2019 17:36:00,1,1655.0,1224.0,0.74,7.875,1,1,0,1,0,0,0,1,0.0,0.0
1003,900,24-09-2019 17:38:00,1,1756.0,1338.0,0.762,8.4,0,0,0,0,0,0,0,0,0.0,0.0
1003,901,24-09-2019 17:40:00,1,1743.0,1348.0,0.773,8.362,0,0,0,0,0,0,0,1,0.0,0.0
1003,902,24-09-2019 17:42:00,1,1861.0,1397.0,0.751,8.879,3,3,1,2,0,0,0,1,0.01,0.0
1003,903,24-09-2019 17:44:00,1,1809.5,1349.0,0.7455,8.6225,12,12,4,8,0,0,0,5,0.0,0.0
1003,904,24-09-2019 17:46:00,1,1758.0,1301.0,0.74,8.366,0,0,0,0,0,0,0,1,0.0,0.0
1003,905,24-09-2019 17:48:00,1,1760.0,1290.0,0.733,8.361,3,3,1,2,0,0,0,5,0.0,0.0
1003,906,24-09-2019 17:50:00,1,1758.0,1289.0,0.733,8.354,0,0,0,0,0,0,0,13,0.0,0.0
1003,907,24-09-2019 17:52:00,1,1558.0,1109.0,0.712,7.368,0,0,0,0,0,0,0,11,0.0,0.0
1003,908,24-09-2019 17:54:00,1,1455.0,1054.0,0.724,6.899,0,0,0,0,0,0,0,22,0.0,0.0
1003,909,24-09-2019 17:56:00,1,1551.0,1124.0,0.724,7.357,0,0,0,0,0,0,0,28,0.0,0.0
1003,910,24-09-2019 17:58:00,1,1746.0,1359.0,0.778,8.385,1,1,0,1,0,0,0,66,0.0,0.0
1003,911,24-09-2019 18:00:00,0,2277.0,1688.0,0.741,10.842,317,193,154,39,124,95,29,59,0.0,0.02
1003,912,24-09-2019 18:02:00,0,2170.0,1622.0,0.747,10.345,297,163,117,46,134,104,30,114,0.0,0.0
1003,913,24-09-2019 18:04:00,0,2482.0,1846.0,0.744,11.825,306,149,120,29,157,120,37,102,0.0,0.0
1003,914,24-09-2019 18:06:00,0,2279.0,1656.0,0.726,10.814,254,165,123,42,89,65,24,148,0.0,0.0
1003,915,24-09-2019 18:08:00,0,2260.0,1760.0,0.779,10.853,385,245,202,43,140,108,32,166,0.0,0.0
1003,916,24-09-2019 18:10:00,0,2786.0,2063.0,0.74,13.26,242,127,90,37,115,91,24,37,0.0,0.0
1003,917,24-09-2019 18:12:00,0,2799.0,2048.0,0.732,13.295,273,155,123,32,118,94,24,142,0.0,0.0
1003,918,24-09-2019 18:14:00,0,2461.0,1928.0,0.784,11.832,113,75,51,24,38,31,7,46,0.0,0.0
1003,919,24-09-2019 18:16:00,0,2067.0,1537.0,0.744,9.845,224,104,72,32,120,86,34,70,0.0,0.0
1003,920,24-09-2019 18:18:00,0,2276.0,1690.5,0.743,10.8395,264,166,122,44,98,64,34,64,0.0,0.0
1003,921,24-09-2019 18:20:00,0,2485.0,1844.0,0.742,11.834,119,57,36,21,62,41,21,20,0.0,0.0
1003,922,24-09-2019 18:22:00,0,2484.0,1839.0,0.74,11.822,304,166,120,46,138,98,40,40,0.0,0.0
1003,923,24-09-2019 18:24:00,0,2272.0,1673.0,0.736,10.805,330,178,140,38,152,113,39,112,0.0,0.0
1003,924,24-09-2019 18:26:00,0,2291.0,1592.0,0.695,10.791,280,178,132,46,102,71,31,115,0.0,0.0
1003,925,24-09-2019 18:28:00,0,3021.0,2140.0,0.709,14.272,93,51,39,12,42,29,13,36,0.01,0.0
1003,926,24-09-2019 18:30:00,0,2799.0,2054.0,0.734,13.302,153,70,45,25,83,58,25,12,0.0,0.0
1003,927,24-09-2019 18:32:00,0,2802.0,2004.0,0.715,13.258,100,50,19,31,50,28,22,5,0.0,0.0
1003,928,24-09-2019 18:34:00,0,2698.0,1958.0,0.726,12.799,135,83,56,27,52,32,20,42,0.0,0.0
1003,929,24-09-2019 18:36:00,0,1971.0,1405.0,0.713,9.322,247,119,89,30,128,90,38,43,0.0,0.0
1003,930,24-09-2019 18:38:00,0,1977.0,1412.0,0.714,9.354,192,123,79,44,69,38,31,8,0.0,0.0
1003,931,24-09-2019 18:40:00,0,2580.0,1893.0,0.734,12.263,104,78,45,33,26,10,16,0,0.0,0.0
1003,932,24-09-2019 18:42:00,0,2581.0,1927.0,0.747,12.303,138,93,55,38,45,22,23,24,0.0,0.0
1003,933,24-09-2019 18:44:00,0,2829.0,1967.0,0.695,13.322,204,147,116,31,57,47,10,85,0.0,0.0
1003,934,24-09-2019 18:46:00,0,2808.0,1977.0,0.704,13.255,267,185,135,50,82,58,24,121,0.0,0.01
1003,935,24-09-2019 18:48:00,0,2692.0,1936.0,0.719,12.749,132,93,47,46,39,8,31,54,0.0,0.0
1003,936,24-09-2019 18:50:00,0,2924.0,2085.0,0.713,13.83,150,74,41,33,76,36,40,65,0.0,0.0
1003,937,24-09-2019 18:52:00,0,2859.5,2046.0,0.7155,13.5325,168,96,67,29,72,33,39,78,0.0,0.0
1003,938,24-09-2019 18:54:00,0,2795.0,2007.0,0.718,13.235,278,192,150,42,86,58,28,110,0.0,0.0
1003,939,24-09-2019 18:56:00,0,2485.0,1828.0,0.735,11.817,313,191,162,29,122,97,25,160,0.01,0.0
1003,940,24-09-2019 18:58:00,0,2476.0,1862.0,0.752,11.819,406,232,194,38,174,137,37,175,0.0,0.0
1003,941,24-09-2019 19:00:00,0,2812.0,2000.0,0.711,13.293,243,109,84,25,134,89,45,68,0.0,0.0
1003,942,24-09-2019 19:02:00,0,1973.0,1412.0,0.716,9.336,240,115,85,30,125,86,39,14,0.0,0.0
1003,943,24-09-2019 19:04:00,0,2371.0,1782.0,0.752,11.316,148,86,60,26,62,46,16,59,0.0,0.0
1003,944,24-09-2019 19:06:00,0,2482.0,1836.0,0.74,11.811,374,228,184,44,146,113,33,162,0.0,0.0
1003,945,24-09-2019 19:08:00,0,3000.0,2232.0,0.744,14.29,100,50,21,29,50,25,25,10,0.0,0.0
1003,946,24-09-2019 19:10:00,0,2923.0,2050.0,0.701,13.788,194,98,69,29,96,59,37,41,0.0,0.0
1003,947,24-09-2019 19:12:00,0,2388.0,1714.0,0.718,11.306,94,52,27,25,42,16,26,0,0.0,0.0
1003,948,24-09-2019 19:14:00,0,2821.0,1936.0,0.686,13.258,295,191,136,55,104,61,43,22,0.0,0.0
1003,949,24-09-2019 19:16:00,0,2799.0,2033.0,0.726,13.28,367,215,165,50,152,125,27,117,0.01,0.0
1003,950,24-09-2019 19:18:00,0,2802.0,2058.0,0.734,13.317,142,80,57,23,62,52,10,79,0.0,0.0
1003,951,24-09-2019 19:20:00,0,2809.0,1963.0,0.699,13.24,209,128,88,40,81,42,39,32,0.0,0.11
1003,952,24-09-2019 19:22:00,0,2791.0,2088.0,0.748,13.309,157,108,65,43,49,28,21,56,0.0,0.0
1003,953,24-09-2019 19:24:00,0,3001.0,2226.0,0.742,14.29,173,111,72,39,62,20,42,69,0.0,0.0
1003,954,24-09-2019 19:26:00,0,2993.0,2245.5,0.7505,14.279,144,80,51,29,64,28,36,72,0.0,0.0
1003,955,24-09-2019 19:28:00,0,2985.0,2265.0,0.759,14.268,218,128,85,43,90,44,46,48,0.0,0.0
1003,956,24-09-2019 19:30:00,0,3001.0,2182.0,0.727,14.242,166,102,68,34,64,25,39,53,0.0,0.0
1003,957,24-09-2019 19:32:00,0,3216.0,2347.0,0.73,15.272,172,105,61,44,67,16,51,71,0.0,0.0
1003,958,24-09-2019 19:34:00,0,2995.0,2243.0,0.749,14.284,157,75,38,37,82,34,48,63,0.0,0.0
1003,959,24-09-2019 19:36:00,0,3199.0,2382.0,0.745,15.242,181,89,56,33,92,38,54,61,0.0,0.0
1003,960,24-09-2019 19:38:00,0,3181.0,2525.0,0.794,15.33,160,57,26,31,103,61,42,36,0.0,0.0
1003,961,24-09-2019 19:40:00,0,3179.0,2473.0,0.778,15.263,162,73,45,28,89,34,55,65,0.0,0.0
1003,962,24-09-2019 19:42:00,0,3180.0,2455.0,0.772,15.248,179,102,62,40,77,37,40,72,0.0,0.0
1003,963,24-09-2019 19:44:00,0,3141.0,2617.0,0.833,15.274,221,100,59,41,121,67,54,55,0.0,0.0
1003,964,24-09-2019 19:46:00,0,3143.0,2625.0,0.835,15.292,178,79,45,34,99,47,52,49,0.0,0.0
1003,965,24-09-2019 19:48:00,0,3167.0,2505.0,0.791,15.252,215,153,105,48,62,20,42,77,0.0,0.0
1003,966,24-09-2019 19:50:00,0,3048.0,2510.0,0.824,14.786,186,105,66,39,81,43,38,70,0.0,0.0
1003,967,24-09-2019 19:52:00,0,3461.0,2802.0,0.809,16.74,323,152,106,46,171,112,59,56,0.02,0.03
1003,968,24-09-2019 19:54:00,0,3035.0,2548.0,0.84,14.779,164,83,52,31,81,44,37,39,0.33,0.01
1003,969,24-09-2019 19:56:00,0,3145.0,2593.0,0.824,15.262,161,95,55,40,66,32,34,49,0.0,0.03
1003,970,24-09-2019 19:58:00,0,2934.0,2448.0,0.834,14.269,316,173,142,31,143,98,45,64,0.0,0.0
1003,971,24-09-2019 20:00:00,0,3187.5,2662.0,0.835,15.5055,185,108,73,35,77,40,37,61,0.0,0.0
1003,972,24-09-2019 20:02:00,0,3441.0,2876.0,0.836,16.742,218,120,78,42,98,53,45,42,0.0,0.02
1003,973,24-09-2019 20:04:00,0,3445.0,2873.0,0.834,16.755,194,86,45,41,108,69,39,62,0.0,0.0
1003,974,24-09-2019 20:06:00,0,3417.0,2980.0,0.872,16.764,148,89,58,31,59,17,42,77,0.0,0.0
1003,975,24-09-2019 20:08:00,0,3326.0,2874.0,0.864,16.285,101,58,33,25,43,15,28,43,0.01,0.13
1003,976,24-09-2019 20:10:00,0,3324.0,2860.0,0.86,16.263,179,117,89,28,62,44,18,61,0.21,0.03
1003,977,24-09-2019 20:12:00,0,3105.0,2792.0,0.899,15.326,142,77,41,36,65,25,40,86,0.01,0.0
1003,978,24-09-2019 20:14:00,0,3105.0,2789.0,0.898,15.32,183,113,73,40,70,33,37,58,0.0,0.05
1003,979,24-09-2019 20:16:00,0,3417.0,3003.0,0.879,16.789,151,77,31,46,74,19,55,72,0.0,0.02
1003,980,24-09-2019 20:18:00,0,2905.0,2548.0,0.877,14.266,223,135,105,30,88,54,34,63,0.06,0.02
1003,981,24-09-2019 20:20:00,0,3514.0,3077.0,0.876,17.25,164,103,71,32,61,28,33,41,0.05,0.01
1003,982,24-09-2019 20:22:00,0,3419.0,2934.0,0.858,16.718,141,91,56,35,50,15,35,63,0.01,0.0
1003,983,24-09-2019 20:24:00,0,3624.0,3156.0,0.871,17.775,295,190,148,42,105,71,34,52,0.03,0.0
1003,984,24-09-2019 20:26:00,0,2898.0,2675.0,0.923,14.38,359,226,174,52,133,100,33,96,0.0,0.05
1003,985,24-09-2019 20:28:00,0,2699.0,2379.0,0.881,13.267,58,33,26,7,25,21,4,73,0.01,0.0
1003,986,24-09-2019 20:30:00,0,2203.0,1956.0,0.888,10.844,67,56,41,15,11,6,5,70,0.0,0.0
1003,987,24-09-2019 20:32:00,0,3425.0,2906.0,0.849,16.711,128,76,48,28,52,20,32,59,0.0,0.0
1003,988,24-09-2019 20:34:00,0,3409.0,3001.5,0.881,16.754,124,68,44,24,56,2,54,60,0.01,0.0
1003,989,24-09-2019 20:36:00,0,3393.0,3097.0,0.913,16.797,198,115,77,38,83,49,34,59,0.0,0.01
1003,990,24-09-2019 20:38:00,0,3591.0,3284.0,0.915,17.783,188,107,73,34,81,42,39,64,0.0,0.06
1003,991,24-09-2019 20:40:00,0,2604.0,2316.0,0.889,12.825,52,11,6,5,41,26,15,0,0.0,0.01
1003,992,24-09-2019 20:42:00,0,2228.0,1854.0,0.832,10.831,18,6,4,2,12,9,3,0,0.0,0.0
1003,993,24-09-2019 20:44:00,0,2238.0,1803.0,0.806,10.813,16,6,2,4,10,5,5,0,0.0,0.0
1003,994,24-09-2019 20:46:00,0,2000.0,1763.0,0.882,9.832,8,2,0,2,6,5,1,0,0.0,0.0
1003,995,24-09-2019 20:48:00,0,2008.0,1763.0,0.878,9.865,6,4,0,4,2,1,1,0,0.0,0.0
1003,996,24-09-2019 20:50:00,0,1904.0,1685.0,0.885,9.367,49,31,13,18,18,14,4,0,0.0,0.0
1003,997,24-09-2019 20:52:00,0,1925.0,1615.0,0.839,9.373,295,155,115,40,140,100,40,25,0.05,0.04
1003,998,24-09-2019 20:54:00,0,2899.0,2549.0,0.879,14.245,115,81,45,36,34,8,26,53,0.0,0.0
1003,999,24-09-2019 20:56:00,0,3394.0,3076.0,0.906,16.78,153,103,67,36,50,22,28,80,0.0,0.01
1003,1000,24-09-2019 20:58:00,0,3684.0,3399.0,0.923,18.279,126,73,42,31,53,29,24,44,0.0,0.09
1003,1001,24-09-2019 21:00:00,0,3577.0,3269.0,0.914,17.713,193,110,76,34,83,61,22,42,0.25,0.03
1003,1002,24-09-2019 21:02:00,0,3554.0,3388.0,0.953,17.755,332,205,158,47,127,92,35,143,0.0,0.0
1003,1003,24-09-2019 21:04:00,0,3604.0,3173.0,0.88,17.713,186,97,61,36,89,46,43,80,0.0,0.02
1003,1004,24-09-2019 21:06:00,0,3926.0,3435.0,0.875,19.271,154,92,64,28,62,23,39,62,0.04,0.09
1003,1005,24-09-2019 21:08:00,0,3862.5,3418.0,0.885,19.002,233,152,99,53,81,53,28,57,0.02,0.03
1003,1006,24-09-2019 21:10:00,0,3799.0,3401.0,0.895,18.733,127,67,38,29,60,33,27,48,0.0,0.04
1003,1007,24-09-2019 21:12:00,0,3789.0,3434.0,0.907,18.73,112,80,55,25,32,17,15,60,0.0,0.06
1003,1008,24-09-2019 21:14:00,0,3691.0,3366.0,0.912,18.267,97,59,29,30,38,13,25,36,0.0,0.08
1003,1009,24-09-2019 21:16:00,0,3805.0,3411.0,0.897,18.768,286,156,124,32,130,91,39,81,0.14,0.0
1003,1010,24-09-2019 21:18:00,0,2674.0,2475.0,0.926,13.276,369,191,143,48,178,126,52,74,0.03,0.04
1003,1011,24-09-2019 21:20:00,0,3386.0,3091.0,0.913,16.762,200,111,76,35,89,62,27,67,0.01,0.0
1003,1012,24-09-2019 21:22:00,0,3569.0,3324.0,0.931,17.742,135,89,62,27,46,28,18,36,0.0,0.42
1003,1013,24-09-2019 21:24:00,0,2895.0,2592.0,0.895,14.274,44,24,0,24,20,0,20,0,0.0,0.0
1003,1014,24-09-2019 21:26:00,0,2205.0,1933.0,0.877,10.829,254,141,102,39,113,89,24,86,0.08,0.01
1003,1015,24-09-2019 21:28:00,0,3182.0,2945.0,0.926,15.798,314,163,134,29,151,119,32,136,0.0,0.01
1003,1016,24-09-2019 21:30:00,0,3982.0,3621.0,0.909,19.699,285,170,135,35,115,88,27,120,0.12,0.0
1003,1017,24-09-2019 21:32:00,0,3172.0,2960.0,0.933,15.773,264,155,122,33,109,84,25,113,0.0,0.0
1003,1018,24-09-2019 21:34:00,0,3884.0,3582.0,0.922,19.267,265,161,130,31,104,76,28,64,0.0,0.04
1003,1019,24-09-2019 21:36:00,0,3581.0,3280.0,0.916,17.742,349,183,149,34,166,137,29,94,0.0,0.0
1003,1020,24-09-2019 21:38:00,0,3571.0,3321.0,0.93,17.746,116,56,39,17,60,46,14,11,0.0,0.0
1003,1021,24-09-2019 21:40:00,0,2896.0,2610.0,0.901,14.299,119,49,39,10,70,50,20,3,0.02,0.0
1003,1022,24-09-2019 21:42:00,0,2898.5,2595.0,0.895,14.2915,81,40,28,12,41,30,11,17,0.0,0.0
1003,1023,24-09-2019 21:44:00,0,2901.0,2580.0,0.889,14.284,142,79,65,14,63,47,16,88,0.18,0.0
1003,1024,24-09-2019 21:46:00,0,3390.0,3069.0,0.905,16.756,440,241,198,43,199,162,37,106,0.0,0.0
1003,1025,24-09-2019 21:48:00,0,3170.0,2991.0,0.943,15.799,319,175,133,42,144,115,29,141,0.0,0.0
1003,1026,24-09-2019 21:50:00,0,3363.0,3141.0,0.934,16.726,325,171,137,34,154,123,31,44,0.0,0.0
1003,1027,24-09-2019 21:52:00,0,3371.0,3110.0,0.922,16.726,182,82,67,15,100,89,11,27,0.0,0.0
1003,1028,24-09-2019 21:54:00,0,2672.0,2511.0,0.94,13.308,206,100,75,25,106,83,23,93,0.0,0.0
1003,1029,24-09-2019 21:56:00,0,3368.0,3161.0,0.939,16.769,1,1,1,0,0,0,0,59,0.0,0.0
1003,1030,24-09-2019 21:58:00,0,3377.0,3117.0,0.923,16.756,4,4,1,3,0,0,0,48,0.0,0.0
1003,1031,24-09-2019 22:00:00,0,3053.0,2899.0,0.95,15.239,0,0,0,0,0,0,0,48,0.0,0.0
1003,1032,24-09-2019 22:02:00,0,3388.0,3131.0,0.924,16.814,2,1,1,0,1,0,1,46,0.0,0.0
1003,1033,24-09-2019 22:04:00,0,3164.0,3011.0,0.951,15.8,0,0,0,0,0,0,0,31,0.0,0.0
1003,1034,24-09-2019 22:06:00,0,3080.0,2881.0,0.935,15.326,0,0,0,0,0,0,0,0,0.0,0.0
1003,1035,24-09-2019 22:08:00,0,3079.0,2850.0,0.926,15.286,0,0,0,0,0,0,0,0,0.0,0.0
1003,1036,24-09-2019 22:10:00,0,2873.0,2670.0,0.929,14.275,0,0,0,0,0,0,0,0,0.0,0.0
1003,1037,24-09-2019 22:12:00,0,2672.0,2547.0,0.953,13.345,0,0,0,0,0,0,0,1,0.0,0.0
1003,1038,24-09-2019 22:14:00,0,2668.0,2509.0,0.94,13.288,0,0,0,0,0,0,0,2,0.0,0.0
1003,1039,24-09-2019 22:16:00,0,2564.0,2452.5,0.957,12.817,0,0,0,0,0,0,0,0,0.0,0.0
1003,1040,24-09-2019 22:18:00,0,2460.0,2396.0,0.974,12.346,0,0,0,0,0,0,0,0,0.0,0.0
1003,1041,24-09-2019 22:20:00,0,2341.0,2369.0,1.012,11.844,0,0,0,0,0,0,0,13,0.0,0.0
1003,1042,24-09-2019 22:22:00,0,2344.0,2370.0,1.011,11.86,0,0,0,0,0,0,0,42,0.0,0.0
1003,1043,24-09-2019 22:24:00,0,2375.0,2292.0,0.965,11.894,0,0,0,0,0,0,0,9,0.0,0.0
1003,1044,24-09-2019 22:26:00,0,2146.0,2140.0,0.998,10.823,101,61,52,9,40,28,12,39,0.0,0.0
1003,1045,24-09-2019 22:28:00,0,2172.0,2068.0,0.952,10.845,182,107,64,43,75,52,23,39,0.0,0.0
1003,1046,24-09-2019 22:30:00,0,2370.0,2273.0,0.959,11.855,336,198,153,45,138,109,29,147,0.0,0.0
1003,1047,24-09-2019 22:32:00,0,2349.0,2358.0,1.004,11.864,232,134,106,28,98,77,21,71,0.01,0.0
1003,1048,24-09-2019 22:34:00,0,2344.0,2361.0,1.007,11.847,120,86,58,28,34,23,11,85,0.01,0.0
1003,1049,24-09-2019 22:36:00,0,2775.0,2609.0,0.94,13.821,168,86,66,20,82,51,31,58,0.03,0.0
1003,1050,24-09-2019 22:38:00,0,2693.0,2481.0,0.921,13.358,197,125,88,37,72,47,25,5,0.0,0.0
1003,1051,24-09-2019 22:40:00,0,2675.0,2507.0,0.937,13.316,181,70,39,31,111,74,37,2,0.0,0.0
1003,1052,24-09-2019 22:42:00,0,2667.0,2539.0,0.952,13.317,302,193,155,38,109,73,36,87,0.0,0.0
1003,1053,24-09-2019 22:44:00,0,2866.0,2731.0,0.953,14.314,245,142,96,46,103,70,33,57,0.0,0.04
1003,1054,24-09-2019 22:46:00,0,2841.0,2779.0,0.978,14.269,166,73,47,26,93,48,45,60,0.0,0.0
1003,1055,24-09-2019 22:48:00,0,3033.0,3049.0,1.005,15.325,225,125,90,35,100,60,40,101,0.07,0.0
1003,1056,24-09-2019 22:50:00,0,3029.5,3031.5,1.0005,15.291,273,140,98,42,133,94,39,42,0.01,0.04
1003,1057,24-09-2019 22:52:00,0,3026.0,3014.0,0.996,15.257,190,109,82,27,81,58,23,71,0.03,0.0
1003,1058,24-09-2019 22:54:00,0,2840.0,2783.0,0.98,14.27,22,14,12,2,8,8,0,69,0.01,0.0
1003,1059,24-09-2019 22:56:00,0,2851.0,2787.0,0.978,14.317,2,1,0,1,1,0,1,49,0.0,0.0
1003,1060,24-09-2019 22:58:00,0,3056.0,2991.0,0.979,15.353,0,0,0,0,0,0,0,21,0.0,0.0
1003,1061,24-09-2019 23:00:00,0,3145.0,3059.0,0.973,15.776,0,0,0,0,0,0,0,10,0.0,0.0
1003,1062,24-09-2019 23:02:00,0,3071.0,2872.0,0.935,15.281,0,0,0,0,0,0,0,1,0.0,0.0
1003,1063,24-09-2019 23:04:00,0,2862.0,2768.0,0.967,14.341,0,0,0,0,0,0,0,3,0.0,0.0
1003,1064,24-09-2019 23:06:00,0,2766.0,2618.0,0.946,13.797,0,0,0,0,0,0,0,0,0.0,0.0
1003,1065,24-09-2019 23:08:00,0,2693.0,2446.0,0.908,13.318,0,0,0,0,0,0,0,2,0.0,0.0
1003,1066,24-09-2019 23:10:00,0,2367.0,2274.0,0.96,11.845,0,0,0,0,0,0,0,29,0.0,0.0
1003,1067,24-09-2019 23:12:00,0,2386.0,2183.0,0.915,11.819,185,114,90,24,71,57,14,72,0.0,0.0
1003,1068,24-09-2019 23:14:00,0,2348.0,2348.0,1.0,11.851,107,72,45,27,35,26,9,62,0.05,0.0
1003,1069,24-09-2019 23:16:00,0,2345.0,2353.0,1.003,11.843,0,0,0,0,0,0,0,39,0.0,0.0
1003,1070,24-09-2019 23:18:00,0,2576.0,2426.0,0.942,12.834,12,10,3,7,2,1,1,56,0.0,0.0
1003,1071,24-09-2019 23:20:00,0,2666.0,2555.0,0.959,13.332,294,177,142,35,117,87,30,100,0.03,0.0
1003,1072,24-09-2019 23:22:00,0,2667.0,2515.0,0.943,13.293,105,69,42,27,36,17,19,62,0.0,0.17
1003,1073,24-09-2019 23:24:00,0,2813.0,2686.5,0.9545,14.058,136,74,53,21,62,21,41,61,0.0,0.0
1003,1074,24-09-2019 23:26:00,0,2959.0,2858.0,0.966,14.823,189,97,67,30,92,57,35,64,0.0,0.0
1003,1075,24-09-2019 23:28:00,0,3465.0,3273.0,0.945,17.274,120,58,21,37,62,30,32,44,0.05,0.0
1003,1076,24-09-2019 23:30:00,0,2960.0,2850.0,0.963,14.819,91,48,14,34,43,0,43,63,0.0,0.0
1003,1077,24-09-2019 23:32:00,0,3054.0,2950.0,0.966,15.297,156,67,38,29,89,52,37,55,0.0,0.0
1003,1078,24-09-2019 23:34:00,0,3146.0,3037.0,0.965,15.756,108,47,34,13,61,44,17,74,0.1,0.0
1003,1079,24-09-2019 23:36:00,0,2578.0,2417.0,0.938,12.832,0,0,0,0,0,0,0,34,0.0,0.0
1003,1080,24-09-2019 23:38:00,0,2681.0,2501.0,0.933,13.333,0,0,0,0,0,0,0,10,0.0,0.0
1003,1081,24-09-2019 23:40:00,0,2891.0,2628.0,0.909,14.299,0,0,0,0,0,0,0,2,0.0,0.0
1003,1082,24-09-2019 23:42:00,0,2863.0,2739.0,0.957,14.313,0,0,0,0,0,0,0,0,0.0,0.0
1003,1083,24-09-2019 23:44:00,0,2886.0,2650.0,0.918,14.303,0,0,0,0,0,0,0,0,0.0,0.0
1003,1084,24-09-2019 23:46:00,0,2677.0,2507.0,0.936,13.324,0,0,0,0,0,0,0,3,0.0,0.0
1003,1085,24-09-2019 23:48:00,0,2871.0,2685.0,0.935,14.285,0,0,0,0,0,0,0,0,0.0,0.0
1003,1086,24-09-2019 23:50:00,0,2762.0,2612.0,0.946,13.773,0,0,0,0,0,0,0,0,0.0,0.0
1003,1087,24-09-2019 23:52:00,0,2571.0,2437.0,0.948,12.827,0,0,0,0,0,0,0,0,0.0,0.0
1003,1088,24-09-2019 23:54:00,0,2362.0,2299.0,0.973,11.853,0,0,0,0,0,0,0,2,0.0,0.0
1003,1089,24-09-2019 23:56:00,0,2376.0,2252.0,0.948,11.853,0,0,0,0,0,0,0,0,0.0,0.0
1003,1090,24-09-2019 23:58:00,0,2266.0,2190.5,0.9675,11.352,0,0,0,0,0,0,0,2,0.0,0.0
1003,1091,25-09-2019 00:00:00,0,2156.0,2129.0,0.987,10.851,0,0,0,0,0,0,0,10,0.0,0.0
1003,1092,25-09-2019 00:02:00,0,2159.0,2160.0,1.0,10.899,0,0,0,0,0,0,0,6,0.0,0.0
1003,1093,25-09-2019 00:04:00,0,1850.0,1876.0,1.014,9.367,97,58,38,20,39,28,11,42,0.0,0.0
1003,1094,25-09-2019 00:06:00,0,2089.0,1938.0,0.928,10.377,6,6,1,5,0,0,0,58,0.0,0.0
1003,1095,25-09-2019 00:08:00,0,2262.0,2203.0,0.974,11.35,0,0,0,0,0,0,0,38,0.0,0.0
1003,1096,25-09-2019 00:10:00,0,2181.0,2032.0,0.932,10.843,0,0,0,0,0,0,0,0,0.0,0.0
1003,1097,25-09-2019 00:12:00,0,2100.0,1905.0,0.908,10.382,0,0,0,0,0,0,0,10,0.0,0.0
1003,1098,25-09-2019 00:14:00,0,2087.0,1916.0,0.918,10.345,0,0,0,0,0,0,0,0,0.0,0.0
1003,1099,25-09-2019 00:16:00,0,2082.0,1966.0,0.944,10.379,0,0,0,0,0,0,0,1,0.0,0.0
1003,1100,25-09-2019 00:18:00,0,1858.0,1888.0,1.017,9.409,0,0,0,0,0,0,0,0,0.0,0.0
1003,1101,25-09-2019 00:20:00,0,1870.0,1803.0,0.964,9.365,0,0,0,0,0,0,0,4,0.0,0.0
1003,1102,25-09-2019 00:22:00,0,1889.0,1739.0,0.921,9.369,0,0,0,0,0,0,0,3,0.0,0.0
1003,1103,25-09-2019 00:24:00,0,1775.0,1698.0,0.957,8.873,0,0,0,0,0,0,0,5,0.0,0.0
1003,1104,25-09-2019 00:26:00,0,1896.0,1720.0,0.907,9.375,0,0,0,0,0,0,0,7,0.0,0.0
1003,1105,25-09-2019 00:28:00,0,1869.0,1819.0,0.973,9.377,0,0,0,0,0,0,0,7,0.0,0.0
1003,1106,25-09-2019 00:30:00,0,1871.0,1781.0,0.952,9.343,0,0,0,0,0,0,0,12,0.0,0.0
1003,1107,25-09-2019 00:32:00,0,1862.0,1824.5,0.98,9.355,0,0,0,0,0,0,0,10,0.0,0.0
1003,1108,25-09-2019 00:34:00,0,1853.0,1868.0,1.008,9.367,0,0,0,0,0,0,0,3,0.0,0.0
1003,1109,25-09-2019 00:36:00,0,1874.0,1802.0,0.962,9.38,0,0,0,0,0,0,0,4,0.0,0.0
1003,1110,25-09-2019 00:38:00,0,1773.0,1719.0,0.969,8.89,0,0,0,0,0,0,0,35,0.0,0.0
1003,1111,25-09-2019 00:40:00,0,2151.0,2150.0,1.0,10.855,0,0,0,0,0,0,0,19,0.0,0.0
1003,1112,25-09-2019 00:42:00,0,2361.0,2320.0,0.983,11.869,0,0,0,0,0,0,0,4,0.0,0.0
1003,1113,25-09-2019 00:44:00,0,2356.0,2290.0,0.972,11.816,0,0,0,0,0,0,0,36,0.0,0.0
1003,1114,25-09-2019 00:46:00,0,2254.0,2246.0,0.996,11.367,157,89,63,26,68,54,14,58,0.0,0.0
1003,1115,25-09-2019 00:48:00,0,2344.0,2336.0,0.997,11.819,282,166,114,52,116,71,45,67,0.0,0.0
1003,1116,25-09-2019 00:50:00,0,2681.0,2518.0,0.939,13.352,100,51,26,25,49,7,42,61,0.0,0.0
1003,1117,25-09-2019 00:52:00,0,2655.0,2576.0,0.97,13.314,147,82,44,38,65,22,43,54,0.0,0.0
1003,1118,25-09-2019 00:54:00,0,2840.0,2786.0,0.981,14.274,108,62,30,32,46,6,40,54,0.0,0.0
1003,1119,25-09-2019 00:56:00,0,2841.0,2844.0,1.001,14.342,133,95,46,49,38,9,29,58,0.0,0.05
1003,1120,25-09-2019 00:58:00,0,2941.0,2891.0,0.983,14.786,126,88,45,43,38,17,21,58,0.0,0.07
1003,1121,25-09-2019 01:00:00,0,3039.0,3032.0,0.998,15.329,180,122,80,42,58,32,26,77,0.0,0.0
1003,1122,25-09-2019 01:02:00,0,3349.0,3212.0,0.959,16.75,124,51,32,19,73,41,32,40,0.29,0.08
1003,1123,25-09-2019 01:04:00,0,3069.0,2919.0,0.951,15.322,85,45,26,19,40,3,37,58,0.0,0.04
1003,1124,25-09-2019 01:06:00,0,3161.0,3024.5,0.9565,15.8015,127,79,41,38,48,13,35,59,0.0,0.05
1003,1125,25-09-2019 01:08:00,0,3253.0,3130.0,0.962,16.281,163,123,86,37,40,15,25,76,0.0,0.0
1003,1126,25-09-2019 01:10:00,0,3358.0,3164.0,0.942,16.735,136,79,48,31,57,31,26,44,0.13,0.07
1003,1127,25-09-2019 01:12:00,0,2952.0,2882.0,0.976,14.82,213,120,85,35,93,67,26,100,0.01,0.05
1003,1128,25-09-2019 01:14:00,0,3362.0,3208.0,0.954,16.796,107,72,37,35,35,14,21,47,0.0,0.08
1003,1129,25-09-2019 01:16:00,0,3342.0,3229.0,0.966,16.743,236,139,111,28,97,74,23,85,0.21,0.0
1003,1130,25-09-2019 01:18:00,0,3369.0,3142.0,0.933,16.754,290,140,96,44,150,118,32,45,0.0,0.0
1003,1131,25-09-2019 01:20:00,0,3570.0,3340.0,0.936,17.766,125,84,55,29,41,16,25,63,0.0,0.0
1003,1132,25-09-2019 01:22:00,0,3555.0,3415.0,0.961,17.785,182,89,62,27,93,67,26,31,0.21,0.03
1003,1133,25-09-2019 01:24:00,0,3555.0,3426.0,0.964,17.798,433,222,181,41,211,167,44,114,0.0,0.0
1003,1134,25-09-2019 01:26:00,0,3254.0,3126.0,0.961,16.281,405,192,155,37,213,168,45,201,0.0,0.0
1003,1135,25-09-2019 01:28:00,0,2840.0,2830.0,0.997,14.322,204,89,64,25,115,83,32,94,0.0,0.0
1003,1136,25-09-2019 01:30:00,0,3025.0,3058.0,1.011,15.303,363,98,71,27,265,225,40,34,0.0,0.0
1003,1137,25-09-2019 01:32:00,0,2763.0,2616.0,0.947,13.784,161,26,5,21,135,78,57,0,0.0,0.0
1003,1138,25-09-2019 01:34:00,0,2372.0,2237.0,0.943,11.822,215,51,22,29,164,113,51,8,0.0,0.0
1003,1139,25-09-2019 01:36:00,0,2351.0,2302.0,0.979,11.812,238,105,74,31,133,86,47,49,0.0,0.0
1003,1140,25-09-2019 01:38:00,0,3542.0,3461.0,0.977,17.786,185,71,37,34,114,66,48,63,0.0,0.08
1003,1141,25-09-2019 01:40:00,0,3749.0,3602.5,0.962,18.758,208,78,43,35,130,76,54,59,0.0,0.04
1003,1142,25-09-2019 01:42:00,0,3956.0,3744.0,0.947,19.73,404,128,86,42,276,207,69,33,0.0,0.05
1003,1143,25-09-2019 01:44:00,0,2944.0,2885.0,0.98,14.795,438,191,155,36,247,191,56,103,0.0,0.0
1003,1144,25-09-2019 01:46:00,0,3142.0,3045.0,0.969,15.749,48,17,11,6,31,22,9,92,0.0,0.0
1003,1145,25-09-2019 01:48:00,0,3035.0,3029.0,0.998,15.31,10,6,1,5,4,2,2,54,0.0,0.0
1003,1146,25-09-2019 01:50:00,0,3065.0,2909.0,0.949,15.297,3,3,2,1,0,0,0,61,0.0,0.0
1003,1147,25-09-2019 01:52:00,0,3142.0,3077.0,0.979,15.786,8,7,5,2,1,1,0,55,0.0,0.0
1003,1148,25-09-2019 01:54:00,0,3356.0,3208.0,0.956,16.773,0,0,0,0,0,0,0,7,0.0,0.01
1003,1149,25-09-2019 01:56:00,0,2960.0,2878.0,0.973,14.847,0,0,0,0,0,0,0,18,0.0,0.0
1003,1150,25-09-2019 01:58:00,0,3063.0,2946.0,0.962,15.331,0,0,0,0,0,0,0,93,0.0,0.0
1003,1151,25-09-2019 02:00:00,0,2883.0,2630.0,0.912,14.273,0,0,0,0,0,0,0,24,0.0,0.0
1003,1152,25-09-2019 02:02:00,0,2676.0,2499.0,0.934,13.31,0,0,0,0,0,0,0,3,0.0,0.0
1003,1153,25-09-2019 02:04:00,0,2354.0,2341.0,0.995,11.867,0,0,0,0,0,0,0,1,0.0,0.0
1003,1154,25-09-2019 02:06:00,0,2372.0,2240.0,0.944,11.828,0,0,0,0,0,0,0,13,0.0,0.0
1003,1155,25-09-2019 02:08:00,0,2393.0,2190.0,0.915,11.855,0,0,0,0,0,0,0,1,0.0,0.0
1003,1156,25-09-2019 02:10:00,0,2151.0,2140.0,0.995,10.843,0,0,0,0,0,0,0,1,0.0,0.0
1003,1157,25-09-2019 02:12:00,0,2171.0,2072.0,0.954,10.847,0,0,0,0,0,0,0,3,0.0,0.0
1003,1158,25-09-2019 02:14:00,0,2176.0,2048.0,0.941,10.8395,0,0,0,0,0,0,0,0,0.0,0.0
1003,1159,25-09-2019 02:16:00,0,2181.0,2024.0,0.928,10.832,0,0,0,0,0,0,0,0,0.0,0.0
1003,1160,25-09-2019 02:18:00,0,2174.0,2095.0,0.964,10.884,40,23,20,3,17,12,5,51,0.0,0.0
1003,1161,25-09-2019 02:20:00,0,2365.0,2286.0,0.967,11.847,0,0,0,0,0,0,0,29,0.0,0.0
1003,1162,25-09-2019 02:22:00,0,2357.0,2319.0,0.984,11.853,0,0,0,0,0,0,0,33,0.0,0.0
1003,1163,25-09-2019 02:24:00,0,2254.0,2225.0,0.987,11.344,0,0,0,0,0,0,0,38,0.0,0.0
1003,1164,25-09-2019 02:26:00,0,2159.0,2144.0,0.993,10.88,0,0,0,0,0,0,0,9,0.0,0.0
1003,1165,25-09-2019 02:28:00,0,2356.0,2297.0,0.975,11.824,0,0,0,0,0,0,0,0,0.0,0.0
1003,1166,25-09-2019 02:30:00,0,2360.0,2282.0,0.967,11.826,0,0,0,0,0,0,0,8,0.0,0.0
1003,1167,25-09-2019 02:32:00,0,2347.0,2324.0,0.99,11.82,0,0,0,0,0,0,0,49,0.0,0.0
1003,1168,25-09-2019 02:34:00,0,2328.0,2430.0,1.044,11.863,1,1,1,0,0,0,0,52,0.0,0.0
1003,1169,25-09-2019 02:36:00,0,2341.0,2377.0,1.015,11.856,323,149,112,37,174,133,41,138,0.0,0.0
1003,1170,25-09-2019 02:38:00,0,2325.0,2404.0,1.034,11.823,0,0,0,0,0,0,0,23,0.0,0.0
1003,1171,25-09-2019 02:40:00,0,2664.0,2573.0,0.966,13.346,0,0,0,0,0,0,0,5,0.0,0.0
1003,1172,25-09-2019 02:42:00,0,2670.0,2529.0,0.947,13.318,0,0,0,0,0,0,0,0,0.0,0.0
1003,1173,25-09-2019 02:44:00,0,2443.0,2456.0,1.005,12.345,0,0,0,0,0,0,0,13,0.0,0.0
1003,1174,25-09-2019 02:46:00,0,2126.0,2220.0,1.044,10.834,0,0,0,0,0,0,0,10,0.0,0.0
1003,1175,25-09-2019 02:48:00,0,2011.0,1976.5,0.979,10.1105,0,0,0,0,0,0,0,10,0.0,0.0
1003,1176,25-09-2019 02:50:00,0,1896.0,1733.0,0.914,9.387,0,0,0,0,0,0,0,2,0.01,0.0
1003,1177,25-09-2019 02:52:00,0,1892.0,1726.0,0.912,9.367,0,0,0,0,0,0,0,6,0.0,0.0
1003,1178,25-09-2019 02:54:00,0,1889.0,1731.0,0.916,9.36,0,0,0,0,0,0,0,3,0.0,0.0
1003,1179,25-09-2019 02:56:00,0,1877.0,1780.0,0.948,9.368,0,0,0,0,0,0,0,18,0.0,0.0
1003,1180,25-09-2019 02:58:00,0,2169.0,2077.0,0.958,10.847,0,0,0,0,0,0,0,0,0.0,0.0
1003,1181,25-09-2019 03:00:00,0,2140.0,2212.0,1.034,10.879,0,0,0,0,0,0,0,11,0.0,0.0
1003,1182,25-09-2019 03:02:00,0,2362.0,2289.0,0.969,11.841,109,46,35,11,63,45,18,42,0.0,0.0
1003,1183,25-09-2019 03:04:00,0,2363.0,2264.0,0.958,11.819,209,69,35,34,140,86,54,61,0.0,0.0
1003,1184,25-09-2019 03:06:00,0,2648.0,2604.0,0.983,13.317,202,27,10,17,175,123,52,42,0.0,0.05
1003,1185,25-09-2019 03:08:00,0,2878.0,2693.0,0.936,14.321,63,21,7,14,42,11,31,6,0.0,0.4
1003,1186,25-09-2019 03:10:00,0,2877.0,2699.0,0.938,14.325,7,5,0,5,2,0,2,0,0.0,0.0
1003,1187,25-09-2019 03:12:00,0,2827.0,2871.0,1.015,14.316,115,18,1,17,97,79,18,0,0.05,0.0
1003,1188,25-09-2019 03:14:00,0,2638.0,2646.0,1.003,13.324,232,103,84,19,129,102,27,139,0.09,0.0
1003,1189,25-09-2019 03:16:00,0,2149.0,2169.0,1.009,10.869,330,181,146,35,149,111,38,138,0.1,0.0
1003,1190,25-09-2019 03:18:00,0,2643.0,2623.0,0.992,13.317,226,142,103,39,84,64,20,72,0.0,0.0
1003,1191,25-09-2019 03:20:00,0,3010.0,3066.0,1.018,15.254,285,157,101,56,128,85,43,33,0.01,0.0
1003,1192,25-09-2019 03:22:00,0,2823.0,2861.0,1.013,14.2905,596,245,179,66,351,279,72,114,0.02,0.01
1003,1193,25-09-2019 03:24:00,0,2636.0,2656.0,1.008,13.327,106,42,26,16,64,53,11,0,0.0,0.0
1003,1194,25-09-2019 03:26:00,0,2156.0,2148.0,0.996,10.871,204,82,57,25,122,103,19,8,0.0,0.0
1003,1195,25-09-2019 03:28:00,0,2671.0,2506.0,0.938,13.299,519,134,93,41,385,311,74,31,0.04,0.01
1003,1196,25-09-2019 03:30:00,0,2676.0,2497.0,0.933,13.307,549,255,197,58,294,241,53,197,0.0,0.0
1003,1197,25-09-2019 03:32:00,0,3238.0,3176.0,0.981,16.274,312,148,115,33,164,137,27,132,0.03,0.0
1003,1198,25-09-2019 03:34:00,0,3143.0,3116.0,0.991,15.832,19,12,9,3,7,7,0,79,0.01,0.0
1003,1199,25-09-2019 03:36:00,0,3042.0,2941.0,0.966,15.243,0,0,0,0,0,0,0,45,0.0,0.0
1003,1200,25-09-2019 03:38:00,0,3029.0,3054.0,1.008,15.314,2,2,1,1,0,0,0,39,0.0,0.0
1003,1201,25-09-2019 03:40:00,0,3036.0,2986.0,0.983,15.268,0,0,0,0,0,0,0,26,0.0,0.0
1003,1202,25-09-2019 03:42:00,0,3261.0,3099.0,0.95,16.278,32,18,15,3,14,13,1,45,0.0,0.0
1003,1203,25-09-2019 03:44:00,0,3256.0,3145.0,0.966,16.312,0,0,0,0,0,0,0,30,0.0,0.0
1003,1204,25-09-2019 03:46:00,0,3247.0,3111.0,0.958,16.239,0,0,0,0,0,0,0,23,0.0,0.0
1003,1205,25-09-2019 03:48:00,0,3047.0,2926.0,0.96,15.243,0,0,0,0,0,0,0,1,0.0,0.0
1003,1206,25-09-2019 03:50:00,0,2860.0,2786.0,0.974,14.354,0,0,0,0,0,0,0,20,0.0,0.0
1003,1207,25-09-2019 03:52:00,0,2888.0,2628.0,0.91,14.287,0,0,0,0,0,0,0,29,0.0,0.0
1003,1208,25-09-2019 03:54:00,0,2884.0,2672.0,0.927,14.32,0,0,0,0,0,0,0,0,0.0,0.0
1003,1209,25-09-2019 03:56:00,0,2722.0,2570.0,0.9455,13.5695,0,0,0,0,0,0,0,7,0.01,0.0
1003,1210,25-09-2019 03:58:00,0,2560.0,2468.0,0.964,12.819,0,0,0,0,0,0,0,0,0.0,0.0
1003,1211,25-09-2019 04:00:00,0,2358.0,2316.0,0.982,11.852,0,0,0,0,0,0,0,6,0.0,0.0
1003,1212,25-09-2019 04:02:00,0,2361.0,2295.0,0.972,11.841,0,0,0,0,0,0,0,0,0.0,0.0
1003,1213,25-09-2019 04:04:00,0,2145.0,2157.0,1.005,10.841,0,0,0,0,0,0,0,14,0.0,0.0
1003,1214,25-09-2019 04:06:00,0,2182.0,2060.0,0.944,10.879,0,0,0,0,0,0,0,0,0.0,0.0
1003,1215,25-09-2019 04:08:00,0,2091.0,1942.0,0.928,10.39,0,0,0,0,0,0,0,0,0.0,0.0
1003,1216,25-09-2019 04:10:00,0,2086.0,1917.0,0.919,10.342,0,0,0,0,0,0,0,9,0.0,0.0
1003,1217,25-09-2019 04:12:00,0,1970.0,1893.0,0.961,9.858,0,0,0,0,0,0,0,0,0.0,0.0
1003,1218,25-09-2019 04:14:00,0,1975.0,1919.0,0.972,9.905,0,0,0,0,0,0,0,0,0.0,0.0
1003,1219,25-09-2019 04:16:00,0,2077.0,1950.0,0.939,10.341,0,0,0,0,0,0,0,8,0.0,0.0
1003,1220,25-09-2019 04:18:00,0,2175.0,2056.0,0.946,10.844,0,0,0,0,0,0,0,0,0.0,0.0
1003,1221,25-09-2019 04:20:00,0,2153.0,2173.0,1.009,10.888,0,0,0,0,0,0,0,0,0.0,0.0
1003,1222,25-09-2019 04:22:00,0,2177.0,2047.0,0.941,10.842,0,0,0,0,0,0,0,5,0.0,0.0
1003,1223,25-09-2019 04:24:00,0,1966.0,1927.0,0.98,9.881,0,0,0,0,0,0,0,0,0.0,0.0
1003,1224,25-09-2019 04:26:00,0,1965.0,1919.0,0.977,9.868,40,17,15,2,23,19,4,13,0.0,0.0
1003,1225,25-09-2019 04:28:00,0,2058.0,2006.0,0.974,10.33,22,14,9,5,8,6,2,75,0.0,0.0
1003,1226,25-09-2019 04:30:00,0,2135.0,2205.0,1.0305,10.8535,370,132,108,24,238,189,49,101,0.0,0.0
1003,1227,25-09-2019 04:32:00,0,2212.0,2404.0,1.087,11.377,484,215,167,48,269,232,37,176,0.14,0.01
1003,1228,25-09-2019 04:34:00,0,2316.0,2488.0,1.074,11.88,523,356,281,75,167,125,42,101,0.0,0.0
1003,1229,25-09-2019 04:36:00,0,2512.0,2673.0,1.064,12.856,260,150,112,38,110,84,26,132,0.0,0.0
1003,1230,25-09-2019 04:38:00,0,2749.0,2718.0,0.989,13.841,226,138,112,26,88,67,21,163,0.0,0.01
1003,1231,25-09-2019 04:40:00,0,2627.0,2673.0,1.018,13.308,301,155,114,41,146,119,27,90,0.0,0.0
1003,1232,25-09-2019 04:42:00,0,2210.0,2385.0,1.079,11.347,307,88,59,29,219,178,41,23,0.0,0.0
1003,1233,25-09-2019 04:44:00,0,2250.0,2253.0,1.002,11.357,336,77,47,30,259,226,33,0,0.0,0.0
1003,1234,25-09-2019 04:46:00,0,2442.0,2431.0,0.995,12.315,286,110,81,29,176,141,35,53,0.0,0.03
1003,1235,25-09-2019 04:48:00,0,2745.0,2696.0,0.982,13.801,274,103,73,30,171,152,19,51,0.0,0.0
1003,1236,25-09-2019 04:50:00,0,2937.0,2923.0,0.995,14.807,339,125,83,42,214,167,47,10,0.0,0.0
1003,1237,25-09-2019 04:52:00,0,2235.0,2332.0,1.044,11.386,350,165,128,37,185,149,36,111,0.0,0.0
1003,1238,25-09-2019 04:54:00,0,2634.0,2641.0,1.003,13.3,515,214,172,42,301,232,69,101,0.0,0.0
1003,1239,25-09-2019 04:56:00,0,2812.0,2907.0,1.034,14.295,349,151,107,44,198,147,51,42,0.0,0.0
1003,1240,25-09-2019 04:58:00,0,2938.0,2956.0,1.006,14.847,212,57,29,28,155,106,49,66,0.0,0.0
1003,1241,25-09-2019 05:00:00,0,3249.0,3183.0,0.98,16.325,219,96,64,32,123,82,41,56,0.0,0.0
1003,1242,25-09-2019 05:02:00,0,3205.0,3276.0,1.022,16.254,208,74,45,29,134,80,54,33,0.0,0.06
1003,1243,25-09-2019 05:04:00,0,3028.5,3023.0,0.9965,15.2775,172,68,47,21,104,80,24,79,0.02,0.0
1003,1244,25-09-2019 05:06:00,0,2852.0,2770.0,0.971,14.301,206,71,51,20,135,101,34,81,0.0,0.0
1003,1245,25-09-2019 05:08:00,0,2663.0,2539.0,0.954,13.301,3,2,1,1,1,0,1,37,0.0,0.0
1003,1246,25-09-2019 05:10:00,0,3062.0,2898.0,0.947,15.271,0,0,0,0,0,0,0,24,0.0,0.0
1003,1247,25-09-2019 05:12:00,0,3146.0,3055.0,0.971,15.777,1,1,1,0,0,0,0,54,0.0,0.0
1003,1248,25-09-2019 05:14:00,0,3067.0,2929.0,0.955,15.327,2,2,1,1,0,0,0,37,0.0,0.0
1003,1249,25-09-2019 05:16:00,0,3139.0,3113.0,0.992,15.813,0,0,0,0,0,0,0,23,0.0,0.0
1003,1250,25-09-2019 05:18:00,0,2842.0,2812.0,0.99,14.311,0,0,0,0,0,0,0,15,0.0,0.0
1003,1251,25-09-2019 05:20:00,0,2863.0,2761.0,0.965,14.335,0,0,0,0,0,0,0,1,0.0,0.0
1003,1252,25-09-2019 05:22:00,0,2864.0,2720.0,0.95,14.295,0,0,0,0,0,0,0,2,0.0,0.0
1003,1253,25-09-2019 05:24:00,0,2886.0,2678.0,0.928,14.335,0,0,0,0,0,0,0,0,0.0,0.0
1003,1254,25-09-2019 05:26:00,0,2660.0,2579.0,0.97,13.334,0,0,0,0,0,0,0,20,0.0,0.0
1003,1255,25-09-2019 05:28:00,0,2684.0,2503.0,0.933,13.346,0,0,0,0,0,0,0,1,0.0,0.0
1003,1256,25-09-2019 05:30:00,0,2450.0,2416.0,0.986,12.329,0,0,0,0,0,0,0,12,0.0,0.0
1003,1257,25-09-2019 05:32:00,0,2451.0,2420.0,0.988,12.336,0,0,0,0,0,0,0,0,0.0,0.0
1003,1258,25-09-2019 05:34:00,0,2356.0,2324.0,0.986,11.854,0,0,0,0,0,0,0,0,0.0,0.0
1003,1259,25-09-2019 05:36:00,0,2248.0,2249.0,1.0,11.345,0,0,0,0,0,0,0,1,0.0,0.0
1003,1260,25-09-2019 05:38:00,0,2255.5,2237.5,0.992,11.362,83,30,21,9,53,42,11,54,0.0,0.0
1003,1261,25-09-2019 05:40:00,0,2263.0,2226.0,0.984,11.379,354,179,148,31,175,135,40,119,0.0,0.0
1003,1262,25-09-2019 05:42:00,0,2663.0,2541.0,0.954,13.307,280,124,90,34,156,117,39,94,0.0,0.0
1003,1263,25-09-2019 05:44:00,0,2341.0,2392.0,1.022,11.871,375,169,131,38,206,152,54,136,0.0,0.0
1003,1264,25-09-2019 05:46:00,0,2669.0,2513.0,0.942,13.297,423,201,145,56,222,171,51,67,0.0,0.0
1003,1265,25-09-2019 05:48:00,0,2339.0,2371.0,1.014,11.84,622,332,271,61,290,229,61,128,0.0,0.0
1003,1266,25-09-2019 05:50:00,0,2667.0,2570.0,0.964,13.354,256,78,56,22,178,141,37,52,0.0,0.0
1003,1267,25-09-2019 05:52:00,0,2676.0,2480.0,0.927,13.288,348,158,122,36,190,142,48,97,0.02,0.01
1003,1268,25-09-2019 05:54:00,0,2854.0,2745.0,0.962,14.286,268,59,30,29,209,167,42,6,0.01,0.0
1003,1269,25-09-2019 05:56:00,0,2871.0,2721.0,0.948,14.323,437,243,199,44,194,156,38,183,0.0,0.0
1003,1270,25-09-2019 05:58:00,0,2759.0,2658.0,0.963,13.812,494,255,207,48,239,205,34,174,0.0,0.0
1003,1271,25-09-2019 06:00:00,1,3047.0,2956.0,0.97,15.278,499,255,212,43,244,185,59,130,0.01,0.0
1003,1272,25-09-2019 06:02:00,1,3039.0,3014.0,0.992,15.31,589,340,272,68,249,201,48,154,0.0,0.0
1003,1273,25-09-2019 06:04:00,1,3032.0,3013.0,0.994,15.283,338,169,145,24,169,129,40,188,0.01,0.0
1003,1274,25-09-2019 06:06:00,1,3352.0,3238.0,0.966,16.793,264,137,108,29,127,92,35,117,0.0,0.0
1003,1275,25-09-2019 06:08:00,1,3036.0,3014.0,0.993,15.297,84,50,34,16,34,27,7,88,0.0,0.0
1003,1276,25-09-2019 06:10:00,1,3037.0,3021.0,0.995,15.309,0,0,0,0,0,0,0,37,0.0,0.0
1003,1277,25-09-2019 06:12:00,1,2999.5,2937.5,0.9795,15.07,5,5,2,3,0,0,0,44,0.0,0.0
1003,1278,25-09-2019 06:14:00,1,2962.0,2854.0,0.964,14.831,0,0,0,0,0,0,0,31,0.0,0.0
1003,1279,25-09-2019 06:16:00,1,3067.0,2908.0,0.948,15.303,3,3,1,2,0,0,0,34,0.0,0.0
1003,1280,25-09-2019 06:18:00,1,2950.0,2868.0,0.972,14.798,0,0,0,0,0,0,0,0,0.0,0.0
1003,1281,25-09-2019 06:20:00,1,2881.0,2673.0,0.928,14.31,0,0,0,0,0,0,0,2,0.0,0.0
1003,1282,25-09-2019 06:22:00,1,2690.0,2459.0,0.914,13.32,0,0,0,0,0,0,0,0,0.0,0.0
1003,1283,25-09-2019 06:24:00,1,2359.0,2281.0,0.967,11.818,0,0,0,0,0,0,0,0,0.0,0.0
1003,1284,25-09-2019 06:26:00,1,2373.0,2215.0,0.933,11.804,0,0,0,0,0,0,0,0,0.0,0.0
1003,1285,25-09-2019 06:28:00,1,2173.0,2081.0,0.958,10.865,0,0,0,0,0,0,0,0,0.0,0.0
1003,1286,25-09-2019 06:30:00,1,2200.0,1965.0,0.893,10.844,0,0,0,0,0,0,0,3,0.0,0.0
1003,1287,25-09-2019 06:32:00,1,2088.0,1925.0,0.922,10.356,0,0,0,0,0,0,0,0,0.0,0.0
1003,1288,25-09-2019 06:34:00,1,1972.0,1888.0,0.957,9.861,0,0,0,0,0,0,0,2,0.0,0.0
1003,1289,25-09-2019 06:36:00,1,1853.0,1850.0,0.998,9.349,0,0,0,0,0,0,0,2,0.0,0.0
1003,1290,25-09-2019 06:38:00,1,1857.0,1854.0,0.998,9.37,0,0,0,0,0,0,0,0,0.0,0.0
1003,1291,25-09-2019 06:40:00,1,1859.0,1831.0,0.985,9.352,0,0,0,0,0,0,0,6,0.0,0.0
1003,1292,25-09-2019 06:42:00,1,2070.0,1975.0,0.954,10.342,0,0,0,0,0,0,0,0,0.0,0.0
1003,1293,25-09-2019 06:44:00,1,1964.0,1951.0,0.994,9.897,0,0,0,0,0,0,0,4,0.0,0.0
1003,1294,25-09-2019 06:46:00,1,1966.0,1937.0,0.9855,9.89,0,0,0,0,0,0,0,14,0.0,0.0
1003,1295,25-09-2019 06:48:00,1,1968.0,1923.0,0.977,9.883,0,0,0,0,0,0,0,1,0.0,0.0
1003,1296,25-09-2019 06:50:00,1,1864.0,1821.0,0.977,9.36,0,0,0,0,0,0,0,1,0.0,0.0
1003,1297,25-09-2019 06:52:00,1,1878.0,1785.0,0.951,9.375,0,0,0,0,0,0,0,0,0.0,0.0
1003,1298,25-09-2019 06:54:00,1,1856.0,1875.0,1.01,9.39,0,0,0,0,0,0,0,0,0.0,0.0
1003,1299,25-09-2019 06:56:00,1,1869.0,1827.0,0.978,9.386,0,0,0,0,0,0,0,0,0.0,0.0
1003,1300,25-09-2019 06:58:00,1,1854.0,1856.0,1.001,9.36,0,0,0,0,0,0,0,7,0.0,0.0
1003,1301,25-09-2019 07:00:00,1,1969.0,1939.0,0.985,9.906,0,0,0,0,0,0,0,13,0.0,0.0
1003,1302,25-09-2019 07:02:00,1,1852.0,1881.0,1.016,9.379,0,0,0,0,0,0,0,2,0.0,0.0
1003,1303,25-09-2019 07:04:00,1,1866.0,1840.0,0.986,9.388,0,0,0,0,0,0,0,0,0.0,0.0
1003,1304,25-09-2019 07:06:00,1,1971.0,1907.0,0.967,9.878,0,0,0,0,0,0,0,0,0.0,0.0
1003,1305,25-09-2019 07:08:00,1,1969.0,1911.0,0.97,9.872,0,0,0,0,0,0,0,0,0.0,0.0
1003,1306,25-09-2019 07:10:00,1,2191.0,1997.0,0.911,10.842,0,0,0,0,0,0,0,3,0.0,0.0
1003,1307,25-09-2019 07:12:00,1,1855.0,1861.0,1.003,9.369,0,0,0,0,0,0,0,2,0.0,0.0
1003,1308,25-09-2019 07:14:00,1,1867.0,1824.0,0.977,9.375,1,1,1,0,0,0,0,15,0.0,0.0
1003,1309,25-09-2019 07:16:00,1,2186.0,2012.0,0.92,10.842,16,11,2,9,5,1,4,23,0.0,0.0
1003,1310,25-09-2019 07:18:00,1,2174.0,2021.0,0.93,10.803,3,2,0,2,1,0,1,6,0.0,0.0
1003,1311,25-09-2019 07:20:00,1,2162.5,2078.5,0.9615,10.821,0,0,0,0,0,0,0,22,0.0,0.0
1003,1312,25-09-2019 07:22:00,1,2151.0,2136.0,0.993,10.839,3,3,1,2,0,0,0,30,0.0,0.0
1003,1313,25-09-2019 07:24:00,1,2565.0,2466.0,0.962,12.837,204,87,66,21,117,77,40,56,0.0,0.0
1003,1314,25-09-2019 07:26:00,1,2138.0,2199.0,1.028,10.859,213,110,92,18,103,74,29,69,0.0,0.0
1003,1315,25-09-2019 07:28:00,1,2455.0,2429.0,0.99,12.362,0,0,0,0,0,0,0,8,0.0,0.0
1003,1316,25-09-2019 07:30:00,1,2380.0,2206.0,0.927,11.821,0,0,0,0,0,0,0,0,0.0,0.0
1003,1317,25-09-2019 07:32:00,1,2161.0,2132.0,0.986,10.875,0,0,0,0,0,0,0,4,0.0,0.0
1003,1318,25-09-2019 07:34:00,1,2178.0,2037.0,0.935,10.838,0,0,0,0,0,0,0,6,0.0,0.0
1003,1319,25-09-2019 07:36:00,1,2186.0,2021.0,0.925,10.849,0,0,0,0,0,0,0,0,0.0,0.0
1003,1320,25-09-2019 07:38:00,1,2083.0,1944.0,0.933,10.359,0,0,0,0,0,0,0,0,0.0,0.0
1003,1321,25-09-2019 07:40:00,1,1968.0,1902.0,0.966,9.86,0,0,0,0,0,0,0,0,0.0,0.0
1003,1322,25-09-2019 07:42:00,1,2085.0,1955.0,0.938,10.378,0,0,0,0,0,0,0,1,0.0,0.0
1003,1323,25-09-2019 07:44:00,1,1846.0,1877.0,1.017,9.351,0,0,0,0,0,0,0,0,0.0,0.0
1003,1324,25-09-2019 07:46:00,1,1862.0,1831.0,0.983,9.365,0,0,0,0,0,0,0,2,0.0,0.0
1003,1325,25-09-2019 07:48:00,1,1970.0,1907.0,0.968,9.873,0,0,0,0,0,0,0,7,0.0,0.0
1003,1326,25-09-2019 07:50:00,1,1890.0,1780.0,0.942,9.416,0,0,0,0,0,0,0,0,0.0,0.0
1003,1327,25-09-2019 07:52:00,1,1885.0,1738.0,0.922,9.351,0,0,0,0,0,0,0,0,0.0,0.0
1003,1328,25-09-2019 07:54:00,1,1877.5,1778.5,0.9475,9.366,0,0,0,0,0,0,0,1,0.0,0.0
1003,1329,25-09-2019 07:56:00,1,1870.0,1819.0,0.973,9.381,0,0,0,0,0,0,0,0,0.0,0.0
1003,1330,25-09-2019 07:58:00,1,1888.0,1764.0,0.934,9.392,0,0,0,0,0,0,0,0,0.0,0.0
1003,1331,25-09-2019 08:00:00,1,1864.0,1846.0,0.991,9.388,0,0,0,0,0,0,0,5,0.0,0.0
1003,1332,25-09-2019 08:02:00,1,2195.0,1970.0,0.897,10.831,0,0,0,0,0,0,0,0,0.0,0.0
1003,1333,25-09-2019 08:04:00,1,1968.0,1909.0,0.97,9.866,0,0,0,0,0,0,0,2,0.0,0.0
1003,1334,25-09-2019 08:06:00,1,2080.0,1952.0,0.938,10.356,0,0,0,0,0,0,0,0,0.0,0.0
1003,1335,25-09-2019 08:08:00,1,2087.0,1926.0,0.923,10.356,0,0,0,0,0,0,0,0,0.0,0.0
1003,1336,25-09-2019 08:10:00,1,2086.0,1943.0,0.932,10.368,0,0,0,0,0,0,0,0,0.0,0.0
1003,1337,25-09-2019 08:12:00,1,2079.0,1926.0,0.926,10.323,4,3,1,2,1,1,0,9,0.0,0.0
1003,1338,25-09-2019 08:14:00,1,2183.0,2057.0,0.942,10.88,9,8,2,6,1,0,1,39,0.0,0.0
1003,1339,25-09-2019 08:16:00,1,2384.0,2205.0,0.925,11.834,8,6,1,5,2,1,1,48,0.0,0.0
1003,1340,25-09-2019 08:18:00,1,2352.0,2324.0,0.988,11.84,11,10,1,9,1,1,0,30,0.0,0.0
1003,1341,25-09-2019 08:20:00,1,2342.0,2343.0,1.001,11.82,7,6,3,3,1,1,0,30,0.0,0.0
1003,1342,25-09-2019 08:22:00,1,2575.0,2423.0,0.941,12.829,100,47,25,22,53,29,24,40,0.0,0.0
1003,1343,25-09-2019 08:24:00,1,2878.0,2667.0,0.927,14.293,149,65,57,8,84,65,19,65,0.0,0.0
1003,1344,25-09-2019 08:26:00,1,2690.0,2441.0,0.907,13.302,317,133,91,42,184,122,62,18,0.0,0.04
1003,1345,25-09-2019 08:28:00,1,2678.5,2489.0,0.929,13.3085,114,39,20,19,75,54,21,2,0.0,0.0
1003,1346,25-09-2019 08:30:00,1,2667.0,2537.0,0.951,13.315,298,166,125,41,132,92,40,72,0.0,0.0
1003,1347,25-09-2019 08:32:00,1,2676.0,2514.0,0.939,13.328,204,103,71,32,101,64,37,68,0.0,0.01
1003,1348,25-09-2019 08:34:00,1,2845.0,2795.0,0.982,14.305,138,62,38,24,76,38,38,50,0.01,0.02
1003,1349,25-09-2019 08:36:00,1,2858.0,2801.0,0.98,14.363,155,75,45,30,80,40,40,39,0.0,0.02
1003,1350,25-09-2019 08:38:00,1,2768.0,2597.0,0.938,13.779,285,164,123,41,121,90,31,63,0.02,0.01
1003,1351,25-09-2019 08:40:00,1,2667.0,2544.0,0.954,13.326,183,81,58,23,102,73,29,90,0.05,0.06
1003,1352,25-09-2019 08:42:00,1,2352.0,2314.0,0.984,11.827,6,5,3,2,1,1,0,76,0.0,0.0
1003,1353,25-09-2019 08:44:00,1,2352.0,2308.0,0.981,11.82,0,0,0,0,0,0,0,19,0.0,0.0
1003,1354,25-09-2019 08:46:00,1,2368.0,2276.0,0.961,11.851,1,1,1,0,0,0,0,46,0.0,0.0
1003,1355,25-09-2019 08:48:00,1,2663.0,2562.0,0.962,13.327,0,0,0,0,0,0,0,43,0.0,0.0
1003,1356,25-09-2019 08:50:00,1,2691.0,2434.0,0.905,13.297,0,0,0,0,0,0,0,26,0.0,0.0
1003,1357,25-09-2019 08:52:00,1,2702.0,2424.0,0.897,13.33,0,0,0,0,0,0,0,2,0.0,0.0
1003,1358,25-09-2019 08:54:00,1,2460.0,2395.0,0.974,12.342,0,0,0,0,0,0,0,0,0.0,0.0
1003,1359,25-09-2019 08:56:00,1,2363.0,2277.0,0.964,11.832,0,0,0,0,0,0,0,0,0.0,0.0
1003,1360,25-09-2019 08:58:00,1,2157.0,2118.0,0.982,10.843,0,0,0,0,0,0,0,0,0.0,0.0
1003,1361,25-09-2019 09:00:00,1,2187.0,2043.0,0.934,10.879,0,0,0,0,0,0,0,0,0.0,0.0
1003,1362,25-09-2019 09:02:00,1,1964.5,1931.5,0.9895,9.8785,0,0,0,0,0,0,0,1,0.0,0.0
1003,1363,25-09-2019 09:04:00,1,1742.0,1820.0,1.045,8.878,0,0,0,0,0,0,0,0,0.0,0.0
1003,1364,25-09-2019 09:06:00,1,1760.0,1756.0,0.998,8.878,0,0,0,0,0,0,0,0,0.0,0.0
1003,1365,25-09-2019 09:08:00,1,1768.0,1744.0,0.986,8.898,0,0,0,0,0,0,0,0,0.0,0.0
1003,1366,25-09-2019 09:10:00,1,1741.0,1828.0,1.05,8.882,0,0,0,0,0,0,0,0,0.0,0.0
1003,1367,25-09-2019 09:12:00,1,1849.0,1900.0,1.028,9.387,0,0,0,0,0,0,0,19,0.0,0.0
1003,1368,25-09-2019 09:14:00,1,1728.0,1879.0,1.088,8.887,0,0,0,0,0,0,0,4,0.0,0.0
1003,1369,25-09-2019 09:16:00,1,1852.0,1910.0,1.032,9.41,3,3,1,2,0,0,0,8,0.0,0.0
1003,1370,25-09-2019 09:18:00,1,1746.0,1803.0,1.033,8.874,0,0,0,0,0,0,0,25,0.0,0.0
1003,1371,25-09-2019 09:20:00,1,1768.0,1735.0,0.981,8.887,0,0,0,0,0,0,0,0,0.0,0.0
1003,1372,25-09-2019 09:22:00,1,1779.0,1686.0,0.948,8.874,0,0,0,0,0,0,0,6,0.0,0.0
1003,1373,25-09-2019 09:24:00,1,1545.0,1648.0,1.066,7.913,0,0,0,0,0,0,0,3,0.0,0.0
1003,1374,25-09-2019 09:26:00,1,1661.0,1663.0,1.001,8.386,0,0,0,0,0,0,0,4,0.0,0.0
1003,1375,25-09-2019 09:28:00,1,1770.0,1728.0,0.976,8.887,0,0,0,0,0,0,0,2,0.0,0.0
1003,1376,25-09-2019 09:30:00,1,1849.0,1870.0,1.011,9.357,0,0,0,0,0,0,0,0,0.0,0.0
1003,1377,25-09-2019 09:32:00,1,2075.0,1971.0,0.95,10.358,0,0,0,0,0,0,0,0,0.0,0.0
1003,1378,25-09-2019 09:34:00,1,2079.0,1984.0,0.954,10.387,2,2,1,1,0,0,0,14,0.0,0.0
1003,1379,25-09-2019 09:36:00,1,1963.0,1936.0,0.988,9.8775,0,0,0,0,0,0,0,6,0.0,0.0
1003,1380,25-09-2019 09:38:00,1,1847.0,1888.0,1.022,9.368,0,0,0,0,0,0,0,0,0.0,0.0
1003,1381,25-09-2019 09:40:00,1,1974.0,1867.0,0.946,9.845,3,3,1,2,0,0,0,4,0.0,0.0
1003,1382,25-09-2019 09:42:00,1,1976.0,1901.0,0.962,9.889,7,5,0,5,2,1,1,1,0.0,0.0
1003,1383,25-09-2019 09:44:00,1,1980.0,1883.0,0.951,9.885,1,1,0,1,0,0,0,5,0.0,0.0
1003,1384,25-09-2019 09:46:00,1,1972.0,1888.0,0.958,9.859,2,2,0,2,0,0,0,3,0.0,0.0
1003,1385,25-09-2019 09:48:00,1,1987.0,1855.0,0.934,9.883,0,0,0,0,0,0,0,1,0.0,0.0
1003,1386,25-09-2019 09:50:00,1,1871.0,1813.0,0.969,9.378,0,0,0,0,0,0,0,1,0.0,0.0
1003,1387,25-09-2019 09:52:00,1,1878.0,1792.0,0.954,9.382,0,0,0,0,0,0,0,12,0.0,0.0
1003,1388,25-09-2019 09:54:00,1,1879.0,1770.0,0.942,9.364,0,0,0,0,0,0,0,27,0.0,0.0
1003,1389,25-09-2019 09:56:00,1,1886.0,1742.0,0.924,9.357,3,3,0,3,0,0,0,27,0.0,0.0
1003,1390,25-09-2019 09:58:00,1,1984.0,1872.0,0.943,9.889,1,1,0,1,0,0,0,73,0.0,0.0
1003,1391,25-09-2019 10:00:00,1,1876.0,1779.0,0.948,9.363,23,20,5,15,3,0,3,66,0.0,0.0
1003,1392,25-09-2019 10:02:00,1,2194.0,1994.0,0.909,10.85,4,3,0,3,1,0,1,19,0.0,0.0
1003,1393,25-09-2019 10:04:00,1,2185.0,2013.0,0.922,10.836,11,9,1,8,2,0,2,13,0.0,0.0
1003,1394,25-09-2019 10:06:00,1,2173.0,2087.0,0.96,10.872,0,0,0,0,0,0,0,8,0.0,0.0
1003,1395,25-09-2019 10:08:00,1,2178.0,2067.0,0.949,10.868,33,21,15,6,12,11,1,29,0.0,0.0
1003,1396,25-09-2019 10:10:00,1,2424.5,2293.0,0.946,12.0895,153,52,27,25,101,64,37,45,0.0,0.0
1003,1397,25-09-2019 10:12:00,1,2671.0,2519.0,0.943,13.311,153,17,5,12,136,79,57,33,0.0,0.0
1003,1398,25-09-2019 10:14:00,1,2900.0,2610.0,0.9,14.317,177,17,9,8,160,107,53,25,0.0,0.0
1003,1399,25-09-2019 10:16:00,1,2971.0,2790.0,0.939,14.795,235,32,14,18,203,143,60,34,0.0,0.0
1003,1400,25-09-2019 10:18:00,1,2890.0,2673.0,0.925,14.344,318,158,111,47,160,114,46,121,0.02,0.02
1003,1401,25-09-2019 10:20:00,1,2688.0,2487.0,0.925,13.342,279,162,134,28,117,83,34,50,0.0,0.0
1003,1402,25-09-2019 10:22:00,1,2159.0,2100.0,0.972,10.83,254,112,78,34,142,107,35,81,0.0,0.0
1003,1403,25-09-2019 10:24:00,1,2462.0,2391.0,0.971,12.346,0,0,0,0,0,0,0,67,0.0,0.01
1003,1404,25-09-2019 10:26:00,1,2180.0,2069.0,0.949,10.878,0,0,0,0,0,0,0,14,0.0,0.0
1003,1405,25-09-2019 10:28:00,1,2367.0,2259.0,0.954,11.828,0,0,0,0,0,0,0,24,0.0,0.0
1003,1406,25-09-2019 10:30:00,1,2173.0,2060.0,0.948,10.843,22,13,11,2,9,6,3,33,0.0,0.0
1003,1407,25-09-2019 10:32:00,1,2350.0,2339.0,0.995,11.849,0,0,0,0,0,0,0,1,0.0,0.0
1003,1408,25-09-2019 10:34:00,1,2568.0,2397.0,0.934,12.771,0,0,0,0,0,0,0,0,0.0,0.0
1003,1409,25-09-2019 10:36:00,1,2378.0,2254.0,0.948,11.864,0,0,0,0,0,0,0,12,0.0,0.0
1003,1410,25-09-2019 10:38:00,1,2167.0,2090.0,0.964,10.853,0,0,0,0,0,0,0,8,0.0,0.0
1003,1411,25-09-2019 10:40:00,1,2199.0,1962.0,0.892,10.838,0,0,0,0,0,0,0,1,0.0,0.0
1003,1412,25-09-2019 10:42:00,1,2205.0,1959.0,0.888,10.858,0,0,0,0,0,0,0,0,0.0,0.0
1003,1413,25-09-2019 10:44:00,1,2041.0,1882.0,0.925,10.125,0,0,0,0,0,0,0,0,0.0,0.0
1003,1414,25-09-2019 10:46:00,1,1877.0,1805.0,0.962,9.392,0,0,0,0,0,0,0,0,0.0,0.0
1003,1415,25-09-2019 10:48:00,1,1863.0,1820.0,0.977,9.355,0,0,0,0,0,0,0,1,0.0,0.0
1003,1416,25-09-2019 10:50:00,1,1869.0,1835.0,0.982,9.394,0,0,0,0,0,0,0,0,0.0,0.0
1003,1417,25-09-2019 10:52:00,1,1892.0,1728.0,0.913,9.368,0,0,0,0,0,0,0,1,0.0,0.0
1003,1418,25-09-2019 10:54:00,1,1899.0,1692.0,0.891,9.356,0,0,0,0,0,0,0,0,0.0,0.0
1003,1419,25-09-2019 10:56:00,1,1676.0,1621.0,0.967,8.397,0,0,0,0,0,0,0,0,0.0,0.0
1003,1420,25-09-2019 10:58:00,1,1883.0,1767.0,0.939,9.374,0,0,0,0,0,0,0,3,0.0,0.0
1003,1421,25-09-2019 11:00:00,1,1901.0,1702.0,0.896,9.373,0,0,0,0,0,0,0,2,0.0,0.0
1003,1422,25-09-2019 11:02:00,1,1790.0,1643.0,0.918,8.87,0,0,0,0,0,0,0,8,0.0,0.0
1003,1423,25-09-2019 11:04:00,1,1677.0,1617.0,0.964,8.397,0,0,0,0,0,0,0,14,0.0,0.0
1003,1424,25-09-2019 11:06:00,1,1905.0,1697.0,0.891,9.383,0,0,0,0,0,0,0,0,0.0,0.0
1003,1425,25-09-2019 11:08:00,1,1670.0,1601.0,0.959,8.354,0,0,0,0,0,0,0,0,0.0,0.0
1003,1426,25-09-2019 11:10:00,1,1792.0,1637.0,0.913,8.873,0,0,0,0,0,0,0,4,0.0,0.0
1003,1427,25-09-2019 11:12:00,1,1892.0,1726.0,0.912,9.365,0,0,0,0,0,0,0,0,0.0,0.0
1003,1428,25-09-2019 11:14:00,1,1878.0,1796.0,0.957,9.387,0,0,0,0,0,0,0,0,0.0,0.0
1003,1429,25-09-2019 11:16:00,1,2214.0,1912.0,0.864,10.84,0,0,0,0,0,0,0,0,0.0,0.0
1003,1430,25-09-2019 11:18:00,1,2160.5,1885.5,0.873,10.6,0,0,0,0,0,0,0,0,0.0,0.0
1003,1431,25-09-2019 11:20:00,1,2107.0,1859.0,0.882,10.36,0,0,0,0,0,0,0,1,0.0,0.0
1003,1432,25-09-2019 11:22:00,1,1988.0,1821.0,0.916,9.85,0,0,0,0,0,0,0,5,0.0,0.0
1003,1433,25-09-2019 11:24:00,1,1984.0,1830.0,0.922,9.845,0,0,0,0,0,0,0,0,0.0,0.0
1003,1434,25-09-2019 11:26:00,1,2105.0,1855.0,0.881,10.347,0,0,0,0,0,0,0,5,0.0,0.0
1003,1435,25-09-2019 11:28:00,1,1995.0,1827.0,0.916,9.883,0,0,0,0,0,0,0,7,0.0,0.0
1003,1436,25-09-2019 11:30:00,1,2108.0,1842.0,0.874,10.347,0,0,0,0,0,0,0,26,0.0,0.0
1003,1437,25-09-2019 11:32:00,1,1894.0,1751.0,0.925,9.4,0,0,0,0,0,0,0,3,0.0,0.0
1003,1438,25-09-2019 11:34:00,1,1900.0,1713.0,0.902,9.381,0,0,0,0,0,0,0,1,0.0,0.0
1003,1439,25-09-2019 11:36:00,1,1896.0,1717.0,0.906,9.37,0,0,0,0,0,0,0,0,0.0,0.0
1003,1440,25-09-2019 11:38:00,1,1900.0,1693.0,0.891,9.36,0,0,0,0,0,0,0,1,0.0,0.0
1003,1441,25-09-2019 11:40:00,1,1912.0,1667.0,0.872,9.378,56,31,19,12,25,21,4,14,0.0,0.0
1003,1442,25-09-2019 11:42:00,1,2188.0,1990.0,0.91,10.825,89,34,19,15,55,32,23,25,0.0,0.01
1003,1443,25-09-2019 11:44:00,1,2399.0,2128.0,0.887,11.809,80,19,4,15,61,29,32,32,0.0,0.0
1003,1444,25-09-2019 11:46:00,1,2730.0,2325.0,0.852,13.33,87,20,9,11,67,33,34,33,0.0,0.0
1003,1445,25-09-2019 11:48:00,1,2694.0,2443.0,0.907,13.318,117,20,6,14,97,55,42,32,0.0,0.02
1003,1446,25-09-2019 11:50:00,1,2884.0,2666.0,0.924,14.316,174,22,5,17,152,105,47,25,0.0,0.0
1003,1447,25-09-2019 11:52:00,1,2637.5,2430.5,0.921,13.0825,315,189,151,38,126,97,29,107,0.0,0.06
1003,1448,25-09-2019 11:54:00,1,2391.0,2195.0,0.918,11.849,239,142,113,29,97,69,28,50,0.0,0.23
1003,1449,25-09-2019 11:56:00,1,2287.0,2113.0,0.924,11.351,250,130,86,44,120,79,41,16,0.08,0.0
1003,1450,25-09-2019 11:58:00,1,2792.0,2535.0,0.908,13.805,255,119,82,37,136,96,40,44,0.05,0.0
1003,1451,25-09-2019 12:00:00,1,2884.0,2646.0,0.917,14.292,34,24,14,10,10,8,2,54,0.0,0.0
1003,1452,25-09-2019 12:02:00,1,2175.0,2063.0,0.948,10.853,6,6,0,6,0,0,0,27,0.0,0.0
1003,1453,25-09-2019 12:04:00,1,2285.0,2146.0,0.939,11.38,0,0,0,0,0,0,0,32,0.0,0.0
1003,1454,25-09-2019 12:06:00,1,2277.0,2122.0,0.932,11.32,0,0,0,0,0,0,0,40,0.0,0.0
1003,1455,25-09-2019 12:08:00,1,2186.0,2033.0,0.93,10.863,0,0,0,0,0,0,0,13,0.0,0.0
1003,1456,25-09-2019 12:10:00,1,2186.0,2004.0,0.917,10.833,0,0,0,0,0,0,0,3,0.0,0.0
1003,1457,25-09-2019 12:12:00,1,2214.0,1946.0,0.879,10.877,0,0,0,0,0,0,0,11,0.0,0.0
1003,1458,25-09-2019 12:14:00,1,2164.0,2090.0,0.966,10.84,0,0,0,0,0,0,0,0,0.0,0.0
1003,1459,25-09-2019 12:16:00,1,2176.0,2066.0,0.949,10.859,0,0,0,0,0,0,0,0,0.0,0.0
1003,1460,25-09-2019 12:18:00,1,2184.0,2039.0,0.934,10.862,0,0,0,0,0,0,0,1,0.0,0.0
1003,1461,25-09-2019 12:20:00,1,2165.0,2089.0,0.965,10.842,0,0,0,0,0,0,0,0,0.0,0.0
1003,1462,25-09-2019 12:22:00,1,2189.0,2006.0,0.917,10.844,0,0,0,0,0,0,0,0,0.0,0.0
1003,1463,25-09-2019 12:24:00,1,2210.0,1929.0,0.873,10.843,0,0,0,0,0,0,0,0,0.0,0.0
1003,1464,25-09-2019 12:26:00,1,2099.5,1890.0,0.902,10.3635,0,0,0,0,0,0,0,0,0.0,0.0
1003,1465,25-09-2019 12:28:00,1,1989.0,1851.0,0.931,9.884,0,0,0,0,0,0,0,3,0.0,0.0
1003,1466,25-09-2019 12:30:00,1,1873.0,1816.0,0.969,9.392,0,0,0,0,0,0,0,0,0.0,0.0
1003,1467,25-09-2019 12:32:00,1,1877.0,1786.0,0.951,9.374,0,0,0,0,0,0,0,5,0.0,0.0
1003,1468,25-09-2019 12:34:00,1,1993.0,1837.0,0.922,9.885,0,0,0,0,0,0,0,1,0.0,0.0
1003,1469,25-09-2019 12:36:00,1,1896.0,1720.0,0.907,9.375,0,0,0,0,0,0,0,0,0.0,0.0
1003,1470,25-09-2019 12:38:00,1,1793.0,1620.0,0.903,8.857,0,0,0,0,0,0,0,6,0.0,0.0
1003,1471,25-09-2019 12:40:00,1,1793.0,1642.0,0.916,8.88,0,0,0,0,0,0,0,2,0.0,0.0
1003,1472,25-09-2019 12:42:00,1,1678.0,1591.0,0.948,8.373,0,0,0,0,0,0,0,2,0.0,0.0
1003,1473,25-09-2019 12:44:00,1,1891.0,1721.0,0.91,9.357,0,0,0,0,0,0,0,2,0.0,0.0
1003,1474,25-09-2019 12:46:00,1,1890.0,1742.0,0.922,9.376,0,0,0,0,0,0,0,12,0.0,0.0
1003,1475,25-09-2019 12:48:00,1,1880.0,1771.0,0.942,9.369,0,0,0,0,0,0,0,1,0.0,0.0
1003,1476,25-09-2019 12:50:00,1,1883.0,1746.0,0.927,9.35,0,0,0,0,0,0,0,7,0.0,0.0
1003,1477,25-09-2019 12:52:00,1,1900.0,1707.0,0.899,9.375,0,0,0,0,0,0,0,6,0.0,0.0
1003,1478,25-09-2019 12:54:00,1,1900.0,1700.0,0.895,9.367,0,0,0,0,0,0,0,5,0.0,0.0
1003,1479,25-09-2019 12:56:00,1,1907.0,1676.0,0.879,9.37,0,0,0,0,0,0,0,1,0.0,0.0
1003,1480,25-09-2019 12:58:00,1,1899.0,1664.0,0.876,9.325,0,0,0,0,0,0,0,7,0.0,0.0
1003,1481,25-09-2019 13:00:00,1,1795.5,1607.0,0.896,8.8535,0,0,0,0,0,0,0,60,0.0,0.0
1003,1482,25-09-2019 13:02:00,1,1692.0,1550.0,0.916,8.382,0,0,0,0,0,0,0,14,0.0,0.0
1003,1483,25-09-2019 13:04:00,1,1702.0,1530.0,0.899,8.399,0,0,0,0,0,0,0,25,0.0,0.0
1003,1484,25-09-2019 13:06:00,1,1916.0,1636.0,0.854,9.362,0,0,0,0,0,0,0,22,0.0,0.0
1003,1485,25-09-2019 13:08:00,1,1901.0,1695.0,0.891,9.368,9,8,0,8,1,1,0,46,0.0,0.0
1003,1486,25-09-2019 13:10:00,1,1897.0,1716.0,0.904,9.375,17,17,2,15,0,0,0,28,0.0,0.0
1003,1487,25-09-2019 13:12:00,1,2204.0,1940.0,0.88,10.83,93,56,38,18,37,22,15,47,0.0,0.0
1003,1488,25-09-2019 13:14:00,1,2398.0,2161.0,0.901,11.838,162,61,35,26,101,47,54,67,0.0,0.0
1003,1489,25-09-2019 13:16:00,1,2698.0,2437.0,0.903,13.33,112,21,6,15,91,53,38,22,0.0,0.0
1003,1490,25-09-2019 13:18:00,1,2911.0,2535.0,0.871,14.278,95,29,6,23,66,30,36,31,0.0,0.0
1003,1491,25-09-2019 13:20:00,1,2898.0,2608.0,0.9,14.305,86,17,3,14,69,34,35,14,0.0,0.0
1003,1492,25-09-2019 13:22:00,1,2997.0,2719.0,0.907,14.819,98,22,3,19,76,37,39,9,0.0,0.0
1003,1493,25-09-2019 13:24:00,1,3104.0,2802.0,0.903,15.331,92,23,6,17,69,43,26,15,0.0,0.0
1003,1494,25-09-2019 13:26:00,1,2883.0,2656.0,0.921,14.298,271,103,63,40,168,114,54,41,0.02,0.0
1003,1495,25-09-2019 13:28:00,1,2278.0,2130.0,0.935,11.335,251,162,128,34,89,68,21,106,0.17,0.09
1003,1496,25-09-2019 13:30:00,1,2387.0,2205.0,0.924,11.847,329,234,181,53,95,69,26,32,0.06,0.0
1003,1497,25-09-2019 13:32:00,1,2582.0,2361.0,0.914,12.789,365,199,159,40,166,117,49,50,0.01,0.0
1003,1498,25-09-2019 13:34:00,1,2524.0,2359.0,0.935,12.5565,135,63,41,22,72,49,23,65,0.0,0.0
1003,1499,25-09-2019 13:36:00,1,2466.0,2357.0,0.956,12.324,139,60,39,21,79,41,38,58,0.0,0.0
1003,1500,25-09-2019 13:38:00,1,3080.0,2896.0,0.94,15.34,68,15,0,15,53,22,31,21,0.0,0.0
1003,1501,25-09-2019 13:40:00,1,3054.0,2956.0,0.968,15.305,91,6,2,4,85,51,34,13,0.0,0.0
1003,1502,25-09-2019 13:42:00,1,3040.0,3004.0,0.988,15.303,101,24,6,18,77,51,26,9,0.0,0.02
1003,1503,25-09-2019 13:44:00,1,2772.0,2650.0,0.956,13.853,124,73,62,11,51,40,11,72,0.0,0.0
1003,1504,25-09-2019 13:46:00,1,2173.0,2070.0,0.953,10.853,4,4,2,2,0,0,0,46,0.0,0.0
1003,1505,25-09-2019 13:48:00,1,1981.0,1838.0,0.928,9.84,0,0,0,0,0,0,0,6,0.0,0.0
1003,1506,25-09-2019 13:50:00,1,1983.0,1852.0,0.934,9.864,0,0,0,0,0,0,0,1,0.0,0.03
1003,1507,25-09-2019 13:52:00,1,2170.0,2090.0,0.963,10.865,0,0,0,0,0,0,0,0,0.0,0.0
1003,1508,25-09-2019 13:54:00,1,2663.0,2562.0,0.962,13.328,0,0,0,0,0,0,0,0,0.0,0.0
1003,1509,25-09-2019 13:56:00,1,2647.0,2580.0,0.975,13.286,0,0,0,0,0,0,0,0,0.0,0.0
1003,1510,25-09-2019 13:58:00,1,2140.0,2193.0,1.025,10.86,0,0,0,0,0,0,0,0,0.0,0.0
1003,1511,25-09-2019 14:00:00,1,2182.0,2008.0,0.92,10.819,0,0,0,0,0,0,0,0,0.0,0.0
1003,1512,25-09-2019 14:02:00,1,2191.0,2006.0,0.916,10.854,0,0,0,0,0,0,0,0,0.0,0.0
1003,1513,25-09-2019 14:04:00,1,2184.0,2035.0,0.932,10.859,0,0,0,0,0,0,0,0,0.0,0.0
1003,1514,25-09-2019 14:06:00,1,2168.0,2076.0,0.958,10.841,0,0,0,0,0,0,0,0,0.0,0.0
1003,1515,25-09-2019 14:08:00,1,2008.0,1976.0,0.9865,10.099,0,0,0,0,0,0,0,0,0.0,0.0
1003,1516,25-09-2019 14:10:00,1,1848.0,1876.0,1.015,9.357,0,0,0,0,0,0,0,0,0.0,0.0
1003,1517,25-09-2019 14:12:00,1,1971.0,1909.0,0.969,9.879,0,0,0,0,0,0,0,0,0.0,0.0
1003,1518,25-09-2019 14:14:00,1,1849.0,1885.0,1.019,9.372,0,0,0,0,0,0,0,0,0.0,0.0
1003,1519,25-09-2019 14:16:00,1,1844.0,1910.0,1.036,9.381,0,0,0,0,0,0,0,3,0.0,0.0
1003,1520,25-09-2019 14:18:00,1,2180.0,2036.0,0.934,10.843,0,0,0,0,0,0,0,0,0.0,0.0
1003,1521,25-09-2019 14:20:00,1,2157.0,2137.0,0.991,10.864,0,0,0,0,0,0,0,0,0.0,0.0
1003,1522,25-09-2019 14:22:00,1,2146.0,2182.0,1.017,10.87,0,0,0,0,0,0,0,0,0.0,0.0
1003,1523,25-09-2019 14:24:00,1,2159.0,2130.0,0.987,10.863,0,0,0,0,0,0,0,0,0.0,0.0
1003,1524,25-09-2019 14:26:00,1,2154.0,2128.0,0.988,10.841,0,0,0,0,0,0,0,0,0.0,0.0
1003,1525,25-09-2019 14:28:00,1,2186.0,2017.0,0.923,10.847,0,0,0,0,0,0,0,0,0.0,0.0
1003,1526,25-09-2019 14:30:00,1,1955.0,1970.0,1.008,9.884,0,0,0,0,0,0,0,0,0.0,0.0
1003,1527,25-09-2019 14:32:00,1,1954.0,1973.0,1.01,9.882,0,0,0,0,0,0,0,1,0.0,0.0
1003,1528,25-09-2019 14:34:00,1,2058.0,2023.0,0.983,10.349,0,0,0,0,0,0,0,7,0.0,0.0
1003,1529,25-09-2019 14:36:00,1,1847.0,1891.0,1.024,9.37,0,0,0,0,0,0,0,2,0.0,0.0
1003,1530,25-09-2019 14:38:00,1,1864.0,1848.0,0.992,9.389,0,0,0,0,0,0,0,3,0.0,0.0
1003,1531,25-09-2019 14:40:00,1,1870.0,1809.0,0.967,9.368,0,0,0,0,0,0,0,1,0.0,0.0
1003,1532,25-09-2019 14:42:00,1,1911.5,1893.0,0.9895,9.625,1,1,0,1,0,0,0,0,0.0,0.0
1003,1533,25-09-2019 14:44:00,1,1953.0,1977.0,1.012,9.882,0,0,0,0,0,0,0,6,0.0,0.0
1003,1534,25-09-2019 14:46:00,1,2066.0,2009.0,0.973,10.364,69,26,19,7,43,30,13,23,0.0,0.04
1003,1535,25-09-2019 14:48:00,1,2354.0,2313.0,0.983,11.835,77,30,4,26,47,27,20,10,0.0,0.0
1003,1536,25-09-2019 14:50:00,1,2647.0,2620.0,0.99,13.332,77,27,4,23,50,28,22,17,0.0,0.0
1003,1537,25-09-2019 14:52:00,1,2861.0,2777.0,0.971,14.348,60,21,0,21,39,25,14,7,0.0,0.0
1003,1538,25-09-2019 14:54:00,1,2812.0,2924.0,1.04,14.317,44,20,0,20,24,15,9,5,0.0,0.09
1003,1539,25-09-2019 14:56:00,1,2827.0,2894.0,1.024,14.343,409,244,193,51,165,117,48,52,0.08,0.03
1003,1540,25-09-2019 14:58:00,1,2131.0,2226.0,1.044,10.862,117,77,52,25,40,32,8,81,0.0,0.0
1003,1541,25-09-2019 15:00:00,1,1872.0,1777.0,0.95,9.341,0,0,0,0,0,0,0,18,0.01,0.01
1003,1542,25-09-2019 15:02:00,1,1869.0,1804.0,0.965,9.359,0,0,0,0,0,0,0,25,0.0,0.01
1003,1543,25-09-2019 15:04:00,1,2142.0,2209.0,1.031,10.883,0,0,0,0,0,0,0,13,0.0,0.0
1003,1544,25-09-2019 15:06:00,1,2319.0,2425.0,1.046,11.821,0,0,0,0,0,0,0,43,0.0,0.0
1003,1545,25-09-2019 15:08:00,1,2446.0,2456.0,1.004,12.357,0,0,0,0,0,0,0,32,0.0,0.0
1003,1546,25-09-2019 15:10:00,1,2344.0,2364.0,1.008,11.853,0,0,0,0,0,0,0,31,0.0,0.0
1003,1547,25-09-2019 15:12:00,1,2367.0,2275.0,0.961,11.845,0,0,0,0,0,0,0,14,0.0,0.0
1003,1548,25-09-2019 15:14:00,1,2135.0,2219.0,1.039,10.868,0,0,0,0,0,0,0,3,0.0,0.0
1003,1549,25-09-2019 15:16:00,1,2140.0,2189.5,1.023,10.8555,0,0,0,0,0,0,0,0,0.0,0.0
1003,1550,25-09-2019 15:18:00,1,2145.0,2160.0,1.007,10.843,0,0,0,0,0,0,0,3,0.0,0.0
1003,1551,25-09-2019 15:20:00,1,2157.0,2124.0,0.985,10.848,0,0,0,0,0,0,0,7,0.0,0.0
1003,1552,25-09-2019 15:22:00,1,2155.0,2131.0,0.989,10.851,0,0,0,0,0,0,0,10,0.0,0.0
1003,1553,25-09-2019 15:24:00,1,2160.0,2121.0,0.982,10.86,0,0,0,0,0,0,0,1,0.0,0.0
1003,1554,25-09-2019 15:26:00,1,2165.0,2102.0,0.971,10.857,0,0,0,0,0,0,0,3,0.0,0.0
1003,1555,25-09-2019 15:28:00,1,2175.0,2098.0,0.965,10.892,0,0,0,0,0,0,0,6,0.0,0.0
1003,1556,25-09-2019 15:30:00,1,2061.0,2038.0,0.989,10.375,0,0,0,0,0,0,0,0,0.0,0.0
1003,1557,25-09-2019 15:32:00,1,1954.0,1969.0,1.008,9.878,0,0,0,0,0,0,0,2,0.0,0.0
1003,1558,25-09-2019 15:34:00,1,1956.0,1966.0,1.005,9.883,0,0,0,0,0,0,0,3,0.0,0.0
1003,1559,25-09-2019 15:36:00,1,1940.0,2004.0,1.033,9.863,0,0,0,0,0,0,0,0,0.0,0.0
1003,1560,25-09-2019 15:38:00,1,1835.0,1944.0,1.059,9.383,0,0,0,0,0,0,0,0,0.0,0.0
1003,1561,25-09-2019 15:40:00,1,1842.0,1927.0,1.046,9.389,0,0,0,0,0,0,0,0,0.0,0.0
1003,1562,25-09-2019 15:42:00,1,2061.0,2022.0,0.981,10.36,0,0,0,0,0,0,0,7,0.0,0.01
1003,1563,25-09-2019 15:44:00,1,1843.0,1927.0,1.045,9.394,0,0,0,0,0,0,0,0,0.0,0.0
1003,1564,25-09-2019 15:46:00,1,1850.0,1859.0,1.005,9.346,0,0,0,0,0,0,0,0,0.0,0.0
1003,1565,25-09-2019 15:48:00,1,1853.0,1888.0,1.018,9.392,4,4,2,2,0,0,0,7,0.0,0.0
1003,1566,25-09-2019 15:50:00,1,1855.5,1870.0,1.0075,9.3815,4,3,2,1,1,1,0,11,0.0,0.0
1003,1567,25-09-2019 15:52:00,1,1858.0,1852.0,0.997,9.371,0,0,0,0,0,0,0,0,0.0,0.0
1003,1568,25-09-2019 15:54:00,1,1870.0,1836.0,0.982,9.401,0,0,0,0,0,0,0,1,0.0,0.0
1003,1569,25-09-2019 15:56:00,1,1853.0,1853.0,1.0,9.352,0,0,0,0,0,0,0,0,0.0,0.0
1003,1570,25-09-2019 15:58:00,1,1862.0,1855.0,0.996,9.389,0,0,0,0,0,0,0,0,0.0,0.0
1003,1571,25-09-2019 16:00:00,1,1873.0,1806.0,0.964,9.378,0,0,0,0,0,0,0,3,0.0,0.0
1003,1572,25-09-2019 16:02:00,1,1864.0,1844.0,0.989,9.385,0,0,0,0,0,0,0,1,0.0,0.0
1003,1573,25-09-2019 16:04:00,1,1841.0,1919.0,1.042,9.38,0,0,0,0,0,0,0,16,0.0,0.0
1003,1574,25-09-2019 16:06:00,1,1945.0,1982.0,1.019,9.855,0,0,0,0,0,0,0,13,0.0,0.0
1003,1575,25-09-2019 16:08:00,1,1948.0,2005.0,1.03,9.893,0,0,0,0,0,0,0,5,0.0,0.0
1003,1576,25-09-2019 16:10:00,1,2163.0,2096.0,0.969,10.843,0,0,0,0,0,0,0,28,0.0,0.0
1003,1577,25-09-2019 16:12:00,1,2141.0,2192.0,1.024,10.862,0,0,0,0,0,0,0,18,0.0,0.0
1003,1578,25-09-2019 16:14:00,1,2238.0,2302.0,1.029,11.365,5,5,2,3,0,0,0,41,0.0,0.0
1003,1579,25-09-2019 16:16:00,1,2146.0,2160.0,1.006,10.845,0,0,0,0,0,0,0,23,0.0,0.0
1003,1580,25-09-2019 16:18:00,1,2133.0,2228.0,1.044,10.872,0,0,0,0,0,0,0,10,0.0,0.0
1003,1581,25-09-2019 16:20:00,1,2162.0,2110.0,0.976,10.853,0,0,0,0,0,0,0,2,0.0,0.0
1003,1582,25-09-2019 16:22:00,1,2056.0,2063.0,1.003,10.386,0,0,0,0,0,0,0,4,0.0,0.0
1003,1583,25-09-2019 16:24:00,1,1945.5,2001.5,1.03,9.882,0,0,0,0,0,0,0,0,0.0,0.0
1003,1584,25-09-2019 16:26:00,1,1835.0,1940.0,1.057,9.378,0,0,0,0,0,0,0,0,0.0,0.0
1003,1585,25-09-2019 16:28:00,1,1839.0,1913.0,1.04,9.362,0,0,0,0,0,0,0,2,0.0,0.0
1003,1586,25-09-2019 16:30:00,1,1831.0,1955.0,1.068,9.378,0,0,0,0,0,0,0,0,0.0,0.0
1003,1587,25-09-2019 16:32:00,1,1953.0,1961.0,1.004,9.863,0,0,0,0,0,0,0,5,0.0,0.0
1003,1588,25-09-2019 16:34:00,1,1948.0,1975.0,1.014,9.86,0,0,0,0,0,0,0,4,0.0,0.0
1003,1589,25-09-2019 16:36:00,1,1958.0,1951.0,0.997,9.873,0,0,0,0,0,0,0,0,0.0,0.0
1003,1590,25-09-2019 16:38:00,1,1846.0,1934.0,1.047,9.415,44,22,10,12,22,13,9,30,0.0,0.0
1003,1591,25-09-2019 16:40:00,1,2445.0,2457.0,1.005,12.354,114,32,1,31,82,49,33,12,0.0,0.0
1003,1592,25-09-2019 16:42:00,1,2756.0,2677.0,0.971,13.823,67,29,1,28,38,24,14,5,0.0,0.08
1003,1593,25-09-2019 16:44:00,1,2859.0,2720.0,0.951,14.278,29,10,2,8,19,13,6,5,0.0,0.06
1003,1594,25-09-2019 16:46:00,1,2925.0,2951.0,1.009,14.791,69,19,2,17,50,32,18,11,0.0,0.08
1003,1595,25-09-2019 16:48:00,1,2829.0,2895.0,1.024,14.35,100,20,3,17,80,56,24,12,0.0,0.09
1003,1596,25-09-2019 16:50:00,1,2841.0,2825.0,0.994,14.322,222,122,83,39,100,69,31,45,0.11,0.03
1003,1597,25-09-2019 16:52:00,1,2438.0,2450.0,1.005,12.319,347,210,154,56,137,95,42,110,0.0,0.16
1003,1598,25-09-2019 16:54:00,1,2142.0,2175.0,1.015,10.848,303,183,138,45,120,82,38,46,0.02,0.0
1003,1599,25-09-2019 16:56:00,1,2250.0,2239.0,0.995,11.343,475,275,214,61,200,140,60,28,0.01,0.0
1003,1600,25-09-2019 16:58:00,1,2012.0,1977.5,0.981,10.116,257,148,110,38,109,66,43,68,0.0,0.0
1003,1601,25-09-2019 17:00:00,1,1774.0,1716.0,0.967,8.889,292,157,110,47,135,98,37,90,0.04,0.0
1003,1602,25-09-2019 17:02:00,1,2818.0,2934.0,1.041,14.349,10,7,6,1,3,2,1,61,0.01,0.0
1003,1603,25-09-2019 17:04:00,1,2355.0,2313.0,0.982,11.839,2,2,1,1,0,0,0,25,0.01,0.0
1003,1604,25-09-2019 17:06:00,1,2427.0,2494.0,1.028,12.322,0,0,0,0,0,0,0,28,0.0,0.0
1003,1605,25-09-2019 17:08:00,1,2424.0,2509.0,1.035,12.329,0,0,0,0,0,0,0,17,0.0,0.0
1003,1606,25-09-2019 17:10:00,1,2374.0,2298.0,0.968,11.897,0,0,0,0,0,0,0,0,0.0,0.0
1003,1607,25-09-2019 17:12:00,1,2437.0,2426.0,0.995,12.29,0,0,0,0,0,0,0,0,0.0,0.0
1003,1608,25-09-2019 17:14:00,1,2314.0,2449.0,1.058,11.829,0,0,0,0,0,0,0,7,0.0,0.0
1003,1609,25-09-2019 17:16:00,1,2329.0,2440.0,1.047,11.878,0,0,0,0,0,0,0,2,0.0,0.0
1003,1610,25-09-2019 17:18:00,1,2349.0,2331.0,0.992,11.836,0,0,0,0,0,0,0,1,0.0,0.0
1003,1611,25-09-2019 17:20:00,1,2132.0,2219.0,1.041,10.855,0,0,0,0,0,0,0,0,0.0,0.0
1003,1612,25-09-2019 17:22:00,1,2157.0,2159.0,1.001,10.887,0,0,0,0,0,0,0,0,0.0,0.0
1003,1613,25-09-2019 17:24:00,1,2161.0,2145.0,0.993,10.887,0,0,0,0,0,0,0,0,0.0,0.0
1003,1614,25-09-2019 17:26:00,1,2123.0,2271.0,1.07,10.877,0,0,0,0,0,0,0,2,0.0,0.0
1003,1615,25-09-2019 17:28:00,1,2345.0,2369.0,1.01,11.861,0,0,0,0,0,0,0,3,0.0,0.0
1003,1616,25-09-2019 17:30:00,1,2341.0,2350.0,1.004,11.824,4,4,1,3,0,0,0,6,0.0,0.0
1003,1617,25-09-2019 17:32:00,1,2246.0,2244.5,0.9995,11.333,2,2,0,2,0,0,0,13,0.0,0.0
1003,1618,25-09-2019 17:34:00,1,2151.0,2139.0,0.995,10.842,0,0,0,0,0,0,0,0,0.0,0.0
1003,1619,25-09-2019 17:36:00,1,1950.0,1996.0,1.024,9.891,0,0,0,0,0,0,0,0,0.0,0.0
1003,1620,25-09-2019 17:38:00,1,1835.0,1945.0,1.06,9.383,0,0,0,0,0,0,0,0,0.0,0.0
1003,1621,25-09-2019 17:40:00,1,1842.0,1905.0,1.034,9.364,0,0,0,0,0,0,0,0,0.0,0.0
1003,1622,25-09-2019 17:42:00,1,1845.0,1921.0,1.041,9.395,0,0,0,0,0,0,0,0,0.0,0.0
1003,1623,25-09-2019 17:44:00,1,1830.0,1942.0,1.061,9.36,0,0,0,0,0,0,0,1,0.0,0.0
1003,1624,25-09-2019 17:46:00,1,2052.0,2033.0,0.991,10.335,0,0,0,0,0,0,0,10,0.0,0.0
1003,1625,25-09-2019 17:48:00,1,2179.0,2070.0,0.95,10.878,0,0,0,0,0,0,0,4,0.0,0.0
1003,1626,25-09-2019 17:50:00,1,2057.0,2055.0,0.999,10.38,0,0,0,0,0,0,0,3,0.0,0.0
1003,1627,25-09-2019 17:52:00,1,2058.0,2017.0,0.98,10.343,0,0,0,0,0,0,0,2,0.0,0.0
1003,1628,25-09-2019 17:54:00,1,1939.0,2018.0,1.041,9.875,0,0,0,0,0,0,0,9,0.0,0.0
1003,1629,25-09-2019 17:56:00,1,2052.0,2034.0,0.991,10.337,0,0,0,0,0,0,0,5,0.0,0.0
1003,1630,25-09-2019 17:58:00,1,2150.0,2132.0,0.992,10.829,0,0,0,0,0,0,0,8,0.0,0.0
1003,1631,25-09-2019 18:00:00,0,2156.0,2161.0,1.003,10.885,0,0,0,0,0,0,0,7,0.0,0.0
1003,1632,25-09-2019 18:02:00,0,2161.0,2139.0,0.99,10.882,0,0,0,0,0,0,0,2,0.0,0.0
1003,1633,25-09-2019 18:04:00,0,2120.0,2271.0,1.071,10.866,220,125,107,18,95,65,30,49,0.0,0.0
1003,1634,25-09-2019 18:06:00,0,2226.5,2339.5,1.0515,11.3625,104,29,24,5,75,43,32,9,0.0,0.09
1003,1635,25-09-2019 18:08:00,0,2333.0,2408.0,1.032,11.859,5,5,1,4,0,0,0,0,0.0,0.0
1003,1636,25-09-2019 18:10:00,0,2326.0,2421.0,1.041,11.843,111,56,44,12,55,28,27,36,0.0,0.0
1003,1637,25-09-2019 18:12:00,0,2643.0,2645.0,1.001,13.341,557,331,267,64,226,181,45,191,0.08,0.0
1003,1638,25-09-2019 18:14:00,0,2852.0,2801.0,0.982,14.339,523,316,254,62,207,161,46,173,0.05,0.01
1003,1639,25-09-2019 18:16:00,0,2914.0,2973.0,1.02,14.772,330,183,139,44,147,99,48,90,0.0,0.0
1003,1640,25-09-2019 18:18:00,0,2726.0,2807.0,1.03,13.848,457,270,211,59,187,139,48,92,0.0,0.07
1003,1641,25-09-2019 18:20:00,0,2810.0,2908.0,1.035,14.291,428,255,201,54,173,127,46,76,0.0,0.0
1003,1642,25-09-2019 18:22:00,0,2829.0,2859.0,1.011,14.311,271,156,130,26,115,93,22,189,0.0,0.0
1003,1643,25-09-2019 18:24:00,0,2916.0,2984.0,1.023,14.79,349,181,144,37,168,130,38,109,0.0,0.0
1003,1644,25-09-2019 18:26:00,0,2823.0,2878.0,1.02,14.308,25,20,15,5,5,3,2,94,0.0,0.0
1003,1645,25-09-2019 18:28:00,0,2941.0,2954.0,1.004,14.86,17,13,2,11,4,1,3,28,0.0,0.0
1003,1646,25-09-2019 18:30:00,0,2811.0,2901.0,1.032,14.286,5,5,0,5,0,0,0,30,0.0,0.0
1003,1647,25-09-2019 18:32:00,0,3035.0,3069.0,1.011,15.354,0,0,0,0,0,0,0,16,0.0,0.0
1003,1648,25-09-2019 18:34:00,0,3039.0,3009.0,0.99,15.305,3,2,0,2,1,1,0,41,0.0,0.0
1003,1649,25-09-2019 18:36:00,0,3044.0,2935.0,0.964,15.243,4,3,1,2,1,0,1,40,0.0,0.0
1003,1650,25-09-2019 18:38:00,0,3047.0,2995.0,0.983,15.319,0,0,0,0,0,0,0,34,0.0,0.0
1003,1651,25-09-2019 18:40:00,0,2954.0,2872.5,0.972,14.818,0,0,0,0,0,0,0,0,0.0,0.0
1003,1652,25-09-2019 18:42:00,0,2861.0,2750.0,0.961,14.317,0,0,0,0,0,0,0,0,0.0,0.0
1003,1653,25-09-2019 18:44:00,0,2657.0,2570.0,0.967,13.314,0,0,0,0,0,0,0,11,0.0,0.0
1003,1654,25-09-2019 18:46:00,0,2333.0,2389.0,1.024,11.836,0,0,0,0,0,0,0,11,0.0,0.0
1003,1655,25-09-2019 18:48:00,0,2259.0,2229.0,0.987,11.369,0,0,0,0,0,0,0,0,0.0,0.0
1003,1656,25-09-2019 18:50:00,0,2250.0,2244.0,0.997,11.35,0,0,0,0,0,0,0,1,0.0,0.0
1003,1657,25-09-2019 18:52:00,0,2133.0,2224.0,1.043,10.867,31,20,17,3,11,5,6,17,0.0,0.0
1003,1658,25-09-2019 18:54:00,0,2364.0,2288.0,0.968,11.847,156,85,62,23,71,40,31,32,0.0,0.0
1003,1659,25-09-2019 18:56:00,0,2136.0,2195.0,1.028,10.846,218,91,58,33,127,88,39,46,0.0,0.0
1003,1660,25-09-2019 18:58:00,0,2436.0,2474.0,1.016,12.336,246,134,93,41,112,70,42,87,0.0,0.0
1003,1661,25-09-2019 19:00:00,0,2561.0,2502.0,0.977,12.858,140,55,26,29,85,37,48,43,0.01,0.0
1003,1662,25-09-2019 19:02:00,0,2648.0,2630.0,0.993,13.344,128,32,14,18,96,55,41,46,0.0,0.0
1003,1663,25-09-2019 19:04:00,0,3023.0,3047.0,1.008,15.282,187,42,24,18,145,98,47,34,0.0,0.0
1003,1664,25-09-2019 19:06:00,0,2748.0,2697.0,0.981,13.814,135,57,37,20,78,50,28,58,0.0,0.0
1003,1665,25-09-2019 19:08:00,0,2133.0,2205.0,1.034,10.846,306,101,77,24,205,152,53,36,0.0,0.0
1003,1666,25-09-2019 19:10:00,0,2840.0,2822.0,0.994,14.312,57,35,26,9,22,14,8,82,0.0,0.0
1003,1667,25-09-2019 19:12:00,0,2542.0,2519.0,0.991,12.805,217,137,110,27,80,65,15,144,0.0,0.0
1003,1668,25-09-2019 19:14:00,0,2886.0,2837.5,0.984,14.5135,205,35,10,25,170,117,53,35,0.0,0.0
1003,1669,25-09-2019 19:16:00,0,3230.0,3156.0,0.977,16.222,144,21,2,19,123,83,40,16,0.0,0.01
1003,1670,25-09-2019 19:18:00,0,3119.0,3154.0,1.011,15.78,130,39,13,26,91,68,23,19,0.0,0.1
1003,1671,25-09-2019 19:20:00,0,3048.0,3024.0,0.992,15.356,112,27,10,17,85,59,26,14,0.1,0.05
1003,1672,25-09-2019 19:22:00,0,3330.0,3309.0,0.994,16.783,125,56,45,11,69,53,16,56,0.0,0.03
1003,1673,25-09-2019 19:24:00,0,2559.0,2470.0,0.965,12.817,0,0,0,0,0,0,0,37,0.0,0.0
1003,1674,25-09-2019 19:26:00,0,2139.0,2214.0,1.035,10.877,0,0,0,0,0,0,0,44,0.0,0.0
1003,1675,25-09-2019 19:28:00,0,2447.0,2450.0,1.001,12.354,0,0,0,0,0,0,0,16,0.0,0.0
1003,1676,25-09-2019 19:30:00,0,2662.0,2558.0,0.961,13.319,0,0,0,0,0,0,0,0,0.01,0.0
1003,1677,25-09-2019 19:32:00,0,2643.0,2588.0,0.979,13.28,0,0,0,0,0,0,0,0,0.0,0.0
1003,1678,25-09-2019 19:34:00,0,2655.0,2605.0,0.981,13.344,0,0,0,0,0,0,0,0,0.0,0.0
1003,1679,25-09-2019 19:36:00,0,2660.0,2581.0,0.97,13.337,0,0,0,0,0,0,0,0,0.0,0.0
1003,1680,25-09-2019 19:38:00,0,2655.0,2574.0,0.969,13.312,0,0,0,0,0,0,0,0,0.0,0.0
1003,1681,25-09-2019 19:40:00,0,2655.0,2589.0,0.975,13.328,0,0,0,0,0,0,0,0,0.0,0.0
1003,1682,25-09-2019 19:42:00,0,2551.0,2533.0,0.993,12.855,0,0,0,0,0,0,0,7,0.0,0.0
1003,1683,25-09-2019 19:44:00,0,2652.0,2578.0,0.972,13.303,0,0,0,0,0,0,0,2,0.0,0.0
1003,1684,25-09-2019 19:46:00,0,2428.0,2515.0,1.036,12.35,0,0,0,0,0,0,0,8,0.0,0.0
1003,1685,25-09-2019 19:48:00,0,2388.5,2435.0,1.0195,12.1055,0,0,0,0,0,0,0,3,0.0,0.0
1003,1686,25-09-2019 19:50:00,0,2349.0,2355.0,1.003,11.861,5,5,2,3,0,0,0,47,0.0,0.0
1003,1687,25-09-2019 19:52:00,0,2342.0,2379.0,1.016,11.861,194,99,76,23,95,73,22,68,0.0,0.01
1003,1688,25-09-2019 19:54:00,0,2738.0,2715.0,0.992,13.793,163,56,17,39,107,68,39,43,0.0,0.0
1003,1689,25-09-2019 19:56:00,0,2837.0,2803.0,0.988,14.282,70,30,1,29,40,24,16,13,0.0,0.0
1003,1690,25-09-2019 19:58:00,0,3022.0,3097.0,1.025,15.334,132,39,25,14,93,64,29,19,0.03,0.04
1003,1691,25-09-2019 20:00:00,0,2842.0,2800.0,0.985,14.296,18,13,7,6,5,4,1,27,0.02,0.01
1003,1692,25-09-2019 20:02:00,0,2550.0,2516.0,0.987,12.831,177,94,70,24,83,58,25,84,0.0,0.0
1003,1693,25-09-2019 20:04:00,0,2868.0,2741.0,0.956,14.334,128,26,6,20,102,53,49,40,0.0,0.0
1003,1694,25-09-2019 20:06:00,0,2811.0,2927.0,1.041,14.315,71,48,33,15,23,19,4,98,0.0,0.02
1003,1695,25-09-2019 20:08:00,0,2333.0,2370.0,1.016,11.817,176,84,55,29,92,58,34,57,0.04,0.02
1003,1696,25-09-2019 20:10:00,0,2865.0,2732.0,0.954,14.312,1,1,1,0,0,0,0,32,0.0,0.0
1003,1697,25-09-2019 20:12:00,0,2154.0,2149.0,0.998,10.865,0,0,0,0,0,0,0,7,0.0,0.0
1003,1698,25-09-2019 20:14:00,0,2136.0,2235.0,1.046,10.891,0,0,0,0,0,0,0,0,0.0,0.0
1003,1699,25-09-2019 20:16:00,0,2340.0,2395.0,1.023,11.872,0,0,0,0,0,0,0,6,0.0,0.0
1003,1700,25-09-2019 20:18:00,0,2342.0,2352.0,1.004,11.829,0,0,0,0,0,0,0,8,0.0,0.0
1003,1701,25-09-2019 20:20:00,0,2349.0,2349.0,1.0,11.855,0,0,0,0,0,0,0,5,0.0,0.0
1003,1702,25-09-2019 20:22:00,0,2445.0,2459.5,1.0055,12.3555,0,0,0,0,0,0,0,11,0.0,0.0
1003,1703,25-09-2019 20:24:00,0,2541.0,2570.0,1.011,12.856,21,15,8,7,6,6,0,38,0.0,0.0
1003,1704,25-09-2019 20:26:00,0,2664.0,2550.0,0.957,13.319,0,0,0,0,0,0,0,36,0.0,0.01
1003,1705,25-09-2019 20:28:00,0,2740.0,2713.0,0.99,13.799,21,20,11,9,1,1,0,46,0.0,0.0
1003,1706,25-09-2019 20:30:00,0,2843.0,2820.0,0.992,14.324,13,13,6,7,0,0,0,41,0.0,0.0
1003,1707,25-09-2019 20:32:00,0,3007.0,3161.0,1.051,15.348,104,49,28,21,55,34,21,54,0.0,0.0
1003,1708,25-09-2019 20:34:00,0,3104.0,3168.0,1.021,15.738,167,67,33,34,100,64,36,37,0.0,0.05
1003,1709,25-09-2019 20:36:00,0,3235.0,3198.0,0.988,16.287,179,57,35,22,122,84,38,29,0.03,0.02
1003,1710,25-09-2019 20:38:00,0,3328.0,3315.0,0.996,16.782,300,176,144,32,124,90,34,142,0.02,0.01
1003,1711,25-09-2019 20:40:00,0,3345.0,3265.0,0.976,16.795,260,91,56,35,169,113,56,29,0.0,0.0
1003,1712,25-09-2019 20:42:00,0,3528.0,3505.0,0.994,17.782,129,36,3,33,93,66,27,16,0.0,0.0
1003,1713,25-09-2019 20:44:00,0,3550.0,3452.0,0.972,17.808,94,28,2,26,66,41,25,5,0.0,0.0
1003,1714,25-09-2019 20:46:00,0,3495.0,3563.0,1.02,17.714,329,167,126,41,162,110,52,74,0.05,0.11
1003,1715,25-09-2019 20:48:00,0,3029.0,3020.0,0.997,15.277,135,43,12,31,92,55,37,28,0.01,0.0
1003,1716,25-09-2019 20:50:00,0,3747.0,3597.0,0.96,18.746,282,157,113,44,125,89,36,59,0.09,0.1
1003,1717,25-09-2019 20:52:00,0,3313.0,3371.0,1.018,16.784,276,142,110,32,134,98,36,130,0.0,0.0
1003,1718,25-09-2019 20:54:00,0,3733.0,3634.0,0.973,18.729,206,110,82,28,96,61,35,51,0.03,0.03
1003,1719,25-09-2019 20:56:00,0,3641.0,3520.0,0.9665,18.242,166,84,61,23,82,58,24,33,0.03,0.02
1003,1720,25-09-2019 20:58:00,0,3549.0,3406.0,0.96,17.755,193,91,73,18,102,80,22,107,0.0,0.03
1003,1721,25-09-2019 21:00:00,0,3244.0,3181.0,0.981,16.302,161,74,48,26,87,50,37,46,0.04,0.0
1003,1722,25-09-2019 21:02:00,0,3852.0,3741.0,0.971,19.317,105,30,2,28,75,52,23,7,0.0,0.0
1003,1723,25-09-2019 21:04:00,0,3748.0,3597.0,0.96,18.747,90,23,0,23,67,41,26,8,0.0,0.0
1003,1724,25-09-2019 21:06:00,0,3829.0,3780.0,0.987,19.271,178,84,54,30,94,61,33,38,0.07,0.08
1003,1725,25-09-2019 21:08:00,0,3053.0,2957.0,0.969,15.301,240,120,90,30,120,81,39,48,0.0,0.0
1003,1726,25-09-2019 21:10:00,0,2755.0,2672.0,0.97,13.811,253,148,110,38,105,81,24,37,0.0,0.04
1003,1727,25-09-2019 21:12:00,0,3331.0,3311.0,0.994,16.79,465,267,223,44,198,160,38,113,0.01,0.0
1003,1728,25-09-2019 21:14:00,0,2859.0,2755.0,0.963,14.314,200,86,48,38,114,83,31,31,0.0,0.0
1003,1729,25-09-2019 21:16:00,0,3820.0,3757.0,0.984,19.209,266,127,102,25,139,100,39,50,0.0,0.0
1003,1730,25-09-2019 21:18:00,0,3860.0,3673.0,0.952,19.273,52,17,0,17,35,20,15,6,0.0,0.02
1003,1731,25-09-2019 21:20:00,0,3805.0,3802.0,0.999,19.199,30,15,0,15,15,10,5,3,0.0,0.0
1003,1732,25-09-2019 21:22:00,0,3844.0,3679.0,0.957,19.217,30,9,4,5,21,11,10,1,0.18,0.08
1003,1733,25-09-2019 21:24:00,0,3327.0,3383.0,1.017,16.853,173,94,63,31,79,42,37,18,0.0,0.0
1003,1734,25-09-2019 21:26:00,0,2844.0,2820.0,0.992,14.327,11,9,8,1,2,2,0,41,0.0,0.0
1003,1735,25-09-2019 21:28:00,0,2752.0,2668.0,0.969,13.796,0,0,0,0,0,0,0,35,0.0,0.0
1003,1736,25-09-2019 21:30:00,0,2557.0,2496.5,0.9765,12.839,0,0,0,0,0,0,0,0,0.0,0.0
1003,1737,25-09-2019 21:32:00,0,2362.0,2325.0,0.984,11.882,0,0,0,0,0,0,0,2,0.0,0.01
1003,1738,25-09-2019 21:34:00,0,2331.0,2408.0,1.033,11.85,0,0,0,0,0,0,0,0,0.0,0.0
1003,1739,25-09-2019 21:36:00,0,2864.0,2736.0,0.956,14.312,0,0,0,0,0,0,0,0,0.0,0.0
1003,1740,25-09-2019 21:38:00,0,2852.0,2774.0,0.973,14.306,0,0,0,0,0,0,0,1,0.0,0.0
1003,1741,25-09-2019 21:40:00,0,2831.0,2865.0,1.012,14.324,0,0,0,0,0,0,0,1,0.0,0.0
1003,1742,25-09-2019 21:42:00,0,2835.0,2839.0,1.001,14.312,0,0,0,0,0,0,0,0,0.0,0.0
1003,1743,25-09-2019 21:44:00,0,2833.0,2843.0,1.004,14.308,0,0,0,0,0,0,0,0,0.0,0.0
1003,1744,25-09-2019 21:46:00,0,2840.0,2785.0,0.981,14.274,1,1,1,0,0,0,0,11,0.0,0.01
1003,1745,25-09-2019 21:48:00,0,2666.0,2574.0,0.965,13.353,155,65,42,23,90,62,28,15,0.0,0.0
1003,1746,25-09-2019 21:50:00,0,3032.0,2989.0,0.986,15.254,111,38,4,34,73,49,24,5,0.0,0.0
1003,1747,25-09-2019 21:52:00,0,3302.0,3388.0,1.026,16.76,101,33,2,31,68,44,24,11,0.0,0.0
1003,1748,25-09-2019 21:54:00,0,3418.0,3461.0,1.013,17.299,54,27,0,27,27,15,12,4,0.0,0.12
1003,1749,25-09-2019 21:56:00,0,3425.0,3432.0,1.002,17.295,43,9,0,9,34,17,17,1,0.0,0.36
1003,1750,25-09-2019 21:58:00,0,3304.0,3390.0,1.026,16.77,31,7,3,4,24,3,21,0,0.03,0.0
1003,1751,25-09-2019 22:00:00,0,2925.0,2964.0,1.013,14.807,278,173,136,37,105,67,38,55,0.11,0.0
1003,1752,25-09-2019 22:02:00,0,3045.0,3002.0,0.986,15.319,72,35,24,11,37,26,11,19,0.08,0.01
1003,1753,25-09-2019 22:04:00,0,3235.5,3222.0,0.9955,16.314,171,92,66,26,79,54,25,27,0.0,0.01
1003,1754,25-09-2019 22:06:00,0,3426.0,3442.0,1.005,17.309,379,183,150,33,196,151,45,103,0.0,0.03
1003,1755,25-09-2019 22:08:00,0,3113.0,3182.0,1.022,15.789,379,227,189,38,152,119,33,190,0.0,0.0
1003,1756,25-09-2019 22:10:00,0,3027.0,3051.0,1.008,15.302,398,236,200,36,162,134,28,219,0.0,0.0
1003,1757,25-09-2019 22:12:00,0,3522.0,3511.0,0.997,17.762,453,266,227,39,187,158,29,163,0.0,0.0
1003,1758,25-09-2019 22:14:00,0,3629.0,3621.0,0.998,18.306,547,338,289,49,209,176,33,152,0.0,0.0
1003,1759,25-09-2019 22:16:00,0,3519.0,3532.0,1.004,17.776,341,209,162,47,132,105,27,97,0.06,0.0
1003,1760,25-09-2019 22:18:00,0,3525.0,3517.0,0.998,17.783,99,64,50,14,35,25,10,33,0.02,0.0
1003,1761,25-09-2019 22:20:00,0,3812.0,3773.0,0.99,19.195,364,177,145,32,187,146,41,129,0.0,0.0
1003,1762,25-09-2019 22:22:00,0,3528.0,3509.0,0.995,17.784,394,209,177,32,185,145,40,137,0.05,0.0
1003,1763,25-09-2019 22:24:00,0,3518.0,3517.0,1.0,17.756,453,216,161,55,237,176,61,141,0.0,0.0
1003,1764,25-09-2019 22:26:00,0,3424.0,3385.0,0.989,17.238,166,91,63,28,75,55,20,76,0.0,0.0
1003,1765,25-09-2019 22:28:00,0,3818.0,3710.0,0.972,19.149,176,101,74,27,75,46,29,47,0.0,0.0
1003,1766,25-09-2019 22:30:00,0,3121.0,3149.0,1.009,15.783,299,166,124,42,133,93,40,64,0.0,0.0
1003,1767,25-09-2019 22:32:00,0,3013.0,3083.0,1.023,15.284,340,166,124,42,174,135,39,65,0.0,0.0
1003,1768,25-09-2019 22:34:00,0,3129.0,3120.0,0.997,15.78,85,41,24,17,44,32,12,20,0.02,0.0
1003,1769,25-09-2019 22:36:00,0,3311.0,3358.0,1.014,16.762,214,132,103,29,82,63,19,130,0.0,0.0
1003,1770,25-09-2019 22:38:00,0,3313.5,3369.0,1.0165,16.784,392,237,190,47,155,124,31,125,0.0,0.0
1003,1771,25-09-2019 22:40:00,0,3316.0,3380.0,1.019,16.806,393,232,181,51,161,124,37,138,0.0,0.0
1003,1772,25-09-2019 22:42:00,0,3021.0,3081.0,1.02,15.312,344,201,153,48,143,109,34,91,0.0,0.0
1003,1773,25-09-2019 22:44:00,0,3343.0,3269.0,0.978,16.79,242,137,103,34,105,70,35,50,0.0,0.08
1003,1774,25-09-2019 22:46:00,0,3018.0,3120.0,1.034,15.343,50,43,23,20,7,2,5,33,0.0,0.0
1003,1775,25-09-2019 22:48:00,0,2181.0,2006.0,0.92,10.813,122,75,42,33,47,30,17,68,0.0,0.0
1003,1776,25-09-2019 22:50:00,0,2841.0,2818.0,0.992,14.312,173,110,79,31,63,41,22,18,0.0,0.0
1003,1777,25-09-2019 22:52:00,0,3029.0,3047.0,1.006,15.306,432,249,200,49,183,137,46,134,0.0,0.0
1003,1778,25-09-2019 22:54:00,0,3345.0,3261.0,0.975,16.79,116,59,31,28,57,27,30,2,0.0,0.0
1003,1779,25-09-2019 22:56:00,0,3332.0,3264.0,0.98,16.742,230,131,90,41,99,74,25,4,0.0,0.0
1003,1780,25-09-2019 22:58:00,0,3125.0,3162.0,1.012,15.813,118,57,21,36,61,36,25,11,0.0,0.0
1003,1781,25-09-2019 23:00:00,0,3338.0,3270.0,0.98,16.771,154,61,36,25,93,50,43,0,0.0,0.0
1003,1782,25-09-2019 23:02:00,0,3123.0,3166.0,1.014,15.811,256,104,67,37,152,101,51,0,0.0,0.0
1003,1783,25-09-2019 23:04:00,0,3124.0,3145.0,1.007,15.792,474,241,178,63,233,183,50,3,0.0,0.0
1003,1784,25-09-2019 23:06:00,0,3233.0,3191.0,0.987,16.27,338,169,120,49,169,132,37,36,0.0,0.0
1003,1785,25-09-2019 23:08:00,0,3031.0,3008.0,0.992,15.274,163,60,30,30,103,64,39,60,0.0,0.0
1003,1786,25-09-2019 23:10:00,0,3332.0,3276.0,0.983,16.755,104,22,5,17,82,57,25,17,0.0,0.0
1003,1787,25-09-2019 23:12:00,0,3334.0,3278.0,0.983,16.766,81,21,1,20,60,39,21,16,0.0,0.0
1003,1788,25-09-2019 23:14:00,0,3336.0,3280.0,0.983,16.777,23,13,0,13,10,6,4,8,0.0,0.0
1003,1789,25-09-2019 23:16:00,0,3326.0,3305.0,0.994,16.762,215,122,94,28,93,67,26,88,0.26,0.04
1003,1790,25-09-2019 23:18:00,0,2869.0,2723.0,0.949,14.318,230,147,115,32,83,67,16,95,0.0,0.02
1003,1791,25-09-2019 23:20:00,0,3716.0,3648.0,0.982,18.679,308,159,121,38,149,122,27,108,0.0,0.0
1003,1792,25-09-2019 23:22:00,0,2744.0,2703.0,0.985,13.804,440,229,174,55,211,178,33,160,0.0,0.0
1003,1793,25-09-2019 23:24:00,0,2442.0,2446.0,1.001,12.33,346,158,117,41,188,148,40,129,0.0,0.0
1003,1794,25-09-2019 23:26:00,0,2873.0,2731.0,0.951,14.342,188,28,7,21,160,103,57,1,0.0,0.0
1003,1795,25-09-2019 23:28:00,0,2865.0,2716.0,0.948,14.293,349,92,42,50,257,187,70,1,0.0,0.0
1003,1796,25-09-2019 23:30:00,0,2654.0,2622.0,0.988,13.36,398,204,149,55,194,130,64,12,0.0,0.0
1003,1797,25-09-2019 23:32:00,0,3054.0,2964.0,0.97,15.314,273,116,96,20,157,100,57,116,0.0,0.03
1003,1798,25-09-2019 23:34:00,0,2845.0,2759.0,0.97,14.265,306,144,100,44,162,103,59,139,0.0,0.0
1003,1799,25-09-2019 23:36:00,0,2950.0,2893.0,0.981,14.828,420,137,98,39,283,215,68,112,0.0,0.0
1003,1800,25-09-2019 23:38:00,0,2634.0,2648.0,1.005,13.309,197,47,29,18,150,101,49,1,0.0,0.0
1003,1801,25-09-2019 23:40:00,0,2868.0,2758.0,0.962,14.352,324,37,20,17,287,210,77,1,0.0,0.0
1003,1802,25-09-2019 23:42:00,0,2929.0,2916.0,0.995,14.769,208,39,17,22,169,108,61,0,0.0,0.0
1003,1803,25-09-2019 23:44:00,0,2934.0,2916.0,0.994,14.788,225,24,6,18,201,149,52,0,0.0,0.0
1003,1804,25-09-2019 23:46:00,0,2874.5,2898.5,1.009,14.5335,464,190,136,54,274,199,75,4,0.0,0.0
1003,1805,25-09-2019 23:48:00,0,2815.0,2881.0,1.024,14.279,792,418,332,86,374,297,77,37,0.0,0.04
1003,1806,25-09-2019 23:50:00,0,3047.0,2969.0,0.974,15.291,372,156,120,36,216,163,53,115,0.0,0.0
1003,1807,25-09-2019 23:52:00,0,3042.0,2992.0,0.984,15.297,345,136,101,35,209,146,63,19,0.0,0.0
1003,1808,25-09-2019 23:54:00,0,2824.0,2891.0,1.024,14.326,352,129,103,26,223,159,64,78,0.0,0.0
1003,1809,25-09-2019 23:56:00,0,2946.0,2924.0,0.992,14.844,477,176,130,46,301,230,71,27,0.0,0.0
1003,1810,25-09-2019 23:58:00,0,2859.0,2766.0,0.967,14.328,307,81,51,30,226,161,65,0,0.0,0.0
1003,1811,26-09-2019 00:00:00,0,2872.0,2714.0,0.945,14.319,350,146,104,42,204,151,53,0,0.0,0.0
1003,1812,26-09-2019 00:02:00,0,2867.0,2715.0,0.947,14.303,634,292,231,61,342,261,81,44,0.0,0.0
1003,1813,26-09-2019 00:04:00,0,2827.0,2904.0,1.027,14.352,367,117,82,35,250,181,69,0,0.0,0.0
1003,1814,26-09-2019 00:06:00,0,2626.0,2679.0,1.02,13.311,454,183,133,50,271,199,72,39,0.0,0.0
1003,1815,26-09-2019 00:08:00,0,2761.0,2675.0,0.969,13.84,155,14,1,13,141,97,44,11,0.0,0.0
1003,1816,26-09-2019 00:10:00,0,3021.0,3082.0,1.02,15.313,202,26,2,24,176,126,50,14,0.0,0.0
1003,1817,26-09-2019 00:12:00,0,3120.0,3181.0,1.019,15.814,315,117,83,34,198,140,58,22,0.0,0.0
1003,1818,26-09-2019 00:14:00,0,2181.0,2053.0,0.941,10.866,400,175,128,47,225,157,68,0,0.0,0.0
1003,1819,26-09-2019 00:16:00,0,2079.0,1977.0,0.951,10.381,403,183,136,47,220,173,47,83,0.0,0.0
1003,1820,26-09-2019 00:18:00,0,2835.0,2827.0,0.997,14.298,453,178,129,49,275,213,62,136,0.0,0.0
1003,1821,26-09-2019 00:20:00,0,2834.0,2845.5,1.004,14.315,332,92,65,27,240,188,52,42,0.0,0.0
1003,1822,26-09-2019 00:22:00,0,2833.0,2864.0,1.011,14.332,369,133,99,34,236,172,64,10,0.0,0.0
1003,1823,26-09-2019 00:24:00,0,3121.0,3165.0,1.014,15.802,138,64,37,27,74,50,24,15,0.0,0.0
1003,1824,26-09-2019 00:26:00,0,3054.0,2966.0,0.971,15.316,142,57,34,23,85,56,29,8,0.0,0.01
1003,1825,26-09-2019 00:28:00,0,2641.0,2638.0,0.999,13.324,224,93,53,40,131,81,50,0,0.0,0.0
1003,1826,26-09-2019 00:30:00,0,2166.0,2117.0,0.977,10.878,535,212,142,70,323,233,90,0,0.0,0.0
1003,1827,26-09-2019 00:32:00,0,2183.0,2030.0,0.93,10.848,418,217,152,65,201,157,44,44,0.0,0.0
1003,1828,26-09-2019 00:34:00,0,2852.0,2773.0,0.972,14.307,516,299,230,69,217,165,52,19,0.0,0.01
1003,1829,26-09-2019 00:36:00,0,3008.0,3128.0,1.04,15.315,246,87,45,42,159,107,52,5,0.0,0.0
1003,1830,26-09-2019 00:38:00,0,3035.0,3009.0,0.991,15.29,166,45,13,32,121,68,53,5,0.0,0.0
1003,1831,26-09-2019 00:40:00,0,3030.0,3045.0,1.005,15.308,78,12,3,9,66,34,32,0,0.0,0.0
1003,1832,26-09-2019 00:42:00,0,3017.0,3082.0,1.022,15.297,84,13,0,13,71,23,48,0,0.0,0.0
1003,1833,26-09-2019 00:44:00,0,3026.0,3023.0,0.999,15.269,67,27,11,16,40,18,22,0,0.0,0.0
1003,1834,26-09-2019 00:46:00,0,2822.0,2909.0,1.031,14.338,81,11,5,6,70,51,19,0,0.0,0.0
1003,1835,26-09-2019 00:48:00,0,2866.0,2731.0,0.953,14.315,12,6,2,4,6,2,4,0,0.0,0.0
1003,1836,26-09-2019 00:50:00,0,2430.0,2495.0,1.027,12.335,11,1,0,1,10,0,10,0,0.0,0.0
1003,1837,26-09-2019 00:52:00,0,2358.0,2307.0,0.978,11.844,6,5,2,3,1,0,1,0,0.0,0.0
1003,1838,26-09-2019 00:54:00,0,2267.5,2186.0,0.9635,11.3535,3,3,1,2,0,0,0,0,0.0,0.0
1003,1839,26-09-2019 00:56:00,0,2177.0,2065.0,0.949,10.863,54,21,8,13,33,21,12,0,0.0,0.0
1003,1840,26-09-2019 00:58:00,0,2173.0,2073.0,0.954,10.858,0,0,0,0,0,0,0,0,0.0,0.0
1003,1841,26-09-2019 01:00:00,0,2174.0,2072.0,0.953,10.859,73,30,19,11,43,24,19,0,0.0,0.0
1003,1842,26-09-2019 01:02:00,0,2180.0,2052.0,0.941,10.861,105,0,0,0,105,91,14,0,0.0,0.0
1003,1843,26-09-2019 01:04:00,0,1865.0,1848.0,0.991,9.395,67,0,0,0,67,53,14,0,0.0,0.0
1003,1844,26-09-2019 01:06:00,0,1776.0,1728.0,0.973,8.909,48,0,0,0,48,41,7,0,0.0,0.0
1003,1845,26-09-2019 01:08:00,0,1653.0,1680.0,1.016,8.373,38,1,1,0,37,21,16,0,0.0,0.0
1003,1846,26-09-2019 01:10:00,0,1773.0,1704.0,0.961,8.872,67,18,8,10,49,23,26,0,0.0,0.0
1003,1847,26-09-2019 01:12:00,0,1869.0,1839.0,0.984,9.399,213,88,57,31,125,70,55,17,0.0,0.0
1003,1848,26-09-2019 01:14:00,0,2637.0,2643.0,1.002,13.316,169,78,52,26,91,59,32,63,0.0,0.0
1003,1849,26-09-2019 01:16:00,0,2824.0,2862.0,1.013,14.295,298,135,101,34,163,116,47,42,0.0,0.02
1003,1850,26-09-2019 01:18:00,0,2860.0,2754.0,0.963,14.316,463,244,198,46,219,156,63,35,0.0,0.0
1003,1851,26-09-2019 01:20:00,0,2817.0,2915.0,1.035,14.324,205,105,72,33,100,72,28,7,0.0,0.04
1003,1852,26-09-2019 01:22:00,0,2823.0,2886.0,1.022,14.317,346,161,125,36,185,142,43,60,0.0,0.0
1003,1853,26-09-2019 01:24:00,0,2850.0,2773.0,0.973,14.299,706,380,304,76,326,247,79,4,0.0,0.0
1003,1854,26-09-2019 01:26:00,0,2847.0,2794.0,0.982,14.311,512,296,241,55,216,162,54,115,0.0,0.0
1003,1855,26-09-2019 01:28:00,0,2840.5,2801.0,0.9865,14.292,343,166,125,41,177,145,32,142,0.0,0.0
1003,1856,26-09-2019 01:30:00,0,2834.0,2808.0,0.991,14.273,276,115,67,48,161,119,42,42,0.0,0.0
1003,1857,26-09-2019 01:32:00,0,2642.0,2645.0,1.001,13.34,632,346,261,85,286,216,70,0,0.0,0.0
1003,1858,26-09-2019 01:34:00,0,2659.0,2587.0,0.973,13.342,436,220,169,51,216,166,50,84,0.0,0.0
1003,1859,26-09-2019 01:36:00,0,2848.0,2844.0,0.999,14.368,133,50,35,15,83,67,16,40,0.0,0.0
1003,1860,26-09-2019 01:38:00,0,3058.0,2942.0,0.962,15.304,87,37,3,34,50,29,21,3,0.0,0.0
1003,1861,26-09-2019 01:40:00,0,3132.0,3125.0,0.998,15.797,52,24,0,24,28,16,12,0,0.0,0.0
1003,1862,26-09-2019 01:42:00,0,3328.0,3311.0,0.995,16.776,19,13,0,13,6,3,3,0,0.0,0.01
1003,1863,26-09-2019 01:44:00,0,3329.0,3341.0,1.004,16.815,255,152,115,37,103,71,32,2,0.0,0.05
1003,1864,26-09-2019 01:46:00,0,2856.0,2788.0,0.976,14.338,475,267,208,59,208,153,55,53,0.0,0.02
1003,1865,26-09-2019 01:48:00,0,3029.0,3052.0,1.008,15.312,387,195,153,42,192,132,60,7,0.0,0.0
1003,1866,26-09-2019 01:50:00,0,2648.0,2632.0,0.994,13.349,455,244,183,61,211,155,56,24,0.03,0.0
1003,1867,26-09-2019 01:52:00,0,2640.0,2630.0,0.996,13.312,329,136,98,38,193,144,49,42,0.0,0.0
1003,1868,26-09-2019 01:54:00,0,2353.0,2351.0,0.999,11.875,860,526,416,110,334,252,82,3,0.0,0.0
1003,1869,26-09-2019 01:56:00,0,2840.0,2804.0,0.987,14.292,608,347,288,59,261,204,57,74,0.0,0.0
1003,1870,26-09-2019 01:58:00,0,3051.0,3005.0,0.985,15.348,97,38,19,19,59,27,32,2,0.0,0.0
1003,1871,26-09-2019 02:00:00,0,2837.0,2816.0,0.992,14.295,112,35,4,31,77,36,41,2,0.0,0.0
1003,1872,26-09-2019 02:02:00,0,2930.5,2935.0,1.001,14.795,43,17,4,13,26,15,11,0,0.0,0.0
1003,1873,26-09-2019 02:04:00,0,3024.0,3054.0,1.01,15.295,52,23,10,13,29,12,17,0,0.0,0.0
1003,1874,26-09-2019 02:06:00,0,2830.0,2883.0,1.018,14.342,12,1,1,0,11,1,10,0,0.0,0.0
1003,1875,26-09-2019 02:08:00,0,2840.0,2791.0,0.983,14.28,20,11,4,7,9,2,7,0,0.0,0.0
1003,1876,26-09-2019 02:10:00,0,2640.0,2640.0,1.0,13.323,28,0,0,0,28,1,27,0,0.0,0.0
1003,1877,26-09-2019 02:12:00,0,2355.0,2349.0,0.998,11.878,23,0,0,0,23,0,23,0,0.0,0.0
1003,1878,26-09-2019 02:14:00,0,2154.0,2139.0,0.993,10.857,77,27,16,11,50,18,32,0,0.0,0.0
1003,1879,26-09-2019 02:16:00,0,2152.0,2120.0,0.985,10.826,13,13,1,12,0,0,0,0,0.0,0.0
1003,1880,26-09-2019 02:18:00,0,2068.0,2008.0,0.971,10.373,3,2,0,2,1,0,1,0,0.0,0.0
1003,1881,26-09-2019 02:20:00,0,1855.0,1838.0,0.991,9.342,0,0,0,0,0,0,0,0,0.0,0.0
1003,1882,26-09-2019 02:22:00,0,1878.0,1783.0,0.95,9.372,7,4,2,2,3,0,3,0,0.0,0.0
1003,1883,26-09-2019 02:24:00,0,1849.0,1876.0,1.015,9.362,0,0,0,0,0,0,0,0,0.0,0.0
1003,1884,26-09-2019 02:26:00,0,1849.0,1915.0,1.036,9.403,15,7,3,4,8,5,3,0,0.0,0.0
1003,1885,26-09-2019 02:28:00,0,1962.0,1939.0,0.988,9.875,109,42,16,26,67,32,35,0,0.0,0.0
1003,1886,26-09-2019 02:30:00,0,2556.0,2477.0,0.969,12.813,66,34,4,30,32,6,26,3,0.0,0.0
1003,1887,26-09-2019 02:32:00,0,2875.0,2700.0,0.939,14.315,77,38,14,24,39,15,24,0,0.0,0.0
1003,1888,26-09-2019 02:34:00,0,2881.0,2712.0,0.941,14.352,27,11,3,8,16,10,6,0,0.0,0.0
1003,1889,26-09-2019 02:36:00,0,2608.5,2530.0,0.973,13.078,0,0,0,0,0,0,0,0,0.0,0.0
1003,1890,26-09-2019 02:38:00,0,2336.0,2348.0,1.005,11.804,3,1,0,1,2,0,2,0,0.0,0.0
1003,1891,26-09-2019 02:40:00,0,2256.0,2243.0,0.994,11.372,12,0,0,0,12,0,12,0,0.0,0.0
1003,1892,26-09-2019 02:42:00,0,2145.0,2161.0,1.008,10.844,26,13,4,9,13,7,6,0,0.0,0.01
1003,1893,26-09-2019 02:44:00,0,2156.0,2115.0,0.981,10.835,100,33,24,9,67,45,22,8,0.0,0.0
1003,1894,26-09-2019 02:46:00,0,2901.0,2628.0,0.906,14.338,32,22,0,22,10,4,6,2,0.0,0.01
1003,1895,26-09-2019 02:48:00,0,3065.0,2888.0,0.942,15.271,30,14,1,13,16,4,12,5,0.0,0.0
1003,1896,26-09-2019 02:50:00,0,3054.0,2944.0,0.964,15.294,51,16,4,12,35,17,18,6,0.0,0.0
1003,1897,26-09-2019 02:52:00,0,3051.0,2960.0,0.97,15.298,51,22,1,21,29,16,13,4,0.0,0.15
1003,1898,26-09-2019 02:54:00,0,3057.0,2954.0,0.966,15.316,184,74,49,25,110,83,27,34,0.07,0.03
1003,1899,26-09-2019 02:56:00,0,2660.0,2558.0,0.962,13.313,878,501,405,96,377,294,83,33,0.0,0.0
1003,1900,26-09-2019 02:58:00,0,3040.0,2997.0,0.986,15.296,522,315,248,67,207,161,46,110,0.0,0.0
1003,1901,26-09-2019 03:00:00,0,2818.0,2920.0,1.036,14.334,329,181,143,38,148,110,38,186,0.0,0.02
1003,1902,26-09-2019 03:02:00,0,3048.0,2962.0,0.972,15.289,370,206,166,40,164,121,43,103,0.17,0.0
1003,1903,26-09-2019 03:04:00,0,2874.0,2700.0,0.939,14.312,179,62,43,19,117,79,38,82,0.0,0.0
1003,1904,26-09-2019 03:06:00,0,3332.0,3264.0,0.98,16.743,305,136,101,35,169,123,46,66,0.0,0.0
1003,1905,26-09-2019 03:08:00,0,3045.0,2960.0,0.972,15.275,138,58,36,22,80,53,27,31,0.0,0.0
1003,1906,26-09-2019 03:10:00,0,2806.0,2720.5,0.9695,14.0675,398,230,172,58,168,120,48,4,0.0,0.01
1003,1907,26-09-2019 03:12:00,0,2567.0,2481.0,0.967,12.86,460,222,158,64,238,183,55,10,0.0,0.0
1003,1908,26-09-2019 03:14:00,0,2851.0,2770.0,0.971,14.299,400,254,204,50,146,114,32,112,0.0,0.0
1003,1909,26-09-2019 03:16:00,0,2863.0,2753.0,0.962,14.327,222,113,82,31,109,72,37,35,0.0,0.0
1003,1910,26-09-2019 03:18:00,0,2162.0,2105.0,0.974,10.847,133,71,40,31,62,29,33,1,0.0,0.0
1003,1911,26-09-2019 03:20:00,0,2684.0,2456.0,0.915,13.295,82,37,17,20,45,16,29,0,0.0,0.0
1003,1912,26-09-2019 03:22:00,0,2878.0,2673.0,0.929,14.3,29,10,3,7,19,6,13,0,0.0,0.0
1003,1913,26-09-2019 03:24:00,0,2950.0,2883.0,0.977,14.815,42,15,7,8,27,1,26,0,0.0,0.01
1003,1914,26-09-2019 03:26:00,0,2849.0,2783.0,0.977,14.304,3,2,2,0,1,0,1,0,0.0,0.0
1003,1915,26-09-2019 03:28:00,0,2769.0,2623.0,0.947,13.812,18,7,3,4,11,5,6,0,0.0,0.0
1003,1916,26-09-2019 03:30:00,0,2657.0,2602.0,0.979,13.348,2,1,1,0,1,1,0,0,0.0,0.0
1003,1917,26-09-2019 03:32:00,0,2250.0,2251.0,1.0,11.358,10,0,0,0,10,2,8,0,0.0,0.0
1003,1918,26-09-2019 03:34:00,0,2177.0,2014.0,0.925,10.808,51,15,9,6,36,6,30,0,0.0,0.0
1003,1919,26-09-2019 03:36:00,0,2176.0,2038.0,0.937,10.829,24,1,0,1,23,2,21,0,0.0,0.0
1003,1920,26-09-2019 03:38:00,0,2068.0,2002.0,0.968,10.363,0,0,0,0,0,0,0,0,0.0,0.0
1003,1921,26-09-2019 03:40:00,0,1957.0,1962.0,1.002,9.882,9,8,5,3,1,0,1,0,0.0,0.0
1003,1922,26-09-2019 03:42:00,0,2192.0,2001.0,0.913,10.852,2,2,0,2,0,0,0,0,0.0,0.0
1003,1923,26-09-2019 03:44:00,0,2171.5,2071.5,0.9545,10.849,14,6,0,6,8,0,8,0,0.0,0.0
1003,1924,26-09-2019 03:46:00,0,2151.0,2142.0,0.996,10.846,7,1,0,1,6,0,6,0,0.0,0.0
1003,1925,26-09-2019 03:48:00,0,2369.0,2264.0,0.955,11.841,0,0,0,0,0,0,0,0,0.0,0.0
1003,1926,26-09-2019 03:50:00,0,2266.0,2190.0,0.966,11.352,5,3,1,2,2,0,2,0,0.0,0.0
1003,1927,26-09-2019 03:52:00,0,2158.0,2095.0,0.971,10.821,5,0,0,0,5,1,4,0,0.0,0.0
1003,1928,26-09-2019 03:54:00,0,2187.0,2036.0,0.931,10.872,70,53,42,11,17,8,9,0,0.0,0.0
1003,1929,26-09-2019 03:56:00,0,2168.0,2089.0,0.964,10.853,128,34,7,27,94,56,38,0,0.0,0.0
1003,1930,26-09-2019 03:58:00,0,2337.0,2383.0,1.02,11.846,210,65,30,35,145,90,55,1,0.0,0.0
1003,1931,26-09-2019 04:00:00,0,2647.0,2612.0,0.987,13.322,107,39,23,16,68,39,29,17,0.0,0.0
1003,1932,26-09-2019 04:02:00,0,2887.0,2635.0,0.913,14.292,97,15,2,13,82,44,38,5,0.0,0.0
1003,1933,26-09-2019 04:04:00,0,2949.0,2840.0,0.963,14.762,61,11,1,10,50,33,17,12,0.0,0.0
1003,1934,26-09-2019 04:06:00,0,3051.0,2977.0,0.976,15.315,51,19,1,18,32,17,15,2,0.0,0.09
1003,1935,26-09-2019 04:08:00,0,3023.0,3052.0,1.01,15.29,42,20,1,19,22,9,13,1,0.0,0.03
1003,1936,26-09-2019 04:10:00,0,3141.0,3069.0,0.977,15.772,465,265,202,63,200,155,45,23,0.0,0.07
1003,1937,26-09-2019 04:12:00,0,2859.0,2755.0,0.963,14.314,1001,638,521,117,363,283,80,59,0.0,0.0
1003,1938,26-09-2019 04:14:00,0,3033.0,3025.0,0.997,15.3,733,380,298,82,353,271,82,24,0.0,0.0
1003,1939,26-09-2019 04:16:00,0,2335.0,2374.0,1.017,11.829,434,237,173,64,197,146,51,71,0.0,0.05
1003,1940,26-09-2019 04:18:00,0,2297.0,2293.0,0.998,11.5895,263,132,82,50,131,90,41,54,0.0,0.0
1003,1941,26-09-2019 04:20:00,0,2259.0,2212.0,0.979,11.35,365,241,174,67,124,75,49,0,0.0,0.0
1003,1942,26-09-2019 04:22:00,0,2075.0,1956.0,0.943,10.34,276,135,96,39,141,91,50,37,0.0,0.0
1003,1943,26-09-2019 04:24:00,0,2684.0,2483.0,0.925,13.324,581,348,267,81,233,174,59,29,0.0,0.0
1003,1944,26-09-2019 04:26:00,0,2848.0,2784.0,0.978,14.301,181,56,33,23,125,78,47,1,0.0,0.0
1003,1945,26-09-2019 04:28:00,0,3027.0,3057.0,1.01,15.309,210,125,78,47,85,43,42,35,0.0,0.0
1003,1946,26-09-2019 04:30:00,0,3356.0,3186.0,0.949,16.75,93,19,1,18,74,38,36,4,0.0,0.0
1003,1947,26-09-2019 04:32:00,0,3314.0,3359.0,1.014,16.775,73,26,0,26,47,27,20,0,0.0,0.02
1003,1948,26-09-2019 04:34:00,0,3313.0,3326.0,1.004,16.736,80,14,4,10,66,33,33,9,0.0,0.05
1003,1949,26-09-2019 04:36:00,0,3361.0,3216.0,0.957,16.803,88,42,35,7,46,36,10,2,0.27,0.05
1003,1950,26-09-2019 04:38:00,0,2562.0,2469.0,0.964,12.828,7,6,1,5,1,1,0,0,0.0,0.0
1003,1951,26-09-2019 04:40:00,0,2342.0,2358.0,1.007,11.836,9,3,2,1,6,0,6,0,0.0,0.01
1003,1952,26-09-2019 04:42:00,0,2359.0,2293.0,0.972,11.833,17,4,3,1,13,2,11,0,0.0,0.0
1003,1953,26-09-2019 04:44:00,0,2156.0,2157.0,1.0,10.882,36,4,1,3,32,2,30,0,0.0,0.0
1003,1954,26-09-2019 04:46:00,0,2156.0,2126.0,0.986,10.849,4,1,1,0,3,3,0,0,0.0,0.0
1003,1955,26-09-2019 04:48:00,0,1953.0,1954.0,1.0,9.859,0,0,0,0,0,0,0,0,0.0,0.0
1003,1956,26-09-2019 04:50:00,0,1866.0,1833.0,0.982,9.383,4,0,0,0,4,1,3,0,0.0,0.0
1003,1957,26-09-2019 04:52:00,0,1822.0,1771.0,0.9715,9.14,39,12,8,4,27,12,15,0,0.0,0.0
1003,1958,26-09-2019 04:54:00,0,1778.0,1709.0,0.961,8.897,4,0,0,0,4,0,4,0,0.0,0.0
1003,1959,26-09-2019 04:56:00,0,1769.0,1717.0,0.971,8.871,0,0,0,0,0,0,0,0,0.0,0.0
1003,1960,26-09-2019 04:58:00,0,1866.0,1831.0,0.981,9.38,0,0,0,0,0,0,0,0,0.0,0.0
1003,1961,26-09-2019 05:00:00,0,1954.0,1973.0,1.01,9.884,6,3,1,2,3,1,2,0,0.0,0.0
1003,1962,26-09-2019 05:02:00,0,2143.0,2159.0,1.008,10.832,2,0,0,0,2,0,2,0,0.0,0.0
1003,1963,26-09-2019 05:04:00,0,2141.0,2211.0,1.033,10.882,88,56,30,26,32,11,21,0,0.0,0.0
1003,1964,26-09-2019 05:06:00,0,2249.0,2271.0,1.01,11.374,109,53,24,29,56,31,25,0,0.0,0.0
1003,1965,26-09-2019 05:08:00,0,2746.0,2713.0,0.988,13.823,35,19,7,12,16,2,14,0,0.0,0.0
1003,1966,26-09-2019 05:10:00,0,2915.0,2971.0,1.019,14.771,273,134,89,45,139,95,44,45,0.0,0.0
1003,1967,26-09-2019 05:12:00,0,3014.0,3094.0,1.027,15.299,230,133,103,30,97,76,21,89,0.0,0.0
1003,1968,26-09-2019 05:14:00,0,2819.0,2880.0,1.022,14.295,287,157,125,32,130,104,26,130,0.0,0.03
1003,1969,26-09-2019 05:16:00,0,3017.0,3131.0,1.038,15.353,198,102,74,28,96,74,22,130,0.0,0.0
1003,1970,26-09-2019 05:18:00,0,3296.0,3392.0,1.029,16.743,403,180,130,50,223,182,41,78,0.0,0.0
1003,1971,26-09-2019 05:20:00,0,3011.0,3113.0,1.034,15.308,309,153,109,44,156,116,40,67,0.0,0.0
1003,1972,26-09-2019 05:22:00,0,2842.0,2834.0,0.997,14.336,381,198,153,45,183,142,41,181,0.0,0.0
1003,1973,26-09-2019 05:24:00,0,2822.0,2879.0,1.02,14.304,314,175,119,56,139,100,39,104,0.0,0.0
1003,1974,26-09-2019 05:26:00,0,2938.5,2909.0,0.991,14.7975,272,130,90,40,142,97,45,11,0.0,0.0
1003,1975,26-09-2019 05:28:00,0,3055.0,2939.0,0.962,15.291,425,223,182,41,202,149,53,39,0.0,0.0
1003,1976,26-09-2019 05:30:00,0,3039.0,3010.0,0.99,15.307,140,69,40,29,71,37,34,3,0.0,0.0
1003,1977,26-09-2019 05:32:00,0,2957.0,2863.0,0.968,14.821,59,29,2,27,30,6,24,3,0.0,0.0
1003,1978,26-09-2019 05:34:00,0,3064.0,2886.0,0.942,15.267,40,17,2,15,23,4,19,0,0.0,0.0
1003,1979,26-09-2019 05:36:00,0,2855.0,2748.0,0.963,14.291,89,41,13,28,48,29,19,0,0.0,0.0
1003,1980,26-09-2019 05:38:00,0,2869.0,2753.0,0.959,14.353,77,46,17,29,31,11,20,0,0.0,0.0
1003,1981,26-09-2019 05:40:00,0,2850.0,2760.0,0.968,14.286,87,34,5,29,53,23,30,0,0.0,0.0
1003,1982,26-09-2019 05:42:00,0,2884.0,2658.0,0.922,14.304,40,19,6,13,21,3,18,0,0.0,0.0
1003,1983,26-09-2019 05:44:00,0,2679.0,2507.0,0.936,13.331,0,0,0,0,0,0,0,0,0.0,0.0
1003,1984,26-09-2019 05:46:00,0,2351.0,2334.0,0.993,11.846,1,0,0,0,1,0,1,0,0.0,0.0
1003,1985,26-09-2019 05:48:00,0,2396.0,2186.0,0.913,11.86,40,18,9,9,22,9,13,0,0.0,0.0
1003,1986,26-09-2019 05:50:00,0,2171.0,2061.0,0.949,10.837,0,0,0,0,0,0,0,0,0.0,0.0
1003,1987,26-09-2019 05:52:00,0,1858.0,1868.0,1.005,9.39,0,0,0,0,0,0,0,0,0.0,0.0
1003,1988,26-09-2019 05:54:00,0,1892.0,1728.0,0.913,9.368,3,0,0,0,3,0,3,0,0.0,0.0
1003,1989,26-09-2019 05:56:00,0,1671.0,1654.0,0.99,8.416,12,6,3,3,6,2,4,0,0.0,0.0
1003,1990,26-09-2019 05:58:00,0,1669.0,1633.0,0.978,8.384,0,0,0,0,0,0,0,0,0.0,0.0
1003,1991,26-09-2019 06:00:00,1,1670.5,1625.5,0.973,8.381,0,0,0,0,0,0,0,0,0.0,0.0
1003,1992,26-09-2019 06:02:00,1,1672.0,1618.0,0.968,8.378,32,16,12,4,16,11,5,0,0.0,0.0
1003,1993,26-09-2019 06:04:00,1,1903.0,1691.0,0.889,9.368,96,35,20,15,61,26,35,0,0.0,0.0
1003,1994,26-09-2019 06:06:00,1,2284.0,2134.0,0.934,11.36,12,6,4,2,6,0,6,0,0.0,0.0
1003,1995,26-09-2019 06:08:00,1,2385.0,2221.0,0.931,11.857,6,1,0,1,5,0,5,0,0.0,0.0
1003,1996,26-09-2019 06:10:00,1,2389.0,2204.0,0.922,11.852,38,17,6,11,21,9,12,0,0.0,0.0
1003,1997,26-09-2019 06:12:00,1,2281.0,2117.0,0.928,11.33,1,0,0,0,1,0,1,0,0.0,0.0
1003,1998,26-09-2019 06:14:00,1,2183.0,2030.0,0.93,10.85,104,41,28,13,63,45,18,14,0.0,0.0
1003,1999,26-09-2019 06:16:00,1,2288.0,2089.0,0.913,11.327,99,40,24,16,59,39,20,65,0.0,0.0
1003,2000,26-09-2019 06:18:00,1,2612.0,2303.0,0.882,12.843,0,0,0,0,0,0,0,46,0.0,0.0
1003,2001,26-09-2019 06:20:00,1,2704.0,2416.0,0.894,13.327,0,0,0,0,0,0,0,27,0.0,0.0
1003,2002,26-09-2019 06:22:00,1,2705.0,2419.0,0.894,13.335,0,0,0,0,0,0,0,7,0.0,0.0
1003,2003,26-09-2019 06:24:00,1,2377.0,2239.0,0.942,11.843,0,0,0,0,0,0,0,0,0.0,0.0
1003,2004,26-09-2019 06:26:00,1,2401.0,2096.0,0.873,11.781,0,0,0,0,0,0,0,1,0.0,0.0
1003,2005,26-09-2019 06:28:00,1,2190.0,2024.0,0.924,10.87,0,0,0,0,0,0,0,3,0.0,0.0
1003,2006,26-09-2019 06:30:00,1,2201.0,1938.0,0.881,10.817,0,0,0,0,0,0,0,0,0.0,0.0
1003,2007,26-09-2019 06:32:00,1,2212.0,1922.0,0.869,10.845,0,0,0,0,0,0,0,1,0.0,0.0
1003,2008,26-09-2019 06:34:00,1,2160.0,1893.5,0.8765,10.6075,0,0,0,0,0,0,0,4,0.0,0.0
1003,2009,26-09-2019 06:36:00,1,2108.0,1865.0,0.884,10.37,0,0,0,0,0,0,0,0,0.0,0.0
1003,2010,26-09-2019 06:38:00,1,1991.0,1830.0,0.919,9.869,0,0,0,0,0,0,0,0,0.0,0.0
1003,2011,26-09-2019 06:40:00,1,1998.0,1778.0,0.89,9.842,0,0,0,0,0,0,0,1,0.0,0.0
1003,2012,26-09-2019 06:42:00,1,1877.0,1798.0,0.958,9.388,40,27,24,3,13,10,3,27,0.0,0.0
1003,2013,26-09-2019 06:44:00,1,1986.0,1829.0,0.921,9.849,0,0,0,0,0,0,0,1,0.0,0.0
1003,2014,26-09-2019 06:46:00,1,1884.0,1786.0,0.948,9.398,0,0,0,0,0,0,0,0,0.0,0.0
1003,2015,26-09-2019 06:48:00,1,1889.0,1750.0,0.926,9.38,0,0,0,0,0,0,0,1,0.0,0.0
1003,2016,26-09-2019 06:50:00,1,2101.0,1859.0,0.884,10.337,0,0,0,0,0,0,0,1,0.0,0.0
1003,2017,26-09-2019 06:52:00,1,1870.0,1800.0,0.962,9.361,0,0,0,0,0,0,0,0,0.0,0.0
1003,2018,26-09-2019 06:54:00,1,1884.0,1761.0,0.935,9.372,0,0,0,0,0,0,0,0,0.0,0.0
1003,2019,26-09-2019 06:56:00,1,1892.0,1739.0,0.919,9.38,0,0,0,0,0,0,0,3,0.0,0.0
1003,2020,26-09-2019 06:58:00,1,1894.0,1707.0,0.901,9.354,19,18,13,5,1,1,0,53,0.0,0.0
1003,2021,26-09-2019 07:00:00,1,2202.0,1981.0,0.899,10.871,58,7,1,6,51,22,29,50,0.0,0.0
1003,2022,26-09-2019 07:02:00,1,2713.0,2352.0,0.867,13.295,42,12,5,7,30,6,24,34,0.0,0.04
1003,2023,26-09-2019 07:04:00,1,2681.0,2464.0,0.919,13.289,61,32,15,17,29,9,20,18,0.0,0.02
1003,2024,26-09-2019 07:06:00,1,2688.0,2429.0,0.904,13.282,31,20,11,9,11,2,9,57,0.0,0.1
1003,2025,26-09-2019 07:08:00,1,2790.0,2520.0,0.9035,13.783,50,38,19,19,12,2,10,50,0.0,0.02
1003,2026,26-09-2019 07:10:00,1,2892.0,2611.0,0.903,14.284,36,23,15,8,13,6,7,43,0.0,0.04
1003,2027,26-09-2019 07:12:00,1,2866.0,2710.0,0.946,14.292,252,142,104,38,110,79,31,48,0.01,0.09
1003,2028,26-09-2019 07:14:00,1,2587.0,2405.0,0.93,12.855,320,193,162,31,127,104,23,194,0.0,0.0
1003,2029,26-09-2019 07:16:00,1,2671.0,2517.0,0.942,13.312,337,200,153,47,137,104,33,143,0.0,0.0
1003,2030,26-09-2019 07:18:00,1,2891.0,2654.0,0.918,14.329,173,118,93,25,55,43,12,45,0.0,0.0
1003,2031,26-09-2019 07:20:00,1,2461.0,2340.0,0.951,12.287,365,217,172,45,148,118,30,98,0.04,0.0
1003,2032,26-09-2019 07:22:00,1,2855.0,2757.0,0.966,14.299,206,105,68,37,101,77,24,31,0.01,0.0
1003,2033,26-09-2019 07:24:00,1,2472.0,2341.0,0.947,12.331,73,36,29,7,37,27,10,65,0.0,0.0
1003,2034,26-09-2019 07:26:00,1,2676.0,2512.0,0.939,13.324,0,0,0,0,0,0,0,39,0.0,0.0
1003,2035,26-09-2019 07:28:00,1,2783.0,2580.0,0.927,13.821,0,0,0,0,0,0,0,22,0.0,0.0
1003,2036,26-09-2019 07:30:00,1,2847.0,2804.0,0.985,14.322,0,0,0,0,0,0,0,6,0.0,0.0
1003,2037,26-09-2019 07:32:00,1,2849.0,2736.0,0.961,14.253,0,0,0,0,0,0,0,1,0.0,0.0
1003,2038,26-09-2019 07:34:00,1,2655.0,2625.0,0.989,13.365,0,0,0,0,0,0,0,1,0.0,0.0
1003,2039,26-09-2019 07:36:00,1,2687.0,2470.0,0.919,13.323,0,0,0,0,0,0,0,0,0.0,0.0
1003,2040,26-09-2019 07:38:00,1,2366.0,2272.0,0.96,11.838,0,0,0,0,0,0,0,2,0.0,0.0
1003,2041,26-09-2019 07:40:00,1,2151.0,2155.0,1.002,10.859,0,0,0,0,0,0,0,1,0.0,0.0
1003,2042,26-09-2019 07:42:00,1,2118.0,2050.5,0.968,10.614,0,0,0,0,0,0,0,0,0.0,0.0
1003,2043,26-09-2019 07:44:00,1,2085.0,1946.0,0.934,10.369,0,0,0,0,0,0,0,2,0.0,0.0
1003,2044,26-09-2019 07:46:00,1,2195.0,1988.0,0.905,10.851,0,0,0,0,0,0,0,7,0.0,0.0
1003,2045,26-09-2019 07:48:00,1,2187.0,1988.0,0.909,10.817,0,0,0,0,0,0,0,0,0.0,0.0
1003,2046,26-09-2019 07:50:00,1,2073.0,1959.0,0.945,10.337,0,0,0,0,0,0,0,0,0.0,0.0
1003,2047,26-09-2019 07:52:00,1,2077.0,1961.0,0.944,10.353,0,0,0,0,0,0,0,2,0.0,0.0
1003,2048,26-09-2019 07:54:00,1,2075.0,1987.0,0.958,10.374,0,0,0,0,0,0,0,0,0.0,0.0
1003,2049,26-09-2019 07:56:00,1,2066.0,1985.0,0.961,10.338,0,0,0,0,0,0,0,0,0.0,0.0
1003,2050,26-09-2019 07:58:00,1,2071.0,1981.0,0.957,10.351,0,0,0,0,0,0,0,0,0.0,0.0
1003,2051,26-09-2019 08:00:00,1,2191.0,1993.0,0.91,10.839,0,0,0,0,0,0,0,7,0.0,0.0
1003,2052,26-09-2019 08:02:00,1,2189.0,2006.0,0.916,10.847,0,0,0,0,0,0,0,4,0.0,0.0
1003,2053,26-09-2019 08:04:00,1,2194.0,2006.0,0.915,10.863,0,0,0,0,0,0,0,3,0.0,0.0
1003,2054,26-09-2019 08:06:00,1,2190.0,1996.0,0.911,10.84,0,0,0,0,0,0,0,0,0.0,0.0
1003,2055,26-09-2019 08:08:00,1,2198.0,1967.0,0.895,10.838,0,0,0,0,0,0,0,1,0.0,0.0
1003,2056,26-09-2019 08:10:00,1,2212.0,1934.0,0.874,10.858,0,0,0,0,0,0,0,2,0.0,0.0
1003,2057,26-09-2019 08:12:00,1,1981.0,1841.0,0.929,9.843,0,0,0,0,0,0,0,0,0.0,0.0
1003,2058,26-09-2019 08:14:00,1,1870.0,1815.0,0.971,9.377,0,0,0,0,0,0,0,0,0.0,0.0
1003,2059,26-09-2019 08:16:00,1,1872.0,1804.5,0.964,9.3725,0,0,0,0,0,0,0,5,0.0,0.0
1003,2060,26-09-2019 08:18:00,1,1874.0,1794.0,0.957,9.368,0,0,0,0,0,0,0,11,0.0,0.0
1003,2061,26-09-2019 08:20:00,1,1871.0,1779.0,0.951,9.343,0,0,0,0,0,0,0,2,0.0,0.0
1003,2062,26-09-2019 08:22:00,1,1889.0,1760.0,0.932,9.392,0,0,0,0,0,0,0,0,0.0,0.0
1003,2063,26-09-2019 08:24:00,1,1869.0,1838.0,0.983,9.399,0,0,0,0,0,0,0,4,0.0,0.0
1003,2064,26-09-2019 08:26:00,1,1977.0,1872.0,0.947,9.864,0,0,0,0,0,0,0,1,0.0,0.0
1003,2065,26-09-2019 08:28:00,1,1870.0,1817.0,0.971,9.381,0,0,0,0,0,0,0,2,0.02,0.0
1003,2066,26-09-2019 08:30:00,1,1994.0,1839.0,0.922,9.893,0,0,0,0,0,0,0,50,0.0,0.0
1003,2067,26-09-2019 08:32:00,1,2209.0,1935.0,0.876,10.848,42,31,22,9,11,2,9,63,0.0,0.0
1003,2068,26-09-2019 08:34:00,1,2390.0,2150.0,0.9,11.796,75,64,33,31,11,2,9,47,0.0,0.12
1003,2069,26-09-2019 08:36:00,1,2476.0,2325.0,0.939,12.331,104,86,49,37,18,4,14,49,0.0,0.0
1003,2070,26-09-2019 08:38:00,1,2696.0,2441.0,0.905,13.326,135,84,60,24,51,28,23,34,0.08,0.08
1003,2071,26-09-2019 08:40:00,1,2579.0,2410.0,0.935,12.829,521,296,227,69,225,169,56,32,0.0,0.0
1003,2072,26-09-2019 08:42:00,1,2398.0,2169.0,0.905,11.849,371,184,128,56,187,126,61,5,0.0,0.0
1003,2073,26-09-2019 08:44:00,1,2176.0,2024.0,0.93,10.815,128,73,57,16,55,39,16,62,0.0,0.0
1003,2074,26-09-2019 08:46:00,1,2384.0,2200.0,0.923,11.827,0,0,0,0,0,0,0,33,0.0,0.0
1003,2075,26-09-2019 08:48:00,1,2366.0,2283.0,0.965,11.849,0,0,0,0,0,0,0,42,0.0,0.0
1003,2076,26-09-2019 08:50:00,1,2630.5,2464.5,0.9395,13.092,0,0,0,0,0,0,0,36,0.0,0.0
1003,2077,26-09-2019 08:52:00,1,2895.0,2646.0,0.914,14.335,0,0,0,0,0,0,0,23,0.0,0.0
1003,2078,26-09-2019 08:54:00,1,2645.0,2613.0,0.988,13.314,0,0,0,0,0,0,0,0,0.0,0.0
1003,2079,26-09-2019 08:56:00,1,2566.0,2444.0,0.952,12.817,0,0,0,0,0,0,0,2,0.0,0.0
1003,2080,26-09-2019 08:58:00,1,2358.0,2325.0,0.986,11.863,0,0,0,0,0,0,0,4,0.0,0.0
1003,2081,26-09-2019 09:00:00,1,2361.0,2269.0,0.961,11.815,0,0,0,0,0,0,0,5,0.0,0.0
1003,2082,26-09-2019 09:02:00,1,2146.0,2163.0,1.008,10.851,0,0,0,0,0,0,0,4,0.0,0.0
1003,2083,26-09-2019 09:04:00,1,2172.0,2073.0,0.954,10.854,0,0,0,0,0,0,0,1,0.0,0.0
1003,2084,26-09-2019 09:06:00,1,2185.0,2016.0,0.923,10.842,0,0,0,0,0,0,0,0,0.0,0.0
1003,2085,26-09-2019 09:08:00,1,1969.0,1925.0,0.978,9.888,0,0,0,0,0,0,0,0,0.0,0.0
1003,2086,26-09-2019 09:10:00,1,1970.0,1894.0,0.961,9.859,0,0,0,0,0,0,0,1,0.0,0.0
1003,2087,26-09-2019 09:12:00,1,1853.0,1858.0,1.003,9.358,0,0,0,0,0,0,0,0,0.0,0.0
1003,2088,26-09-2019 09:14:00,1,1859.0,1850.0,0.995,9.372,0,0,0,0,0,0,0,4,0.0,0.0
1003,2089,26-09-2019 09:16:00,1,1986.0,1871.0,0.942,9.894,0,0,0,0,0,0,0,0,0.0,0.0
1003,2090,26-09-2019 09:18:00,1,1867.0,1840.0,0.985,9.392,0,0,0,0,0,0,0,0,0.0,0.0
1003,2091,26-09-2019 09:20:00,1,1863.0,1839.0,0.987,9.377,0,0,0,0,0,0,0,15,0.0,0.0
1003,2092,26-09-2019 09:22:00,1,2088.0,1926.0,0.923,10.358,0,0,0,0,0,0,0,3,0.0,0.0
1003,2093,26-09-2019 09:24:00,1,2035.5,1891.0,0.9295,10.113,0,0,0,0,0,0,0,7,0.0,0.0
1003,2094,26-09-2019 09:26:00,1,1983.0,1856.0,0.936,9.868,0,0,0,0,0,0,0,0,0.0,0.0
1003,2095,26-09-2019 09:28:00,1,2095.0,1917.0,0.915,10.378,0,0,0,0,0,0,0,0,0.0,0.0
1003,2096,26-09-2019 09:30:00,1,1972.0,1881.0,0.954,9.852,0,0,0,0,0,0,0,12,0.0,0.0
1003,2097,26-09-2019 09:32:00,1,1870.0,1830.0,0.979,9.393,4,4,3,1,0,0,0,28,0.0,0.0
1003,2098,26-09-2019 09:34:00,1,2185.0,2029.0,0.929,10.858,4,4,2,2,0,0,0,22,0.0,0.0
1003,2099,26-09-2019 09:36:00,1,2181.0,2043.0,0.937,10.854,0,0,0,0,0,0,0,27,0.0,0.0
1003,2100,26-09-2019 09:38:00,1,2174.0,2073.0,0.954,10.861,0,0,0,0,0,0,0,18,0.0,0.0
1003,2101,26-09-2019 09:40:00,1,2169.0,2070.0,0.954,10.836,0,0,0,0,0,0,0,2,0.0,0.0
1003,2102,26-09-2019 09:42:00,1,2208.0,1939.0,0.878,10.845,0,0,0,0,0,0,0,1,0.0,0.0
1003,2103,26-09-2019 09:44:00,1,1988.0,1851.0,0.931,9.882,0,0,0,0,0,0,0,14,0.0,0.0
1003,2104,26-09-2019 09:46:00,1,1867.0,1800.0,0.964,9.349,0,0,0,0,0,0,0,0,0.0,0.0
1003,2105,26-09-2019 09:48:00,1,1894.0,1726.0,0.911,9.375,0,0,0,0,0,0,0,5,0.0,0.0
1003,2106,26-09-2019 09:50:00,1,1887.0,1747.0,0.926,9.37,0,0,0,0,0,0,0,3,0.0,0.0
1003,2107,26-09-2019 09:52:00,1,1901.0,1712.0,0.901,9.387,0,0,0,0,0,0,0,1,0.0,0.0
1003,2108,26-09-2019 09:54:00,1,1903.0,1695.0,0.891,9.377,0,0,0,0,0,0,0,4,0.0,0.0
1003,2109,26-09-2019 09:56:00,1,1897.0,1703.0,0.897,9.36,0,0,0,0,0,0,0,3,0.0,0.0
1003,2110,26-09-2019 09:58:00,1,1851.0,1651.0,0.8915,9.1215,0,0,0,0,0,0,0,6,0.0,0.0
1003,2111,26-09-2019 10:00:00,1,1805.0,1599.0,0.886,8.883,0,0,0,0,0,0,0,15,0.0,0.0
1003,2112,26-09-2019 10:02:00,1,1900.0,1704.0,0.897,9.374,0,0,0,0,0,0,0,0,0.0,0.0
1003,2113,26-09-2019 10:04:00,1,1897.0,1705.0,0.899,9.361,2,2,1,1,0,0,0,31,0.0,0.0
1003,2114,26-09-2019 10:06:00,1,1887.0,1753.0,0.929,9.377,112,97,66,31,15,7,8,65,0.0,0.0
1003,2115,26-09-2019 10:08:00,1,2394.0,2137.0,0.893,11.797,121,92,54,38,29,11,18,56,0.0,0.0
1003,2116,26-09-2019 10:10:00,1,2613.0,2327.0,0.89,12.873,247,131,96,35,116,78,38,40,0.0,0.0
1003,2117,26-09-2019 10:12:00,1,2386.0,2185.0,0.916,11.82,369,232,192,40,137,95,42,101,0.0,0.0
1003,2118,26-09-2019 10:14:00,1,2405.0,2141.0,0.89,11.844,146,73,40,33,73,54,19,12,0.01,0.02
1003,2119,26-09-2019 10:16:00,1,2868.0,2680.0,0.934,14.266,416,178,129,49,238,178,60,0,0.02,0.0
1003,2120,26-09-2019 10:18:00,1,2595.0,2374.0,0.915,12.85,334,187,142,45,147,111,36,90,0.0,0.0
1003,2121,26-09-2019 10:20:00,1,2197.0,1995.0,0.908,10.863,364,206,156,50,158,111,47,120,0.0,0.0
1003,2122,26-09-2019 10:22:00,1,2176.0,2057.0,0.946,10.851,0,0,0,0,0,0,0,37,0.0,0.0
1003,2123,26-09-2019 10:24:00,1,2182.0,2019.0,0.925,10.831,0,0,0,0,0,0,0,20,0.0,0.0
1003,2124,26-09-2019 10:26:00,1,2289.0,2125.0,0.928,11.371,0,0,0,0,0,0,0,16,0.0,0.0
1003,2125,26-09-2019 10:28:00,1,2365.0,2259.0,0.955,11.819,0,0,0,0,0,0,0,34,0.0,0.0
1003,2126,26-09-2019 10:30:00,1,2378.0,2259.0,0.95,11.87,0,0,0,0,0,0,0,6,0.0,0.0
1003,2127,26-09-2019 10:32:00,1,2332.0,2190.5,0.939,11.6125,0,0,0,0,0,0,0,3,0.0,0.0
1003,2128,26-09-2019 10:34:00,1,2286.0,2122.0,0.928,11.355,0,0,0,0,0,0,0,0,0.0,0.0
1003,2129,26-09-2019 10:36:00,1,2181.0,2028.0,0.93,10.84,0,0,0,0,0,0,0,0,0.0,0.0
1003,2130,26-09-2019 10:38:00,1,2088.0,1908.0,0.914,10.341,0,0,0,0,0,0,0,0,0.0,0.0
1003,2131,26-09-2019 10:40:00,1,1983.0,1840.0,0.928,9.852,0,0,0,0,0,0,0,1,0.0,0.0
1003,2132,26-09-2019 10:42:00,1,1998.0,1819.0,0.91,9.886,0,0,0,0,0,0,0,0,0.0,0.0
1003,2133,26-09-2019 10:44:00,1,1885.0,1760.0,0.934,9.375,0,0,0,0,0,0,0,0,0.0,0.0
1003,2134,26-09-2019 10:46:00,1,1899.0,1702.0,0.896,9.366,0,0,0,0,0,0,0,2,0.0,0.0
1003,2135,26-09-2019 10:48:00,1,1906.0,1695.0,0.889,9.387,0,0,0,0,0,0,0,0,0.0,0.0
1003,2136,26-09-2019 10:50:00,1,1915.0,1647.0,0.86,9.369,0,0,0,0,0,0,0,1,0.0,0.0
1003,2137,26-09-2019 10:52:00,1,1910.0,1658.0,0.868,9.362,0,0,0,0,0,0,0,0,0.0,0.0
1003,2138,26-09-2019 10:54:00,1,1916.0,1629.0,0.85,9.35,0,0,0,0,0,0,0,0,0.0,0.0
1003,2139,26-09-2019 10:56:00,1,1925.0,1620.0,0.842,9.378,0,0,0,0,0,0,0,12,0.0,0.0
1003,2140,26-09-2019 10:58:00,1,2012.0,1741.0,0.865,9.856,0,0,0,0,0,0,0,0,0.0,0.0
1003,2141,26-09-2019 11:00:00,1,1892.0,1728.0,0.914,9.367,0,0,0,0,0,0,0,0,0.0,0.0
1003,2142,26-09-2019 11:02:00,1,1908.0,1667.0,0.874,9.362,0,0,0,0,0,0,0,0,0.0,0.0
1003,2143,26-09-2019 11:04:00,1,1911.0,1642.0,0.859,9.346,0,0,0,0,0,0,0,0,0.0,0.0
1003,2144,26-09-2019 11:06:00,1,1862.5,1601.0,0.8595,9.111,0,0,0,0,0,0,0,0,0.0,0.0
1003,2145,26-09-2019 11:08:00,1,1814.0,1560.0,0.86,8.876,0,0,0,0,0,0,0,0,0.0,0.0
1003,2146,26-09-2019 11:10:00,1,1937.0,1568.0,0.809,9.369,0,0,0,0,0,0,0,0,0.0,0.0
1003,2147,26-09-2019 11:12:00,1,1815.0,1533.0,0.844,8.848,0,0,0,0,0,0,0,0,0.0,0.0
1003,2148,26-09-2019 11:14:00,1,1823.0,1500.0,0.823,8.844,0,0,0,0,0,0,0,0,0.0,0.0
1003,2149,26-09-2019 11:16:00,1,1706.0,1502.0,0.88,8.386,0,0,0,0,0,0,0,0,0.0,0.0
1003,2150,26-09-2019 11:18:00,1,1715.0,1479.0,0.863,8.394,0,0,0,0,0,0,0,0,0.0,0.0
1003,2151,26-09-2019 11:20:00,1,1710.0,1468.0,0.858,8.364,0,0,0,0,0,0,0,0,0.0,0.0
1003,2152,26-09-2019 11:22:00,1,1710.0,1471.0,0.86,8.367,0,0,0,0,0,0,0,0,0.0,0.0
1003,2153,26-09-2019 11:24:00,1,1833.0,1476.0,0.805,8.856,0,0,0,0,0,0,0,0,0.0,0.0
1003,2154,26-09-2019 11:26:00,1,1718.0,1462.0,0.851,8.387,0,0,0,0,0,0,0,2,0.0,0.0
1003,2155,26-09-2019 11:28:00,1,1830.0,1505.0,0.822,8.878,0,0,0,0,0,0,0,13,0.0,0.0
1003,2156,26-09-2019 11:30:00,1,1938.0,1551.0,0.8,9.353,8,8,2,6,0,0,0,43,0.0,0.0
1003,2157,26-09-2019 11:32:00,1,2249.0,1800.0,0.8,10.855,97,51,33,18,46,28,18,76,0.0,0.0
1003,2158,26-09-2019 11:34:00,1,2414.0,2066.0,0.856,11.796,69,26,13,13,43,16,27,123,0.0,0.0
1003,2159,26-09-2019 11:36:00,1,2744.0,2237.0,0.815,13.288,103,11,5,6,92,53,39,95,0.0,0.0
1003,2160,26-09-2019 11:38:00,1,2931.0,2493.0,0.85,14.31,83,21,3,18,62,36,26,91,0.0,0.0
1003,2161,26-09-2019 11:40:00,1,2666.5,2312.0,0.8685,13.0665,23,12,2,10,11,7,4,80,0.0,0.33
1003,2162,26-09-2019 11:42:00,1,2402.0,2131.0,0.887,11.823,0,0,0,0,0,0,0,79,0.0,0.01
1003,2163,26-09-2019 11:44:00,1,2409.0,2097.0,0.87,11.814,0,0,0,0,0,0,0,76,0.0,0.0
1003,2164,26-09-2019 11:46:00,1,2505.0,2227.0,0.889,12.335,392,224,175,49,168,127,41,82,0.05,0.02
1003,2165,26-09-2019 11:48:00,1,2404.0,2168.0,0.902,11.871,553,306,241,65,247,180,67,75,0.04,0.05
1003,2166,26-09-2019 11:50:00,1,2699.0,2435.0,0.902,13.33,222,116,85,31,106,84,22,91,0.0,0.0
1003,2167,26-09-2019 11:52:00,1,2391.0,2174.0,0.91,11.826,466,256,192,64,210,152,58,17,0.01,0.0
1003,2168,26-09-2019 11:54:00,1,2592.0,2369.0,0.914,12.837,641,306,237,69,335,254,81,70,0.0,0.0
1003,2169,26-09-2019 11:56:00,1,2658.0,2563.0,0.964,13.309,430,291,225,66,139,100,39,45,0.06,0.0
1003,2170,26-09-2019 11:58:00,1,2672.0,2518.0,0.943,13.315,227,108,81,27,119,86,33,3,0.0,0.0
1003,2171,26-09-2019 12:00:00,1,2763.0,2579.0,0.933,13.743,534,292,223,69,242,185,57,7,0.01,0.0
1003,2172,26-09-2019 12:02:00,1,2863.0,2729.0,0.953,14.3,77,35,25,10,42,32,10,59,0.0,0.0
1003,2173,26-09-2019 12:04:00,1,2673.0,2517.0,0.942,13.317,0,0,0,0,0,0,0,47,0.0,0.0
1003,2174,26-09-2019 12:06:00,1,2683.0,2495.0,0.93,13.335,0,0,0,0,0,0,0,13,0.0,0.0
1003,2175,26-09-2019 12:08:00,1,2677.0,2473.0,0.924,13.285,0,0,0,0,0,0,0,0,0.0,0.0
1003,2176,26-09-2019 12:10:00,1,2337.0,2384.0,1.02,11.845,0,0,0,0,0,0,0,0,0.0,0.0
1003,2177,26-09-2019 12:12:00,1,2363.0,2307.0,0.976,11.863,0,0,0,0,0,0,0,0,0.0,0.0
1003,2178,26-09-2019 12:14:00,1,2252.0,2249.5,1.0,11.3625,0,0,0,0,0,0,0,5,0.0,0.0
1003,2179,26-09-2019 12:16:00,1,2141.0,2192.0,1.024,10.862,0,0,0,0,0,0,0,0,0.0,0.0
1003,2180,26-09-2019 12:18:00,1,2169.0,2087.0,0.962,10.858,0,0,0,0,0,0,0,0,0.0,0.0
1003,2181,26-09-2019 12:20:00,1,2141.0,2201.0,1.028,10.873,0,0,0,0,0,0,0,0,0.0,0.0
1003,2182,26-09-2019 12:22:00,1,2139.0,2191.0,1.024,10.855,0,0,0,0,0,0,0,0,0.0,0.0
1003,2183,26-09-2019 12:24:00,1,2137.0,2245.0,1.051,10.903,0,0,0,0,0,0,0,1,0.0,0.0
1003,2184,26-09-2019 12:26:00,1,2115.0,2268.0,1.072,10.845,0,0,0,0,0,0,0,4,0.0,0.0
1003,2185,26-09-2019 12:28:00,1,2118.0,2278.0,1.076,10.865,0,0,0,0,0,0,0,0,0.0,0.0
1003,2186,26-09-2019 12:30:00,1,2144.0,2191.0,1.022,10.873,0,0,0,0,0,0,0,0,0.0,0.0
1003,2187,26-09-2019 12:32:00,1,2152.0,2159.0,1.003,10.869,0,0,0,0,0,0,0,2,0.0,0.0
1003,2188,26-09-2019 12:34:00,1,2154.0,2145.0,0.996,10.86,0,0,0,0,0,0,0,0,0.0,0.0
1003,2189,26-09-2019 12:36:00,1,2164.0,2109.0,0.975,10.861,0,0,0,0,0,0,0,15,0.0,0.0
1003,2190,26-09-2019 12:38:00,1,2170.0,2105.0,0.97,10.881,0,0,0,0,0,0,0,1,0.0,0.0
1003,2191,26-09-2019 12:40:00,1,2164.0,2106.0,0.973,10.859,0,0,0,0,0,0,0,0,0.0,0.0
1003,2192,26-09-2019 12:42:00,1,1927.0,2056.0,1.067,9.87,0,0,0,0,0,0,0,2,0.0,0.0
1003,2193,26-09-2019 12:44:00,1,1823.0,1981.0,1.087,9.377,4,1,1,0,3,1,2,9,0.0,0.0
1003,2194,26-09-2019 12:46:00,1,1854.0,1899.0,1.024,9.406,0,0,0,0,0,0,0,2,0.0,0.0
1003,2195,26-09-2019 12:48:00,1,1849.5,1891.5,1.0225,9.3805,0,0,0,0,0,0,0,0,0.0,0.0
1003,2196,26-09-2019 12:50:00,1,1845.0,1884.0,1.021,9.355,41,20,14,6,21,16,5,14,0.0,0.0
1003,2197,26-09-2019 12:52:00,1,1841.0,1938.0,1.053,9.401,0,0,0,0,0,0,0,0,0.0,0.0
1003,2198,26-09-2019 12:54:00,1,1849.0,1881.0,1.017,9.369,0,0,0,0,0,0,0,0,0.0,0.0
1003,2199,26-09-2019 12:56:00,1,1844.0,1890.0,1.025,9.359,0,0,0,0,0,0,0,0,0.0,0.0
1003,2200,26-09-2019 12:58:00,1,1858.0,1878.0,1.011,9.399,0,0,0,0,0,0,0,0,0.0,0.0
1003,2201,26-09-2019 13:00:00,1,1854.0,1863.0,1.005,9.369,0,0,0,0,0,0,0,9,0.0,0.0
1003,2202,26-09-2019 13:02:00,1,1831.0,1961.0,1.071,9.383,0,0,0,0,0,0,0,0,0.0,0.0
1003,2203,26-09-2019 13:04:00,1,1834.0,1945.0,1.061,9.377,0,0,0,0,0,0,0,0,0.0,0.0
1003,2204,26-09-2019 13:06:00,1,1823.0,1988.0,1.09,9.384,0,0,0,0,0,0,0,0,0.0,0.0
1003,2205,26-09-2019 13:08:00,1,1832.0,1964.0,1.072,9.393,0,0,0,0,0,0,0,0,0.0,0.0
1003,2206,26-09-2019 13:10:00,1,1838.0,1938.0,1.054,9.388,0,0,0,0,0,0,0,0,0.0,0.0
1003,2207,26-09-2019 13:12:00,1,1840.0,1920.0,1.043,9.374,0,0,0,0,0,0,0,1,0.0,0.0
1003,2208,26-09-2019 13:14:00,1,1948.0,1963.0,1.008,9.847,0,0,0,0,0,0,0,4,0.0,0.0
1003,2209,26-09-2019 13:16:00,1,1842.0,1924.0,1.045,9.386,0,0,0,0,0,0,0,0,0.0,0.0
1003,2210,26-09-2019 13:18:00,1,1833.0,1934.0,1.055,9.361,0,0,0,0,0,0,0,3,0.0,0.0
1003,2211,26-09-2019 13:20:00,1,1842.0,1930.0,1.048,9.393,0,0,0,0,0,0,0,0,0.0,0.0
1003,2212,26-09-2019 13:22:00,1,1847.5,1907.5,1.0325,9.391,0,0,0,0,0,0,0,2,0.0,0.0
1003,2213,26-09-2019 13:24:00,1,1853.0,1885.0,1.017,9.389,3,0,0,0,3,1,2,5,0.0,0.0
1003,2214,26-09-2019 13:26:00,1,2075.0,1986.0,0.957,10.376,0,0,0,0,0,0,0,8,0.01,0.0
1003,2215,26-09-2019 13:28:00,1,2060.0,2041.0,0.991,10.376,0,0,0,0,0,0,0,2,0.0,0.0
1003,2216,26-09-2019 13:30:00,1,1849.0,1914.0,1.036,9.403,0,0,0,0,0,0,0,1,0.0,0.0
1003,2217,26-09-2019 13:32:00,1,1857.0,1871.0,1.008,9.386,0,0,0,0,0,0,0,0,0.0,0.0
1003,2218,26-09-2019 13:34:00,1,1861.0,1849.0,0.994,9.378,0,0,0,0,0,0,0,1,0.0,0.0
1003,2219,26-09-2019 13:36:00,1,1860.0,1857.0,0.998,9.384,0,0,0,0,0,0,0,1,0.0,0.0
1003,2220,26-09-2019 13:38:00,1,1862.0,1844.0,0.991,9.378,0,0,0,0,0,0,0,7,0.0,0.0
1003,2221,26-09-2019 13:40:00,1,1855.0,1860.0,1.003,9.367,0,0,0,0,0,0,0,2,0.0,0.0
1003,2222,26-09-2019 13:42:00,1,1766.0,1742.0,0.986,8.886,0,0,0,0,0,0,0,2,0.0,0.0
1003,2223,26-09-2019 13:44:00,1,1658.0,1685.0,1.016,8.398,86,46,35,11,40,33,7,18,0.0,0.0
1003,2224,26-09-2019 13:46:00,1,1850.0,1850.0,1.0,9.338,4,4,2,2,0,0,0,3,0.0,0.0
1003,2225,26-09-2019 13:48:00,1,1851.0,1895.0,1.024,9.389,7,7,1,6,0,0,0,5,0.0,0.0
1003,2226,26-09-2019 13:50:00,1,1959.0,1949.0,0.995,9.876,13,10,4,6,3,1,2,27,0.0,0.0
1003,2227,26-09-2019 13:52:00,1,2069.0,2000.0,0.966,10.367,0,0,0,0,0,0,0,9,0.0,0.0
1003,2228,26-09-2019 13:54:00,1,2166.0,2100.0,0.97,10.857,0,0,0,0,0,0,0,19,0.0,0.0
1003,2229,26-09-2019 13:56:00,1,2154.5,2153.0,1.0,10.87,0,0,0,0,0,0,0,16,0.0,0.0
1003,2230,26-09-2019 13:58:00,1,2143.0,2206.0,1.03,10.883,1,1,0,1,0,0,0,46,0.0,0.0
1003,2231,26-09-2019 14:00:00,1,2130.0,2201.0,1.033,10.829,0,0,0,0,0,0,0,23,0.0,0.0
1003,2232,26-09-2019 14:02:00,1,2370.0,2262.0,0.954,11.841,0,0,0,0,0,0,0,27,0.0,0.0
1003,2233,26-09-2019 14:04:00,1,2254.0,2241.0,0.994,11.363,0,0,0,0,0,0,0,26,0.0,0.0
1003,2234,26-09-2019 14:06:00,1,2254.0,2217.0,0.983,11.336,0,0,0,0,0,0,0,18,0.0,0.0
1003,2235,26-09-2019 14:08:00,1,2373.0,2249.0,0.948,11.838,0,0,0,0,0,0,0,15,0.0,0.0
1003,2236,26-09-2019 14:10:00,1,2148.0,2155.0,1.003,10.85,0,0,0,0,0,0,0,0,0.0,0.0
1003,2237,26-09-2019 14:12:00,1,2184.0,2023.0,0.926,10.843,0,0,0,0,0,0,0,0,0.0,0.0
1003,2238,26-09-2019 14:14:00,1,2187.0,2003.0,0.916,10.835,0,0,0,0,0,0,0,6,0.0,0.0
1003,2239,26-09-2019 14:16:00,1,2200.0,1989.0,0.904,10.87,0,0,0,0,0,0,0,0,0.0,0.0
1003,2240,26-09-2019 14:18:00,1,2191.0,2000.0,0.913,10.847,0,0,0,0,0,0,0,1,0.0,0.0
1003,2241,26-09-2019 14:20:00,1,2195.0,1953.0,0.89,10.81,0,0,0,0,0,0,0,0,0.0,0.0
1003,2242,26-09-2019 14:22:00,1,2088.0,1932.0,0.925,10.366,0,0,0,0,0,0,0,1,0.0,0.0
1003,2243,26-09-2019 14:24:00,1,1975.0,1870.0,0.947,9.853,0,0,0,0,0,0,0,0,0.0,0.0
1003,2244,26-09-2019 14:26:00,1,1867.0,1819.0,0.974,9.37,0,0,0,0,0,0,0,0,0.0,0.0
1003,2245,26-09-2019 14:28:00,1,1867.0,1818.0,0.974,9.369,0,0,0,0,0,0,0,0,0.0,0.0
1003,2246,26-09-2019 14:30:00,1,1921.0,1843.5,0.96,9.611,1,1,1,0,0,0,0,8,0.0,0.0
1003,2247,26-09-2019 14:32:00,1,1975.0,1869.0,0.946,9.853,0,0,0,0,0,0,0,0,0.0,0.0
1003,2248,26-09-2019 14:34:00,1,1864.0,1829.0,0.981,9.37,0,0,0,0,0,0,0,0,0.0,0.0
1003,2249,26-09-2019 14:36:00,1,1857.0,1846.0,0.994,9.36,0,0,0,0,0,0,0,6,0.0,0.0
1003,2250,26-09-2019 14:38:00,1,1966.0,1894.0,0.963,9.843,0,0,0,0,0,0,0,1,0.0,0.0
1003,2251,26-09-2019 14:40:00,1,1874.0,1786.0,0.953,9.362,0,0,0,0,0,0,0,4,0.0,0.0
1003,2252,26-09-2019 14:42:00,1,1893.0,1727.0,0.912,9.37,0,0,0,0,0,0,0,3,0.0,0.0
1003,2253,26-09-2019 14:44:00,1,1906.0,1677.0,0.88,9.366,0,0,0,0,0,0,0,0,0.0,0.0
1003,2254,26-09-2019 14:46:00,1,1905.0,1686.0,0.885,9.371,0,0,0,0,0,0,0,0,0.0,0.0
1003,2255,26-09-2019 14:48:00,1,1902.0,1680.0,0.883,9.353,73,43,31,12,30,22,8,29,0.0,0.0
1003,2256,26-09-2019 14:50:00,1,1997.0,1808.0,0.906,9.869,0,0,0,0,0,0,0,1,0.0,0.0
1003,2257,26-09-2019 14:52:00,1,1883.0,1775.0,0.943,9.384,0,0,0,0,0,0,0,1,0.0,0.0
1003,2258,26-09-2019 14:54:00,1,1898.0,1683.0,0.887,9.341,0,0,0,0,0,0,0,6,0.0,0.0
1003,2259,26-09-2019 14:56:00,1,1674.0,1610.0,0.962,8.377,0,0,0,0,0,0,0,3,0.0,0.0
1003,2260,26-09-2019 14:58:00,1,1676.0,1605.0,0.957,8.38,0,0,0,0,0,0,0,0,0.0,0.0
1003,2261,26-09-2019 15:00:00,1,1688.0,1571.0,0.93,8.391,0,0,0,0,0,0,0,4,0.0,0.0
1003,2262,26-09-2019 15:02:00,1,1694.0,1560.0,0.921,8.401,0,0,0,0,0,0,0,8,0.0,0.0
1003,2263,26-09-2019 15:04:00,1,1686.0,1586.0,0.941,8.3975,0,0,0,0,0,0,0,7,0.0,0.0
1003,2264,26-09-2019 15:06:00,1,1678.0,1612.0,0.961,8.394,0,0,0,0,0,0,0,2,0.0,0.0
1003,2265,26-09-2019 15:08:00,1,1794.0,1640.0,0.914,8.883,0,0,0,0,0,0,0,3,0.0,0.0
1003,2266,26-09-2019 15:10:00,1,1679.0,1608.0,0.958,8.394,0,0,0,0,0,0,0,0,0.0,0.0
1003,2267,26-09-2019 15:12:00,1,1899.0,1711.0,0.901,9.376,0,0,0,0,0,0,0,0,0.0,0.0
1003,2268,26-09-2019 15:14:00,1,1886.0,1767.0,0.937,9.385,0,0,0,0,0,0,0,3,0.0,0.0
1003,2269,26-09-2019 15:16:00,1,1905.0,1670.0,0.876,9.356,0,0,0,0,0,0,0,0,0.0,0.0
1003,2270,26-09-2019 15:18:00,1,1694.0,1541.0,0.909,8.381,0,0,0,0,0,0,0,0,0.0,0.0
1003,2271,26-09-2019 15:20:00,1,1713.0,1483.0,0.866,8.391,1,0,0,0,1,0,1,30,0.0,0.0
1003,2272,26-09-2019 15:22:00,1,1909.0,1671.0,0.875,9.369,0,0,0,0,0,0,0,44,0.01,0.0
1003,2273,26-09-2019 15:24:00,1,2004.0,1782.0,0.889,9.866,0,0,0,0,0,0,0,35,0.0,0.0
1003,2274,26-09-2019 15:26:00,1,2228.0,1873.0,0.841,10.851,1,0,0,0,1,1,0,43,0.0,0.0
1003,2275,26-09-2019 15:28:00,1,2186.0,2028.0,0.928,10.857,34,21,12,9,13,6,7,50,0.0,0.0
1003,2276,26-09-2019 15:30:00,1,2381.0,2230.0,0.937,11.849,162,101,74,27,61,46,15,55,0.0,0.0
1003,2277,26-09-2019 15:32:00,1,2286.0,2107.0,0.921,11.341,140,69,39,30,71,42,29,33,0.0,0.06
1003,2278,26-09-2019 15:34:00,1,2710.0,2381.0,0.878,13.314,119,19,6,13,100,49,51,28,0.0,0.0
1003,2279,26-09-2019 15:36:00,1,2864.0,2689.0,0.939,14.259,181,20,3,17,161,111,50,20,0.0,0.0
1003,2280,26-09-2019 15:38:00,1,2893.0,2610.5,0.903,14.287,149,40,19,21,109,70,39,37,0.0,0.01
1003,2281,26-09-2019 15:40:00,1,2922.0,2532.0,0.867,14.315,154,105,68,37,49,26,23,57,0.0,0.0
1003,2282,26-09-2019 15:42:00,1,2692.0,2457.0,0.913,13.325,195,117,80,37,78,46,32,38,0.11,0.03
1003,2283,26-09-2019 15:44:00,1,2690.0,2460.0,0.914,13.323,92,43,29,14,49,38,11,44,0.0,0.0
1003,2284,26-09-2019 15:46:00,1,1990.0,1838.0,0.924,9.875,0,0,0,0,0,0,0,18,0.0,0.0
1003,2285,26-09-2019 15:48:00,1,1878.0,1776.0,0.946,9.365,0,0,0,0,0,0,0,2,0.0,0.0
1003,2286,26-09-2019 15:50:00,1,1995.0,1799.0,0.902,9.85,0,0,0,0,0,0,0,3,0.0,0.0
1003,2287,26-09-2019 15:52:00,1,2210.0,1906.0,0.862,10.818,0,0,0,0,0,0,0,1,0.0,0.0
1003,2288,26-09-2019 15:54:00,1,2198.0,1991.0,0.906,10.862,0,0,0,0,0,0,0,0,0.0,0.0
1003,2289,26-09-2019 15:56:00,1,2182.0,2050.0,0.94,10.869,0,0,0,0,0,0,0,2,0.0,0.0
1003,2290,26-09-2019 15:58:00,1,2379.0,2203.0,0.926,11.814,0,0,0,0,0,0,0,2,0.0,0.0
1003,2291,26-09-2019 16:00:00,1,2357.0,2316.0,0.982,11.851,0,0,0,0,0,0,0,0,0.0,0.0
1003,2292,26-09-2019 16:02:00,1,2369.0,2291.0,0.967,11.872,0,0,0,0,0,0,0,1,0.0,0.0
1003,2293,26-09-2019 16:04:00,1,2367.0,2299.0,0.971,11.873,0,0,0,0,0,0,0,3,0.0,0.0
1003,2294,26-09-2019 16:06:00,1,2362.0,2291.0,0.97,11.841,0,0,0,0,0,0,0,0,0.0,0.0
1003,2295,26-09-2019 16:08:00,1,2135.0,2204.0,1.032,10.853,0,0,0,0,0,0,0,0,0.01,0.0
1003,2296,26-09-2019 16:10:00,1,2154.0,2119.0,0.984,10.834,1,1,1,0,0,0,0,6,0.0,0.0
1003,2297,26-09-2019 16:12:00,1,2166.5,2098.0,0.9685,10.8595,0,0,0,0,0,0,0,1,0.0,0.0
1003,2298,26-09-2019 16:14:00,1,2179.0,2077.0,0.953,10.885,0,0,0,0,0,0,0,1,0.0,0.0
1003,2299,26-09-2019 16:16:00,1,2185.0,2026.0,0.928,10.851,0,0,0,0,0,0,0,0,0.0,0.01
1003,2300,26-09-2019 16:18:00,1,2185.0,2030.0,0.929,10.856,0,0,0,0,0,0,0,3,0.0,0.0
1003,2301,26-09-2019 16:20:00,1,2072.0,1993.0,0.962,10.371,0,0,0,0,0,0,0,2,0.0,0.0
1003,2302,26-09-2019 16:22:00,1,2076.0,1970.0,0.949,10.359,0,0,0,0,0,0,0,3,0.0,0.01
1003,2303,26-09-2019 16:24:00,1,1959.0,1937.0,0.989,9.862,0,0,0,0,0,0,0,0,0.0,0.0
1003,2304,26-09-2019 16:26:00,1,1975.0,1922.0,0.974,9.908,0,0,0,0,0,0,0,0,0.0,0.0
1003,2305,26-09-2019 16:28:00,1,1964.0,1918.0,0.977,9.861,0,0,0,0,0,0,0,3,0.0,0.0
1003,2306,26-09-2019 16:30:00,1,1968.0,1912.0,0.972,9.871,0,0,0,0,0,0,0,9,0.0,0.0
1003,2307,26-09-2019 16:32:00,1,1980.0,1876.0,0.947,9.879,0,0,0,0,0,0,0,5,0.0,0.0
1003,2308,26-09-2019 16:34:00,1,1867.0,1838.0,0.985,9.389,0,0,0,0,0,0,0,0,0.0,0.0
1003,2309,26-09-2019 16:36:00,1,1881.0,1766.0,0.939,9.364,0,0,0,0,0,0,0,0,0.0,0.0
1003,2310,26-09-2019 16:38:00,1,1891.0,1767.0,0.934,9.405,0,0,0,0,0,0,0,0,0.0,0.0
1003,2311,26-09-2019 16:40:00,1,2091.0,1916.0,0.917,10.359,12,11,3,8,1,1,0,23,0.0,0.0
1003,2312,26-09-2019 16:42:00,1,2085.0,1892.0,0.908,10.308,7,7,2,5,0,0,0,20,0.0,0.0
1003,2313,26-09-2019 16:44:00,1,2195.0,1984.0,0.904,10.846,3,3,2,1,0,0,0,23,0.0,0.0
1003,2314,26-09-2019 16:46:00,1,2079.5,1951.5,0.9405,10.3535,12,10,1,9,2,0,2,5,0.0,0.0
1003,2315,26-09-2019 16:48:00,1,1964.0,1919.0,0.977,9.861,0,0,0,0,0,0,0,0,0.0,0.0
1003,2316,26-09-2019 16:50:00,1,1868.0,1824.0,0.976,9.378,0,0,0,0,0,0,0,0,0.0,0.0
1003,2317,26-09-2019 16:52:00,1,1874.0,1789.0,0.955,9.365,0,0,0,0,0,0,0,0,0.0,0.0
1003,2318,26-09-2019 16:54:00,1,1876.0,1764.0,0.94,9.346,0,0,0,0,0,0,0,0,0.0,0.0
1003,2319,26-09-2019 16:56:00,1,1877.0,1781.0,0.949,9.365,0,0,0,0,0,0,0,0,0.0,0.0
1003,2320,26-09-2019 16:58:00,1,1889.0,1767.0,0.936,9.397,0,0,0,0,0,0,0,5,0.0,0.0
1003,2321,26-09-2019 17:00:00,1,2001.0,1779.0,0.889,9.852,125,83,50,33,42,19,23,52,0.0,0.0
1003,2322,26-09-2019 17:02:00,1,2296.0,2064.0,0.899,11.333,92,45,17,28,47,22,25,24,0.0,0.0
1003,2323,26-09-2019 17:04:00,1,2490.0,2266.0,0.91,12.321,44,13,3,10,31,14,17,11,0.0,0.03
1003,2324,26-09-2019 17:06:00,1,2694.0,2462.0,0.914,13.339,202,113,85,28,89,59,30,47,0.0,0.04
1003,2325,26-09-2019 17:08:00,1,2187.0,2035.0,0.93,10.87,398,259,213,46,139,110,29,139,0.02,0.0
1003,2326,26-09-2019 17:10:00,1,2160.0,2104.0,0.974,10.841,0,0,0,0,0,0,0,3,0.0,0.01
1003,2327,26-09-2019 17:12:00,1,2103.0,1888.0,0.898,10.375,0,0,0,0,0,0,0,5,0.0,0.01
1003,2328,26-09-2019 17:14:00,1,2103.0,1877.0,0.892,10.364,0,0,0,0,0,0,0,7,0.0,0.0
1003,2329,26-09-2019 17:16:00,1,2198.0,1960.0,0.891,10.832,0,0,0,0,0,0,0,31,0.0,0.0
1003,2330,26-09-2019 17:18:00,1,2169.0,2097.0,0.967,10.868,0,0,0,0,0,0,0,19,0.0,0.0
1003,2331,26-09-2019 17:20:00,1,2262.0,2178.0,0.963,11.3235,0,0,0,0,0,0,0,1,0.0,0.0
1003,2332,26-09-2019 17:22:00,1,2355.0,2259.0,0.959,11.779,0,0,0,0,0,0,0,2,0.0,0.0
1003,2333,26-09-2019 17:24:00,1,2384.0,2195.0,0.92,11.825,0,0,0,0,0,0,0,17,0.0,0.0
1003,2334,26-09-2019 17:26:00,1,2157.0,2134.0,0.989,10.861,0,0,0,0,0,0,0,0,0.0,0.0
1003,2335,26-09-2019 17:28:00,1,2170.0,2060.0,0.949,10.829,0,0,0,0,0,0,0,2,0.0,0.0
1003,2336,26-09-2019 17:30:00,1,2181.0,2026.0,0.929,10.835,0,0,0,0,0,0,0,0,0.0,0.0
1003,2337,26-09-2019 17:32:00,1,2166.0,2127.0,0.982,10.89,0,0,0,0,0,0,0,0,0.0,0.0
1003,2338,26-09-2019 17:34:00,1,2165.0,2120.0,0.979,10.876,0,0,0,0,0,0,0,0,0.0,0.0
1003,2339,26-09-2019 17:36:00,1,2164.0,2099.0,0.97,10.848,0,0,0,0,0,0,0,2,0.0,0.0
1003,2340,26-09-2019 17:38:00,1,2154.0,2126.0,0.987,10.842,0,0,0,0,0,0,0,10,0.0,0.0
1003,2341,26-09-2019 17:40:00,1,2174.0,2073.0,0.954,10.859,9,9,2,7,0,0,0,32,0.0,0.0
1003,2342,26-09-2019 17:42:00,1,2276.0,2148.0,0.944,11.344,0,0,0,0,0,0,0,25,0.0,0.0
1003,2343,26-09-2019 17:44:00,1,2389.0,2169.0,0.908,11.814,0,0,0,0,0,0,0,29,0.0,0.0
1003,2344,26-09-2019 17:46:00,1,2367.0,2298.0,0.971,11.869,2,2,1,1,0,0,0,33,0.0,0.0
1003,2345,26-09-2019 17:48:00,1,2458.0,2382.0,0.969,12.32,3,3,0,3,0,0,0,35,0.0,0.0
1003,2346,26-09-2019 17:50:00,1,2350.0,2341.0,0.996,11.85,3,3,2,1,0,0,0,55,0.0,0.0
1003,2347,26-09-2019 17:52:00,1,2374.0,2260.0,0.952,11.857,0,0,0,0,0,0,0,10,0.0,0.0
1003,2348,26-09-2019 17:54:00,1,2283.5,2125.5,0.93,11.351,0,0,0,0,0,0,0,0,0.0,0.0
1003,2349,26-09-2019 17:56:00,1,2193.0,1991.0,0.908,10.845,0,0,0,0,0,0,0,7,0.0,0.0
1003,2350,26-09-2019 17:58:00,1,2194.0,1990.0,0.907,10.848,0,0,0,0,0,0,0,1,0.0,0.0
1003,2351,26-09-2019 18:00:00,0,2207.0,1924.0,0.872,10.824,34,25,19,6,9,7,2,41,0.0,0.0
1003,2352,26-09-2019 18:02:00,0,2480.0,2289.0,0.923,12.306,523,325,282,43,198,157,41,88,0.0,0.0
1003,2353,26-09-2019 18:04:00,0,2928.0,2486.0,0.849,14.29,371,242,200,42,129,95,34,99,0.0,0.0
1003,2354,26-09-2019 18:06:00,0,2818.0,2442.0,0.867,13.806,358,197,152,45,161,108,53,63,0.0,0.0
1003,2355,26-09-2019 18:08:00,0,2823.0,2417.0,0.856,13.797,142,54,26,28,88,48,40,49,0.0,0.0
1003,2356,26-09-2019 18:10:00,0,2929.0,2467.0,0.842,14.27,338,179,130,49,159,117,42,58,0.0,0.0
1003,2357,26-09-2019 18:12:00,0,2914.0,2565.0,0.88,14.321,112,39,17,22,73,43,30,22,0.0,0.0
1003,2358,26-09-2019 18:14:00,0,2922.0,2509.0,0.859,14.29,152,71,37,34,81,53,28,0,0.0,0.0
1003,2359,26-09-2019 18:16:00,0,3010.0,2611.0,0.867,14.75,428,216,166,50,212,167,45,65,0.0,0.0
1003,2360,26-09-2019 18:18:00,0,3004.0,2639.0,0.879,14.758,51,27,20,7,24,13,11,57,0.0,0.0
1003,2361,26-09-2019 18:20:00,0,3010.0,2638.0,0.876,14.779,11,0,0,0,11,1,10,55,0.0,0.0
1003,2362,26-09-2019 18:22:00,0,2919.0,2529.0,0.866,14.301,40,15,8,7,25,4,21,49,0.0,0.0
1003,2363,26-09-2019 18:24:00,0,2719.0,2310.0,0.85,13.27,450,276,224,52,174,132,42,51,0.0,0.0
1003,2364,26-09-2019 18:26:00,0,2921.0,2536.0,0.868,14.316,234,149,108,41,85,64,21,49,0.0,0.0
1003,2365,26-09-2019 18:28:00,0,2927.0,2511.0,0.858,14.312,152,66,33,33,86,54,32,9,0.0,0.0
1003,2366,26-09-2019 18:30:00,0,2933.0,2486.0,0.848,14.308,157,93,54,39,64,23,41,39,0.0,0.0
1003,2367,26-09-2019 18:32:00,0,3147.0,2527.0,0.803,15.198,147,89,67,22,58,37,21,61,0.0,0.0
1003,2368,26-09-2019 18:34:00,0,2934.0,2450.0,0.835,14.273,170,118,75,43,52,31,21,33,0.0,0.0
1003,2369,26-09-2019 18:36:00,0,2985.0,2324.0,0.779,14.335,87,63,36,27,24,11,13,30,0.0,0.0
1003,2370,26-09-2019 18:38:00,0,2969.0,2326.0,0.783,14.275,87,54,27,27,33,10,23,19,0.0,0.0
1003,2371,26-09-2019 18:40:00,0,2961.0,2334.0,0.788,14.252,234,127,87,40,107,80,27,21,0.0,0.0
1003,2372,26-09-2019 18:42:00,0,2952.0,2373.0,0.804,14.258,146,76,43,33,70,49,21,36,0.01,0.0
1003,2373,26-09-2019 18:44:00,0,3474.0,2793.0,0.804,16.778,324,196,153,43,128,94,34,72,0.05,0.0
1003,2374,26-09-2019 18:46:00,0,2856.0,2293.0,0.803,13.79,250,128,94,34,122,83,39,64,0.0,0.0
1003,2375,26-09-2019 18:48:00,0,2254.0,1771.0,0.786,10.84,85,44,25,19,41,23,18,13,0.0,0.0
1003,2376,26-09-2019 18:50:00,0,1922.0,1613.0,0.839,9.359,22,17,2,15,5,0,5,13,0.0,0.0
1003,2377,26-09-2019 18:52:00,0,1926.0,1605.0,0.833,9.366,7,6,4,2,1,0,1,6,0.0,0.0
1003,2378,26-09-2019 18:54:00,0,1945.0,1546.0,0.795,9.376,7,3,1,2,4,3,1,10,0.0,0.0
1003,2379,26-09-2019 18:56:00,0,1955.0,1486.0,0.76,9.347,21,12,8,4,9,6,3,11,0.0,0.0
1003,2380,26-09-2019 18:58:00,0,1962.0,1481.0,0.755,9.371,0,0,0,0,0,0,0,7,0.0,0.0
1003,2381,26-09-2019 19:00:00,0,1961.0,1468.0,0.748,9.352,0,0,0,0,0,0,0,16,0.0,0.0
1003,2382,26-09-2019 19:02:00,0,1950.5,1509.5,0.774,9.3565,0,0,0,0,0,0,0,24,0.0,0.0
1003,2383,26-09-2019 19:04:00,0,1940.0,1551.0,0.8,9.361,235,141,119,22,94,68,26,42,0.0,0.0
1003,2384,26-09-2019 19:06:00,0,2550.0,2048.0,0.803,12.314,314,174,126,48,140,98,42,34,0.0,0.0
1003,2385,26-09-2019 19:08:00,0,2944.0,2397.0,0.814,14.255,191,71,45,26,120,72,48,25,0.0,0.0
1003,2386,26-09-2019 19:10:00,0,2772.0,2154.0,0.777,13.305,70,17,6,11,53,13,40,25,0.0,0.0
1003,2387,26-09-2019 19:12:00,0,2981.0,2291.0,0.769,14.283,30,10,2,8,20,4,16,29,0.0,0.0
1003,2388,26-09-2019 19:14:00,0,3080.0,2404.0,0.781,14.796,273,147,120,27,126,88,38,31,0.0,0.0
1003,2389,26-09-2019 19:16:00,0,3193.0,2445.0,0.766,15.29,24,7,3,4,17,6,11,0,0.0,0.0
1003,2390,26-09-2019 19:18:00,0,2969.0,2350.0,0.792,14.299,6,0,0,0,6,3,3,0,0.0,0.0
1003,2391,26-09-2019 19:20:00,0,2762.0,2167.0,0.785,13.279,20,10,0,10,10,1,9,0,0.0,0.0
1003,2392,26-09-2019 19:22:00,0,2671.0,2047.0,0.767,12.789,13,3,1,2,10,0,10,0,0.0,0.0
1003,2393,26-09-2019 19:24:00,0,2472.0,1929.0,0.78,11.877,123,81,60,21,42,27,15,0,0.0,0.0
1003,2394,26-09-2019 19:26:00,0,2472.0,1884.0,0.762,11.828,18,3,0,3,15,0,15,0,0.0,0.0
1003,2395,26-09-2019 19:28:00,0,2238.0,1796.0,0.802,10.807,8,8,0,8,0,0,0,0,0.0,0.0
1003,2396,26-09-2019 19:30:00,0,2262.0,1715.0,0.758,10.81,0,0,0,0,0,0,0,3,0.0,0.0
1003,2397,26-09-2019 19:32:00,0,2270.0,1717.0,0.756,10.843,22,10,4,6,12,2,10,8,0.0,0.0
1003,2398,26-09-2019 19:34:00,0,2270.0,1717.0,0.756,10.843,279,161,121,40,118,78,40,20,0.0,0.0
1003,2399,26-09-2019 19:36:00,0,2624.0,2008.5,0.764,12.5615,595,337,277,60,258,201,57,70,0.0,0.0
1003,2400,26-09-2019 19:38:00,0,2978.0,2300.0,0.772,14.28,325,202,154,48,123,93,30,60,0.0,0.0
1003,2401,26-09-2019 19:40:00,0,3198.0,2422.0,0.758,15.281,350,170,121,49,180,123,57,4,0.0,0.0
1003,2402,26-09-2019 19:42:00,0,3202.0,2398.0,0.749,15.271,302,152,114,38,150,107,43,28,0.0,0.0
1003,2403,26-09-2019 19:44:00,0,2977.0,2320.0,0.779,14.3,240,99,62,37,141,97,44,4,0.0,0.0
1003,2404,26-09-2019 19:46:00,0,2887.0,2182.0,0.756,13.792,150,82,41,41,68,34,34,0,0.0,0.0
1003,2405,26-09-2019 19:48:00,0,2976.0,2334.0,0.784,14.308,203,88,55,33,115,73,42,4,0.0,0.0
1003,2406,26-09-2019 19:50:00,0,3163.0,2524.0,0.798,15.259,249,144,105,39,105,75,30,38,0.0,0.0
1003,2407,26-09-2019 19:52:00,0,3180.0,2460.0,0.774,15.253,230,125,75,50,105,62,43,27,0.0,0.0
1003,2408,26-09-2019 19:54:00,0,3085.0,2405.0,0.78,14.817,333,174,123,51,159,120,39,82,0.0,0.0
1003,2409,26-09-2019 19:56:00,0,3173.0,2514.0,0.793,15.284,248,132,93,39,116,79,37,8,0.0,0.0
1003,2410,26-09-2019 19:58:00,0,2945.0,2437.0,0.827,14.302,220,120,80,40,100,73,27,10,0.0,0.0
1003,2411,26-09-2019 20:00:00,0,2749.0,2190.0,0.797,13.256,248,134,90,44,114,74,40,2,0.0,0.0
1003,2412,26-09-2019 20:02:00,0,3179.0,2450.0,0.771,15.239,257,136,101,35,121,79,42,43,0.0,0.0
1003,2413,26-09-2019 20:04:00,0,3161.0,2541.0,0.804,15.267,260,146,102,44,114,77,37,33,0.0,0.0
1003,2414,26-09-2019 20:06:00,0,2761.0,2195.0,0.795,13.31,295,167,129,38,128,85,43,82,0.0,0.0
1003,2415,26-09-2019 20:08:00,0,2742.0,2244.0,0.819,13.289,356,237,175,62,119,83,36,75,0.0,0.0
1003,2416,26-09-2019 20:10:00,0,2943.5,2425.5,0.824,14.283,550,401,331,70,149,118,31,18,0.0,0.0
1003,2417,26-09-2019 20:12:00,0,3145.0,2607.0,0.829,15.277,533,405,325,80,128,101,27,37,0.0,0.0
1003,2418,26-09-2019 20:14:00,0,3138.0,2617.0,0.834,15.261,419,313,246,67,106,80,26,18,0.0,0.0
1003,2419,26-09-2019 20:16:00,0,3153.0,2543.0,0.806,15.239,328,286,209,77,42,26,16,19,0.0,0.0
1003,2420,26-09-2019 20:18:00,0,3183.0,2494.0,0.783,15.301,171,84,51,33,87,56,31,7,0.0,0.0
1003,2421,26-09-2019 20:20:00,0,3366.0,2676.0,0.795,16.226,127,73,47,26,54,27,27,2,0.0,0.0
1003,2422,26-09-2019 20:22:00,0,3189.0,2500.0,0.784,15.333,182,110,76,34,72,47,25,4,0.0,0.0
1003,2423,26-09-2019 20:24:00,0,2941.0,2384.0,0.81,14.227,202,111,68,43,91,56,35,3,0.0,0.0
1003,2424,26-09-2019 20:26:00,0,2977.0,2293.0,0.77,14.269,112,73,35,38,39,18,21,0,0.0,0.0
1003,2425,26-09-2019 20:28:00,0,2962.0,2377.0,0.803,14.301,263,170,124,46,93,71,22,70,0.0,0.0
1003,2426,26-09-2019 20:30:00,0,2972.0,2340.0,0.787,14.301,113,89,65,24,24,14,10,25,0.0,0.0
1003,2427,26-09-2019 20:32:00,0,2873.0,2252.0,0.784,13.812,114,63,34,29,51,25,26,1,0.0,0.0
1003,2428,26-09-2019 20:34:00,0,2859.0,2259.0,0.79,13.764,119,58,27,31,61,30,31,3,0.0,0.0
1003,2429,26-09-2019 20:36:00,0,2950.0,2349.0,0.796,14.224,262,131,89,42,131,93,38,5,0.0,0.0
1003,2430,26-09-2019 20:38:00,0,2961.0,2373.0,0.801,14.292,359,211,161,50,148,106,42,48,0.0,0.0
1003,2431,26-09-2019 20:40:00,0,2741.0,2268.0,0.827,13.308,128,62,24,38,66,22,44,47,0.0,0.0
1003,2432,26-09-2019 20:42:00,0,2235.0,1814.0,0.812,10.816,128,36,11,25,92,45,47,42,0.0,0.0
1003,2433,26-09-2019 20:44:00,0,2249.0,1777.5,0.791,10.83,169,58,30,28,111,66,45,39,0.0,0.0
1003,2434,26-09-2019 20:46:00,0,2263.0,1741.0,0.77,10.844,22,2,0,2,20,0,20,46,0.0,0.0
1003,2435,26-09-2019 20:48:00,0,2248.0,1805.0,0.803,10.856,22,7,2,5,15,3,12,38,0.0,0.0
1003,2436,26-09-2019 20:50:00,0,2247.0,1793.0,0.798,10.839,35,17,6,11,18,7,11,9,0.0,0.0
1003,2437,26-09-2019 20:52:00,0,2241.0,1791.0,0.799,10.811,18,14,4,10,4,2,2,0,0.0,0.0
1003,2438,26-09-2019 20:54:00,0,2246.0,1786.0,0.795,10.827,4,4,0,4,0,0,0,0,0.0,0.0
1003,2439,26-09-2019 20:56:00,0,2253.0,1730.0,0.768,10.793,12,7,4,3,5,3,2,0,0.0,0.0
1003,2440,26-09-2019 20:58:00,0,2037.0,1650.0,0.81,9.853,0,0,0,0,0,0,0,0,0.0,0.0
1003,2441,26-09-2019 21:00:00,0,1933.0,1556.0,0.805,9.339,1,1,1,0,0,0,0,0,0.0,0.0
1003,2442,26-09-2019 21:02:00,0,1839.0,1495.0,0.813,8.901,28,13,6,7,15,7,8,0,0.0,0.0
1003,2443,26-09-2019 21:04:00,0,2047.0,1614.0,0.789,9.851,384,253,202,51,131,104,27,19,0.0,0.0
1003,2444,26-09-2019 21:06:00,0,2758.0,2177.0,0.79,13.276,232,136,91,45,96,65,31,14,0.0,0.0
1003,2445,26-09-2019 21:08:00,0,2880.0,2209.0,0.767,13.793,311,158,117,41,153,116,37,71,0.0,0.0
1003,2446,26-09-2019 21:10:00,0,2884.0,2180.0,0.756,13.778,103,66,44,22,37,22,15,10,0.0,0.0
1003,2447,26-09-2019 21:12:00,0,2952.0,2332.0,0.79,14.213,184,102,64,38,82,43,39,0,0.0,0.0
1003,2448,26-09-2019 21:14:00,0,2794.0,2105.0,0.753,13.341,167,87,43,44,80,51,29,1,0.0,0.0
1003,2449,26-09-2019 21:16:00,0,2987.0,2246.0,0.752,14.254,313,158,112,46,155,113,42,10,0.0,0.0
1003,2450,26-09-2019 21:18:00,0,3082.0,2342.5,0.76,14.7365,129,92,56,36,37,18,19,0,0.0,0.0
1003,2451,26-09-2019 21:20:00,0,3177.0,2439.0,0.768,15.219,216,98,63,35,118,76,42,11,0.0,0.0
1003,2452,26-09-2019 21:22:00,0,3065.0,2454.0,0.801,14.792,338,236,171,65,102,70,32,32,0.0,0.0
1003,2453,26-09-2019 21:24:00,0,3063.0,2456.0,0.802,14.787,465,360,281,79,105,78,27,42,0.0,0.0
1003,2454,26-09-2019 21:26:00,0,2947.0,2421.0,0.821,14.292,319,220,172,48,99,74,25,29,0.0,0.0
1003,2455,26-09-2019 21:28:00,0,2965.0,2327.0,0.785,14.258,179,111,77,34,68,35,33,3,0.0,0.0
1003,2456,26-09-2019 21:30:00,0,3174.0,2494.0,0.786,15.266,305,183,133,50,122,91,31,10,0.0,0.0
1003,2457,26-09-2019 21:32:00,0,2950.0,2414.0,0.818,14.295,191,124,79,45,67,49,18,6,0.0,0.0
1003,2458,26-09-2019 21:34:00,0,2976.0,2332.0,0.784,14.31,263,116,84,32,147,108,39,24,0.0,0.0
1003,2459,26-09-2019 21:36:00,0,2957.0,2401.0,0.812,14.307,388,222,161,61,166,119,47,28,0.0,0.0
1003,2460,26-09-2019 21:38:00,0,2758.0,2169.0,0.787,13.267,161,89,51,38,72,48,24,1,0.0,0.0
1003,2461,26-09-2019 21:40:00,0,2769.0,2155.0,0.778,13.297,205,111,74,37,94,56,38,24,0.0,0.0
1003,2462,26-09-2019 21:42:00,0,2961.0,2349.0,0.793,14.268,219,127,90,37,92,50,42,11,0.0,0.0
1003,2463,26-09-2019 21:44:00,0,2756.0,2192.0,0.795,13.285,355,264,191,73,91,56,35,5,0.0,0.0
1003,2464,26-09-2019 21:46:00,0,2957.0,2368.0,0.801,14.273,346,261,195,66,85,56,29,24,0.0,0.0
1003,2465,26-09-2019 21:48:00,0,2971.0,2351.0,0.791,14.308,268,166,127,39,102,76,26,35,0.02,0.0
1003,2466,26-09-2019 21:50:00,0,2959.0,2362.0,0.798,14.275,216,115,85,30,101,68,33,50,0.0,0.0
1003,2467,26-09-2019 21:52:00,0,2866.5,2238.5,0.78,13.774,126,83,58,25,43,35,8,2,0.0,0.0
1003,2468,26-09-2019 21:54:00,0,2774.0,2115.0,0.762,13.273,80,46,23,23,34,12,22,0,0.0,0.0
1003,2469,26-09-2019 21:56:00,0,2677.0,2041.0,0.762,12.808,148,63,31,32,85,51,34,0,0.0,0.0
1003,2470,26-09-2019 21:58:00,0,3167.0,2523.0,0.797,15.272,221,141,95,46,80,51,29,1,0.0,0.0
1003,2471,26-09-2019 22:00:00,0,2773.0,2125.0,0.766,13.279,213,82,52,30,131,72,59,0,0.0,0.0
1003,2472,26-09-2019 22:02:00,0,2437.0,2004.0,0.822,11.823,150,81,39,42,69,28,41,0,0.06,0.0
1003,2473,26-09-2019 22:04:00,0,2959.0,2336.0,0.789,14.244,405,242,175,67,163,114,49,22,0.0,0.0
1003,2474,26-09-2019 22:06:00,0,2754.0,2193.0,0.796,13.28,196,98,56,42,98,56,42,3,0.0,0.0
1003,2475,26-09-2019 22:08:00,0,2458.0,1931.0,0.786,11.821,221,145,93,52,76,42,34,7,0.0,0.0
1003,2476,26-09-2019 22:10:00,0,2952.0,2351.0,0.796,14.236,152,92,55,37,60,31,29,3,0.0,0.0
1003,2477,26-09-2019 22:12:00,0,2973.0,2272.0,0.764,14.228,337,237,181,56,100,71,29,16,0.0,0.0
1003,2478,26-09-2019 22:14:00,0,3070.0,2425.0,0.79,14.78,336,246,174,72,90,63,27,12,0.0,0.0
1003,2479,26-09-2019 22:16:00,0,2972.0,2334.0,0.786,14.293,78,36,22,14,42,18,24,13,0.05,0.0
1003,2480,26-09-2019 22:18:00,0,3604.0,2759.0,0.766,17.254,90,67,42,25,23,14,9,2,0.0,0.0
1003,2481,26-09-2019 22:20:00,0,2984.0,2255.0,0.756,14.254,138,64,27,37,74,42,32,0,0.0,0.0
1003,2482,26-09-2019 22:22:00,0,2772.0,2135.0,0.77,13.286,130,75,37,38,55,24,31,0,0.08,0.0
1003,2483,26-09-2019 22:24:00,0,2988.0,2279.0,0.763,14.295,290,230,181,49,60,38,22,4,0.0,0.0
1003,2484,26-09-2019 22:26:00,0,2878.5,2223.0,0.773,13.8015,244,206,168,38,38,22,16,0,0.0,0.0
1003,2485,26-09-2019 22:28:00,0,2769.0,2167.0,0.783,13.308,365,305,272,33,60,34,26,1,0.0,0.0
1003,2486,26-09-2019 22:30:00,0,2452.0,1951.0,0.796,11.82,443,287,229,58,156,120,36,29,0.0,0.0
1003,2487,26-09-2019 22:32:00,0,2543.0,2054.0,0.807,12.294,373,314,249,65,59,35,24,3,0.0,0.0
1003,2488,26-09-2019 22:34:00,0,2549.0,2040.0,0.8,12.304,537,397,355,42,140,97,43,50,0.0,0.0
1003,2489,26-09-2019 22:36:00,0,2995.0,2276.0,0.76,14.319,543,356,277,79,187,123,64,13,0.0,0.0
1003,2490,26-09-2019 22:38:00,0,2956.0,2322.0,0.786,14.22,328,282,206,76,46,4,42,20,0.0,0.0
1003,2491,26-09-2019 22:40:00,0,2987.0,2252.0,0.754,14.262,308,228,153,75,80,44,36,3,0.0,0.0
1003,2492,26-09-2019 22:42:00,0,2975.0,2256.0,0.759,14.219,355,198,128,70,157,103,54,4,0.0,0.0
1003,2493,26-09-2019 22:44:00,0,2982.0,2285.0,0.766,14.28,157,83,49,34,74,43,31,7,0.0,0.0
1003,2494,26-09-2019 22:46:00,0,3173.0,2519.0,0.794,15.292,348,143,105,38,205,152,53,49,0.07,0.0
1003,2495,26-09-2019 22:48:00,0,2348.0,1875.0,0.798,11.328,381,197,149,48,184,137,47,89,0.0,0.0
1003,2496,26-09-2019 22:50:00,0,2781.0,2114.0,0.76,13.3,235,87,61,26,148,106,42,14,0.0,0.0
1003,2497,26-09-2019 22:52:00,0,2265.0,1718.0,0.758,10.826,221,103,68,35,118,72,46,12,0.0,0.0
1003,2498,26-09-2019 22:54:00,0,2046.0,1628.0,0.795,9.865,407,196,148,48,211,159,52,32,0.0,0.0
1003,2499,26-09-2019 22:56:00,0,2783.0,2082.0,0.748,13.271,196,96,58,38,100,50,50,5,0.0,0.0
1003,2500,26-09-2019 22:58:00,0,2978.0,2307.0,0.775,14.288,457,224,163,61,233,199,34,13,0.0,0.0
1003,2501,26-09-2019 23:00:00,0,2629.0,2000.0,0.759,12.572,49,49,7,42,0,0,0,3,0.0,0.0
1003,2502,26-09-2019 23:02:00,0,2280.0,1693.0,0.743,10.856,104,46,15,31,58,52,6,1,0.0,0.0
1003,2503,26-09-2019 23:04:00,0,2269.0,1683.0,0.742,10.804,413,31,14,17,382,357,25,3,0.0,0.0
1003,2504,26-09-2019 23:06:00,0,2578.0,1979.0,0.768,12.347,294,182,135,47,112,92,20,47,0.0,0.0
1003,2505,26-09-2019 23:08:00,0,2986.0,2294.0,0.768,14.305,248,111,85,26,137,104,33,42,0.0,0.0
1003,2506,26-09-2019 23:10:00,0,2962.0,2297.0,0.775,14.216,137,99,57,42,38,19,19,0,0.0,0.0
1003,2507,26-09-2019 23:12:00,0,2997.0,2243.0,0.748,14.292,285,106,64,42,179,160,19,2,0.0,0.0
1003,2508,26-09-2019 23:14:00,0,2987.0,2245.0,0.752,14.253,216,82,56,26,134,113,21,18,0.07,0.0
1003,2509,26-09-2019 23:16:00,0,2671.0,2071.0,0.775,12.817,105,43,21,22,62,56,6,1,0.0,0.0
1003,2510,26-09-2019 23:18:00,0,2466.0,1905.0,0.772,11.826,108,4,3,1,104,84,20,0,0.0,0.0
1003,2511,26-09-2019 23:20:00,0,2259.0,1757.0,0.778,10.846,196,1,0,1,195,161,34,0,0.0,0.0
1003,2512,26-09-2019 23:22:00,0,2272.0,1685.0,0.742,10.817,1,0,0,0,1,0,1,0,0.0,0.0
1003,2513,26-09-2019 23:24:00,0,2170.0,1630.0,0.751,10.355,2,0,0,0,2,1,1,0,0.0,0.0
1003,2514,26-09-2019 23:26:00,0,2172.0,1604.0,0.738,10.333,89,0,0,0,89,73,16,0,0.0,0.0
1003,2515,26-09-2019 23:28:00,0,2174.0,1609.0,0.74,10.347,332,0,0,0,332,299,33,0,0.0,0.0
1003,2516,26-09-2019 23:30:00,0,2053.0,1568.0,0.764,9.825,276,1,1,0,275,241,34,0,0.0,0.0
1003,2517,26-09-2019 23:32:00,0,1943.0,1530.0,0.787,9.351,10,0,0,0,10,8,2,0,0.0,0.0
1003,2518,26-09-2019 23:34:00,0,1895.5,1469.5,0.775,9.0965,8,0,0,0,8,6,2,0,0.0,0.0
1003,2519,26-09-2019 23:36:00,0,1848.0,1409.0,0.763,8.842,285,22,16,6,263,228,35,0,0.0,0.0
1003,2520,26-09-2019 23:38:00,0,1855.0,1408.0,0.759,8.866,519,271,219,52,248,213,35,77,0.0,0.0
1003,2521,26-09-2019 23:40:00,0,2256.0,1735.0,0.769,10.812,327,137,93,44,190,159,31,13,0.0,0.0
1003,2522,26-09-2019 23:42:00,0,2261.0,1771.0,0.783,10.867,388,196,152,44,192,165,27,65,0.0,0.0
1003,2523,26-09-2019 23:44:00,0,2461.0,1903.0,0.773,11.805,160,52,29,23,108,89,19,1,0.0,0.0
1003,2524,26-09-2019 23:46:00,0,2465.0,1912.0,0.776,11.83,178,29,16,13,149,94,55,0,0.0,0.0
1003,2525,26-09-2019 23:48:00,0,2247.0,1783.0,0.794,10.826,374,112,72,40,262,201,61,73,0.0,0.0
1003,2526,26-09-2019 23:50:00,0,1941.0,1566.0,0.807,9.382,273,104,64,40,169,127,42,43,0.0,0.0
1003,2527,26-09-2019 23:52:00,0,2256.0,1739.0,0.771,10.814,239,43,14,29,196,156,40,0,0.0,0.0
1003,2528,26-09-2019 23:54:00,0,2251.0,1757.0,0.78,10.816,137,74,50,24,63,28,35,20,0.0,0.0
1003,2529,26-09-2019 23:56:00,0,2682.0,2029.0,0.756,12.813,460,181,136,45,279,219,60,41,0.0,0.0
1003,2530,26-09-2019 23:58:00,0,2457.0,1917.0,0.78,11.803,222,65,38,27,157,106,51,2,0.0,0.0
1003,2531,27-09-2019 00:00:00,0,2773.0,2112.0,0.761,13.266,145,25,9,16,120,71,49,0,0.0,0.0
1003,2532,27-09-2019 00:02:00,0,2453.0,1962.0,0.8,11.838,349,176,115,61,173,117,56,6,0.0,0.0
1003,2533,27-09-2019 00:04:00,0,2785.0,2073.0,0.744,13.268,409,269,198,71,140,100,40,13,0.0,0.0
1003,2534,27-09-2019 00:06:00,0,2666.0,2043.0,0.766,12.767,151,78,36,42,73,41,32,0,0.0,0.0
1003,2535,27-09-2019 00:08:00,0,2416.0,1826.0,0.7545,11.5415,133,69,31,38,64,30,34,0,0.0,0.0
1003,2536,27-09-2019 00:10:00,0,2166.0,1609.0,0.743,10.316,169,73,43,30,96,65,31,16,0.08,0.0
1003,2537,27-09-2019 00:12:00,0,2476.0,1887.0,0.762,11.844,147,65,36,29,82,52,30,13,0.0,0.0
1003,2538,27-09-2019 00:14:00,0,2784.0,2062.0,0.741,13.251,220,75,53,22,145,102,43,71,0.0,0.0
1003,2539,27-09-2019 00:16:00,0,2052.0,1592.0,0.776,9.848,154,39,11,28,115,66,49,0,0.0,0.0
1003,2540,27-09-2019 00:18:00,0,1746.0,1345.0,0.77,8.37,56,16,4,12,40,1,39,0,0.0,0.0
1003,2541,27-09-2019 00:20:00,0,1760.0,1306.0,0.742,8.379,248,95,46,49,153,94,59,0,0.0,0.0
1003,2542,27-09-2019 00:22:00,0,2258.0,1761.0,0.78,10.846,35,11,3,8,24,8,16,0,0.0,0.0
1003,2543,27-09-2019 00:24:00,0,2465.0,1912.0,0.776,11.828,2,1,0,1,1,0,1,0,0.0,0.0
1003,2544,27-09-2019 00:26:00,0,2480.0,1853.0,0.747,11.823,2,2,0,2,0,0,0,0,0.0,0.0
1003,2545,27-09-2019 00:28:00,0,2252.0,1747.0,0.776,10.809,42,1,0,1,41,6,35,0,0.0,0.0
1003,2546,27-09-2019 00:30:00,0,2277.0,1678.0,0.737,10.831,17,2,1,1,15,2,13,0,0.0,0.0
1003,2547,27-09-2019 00:32:00,0,2054.0,1582.0,0.77,9.843,3,2,0,2,1,0,1,0,0.0,0.0
1003,2548,27-09-2019 00:34:00,0,1958.0,1484.0,0.758,9.358,0,0,0,0,0,0,0,0,0.0,0.0
1003,2549,27-09-2019 00:36:00,0,1852.0,1413.0,0.763,8.86,2,2,0,2,0,0,0,0,0.0,0.0
1003,2550,27-09-2019 00:38:00,0,1736.0,1389.0,0.8,8.378,30,9,6,3,21,7,14,0,0.0,0.0
1003,2551,27-09-2019 00:40:00,0,1745.0,1365.0,0.783,8.385,42,0,0,0,42,0,42,0,0.0,0.0
1003,2552,27-09-2019 00:42:00,0,1752.5,1332.5,0.761,8.3805,35,0,0,0,35,0,35,0,0.0,0.0
1003,2553,27-09-2019 00:44:00,0,1760.0,1300.0,0.739,8.376,80,17,10,7,63,23,40,0,0.0,0.0
1003,2554,27-09-2019 00:46:00,0,1761.0,1271.0,0.721,8.347,163,0,0,0,163,103,60,0,0.0,0.0
1003,2555,27-09-2019 00:48:00,0,1770.0,1268.0,0.716,8.378,141,0,0,0,141,75,66,0,0.0,0.0
1003,2556,27-09-2019 00:50:00,0,1655.0,1236.0,0.746,7.89,40,0,0,0,40,5,35,0,0.0,0.0
1003,2557,27-09-2019 00:52:00,0,1530.0,1211.0,0.791,7.37,65,0,0,0,65,10,55,0,0.0,0.0
1003,2558,27-09-2019 00:54:00,0,1543.0,1188.0,0.77,7.393,39,2,1,1,37,2,35,0,0.0,0.0
1003,2559,27-09-2019 00:56:00,0,1547.0,1173.0,0.758,7.393,46,0,0,0,46,0,46,0,0.0,0.0
1003,2560,27-09-2019 00:58:00,0,1553.0,1156.0,0.744,7.401,86,19,5,14,67,19,48,0,0.0,0.0
1003,2561,27-09-2019 01:00:00,0,1538.0,1187.0,0.772,7.373,491,197,157,40,294,214,80,60,0.0,0.0
1003,2562,27-09-2019 01:02:00,0,1959.0,1476.0,0.754,9.354,331,123,91,32,208,141,67,48,0.0,0.0
1003,2563,27-09-2019 01:04:00,0,2047.0,1619.0,0.791,9.859,362,138,95,43,224,174,50,41,0.0,0.0
1003,2564,27-09-2019 01:06:00,0,2461.0,1912.0,0.777,11.813,368,166,132,34,202,157,45,65,0.0,0.0
1003,2565,27-09-2019 01:08:00,0,2460.0,1930.0,0.785,11.83,253,102,84,18,151,109,42,64,0.0,0.0
1003,2566,27-09-2019 01:10:00,0,3183.0,2420.0,0.76,15.22,275,37,19,18,238,186,52,0,0.0,0.0
1003,2567,27-09-2019 01:12:00,0,2990.0,2281.0,0.763,14.306,173,61,28,33,112,73,39,7,0.02,0.0
1003,2568,27-09-2019 01:14:00,0,2479.0,1863.0,0.752,11.832,366,193,144,49,173,117,56,7,0.0,0.0
1003,2569,27-09-2019 01:16:00,0,2521.5,1927.0,0.7645,12.069,126,61,43,18,65,26,39,4,0.0,0.0
1003,2570,27-09-2019 01:18:00,0,2564.0,1991.0,0.777,12.306,214,64,36,28,150,100,50,5,0.0,0.0
1003,2571,27-09-2019 01:20:00,0,2780.0,2080.0,0.748,13.257,365,100,63,37,265,186,79,3,0.0,0.0
1003,2572,27-09-2019 01:22:00,0,2449.0,1931.0,0.789,11.786,185,52,31,21,133,89,44,2,0.0,0.0
1003,2573,27-09-2019 01:24:00,0,2456.0,1946.0,0.793,11.832,247,122,85,37,125,76,49,11,0.0,0.0
1003,2574,27-09-2019 01:26:00,0,2454.0,1937.0,0.789,11.815,210,54,16,38,156,99,57,0,0.0,0.0
1003,2575,27-09-2019 01:28:00,0,2457.0,1925.0,0.784,11.81,123,58,37,21,65,36,29,42,0.0,0.0
1003,2576,27-09-2019 01:30:00,0,2447.0,1959.0,0.801,11.812,315,136,87,49,179,117,62,2,0.0,0.0
1003,2577,27-09-2019 01:32:00,0,2688.0,2012.0,0.749,12.818,179,23,8,15,156,96,60,0,0.0,0.0
1003,2578,27-09-2019 01:34:00,0,2484.0,1829.0,0.736,11.813,156,65,22,43,91,49,42,0,0.0,0.0
1003,2579,27-09-2019 01:36:00,0,2572.0,1981.0,0.77,12.328,197,68,48,20,129,76,53,1,0.0,0.0
1003,2580,27-09-2019 01:38:00,0,2453.0,1919.0,0.782,11.788,235,73,40,33,162,103,59,0,0.0,0.0
1003,2581,27-09-2019 01:40:00,0,2248.0,1792.0,0.797,10.84,239,97,63,34,142,85,57,16,0.0,0.0
1003,2582,27-09-2019 01:42:00,0,2245.0,1782.0,0.794,10.82,309,115,66,49,194,137,57,29,0.0,0.0
1003,2583,27-09-2019 01:44:00,0,2457.0,1926.0,0.784,11.813,140,62,45,17,78,51,27,38,0.11,0.0
1003,2584,27-09-2019 01:46:00,0,2243.0,1797.0,0.801,10.827,259,127,91,36,132,74,58,9,0.0,0.0
1003,2585,27-09-2019 01:48:00,0,2473.0,1895.0,0.766,11.841,197,120,79,41,77,44,33,0,0.0,0.0
1003,2586,27-09-2019 01:50:00,0,2363.0,1826.5,0.773,11.3315,126,25,6,19,101,55,46,0,0.0,0.0
1003,2587,27-09-2019 01:52:00,0,2253.0,1758.0,0.78,10.822,169,78,40,38,91,56,35,0,0.0,0.0
1003,2588,27-09-2019 01:54:00,0,2260.0,1755.0,0.777,10.848,253,82,38,44,171,119,52,0,0.0,0.0
1003,2589,27-09-2019 01:56:00,0,2256.0,1762.0,0.781,10.84,77,34,12,22,43,24,19,0,0.0,0.0
1003,2590,27-09-2019 01:58:00,0,2279.0,1674.0,0.734,10.833,40,17,3,14,23,2,21,0,0.0,0.0
1003,2591,27-09-2019 02:00:00,0,1935.0,1549.0,0.801,9.338,46,5,1,4,41,8,33,0,0.0,0.0
1003,2592,27-09-2019 02:02:00,0,1961.0,1463.0,0.746,9.345,11,0,0,0,11,0,11,0,0.0,0.0
1003,2593,27-09-2019 02:04:00,0,1858.0,1406.0,0.756,8.878,23,0,0,0,23,4,19,0,0.0,0.0
1003,2594,27-09-2019 02:06:00,0,1746.0,1350.0,0.773,8.375,31,1,0,1,30,22,8,0,0.0,0.0
1003,2595,27-09-2019 02:08:00,0,1753.0,1328.0,0.758,8.376,0,0,0,0,0,0,0,0,0.0,0.0
1003,2596,27-09-2019 02:10:00,0,1756.0,1311.0,0.747,8.37,1,1,1,0,0,0,0,0,0.0,0.0
1003,2597,27-09-2019 02:12:00,0,1765.0,1263.0,0.716,8.355,3,1,1,0,2,0,2,0,0.0,0.0
1003,2598,27-09-2019 02:14:00,0,1655.0,1218.0,0.736,7.87,7,0,0,0,7,2,5,0,0.0,0.0
1003,2599,27-09-2019 02:16:00,0,1544.0,1173.0,0.76,7.382,3,0,0,0,3,0,3,0,0.0,0.0
1003,2600,27-09-2019 02:18:00,0,1549.0,1163.0,0.751,7.392,8,8,0,8,0,0,0,0,0.0,0.0
1003,2601,27-09-2019 02:20:00,0,1554.0,1125.0,0.724,7.368,3,0,0,0,3,0,3,0,0.0,0.0
1003,2602,27-09-2019 02:22:00,0,1446.0,1086.0,0.751,6.9,1,0,0,0,1,0,1,0,0.0,0.0
1003,2603,27-09-2019 02:24:00,0,1327.0,1066.0,0.8085,6.408,87,21,16,5,66,39,27,0,0.0,0.0
1003,2604,27-09-2019 02:26:00,0,1208.0,1046.0,0.866,5.916,10,9,1,8,1,0,1,0,0.0,0.0
1003,2605,27-09-2019 02:28:00,0,1329.0,1056.0,0.794,6.407,5,3,1,2,2,0,2,0,0.0,0.0
1003,2606,27-09-2019 02:30:00,0,1330.0,1060.0,0.797,6.414,8,7,0,7,1,0,1,0,0.0,0.0
1003,2607,27-09-2019 02:32:00,0,1205.0,1035.0,0.859,5.894,2,0,0,0,2,0,2,0,0.0,0.0
1003,2608,27-09-2019 02:34:00,0,1215.0,1020.0,0.839,5.918,44,22,10,12,22,14,8,0,0.0,0.0
1003,2609,27-09-2019 02:36:00,0,1206.0,1037.0,0.86,5.898,7,4,2,2,3,2,1,0,0.0,0.0
1003,2610,27-09-2019 02:38:00,0,1329.0,1060.0,0.798,6.408,7,5,1,4,2,0,2,0,0.0,0.0
1003,2611,27-09-2019 02:40:00,0,1556.0,1124.0,0.722,7.374,3,0,0,0,3,0,3,0,0.0,0.0
1003,2612,27-09-2019 02:42:00,0,1554.0,1119.0,0.72,7.364,9,5,0,5,4,0,4,0,0.0,0.0
1003,2613,27-09-2019 02:44:00,0,1446.0,1099.0,0.76,6.915,29,4,1,3,25,3,22,0,0.0,0.0
1003,2614,27-09-2019 02:46:00,0,1327.0,1073.0,0.808,6.418,318,139,110,29,179,130,49,21,0.0,0.0
1003,2615,27-09-2019 02:48:00,0,1650.0,1232.0,0.746,7.866,228,102,78,24,126,86,40,61,0.0,0.0
1003,2616,27-09-2019 02:50:00,0,1731.0,1371.0,0.792,8.338,216,92,63,29,124,73,51,7,0.0,0.0
1003,2617,27-09-2019 02:52:00,0,2054.0,1571.0,0.764,9.834,376,166,121,45,210,165,45,15,0.0,0.0
1003,2618,27-09-2019 02:54:00,0,1950.0,1549.0,0.794,9.397,275,112,85,27,163,120,43,24,0.0,0.0
1003,2619,27-09-2019 02:56:00,0,2261.0,1719.0,0.76,10.813,196,81,61,20,115,80,35,32,0.0,0.0
1003,2620,27-09-2019 02:58:00,0,2162.5,1633.0,0.755,10.329,143,10,3,7,133,66,67,0,0.0,0.0
1003,2621,27-09-2019 03:00:00,0,2064.0,1547.0,0.75,9.845,325,141,100,41,184,131,53,27,0.0,0.0
1003,2622,27-09-2019 03:02:00,0,2292.0,1631.0,0.711,10.838,40,10,4,6,30,11,19,1,0.0,0.0
1003,2623,27-09-2019 03:04:00,0,2180.0,1578.0,0.724,10.335,105,1,0,1,104,48,56,0,0.0,0.0
1003,2624,27-09-2019 03:06:00,0,2071.0,1546.0,0.747,9.87,82,13,3,10,69,39,30,0,0.0,0.0
1003,2625,27-09-2019 03:08:00,0,1954.0,1488.0,0.761,9.348,317,122,79,43,195,128,67,17,0.0,0.0
1003,2626,27-09-2019 03:10:00,0,1952.0,1507.0,0.772,9.359,213,57,39,18,156,100,56,4,0.0,0.0
1003,2627,27-09-2019 03:12:00,0,2174.0,1607.0,0.739,10.344,242,103,67,36,139,95,44,7,0.0,0.0
1003,2628,27-09-2019 03:14:00,0,2163.0,1628.0,0.753,10.327,210,22,11,11,188,134,54,0,0.0,0.0
1003,2629,27-09-2019 03:16:00,0,1948.0,1517.0,0.779,9.353,205,21,3,18,184,121,63,0,0.0,0.0
1003,2630,27-09-2019 03:18:00,0,2057.0,1559.0,0.758,9.832,118,6,3,3,112,65,47,0,0.0,0.0
1003,2631,27-09-2019 03:20:00,0,2279.0,1690.0,0.741,10.852,50,0,0,0,50,0,50,0,0.0,0.0
1003,2632,27-09-2019 03:22:00,0,2272.0,1661.0,0.731,10.79,10,0,0,0,10,0,10,0,0.0,0.0
1003,2633,27-09-2019 03:24:00,0,2054.0,1602.0,0.78,9.865,14,12,1,11,2,0,2,0,0.0,0.0
1003,2634,27-09-2019 03:26:00,0,1950.0,1510.0,0.774,9.354,5,5,0,5,0,0,0,0,0.0,0.0
1003,2635,27-09-2019 03:28:00,0,1967.0,1437.0,0.73,9.343,15,14,0,14,1,0,1,0,0.0,0.0
1003,2636,27-09-2019 03:30:00,0,1741.0,1378.0,0.792,8.385,16,3,0,3,13,2,11,0,0.0,0.0
1003,2637,27-09-2019 03:32:00,0,1692.5,1309.0,0.773,8.117,7,6,0,6,1,0,1,0,0.0,0.0
1003,2638,27-09-2019 03:34:00,0,1644.0,1240.0,0.754,7.849,29,9,0,9,20,2,18,0,0.0,0.0
1003,2639,27-09-2019 03:36:00,0,1538.0,1210.0,0.786,7.399,40,3,0,3,37,11,26,0,0.0,0.0
1003,2640,27-09-2019 03:38:00,0,1544.0,1177.0,0.762,7.388,44,14,1,13,30,0,30,0,0.0,0.0
1003,2641,27-09-2019 03:40:00,0,1549.0,1140.0,0.736,7.364,81,31,18,13,50,31,19,0,0.0,0.0
1003,2642,27-09-2019 03:42:00,0,1441.0,1110.0,0.77,6.907,36,15,6,9,21,10,11,0,0.0,0.0
1003,2643,27-09-2019 03:44:00,0,1554.0,1118.0,0.719,7.362,30,27,5,22,3,0,3,0,0.0,0.0
1003,2644,27-09-2019 03:46:00,0,1560.0,1133.0,0.727,7.4,12,11,0,11,1,0,1,0,0.0,0.0
1003,2645,27-09-2019 03:48:00,0,1556.0,1121.0,0.721,7.37,10,4,0,4,6,0,6,0,0.0,0.0
1003,2646,27-09-2019 03:50:00,0,1554.0,1123.0,0.723,7.366,24,15,0,15,9,2,7,0,0.0,0.0
1003,2647,27-09-2019 03:52:00,0,1559.0,1140.0,0.731,7.406,7,7,0,7,0,0,0,0,0.0,0.0
1003,2648,27-09-2019 03:54:00,0,1543.0,1171.0,0.759,7.376,9,2,0,2,7,0,7,0,0.0,0.0
1003,2649,27-09-2019 03:56:00,0,1770.0,1255.0,0.709,8.365,7,0,0,0,7,0,7,0,0.0,0.0
1003,2650,27-09-2019 03:58:00,0,1757.0,1308.0,0.745,8.37,118,38,17,21,80,46,34,0,0.0,0.0
1003,2651,27-09-2019 04:00:00,0,1851.0,1421.0,0.768,8.867,430,247,197,50,183,133,50,92,0.0,0.0
1003,2652,27-09-2019 04:02:00,0,2042.0,1608.0,0.787,9.825,263,92,55,37,171,117,54,17,0.0,0.0
1003,2653,27-09-2019 04:04:00,0,2293.0,1640.0,0.715,10.849,195,42,15,27,153,99,54,0,0.0,0.0
1003,2654,27-09-2019 04:06:00,0,2279.0,1683.5,0.7385,10.8435,319,76,41,35,243,171,72,1,0.0,0.0
1003,2655,27-09-2019 04:08:00,0,2265.0,1727.0,0.762,10.838,11,7,0,7,4,0,4,0,0.0,0.0
1003,2656,27-09-2019 04:10:00,0,2288.0,1646.0,0.719,10.837,6,4,0,4,2,0,2,0,0.0,0.0
1003,2657,27-09-2019 04:12:00,0,2060.0,1579.0,0.767,9.865,244,26,5,21,218,160,58,0,0.0,0.0
1003,2658,27-09-2019 04:14:00,0,1943.0,1526.0,0.785,9.343,10,3,0,3,7,0,7,0,0.0,0.0
1003,2659,27-09-2019 04:16:00,0,1952.0,1493.0,0.765,9.342,18,6,0,6,12,6,6,0,0.0,0.0
1003,2660,27-09-2019 04:18:00,0,1966.0,1455.0,0.74,9.357,201,75,49,26,126,90,36,8,0.0,0.0
1003,2661,27-09-2019 04:20:00,0,1953.0,1494.0,0.765,9.348,293,127,95,32,166,120,46,31,0.0,0.0
1003,2662,27-09-2019 04:22:00,0,1933.0,1567.0,0.81,9.351,227,116,74,42,111,61,50,7,0.0,0.0
1003,2663,27-09-2019 04:24:00,0,2283.0,1665.0,0.729,10.84,261,28,12,16,233,170,63,0,0.0,0.0
1003,2664,27-09-2019 04:26:00,0,2478.0,1835.0,0.74,11.797,281,70,31,39,211,160,51,0,0.06,0.0
1003,2665,27-09-2019 04:28:00,0,2166.0,1620.0,0.748,10.326,242,81,48,33,161,100,61,0,0.0,0.0
1003,2666,27-09-2019 04:30:00,0,2166.0,1629.0,0.752,10.34,404,193,143,50,211,146,65,29,0.0,0.0
1003,2667,27-09-2019 04:32:00,0,2255.0,1759.0,0.78,10.831,272,102,69,33,170,119,51,28,0.0,0.0
1003,2668,27-09-2019 04:34:00,0,2478.0,1836.0,0.741,11.796,368,181,134,47,187,134,53,4,0.0,0.0
1003,2669,27-09-2019 04:36:00,0,2357.0,1817.0,0.771,11.297,236,116,72,44,120,69,51,5,0.0,0.0
1003,2670,27-09-2019 04:38:00,0,1938.0,1558.0,0.804,9.359,89,23,11,12,66,30,36,2,0.0,0.0
1003,2671,27-09-2019 04:40:00,0,1943.0,1537.0,0.791,9.356,109,45,25,20,64,33,31,0,0.0,0.0
1003,2672,27-09-2019 04:42:00,0,1948.0,1516.0,0.778,9.353,105,18,4,14,87,63,24,0,0.0,0.0
1003,2673,27-09-2019 04:44:00,0,2050.0,1592.0,0.777,9.838,6,1,0,1,5,0,5,0,0.0,0.0
1003,2674,27-09-2019 04:46:00,0,1952.0,1519.0,0.778,9.374,25,2,0,2,23,2,21,0,0.0,0.0
1003,2675,27-09-2019 04:48:00,0,1960.0,1445.0,0.737,9.323,33,0,0,0,33,0,33,0,0.0,0.0
1003,2676,27-09-2019 04:50:00,0,1972.0,1401.0,0.71,9.32,34,0,0,0,34,0,34,0,0.0,0.0
1003,2677,27-09-2019 04:52:00,0,1743.0,1353.0,0.776,8.367,43,1,0,1,42,0,42,0,0.0,0.0
1003,2678,27-09-2019 04:54:00,0,1754.0,1300.0,0.741,8.349,6,1,0,1,5,0,5,0,0.0,0.0
1003,2679,27-09-2019 04:56:00,0,1760.0,1284.0,0.729,8.358,0,0,0,0,0,0,0,0,0.0,0.0
1003,2680,27-09-2019 04:58:00,0,1781.0,1245.0,0.699,8.394,0,0,0,0,0,0,0,0,0.0,0.0
1003,2681,27-09-2019 05:00:00,0,1539.0,1202.0,0.781,7.396,1,0,0,0,1,0,1,0,0.0,0.0
1003,2682,27-09-2019 05:02:00,0,1547.0,1157.0,0.748,7.377,2,0,0,0,2,0,2,0,0.0,0.0
1003,2683,27-09-2019 05:04:00,0,1545.0,1152.0,0.746,7.363,0,0,0,0,0,0,0,0,0.0,0.0
1003,2684,27-09-2019 05:06:00,0,1551.0,1155.0,0.745,7.388,0,0,0,0,0,0,0,0,0.0,0.0
1003,2685,27-09-2019 05:08:00,0,1558.0,1131.0,0.726,7.389,0,0,0,0,0,0,0,0,0.0,0.0
1003,2686,27-09-2019 05:10:00,0,1443.0,1092.0,0.757,6.897,26,11,6,5,15,9,6,0,0.0,0.0
1003,2687,27-09-2019 05:12:00,0,1447.0,1090.0,0.753,6.909,0,0,0,0,0,0,0,0,0.0,0.0
1003,2688,27-09-2019 05:14:00,0,1329.0,1057.0,0.7995,6.4075,0,0,0,0,0,0,0,0,0.0,0.0
1003,2689,27-09-2019 05:16:00,0,1211.0,1024.0,0.846,5.906,0,0,0,0,0,0,0,0,0.0,0.0
1003,2690,27-09-2019 05:18:00,0,1218.0,1007.0,0.827,5.914,12,5,4,1,7,2,5,0,0.0,0.0
1003,2691,27-09-2019 05:20:00,0,1220.0,998.0,0.818,5.911,5,0,0,0,5,1,4,0,0.0,0.0
1003,2692,27-09-2019 05:22:00,0,1206.0,1050.0,0.871,5.914,4,0,0,0,4,1,3,0,0.0,0.0
1003,2693,27-09-2019 05:24:00,0,1436.0,1105.0,0.769,6.881,0,0,0,0,0,0,0,0,0.0,0.0
1003,2694,27-09-2019 05:26:00,0,1560.0,1127.0,0.722,7.395,1,0,0,0,1,0,1,0,0.0,0.0
1003,2695,27-09-2019 05:28:00,0,1553.0,1124.0,0.724,7.365,3,0,0,0,3,0,3,0,0.0,0.0
1003,2696,27-09-2019 05:30:00,0,1440.0,1108.0,0.769,6.901,5,0,0,0,5,0,5,0,0.0,0.0
1003,2697,27-09-2019 05:32:00,0,1448.0,1086.0,0.75,6.906,16,8,1,7,8,5,3,0,0.0,0.0
1003,2698,27-09-2019 05:34:00,0,1324.0,1066.0,0.805,6.398,1,1,0,1,0,0,0,0,0.0,0.0
1003,2699,27-09-2019 05:36:00,0,1212.0,1016.0,0.839,5.899,0,0,0,0,0,0,0,0,0.0,0.0
1003,2700,27-09-2019 05:38:00,0,1231.0,962.0,0.781,5.917,2,2,0,2,0,0,0,0,0.0,0.0
1003,2701,27-09-2019 05:40:00,0,1231.0,959.0,0.779,5.913,73,39,8,31,34,15,19,0,0.0,0.0
1003,2702,27-09-2019 05:42:00,0,1552.0,1136.0,0.732,7.372,204,41,17,24,163,113,50,0,0.0,0.0
1003,2703,27-09-2019 05:44:00,0,1759.0,1302.0,0.74,8.372,98,37,21,16,61,31,30,0,0.0,0.0
1003,2704,27-09-2019 05:46:00,0,1948.0,1489.0,0.764,9.325,236,116,86,30,120,83,37,12,0.0,0.0
1003,2705,27-09-2019 05:48:00,0,2221.0,1649.0,0.7445,10.577,390,185,141,44,205,147,58,75,0.0,0.0
1003,2706,27-09-2019 05:50:00,0,2494.0,1809.0,0.725,11.829,175,60,36,24,115,79,36,7,0.0,0.0
1003,2707,27-09-2019 05:52:00,0,2476.0,1830.0,0.739,11.782,275,57,39,18,218,160,58,6,0.03,0.0
1003,2708,27-09-2019 05:54:00,0,2486.0,1833.0,0.737,11.825,131,61,34,27,70,28,42,6,0.0,0.0
1003,2709,27-09-2019 05:56:00,0,2361.0,1780.0,0.754,11.272,72,11,6,5,61,17,44,0,0.0,0.0
1003,2710,27-09-2019 05:58:00,0,2270.0,1721.0,0.758,10.85,241,40,20,20,201,138,63,0,0.0,0.0
1003,2711,27-09-2019 06:00:00,1,2373.0,1798.0,0.757,11.341,168,24,9,15,144,104,40,51,0.0,0.0
1003,2712,27-09-2019 06:02:00,1,2253.0,1767.0,0.784,10.832,470,227,190,37,243,185,58,55,0.0,0.0
1003,2713,27-09-2019 06:04:00,1,2568.0,1981.0,0.771,12.313,354,185,144,41,169,135,34,86,0.0,0.0
1003,2714,27-09-2019 06:06:00,1,3017.0,2158.0,0.715,14.279,283,57,37,20,226,167,59,48,0.0,0.0
1003,2715,27-09-2019 06:08:00,1,3198.0,2369.0,0.741,15.222,242,37,10,27,205,154,51,19,0.0,0.0
1003,2716,27-09-2019 06:10:00,1,3284.0,2541.0,0.774,15.753,241,22,2,20,219,168,51,23,0.0,0.0
1003,2717,27-09-2019 06:12:00,1,3160.0,2515.0,0.796,15.237,233,30,13,17,203,162,41,21,0.0,0.15
1003,2718,27-09-2019 06:14:00,1,3164.0,2569.0,0.812,15.312,114,16,6,10,98,70,28,2,0.13,0.06
1003,2719,27-09-2019 06:16:00,1,3144.0,2587.0,0.823,15.25,173,32,8,24,141,106,35,8,0.07,0.01
1003,2720,27-09-2019 06:18:00,1,3485.0,2749.0,0.789,16.773,214,31,9,22,183,136,47,11,0.09,0.04
1003,2721,27-09-2019 06:20:00,1,3440.0,2900.0,0.843,16.763,120,21,2,19,99,77,22,11,0.0,0.07
1003,2722,27-09-2019 06:22:00,1,3494.0,2937.0,0.8405,17.0175,162,31,14,17,131,95,36,10,0.11,0.08
1003,2723,27-09-2019 06:24:00,1,3548.0,2974.0,0.838,17.272,225,38,11,27,187,136,51,7,0.16,0.06
1003,2724,27-09-2019 06:26:00,1,3526.0,2990.0,0.848,17.203,316,36,17,19,280,241,39,20,0.0,0.01
1003,2725,27-09-2019 06:28:00,1,3646.0,3054.0,0.838,17.748,124,26,0,26,98,67,31,5,0.01,0.0
1003,2726,27-09-2019 06:30:00,1,3657.0,3092.0,0.845,17.832,149,25,8,17,124,91,33,3,0.09,0.11
1003,2727,27-09-2019 06:32:00,1,3628.0,3072.0,0.847,17.694,165,43,15,28,122,91,31,5,0.14,0.06
1003,2728,27-09-2019 06:34:00,1,3420.0,2980.0,0.871,16.773,214,43,19,24,171,129,42,13,0.0,0.04
1003,2729,27-09-2019 06:36:00,1,3610.0,3158.0,0.875,17.721,134,21,0,21,113,78,35,4,0.0,0.06
1003,2730,27-09-2019 06:38:00,1,3610.0,3202.0,0.887,17.767,408,138,93,45,270,223,47,28,0.07,0.06
1003,2731,27-09-2019 06:40:00,1,3078.0,2847.0,0.925,15.279,375,142,116,26,233,180,53,107,0.08,0.0
1003,2732,27-09-2019 06:42:00,1,3415.0,2998.0,0.878,16.773,149,19,1,18,130,92,38,13,0.0,0.0
1003,2733,27-09-2019 06:44:00,1,3598.0,3199.0,0.889,17.716,213,29,7,22,184,146,38,21,0.05,0.15
1003,2734,27-09-2019 06:46:00,1,3402.0,3017.0,0.887,16.745,352,94,75,19,258,195,63,16,0.09,0.01
1003,2735,27-09-2019 06:48:00,1,3091.0,2814.0,0.91,15.294,167,64,36,28,103,64,39,65,0.0,0.06
1003,2736,27-09-2019 06:50:00,1,2881.0,2661.0,0.924,14.3,127,60,38,22,67,33,34,59,0.0,0.04
1003,2737,27-09-2019 06:52:00,1,2896.0,2618.0,0.904,14.306,169,57,38,19,112,79,33,43,0.07,0.03
1003,2738,27-09-2019 06:54:00,1,2403.0,2149.0,0.894,11.848,0,0,0,0,0,0,0,23,0.0,0.0
1003,2739,27-09-2019 06:56:00,1,2391.0,2173.5,0.909,11.8275,0,0,0,0,0,0,0,27,0.0,0.0
1003,2740,27-09-2019 06:58:00,1,2379.0,2198.0,0.924,11.807,0,0,0,0,0,0,0,7,0.0,0.01
1003,2741,27-09-2019 07:00:00,1,2389.0,2184.0,0.914,11.829,0,0,0,0,0,0,0,0,0.0,0.0
1003,2742,27-09-2019 07:02:00,1,2290.0,2093.0,0.914,11.341,0,0,0,0,0,0,0,3,0.01,0.0
1003,2743,27-09-2019 07:04:00,1,2174.0,2057.0,0.946,10.841,0,0,0,0,0,0,0,1,0.0,0.0
1003,2744,27-09-2019 07:06:00,1,2162.0,2096.0,0.969,10.84,0,0,0,0,0,0,0,0,0.0,0.0
1003,2745,27-09-2019 07:08:00,1,2382.0,2207.0,0.926,11.827,83,38,30,8,45,37,8,32,0.05,0.0
1003,2746,27-09-2019 07:10:00,1,2681.0,2529.0,0.943,13.361,0,0,0,0,0,0,0,13,0.0,0.0
1003,2747,27-09-2019 07:12:00,1,2334.0,2398.0,1.028,11.849,0,0,0,0,0,0,0,0,0.0,0.0
1003,2748,27-09-2019 07:14:00,1,2343.0,2353.0,1.004,11.837,99,19,12,7,80,62,18,15,0.02,0.0
1003,2749,27-09-2019 07:16:00,1,2677.0,2516.0,0.94,13.335,136,54,35,19,82,41,41,49,0.0,0.0
1003,2750,27-09-2019 07:18:00,1,2832.0,2842.0,1.004,14.302,341,173,115,58,168,121,47,55,0.04,0.11
1003,2751,27-09-2019 07:20:00,1,2947.0,2930.0,0.994,14.854,227,95,62,33,132,88,44,36,0.08,0.0
1003,2752,27-09-2019 07:22:00,1,3058.0,2917.0,0.954,15.279,197,73,39,34,124,77,47,37,0.05,0.04
1003,2753,27-09-2019 07:24:00,1,3045.0,2999.0,0.985,15.317,248,99,61,38,149,99,50,54,0.08,0.04
1003,2754,27-09-2019 07:26:00,1,3054.0,2951.0,0.966,15.3,288,102,69,33,186,135,51,45,0.03,0.0
1003,2755,27-09-2019 07:28:00,1,2652.0,2613.0,0.985,13.343,0,0,0,0,0,0,0,32,0.0,0.01
1003,2756,27-09-2019 07:30:00,1,2505.5,2457.0,0.9805,12.5925,0,0,0,0,0,0,0,22,0.0,0.01
1003,2757,27-09-2019 07:32:00,1,2359.0,2301.0,0.976,11.842,0,0,0,0,0,0,0,0,0.0,0.0
1003,2758,27-09-2019 07:34:00,1,2175.0,2053.0,0.944,10.845,0,0,0,0,0,0,0,4,0.0,0.0
1003,2759,27-09-2019 07:36:00,1,2266.0,2196.0,0.969,11.357,0,0,0,0,0,0,0,0,0.0,0.0
1003,2760,27-09-2019 07:38:00,1,2373.0,2247.0,0.947,11.838,0,0,0,0,0,0,0,0,0.0,0.0
1003,2761,27-09-2019 07:40:00,1,2376.0,2252.0,0.948,11.853,0,0,0,0,0,0,0,0,0.0,0.0
1003,2762,27-09-2019 07:42:00,1,2262.0,2207.0,0.975,11.355,0,0,0,0,0,0,0,2,0.01,0.0
1003,2763,27-09-2019 07:44:00,1,2134.0,2187.0,1.025,10.83,0,0,0,0,0,0,0,5,0.0,0.0
1003,2764,27-09-2019 07:46:00,1,2339.0,2360.0,1.009,11.83,0,0,0,0,0,0,0,0,0.0,0.0
1003,2765,27-09-2019 07:48:00,1,2366.0,2309.0,0.976,11.88,143,42,31,11,101,84,17,9,0.0,0.0
1003,2766,27-09-2019 07:50:00,1,2327.0,2423.0,1.041,11.851,21,10,5,5,11,6,5,11,0.0,0.0
1003,2767,27-09-2019 07:52:00,1,2350.0,2363.0,1.006,11.874,0,0,0,0,0,0,0,0,0.0,0.0
1003,2768,27-09-2019 07:54:00,1,2345.0,2331.0,0.994,11.821,0,0,0,0,0,0,0,1,0.0,0.0
1003,2769,27-09-2019 07:56:00,1,2231.0,2283.0,1.023,11.317,0,0,0,0,0,0,0,0,0.0,0.0
1003,2770,27-09-2019 07:58:00,1,2134.0,2202.0,1.032,10.847,0,0,0,0,0,0,0,6,0.0,0.0
1003,2771,27-09-2019 08:00:00,1,2144.0,2206.0,1.029,10.887,0,0,0,0,0,0,0,4,0.0,0.0
1003,2772,27-09-2019 08:02:00,1,2154.0,2143.0,0.995,10.858,0,0,0,0,0,0,0,0,0.0,0.0
1003,2773,27-09-2019 08:04:00,1,2049.0,2087.0,1.02,10.3825,0,0,0,0,0,0,0,0,0.0,0.0
1003,2774,27-09-2019 08:06:00,1,1944.0,2031.0,1.045,9.907,0,0,0,0,0,0,0,0,0.0,0.0
1003,2775,27-09-2019 08:08:00,1,2055.0,2052.0,0.998,10.369,0,0,0,0,0,0,0,4,0.0,0.0
1003,2776,27-09-2019 08:10:00,1,2061.0,2036.0,0.988,10.373,0,0,0,0,0,0,0,14,0.0,0.0
1003,2777,27-09-2019 08:12:00,1,2160.0,2099.0,0.972,10.833,6,4,2,2,2,0,2,15,0.0,0.0
1003,2778,27-09-2019 08:14:00,1,2127.0,2216.0,1.042,10.835,9,6,4,2,3,1,2,45,0.01,0.0
1003,2779,27-09-2019 08:16:00,1,2353.0,2324.0,0.987,11.845,125,51,29,22,74,50,24,42,0.0,0.02
1003,2780,27-09-2019 08:18:00,1,2540.0,2562.0,1.009,12.843,200,21,2,19,179,134,45,25,0.0,0.02
1003,2781,27-09-2019 08:20:00,1,2837.0,2859.0,1.008,14.342,209,18,2,16,191,139,52,23,0.0,0.04
1003,2782,27-09-2019 08:22:00,1,2808.0,2927.0,1.043,14.303,160,11,2,9,149,103,46,2,0.0,0.27
1003,2783,27-09-2019 08:24:00,1,2320.0,2443.0,1.053,11.844,101,1,0,1,100,59,41,0,0.0,0.01
1003,2784,27-09-2019 08:26:00,1,2337.0,2368.0,1.013,11.829,345,73,52,21,272,218,54,17,0.17,0.0
1003,2785,27-09-2019 08:28:00,1,2551.0,2537.0,0.994,12.861,0,0,0,0,0,0,0,23,0.0,0.0
1003,2786,27-09-2019 08:30:00,1,2354.0,2310.0,0.981,11.831,0,0,0,0,0,0,0,15,0.03,0.0
1003,2787,27-09-2019 08:32:00,1,2343.0,2347.0,1.002,11.831,0,0,0,0,0,0,0,0,0.0,0.0
1003,2788,27-09-2019 08:34:00,1,2362.0,2283.0,0.967,11.833,0,0,0,0,0,0,0,1,0.0,0.01
1003,2789,27-09-2019 08:36:00,1,2145.0,2188.0,1.02,10.872,0,0,0,0,0,0,0,0,0.0,0.0
1003,2790,27-09-2019 08:38:00,1,2158.0,2132.0,0.988,10.8615,0,0,0,0,0,0,0,2,0.0,0.0
1003,2791,27-09-2019 08:40:00,1,2171.0,2076.0,0.956,10.851,0,0,0,0,0,0,0,0,0.0,0.0
1003,2792,27-09-2019 08:42:00,1,1950.0,1977.0,1.013,9.873,0,0,0,0,0,0,0,0,0.0,0.0
1003,2793,27-09-2019 08:44:00,1,1841.0,1928.0,1.047,9.389,75,41,33,8,34,24,10,6,0.0,0.0
1003,2794,27-09-2019 08:46:00,1,2140.0,2181.0,1.019,10.845,10,9,1,8,1,0,1,0,0.0,0.0
1003,2795,27-09-2019 08:48:00,1,2343.0,2319.0,0.99,11.799,73,39,31,8,34,22,12,1,0.01,0.0
1003,2796,27-09-2019 08:50:00,1,2334.0,2420.0,1.037,11.876,258,25,11,14,233,178,55,22,0.06,0.11
1003,2797,27-09-2019 08:52:00,1,2646.0,2624.0,0.992,13.331,203,6,0,6,197,146,51,15,0.0,0.0
1003,2798,27-09-2019 08:54:00,1,2822.0,2904.0,1.029,14.333,221,105,72,33,116,75,41,41,0.03,0.0
1003,2799,27-09-2019 08:56:00,1,2829.0,2877.0,1.017,14.331,178,83,54,29,95,58,37,33,0.04,0.0
1003,2800,27-09-2019 08:58:00,1,3023.0,2997.0,0.991,15.23,271,78,43,35,193,170,23,50,0.0,0.0
1003,2801,27-09-2019 09:00:00,1,2814.0,2905.0,1.032,14.303,243,121,86,35,122,105,17,71,0.1,0.0
1003,2802,27-09-2019 09:02:00,1,2827.0,2848.0,1.007,14.291,696,250,197,53,446,391,55,31,0.0,0.0
1003,2803,27-09-2019 09:04:00,1,2134.0,2172.0,1.018,10.812,549,234,187,47,315,276,39,13,0.0,0.01
1003,2804,27-09-2019 09:06:00,1,3039.0,3037.0,0.999,15.337,69,22,13,9,47,44,3,36,0.0,0.07
1003,2805,27-09-2019 09:08:00,1,2545.0,2557.0,1.005,12.859,7,4,0,4,3,2,1,18,0.0,0.0
1003,2806,27-09-2019 09:10:00,1,2321.0,2423.0,1.044,11.827,0,0,0,0,0,0,0,0,0.0,0.0
1003,2807,27-09-2019 09:12:00,1,2330.0,2397.0,1.029,11.834,0,0,0,0,0,0,0,0,0.0,0.0
1003,2808,27-09-2019 09:14:00,1,2339.0,2371.0,1.014,11.841,0,0,0,0,0,0,0,3,0.0,0.0
1003,2809,27-09-2019 09:16:00,1,2344.0,2354.0,1.004,11.839,0,0,0,0,0,0,0,0,0.0,0.0
1003,2810,27-09-2019 09:18:00,1,2376.0,2297.0,0.967,11.904,0,0,0,0,0,0,0,4,0.0,0.0
1003,2811,27-09-2019 09:20:00,1,2326.0,2420.0,1.041,11.842,0,0,0,0,0,0,0,0,0.0,0.0
1003,2812,27-09-2019 09:22:00,1,2335.0,2400.0,1.028,11.857,0,0,0,0,0,0,0,2,0.0,0.0
1003,2813,27-09-2019 09:24:00,1,2330.0,2394.0,1.028,11.831,0,0,0,0,0,0,0,8,0.0,0.0
1003,2814,27-09-2019 09:26:00,1,2339.0,2370.0,1.013,11.84,0,0,0,0,0,0,0,9,0.0,0.0
1003,2815,27-09-2019 09:28:00,1,2115.0,2282.0,1.079,10.861,0,0,0,0,0,0,0,3,0.0,0.0
1003,2816,27-09-2019 09:30:00,1,2119.0,2266.0,1.069,10.858,0,0,0,0,0,0,0,0,0.0,0.0
1003,2817,27-09-2019 09:32:00,1,2140.0,2220.0,1.038,10.888,0,0,0,0,0,0,0,0,0.0,0.0
1003,2818,27-09-2019 09:34:00,1,2143.0,2182.0,1.018,10.86,0,0,0,0,0,0,0,0,0.0,0.0
1003,2819,27-09-2019 09:36:00,1,2159.0,2134.0,0.989,10.869,0,0,0,0,0,0,0,1,0.0,0.0
1003,2820,27-09-2019 09:38:00,1,2128.0,2240.0,1.052,10.865,0,0,0,0,0,0,0,1,0.0,0.0
1003,2821,27-09-2019 09:40:00,1,2146.0,2168.0,1.01,10.856,0,0,0,0,0,0,0,0,0.0,0.0
1003,2822,27-09-2019 09:42:00,1,2160.0,2131.0,0.986,10.871,0,0,0,0,0,0,0,17,0.0,0.0
1003,2823,27-09-2019 09:44:00,1,2155.0,2143.0,0.994,10.864,4,2,0,2,2,0,2,17,0.0,0.0
1003,2824,27-09-2019 09:46:00,1,2136.5,2202.5,1.031,10.8565,176,46,26,20,130,117,13,49,0.01,0.0
1003,2825,27-09-2019 09:48:00,1,2118.0,2262.0,1.068,10.849,272,21,4,17,251,240,11,29,0.0,0.0
1003,2826,27-09-2019 09:50:00,1,2309.0,2480.0,1.074,11.841,168,17,1,16,151,128,23,11,0.0,0.0
1003,2827,27-09-2019 09:52:00,1,2836.0,2834.0,0.999,14.311,116,21,2,19,95,82,13,9,0.0,0.0
1003,2828,27-09-2019 09:54:00,1,2836.0,2850.0,1.005,14.328,132,48,27,21,84,76,8,26,0.0,0.0
1003,2829,27-09-2019 09:56:00,1,2638.0,2620.0,0.993,13.295,162,41,18,23,121,111,10,19,0.0,0.03
1003,2830,27-09-2019 09:58:00,1,2817.0,2917.0,1.036,14.327,86,24,13,11,62,56,6,47,0.11,0.02
1003,2831,27-09-2019 10:00:00,1,1947.0,2026.0,1.041,9.914,0,0,0,0,0,0,0,16,0.0,0.01
1003,2832,27-09-2019 10:02:00,1,1838.0,1892.0,1.03,9.334,0,0,0,0,0,0,0,11,0.0,0.0
1003,2833,27-09-2019 10:04:00,1,2161.0,2105.0,0.974,10.845,0,0,0,0,0,0,0,2,0.0,0.0
1003,2834,27-09-2019 10:06:00,1,2159.0,2136.0,0.99,10.871,0,0,0,0,0,0,0,2,0.0,0.0
1003,2835,27-09-2019 10:08:00,1,2338.0,2356.0,1.008,11.82,0,0,0,0,0,0,0,0,0.0,0.0
1003,2836,27-09-2019 10:10:00,1,2342.0,2369.0,1.011,11.848,0,0,0,0,0,0,0,0,0.0,0.0
1003,2837,27-09-2019 10:12:00,1,2339.0,2380.0,1.018,11.85,0,0,0,0,0,0,0,1,0.0,0.0
1003,2838,27-09-2019 10:14:00,1,2353.0,2317.0,0.985,11.836,0,0,0,0,0,0,0,0,0.0,0.0
1003,2839,27-09-2019 10:16:00,1,2133.0,2206.0,1.034,10.847,0,0,0,0,0,0,0,1,0.0,0.0
1003,2840,27-09-2019 10:18:00,1,2119.0,2243.0,1.059,10.831,0,0,0,0,0,0,0,1,0.0,0.0
1003,2841,27-09-2019 10:20:00,1,2136.5,2192.5,1.0265,10.845,0,0,0,0,0,0,0,1,0.0,0.01
1003,2842,27-09-2019 10:22:00,1,2154.0,2142.0,0.994,10.859,0,0,0,0,0,0,0,6,0.0,0.0
1003,2843,27-09-2019 10:24:00,1,2045.0,2076.0,1.015,10.354,0,0,0,0,0,0,0,1,0.0,0.0
1003,2844,27-09-2019 10:26:00,1,1945.0,2005.0,1.031,9.881,0,0,0,0,0,0,0,2,0.0,0.0
1003,2845,27-09-2019 10:28:00,1,2157.0,2131.0,0.988,10.856,0,0,0,0,0,0,0,0,0.0,0.0
1003,2846,27-09-2019 10:30:00,1,2041.0,2095.0,1.026,10.362,0,0,0,0,0,0,0,0,0.0,0.0
1003,2847,27-09-2019 10:32:00,1,2044.0,2096.0,1.025,10.374,0,0,0,0,0,0,0,0,0.0,0.0
1003,2848,27-09-2019 10:34:00,1,2042.0,2098.0,1.027,10.369,0,0,0,0,0,0,0,0,0.0,0.0
1003,2849,27-09-2019 10:36:00,1,2155.0,2161.0,1.003,10.881,0,0,0,0,0,0,0,1,0.0,0.0
1003,2850,27-09-2019 10:38:00,1,2032.0,2132.0,1.049,10.365,17,11,5,6,6,1,5,22,0.0,0.0
1003,2851,27-09-2019 10:40:00,1,1921.0,2065.0,1.075,9.855,0,0,0,0,0,0,0,0,0.0,0.0
1003,2852,27-09-2019 10:42:00,1,1938.0,2026.0,1.045,9.878,0,0,0,0,0,0,0,0,0.0,0.0
1003,2853,27-09-2019 10:44:00,1,1820.0,2013.0,1.106,9.399,0,0,0,0,0,0,0,0,0.0,0.0
1003,2854,27-09-2019 10:46:00,1,1830.0,1972.0,1.078,9.392,0,0,0,0,0,0,0,2,0.0,0.0
1003,2855,27-09-2019 10:48:00,1,1820.0,2016.0,1.108,9.404,0,0,0,0,0,0,0,13,0.0,0.0
1003,2856,27-09-2019 10:50:00,1,2037.0,2125.0,1.043,10.376,0,0,0,0,0,0,0,1,0.0,0.01
1003,2857,27-09-2019 10:52:00,1,2155.0,2141.0,0.994,10.86,0,0,0,0,0,0,0,0,0.0,0.0
1003,2858,27-09-2019 10:54:00,1,2101.0,2121.0,1.01,10.626,0,0,0,0,0,0,0,1,0.0,0.0
1003,2859,27-09-2019 10:56:00,1,2047.0,2101.0,1.026,10.392,0,0,0,0,0,0,0,0,0.0,0.0
1003,2860,27-09-2019 10:58:00,1,1839.0,1926.0,1.047,9.376,0,0,0,0,0,0,0,5,0.0,0.0
1003,2861,27-09-2019 11:00:00,1,1843.0,1914.0,1.039,9.379,206,70,47,23,136,112,24,27,0.0,0.01
1003,2862,27-09-2019 11:02:00,1,2047.0,2073.0,1.013,10.359,0,0,0,0,0,0,0,0,0.0,0.0
1003,2863,27-09-2019 11:04:00,1,1741.0,1812.0,1.041,8.867,0,0,0,0,0,0,0,0,0.0,0.0
1003,2864,27-09-2019 11:06:00,1,1647.0,1722.0,1.046,8.395,0,0,0,0,0,0,0,0,0.0,0.0
1003,2865,27-09-2019 11:08:00,1,1666.0,1662.0,0.998,8.404,0,0,0,0,0,0,0,9,0.0,0.0
1003,2866,27-09-2019 11:10:00,1,1636.0,1744.0,1.067,8.375,0,0,0,0,0,0,0,0,0.0,0.0
1003,2867,27-09-2019 11:12:00,1,1757.0,1792.0,1.02,8.908,0,0,0,0,0,0,0,2,0.0,0.0
1003,2868,27-09-2019 11:14:00,1,1860.0,1853.0,0.996,9.378,0,0,0,0,0,0,0,1,0.0,0.0
1003,2869,27-09-2019 11:16:00,1,1848.0,1889.0,1.022,9.373,0,0,0,0,0,0,0,4,0.0,0.0
1003,2870,27-09-2019 11:18:00,1,2154.0,2117.0,0.982,10.832,0,0,0,0,0,0,0,0,0.0,0.0
1003,2871,27-09-2019 11:20:00,1,2101.0,2308.0,1.099,10.832,0,0,0,0,0,0,0,0,0.0,0.0
1003,2872,27-09-2019 11:22:00,1,2108.0,2300.0,1.091,10.853,0,0,0,0,0,0,0,0,0.0,0.0
1003,2873,27-09-2019 11:24:00,1,2041.0,2127.0,1.042,10.395,0,0,0,0,0,0,0,7,0.0,0.0
1003,2874,27-09-2019 11:26:00,1,1926.0,2049.0,1.064,9.856,0,0,0,0,0,0,0,2,0.0,0.0
1003,2875,27-09-2019 11:28:00,1,1785.5,1895.0,1.061,9.1325,0,0,0,0,0,0,0,0,0.0,0.0
1003,2876,27-09-2019 11:30:00,1,1645.0,1741.0,1.058,8.409,0,0,0,0,0,0,0,0,0.0,0.0
1003,2877,27-09-2019 11:32:00,1,1645.0,1718.0,1.044,8.382,0,0,0,0,0,0,0,0,0.0,0.0
1003,2878,27-09-2019 11:34:00,1,1648.0,1721.0,1.044,8.398,0,0,0,0,0,0,0,0,0.0,0.0
1003,2879,27-09-2019 11:36:00,1,1641.0,1732.0,1.055,8.385,0,0,0,0,0,0,0,0,0.0,0.0
1003,2880,27-09-2019 11:38:00,1,1637.0,1753.0,1.07,8.392,0,0,0,0,0,0,0,0,0.0,0.0
1003,2881,27-09-2019 11:40:00,1,1861.0,1882.0,1.011,9.415,0,0,0,0,0,0,0,9,0.0,0.0
1003,2882,27-09-2019 11:42:00,1,1819.0,1986.0,1.091,9.366,2,1,1,0,1,0,1,40,0.0,0.0
1003,2883,27-09-2019 11:44:00,1,2147.0,2164.0,1.008,10.854,0,0,0,0,0,0,0,59,0.0,0.0
1003,2884,27-09-2019 11:46:00,1,1918.0,2089.0,1.09,9.868,0,0,0,0,0,0,0,13,0.0,0.0
1003,2885,27-09-2019 11:48:00,1,1813.0,2016.0,1.112,9.376,0,0,0,0,0,0,0,11,0.0,0.0
1003,2886,27-09-2019 11:50:00,1,1839.0,1930.0,1.049,9.382,86,30,17,13,56,45,11,12,0.0,0.0
1003,2887,27-09-2019 11:52:00,1,2323.0,2460.0,1.059,11.874,94,22,2,20,72,59,13,7,0.0,0.0
1003,2888,27-09-2019 11:54:00,1,2624.0,2668.0,1.017,13.294,102,23,9,14,79,70,9,17,0.0,0.04
1003,2889,27-09-2019 11:56:00,1,2833.0,2843.0,1.004,14.308,228,30,2,28,198,171,27,13,0.0,0.0
1003,2890,27-09-2019 11:58:00,1,2794.0,2985.0,1.068,14.312,107,12,2,10,95,78,17,7,0.0,0.05
1003,2891,27-09-2019 12:00:00,1,2819.0,2928.0,1.039,14.348,181,24,2,22,157,137,20,9,0.0,0.05
1003,2892,27-09-2019 12:02:00,1,2802.5,2965.0,1.058,14.3245,108,26,10,16,82,67,15,7,0.19,0.06
1003,2893,27-09-2019 12:04:00,1,2786.0,3002.0,1.077,14.301,108,26,4,22,82,69,13,10,0.03,0.04
1003,2894,27-09-2019 12:06:00,1,2620.0,2747.0,1.049,13.361,314,145,102,43,169,150,19,23,0.0,0.0
1003,2895,27-09-2019 12:08:00,1,3005.0,3171.0,1.055,15.351,94,23,2,21,71,57,14,4,0.0,0.07
1003,2896,27-09-2019 12:10:00,1,2995.0,3144.0,1.05,15.279,402,127,90,37,275,247,28,24,0.08,0.03
1003,2897,27-09-2019 12:12:00,1,2120.0,2252.0,1.062,10.847,468,282,219,63,186,136,50,0,0.0,0.0
1003,2898,27-09-2019 12:14:00,1,2177.0,2050.0,0.942,10.846,652,227,180,47,425,370,55,12,0.0,0.04
1003,2899,27-09-2019 12:16:00,1,3042.0,3017.0,0.992,15.326,130,30,1,29,100,73,27,10,0.0,0.0
1003,2900,27-09-2019 12:18:00,1,3416.0,3487.0,1.021,17.318,155,19,3,16,136,118,18,2,0.07,0.06
1003,2901,27-09-2019 12:20:00,1,3306.0,3323.0,1.005,16.703,417,199,162,37,218,179,39,40,0.01,0.02
1003,2902,27-09-2019 12:22:00,1,2669.0,2605.0,0.976,13.399,0,0,0,0,0,0,0,19,0.0,0.0
1003,2903,27-09-2019 12:24:00,1,2237.0,2274.0,1.017,11.331,0,0,0,0,0,0,0,23,0.0,0.0
1003,2904,27-09-2019 12:26:00,1,2342.0,2397.0,1.023,11.88,0,0,0,0,0,0,0,25,0.0,0.0
1003,2905,27-09-2019 12:28:00,1,2638.0,2661.0,1.009,13.339,0,0,0,0,0,0,0,16,0.01,0.0
1003,2906,27-09-2019 12:30:00,1,2835.0,2829.0,0.998,14.302,0,0,0,0,0,0,0,21,0.0,0.0
1003,2907,27-09-2019 12:32:00,1,3027.0,3032.0,1.002,15.281,3,2,1,1,1,0,1,41,0.0,0.0
1003,2908,27-09-2019 12:34:00,1,2810.0,2943.0,1.047,14.329,0,0,0,0,0,0,0,30,0.0,0.0
1003,2909,27-09-2019 12:36:00,1,2818.0,2905.0,1.031,14.3185,0,0,0,0,0,0,0,7,0.0,0.0
1003,2910,27-09-2019 12:38:00,1,2826.0,2867.0,1.015,14.308,0,0,0,0,0,0,0,0,0.0,0.0
1003,2911,27-09-2019 12:40:00,1,2857.0,2733.0,0.957,14.282,0,0,0,0,0,0,0,0,0.0,0.0
1003,2912,27-09-2019 12:42:00,1,2644.0,2622.0,0.992,13.322,0,0,0,0,0,0,0,6,0.0,0.0
1003,2913,27-09-2019 12:44:00,1,2658.0,2572.0,0.968,13.321,0,0,0,0,0,0,0,0,0.0,0.0
1003,2914,27-09-2019 12:46:00,1,2546.0,2533.0,0.995,12.837,0,0,0,0,0,0,0,0,0.0,0.0
1003,2915,27-09-2019 12:48:00,1,2311.0,2483.0,1.075,11.854,0,0,0,0,0,0,0,3,0.01,0.0
1003,2916,27-09-2019 12:50:00,1,2320.0,2464.0,1.062,11.869,0,0,0,0,0,0,0,7,0.0,0.0
1004,1,23-09-2019 11:40:00,1,4348.0,3293.0,0.757,20.779,72,40,25,15,32,7,25,3,0.01,0.0
1004,2,23-09-2019 11:42:00,1,4251.0,3138.0,0.738,20.226,19,11,6,5,8,2,6,0,0.0,0.0
1004,3,23-09-2019 11:44:00,1,4082.0,2955.0,0.723,19.3565,9,7,5,2,2,0,2,0,0.0,0.0
1004,4,23-09-2019 11:46:00,1,3913.0,2772.0,0.708,18.487,10,8,3,5,2,0,2,0,0.01,0.0
1004,5,23-09-2019 11:48:00,1,3574.0,2644.0,0.74,17.01,9,4,1,3,5,0,5,0,0.0,0.0
1004,6,23-09-2019 11:50:00,1,3394.0,2509.0,0.739,16.151,2,0,0,0,2,0,2,0,0.0,0.0
1004,7,23-09-2019 11:52:00,1,3416.0,2458.0,0.72,16.179,6,1,0,1,5,0,5,0,0.0,0.0
1004,8,23-09-2019 11:54:00,1,3402.0,2409.0,0.708,16.073,7,6,2,4,1,0,1,0,0.0,0.0
1004,9,23-09-2019 11:56:00,1,3417.0,2397.0,0.702,16.118,6,4,0,4,2,0,2,0,0.0,0.0
1004,10,23-09-2019 11:58:00,1,3219.0,2260.0,0.702,15.185,22,16,4,12,6,0,6,0,0.0,0.0
1004,11,23-09-2019 12:00:00,1,3422.0,2380.0,0.696,16.119,55,36,16,20,19,7,12,7,0.0,0.0
1004,12,23-09-2019 12:02:00,1,3775.0,2746.0,0.727,17.913,97,63,37,26,34,18,16,2,0.0,0.0
1004,13,23-09-2019 12:04:00,1,3571.0,2676.0,0.749,17.035,106,68,48,20,38,19,19,1,0.0,0.0
1004,14,23-09-2019 12:06:00,1,3896.0,2795.0,0.717,18.447,54,40,21,19,14,3,11,4,0.0,0.0
1004,15,23-09-2019 12:08:00,1,3680.0,2707.0,0.736,17.495,61,51,26,25,10,2,8,0,0.0,0.0
1004,16,23-09-2019 12:10:00,1,3906.0,2764.0,0.708,18.451,30,25,7,18,5,2,3,5,0.0,0.0
1004,17,23-09-2019 12:12:00,1,3585.0,2645.0,0.738,17.056,11,3,0,3,8,1,7,0,0.0,0.0
1004,18,23-09-2019 12:14:00,1,3592.0,2613.0,0.727,17.048,10,2,1,1,8,0,8,0,0.0,0.0
1004,19,23-09-2019 12:16:00,1,3202.0,2320.0,0.724,15.187,6,6,3,3,0,0,0,0,0.0,0.0
1004,20,23-09-2019 12:18:00,1,2959.0,2137.5,0.722,14.026,7,7,3,4,0,0,0,0,0.0,0.0
1004,21,23-09-2019 12:20:00,1,2716.0,1955.0,0.72,12.865,5,5,2,3,0,0,0,0,0.0,0.0
1004,22,23-09-2019 12:22:00,1,2741.0,1908.0,0.696,12.912,0,0,0,0,0,0,0,0,0.0,0.0
1004,23,23-09-2019 12:24:00,1,2752.0,1842.0,0.669,12.885,17,15,6,9,2,0,2,0,0.0,0.0
1004,24,23-09-2019 12:26:00,1,2721.0,1946.0,0.715,12.877,0,0,0,0,0,0,0,0,0.0,0.0
1004,25,23-09-2019 12:28:00,1,2748.0,1869.0,0.68,12.897,0,0,0,0,0,0,0,0,0.0,0.0
1004,26,23-09-2019 12:30:00,1,2751.0,1849.0,0.672,12.885,0,0,0,0,0,0,0,0,0.0,0.0
1004,27,23-09-2019 12:32:00,1,2753.0,1838.0,0.668,12.882,0,0,0,0,0,0,0,0,0.0,0.0
1004,28,23-09-2019 12:34:00,1,2642.0,1811.0,0.685,12.417,10,9,4,5,1,0,1,0,0.0,0.0
1004,29,23-09-2019 12:36:00,1,2756.0,1851.0,0.672,12.908,40,34,18,16,6,2,4,0,0.0,0.0
1004,30,23-09-2019 12:38:00,1,3215.0,2279.0,0.709,15.192,2,1,0,1,1,1,0,0,0.0,0.0
1004,31,23-09-2019 12:40:00,1,3215.0,2290.0,0.712,15.204,1,0,0,0,1,0,1,0,0.0,0.0
1004,32,23-09-2019 12:42:00,1,3225.0,2253.0,0.699,15.201,22,11,0,11,11,0,11,0,0.0,0.0
1004,33,23-09-2019 12:44:00,1,3230.0,2237.0,0.693,15.204,11,2,0,2,9,0,9,0,0.0,0.0
1004,34,23-09-2019 12:46:00,1,3241.0,2197.0,0.678,15.205,2,1,0,1,1,0,1,0,0.0,0.0
1004,35,23-09-2019 12:48:00,1,3125.0,2186.0,0.699,14.734,6,1,0,1,5,1,4,0,0.0,0.0
1004,36,23-09-2019 12:50:00,1,3145.0,2173.0,0.691,14.799,2,0,0,0,2,0,2,0,0.0,0.0
1004,37,23-09-2019 12:52:00,1,3043.5,2102.5,0.691,14.32,1,0,0,0,1,0,1,0,0.0,0.0
1004,38,23-09-2019 12:54:00,1,2942.0,2032.0,0.691,13.841,2,0,0,0,2,0,2,0,0.0,0.0
1004,39,23-09-2019 12:56:00,1,2739.0,1868.0,0.682,12.86,7,3,2,1,4,0,4,0,0.0,0.0
1004,40,23-09-2019 12:58:00,1,2629.0,1851.0,0.704,12.409,0,0,0,0,0,0,0,0,0.0,0.0
1004,41,23-09-2019 13:00:00,1,2753.0,1889.0,0.686,12.939,3,0,0,0,3,0,3,0,0.0,0.0
1004,42,23-09-2019 13:02:00,1,2734.0,1936.0,0.708,12.918,0,0,0,0,0,0,0,0,0.0,0.0
1004,43,23-09-2019 13:04:00,1,2725.0,1958.0,0.718,12.902,2,1,1,0,1,0,1,0,0.0,0.0
1004,44,23-09-2019 13:06:00,1,2732.0,1917.0,0.702,12.886,1,1,0,1,0,0,0,0,0.0,0.0
1004,45,23-09-2019 13:08:00,1,2733.0,1940.0,0.71,12.918,3,0,0,0,3,2,1,0,0.0,0.0
1004,46,23-09-2019 13:10:00,1,2728.0,1958.0,0.718,12.916,1,0,0,0,1,0,1,0,0.0,0.0
1004,47,23-09-2019 13:12:00,1,2715.0,1946.0,0.717,12.853,0,0,0,0,0,0,0,0,0.0,0.0
1004,48,23-09-2019 13:14:00,1,2942.0,2011.0,0.684,13.817,1,0,0,0,1,0,1,0,0.0,0.0
1004,49,23-09-2019 13:16:00,1,2946.0,1989.0,0.675,13.809,0,0,0,0,0,0,0,0,0.0,0.0
1004,50,23-09-2019 13:18:00,1,2945.0,1994.0,0.677,13.812,1,0,0,0,1,0,1,0,0.0,0.0
1004,51,23-09-2019 13:20:00,1,2841.0,1962.0,0.69,13.368,0,0,0,0,0,0,0,0,0.0,0.0
1004,52,23-09-2019 13:22:00,1,2740.0,1873.0,0.684,12.868,0,0,0,0,0,0,0,0,0.0,0.0
1004,53,23-09-2019 13:24:00,1,2646.0,1839.0,0.695,12.464,30,20,6,14,10,0,10,0,0.0,0.0
1004,54,23-09-2019 13:26:00,1,2841.0,1974.0,0.695,13.38,11,5,3,2,6,0,6,0,0.0,0.0
1004,55,23-09-2019 13:28:00,1,3036.0,2109.0,0.695,14.296,4,4,1,3,0,0,0,0,0.0,0.0
1004,56,23-09-2019 13:30:00,1,3140.0,2176.0,0.693,14.783,28,17,5,12,11,1,10,0,0.0,0.0
1004,57,23-09-2019 13:32:00,1,3333.0,2262.0,0.679,15.637,0,0,0,0,0,0,0,0,0.0,0.0
1004,58,23-09-2019 13:34:00,1,3134.0,2185.0,0.697,14.768,7,3,0,3,4,0,4,0,0.0,0.0
1004,59,23-09-2019 13:36:00,1,3015.0,2146.0,0.712,14.256,0,0,0,0,0,0,0,0,0.0,0.0
1004,60,23-09-2019 13:38:00,1,3016.0,2146.0,0.712,14.261,6,6,0,6,0,0,0,0,0.0,0.0
1004,61,23-09-2019 13:40:00,1,3029.0,2135.0,0.705,14.3,4,1,0,1,3,0,3,0,0.0,0.0
1004,62,23-09-2019 13:42:00,1,3055.0,2066.0,0.676,14.324,1,1,0,1,0,0,0,0,0.0,0.0
1004,63,23-09-2019 13:44:00,1,2852.0,1927.0,0.676,13.372,1,1,0,1,0,0,0,0,0.0,0.0
1004,64,23-09-2019 13:46:00,1,2944.0,2005.0,0.681,13.819,2,2,1,1,0,0,0,0,0.0,0.0
1004,65,23-09-2019 13:48:00,1,2940.0,2003.0,0.681,13.8,7,6,0,6,1,1,0,0,0.0,0.0
1004,66,23-09-2019 13:50:00,1,2844.0,1934.0,0.68,13.346,6,6,2,4,0,0,0,0,0.0,0.0
1004,67,23-09-2019 13:52:00,1,2845.0,1968.0,0.692,13.39,4,4,0,4,0,0,0,0,0.0,0.0
1004,68,23-09-2019 13:54:00,1,2830.0,1984.0,0.701,13.347,1,1,0,1,0,0,0,0,0.0,0.0
1004,69,23-09-2019 13:56:00,1,2832.0,1995.0,0.704,13.368,7,3,1,2,4,2,2,0,0.0,0.0
1004,70,23-09-2019 13:58:00,1,2943.0,2015.0,0.685,13.827,17,17,1,16,0,0,0,0,0.0,0.0
1004,71,23-09-2019 14:00:00,1,2943.0,2018.0,0.686,13.8295,5,4,0,4,1,0,1,0,0.0,0.0
1004,72,23-09-2019 14:02:00,1,2943.0,2021.0,0.687,13.832,1,1,0,1,0,0,0,0,0.0,0.0
1004,73,23-09-2019 14:04:00,1,2842.0,1984.0,0.698,13.395,7,4,1,3,3,0,3,0,0.0,0.0
1004,74,23-09-2019 14:06:00,1,2844.0,1959.0,0.689,13.374,4,2,0,2,2,0,2,0,0.0,0.0
1004,75,23-09-2019 14:08:00,1,2831.0,1925.0,0.68,13.287,3,2,1,1,1,0,1,0,0.0,0.0
1004,76,23-09-2019 14:10:00,1,2857.0,1901.0,0.665,13.363,0,0,0,0,0,0,0,0,0.0,0.0
1004,77,23-09-2019 14:12:00,1,2667.0,1723.0,0.646,12.415,9,8,0,8,1,0,1,0,0.0,0.0
1004,78,23-09-2019 14:14:00,1,2667.0,1712.0,0.642,12.405,0,0,0,0,0,0,0,0,0.0,0.0
1004,79,23-09-2019 14:16:00,1,2678.0,1718.0,0.641,12.455,9,6,0,6,3,0,3,0,0.0,0.0
1004,80,23-09-2019 14:18:00,1,2747.0,1852.0,0.674,12.875,3,1,0,1,2,0,2,0,0.0,0.0
1004,81,23-09-2019 14:20:00,1,2754.0,1848.0,0.671,12.895,1,1,0,1,0,0,0,0,0.0,0.0
1004,82,23-09-2019 14:22:00,1,2865.0,1863.0,0.65,13.349,0,0,0,0,0,0,0,0,0.0,0.0
1004,83,23-09-2019 14:24:00,1,2856.0,1912.0,0.67,13.369,3,2,0,2,1,0,1,0,0.0,0.0
1004,84,23-09-2019 14:26:00,1,2861.0,1897.0,0.663,13.372,1,1,0,1,0,0,0,0,0.0,0.0
1004,85,23-09-2019 14:28:00,1,2848.0,1927.0,0.676,13.356,53,41,26,15,12,3,9,0,0.0,0.0
1004,86,23-09-2019 14:30:00,1,3033.0,2127.0,0.701,14.307,53,29,9,20,24,12,12,0,0.0,0.0
1004,87,23-09-2019 14:32:00,1,3018.0,2140.0,0.709,14.263,30,21,4,17,9,2,7,0,0.0,0.0
1004,88,23-09-2019 14:34:00,1,3271.5,2294.5,0.702,15.432,79,56,31,25,23,10,13,10,0.0,0.0
1004,89,23-09-2019 14:36:00,1,3525.0,2449.0,0.695,16.601,76,52,17,35,24,5,19,8,0.0,0.0
1004,90,23-09-2019 14:38:00,1,3529.0,2460.0,0.697,16.628,40,23,2,21,17,2,15,0,0.0,0.0
1004,91,23-09-2019 14:40:00,1,3524.0,2486.0,0.706,16.636,60,46,20,26,14,4,10,7,0.0,0.0
1004,92,23-09-2019 14:42:00,1,3313.0,2387.0,0.721,15.698,87,51,40,11,36,11,25,7,0.0,0.0
1004,93,23-09-2019 14:44:00,1,2835.0,1966.0,0.693,13.347,172,78,62,16,94,63,31,19,0.0,0.0
1004,94,23-09-2019 14:46:00,1,3302.0,2378.0,0.72,15.644,125,60,40,20,65,34,31,3,0.0,0.0
1004,95,23-09-2019 14:48:00,1,3426.0,2398.0,0.7,16.153,93,51,30,21,42,22,20,5,0.0,0.0
1004,96,23-09-2019 14:50:00,1,3504.0,2430.0,0.693,16.498,38,25,4,21,13,3,10,0,0.0,0.0
1004,97,23-09-2019 14:52:00,1,3530.0,2468.0,0.699,16.642,66,31,9,22,35,0,35,0,0.0,0.0
1004,98,23-09-2019 14:54:00,1,3524.0,2441.0,0.693,16.588,64,56,27,29,8,0,8,0,0.0,0.0
1004,99,23-09-2019 14:56:00,1,3330.0,2301.0,0.691,15.67,11,11,1,10,0,0,0,0,0.0,0.0
1004,100,23-09-2019 14:58:00,1,3123.0,2238.0,0.717,14.781,8,8,0,8,0,0,0,0,0.0,0.0
1004,101,23-09-2019 15:00:00,1,3018.0,2149.0,0.712,14.271,2,2,0,2,0,0,0,0,0.0,0.0
1004,102,23-09-2019 15:02:00,1,2938.0,2040.0,0.695,13.835,4,0,0,0,4,2,2,0,0.0,0.0
1004,103,23-09-2019 15:04:00,1,2834.0,1989.0,0.702,13.37,19,16,5,11,3,0,3,0,0.0,0.0
1004,104,23-09-2019 15:06:00,1,3028.0,2054.0,0.678,14.206,0,0,0,0,0,0,0,0,0.0,0.0
1004,105,23-09-2019 15:08:00,1,2926.5,2034.5,0.6955,13.7835,0,0,0,0,0,0,0,0,0.0,0.0
1004,106,23-09-2019 15:10:00,1,2825.0,2015.0,0.713,13.361,5,5,2,3,0,0,0,0,0.0,0.0
1004,107,23-09-2019 15:12:00,1,2823.0,2024.0,0.717,13.365,0,0,0,0,0,0,0,0,0.0,0.0
1004,108,23-09-2019 15:14:00,1,2845.0,1987.0,0.698,13.409,0,0,0,0,0,0,0,0,0.0,0.0
1004,109,23-09-2019 15:16:00,1,2844.0,1930.0,0.679,13.344,0,0,0,0,0,0,0,0,0.0,0.0
1004,110,23-09-2019 15:18:00,1,2862.0,1899.0,0.664,13.38,0,0,0,0,0,0,0,0,0.0,0.0
1004,111,23-09-2019 15:20:00,1,2648.0,1801.0,0.68,12.428,9,9,0,9,0,0,0,0,0.0,0.0
1004,112,23-09-2019 15:22:00,1,2635.0,1854.0,0.704,12.436,1,1,0,1,0,0,0,0,0.0,0.0
1004,113,23-09-2019 15:24:00,1,2644.0,1832.0,0.693,12.447,22,22,0,22,0,0,0,0,0.0,0.0
1004,114,23-09-2019 15:26:00,1,2636.0,1822.0,0.691,12.403,4,4,0,4,0,0,0,0,0.0,0.0
1004,115,23-09-2019 15:28:00,1,2638.0,1835.0,0.696,12.428,0,0,0,0,0,0,0,0,0.0,0.0
1004,116,23-09-2019 15:30:00,1,2640.0,1861.0,0.705,12.463,17,10,1,9,7,1,6,0,0.0,0.0
1004,117,23-09-2019 15:32:00,1,2660.0,1772.0,0.666,12.441,40,35,3,32,5,2,3,0,0.0,0.0
1004,118,23-09-2019 15:34:00,1,2657.0,1786.0,0.672,12.447,0,0,0,0,0,0,0,0,0.0,0.0
1004,119,23-09-2019 15:36:00,1,2641.0,1823.0,0.69,12.423,0,0,0,0,0,0,0,0,0.0,0.0
1004,120,23-09-2019 15:38:00,1,2651.0,1811.0,0.683,12.45,42,38,15,23,4,1,3,0,0.0,0.0
1004,121,23-09-2019 15:40:00,1,2643.0,1842.0,0.697,12.453,21,20,3,17,1,0,1,0,0.0,0.0
1004,122,23-09-2019 15:42:00,1,2737.5,1901.0,0.6945,12.891,10,6,3,3,4,2,2,0,0.0,0.0
1004,123,23-09-2019 15:44:00,1,2832.0,1960.0,0.692,13.329,2,0,0,0,2,0,2,0,0.0,0.0
1004,124,23-09-2019 15:46:00,1,2850.0,1956.0,0.686,13.395,8,8,2,6,0,0,0,0,0.0,0.0
1004,125,23-09-2019 15:48:00,1,2841.0,1960.0,0.69,13.362,0,0,0,0,0,0,0,0,0.0,0.0
1004,126,23-09-2019 15:50:00,1,2848.0,1884.0,0.661,13.307,10,10,3,7,0,0,0,0,0.0,0.0
1004,127,23-09-2019 15:52:00,1,2841.0,1947.0,0.685,13.349,1,1,0,1,0,0,0,0,0.0,0.0
1004,128,23-09-2019 15:54:00,1,2849.0,1959.0,0.688,13.393,0,0,0,0,0,0,0,0,0.0,0.0
1004,129,23-09-2019 15:56:00,1,2842.0,1951.0,0.687,13.359,7,5,2,3,2,1,1,0,0.0,0.0
1004,130,23-09-2019 15:58:00,1,2750.0,1855.0,0.675,12.889,3,2,1,1,1,1,0,0,0.0,0.0
1004,131,23-09-2019 16:00:00,1,2759.0,1849.0,0.67,12.918,0,0,0,0,0,0,0,0,0.0,0.0
1004,132,23-09-2019 16:02:00,1,2643.0,1836.0,0.695,12.446,4,0,0,0,4,0,4,0,0.0,0.0
1004,133,23-09-2019 16:04:00,1,2660.0,1776.0,0.668,12.446,2,0,0,0,2,0,2,0,0.0,0.0
1004,134,23-09-2019 16:06:00,1,2672.0,1722.0,0.645,12.436,0,0,0,0,0,0,0,0,0.0,0.0
1004,135,23-09-2019 16:08:00,1,2668.0,1711.0,0.641,12.406,21,16,2,14,5,1,4,0,0.0,0.0
1004,136,23-09-2019 16:10:00,1,2653.0,1826.0,0.688,12.474,5,2,0,2,3,0,3,0,0.0,0.0
1004,137,23-09-2019 16:12:00,1,2659.0,1800.0,0.677,12.468,0,0,0,0,0,0,0,0,0.0,0.0
1004,138,23-09-2019 16:14:00,1,2672.0,1763.0,0.66,12.479,21,9,5,4,12,0,12,0,0.0,0.0
1004,139,23-09-2019 16:16:00,1,2668.0,1762.0,0.6605,12.4635,7,3,1,2,4,0,4,0,0.0,0.0
1004,140,23-09-2019 16:18:00,1,2664.0,1761.0,0.661,12.448,13,8,2,6,5,0,5,0,0.0,0.0
1004,141,23-09-2019 16:20:00,1,2655.0,1762.0,0.664,12.413,9,9,1,8,0,0,0,0,0.0,0.0
1004,142,23-09-2019 16:22:00,1,2662.0,1771.0,0.665,12.449,29,18,6,12,11,2,9,0,0.0,0.0
1004,143,23-09-2019 16:24:00,1,2636.0,1826.0,0.693,12.408,63,51,19,32,12,5,7,3,0.0,0.0
1004,144,23-09-2019 16:26:00,1,2861.0,1887.0,0.66,13.36,60,41,22,19,19,6,13,0,0.0,0.0
1004,145,23-09-2019 16:28:00,1,2647.0,1827.0,0.69,12.454,96,59,32,27,37,6,31,2,0.0,0.0
1004,146,23-09-2019 16:30:00,1,2829.0,1981.0,0.7,13.34,87,57,32,25,30,10,20,5,0.0,0.0
1004,147,23-09-2019 16:32:00,1,3050.0,2056.0,0.674,14.293,110,63,36,27,47,27,20,5,0.0,0.0
1004,148,23-09-2019 16:34:00,1,3047.0,2057.0,0.675,14.283,15,8,4,4,7,5,2,0,0.0,0.0
1004,149,23-09-2019 16:36:00,1,3037.0,2087.0,0.687,14.275,45,44,34,10,1,0,1,0,0.0,0.0
1004,150,23-09-2019 16:38:00,1,2846.0,1957.0,0.688,13.379,8,6,2,4,2,0,2,0,0.0,0.0
1004,151,23-09-2019 16:40:00,1,2752.0,1883.0,0.684,12.929,1,0,0,0,1,0,1,0,0.0,0.0
1004,152,23-09-2019 16:42:00,1,2656.0,1810.0,0.681,12.47,0,0,0,0,0,0,0,0,0.0,0.0
1004,153,23-09-2019 16:44:00,1,2657.0,1742.0,0.656,12.398,0,0,0,0,0,0,0,0,0.0,0.0
1004,154,23-09-2019 16:46:00,1,2436.0,1692.0,0.695,11.473,15,0,0,0,15,0,15,0,0.0,0.0
1004,155,23-09-2019 16:48:00,1,2351.0,1659.0,0.706,11.099,8,0,0,0,8,0,8,0,0.0,0.0
1004,156,23-09-2019 16:50:00,1,2401.5,1666.5,0.6945,11.3065,3,0,0,0,3,0,3,0,0.0,0.0
1004,157,23-09-2019 16:52:00,1,2452.0,1674.0,0.683,11.514,7,1,0,1,6,0,6,0,0.0,0.0
1004,158,23-09-2019 16:54:00,1,2452.0,1667.0,0.68,11.505,0,0,0,0,0,0,0,0,0.0,0.0
1004,159,23-09-2019 16:56:00,1,2345.0,1662.0,0.708,11.081,0,0,0,0,0,0,0,0,0.0,0.0
1004,160,23-09-2019 16:58:00,1,2352.0,1620.0,0.689,11.061,2,0,0,0,2,0,2,0,0.0,0.0
1004,161,23-09-2019 17:00:00,1,2364.0,1590.0,0.673,11.074,0,0,0,0,0,0,0,0,0.0,0.0
1004,162,23-09-2019 17:02:00,1,2368.0,1590.0,0.672,11.09,0,0,0,0,0,0,0,0,0.0,0.0
1004,163,23-09-2019 17:04:00,1,2355.0,1631.0,0.692,11.084,0,0,0,0,0,0,0,0,0.0,0.0
1004,164,23-09-2019 17:06:00,1,2570.0,1692.0,0.658,12.0,22,17,7,10,5,1,4,0,0.0,0.0
1004,165,23-09-2019 17:08:00,1,2664.0,1775.0,0.666,12.463,2,2,0,2,0,0,0,0,0.0,0.0
1004,166,23-09-2019 17:10:00,1,2658.0,1757.0,0.661,12.42,4,2,0,2,2,0,2,0,0.0,0.0
1004,167,23-09-2019 17:12:00,1,2559.0,1690.0,0.66,11.952,1,1,1,0,0,0,0,0,0.0,0.0
1004,168,23-09-2019 17:14:00,1,2463.0,1679.0,0.682,11.563,9,6,2,4,3,0,3,0,0.0,0.0
1004,169,23-09-2019 17:16:00,1,2343.0,1639.0,0.7,11.047,2,2,0,2,0,0,0,0,0.0,0.0
1004,170,23-09-2019 17:18:00,1,2354.0,1630.0,0.692,11.079,5,5,0,5,0,0,0,0,0.0,0.0
1004,171,23-09-2019 17:20:00,1,2346.0,1632.0,0.696,11.052,7,7,0,7,0,0,0,0,0.0,0.0
1004,172,23-09-2019 17:22:00,1,2351.0,1643.0,0.699,11.084,2,2,1,1,0,0,0,0,0.0,0.0
1004,173,23-09-2019 17:24:00,1,2350.5,1623.5,0.6905,11.06,9,9,0,9,0,0,0,0,0.0,0.0
1004,174,23-09-2019 17:26:00,1,2350.0,1604.0,0.682,11.036,4,1,0,1,3,0,3,0,0.0,0.0
1004,175,23-09-2019 17:28:00,1,2344.0,1623.0,0.692,11.035,4,4,0,4,0,0,0,0,0.0,0.0
1004,176,23-09-2019 17:30:00,1,2455.0,1659.0,0.676,11.512,24,21,11,10,3,1,2,0,0.0,0.0
1004,177,23-09-2019 17:32:00,1,2676.0,1755.0,0.656,12.486,59,45,21,24,14,2,12,0,0.0,0.0
1004,178,23-09-2019 17:34:00,1,2640.0,1827.0,0.692,12.425,36,24,11,13,12,3,9,0,0.0,0.0
1004,179,23-09-2019 17:36:00,1,2840.0,1940.0,0.683,13.337,44,36,8,28,8,0,8,2,0.0,0.0
1004,180,23-09-2019 17:38:00,1,3029.0,2095.0,0.692,14.254,49,35,19,16,14,3,11,6,0.0,0.0
1004,181,23-09-2019 17:40:00,1,3040.0,2112.0,0.695,14.315,48,34,17,17,14,3,11,0,0.0,0.0
1004,182,23-09-2019 17:42:00,1,3061.0,2042.0,0.667,14.323,58,38,15,23,20,3,17,0,0.0,0.0
1004,183,23-09-2019 17:44:00,1,3019.0,2132.0,0.706,14.255,37,10,5,5,27,6,21,2,0.0,0.0
1004,184,23-09-2019 17:46:00,1,3046.0,2047.0,0.672,14.269,8,1,1,0,7,0,7,0,0.0,0.0
1004,185,23-09-2019 17:48:00,1,2827.0,2013.0,0.712,13.367,7,4,1,3,3,0,3,0,0.0,0.0
1004,186,23-09-2019 17:50:00,1,2841.0,1919.0,0.675,13.32,5,5,1,4,0,0,0,0,0.0,0.0
1004,187,23-09-2019 17:52:00,1,2740.0,1866.0,0.681,12.862,5,4,2,2,1,0,1,0,0.0,0.0
1004,188,23-09-2019 17:54:00,1,2652.0,1818.0,0.685,12.462,2,2,0,2,0,0,0,0,0.0,0.0
1004,189,23-09-2019 17:56:00,1,2658.0,1773.0,0.667,12.436,2,2,0,2,0,0,0,0,0.0,0.0
1004,190,23-09-2019 17:58:00,1,2661.0,1760.5,0.6615,12.433,8,7,2,5,1,0,1,0,0.0,0.0
1004,191,23-09-2019 18:00:00,0,2664.0,1748.0,0.656,12.43,9,6,1,5,3,1,2,0,0.0,0.0
1004,192,23-09-2019 18:02:00,0,2650.0,1772.0,0.669,12.404,32,32,0,32,0,0,0,0,0.0,0.0
1004,193,23-09-2019 18:04:00,0,2675.0,1728.0,0.646,12.452,75,49,27,22,26,11,15,0,0.0,0.0
1004,194,23-09-2019 18:06:00,0,2750.0,1893.0,0.689,12.931,234,140,103,37,94,60,34,10,0.0,0.0
1004,195,23-09-2019 18:08:00,0,3326.0,2328.0,0.7,15.681,157,100,54,46,57,31,26,5,0.0,0.0
1004,196,23-09-2019 18:10:00,0,3012.0,2148.0,0.713,14.245,277,146,116,30,131,96,35,4,0.0,0.0
1004,197,23-09-2019 18:12:00,0,3516.0,2499.0,0.711,16.622,314,194,154,40,120,91,29,21,0.0,0.0
1004,198,23-09-2019 18:14:00,0,4004.0,2783.0,0.695,18.858,265,151,123,28,114,88,26,50,0.0,0.0
1004,199,23-09-2019 18:16:00,0,3699.0,2669.0,0.721,17.53,114,72,39,33,42,27,15,7,0.0,0.0
1004,200,23-09-2019 18:18:00,0,3509.0,2496.0,0.711,16.589,19,17,4,13,2,0,2,0,0.0,0.0
1004,201,23-09-2019 18:20:00,0,3321.0,2307.0,0.695,15.638,100,65,40,25,35,10,25,0,0.0,0.0
1004,202,23-09-2019 18:22:00,0,3530.0,2348.0,0.665,16.507,48,38,15,23,10,1,9,0,0.0,0.0
1004,203,23-09-2019 18:24:00,0,3525.0,2515.0,0.714,16.673,90,54,26,28,36,14,22,6,0.0,0.0
1004,204,23-09-2019 18:26:00,0,3502.0,2536.0,0.724,16.608,20,13,7,6,7,4,3,0,0.0,0.0
1004,205,23-09-2019 18:28:00,0,3536.0,2464.0,0.697,16.661,184,129,86,43,55,35,20,43,0.0,0.0
1004,206,23-09-2019 18:30:00,0,4071.0,2935.0,0.721,19.288,299,168,116,52,131,96,35,52,0.0,0.0
1004,207,23-09-2019 18:32:00,0,4028.5,2901.5,0.7205,19.085,236,155,113,42,81,51,30,42,0.0,0.0
1004,208,23-09-2019 18:34:00,0,3986.0,2868.0,0.72,18.882,181,107,68,39,74,51,23,28,0.0,0.0
1004,209,23-09-2019 18:36:00,0,3505.0,2532.0,0.722,16.613,148,82,50,32,66,37,29,3,0.0,0.0
1004,210,23-09-2019 18:38:00,0,4017.0,2772.0,0.69,18.895,92,63,39,24,29,18,11,11,0.0,0.0
1004,211,23-09-2019 18:40:00,0,3525.0,2462.0,0.698,16.614,111,75,50,25,36,23,13,11,0.0,0.0
1004,212,23-09-2019 18:42:00,0,3527.0,2372.0,0.673,16.522,6,1,1,0,5,0,5,0,0.0,0.0
1004,213,23-09-2019 18:44:00,0,3141.0,2150.0,0.685,14.756,8,1,1,0,7,0,7,0,0.0,0.0
1004,214,23-09-2019 18:46:00,0,3134.0,2149.0,0.686,14.728,13,6,4,2,7,3,4,0,0.0,0.0
1004,215,23-09-2019 18:48:00,0,3365.0,2225.0,0.661,15.721,85,51,38,13,34,19,15,3,0.0,0.0
1004,216,23-09-2019 18:50:00,0,3360.0,2203.0,0.656,15.677,18,1,0,1,17,7,10,0,0.0,0.0
1004,217,23-09-2019 18:52:00,0,3018.0,2106.0,0.698,14.225,3,0,0,0,3,2,1,0,0.0,0.0
1004,218,23-09-2019 18:54:00,0,3061.0,2011.0,0.657,14.289,75,48,28,20,27,13,14,4,0.0,0.0
1004,219,23-09-2019 18:56:00,0,3021.0,2138.0,0.708,14.269,77,52,26,26,25,6,19,0,0.0,0.0
1004,220,23-09-2019 18:58:00,0,3238.0,2203.0,0.68,15.2,174,92,68,24,82,47,35,22,0.0,0.0
1004,221,23-09-2019 19:00:00,0,3909.0,2779.0,0.711,18.477,160,104,77,27,56,41,15,36,0.0,0.0
1004,222,23-09-2019 19:02:00,0,3702.0,2695.0,0.728,17.569,260,164,128,36,96,64,32,21,0.0,0.0
1004,223,23-09-2019 19:04:00,0,3509.0,2464.0,0.702,16.556,72,39,20,19,33,7,26,0,0.0,0.0
1004,224,23-09-2019 19:06:00,0,3518.0,2435.0,0.692,16.5595,147,74,52,22,73,45,28,10,0.0,0.0
1004,225,23-09-2019 19:08:00,0,3527.0,2406.0,0.682,16.563,63,44,30,14,19,9,10,4,0.0,0.0
1004,226,23-09-2019 19:10:00,0,3518.0,2470.0,0.702,16.595,207,109,82,27,98,65,33,16,0.0,0.0
1004,227,23-09-2019 19:12:00,0,3680.0,2686.0,0.73,17.472,87,73,47,26,14,3,11,38,0.0,0.0
1004,228,23-09-2019 19:14:00,0,3908.0,2757.0,0.705,18.451,77,32,20,12,45,15,30,13,0.0,0.0
1004,229,23-09-2019 19:16:00,0,3320.0,2309.0,0.695,15.639,131,75,56,19,56,30,26,9,0.0,0.0
1004,230,23-09-2019 19:18:00,0,3534.0,2366.0,0.67,16.545,158,108,73,35,50,23,27,22,0.0,0.0
1004,231,23-09-2019 19:20:00,0,3695.0,2690.0,0.728,17.537,103,82,52,30,21,12,9,32,0.0,0.0
1004,232,23-09-2019 19:22:00,0,3697.0,2693.0,0.728,17.551,137,102,67,35,35,9,26,66,0.0,0.0
1004,233,23-09-2019 19:24:00,0,4028.0,2779.0,0.69,18.946,312,218,173,45,94,67,27,31,0.0,0.0
1004,234,23-09-2019 19:26:00,0,3915.0,2743.0,0.701,18.462,326,256,191,65,70,36,34,49,0.0,0.0
1004,235,23-09-2019 19:28:00,0,4030.0,2769.0,0.687,18.945,259,180,125,55,79,48,31,32,0.0,0.0
1004,236,23-09-2019 19:30:00,0,3683.0,2635.0,0.715,17.429,173,128,92,36,45,25,20,23,0.0,0.0
1004,237,23-09-2019 19:32:00,0,3698.0,2654.0,0.718,17.507,111,70,41,29,41,22,19,5,0.0,0.0
1004,238,23-09-2019 19:34:00,0,3512.0,2514.0,0.716,16.622,61,44,20,24,17,10,7,3,0.0,0.0
1004,239,23-09-2019 19:36:00,0,3713.0,2584.0,0.696,17.491,7,6,0,6,1,0,1,0,0.0,0.0
1004,240,23-09-2019 19:38:00,0,3512.0,2474.0,0.704,16.578,3,2,0,2,1,0,1,0,0.0,0.0
1004,241,23-09-2019 19:40:00,0,3368.5,2337.5,0.6935,15.8605,7,4,0,4,3,0,3,0,0.0,0.0
1004,242,23-09-2019 19:42:00,0,3225.0,2201.0,0.683,15.143,16,10,9,1,6,2,4,0,0.0,0.0
1004,243,23-09-2019 19:44:00,0,3020.0,2144.0,0.71,14.274,0,0,0,0,0,0,0,0,0.0,0.0
1004,244,23-09-2019 19:46:00,0,3033.0,2120.0,0.699,14.298,15,15,2,13,0,0,0,0,0.0,0.0
1004,245,23-09-2019 19:48:00,0,2934.0,2041.0,0.696,13.82,30,28,24,4,2,1,1,0,0.0,0.0
1004,246,23-09-2019 19:50:00,0,2833.0,1948.0,0.688,13.32,6,6,3,3,0,0,0,0,0.0,0.0
1004,247,23-09-2019 19:52:00,0,2643.0,1846.0,0.698,12.458,141,96,63,33,45,24,21,9,0.0,0.0
1004,248,23-09-2019 19:54:00,0,3124.0,2221.0,0.711,14.769,190,112,93,19,78,52,26,19,0.0,0.0
1004,249,23-09-2019 19:56:00,0,3316.0,2345.0,0.707,15.663,114,74,45,29,40,22,18,15,0.0,0.0
1004,250,23-09-2019 19:58:00,0,3307.0,2381.0,0.72,15.667,129,63,45,18,66,41,25,19,0.0,0.0
1004,251,23-09-2019 20:00:00,0,3320.0,2302.0,0.693,15.631,189,109,69,40,80,36,44,0,0.0,0.0
1004,252,23-09-2019 20:02:00,0,3323.0,2333.0,0.702,15.678,102,52,31,21,50,25,25,9,0.0,0.0
1004,253,23-09-2019 20:04:00,0,3685.0,2631.0,0.714,17.434,162,89,53,36,73,44,29,12,0.0,0.0
1004,254,23-09-2019 20:06:00,0,3223.0,2247.0,0.697,15.187,225,109,75,34,116,77,39,34,0.0,0.0
1004,255,23-09-2019 20:08:00,0,3897.0,2798.0,0.718,18.454,179,112,83,29,67,39,28,27,0.0,0.0
1004,256,23-09-2019 20:10:00,0,3497.0,2573.0,0.736,16.626,15,13,0,13,2,0,2,0,0.0,0.0
1004,257,23-09-2019 20:12:00,0,3706.0,2594.0,0.7,17.472,148,78,43,35,70,42,28,2,0.0,0.0
1004,258,23-09-2019 20:14:00,0,3701.0,2613.0,0.706,17.4745,161,101,74,27,60,43,17,22,0.0,0.0
1004,259,23-09-2019 20:16:00,0,3696.0,2632.0,0.712,17.477,66,26,14,12,40,28,12,0,0.0,0.0
1004,260,23-09-2019 20:18:00,0,3725.0,2613.0,0.701,17.57,114,62,30,32,52,32,20,9,0.0,0.0
1004,261,23-09-2019 20:20:00,0,4012.0,2814.0,0.701,18.923,156,80,61,19,76,45,31,29,0.0,0.0
1004,262,23-09-2019 20:22:00,0,3675.0,2690.0,0.732,17.46,31,5,3,2,26,10,16,1,0.0,0.0
1004,263,23-09-2019 20:24:00,0,3503.0,2482.0,0.708,16.549,6,2,0,2,4,0,4,0,0.0,0.0
1004,264,23-09-2019 20:26:00,0,3324.0,2347.0,0.706,15.695,11,0,0,0,11,3,8,0,0.0,0.0
1004,265,23-09-2019 20:28:00,0,3131.0,2158.0,0.689,14.726,11,4,2,2,7,2,5,0,0.0,0.0
1004,266,23-09-2019 20:30:00,0,3054.0,2050.0,0.671,14.303,5,2,0,2,3,1,2,0,0.0,0.0
1004,267,23-09-2019 20:32:00,0,2848.0,1957.0,0.687,13.389,12,4,3,1,8,4,4,0,0.0,0.0
1004,268,23-09-2019 20:34:00,0,2829.0,2006.0,0.709,13.366,18,10,3,7,8,2,6,0,0.0,0.0
1004,269,23-09-2019 20:36:00,0,2934.0,2008.0,0.684,13.783,245,128,89,39,117,73,44,11,0.0,0.0
1004,270,23-09-2019 20:38:00,0,3326.0,2268.0,0.682,15.617,114,70,46,24,44,28,16,0,0.0,0.0
1004,271,23-09-2019 20:40:00,0,3008.0,2205.0,0.733,14.293,124,59,38,21,65,38,27,7,0.0,0.0
1004,272,23-09-2019 20:42:00,0,3008.0,2171.0,0.722,14.257,90,49,31,18,41,23,18,4,0.0,0.0
1004,273,23-09-2019 20:44:00,0,3041.0,2092.0,0.688,14.297,110,58,36,22,52,34,18,4,0.0,0.0
1004,274,23-09-2019 20:46:00,0,3341.0,2291.0,0.686,15.7,200,103,85,18,97,69,28,25,0.0,0.0
1004,275,23-09-2019 20:48:00,0,3426.0,2392.5,0.698,16.1485,107,70,44,26,37,26,11,16,0.0,0.0
1004,276,23-09-2019 20:50:00,0,3511.0,2494.0,0.71,16.597,48,35,15,20,13,9,4,3,0.0,0.0
1004,277,23-09-2019 20:52:00,0,3313.0,2337.0,0.705,15.641,79,50,30,20,29,21,8,0,0.0,0.0
1004,278,23-09-2019 20:54:00,0,3317.0,2364.0,0.713,15.687,230,111,81,30,119,89,30,34,0.0,0.0
1004,279,23-09-2019 20:56:00,0,3527.0,2427.0,0.688,16.586,112,79,55,24,33,19,14,20,0.0,0.0
1004,280,23-09-2019 20:58:00,0,3539.0,2392.0,0.676,16.595,158,89,52,37,69,38,31,13,0.0,0.0
1004,281,23-09-2019 21:00:00,0,3260.0,2189.0,0.671,15.269,117,75,41,34,42,23,19,7,0.0,0.0
1004,282,23-09-2019 21:02:00,0,3338.0,2272.0,0.68,15.669,74,53,31,22,21,12,9,0,0.0,0.0
1004,283,23-09-2019 21:04:00,0,3025.0,2129.0,0.704,14.277,131,73,60,13,58,37,21,12,0.0,0.0
1004,284,23-09-2019 21:06:00,0,3332.0,2246.0,0.674,15.616,204,120,92,28,84,55,29,16,0.0,0.0
1004,285,23-09-2019 21:08:00,0,3547.0,2399.0,0.676,16.633,126,73,52,21,53,42,11,41,0.0,0.0
1004,286,23-09-2019 21:10:00,0,3519.0,2469.0,0.702,16.599,347,198,156,42,149,117,32,37,0.0,0.0
1004,287,23-09-2019 21:12:00,0,3547.0,2431.0,0.685,16.666,207,126,97,29,81,55,26,20,0.0,0.0
1004,288,23-09-2019 21:14:00,0,3256.0,2163.0,0.664,15.225,0,0,0,0,0,0,0,0,0.0,0.0
1004,289,23-09-2019 21:16:00,0,3059.0,2032.0,0.664,14.301,3,0,0,0,3,1,2,0,0.0,0.0
1004,290,23-09-2019 21:18:00,0,3051.0,1966.0,0.644,14.199,2,0,0,0,2,0,2,0,0.0,0.0
1004,291,23-09-2019 21:20:00,0,2854.0,1939.0,0.679,13.393,23,14,12,2,9,6,3,2,0.0,0.0
1004,292,23-09-2019 21:22:00,0,3101.0,2109.5,0.68,14.5535,195,103,71,32,92,67,25,12,0.0,0.0
1004,293,23-09-2019 21:24:00,0,3348.0,2280.0,0.681,15.714,230,102,68,34,128,105,23,8,0.0,0.0
1004,294,23-09-2019 21:26:00,0,3326.0,2304.0,0.693,15.658,271,144,114,30,127,87,40,22,0.0,0.0
1004,295,23-09-2019 21:28:00,0,3311.0,2339.0,0.707,15.635,138,91,65,26,47,33,14,23,0.0,0.0
1004,296,23-09-2019 21:30:00,0,3525.0,2431.0,0.69,16.58,132,83,54,29,49,27,22,25,0.0,0.0
1004,297,23-09-2019 21:32:00,0,3317.0,2291.0,0.691,15.606,106,77,48,29,29,20,9,9,0.0,0.0
1004,298,23-09-2019 21:34:00,0,3328.0,2302.0,0.692,15.664,139,56,35,21,83,52,31,5,0.0,0.0
1004,299,23-09-2019 21:36:00,0,3325.0,2301.0,0.692,15.649,191,123,91,32,68,42,26,9,0.0,0.0
1004,300,23-09-2019 21:38:00,0,3325.0,2290.0,0.689,15.637,144,86,61,25,58,34,24,10,0.0,0.0
1004,301,23-09-2019 21:40:00,0,3499.0,2500.0,0.715,16.556,70,36,18,18,34,20,14,10,0.0,0.0
1004,302,23-09-2019 21:42:00,0,3150.0,2132.0,0.677,14.773,232,142,117,25,90,67,23,14,0.0,0.0
1004,303,23-09-2019 21:44:00,0,3532.0,2379.0,0.674,16.55,292,172,129,43,120,83,37,22,0.0,0.0
1004,304,23-09-2019 21:46:00,0,3532.0,2385.0,0.675,16.558,377,231,174,57,146,92,54,48,0.0,0.0
1004,305,23-09-2019 21:48:00,0,3719.0,2573.0,0.692,17.502,383,263,205,58,120,83,37,51,0.0,0.0
1004,306,23-09-2019 21:50:00,0,3700.0,2596.0,0.702,17.455,249,177,139,38,72,40,32,52,0.0,0.0
1004,307,23-09-2019 21:52:00,0,3610.0,2530.0,0.701,17.024,235,159,114,45,76,43,33,38,0.0,0.0
1004,308,23-09-2019 21:54:00,0,3732.0,2541.0,0.681,17.516,222,178,128,50,44,17,27,56,0.0,0.0
1004,309,23-09-2019 21:56:00,0,3715.5,2585.5,0.696,17.502,206,156,107,49,50,15,35,61,0.0,0.0
1004,310,23-09-2019 21:58:00,0,3699.0,2630.0,0.711,17.488,186,152,104,48,34,10,24,59,0.0,0.0
1004,311,23-09-2019 22:00:00,0,3925.0,2689.0,0.685,18.443,134,101,58,43,33,12,21,49,0.0,0.0
1004,312,23-09-2019 22:02:00,0,4022.0,2750.0,0.684,18.891,426,253,199,54,173,121,52,42,0.0,0.0
1004,313,23-09-2019 22:04:00,0,4091.0,2896.0,0.708,19.327,241,136,111,25,105,79,26,20,0.0,0.0
1004,314,23-09-2019 22:06:00,0,3515.0,2479.0,0.705,16.593,167,96,72,24,71,48,23,20,0.0,0.0
1004,315,23-09-2019 22:08:00,0,3507.0,2453.0,0.7,16.532,81,55,27,28,26,7,19,2,0.0,0.0
1004,316,23-09-2019 22:10:00,0,3699.0,2629.0,0.711,17.484,262,157,119,38,105,81,24,22,0.0,0.0
1004,317,23-09-2019 22:12:00,0,3688.0,2700.0,0.732,17.521,91,66,49,17,25,13,12,8,0.0,0.0
1004,318,23-09-2019 22:14:00,0,3700.0,2671.0,0.722,17.537,181,100,77,23,81,66,15,21,0.0,0.0
1004,319,23-09-2019 22:16:00,0,3686.0,2710.0,0.735,17.524,54,41,25,16,13,7,6,0,0.0,0.0
1004,320,23-09-2019 22:18:00,0,3707.0,2639.0,0.712,17.527,188,125,89,36,63,39,24,22,0.0,0.0
1004,321,23-09-2019 22:20:00,0,3792.0,2777.0,0.732,18.016,218,136,109,27,82,60,22,34,0.0,0.0
1004,322,23-09-2019 22:22:00,0,3668.0,2743.0,0.748,17.488,6,3,1,2,3,1,2,0,0.0,0.0
1004,323,23-09-2019 22:24:00,0,3597.0,2588.0,0.719,17.039,5,3,1,2,2,1,1,0,0.0,0.0
1004,324,23-09-2019 22:26:00,0,3511.0,2496.0,0.711,16.595,14,2,1,1,12,8,4,0,0.0,0.0
1004,325,23-09-2019 22:28:00,0,3344.0,2264.0,0.677,15.681,0,0,0,0,0,0,0,0,0.0,0.0
1004,326,23-09-2019 22:30:00,0,3199.0,2153.5,0.673,14.9875,2,1,0,1,1,1,0,0,0.0,0.0
1004,327,23-09-2019 22:32:00,0,3054.0,2043.0,0.669,14.294,34,20,9,11,14,7,7,0,0.0,0.0
1004,328,23-09-2019 22:34:00,0,3034.0,2117.0,0.698,14.299,199,93,64,29,106,74,32,10,0.0,0.0
1004,329,23-09-2019 22:36:00,0,3333.0,2289.0,0.687,15.668,140,93,66,27,47,22,25,19,0.0,0.0
1004,330,23-09-2019 22:38:00,0,3307.0,2354.0,0.712,15.634,163,88,56,32,75,48,27,20,0.0,0.0
1004,331,23-09-2019 22:40:00,0,3340.0,2287.0,0.685,15.692,258,128,94,34,130,92,38,27,0.0,0.0
1004,332,23-09-2019 22:42:00,0,3318.0,2332.0,0.703,15.654,120,74,49,25,46,27,19,11,0.0,0.0
1004,333,23-09-2019 22:44:00,0,3312.0,2331.0,0.704,15.63,325,156,129,27,169,125,44,40,0.0,0.0
1004,334,23-09-2019 22:46:00,0,3527.0,2457.0,0.697,16.617,259,140,108,32,119,76,43,16,0.0,0.0
1004,335,23-09-2019 22:48:00,0,3510.0,2509.0,0.715,16.609,177,138,104,34,39,12,27,36,0.0,0.0
1004,336,23-09-2019 22:50:00,0,3510.0,2488.0,0.709,16.585,247,140,97,43,107,64,43,19,0.0,0.0
1004,337,23-09-2019 22:52:00,0,3504.0,2481.0,0.708,16.553,230,122,95,27,108,76,32,36,0.0,0.0
1004,338,23-09-2019 22:54:00,0,3495.0,2529.0,0.724,16.57,178,80,53,27,98,62,36,10,0.0,0.0
1004,339,23-09-2019 22:56:00,0,3513.0,2456.0,0.699,16.561,198,141,106,35,57,31,26,17,0.0,0.0
1004,340,23-09-2019 22:58:00,0,3511.0,2497.0,0.711,16.599,532,260,210,50,272,220,52,31,0.0,0.0
1004,341,23-09-2019 23:00:00,0,3522.0,2475.0,0.703,16.618,398,191,142,49,207,158,49,34,0.0,0.0
1004,342,23-09-2019 23:02:00,0,3698.0,2644.0,0.715,17.498,291,167,124,43,124,89,35,43,0.0,0.0
1004,343,23-09-2019 23:04:00,0,3714.0,2609.5,0.7025,17.5235,142,84,52,32,58,49,9,10,0.0,0.0
1004,344,23-09-2019 23:06:00,0,3730.0,2575.0,0.69,17.549,376,295,232,63,81,43,38,75,0.0,0.0
1004,345,23-09-2019 23:08:00,0,4013.0,2786.0,0.694,18.896,487,300,240,60,187,133,54,71,0.0,0.0
1004,346,23-09-2019 23:10:00,0,4002.0,2826.0,0.706,18.899,393,267,219,48,126,84,42,68,0.0,0.0
1004,347,23-09-2019 23:12:00,0,3981.0,2871.0,0.721,18.864,326,200,155,45,126,87,39,81,0.0,0.0
1004,348,23-09-2019 23:14:00,0,3978.0,2905.0,0.73,18.889,322,215,165,50,107,63,44,89,0.0,0.0
1004,349,23-09-2019 23:16:00,0,4187.0,2978.0,0.711,19.797,299,176,129,47,123,82,41,75,0.0,0.0
1004,350,23-09-2019 23:18:00,0,4172.0,2984.0,0.715,19.743,258,176,117,59,82,51,31,71,0.0,0.0
1004,351,23-09-2019 23:20:00,0,4150.0,3107.0,0.749,19.792,319,227,157,70,92,61,31,50,0.0,0.0
1004,352,23-09-2019 23:22:00,0,4239.0,3209.0,0.757,20.254,276,184,127,57,92,62,30,41,0.0,0.0
1004,353,23-09-2019 23:24:00,0,4181.0,3049.0,0.729,19.851,481,266,201,65,215,174,41,43,0.0,0.0
1004,354,23-09-2019 23:26:00,0,3767.0,2855.0,0.758,18.005,346,182,135,47,164,122,42,24,0.0,0.0
1004,355,23-09-2019 23:28:00,0,3392.0,2507.0,0.739,16.141,137,95,68,27,42,18,24,25,0.0,0.0
1004,356,23-09-2019 23:30:00,0,4050.0,3068.0,0.758,19.356,448,230,180,50,218,166,52,39,0.0,0.0
1004,357,23-09-2019 23:32:00,0,3869.0,2917.0,0.754,18.474,405,228,183,45,177,142,35,177,0.0,0.0
1004,358,23-09-2019 23:34:00,0,4330.0,3363.0,0.777,20.784,278,160,137,23,118,94,24,231,0.0,0.0
1004,359,23-09-2019 23:36:00,0,4618.0,3574.0,0.774,22.153,398,210,178,32,188,142,46,198,0.0,0.0
1004,360,23-09-2019 23:38:00,0,4618.0,3565.0,0.772,22.143,287,180,130,50,107,58,49,63,0.0,0.0
1004,361,23-09-2019 23:40:00,0,4618.0,3556.0,0.77,22.133,217,159,113,46,58,26,32,60,0.0,0.0
1004,362,23-09-2019 23:42:00,0,4608.0,3589.0,0.779,22.128,307,184,135,49,123,85,38,75,0.0,0.0
1004,363,23-09-2019 23:44:00,0,4596.0,3658.0,0.796,22.158,298,180,135,45,118,80,38,62,0.0,0.0
1004,364,23-09-2019 23:46:00,0,4594.0,3678.0,0.801,22.173,220,113,82,31,107,71,36,2,0.41,0.0
1004,365,23-09-2019 23:48:00,0,4117.0,3249.0,0.789,19.817,268,164,110,54,104,58,46,55,0.01,0.0
1004,366,23-09-2019 23:50:00,0,4600.0,3636.0,0.79,22.152,491,297,228,69,194,136,58,70,0.0,0.0
1004,367,23-09-2019 23:52:00,0,4615.0,3576.0,0.775,22.143,203,159,101,58,44,18,26,64,0.0,0.0
1004,368,23-09-2019 23:54:00,0,4581.0,3695.0,0.807,22.139,225,184,130,54,41,15,26,71,0.0,0.0
1004,369,23-09-2019 23:56:00,0,4783.0,3835.0,0.802,23.09,258,177,126,51,81,50,31,67,0.03,0.0
1004,370,23-09-2019 23:58:00,0,4557.0,3790.0,0.832,22.151,172,121,74,47,51,27,24,9,0.14,0.0
1004,371,24-09-2019 00:00:00,0,4366.0,3624.0,0.83,21.216,324,199,146,53,125,72,53,72,0.0,0.0
1004,372,24-09-2019 00:02:00,0,5062.0,4075.0,0.805,24.458,178,122,78,44,56,9,47,80,0.0,0.0
1004,373,24-09-2019 00:04:00,0,5046.0,4138.0,0.82,24.462,250,151,105,46,99,60,39,44,0.2,0.0
1004,374,24-09-2019 00:06:00,0,5048.0,4108.0,0.814,24.438,245,185,128,57,60,15,45,72,0.0,0.0
1004,375,24-09-2019 00:08:00,0,5015.0,4238.0,0.845,24.451,215,161,102,59,54,7,47,70,0.0,0.0
1004,376,24-09-2019 00:10:00,0,5017.0,4203.0,0.838,24.421,222,174,114,60,48,3,45,73,0.0,0.0
1004,377,24-09-2019 00:12:00,0,5054.0,4272.0,0.8455,24.642,239,166,127,39,73,16,57,72,0.0,0.0
1004,378,24-09-2019 00:14:00,0,5091.0,4341.0,0.853,24.863,188,117,67,50,71,25,46,66,0.06,0.0
1004,379,24-09-2019 00:16:00,0,5181.0,4503.0,0.869,25.4,279,145,100,45,134,93,41,65,0.05,0.0
1004,380,24-09-2019 00:18:00,0,5181.0,4520.0,0.872,25.418,277,151,104,47,126,87,39,54,0.01,0.0
1004,381,24-09-2019 00:20:00,0,5190.0,4460.0,0.859,25.385,225,155,114,41,70,29,41,55,0.09,0.02
1004,382,24-09-2019 00:22:00,0,5383.0,4642.0,0.862,26.349,184,122,79,43,62,20,42,75,0.0,0.01
1004,383,24-09-2019 00:24:00,0,5269.0,4655.0,0.883,25.913,134,92,56,36,42,15,27,22,0.05,0.02
1004,384,24-09-2019 00:26:00,0,4053.0,3530.0,0.871,19.877,164,116,82,34,48,21,27,12,0.0,0.0
1004,385,24-09-2019 00:28:00,0,4698.0,4119.0,0.877,23.071,400,207,161,46,193,156,37,213,0.02,0.0
1004,386,24-09-2019 00:30:00,0,5011.0,4306.0,0.859,24.509,379,186,154,32,193,137,56,116,0.02,0.01
1004,387,24-09-2019 00:32:00,0,5373.0,4691.0,0.873,26.363,202,135,94,41,67,22,45,53,0.01,0.0
1004,388,24-09-2019 00:34:00,0,5361.0,4723.0,0.881,26.349,162,116,74,42,46,1,45,52,0.0,0.04
1004,389,24-09-2019 00:36:00,0,5433.0,4840.0,0.891,26.765,170,125,79,46,45,14,31,32,0.0,0.14
1004,390,24-09-2019 00:38:00,0,5325.0,4818.0,0.905,26.316,187,128,82,46,59,9,50,52,0.01,0.06
1004,391,24-09-2019 00:40:00,0,5521.0,4909.0,0.889,27.187,189,122,75,47,67,21,46,32,0.16,0.08
1004,392,24-09-2019 00:42:00,0,5349.0,4767.0,0.891,26.352,536,273,223,50,263,215,48,42,0.02,0.0
1004,393,24-09-2019 00:44:00,0,4691.0,4199.0,0.895,23.133,236,110,77,33,126,92,34,88,0.12,0.0
1004,394,24-09-2019 00:46:00,0,4970.0,4464.5,0.898,24.5245,115,80,43,37,35,10,25,55,0.0,0.08
1004,395,24-09-2019 00:48:00,0,5249.0,4730.0,0.901,25.916,219,130,83,47,89,32,57,68,0.0,0.0
1004,396,24-09-2019 00:50:00,0,5137.0,4674.0,0.91,25.415,387,233,171,62,154,113,41,25,0.09,0.0
1004,397,24-09-2019 00:52:00,0,4898.0,4252.0,0.868,24.005,291,153,110,43,138,96,42,37,0.01,0.09
1004,398,24-09-2019 00:54:00,0,5165.0,4568.0,0.884,25.408,120,95,49,46,25,3,22,55,0.0,0.0
1004,399,24-09-2019 00:56:00,0,5163.0,4563.0,0.884,25.394,151,88,60,28,63,25,38,66,0.0,0.0
1004,400,24-09-2019 00:58:00,0,5147.0,4605.0,0.895,25.378,255,146,102,44,109,78,31,87,0.0,0.0
1004,401,24-09-2019 01:00:00,0,5121.0,4693.0,0.916,25.374,198,100,69,31,98,49,49,62,0.19,0.0
1004,402,24-09-2019 01:02:00,0,5204.0,4786.0,0.92,25.801,385,215,166,49,170,127,43,59,0.04,0.03
1004,403,24-09-2019 01:04:00,0,5212.0,4823.0,0.925,25.876,161,103,71,32,58,6,52,86,0.01,0.0
1004,404,24-09-2019 01:06:00,0,5171.0,4635.0,0.896,25.505,156,97,54,43,59,2,57,75,0.0,0.09
1004,405,24-09-2019 01:08:00,0,5108.0,4636.0,0.908,25.257,241,145,107,38,96,63,33,119,0.0,0.02
1004,406,24-09-2019 01:10:00,0,5131.0,4692.0,0.914,25.411,262,135,107,28,127,90,37,82,0.08,0.0
1004,407,24-09-2019 01:12:00,0,4961.0,4403.0,0.888,24.421,460,240,189,51,220,159,61,54,0.03,0.0
1004,408,24-09-2019 01:14:00,0,4936.0,4452.0,0.902,24.375,189,118,80,38,71,44,27,93,0.01,0.01
1004,409,24-09-2019 01:16:00,0,4297.0,3907.0,0.909,21.256,210,126,82,44,84,39,45,73,0.03,0.03
1004,410,24-09-2019 01:18:00,0,4867.0,4329.0,0.889,23.97,113,66,39,27,47,0,47,71,0.0,0.02
1004,411,24-09-2019 01:20:00,0,4756.0,4320.5,0.9085,23.522,194,101,72,29,93,41,52,61,0.0,0.1
1004,412,24-09-2019 01:22:00,0,4645.0,4312.0,0.928,23.074,270,149,105,44,121,82,39,11,0.0,0.01
1004,413,24-09-2019 01:24:00,0,3867.0,3371.0,0.872,18.97,136,53,16,37,83,47,36,0,0.0,0.0
1004,414,24-09-2019 01:26:00,0,3762.0,3242.0,0.862,18.412,95,47,17,30,48,25,23,0,0.0,0.0
1004,415,24-09-2019 01:28:00,0,3556.0,3203.0,0.901,17.555,292,140,107,33,152,113,39,35,0.09,0.0
1004,416,24-09-2019 01:30:00,0,4381.0,3985.0,0.91,21.674,204,113,88,25,91,63,28,41,0.0,0.01
1004,417,24-09-2019 01:32:00,0,4848.0,4441.0,0.916,24.018,155,72,43,29,83,57,26,49,0.14,0.0
1004,418,24-09-2019 01:34:00,0,4844.0,4447.0,0.918,24.009,258,129,97,32,129,87,42,29,0.0,0.0
1004,419,24-09-2019 01:36:00,0,3562.0,3229.0,0.907,17.607,203,107,68,39,96,63,33,71,0.01,0.0
1004,420,24-09-2019 01:38:00,0,3583.0,3121.0,0.871,17.572,82,52,15,37,30,9,21,0,0.0,0.0
1004,421,24-09-2019 01:40:00,0,3863.0,3376.0,0.874,18.96,45,37,13,24,8,2,6,0,0.01,0.0
1004,422,24-09-2019 01:42:00,0,3751.0,3306.0,0.881,18.441,69,41,2,39,28,8,20,0,0.0,0.0
1004,423,24-09-2019 01:44:00,0,4050.0,3537.0,0.873,19.874,119,50,20,30,69,42,27,4,0.0,0.0
1004,424,24-09-2019 01:46:00,0,4377.0,4056.0,0.927,21.737,23,8,0,8,15,10,5,3,0.0,0.0
1004,425,24-09-2019 01:48:00,0,4035.0,3556.0,0.881,19.836,11,7,0,7,4,0,4,0,0.0,0.0
1004,426,24-09-2019 01:50:00,0,3836.0,3411.0,0.889,18.891,1,0,0,0,1,0,1,0,0.0,0.0
1004,427,24-09-2019 01:52:00,0,3643.0,3265.0,0.896,17.969,17,2,1,1,15,0,15,0,0.0,0.0
1004,428,24-09-2019 01:54:00,0,3490.5,3157.0,0.905,17.2475,3,0,0,0,3,0,3,0,0.0,0.0
1004,429,24-09-2019 01:56:00,0,3338.0,3049.0,0.914,16.526,25,10,6,4,15,7,8,0,0.0,0.0
1004,430,24-09-2019 01:58:00,0,3370.0,3063.0,0.909,16.667,5,5,1,4,0,0,0,0,0.0,0.0
1004,431,24-09-2019 02:00:00,0,3291.0,2905.0,0.883,16.183,56,25,8,17,31,20,11,0,0.0,0.0
1004,432,24-09-2019 02:02:00,0,3351.0,3068.0,0.916,16.597,271,146,110,36,125,88,37,56,0.0,0.0
1004,433,24-09-2019 02:04:00,0,3606.0,3400.0,0.943,17.972,345,186,150,36,159,122,37,92,0.0,0.0
1004,434,24-09-2019 02:06:00,0,3526.0,3374.0,0.957,17.627,133,84,60,24,49,36,13,92,0.03,0.0
1004,435,24-09-2019 02:08:00,0,3822.0,3550.0,0.929,18.989,296,94,62,32,202,160,42,29,0.0,0.0
1004,436,24-09-2019 02:10:00,0,3341.0,3151.0,0.943,16.651,145,82,53,29,63,33,30,64,0.0,0.0
1004,437,24-09-2019 02:12:00,0,3824.0,3506.0,0.917,18.946,117,60,36,24,57,16,41,53,0.0,0.0
1004,438,24-09-2019 02:14:00,0,3826.0,3476.0,0.909,18.921,71,41,22,19,30,0,30,50,0.0,0.09
1004,439,24-09-2019 02:16:00,0,3821.0,3499.0,0.916,18.928,100,56,30,26,44,0,44,63,0.0,0.01
1004,440,24-09-2019 02:18:00,0,3927.0,3602.0,0.917,19.462,224,133,103,30,91,53,38,46,0.13,0.03
1004,441,24-09-2019 02:20:00,0,4006.0,3640.0,0.909,19.815,395,188,136,52,207,150,57,5,0.03,0.0
1004,442,24-09-2019 02:22:00,0,3443.0,3198.0,0.929,17.104,228,130,89,41,98,69,29,33,0.0,0.01
1004,443,24-09-2019 02:24:00,0,3896.0,3597.0,0.923,19.332,90,78,44,34,12,2,10,7,0.0,0.0
1004,444,24-09-2019 02:26:00,0,3832.0,3483.0,0.909,18.953,122,52,24,28,70,46,24,2,0.0,0.0
1004,445,24-09-2019 02:28:00,0,3680.0,3418.0,0.9295,18.283,221,131,93,38,90,60,30,24,0.0,0.0
1004,446,24-09-2019 02:30:00,0,3528.0,3353.0,0.95,17.613,200,92,66,26,108,78,30,52,0.0,0.0
1004,447,24-09-2019 02:32:00,0,3812.0,3476.0,0.912,18.865,59,18,5,13,41,19,22,0,0.01,0.0
1004,448,24-09-2019 02:34:00,0,3810.0,3551.0,0.932,18.942,58,24,13,11,34,9,25,0,0.0,0.0
1004,449,24-09-2019 02:36:00,0,3824.0,3521.0,0.921,18.964,12,5,3,2,7,2,5,0,0.0,0.0
1004,450,24-09-2019 02:38:00,0,3733.0,3362.0,0.901,18.43,0,0,0,0,0,0,0,0,0.0,0.0
1004,451,24-09-2019 02:40:00,0,3348.0,3094.0,0.924,16.618,55,2,1,1,53,43,10,0,0.0,0.0
1004,452,24-09-2019 02:42:00,0,3396.0,2919.0,0.86,16.611,41,0,0,0,41,0,41,0,0.0,0.0
1004,453,24-09-2019 02:44:00,0,3195.0,2795.0,0.875,15.685,30,6,3,3,24,2,22,0,0.0,0.0
1004,454,24-09-2019 02:46:00,0,3194.0,2842.0,0.89,15.729,2,1,0,1,1,0,1,0,0.0,0.0
1004,455,24-09-2019 02:48:00,0,3175.0,2891.0,0.91,15.711,4,3,1,2,1,0,1,0,0.0,0.0
1004,456,24-09-2019 02:50:00,0,3186.0,2825.0,0.887,15.682,10,1,0,1,9,0,9,0,0.0,0.0
1004,457,24-09-2019 02:52:00,0,2996.0,2728.0,0.91,14.823,6,1,0,1,5,3,2,0,0.0,0.0
1004,458,24-09-2019 02:54:00,0,2888.0,2592.0,0.898,14.247,2,1,0,1,1,0,1,0,0.0,0.0
1004,459,24-09-2019 02:56:00,0,2915.0,2552.0,0.876,14.311,6,0,0,0,6,2,4,0,0.0,0.0
1004,460,24-09-2019 02:58:00,0,2917.0,2527.0,0.866,14.292,14,7,4,3,7,0,7,0,0.0,0.0
1004,461,24-09-2019 03:00:00,0,2817.0,2525.0,0.896,13.896,3,2,0,2,1,0,1,0,0.0,0.0
1004,462,24-09-2019 03:02:00,0,2771.0,2457.0,0.8865,13.6375,6,2,0,2,4,0,4,0,0.0,0.0
1004,463,24-09-2019 03:04:00,0,2725.0,2389.0,0.877,13.379,16,11,4,7,5,0,5,0,0.0,0.0
1004,464,24-09-2019 03:06:00,0,2728.0,2381.0,0.873,13.383,110,65,40,25,45,24,21,0,0.02,0.01
1004,465,24-09-2019 03:08:00,0,2922.0,2547.0,0.872,14.333,10,7,1,6,3,0,3,0,0.0,0.0
1004,466,24-09-2019 03:10:00,0,2704.0,2480.0,0.917,13.4,177,78,52,26,99,77,22,6,0.0,0.0
1004,467,24-09-2019 03:12:00,0,2877.0,2716.0,0.944,14.341,8,7,0,7,1,0,1,0,0.0,0.0
1004,468,24-09-2019 03:14:00,0,2911.0,2576.0,0.885,14.321,0,0,0,0,0,0,0,0,0.0,0.0
1004,469,24-09-2019 03:16:00,0,2690.0,2521.0,0.937,13.39,0,0,0,0,0,0,0,0,0.0,0.0
1004,470,24-09-2019 03:18:00,0,2695.0,2465.0,0.915,13.349,26,3,0,3,23,4,19,0,0.0,0.0
1004,471,24-09-2019 03:20:00,0,2807.0,2547.0,0.907,13.878,5,0,0,0,5,0,5,0,0.0,0.0
1004,472,24-09-2019 03:22:00,0,2902.0,2580.0,0.889,14.29,10,10,1,9,0,0,0,0,0.0,0.0
1004,473,24-09-2019 03:24:00,0,2914.0,2571.0,0.883,14.326,71,26,12,14,45,14,31,0,0.0,0.0
1004,474,24-09-2019 03:26:00,0,2901.0,2636.0,0.909,14.349,95,39,24,15,56,35,21,0,0.0,0.0
1004,475,24-09-2019 03:28:00,0,2694.0,2521.0,0.936,13.406,8,0,0,0,8,1,7,0,0.0,0.0
1004,476,24-09-2019 03:30:00,0,2715.0,2433.0,0.896,13.39,44,0,0,0,44,6,38,0,0.0,0.0
1004,477,24-09-2019 03:32:00,0,2722.0,2404.0,0.883,13.386,44,0,0,0,44,8,36,0,0.0,0.0
1004,478,24-09-2019 03:34:00,0,2627.0,2358.0,0.898,12.96,108,60,36,24,48,30,18,34,0.0,0.0
1004,479,24-09-2019 03:36:00,0,2942.0,2715.5,0.9205,14.5975,99,49,27,22,50,5,45,64,0.0,0.0
1004,480,24-09-2019 03:38:00,0,3257.0,3073.0,0.943,16.235,313,162,122,40,151,113,38,33,0.0,0.02
1004,481,24-09-2019 03:40:00,0,3161.0,2939.0,0.93,15.706,205,91,66,25,114,83,31,31,0.0,0.0
1004,482,24-09-2019 03:42:00,0,3166.0,2909.0,0.919,15.695,109,57,36,21,52,0,52,66,0.0,0.0
1004,483,24-09-2019 03:44:00,0,3530.0,3236.0,0.917,17.49,94,48,27,21,46,0,46,71,0.0,0.1
1004,484,24-09-2019 03:46:00,0,3520.0,3328.0,0.946,17.552,60,34,18,16,26,0,26,34,0.0,0.13
1004,485,24-09-2019 03:48:00,0,3508.0,3314.0,0.945,17.49,23,19,10,9,4,0,4,12,0.0,0.3
1004,486,24-09-2019 03:50:00,0,3533.0,3312.0,0.938,17.585,156,57,30,27,99,59,40,12,0.15,0.0
1004,487,24-09-2019 03:52:00,0,3171.0,2887.0,0.91,15.691,105,27,10,17,78,46,32,1,0.01,0.0
1004,488,24-09-2019 03:54:00,0,3172.0,2933.0,0.925,15.745,339,120,90,30,219,177,42,39,0.09,0.0
1004,489,24-09-2019 03:56:00,0,3524.0,3411.0,0.968,17.662,260,141,98,43,119,97,22,23,0.03,0.04
1004,490,24-09-2019 03:58:00,0,4160.0,3871.0,0.93,20.677,314,133,96,37,181,134,47,32,0.11,0.01
1004,491,24-09-2019 04:00:00,0,3713.0,3453.0,0.93,18.453,94,28,15,13,66,47,19,0,0.0,0.0
1004,492,24-09-2019 04:02:00,0,3818.0,3493.0,0.915,18.909,32,14,1,13,18,1,17,0,0.0,0.0
1004,493,24-09-2019 04:04:00,0,3715.0,3432.0,0.924,18.434,45,31,6,25,14,4,10,0,0.0,0.0
1004,494,24-09-2019 04:06:00,0,3617.0,3379.0,0.934,17.992,14,10,6,4,4,1,3,0,0.0,0.0
1004,495,24-09-2019 04:08:00,0,3554.0,3189.0,0.897,17.534,36,7,2,5,29,3,26,0,0.0,0.0
1004,496,24-09-2019 04:10:00,0,3453.5,3155.0,0.914,17.1,57,13,0,13,44,2,42,0,0.01,0.0
1004,497,24-09-2019 04:12:00,0,3353.0,3121.0,0.931,16.666,34,11,5,6,23,2,21,0,0.0,0.0
1004,498,24-09-2019 04:14:00,0,3551.0,3223.0,0.908,17.561,30,5,1,4,25,0,25,0,0.0,0.0
1004,499,24-09-2019 04:16:00,0,3522.0,3291.0,0.935,17.519,0,0,0,0,0,0,0,0,0.0,0.0
1004,500,24-09-2019 04:18:00,0,3344.0,3125.0,0.934,16.635,33,5,3,2,28,2,26,0,0.0,0.0
1004,501,24-09-2019 04:20:00,0,3330.0,3098.0,0.93,16.549,3,0,0,0,3,0,3,0,0.0,0.0
1004,502,24-09-2019 04:22:00,0,3352.0,3070.0,0.916,16.604,28,12,7,5,16,12,4,0,0.01,0.0
1004,503,24-09-2019 04:24:00,0,3368.0,3024.0,0.898,16.615,56,5,3,2,51,5,46,0,0.0,0.0
1004,504,24-09-2019 04:26:00,0,3090.0,2768.0,0.896,15.239,11,0,0,0,11,2,9,0,0.0,0.0
1004,505,24-09-2019 04:28:00,0,2979.0,2740.0,0.919,14.772,9,0,0,0,9,2,7,0,0.0,0.0
1004,506,24-09-2019 04:30:00,0,2991.0,2766.0,0.925,14.846,9,2,1,1,7,1,6,0,0.0,0.0
1004,507,24-09-2019 04:32:00,0,2883.0,2684.0,0.931,14.328,23,3,1,2,20,0,20,0,0.0,0.0
1004,508,24-09-2019 04:34:00,0,2864.0,2696.0,0.941,14.269,11,7,1,6,4,2,2,0,0.0,0.0
1004,509,24-09-2019 04:36:00,0,2888.0,2630.0,0.911,14.289,120,52,37,15,68,42,26,0,0.0,0.0
1004,510,24-09-2019 04:38:00,0,3075.0,2831.0,0.92,15.25,64,18,7,11,46,14,32,5,0.0,0.0
1004,511,24-09-2019 04:40:00,0,3171.0,2898.0,0.914,15.701,176,19,9,10,157,116,41,2,0.0,0.0
1004,512,24-09-2019 04:42:00,0,3157.0,2994.0,0.949,15.753,120,80,37,43,40,10,30,0,0.0,0.0
1004,513,24-09-2019 04:44:00,0,3241.5,3118.0,0.962,16.223,77,35,8,27,42,16,26,0,0.0,0.0
1004,514,24-09-2019 04:46:00,0,3326.0,3242.0,0.975,16.693,162,67,34,33,95,52,43,2,0.0,0.0
1004,515,24-09-2019 04:48:00,0,3525.0,3299.0,0.936,17.541,20,12,7,5,8,2,6,0,0.0,0.0
1004,516,24-09-2019 04:50:00,0,3348.0,3114.0,0.93,16.639,4,0,0,0,4,1,3,0,0.0,0.0
1004,517,24-09-2019 04:52:00,0,3256.0,2984.0,0.916,16.134,22,5,2,3,17,5,12,0,0.0,0.0
1004,518,24-09-2019 04:54:00,0,3167.0,2903.0,0.917,15.69,12,3,0,3,9,3,6,0,0.0,0.0
1004,519,24-09-2019 04:56:00,0,3197.0,2804.0,0.877,15.701,31,10,6,4,21,6,15,0,0.0,0.0
1004,520,24-09-2019 04:58:00,0,3174.0,2913.0,0.918,15.731,14,4,1,3,10,5,5,0,0.0,0.0
1004,521,24-09-2019 05:00:00,0,3190.0,2885.0,0.904,15.762,23,16,2,14,7,2,5,0,0.0,0.0
1004,522,24-09-2019 05:02:00,0,3178.0,2837.0,0.893,15.663,124,64,39,25,60,32,28,25,0.0,0.0
1004,523,24-09-2019 05:04:00,0,3337.0,3145.0,0.943,16.629,195,90,57,33,105,70,35,23,0.0,0.0
1004,524,24-09-2019 05:06:00,0,3339.0,3110.0,0.931,16.599,182,88,71,17,94,63,31,42,0.0,0.0
1004,525,24-09-2019 05:08:00,0,3314.0,3218.0,0.971,16.62,25,23,0,23,2,1,1,0,0.0,0.0
1004,526,24-09-2019 05:10:00,0,3429.0,3244.0,0.946,17.103,306,162,124,38,144,111,33,39,0.0,0.0
1004,527,24-09-2019 05:12:00,0,3425.0,3262.0,0.952,17.106,227,62,34,28,165,131,34,8,0.16,0.0
1004,528,24-09-2019 05:14:00,0,3336.0,3139.0,0.941,16.621,232,65,34,31,167,120,47,0,0.0,0.0
1004,529,24-09-2019 05:16:00,0,3324.0,3203.0,0.964,16.643,199,38,12,26,161,111,50,0,0.01,0.0
1004,530,24-09-2019 05:18:00,0,3382.5,3225.0,0.954,16.897,81,10,0,10,71,29,42,0,0.0,0.0
1004,531,24-09-2019 05:20:00,0,3441.0,3247.0,0.944,17.151,50,1,0,1,49,4,45,0,0.0,0.0
1004,532,24-09-2019 05:22:00,0,3340.0,3134.0,0.938,16.628,32,0,0,0,32,0,32,0,0.0,0.0
1004,533,24-09-2019 05:24:00,0,3355.0,3050.0,0.909,16.593,24,12,7,5,12,2,10,0,0.01,0.0
1004,534,24-09-2019 05:26:00,0,3373.0,3018.0,0.895,16.629,5,1,1,0,4,0,4,0,0.0,0.0
1004,535,24-09-2019 05:28:00,0,3163.0,2880.0,0.911,15.649,7,3,1,2,4,1,3,0,0.0,0.0
1004,536,24-09-2019 05:30:00,0,3191.0,2865.0,0.898,15.743,22,10,7,3,12,10,2,0,0.0,0.0
1004,537,24-09-2019 05:32:00,0,3530.0,3304.0,0.936,17.565,62,33,19,14,29,17,12,40,0.0,0.0
1004,538,24-09-2019 05:34:00,0,3426.0,3256.0,0.95,17.101,264,115,85,30,149,113,36,46,0.0,0.0
1004,539,24-09-2019 05:36:00,0,3511.0,3381.0,0.963,17.577,159,96,70,26,63,38,25,35,0.0,0.0
1004,540,24-09-2019 05:38:00,0,3727.0,3531.0,0.948,18.592,159,93,69,24,66,22,44,70,0.0,0.0
1004,541,24-09-2019 05:40:00,0,3328.0,3138.0,0.943,16.586,235,96,67,29,139,102,37,29,0.15,0.0
1004,542,24-09-2019 05:42:00,0,3713.0,3496.0,0.942,18.497,232,66,28,38,166,113,53,7,0.01,0.0
1004,543,24-09-2019 05:44:00,0,3497.0,3414.0,0.976,17.559,91,54,25,29,37,10,27,0,0.0,0.0
1004,544,24-09-2019 05:46:00,0,3511.0,3375.0,0.961,17.57,105,55,26,29,50,19,31,0,0.0,0.0
1004,545,24-09-2019 05:48:00,0,3789.0,3568.0,0.942,18.877,162,98,60,38,64,13,51,92,0.0,0.0
1004,546,24-09-2019 05:50:00,0,4289.0,3970.0,0.926,21.294,111,60,34,26,51,7,44,64,0.0,0.0
1004,547,24-09-2019 05:52:00,0,4103.5,3807.0,0.928,20.383,155,70,38,32,85,49,36,47,0.0,0.03
1004,548,24-09-2019 05:54:00,0,3918.0,3644.0,0.93,19.472,125,81,46,35,44,6,38,70,0.0,0.0
1004,549,24-09-2019 05:56:00,0,4269.0,3983.0,0.933,21.231,122,76,52,24,46,0,46,79,0.0,0.0
1004,550,24-09-2019 05:58:00,0,4235.0,4113.0,0.971,21.24,126,83,45,38,43,2,41,88,0.0,0.0
1004,551,24-09-2019 06:00:00,1,4260.0,4078.0,0.957,21.3,348,184,150,34,164,124,40,63,0.11,0.05
1004,552,24-09-2019 06:02:00,1,4263.0,4054.0,0.951,21.282,230,127,96,31,103,77,26,61,0.01,0.02
1004,553,24-09-2019 06:04:00,1,4255.0,4025.0,0.946,21.22,134,90,56,34,44,12,32,47,0.0,0.02
1004,554,24-09-2019 06:06:00,1,4264.0,3981.0,0.933,21.208,282,174,140,34,108,81,27,115,0.02,0.0
1004,555,24-09-2019 06:08:00,1,4271.0,3959.0,0.927,21.21,143,101,65,36,42,22,20,18,0.01,0.0
1004,556,24-09-2019 06:10:00,1,3171.0,2926.0,0.923,15.732,125,77,52,25,48,5,43,26,0.01,0.0
1004,557,24-09-2019 06:12:00,1,4360.0,4108.0,0.942,21.726,91,57,31,26,34,0,34,48,0.0,0.03
1004,558,24-09-2019 06:14:00,1,4843.0,4586.0,0.947,24.16,132,68,45,23,64,2,62,82,0.0,0.0
1004,559,24-09-2019 06:16:00,1,4892.0,4639.0,0.948,24.41,114,68,44,24,46,4,42,62,0.0,0.14
1004,560,24-09-2019 06:18:00,1,4885.0,4728.0,0.968,24.479,122,73,46,27,49,2,47,67,0.01,0.17
1004,561,24-09-2019 06:20:00,1,4907.0,4639.0,0.945,24.471,168,102,65,37,66,39,27,13,0.18,0.0
1004,562,24-09-2019 06:22:00,1,4594.0,4483.0,0.976,23.065,118,64,41,23,54,2,52,62,0.0,0.0
1004,563,24-09-2019 06:24:00,1,4934.0,4582.0,0.929,24.511,123,69,48,21,54,0,54,80,0.0,0.0
1004,564,24-09-2019 06:26:00,1,4644.0,4336.0,0.934,23.0965,183,111,80,31,72,27,45,40,0.08,0.04
1004,565,24-09-2019 06:28:00,1,4354.0,4090.0,0.939,21.682,176,115,84,31,61,43,18,4,0.01,0.0
1004,566,24-09-2019 06:30:00,1,3821.0,3532.0,0.925,18.964,35,20,8,12,15,1,14,0,0.0,0.01
1004,567,24-09-2019 06:32:00,1,4292.0,3873.0,0.902,21.196,28,12,4,8,16,4,12,0,0.0,0.0
1004,568,24-09-2019 06:34:00,1,4196.0,3837.0,0.914,20.778,65,45,17,28,20,2,18,0,0.0,0.0
1004,569,24-09-2019 06:36:00,1,4351.0,4083.0,0.938,21.664,0,0,0,0,0,0,0,0,0.0,0.0
1004,570,24-09-2019 06:38:00,1,4275.0,3971.0,0.929,21.238,3,2,0,2,1,0,1,0,0.0,0.0
1004,571,24-09-2019 06:40:00,1,3992.0,3728.0,0.934,19.856,16,11,4,7,5,0,5,0,0.0,0.0
1004,572,24-09-2019 06:42:00,1,3803.0,3559.0,0.936,18.923,2,2,1,1,0,0,0,0,0.01,0.0
1004,573,24-09-2019 06:44:00,1,3823.0,3485.0,0.912,18.923,15,12,5,7,3,1,2,0,0.0,0.0
1004,574,24-09-2019 06:46:00,1,3635.0,3351.0,0.922,18.031,0,0,0,0,0,0,0,0,0.0,0.0
1004,575,24-09-2019 06:48:00,1,3554.0,3274.0,0.921,17.625,2,2,2,0,0,0,0,0,0.0,0.0
1004,576,24-09-2019 06:50:00,1,3449.0,3204.0,0.929,17.136,16,13,9,4,3,1,2,0,0.0,0.0
1004,577,24-09-2019 06:52:00,1,3343.0,3105.0,0.929,16.61,2,0,0,0,2,0,2,0,0.0,0.0
1004,578,24-09-2019 06:54:00,1,3375.0,2995.0,0.888,16.612,33,19,8,11,14,0,14,0,0.0,0.0
1004,579,24-09-2019 06:56:00,1,3264.0,2971.0,0.91,16.151,17,14,8,6,3,0,3,0,0.0,0.0
1004,580,24-09-2019 06:58:00,1,3181.0,2814.0,0.885,15.65,0,0,0,0,0,0,0,0,0.0,0.0
1004,581,24-09-2019 07:00:00,1,3043.0,2706.5,0.89,14.9865,0,0,0,0,0,0,0,0,0.0,0.01
1004,582,24-09-2019 07:02:00,1,2905.0,2599.0,0.895,14.323,0,0,0,0,0,0,0,0,0.0,0.0
1004,583,24-09-2019 07:04:00,1,2904.0,2593.0,0.893,14.315,0,0,0,0,0,0,0,0,0.0,0.0
1004,584,24-09-2019 07:06:00,1,2925.0,2531.0,0.865,14.328,24,14,6,8,10,3,7,0,0.0,0.0
1004,585,24-09-2019 07:08:00,1,3088.0,2760.0,0.894,15.223,193,94,59,35,99,62,37,26,0.0,0.0
1004,586,24-09-2019 07:10:00,1,3829.0,3523.0,0.92,18.989,99,60,42,18,39,16,23,45,0.0,0.0
1004,587,24-09-2019 07:12:00,1,3803.0,3600.0,0.947,18.97,228,90,62,28,138,98,40,17,0.0,0.0
1004,588,24-09-2019 07:14:00,1,3810.0,3557.0,0.933,18.95,127,67,38,29,60,0,60,76,0.0,0.0
1004,589,24-09-2019 07:16:00,1,4001.0,3716.0,0.929,19.876,118,59,35,24,59,0,59,80,0.0,0.03
1004,590,24-09-2019 07:18:00,1,3966.0,3788.0,0.955,19.818,132,76,45,31,56,0,56,78,0.0,0.06
1004,591,24-09-2019 07:20:00,1,4182.0,3924.0,0.938,20.822,118,72,44,28,46,5,41,50,0.0,0.06
1004,592,24-09-2019 07:22:00,1,3959.0,3880.0,0.98,19.893,220,117,84,33,103,77,26,18,0.09,0.0
1004,593,24-09-2019 07:24:00,1,3510.0,3349.0,0.954,17.537,165,46,20,26,119,80,39,1,0.01,0.0
1004,594,24-09-2019 07:26:00,1,3992.0,3643.0,0.913,19.761,142,50,30,20,92,62,30,0,0.18,0.09
1004,595,24-09-2019 07:28:00,1,4246.0,4098.0,0.965,21.265,99,63,38,25,36,5,31,54,0.0,0.11
1004,596,24-09-2019 07:30:00,1,4257.0,3989.0,0.937,21.19,125,74,47,27,51,0,51,65,0.0,0.0
1004,597,24-09-2019 07:32:00,1,4252.0,4053.0,0.953,21.239,98,58,28,30,40,0,40,52,0.0,0.0
1004,598,24-09-2019 07:34:00,1,3984.5,3766.5,0.9445,19.8675,185,111,77,34,74,40,34,29,0.0,0.01
1004,599,24-09-2019 07:36:00,1,3717.0,3480.0,0.936,18.496,24,23,3,20,1,0,1,0,0.0,0.0
1004,600,24-09-2019 07:38:00,1,3425.0,3223.0,0.941,17.064,65,50,27,23,15,3,12,0,0.0,0.0
1004,601,24-09-2019 07:40:00,1,3622.0,3390.0,0.936,18.025,14,10,0,10,4,1,3,0,0.0,0.0
1004,602,24-09-2019 07:42:00,1,3612.0,3412.0,0.945,18.007,13,6,3,3,7,2,5,0,0.0,0.0
1004,603,24-09-2019 07:44:00,1,3491.0,3367.0,0.965,17.48,12,9,5,4,3,1,2,0,0.0,0.0
1004,604,24-09-2019 07:46:00,1,3439.0,3225.0,0.938,17.12,0,0,0,0,0,0,0,0,0.0,0.0
1004,605,24-09-2019 07:48:00,1,3324.0,3196.0,0.962,16.633,1,1,0,1,0,0,0,0,0.0,0.01
1004,606,24-09-2019 07:50:00,1,3239.0,3107.0,0.959,16.201,2,2,0,2,0,0,0,0,0.0,0.0
1004,607,24-09-2019 07:52:00,1,3253.0,2996.0,0.921,16.133,0,0,0,0,0,0,0,0,0.0,0.0
1004,608,24-09-2019 07:54:00,1,3051.0,2907.0,0.953,15.238,0,0,0,0,0,0,0,0,0.0,0.0
1004,609,24-09-2019 07:56:00,1,3070.0,2823.0,0.92,15.219,30,21,16,5,9,1,8,0,0.0,0.0
1004,610,24-09-2019 07:58:00,1,3089.0,2803.0,0.907,15.274,7,5,2,3,2,1,1,0,0.0,0.0
1004,611,24-09-2019 08:00:00,1,2974.0,2763.0,0.929,14.777,0,0,0,0,0,0,0,0,0.0,0.0
1004,612,24-09-2019 08:02:00,1,2864.0,2734.0,0.955,14.311,6,0,0,0,6,2,4,0,0.0,0.0
1004,613,24-09-2019 08:04:00,1,2790.0,2630.0,0.943,13.904,2,0,0,0,2,1,1,0,0.0,0.0
1004,614,24-09-2019 08:06:00,1,2779.0,2630.0,0.946,13.861,4,0,0,0,4,0,4,0,0.0,0.0
1004,615,24-09-2019 08:08:00,1,2881.0,2673.0,0.928,14.3095,5,0,0,0,5,2,3,0,0.0,0.0
1004,616,24-09-2019 08:10:00,1,2983.0,2716.0,0.91,14.758,16,0,0,0,16,5,11,0,0.0,0.0
1004,617,24-09-2019 08:12:00,1,3083.0,2776.0,0.9,15.22,61,26,18,8,35,10,25,0,0.0,0.0
1004,618,24-09-2019 08:14:00,1,3188.0,2841.0,0.891,15.707,7,0,0,0,7,4,3,0,0.0,0.0
1004,619,24-09-2019 08:16:00,1,2988.0,2699.0,0.903,14.761,1,1,1,0,0,0,0,0,0.0,0.0
1004,620,24-09-2019 08:18:00,1,2891.0,2655.0,0.918,14.331,164,70,48,22,94,64,30,0,0.0,0.0
1004,621,24-09-2019 08:20:00,1,3357.0,3088.0,0.92,16.646,128,64,39,25,64,34,30,39,0.0,0.0
1004,622,24-09-2019 08:22:00,1,3586.0,3494.0,0.974,17.997,195,126,79,47,69,48,21,16,0.0,0.0
1004,623,24-09-2019 08:24:00,1,3488.0,3450.0,0.989,17.56,338,210,162,48,128,90,38,29,0.0,0.0
1004,624,24-09-2019 08:26:00,1,3809.0,3582.0,0.941,18.973,160,56,34,22,104,71,33,39,0.0,0.04
1004,625,24-09-2019 08:28:00,1,3492.0,3436.0,0.984,17.562,227,126,87,39,101,72,29,63,0.13,0.0
1004,626,24-09-2019 08:30:00,1,3318.0,3240.0,0.977,16.658,25,12,6,6,13,6,7,0,0.0,0.0
1004,627,24-09-2019 08:32:00,1,3346.0,3159.0,0.944,16.681,53,22,7,15,31,14,17,7,0.0,0.0
1004,628,24-09-2019 08:34:00,1,3507.0,3345.0,0.954,17.52,99,47,33,14,52,34,18,24,0.0,0.0
1004,629,24-09-2019 08:36:00,1,3808.0,3561.0,0.935,18.944,69,43,20,23,26,1,25,66,0.0,0.0
1004,630,24-09-2019 08:38:00,1,3795.0,3678.0,0.969,19.025,47,41,24,17,6,0,6,68,0.0,0.08
1004,631,24-09-2019 08:40:00,1,3871.0,3669.0,0.948,19.314,314,177,117,60,137,91,46,6,0.0,0.0
1004,632,24-09-2019 08:42:00,1,3343.5,3062.0,0.91,16.5625,131,61,33,28,70,48,22,1,0.0,0.0
1004,633,24-09-2019 08:44:00,1,2816.0,2455.0,0.872,13.811,57,29,0,29,28,1,27,0,0.0,0.0
1004,634,24-09-2019 08:46:00,1,3365.0,3081.0,0.916,16.671,220,120,78,42,100,65,35,10,0.0,0.0
1004,635,24-09-2019 08:48:00,1,3984.0,3786.0,0.95,19.887,65,23,6,17,42,12,30,0,0.0,0.0
1004,636,24-09-2019 08:50:00,1,4008.0,3708.0,0.925,19.895,33,28,1,27,5,2,3,0,0.0,0.0
1004,637,24-09-2019 08:52:00,1,4009.0,3713.0,0.926,19.907,8,1,0,1,7,3,4,0,0.0,0.0
1004,638,24-09-2019 08:54:00,1,3810.0,3619.0,0.95,19.017,16,3,0,3,13,4,9,0,0.0,0.0
1004,639,24-09-2019 08:56:00,1,3800.0,3584.0,0.943,18.94,29,21,4,17,8,3,5,0,0.0,0.01
1004,640,24-09-2019 08:58:00,1,3711.0,3460.0,0.932,18.45,27,1,0,1,26,0,26,0,0.0,0.0
1004,641,24-09-2019 09:00:00,1,3517.0,3328.0,0.946,17.543,26,16,2,14,10,0,10,0,0.0,0.0
1004,642,24-09-2019 09:02:00,1,3344.0,3107.0,0.929,16.615,39,24,14,10,15,8,7,0,0.0,0.0
1004,643,24-09-2019 09:04:00,1,3370.0,3007.0,0.893,16.606,1,1,0,1,0,0,0,0,0.0,0.0
1004,644,24-09-2019 09:06:00,1,3158.0,2959.0,0.937,15.718,9,0,0,0,9,1,8,0,0.0,0.0
1004,645,24-09-2019 09:08:00,1,3104.0,2791.0,0.899,15.318,25,5,1,4,20,9,11,0,0.0,0.0
1004,646,24-09-2019 09:10:00,1,2878.0,2684.0,0.933,14.31,0,0,0,0,0,0,0,0,0.0,0.0
1004,647,24-09-2019 09:12:00,1,2883.0,2689.0,0.933,14.335,1,1,0,1,0,0,0,0,0.0,0.0
1004,648,24-09-2019 09:14:00,1,2968.0,2741.0,0.924,14.727,0,0,0,0,0,0,0,0,0.0,0.0
1004,649,24-09-2019 09:16:00,1,3077.0,2794.0,0.909,15.2155,23,9,4,5,14,7,7,0,0.0,0.0
1004,650,24-09-2019 09:18:00,1,3186.0,2847.0,0.894,15.704,0,0,0,0,0,0,0,0,0.0,0.0
1004,651,24-09-2019 09:20:00,1,2975.0,2773.0,0.932,14.792,20,4,2,2,16,4,12,0,0.0,0.0
1004,652,24-09-2019 09:22:00,1,3200.0,2817.0,0.88,15.728,9,3,1,2,6,2,4,0,0.0,0.0
1004,653,24-09-2019 09:24:00,1,2868.0,2741.0,0.956,14.333,21,14,3,11,7,4,3,0,0.0,0.0
1004,654,24-09-2019 09:26:00,1,2872.0,2713.0,0.945,14.32,53,17,8,9,36,13,23,0,0.0,0.0
1004,655,24-09-2019 09:28:00,1,3170.0,2914.0,0.919,15.714,153,74,44,30,79,51,28,36,0.02,0.01
1004,656,24-09-2019 09:30:00,1,3135.0,3029.0,0.966,15.707,228,113,85,28,115,82,33,41,0.0,0.01
1004,657,24-09-2019 09:32:00,1,3142.0,3017.0,0.96,15.721,291,158,116,42,133,93,40,27,0.04,0.0
1004,658,24-09-2019 09:34:00,1,3347.0,3095.0,0.925,16.615,362,269,217,52,93,58,35,18,0.0,0.0
1004,659,24-09-2019 09:36:00,1,3337.0,3201.0,0.959,16.693,253,123,85,38,130,90,40,18,0.0,0.0
1004,660,24-09-2019 09:38:00,1,3252.0,3012.0,0.926,16.145,58,39,12,27,19,3,16,0,0.0,0.0
1004,661,24-09-2019 09:40:00,1,3154.0,2955.0,0.937,15.697,77,35,12,23,42,9,33,6,0.0,0.0
1004,662,24-09-2019 09:42:00,1,3345.0,3133.0,0.936,16.649,9,8,1,7,1,0,1,0,0.0,0.0
1004,663,24-09-2019 09:44:00,1,3345.0,3129.0,0.935,16.641,5,5,0,5,0,0,0,0,0.01,0.0
1004,664,24-09-2019 09:46:00,1,3365.0,3065.0,0.911,16.651,12,5,1,4,7,3,4,0,0.0,0.0
1004,665,24-09-2019 09:48:00,1,3147.0,2947.0,0.936,15.663,18,1,0,1,17,6,11,0,0.0,0.0
1004,666,24-09-2019 09:50:00,1,3058.5,2858.5,0.9345,15.215,10,0,0,0,10,6,4,0,0.0,0.0
1004,667,24-09-2019 09:52:00,1,2970.0,2770.0,0.933,14.767,5,2,0,2,3,0,3,0,0.0,0.0
1004,668,24-09-2019 09:54:00,1,2880.0,2695.0,0.936,14.331,28,0,0,0,28,0,28,0,0.0,0.0
1004,669,24-09-2019 09:56:00,1,2911.0,2592.0,0.891,14.338,29,9,5,4,20,11,9,0,0.0,0.0
1004,670,24-09-2019 09:58:00,1,2692.0,2496.0,0.927,13.369,4,4,2,2,0,0,0,0,0.0,0.0
1004,671,24-09-2019 10:00:00,1,2708.0,2468.0,0.911,13.4,5,0,0,0,5,1,4,0,0.0,0.0
1004,672,24-09-2019 10:02:00,1,2705.0,2460.0,0.909,13.382,8,0,0,0,8,2,6,0,0.0,0.0
1004,673,24-09-2019 10:04:00,1,2714.0,2441.0,0.899,13.396,32,17,5,12,15,4,11,0,0.0,0.0
1004,674,24-09-2019 10:06:00,1,2682.0,2526.0,0.942,13.363,10,10,0,10,0,0,0,0,0.0,0.0
1004,675,24-09-2019 10:08:00,1,2692.0,2542.0,0.944,13.42,51,15,11,4,36,9,27,0,0.0,0.0
1004,676,24-09-2019 10:10:00,1,2686.0,2522.0,0.939,13.374,25,15,8,7,10,0,10,0,0.0,0.0
1004,677,24-09-2019 10:12:00,1,2703.0,2487.0,0.92,13.403,2,0,0,0,2,1,1,0,0.0,0.0
1004,678,24-09-2019 10:14:00,1,2722.0,2428.0,0.892,13.413,21,16,6,10,5,1,4,0,0.01,0.0
1004,679,24-09-2019 10:16:00,1,2717.0,2436.0,0.897,13.401,7,7,0,7,0,0,0,0,0.0,0.0
1004,680,24-09-2019 10:18:00,1,2724.0,2439.0,0.895,13.434,0,0,0,0,0,0,0,0,0.0,0.0
1004,681,24-09-2019 10:20:00,1,2724.0,2417.0,0.887,13.411,28,25,6,19,3,3,0,0,0.0,0.0
1004,682,24-09-2019 10:22:00,1,2614.0,2392.0,0.915,12.946,8,3,2,1,5,3,2,0,0.0,0.0
1004,683,24-09-2019 10:24:00,1,2668.5,2407.5,0.9025,13.1785,27,18,10,8,9,5,4,0,0.0,0.0
1004,684,24-09-2019 10:26:00,1,2723.0,2423.0,0.89,13.411,2,2,1,1,0,0,0,0,0.0,0.0
1004,685,24-09-2019 10:28:00,1,2609.0,2403.0,0.921,12.941,6,6,3,3,0,0,0,0,0.0,0.0
1004,686,24-09-2019 10:30:00,1,2606.0,2395.0,0.919,12.92,0,0,0,0,0,0,0,0,0.0,0.0
1004,687,24-09-2019 10:32:00,1,2718.0,2418.0,0.889,13.386,9,6,2,4,3,2,1,0,0.0,0.0
1004,688,24-09-2019 10:34:00,1,2717.0,2442.0,0.899,13.408,132,62,37,25,70,43,27,0,0.0,0.0
1004,689,24-09-2019 10:36:00,1,2873.0,2703.0,0.941,14.312,142,81,41,40,61,29,32,16,0.0,0.0
1004,690,24-09-2019 10:38:00,1,2962.0,2824.0,0.953,14.797,62,45,23,22,17,2,15,57,0.0,0.24
1004,691,24-09-2019 10:40:00,1,3161.0,3002.0,0.95,15.778,0,0,0,0,0,0,0,0,0.0,0.0
1004,692,24-09-2019 10:42:00,1,3143.0,2976.0,0.947,15.677,3,3,1,2,0,0,0,0,0.0,0.01
1004,693,24-09-2019 10:44:00,1,3259.0,3023.0,0.928,16.188,158,105,66,39,53,35,18,13,0.0,0.04
1004,694,24-09-2019 10:46:00,1,3171.0,2894.0,0.913,15.697,102,65,36,29,37,25,12,2,0.0,0.0
1004,695,24-09-2019 10:48:00,1,3254.0,3009.0,0.925,16.154,128,79,42,37,49,30,19,3,0.08,0.0
1004,696,24-09-2019 10:50:00,1,3302.0,3262.0,0.988,16.621,301,192,137,55,109,74,35,4,0.01,0.0
1004,697,24-09-2019 10:52:00,1,3530.0,3283.0,0.93,17.543,292,151,115,36,141,101,40,25,0.0,0.0
1004,698,24-09-2019 10:54:00,1,3529.0,3307.0,0.937,17.566,354,215,165,50,139,109,30,2,0.13,0.0
1004,699,24-09-2019 10:56:00,1,3511.0,3420.0,0.974,17.618,297,150,112,38,147,107,40,36,0.0,0.0
1004,700,24-09-2019 10:58:00,1,3517.5,3404.5,0.968,17.6275,374,273,210,63,101,64,37,9,0.01,0.0
1004,701,24-09-2019 11:00:00,1,3524.0,3389.0,0.962,17.637,203,76,50,26,127,80,47,2,0.0,0.0
1004,702,24-09-2019 11:02:00,1,3492.0,3416.0,0.978,17.538,76,48,17,31,28,2,26,3,0.0,0.0
1004,703,24-09-2019 11:04:00,1,3610.0,3442.0,0.954,18.035,19,11,2,9,8,2,6,0,0.0,0.0
1004,704,24-09-2019 11:06:00,1,3722.0,3477.0,0.934,18.514,53,37,13,24,16,2,14,0,0.0,0.0
1004,705,24-09-2019 11:08:00,1,3816.0,3545.0,0.929,18.957,47,16,0,16,31,10,21,0,0.0,0.0
1004,706,24-09-2019 11:10:00,1,3818.0,3585.0,0.939,19.013,79,52,27,25,27,8,19,0,0.0,0.0
1004,707,24-09-2019 11:12:00,1,3807.0,3510.0,0.922,18.886,76,47,22,25,29,10,19,1,0.0,0.0
1004,708,24-09-2019 11:14:00,1,3819.0,3494.0,0.915,18.915,9,8,0,8,1,0,1,0,0.0,0.0
1004,709,24-09-2019 11:16:00,1,3518.0,3333.0,0.947,17.552,0,0,0,0,0,0,0,0,0.0,0.0
1004,710,24-09-2019 11:18:00,1,3326.0,3208.0,0.965,16.656,0,0,0,0,0,0,0,0,0.0,0.0
1004,711,24-09-2019 11:20:00,1,3345.0,3061.0,0.915,16.568,2,2,1,1,0,0,0,0,0.01,0.0
1004,712,24-09-2019 11:22:00,1,3168.0,2954.0,0.932,15.752,1,1,0,1,0,0,0,0,0.0,0.0
1004,713,24-09-2019 11:24:00,1,3164.0,2846.0,0.899,15.618,3,3,2,1,0,0,0,0,0.0,0.0
1004,714,24-09-2019 11:26:00,1,3083.0,2788.0,0.904,15.232,0,0,0,0,0,0,0,0,0.0,0.0
1004,715,24-09-2019 11:28:00,1,2875.0,2714.0,0.944,14.334,27,9,5,4,18,7,11,0,0.0,0.0
1004,716,24-09-2019 11:30:00,1,2884.0,2699.0,0.936,14.35,44,0,0,0,44,38,6,0,0.0,0.0
1004,717,24-09-2019 11:32:00,1,2780.5,2616.5,0.941,13.8515,13,7,2,5,6,3,3,0,0.0,0.0
1004,718,24-09-2019 11:34:00,1,2677.0,2534.0,0.946,13.353,3,1,0,1,2,1,1,0,0.0,0.0
1004,719,24-09-2019 11:36:00,1,2706.0,2509.0,0.927,13.439,2,0,0,0,2,1,1,0,0.0,0.0
1004,720,24-09-2019 11:38:00,1,2706.0,2482.0,0.917,13.41,0,0,0,0,0,0,0,0,0.0,0.0
1004,721,24-09-2019 11:40:00,1,2716.0,2410.0,0.887,13.37,0,0,0,0,0,0,0,0,0.0,0.0
1004,722,24-09-2019 11:42:00,1,2505.0,2359.0,0.942,12.481,298,154,119,35,144,100,44,3,0.0,0.0
1004,723,24-09-2019 11:44:00,1,2903.0,2628.0,0.905,14.347,114,58,38,20,56,40,16,19,0.0,0.0
1004,724,24-09-2019 11:46:00,1,2886.0,2630.0,0.911,14.283,2,2,1,1,0,0,0,0,0.0,0.0
1004,725,24-09-2019 11:48:00,1,2888.0,2653.0,0.919,14.318,10,4,1,3,6,5,1,1,0.0,0.0
1004,726,24-09-2019 11:50:00,1,2896.0,2633.0,0.909,14.326,22,9,6,3,13,6,7,1,0.0,0.0
1004,727,24-09-2019 11:52:00,1,2914.0,2626.0,0.901,14.387,1,1,1,0,0,0,0,0,0.0,0.0
1004,728,24-09-2019 11:54:00,1,2691.0,2564.0,0.953,13.441,0,0,0,0,0,0,0,0,0.0,0.0
1004,729,24-09-2019 11:56:00,1,2698.0,2515.0,0.932,13.413,0,0,0,0,0,0,0,0,0.0,0.0
1004,730,24-09-2019 11:58:00,1,2691.0,2480.0,0.922,13.348,14,3,2,1,11,4,7,0,0.0,0.0
1004,731,24-09-2019 12:00:00,1,2705.0,2481.0,0.917,13.405,20,2,2,0,18,0,18,0,0.0,0.0
1004,732,24-09-2019 12:02:00,1,2699.0,2469.0,0.915,13.368,0,0,0,0,0,0,0,0,0.0,0.0
1004,733,24-09-2019 12:04:00,1,2732.0,2458.0,0.9,13.483,1,0,0,0,1,0,1,0,0.0,0.0
1004,734,24-09-2019 12:06:00,1,2727.5,2447.5,0.8975,13.455,11,4,2,2,7,4,3,0,0.0,0.0
1004,735,24-09-2019 12:08:00,1,2723.0,2437.0,0.895,13.427,8,8,0,8,0,0,0,0,0.0,0.0
1004,736,24-09-2019 12:10:00,1,2614.0,2404.0,0.919,12.962,1,1,0,1,0,0,0,0,0.0,0.0
1004,737,24-09-2019 12:12:00,1,2606.0,2380.0,0.913,12.903,23,4,0,4,19,2,17,0,0.0,0.0
1004,738,24-09-2019 12:14:00,1,2510.0,2330.0,0.928,12.47,125,69,29,40,56,24,32,0,0.0,0.0
1004,739,24-09-2019 12:16:00,1,2684.0,2516.0,0.938,13.36,149,83,58,25,66,26,40,53,0.0,0.0
1004,740,24-09-2019 12:18:00,1,2886.0,2714.0,0.94,14.377,165,103,68,35,62,37,25,13,0.0,0.0
1004,741,24-09-2019 12:20:00,1,2886.0,2718.0,0.942,14.379,176,99,63,36,77,47,30,20,0.0,0.0
1004,742,24-09-2019 12:22:00,1,2958.0,2835.0,0.958,14.795,217,131,96,35,86,62,24,3,0.0,0.0
1004,743,24-09-2019 12:24:00,1,2475.0,2418.0,0.977,12.429,93,36,9,27,57,22,35,1,0.0,0.0
1004,744,24-09-2019 12:26:00,1,2502.0,2348.0,0.938,12.456,126,72,33,39,54,20,34,0,0.0,0.0
1004,745,24-09-2019 12:28:00,1,2972.0,2797.0,0.941,14.808,47,19,7,12,28,4,24,1,0.0,0.0
1004,746,24-09-2019 12:30:00,1,3159.0,2916.0,0.923,15.675,44,35,0,35,9,1,8,0,0.0,0.0
1004,747,24-09-2019 12:32:00,1,3166.0,2960.0,0.935,15.753,41,36,0,36,5,1,4,0,0.0,0.0
1004,748,24-09-2019 12:34:00,1,3364.0,3068.0,0.912,16.651,19,11,1,10,8,1,7,0,0.0,0.0
1004,749,24-09-2019 12:36:00,1,3140.0,2956.0,0.941,15.642,0,0,0,0,0,0,0,0,0.0,0.0
1004,750,24-09-2019 12:38:00,1,3180.0,2905.0,0.914,15.744,2,1,0,1,1,1,0,0,0.0,0.0
1004,751,24-09-2019 12:40:00,1,3030.0,2815.5,0.93,15.0555,16,0,0,0,16,0,16,0,0.0,0.0
1004,752,24-09-2019 12:42:00,1,2880.0,2726.0,0.946,14.367,6,2,0,2,4,0,4,0,0.0,0.0
1004,753,24-09-2019 12:44:00,1,2892.0,2648.0,0.916,14.326,0,0,0,0,0,0,0,0,0.0,0.0
1004,754,24-09-2019 12:46:00,1,2787.0,2563.0,0.92,13.817,2,0,0,0,2,0,2,0,0.0,0.0
1004,755,24-09-2019 12:48:00,1,2696.0,2501.0,0.928,13.392,48,24,12,12,24,15,9,0,0.0,0.0
1004,756,24-09-2019 12:50:00,1,2694.0,2520.0,0.936,13.403,12,7,2,5,5,4,1,0,0.0,0.0
1004,757,24-09-2019 12:52:00,1,2689.0,2555.0,0.95,13.424,13,8,4,4,5,0,5,0,0.0,0.0
1004,758,24-09-2019 12:54:00,1,2707.0,2500.0,0.924,13.433,1,1,0,1,0,0,0,0,0.0,0.0
1004,759,24-09-2019 12:56:00,1,2694.0,2436.0,0.904,13.31,7,4,1,3,3,0,3,0,0.0,0.0
1004,760,24-09-2019 12:58:00,1,2702.0,2426.0,0.898,13.33,0,0,0,0,0,0,0,0,0.0,0.0
1004,761,24-09-2019 13:00:00,1,2725.0,2389.0,0.877,13.379,9,5,3,2,4,1,3,0,0.0,0.0
1004,762,24-09-2019 13:02:00,1,2518.0,2324.0,0.923,12.493,20,13,1,12,7,0,7,0,0.0,0.0
1004,763,24-09-2019 13:04:00,1,2522.0,2311.0,0.916,12.494,21,20,3,17,1,0,1,0,0.0,0.0
1004,764,24-09-2019 13:06:00,1,2523.0,2287.0,0.907,12.473,18,15,1,14,3,0,3,0,0.0,0.0
1004,765,24-09-2019 13:08:00,1,2515.0,2288.0,0.91,12.442,0,0,0,0,0,0,0,0,0.0,0.0
1004,766,24-09-2019 13:10:00,1,2513.0,2320.0,0.923,12.47,14,6,4,2,8,4,4,0,0.0,0.0
1004,767,24-09-2019 13:12:00,1,2721.0,2395.0,0.88,13.372,9,3,2,1,6,0,6,0,0.0,0.0
1004,768,24-09-2019 13:14:00,1,2722.5,2384.5,0.876,13.366,2,0,0,0,2,0,2,0,0.0,0.0
1004,769,24-09-2019 13:16:00,1,2724.0,2374.0,0.872,13.36,0,0,0,0,0,0,0,0,0.0,0.0
1004,770,24-09-2019 13:18:00,1,2629.0,2370.0,0.901,12.984,1,0,0,0,1,0,1,0,0.0,0.0
1004,771,24-09-2019 13:20:00,1,2529.0,2280.0,0.901,12.49,20,14,3,11,6,2,4,0,0.0,0.0
1004,772,24-09-2019 13:22:00,1,2520.0,2296.0,0.911,12.469,3,3,1,2,0,0,0,0,0.0,0.0
1004,773,24-09-2019 13:24:00,1,2507.0,2346.0,0.936,12.473,1,1,0,1,0,0,0,0,0.0,0.0
1004,774,24-09-2019 13:26:00,1,2613.0,2370.0,0.907,12.919,3,3,0,3,0,0,0,0,0.0,0.0
1004,775,24-09-2019 13:28:00,1,2616.0,2381.0,0.91,12.945,6,6,0,6,0,0,0,0,0.0,0.0
1004,776,24-09-2019 13:30:00,1,2619.0,2374.0,0.906,12.947,46,38,16,22,8,4,4,0,0.0,0.0
1004,777,24-09-2019 13:32:00,1,2706.0,2433.0,0.899,13.355,87,67,29,38,20,2,18,4,0.0,0.0
1004,778,24-09-2019 13:34:00,1,2793.0,2584.0,0.925,13.866,172,101,65,36,71,50,21,31,0.0,0.0
1004,779,24-09-2019 13:36:00,1,2869.0,2773.0,0.967,14.371,96,47,20,27,49,17,32,32,0.0,0.0
1004,780,24-09-2019 13:38:00,1,2893.0,2665.0,0.921,14.348,68,45,26,19,23,4,19,1,0.0,0.0
1004,781,24-09-2019 13:40:00,1,3085.0,2801.0,0.908,15.256,208,115,83,32,93,65,28,24,0.09,0.0
1004,782,24-09-2019 13:42:00,1,3184.0,2855.0,0.897,15.708,131,76,47,29,55,0,55,82,0.0,0.0
1004,783,24-09-2019 13:44:00,1,3335.0,3068.0,0.92,16.538,166,98,62,36,68,0,68,95,0.01,0.0
1004,784,24-09-2019 13:46:00,1,3329.0,3207.0,0.963,16.668,122,76,46,30,46,6,40,43,0.0,0.0
1004,785,24-09-2019 13:48:00,1,3244.5,3069.5,0.9455,16.1815,554,356,287,69,198,145,53,10,0.0,0.06
1004,786,24-09-2019 13:50:00,1,3160.0,2932.0,0.928,15.695,266,129,91,38,137,94,43,28,0.0,0.0
1004,787,24-09-2019 13:52:00,1,3181.0,2778.0,0.873,15.61,185,86,54,32,99,57,42,2,0.0,0.0
1004,788,24-09-2019 13:54:00,1,2893.0,2605.0,0.9,14.284,260,142,98,44,118,79,39,12,0.14,0.0
1004,789,24-09-2019 13:56:00,1,3168.0,2947.0,0.93,15.745,56,11,4,7,45,4,41,0,0.0,0.0
1004,790,24-09-2019 13:58:00,1,3374.0,3057.0,0.906,16.677,52,27,1,26,25,0,25,0,0.02,0.0
1004,791,24-09-2019 14:00:00,1,3335.0,3145.0,0.943,16.621,50,14,4,10,36,2,34,0,0.0,0.0
1004,792,24-09-2019 14:02:00,1,3533.0,3271.0,0.926,17.541,55,25,7,18,30,3,27,0,0.0,0.0
1004,793,24-09-2019 14:04:00,1,3508.0,3350.0,0.955,17.53,123,66,26,40,57,32,25,0,0.0,0.0
1004,794,24-09-2019 14:06:00,1,3630.0,3379.0,0.931,18.044,19,18,6,12,1,1,0,0,0.0,0.0
1004,795,24-09-2019 14:08:00,1,3548.0,3224.0,0.909,17.549,8,7,3,4,1,0,1,0,0.0,0.0
1004,796,24-09-2019 14:10:00,1,3347.0,3085.0,0.922,16.603,0,0,0,0,0,0,0,0,0.0,0.0
1004,797,24-09-2019 14:12:00,1,3176.0,2899.0,0.913,15.721,14,6,3,3,8,0,8,0,0.0,0.0
1004,798,24-09-2019 14:14:00,1,3212.0,2762.0,0.86,15.713,6,0,0,0,6,0,6,0,0.0,0.0
1004,799,24-09-2019 14:16:00,1,2897.0,2665.0,0.92,14.365,9,0,0,0,9,0,9,0,0.0,0.0
1004,800,24-09-2019 14:18:00,1,2905.0,2586.0,0.89,14.308,11,6,3,3,5,1,4,0,0.0,0.0
1004,801,24-09-2019 14:20:00,1,2914.0,2532.0,0.869,14.283,12,9,0,9,3,1,2,0,0.0,0.0
1004,802,24-09-2019 14:22:00,1,2817.0,2481.5,0.8815,13.846,4,4,0,4,0,0,0,0,0.0,0.0
1004,803,24-09-2019 14:24:00,1,2720.0,2431.0,0.894,13.409,1,1,0,1,0,0,0,0,0.0,0.0
1004,804,24-09-2019 14:26:00,1,2710.0,2435.0,0.898,13.372,18,14,9,5,4,0,4,0,0.0,0.0
1004,805,24-09-2019 14:28:00,1,2706.0,2433.0,0.899,13.356,5,3,2,1,2,0,2,0,0.0,0.0
1004,806,24-09-2019 14:30:00,1,2927.0,2495.0,0.852,14.295,0,0,0,0,0,0,0,0,0.0,0.0
1004,807,24-09-2019 14:32:00,1,2722.0,2422.0,0.89,13.405,4,1,0,1,3,1,2,0,0.0,0.0
1004,808,24-09-2019 14:34:00,1,2735.0,2372.0,0.867,13.4,0,0,0,0,0,0,0,0,0.0,0.0
1004,809,24-09-2019 14:36:00,1,2750.0,2299.0,0.836,13.38,3,2,1,1,1,0,1,0,0.0,0.0
1004,810,24-09-2019 14:38:00,1,2535.0,2244.0,0.885,12.471,2,1,0,1,1,0,1,0,0.0,0.0
1004,811,24-09-2019 14:40:00,1,2542.0,2201.0,0.866,12.453,0,0,0,0,0,0,0,0,0.0,0.0
1004,812,24-09-2019 14:42:00,1,2553.0,2170.0,0.85,12.461,0,0,0,0,0,0,0,0,0.0,0.0
1004,813,24-09-2019 14:44:00,1,2562.0,2121.0,0.828,12.444,0,0,0,0,0,0,0,0,0.0,0.0
1004,814,24-09-2019 14:46:00,1,2474.0,2051.0,0.829,12.019,47,31,7,24,16,2,14,0,0.0,0.0
1004,815,24-09-2019 14:48:00,1,2452.0,2113.0,0.862,11.999,139,84,47,37,55,18,37,27,0.0,0.0
1004,816,24-09-2019 14:50:00,1,2918.0,2514.0,0.861,14.279,121,78,46,32,43,3,40,85,0.0,0.0
1004,817,24-09-2019 14:52:00,1,3226.0,2697.0,0.836,15.696,102,57,26,31,45,0,45,65,0.0,0.0
1004,818,24-09-2019 14:54:00,1,3300.0,2845.0,0.862,16.152,99,62,34,28,37,0,37,69,0.0,0.0
1004,819,24-09-2019 14:56:00,1,3333.0,2950.5,0.885,16.3985,127,77,41,36,50,3,47,77,0.0,0.0
1004,820,24-09-2019 14:58:00,1,3366.0,3056.0,0.908,16.645,142,83,54,29,59,2,57,75,0.0,0.0
1004,821,24-09-2019 15:00:00,1,3551.0,3179.0,0.895,17.508,155,93,55,38,62,0,62,76,0.0,0.0
1004,822,24-09-2019 15:02:00,1,3540.0,3250.0,0.918,17.545,394,247,174,73,147,95,52,20,0.15,0.11
1004,823,24-09-2019 15:04:00,1,3357.0,3048.0,0.908,16.6,639,380,309,71,259,197,62,9,0.01,0.0
1004,824,24-09-2019 15:06:00,1,3380.0,3031.0,0.897,16.674,652,402,327,75,250,190,60,12,0.0,0.0
1004,825,24-09-2019 15:08:00,1,3354.0,3117.0,0.929,16.663,350,207,156,51,143,108,35,12,0.0,0.0
1004,826,24-09-2019 15:10:00,1,3281.0,2865.0,0.873,16.1,350,183,138,45,167,125,42,4,0.0,0.0
1004,827,24-09-2019 15:12:00,1,3370.0,3030.0,0.899,16.633,86,71,36,35,15,6,9,1,0.0,0.0
1004,828,24-09-2019 15:14:00,1,3486.0,3083.0,0.884,17.149,361,217,158,59,144,95,49,0,0.0,0.0
1004,829,24-09-2019 15:16:00,1,3349.0,3069.0,0.917,16.591,17,0,0,0,17,0,17,0,0.0,0.0
1004,830,24-09-2019 15:18:00,1,3288.0,2891.0,0.879,16.154,59,40,21,19,19,5,14,0,0.0,0.0
1004,831,24-09-2019 15:20:00,1,3364.0,3042.0,0.904,16.622,22,15,5,10,7,0,7,0,0.0,0.0
1004,832,24-09-2019 15:22:00,1,3398.0,2935.0,0.864,16.636,10,9,2,7,1,0,1,0,0.0,0.0
1004,833,24-09-2019 15:24:00,1,3188.0,2809.0,0.881,15.673,11,8,2,6,3,0,3,0,0.0,0.0
1004,834,24-09-2019 15:26:00,1,3228.0,2702.0,0.837,15.708,7,2,1,1,5,1,4,0,0.0,0.0
1004,835,24-09-2019 15:28:00,1,2998.0,2657.0,0.886,14.754,6,0,0,0,6,2,4,0,0.0,0.0
1004,836,24-09-2019 15:30:00,1,3051.5,2677.5,0.8775,14.9865,8,1,0,1,7,1,6,0,0.0,0.0
1004,837,24-09-2019 15:32:00,1,3105.0,2698.0,0.869,15.219,12,5,2,3,7,1,6,0,0.0,0.0
1004,838,24-09-2019 15:34:00,1,3157.0,2948.0,0.934,15.7,17,8,5,3,9,5,4,0,0.0,0.0
1004,839,24-09-2019 15:36:00,1,3182.0,2902.0,0.912,15.751,0,0,0,0,0,0,0,0,0.0,0.0
1004,840,24-09-2019 15:38:00,1,3185.0,2870.0,0.901,15.728,9,7,4,3,2,0,2,0,0.0,0.0
1004,841,24-09-2019 15:40:00,1,3187.0,2836.0,0.89,15.696,0,0,0,0,0,0,0,0,0.0,0.0
1004,842,24-09-2019 15:42:00,1,3184.0,2798.0,0.879,15.642,6,6,3,3,0,0,0,0,0.01,0.02
1004,843,24-09-2019 15:44:00,1,2987.0,2719.0,0.91,14.779,3,3,0,3,0,0,0,0,0.0,0.0
1004,844,24-09-2019 15:46:00,1,2883.0,2642.0,0.917,14.284,14,14,0,14,0,0,0,0,0.0,0.0
1004,845,24-09-2019 15:48:00,1,2908.0,2579.0,0.887,14.312,6,5,0,5,1,1,0,0,0.0,0.0
1004,846,24-09-2019 15:50:00,1,2905.0,2619.0,0.901,14.347,23,13,9,4,10,4,6,0,0.0,0.0
1004,847,24-09-2019 15:52:00,1,2892.0,2631.0,0.91,14.307,19,9,5,4,10,5,5,0,0.0,0.0
1004,848,24-09-2019 15:54:00,1,2908.0,2588.0,0.89,14.323,0,0,0,0,0,0,0,0,0.0,0.0
1004,849,24-09-2019 15:56:00,1,2919.0,2529.0,0.866,14.3,0,0,0,0,0,0,0,0,0.0,0.0
1004,850,24-09-2019 15:58:00,1,2907.0,2529.0,0.87,14.254,13,0,0,0,13,0,13,0,0.0,0.0
1004,851,24-09-2019 16:00:00,1,2925.0,2529.0,0.865,14.326,27,10,7,3,17,6,11,0,0.0,0.0
1004,852,24-09-2019 16:02:00,1,2920.0,2507.0,0.859,14.279,17,7,4,3,10,1,9,0,0.0,0.0
1004,853,24-09-2019 16:04:00,1,2786.0,2378.0,0.8535,13.6085,12,1,0,1,11,0,11,0,0.0,0.0
1004,854,24-09-2019 16:06:00,1,2652.0,2249.0,0.848,12.938,10,1,0,1,9,0,9,0,0.0,0.0
1004,855,24-09-2019 16:08:00,1,2636.0,2250.0,0.853,12.877,11,0,0,0,11,0,11,0,0.0,0.0
1004,856,24-09-2019 16:10:00,1,2763.0,2258.0,0.817,13.387,1,0,0,0,1,0,1,0,0.0,0.0
1004,857,24-09-2019 16:12:00,1,2761.0,2246.0,0.813,13.367,10,0,0,0,10,0,10,0,0.0,0.0
1004,858,24-09-2019 16:14:00,1,2759.0,2262.0,0.82,13.376,2,0,0,0,2,0,2,0,0.0,0.0
1004,859,24-09-2019 16:16:00,1,2759.0,2265.0,0.821,13.38,0,0,0,0,0,0,0,0,0.0,0.0
1004,860,24-09-2019 16:18:00,1,2758.0,2245.0,0.814,13.354,0,0,0,0,0,0,0,0,0.0,0.0
1004,861,24-09-2019 16:20:00,1,2770.0,2261.0,0.816,13.417,66,28,20,8,38,28,10,0,0.0,0.0
1004,862,24-09-2019 16:22:00,1,2840.0,2394.0,0.843,13.839,186,95,57,38,91,55,36,18,0.0,0.0
1004,863,24-09-2019 16:24:00,1,3196.0,2845.0,0.89,15.74,54,27,9,18,27,14,13,0,0.0,0.0
1004,864,24-09-2019 16:26:00,1,3201.0,2765.0,0.864,15.673,50,18,1,17,32,10,22,0,0.0,0.0
1004,865,24-09-2019 16:28:00,1,3189.0,2849.0,0.893,15.717,139,53,20,33,86,55,31,1,0.0,0.0
1004,866,24-09-2019 16:30:00,1,3386.0,2991.0,0.884,16.651,155,61,35,26,94,66,28,1,0.0,0.0
1004,867,24-09-2019 16:32:00,1,3390.0,2924.0,0.863,16.592,124,44,17,27,80,45,35,0,0.0,0.0
1004,868,24-09-2019 16:34:00,1,3363.0,3049.0,0.907,16.626,104,59,41,18,45,23,22,37,0.0,0.0
1004,869,24-09-2019 16:36:00,1,3375.0,2992.0,0.887,16.608,67,28,14,14,39,28,11,0,0.0,0.03
1004,870,24-09-2019 16:38:00,1,3300.0,2831.0,0.8575,16.135,40,13,1,12,27,7,20,0,0.0,0.0
1004,871,24-09-2019 16:40:00,1,3225.0,2670.0,0.828,15.662,3,1,0,1,2,0,2,0,0.0,0.0
1004,872,24-09-2019 16:42:00,1,3246.0,2642.0,0.814,15.714,0,0,0,0,0,0,0,0,0.0,0.0
1004,873,24-09-2019 16:44:00,1,3121.0,2645.0,0.848,15.227,0,0,0,0,0,0,0,0,0.0,0.0
1004,874,24-09-2019 16:46:00,1,2912.0,2621.0,0.9,14.374,6,3,1,2,3,0,3,0,0.0,0.0
1004,875,24-09-2019 16:48:00,1,2932.0,2461.0,0.839,14.277,0,0,0,0,0,0,0,0,0.0,0.0
1004,876,24-09-2019 16:50:00,1,2740.0,2373.0,0.866,13.422,0,0,0,0,0,0,0,0,0.0,0.0
1004,877,24-09-2019 16:52:00,1,2760.0,2277.0,0.825,13.395,8,2,2,0,6,2,4,0,0.0,0.0
1004,878,24-09-2019 16:54:00,1,2737.0,2360.0,0.862,13.398,8,8,1,7,0,0,0,0,0.0,0.0
1004,879,24-09-2019 16:56:00,1,2737.0,2365.0,0.864,13.403,2,2,0,2,0,0,0,0,0.0,0.0
1004,880,24-09-2019 16:58:00,1,2749.0,2335.0,0.849,13.415,1,1,1,0,0,0,0,0,0.0,0.0
1004,881,24-09-2019 17:00:00,1,2744.0,2299.0,0.838,13.356,6,1,0,1,5,3,2,0,0.0,0.0
1004,882,24-09-2019 17:02:00,1,2761.0,2245.0,0.813,13.363,0,0,0,0,0,0,0,0,0.0,0.0
1004,883,24-09-2019 17:04:00,1,2767.0,2233.0,0.807,13.375,1,0,0,0,1,0,1,0,0.0,0.0
1004,884,24-09-2019 17:06:00,1,2547.0,2205.0,0.866,12.478,0,0,0,0,0,0,0,0,0.0,0.0
1004,885,24-09-2019 17:08:00,1,2664.0,2201.0,0.826,12.934,13,3,2,1,10,3,7,0,0.0,0.0
1004,886,24-09-2019 17:10:00,1,2561.0,2167.0,0.846,12.491,6,1,1,0,5,1,4,0,0.0,0.0
1004,887,24-09-2019 17:12:00,1,2557.5,2170.5,0.8485,12.4795,2,1,0,1,1,0,1,0,0.0,0.0
1004,888,24-09-2019 17:14:00,1,2554.0,2174.0,0.851,12.468,25,22,15,7,3,0,3,0,0.0,0.0
1004,889,24-09-2019 17:16:00,1,2773.0,2212.0,0.798,13.376,3,3,0,3,0,0,0,0,0.0,0.0
1004,890,24-09-2019 17:18:00,1,2774.0,2218.0,0.8,13.384,37,28,7,21,9,4,5,0,0.0,0.0
1004,891,24-09-2019 17:20:00,1,2772.0,2214.0,0.799,13.372,7,5,0,5,2,1,1,0,0.0,0.0
1004,892,24-09-2019 17:22:00,1,2753.0,2250.0,0.817,13.34,4,0,0,0,4,0,4,0,0.0,0.0
1004,893,24-09-2019 17:24:00,1,2768.0,2236.0,0.808,13.381,43,15,8,7,28,11,17,0,0.0,0.0
1004,894,24-09-2019 17:26:00,1,2765.0,2249.0,0.813,13.386,2,1,0,1,1,1,0,0,0.0,0.0
1004,895,24-09-2019 17:28:00,1,2946.0,2416.0,0.82,14.281,6,2,1,1,4,2,2,0,0.0,0.0
1004,896,24-09-2019 17:30:00,1,2945.0,2437.0,0.827,14.304,14,6,1,5,8,5,3,0,0.0,0.0
1004,897,24-09-2019 17:32:00,1,2945.0,2427.0,0.824,14.292,22,11,4,7,11,4,7,0,0.0,0.0
1004,898,24-09-2019 17:34:00,1,2858.0,2350.0,0.822,13.864,121,39,11,28,82,38,44,0,0.0,0.0
1004,899,24-09-2019 17:36:00,1,2950.0,2418.0,0.82,14.298,79,19,6,13,60,33,27,0,0.0,0.0
1004,900,24-09-2019 17:38:00,1,3023.0,2579.0,0.853,14.767,27,23,8,15,4,1,3,0,0.0,0.0
1004,901,24-09-2019 17:40:00,1,3246.0,2644.0,0.815,15.717,109,59,28,31,50,26,24,0,0.0,0.0
1004,902,24-09-2019 17:42:00,1,3215.0,2777.0,0.864,15.743,95,26,11,15,69,36,33,0,0.0,0.0
1004,903,24-09-2019 17:44:00,1,3192.0,2795.0,0.875,15.672,126,68,41,27,58,26,32,18,0.0,0.0
1004,904,24-09-2019 17:46:00,1,3292.5,2869.5,0.8715,16.15,123,81,53,28,42,0,42,65,0.0,0.0
1004,905,24-09-2019 17:48:00,1,3393.0,2944.0,0.868,16.628,149,88,49,39,61,2,59,75,0.0,0.0
1004,906,24-09-2019 17:50:00,1,3599.0,3060.0,0.85,17.567,121,77,44,33,44,2,42,84,0.0,0.0
1004,907,24-09-2019 17:52:00,1,3559.0,3157.0,0.887,17.518,139,81,48,33,58,15,43,50,0.0,0.08
1004,908,24-09-2019 17:54:00,1,3386.0,2990.0,0.883,16.651,85,46,18,28,39,9,30,2,0.0,0.0
1004,909,24-09-2019 17:56:00,1,3258.0,2620.0,0.804,15.739,52,22,0,22,30,2,28,0,0.0,0.0
1004,910,24-09-2019 17:58:00,1,3029.0,2531.0,0.836,14.736,38,20,5,15,18,4,14,1,0.0,0.0
1004,911,24-09-2019 18:00:00,0,3254.0,2594.0,0.797,15.692,3,2,0,2,1,0,1,0,0.0,0.0
1004,912,24-09-2019 18:02:00,0,3249.0,2657.0,0.818,15.744,81,53,42,11,28,21,7,3,0.01,0.0
1004,913,24-09-2019 18:04:00,0,3371.0,2951.0,0.876,16.548,54,22,18,4,32,25,7,5,0.0,0.0
1004,914,24-09-2019 18:06:00,0,3409.0,2863.0,0.84,16.603,1,0,0,0,1,0,1,0,0.0,0.0
1004,915,24-09-2019 18:08:00,0,3216.0,2716.0,0.845,15.679,0,0,0,0,0,0,0,0,0.0,0.0
1004,916,24-09-2019 18:10:00,0,3017.0,2613.0,0.866,14.782,7,4,2,2,3,2,1,0,0.0,0.0
1004,917,24-09-2019 18:12:00,0,2907.0,2585.0,0.889,14.317,4,2,0,2,2,0,2,0,0.0,0.0
1004,918,24-09-2019 18:14:00,0,2910.0,2543.0,0.874,14.281,10,7,0,7,3,0,3,0,0.0,0.0
1004,919,24-09-2019 18:16:00,0,3025.0,2603.0,0.861,14.803,7,1,0,1,6,3,3,0,0.0,0.0
1004,920,24-09-2019 18:18:00,0,3118.0,2676.0,0.858,15.25,19,4,1,3,15,7,8,0,0.0,0.0
1004,921,24-09-2019 18:20:00,0,3248.5,2837.5,0.873,15.9415,117,57,26,31,60,33,27,10,0.0,0.0
1004,922,24-09-2019 18:22:00,0,3379.0,2999.0,0.888,16.633,96,43,10,33,53,12,41,1,0.0,0.0
1004,923,24-09-2019 18:24:00,0,3530.0,3237.0,0.917,17.491,322,174,131,43,148,112,36,73,0.0,0.0
1004,924,24-09-2019 18:26:00,0,3860.0,3426.0,0.888,19.001,139,71,42,29,68,42,26,49,0.0,0.0
1004,925,24-09-2019 18:28:00,0,3737.0,3338.0,0.893,18.42,113,50,18,32,63,32,31,1,0.0,0.0
1004,926,24-09-2019 18:30:00,0,3829.0,3473.0,0.907,18.931,112,27,8,19,85,41,44,0,0.0,0.0
1004,927,24-09-2019 18:32:00,0,3933.0,3514.0,0.893,19.387,218,93,51,42,125,73,52,11,0.0,0.0
1004,928,24-09-2019 18:34:00,0,4111.0,3754.0,0.913,20.352,413,213,174,39,200,155,45,131,0.0,0.0
1004,929,24-09-2019 18:36:00,0,4025.0,3602.0,0.895,19.844,167,92,65,27,75,29,46,88,0.0,0.0
1004,930,24-09-2019 18:38:00,0,4325.0,3825.0,0.884,21.276,118,66,36,30,52,0,52,85,0.0,0.01
1004,931,24-09-2019 18:40:00,0,4294.0,3895.0,0.907,21.23,124,70,46,24,54,0,54,73,0.0,0.08
1004,932,24-09-2019 18:42:00,0,4513.0,3952.0,0.876,22.155,176,82,58,24,94,52,42,42,0.06,0.05
1004,933,24-09-2019 18:44:00,0,4231.0,3715.0,0.878,20.784,218,117,91,26,101,74,27,43,0.0,0.05
1004,934,24-09-2019 18:46:00,0,4674.0,4261.0,0.912,23.134,274,122,95,27,152,107,45,129,0.0,0.0
1004,935,24-09-2019 18:48:00,0,4304.0,3879.0,0.901,21.251,102,61,43,18,41,0,41,62,0.01,0.06
1004,936,24-09-2019 18:50:00,0,4497.0,4039.0,0.898,22.19,147,69,42,27,78,36,42,40,0.0,0.05
1004,937,24-09-2019 18:52:00,0,3845.0,3364.0,0.875,18.873,168,76,40,36,92,55,37,5,0.0,0.0
1004,938,24-09-2019 18:54:00,0,4164.5,3717.5,0.8915,20.523,201,114,83,31,87,58,29,36,0.04,0.02
1004,939,24-09-2019 18:56:00,0,4484.0,4071.0,0.908,22.173,155,75,53,22,80,43,37,59,0.07,0.0
1004,940,24-09-2019 18:58:00,0,4289.0,3879.0,0.904,21.193,277,152,115,37,125,83,42,61,0.01,0.0
1004,941,24-09-2019 19:00:00,0,4281.0,3927.0,0.917,21.213,93,49,27,22,44,19,25,3,0.0,0.0
1004,942,24-09-2019 19:02:00,0,3499.0,3021.0,0.863,17.132,112,36,11,25,76,38,38,1,0.0,0.0
1004,943,24-09-2019 19:04:00,0,4012.0,3601.0,0.898,19.793,4,4,2,2,0,0,0,0,0.0,0.0
1004,944,24-09-2019 19:06:00,0,3833.0,3457.0,0.902,18.93,11,11,8,3,0,0,0,0,0.0,0.0
1004,945,24-09-2019 19:08:00,0,3855.0,3419.0,0.887,18.973,11,9,5,4,2,1,1,0,0.0,0.0
1004,946,24-09-2019 19:10:00,0,3759.0,3301.0,0.878,18.465,22,9,5,4,13,10,3,0,0.0,0.0
1004,947,24-09-2019 19:12:00,0,3833.0,3482.0,0.909,18.956,5,5,5,0,0,0,0,0,0.0,0.0
1004,948,24-09-2019 19:14:00,0,3815.0,3521.0,0.923,18.93,10,3,1,2,7,1,6,0,0.0,0.0
1004,949,24-09-2019 19:16:00,0,3840.0,3432.0,0.894,18.931,5,1,1,0,4,0,4,0,0.0,0.0
1004,950,24-09-2019 19:18:00,0,3549.0,3228.0,0.91,17.556,0,0,0,0,0,0,0,0,0.0,0.0
1004,951,24-09-2019 19:20:00,0,3551.0,3182.0,0.896,17.514,14,10,2,8,4,2,2,0,0.0,0.0
1004,952,24-09-2019 19:22:00,0,3385.0,2996.0,0.885,16.652,1,1,0,1,0,0,0,0,0.0,0.0
1004,953,24-09-2019 19:24:00,0,3396.0,2925.0,0.862,16.617,25,17,6,11,8,3,5,0,0.0,0.0
1004,954,24-09-2019 19:26:00,0,3404.0,2967.0,0.872,16.697,54,37,17,20,17,8,9,0,0.0,0.0
1004,955,24-09-2019 19:28:00,0,3296.5,2886.5,0.876,16.184,18,7,0,7,11,1,10,0,0.0,0.0
1004,956,24-09-2019 19:30:00,0,3189.0,2806.0,0.88,15.671,29,15,9,6,14,9,5,0,0.0,0.0
1004,957,24-09-2019 19:32:00,0,3195.0,2776.0,0.869,15.663,139,77,50,27,62,36,26,21,0.0,0.0
1004,958,24-09-2019 19:34:00,0,3443.0,3194.0,0.928,17.102,95,58,31,27,37,0,37,62,0.0,0.0
1004,959,24-09-2019 19:36:00,0,3840.0,3506.0,0.913,19.009,128,78,45,33,50,0,50,83,0.0,0.04
1004,960,24-09-2019 19:38:00,0,3913.0,3607.0,0.922,19.411,78,48,23,25,30,11,19,34,0.0,0.11
1004,961,24-09-2019 19:40:00,0,3998.0,3691.0,0.923,19.837,273,151,117,34,122,92,30,45,0.12,0.01
1004,962,24-09-2019 19:42:00,0,3978.0,3848.0,0.967,19.933,400,202,162,40,198,150,48,35,0.09,0.04
1004,963,24-09-2019 19:44:00,0,3508.0,3388.0,0.966,17.571,290,173,139,34,117,96,21,87,0.0,0.0
1004,964,24-09-2019 19:46:00,0,3514.0,3354.0,0.954,17.559,268,147,108,39,121,96,25,94,0.0,0.0
1004,965,24-09-2019 19:48:00,0,3525.0,3353.0,0.951,17.601,98,46,23,23,52,26,26,1,0.01,0.0
1004,966,24-09-2019 19:50:00,0,3918.0,3603.0,0.92,19.425,62,19,11,8,43,17,26,0,0.0,0.0
1004,967,24-09-2019 19:52:00,0,3823.0,3539.0,0.926,18.981,122,33,3,30,89,45,44,1,0.0,0.0
1004,968,24-09-2019 19:54:00,0,4016.0,3624.0,0.902,19.837,70,30,13,17,40,20,20,0,0.0,0.0
1004,969,24-09-2019 19:56:00,0,3793.0,3547.0,0.935,18.872,2,0,0,0,2,0,2,0,0.0,0.0
1004,970,24-09-2019 19:58:00,0,3828.0,3456.0,0.903,18.907,2,1,0,1,1,1,0,0,0.0,0.0
1004,971,24-09-2019 20:00:00,0,3505.0,3320.0,0.947,17.486,0,0,0,0,0,0,0,0,0.0,0.0
1004,972,24-09-2019 20:02:00,0,3431.5,3206.0,0.934,17.0695,0,0,0,0,0,0,0,0,0.0,0.0
1004,973,24-09-2019 20:04:00,0,3358.0,3092.0,0.921,16.653,1,0,0,0,1,1,0,0,0.0,0.0
1004,974,24-09-2019 20:06:00,0,3355.0,3070.0,0.915,16.617,12,7,5,2,5,3,2,0,0.0,0.0
1004,975,24-09-2019 20:08:00,0,3362.0,3059.0,0.91,16.633,43,24,16,8,19,10,9,0,0.0,0.0
1004,976,24-09-2019 20:10:00,0,3370.0,3058.0,0.908,16.664,6,3,0,3,3,2,1,0,0.0,0.0
1004,977,24-09-2019 20:12:00,0,3358.0,3053.0,0.909,16.611,86,45,32,13,41,14,27,34,0.0,0.0
1004,978,24-09-2019 20:14:00,0,3535.0,3297.0,0.933,17.578,81,38,22,16,43,5,38,69,0.01,0.0
1004,979,24-09-2019 20:16:00,0,3515.0,3400.0,0.967,17.614,204,121,86,35,83,49,34,54,0.0,0.13
1004,980,24-09-2019 20:18:00,0,3813.0,3487.0,0.915,18.883,108,71,46,25,37,2,35,68,0.0,0.11
1004,981,24-09-2019 20:20:00,0,3807.0,3551.0,0.933,18.931,349,195,160,35,154,128,26,106,0.12,0.0
1004,982,24-09-2019 20:22:00,0,3816.0,3537.0,0.927,18.951,208,116,93,23,92,65,27,47,0.09,0.0
1004,983,24-09-2019 20:24:00,0,3158.0,2949.0,0.934,15.706,34,18,10,8,16,6,10,0,0.0,0.0
1004,984,24-09-2019 20:26:00,0,2910.0,2523.0,0.867,14.259,52,33,6,27,19,10,9,3,0.0,0.0
1004,985,24-09-2019 20:28:00,0,3369.0,2985.0,0.886,16.578,289,148,114,34,141,102,39,30,0.0,0.0
1004,986,24-09-2019 20:30:00,0,4278.0,4019.0,0.94,21.303,93,56,36,20,37,0,37,64,0.01,0.0
1004,987,24-09-2019 20:32:00,0,4235.0,4023.0,0.95,21.139,78,35,15,20,43,10,33,62,0.0,0.13
1004,988,24-09-2019 20:34:00,0,4367.0,4143.0,0.949,21.791,242,106,82,24,136,95,41,19,0.12,0.0
1004,989,24-09-2019 20:36:00,0,3867.0,3608.5,0.931,19.2305,209,112,76,36,97,72,25,70,0.0,0.0
1004,990,24-09-2019 20:38:00,0,3367.0,3074.0,0.913,16.67,304,131,102,29,173,133,40,55,0.15,0.0
1004,991,24-09-2019 20:40:00,0,4273.0,3968.0,0.929,21.227,135,88,52,36,47,28,19,5,0.0,0.0
1004,992,24-09-2019 20:42:00,0,3729.0,3404.0,0.913,18.459,488,221,172,49,267,200,67,2,0.0,0.07
1004,993,24-09-2019 20:44:00,0,4443.0,4147.0,0.933,22.095,231,125,85,40,106,76,30,20,0.0,0.0
1004,994,24-09-2019 20:46:00,0,4263.0,3979.0,0.933,21.202,352,190,145,45,162,121,41,39,0.04,0.0
1004,995,24-09-2019 20:48:00,0,4305.0,3953.0,0.918,21.338,77,33,17,16,44,13,31,0,0.0,0.0
1004,996,24-09-2019 20:50:00,0,4009.0,3620.0,0.903,19.803,81,38,14,24,43,8,35,0,0.0,0.0
1004,997,24-09-2019 20:52:00,0,3998.0,3780.0,0.946,19.937,54,21,9,12,33,6,27,0,0.0,0.0
1004,998,24-09-2019 20:54:00,0,4275.0,4015.0,0.939,21.289,49,19,3,16,30,9,21,0,0.0,0.0
1004,999,24-09-2019 20:56:00,0,4159.0,3886.0,0.934,20.689,4,0,0,0,4,3,1,0,0.02,0.0
1004,1000,24-09-2019 20:58:00,0,3993.0,3701.0,0.927,19.828,9,4,1,3,5,3,2,0,0.0,0.0
1004,1001,24-09-2019 21:00:00,0,3989.0,3668.0,0.92,19.777,2,2,0,2,0,0,0,0,0.0,0.0
1004,1002,24-09-2019 21:02:00,0,3843.0,3442.0,0.896,18.953,37,25,10,15,12,3,9,0,0.0,0.0
1004,1003,24-09-2019 21:04:00,0,3835.0,3508.0,0.915,18.995,130,74,45,29,56,32,24,62,0.0,0.0
1004,1004,24-09-2019 21:06:00,0,3992.0,3793.0,0.95,19.929,14,7,4,3,7,1,6,5,0.0,0.2
1004,1005,24-09-2019 21:08:00,0,4000.0,3679.0,0.92,19.834,243,149,117,32,94,77,17,15,0.0,0.0
1004,1006,24-09-2019 21:10:00,0,3985.0,3755.5,0.9425,19.858,560,347,273,74,213,149,64,6,0.0,0.0
1004,1007,24-09-2019 21:12:00,0,3970.0,3832.0,0.965,19.882,606,330,269,61,276,217,59,90,0.0,0.0
1004,1008,24-09-2019 21:14:00,0,3963.0,3847.0,0.971,19.871,166,105,78,27,61,37,24,115,0.13,0.0
1004,1009,24-09-2019 21:16:00,0,4159.0,3965.0,0.953,20.777,96,55,44,11,41,35,6,9,0.0,0.0
1004,1010,24-09-2019 21:18:00,0,3980.0,3839.0,0.965,19.931,6,2,1,1,4,1,3,0,0.0,0.0
1004,1011,24-09-2019 21:20:00,0,4179.0,3926.0,0.94,20.812,390,244,184,60,146,110,36,0,0.0,0.03
1004,1012,24-09-2019 21:22:00,0,4143.0,3939.0,0.951,20.683,286,168,127,41,118,77,41,2,0.0,0.0
1004,1013,24-09-2019 21:24:00,0,3981.0,3704.0,0.931,19.785,79,14,7,7,65,31,34,0,0.0,0.0
1004,1014,24-09-2019 21:26:00,0,4035.0,3635.0,0.901,19.921,59,20,2,18,39,8,31,0,0.0,0.0
1004,1015,24-09-2019 21:28:00,0,3805.0,3555.0,0.934,18.929,39,17,5,12,22,3,19,0,0.0,0.0
1004,1016,24-09-2019 21:30:00,0,3845.0,3473.0,0.903,18.995,10,6,1,5,4,1,3,0,0.0,0.0
1004,1017,24-09-2019 21:32:00,0,3545.0,3296.0,0.93,17.616,0,0,0,0,0,0,0,0,0.0,0.0
1004,1018,24-09-2019 21:34:00,0,3541.0,3179.0,0.898,17.473,2,0,0,0,2,1,1,0,0.0,0.0
1004,1019,24-09-2019 21:36:00,0,3457.0,3155.0,0.913,17.112,10,8,3,5,2,0,2,0,0.0,0.0
1004,1020,24-09-2019 21:38:00,0,3329.0,3142.0,0.944,16.593,6,4,1,3,2,1,1,0,0.0,0.0
1004,1021,24-09-2019 21:40:00,0,3349.0,3067.0,0.916,16.59,0,0,0,0,0,0,0,0,0.0,0.0
1004,1022,24-09-2019 21:42:00,0,3342.0,3144.0,0.941,16.646,1,0,0,0,1,0,1,0,0.0,0.0
1004,1023,24-09-2019 21:44:00,0,3282.0,3152.0,0.961,16.4205,11,9,5,4,2,1,1,0,0.0,0.0
1004,1024,24-09-2019 21:46:00,0,3222.0,3160.0,0.981,16.195,27,16,10,6,11,7,4,0,0.0,0.0
1004,1025,24-09-2019 21:48:00,0,3218.0,3208.0,0.997,16.231,2,2,1,1,0,0,0,0,0.0,0.0
1004,1026,24-09-2019 21:50:00,0,3215.0,3187.0,0.991,16.197,14,6,3,3,8,6,2,0,0.0,0.0
1004,1027,24-09-2019 21:52:00,0,3127.0,3016.0,0.964,15.659,19,16,2,14,3,2,1,0,0.0,0.0
1004,1028,24-09-2019 21:54:00,0,3046.0,2921.0,0.959,15.236,18,10,7,3,8,4,4,0,0.0,0.0
1004,1029,24-09-2019 21:56:00,0,3132.0,3016.0,0.963,15.678,5,0,0,0,5,2,3,0,0.0,0.0
1004,1030,24-09-2019 21:58:00,0,3063.0,2895.0,0.945,15.271,7,1,0,1,6,1,5,0,0.0,0.0
1004,1031,24-09-2019 22:00:00,0,2960.0,2801.0,0.946,14.764,1,0,0,0,1,0,1,0,0.0,0.0
1004,1032,24-09-2019 22:02:00,0,2751.0,2761.0,1.004,13.895,2,0,0,0,2,0,2,0,0.0,0.0
1004,1033,24-09-2019 22:04:00,0,2749.0,2728.0,0.992,13.852,143,72,44,28,71,48,23,15,0.0,0.0
1004,1034,24-09-2019 22:06:00,0,3118.0,3057.0,0.98,15.669,201,118,91,27,83,55,28,50,0.0,0.0
1004,1035,24-09-2019 22:08:00,0,3285.0,3313.0,1.009,16.61,153,80,40,40,73,37,36,13,0.0,0.0
1004,1036,24-09-2019 22:10:00,0,3198.0,3238.0,1.012,16.184,87,60,28,32,27,7,20,5,0.0,0.0
1004,1037,24-09-2019 22:12:00,0,3311.0,3278.0,0.99,16.674,95,32,11,21,63,26,37,0,0.0,0.0
1004,1038,24-09-2019 22:14:00,0,3488.0,3454.0,0.99,17.567,25,14,5,9,11,1,10,0,0.0,0.0
1004,1039,24-09-2019 22:16:00,0,3415.0,3266.0,0.956,17.071,0,0,0,0,0,0,0,0,0.0,0.0
1004,1040,24-09-2019 22:18:00,0,3381.0,3169.5,0.937,16.8305,8,7,0,7,1,1,0,0,0.0,0.0
1004,1041,24-09-2019 22:20:00,0,3347.0,3073.0,0.918,16.59,2,1,0,1,1,0,1,0,0.0,0.0
1004,1042,24-09-2019 22:22:00,0,3252.0,3005.0,0.924,16.14,2,2,0,2,0,0,0,0,0.0,0.0
1004,1043,24-09-2019 22:24:00,0,3250.0,3035.0,0.934,16.165,70,33,18,15,37,25,12,0,0.0,0.0
1004,1044,24-09-2019 22:26:00,0,3371.0,3048.0,0.904,16.655,96,66,36,30,30,18,12,62,0.0,0.0
1004,1045,24-09-2019 22:28:00,0,3326.0,3220.0,0.968,16.668,209,120,81,39,89,39,50,62,0.0,0.0
1004,1046,24-09-2019 22:30:00,0,3345.0,3145.0,0.94,16.66,92,42,17,25,50,26,24,4,0.0,0.0
1004,1047,24-09-2019 22:32:00,0,3146.0,2949.0,0.937,15.662,126,70,31,39,56,20,36,3,0.0,0.0
1004,1048,24-09-2019 22:34:00,0,3431.0,3228.0,0.941,17.093,39,12,2,10,27,11,16,0,0.0,0.0
1004,1049,24-09-2019 22:36:00,0,3534.0,3241.0,0.917,17.513,12,10,0,10,2,0,2,0,0.0,0.0
1004,1050,24-09-2019 22:38:00,0,3317.0,3194.0,0.963,16.606,14,2,0,2,12,8,4,0,0.0,0.0
1004,1051,24-09-2019 22:40:00,0,3330.0,3152.0,0.947,16.609,4,0,0,0,4,2,2,0,0.0,0.0
1004,1052,24-09-2019 22:42:00,0,3356.0,3070.0,0.915,16.621,91,52,29,23,39,13,26,55,0.0,0.0
1004,1053,24-09-2019 22:44:00,0,3517.0,3394.0,0.965,17.613,166,115,78,37,51,2,49,79,0.0,0.0
1004,1054,24-09-2019 22:46:00,0,3789.0,3657.0,0.965,18.978,81,52,32,20,29,0,29,33,0.0,0.09
1004,1055,24-09-2019 22:48:00,0,3779.0,3665.0,0.97,18.947,164,104,66,38,60,0,60,83,0.0,0.0
1004,1056,24-09-2019 22:50:00,0,3962.0,3835.0,0.968,19.857,213,127,84,43,86,44,42,59,0.0,0.08
1004,1057,24-09-2019 22:52:00,0,3649.0,3470.5,0.9495,18.221,296,122,91,31,174,129,45,44,0.09,0.0
1004,1058,24-09-2019 22:54:00,0,3336.0,3106.0,0.931,16.585,259,22,11,11,237,214,23,1,0.0,0.0
1004,1059,24-09-2019 22:56:00,0,3376.0,3048.0,0.903,16.676,289,149,105,44,140,107,33,80,0.0,0.0
1004,1060,24-09-2019 22:58:00,0,4266.0,4040.0,0.947,21.28,372,168,136,32,204,163,41,181,0.0,0.04
1004,1061,24-09-2019 23:00:00,0,4430.0,4319.0,0.975,22.236,56,48,24,24,8,3,5,0,0.0,0.0
1004,1062,24-09-2019 23:02:00,0,4416.0,4303.0,0.975,22.161,254,139,105,34,115,84,31,60,0.14,0.0
1004,1063,24-09-2019 23:04:00,0,4418.0,4282.0,0.969,22.146,196,143,93,50,53,3,50,83,0.0,0.0
1004,1064,24-09-2019 23:06:00,0,4592.0,4491.0,0.978,23.064,185,128,84,44,57,2,55,82,0.0,0.0
1004,1065,24-09-2019 23:08:00,0,4927.0,4574.0,0.928,24.477,167,85,53,32,82,48,34,25,0.0,0.05
1004,1066,24-09-2019 23:10:00,0,4179.0,3890.0,0.931,20.772,339,178,147,31,161,125,36,144,0.09,0.0
1004,1067,24-09-2019 23:12:00,0,4457.0,4194.0,0.941,22.204,242,163,122,41,79,42,37,85,0.03,0.0
1004,1068,24-09-2019 23:14:00,0,4926.0,4677.0,0.95,24.586,199,144,99,45,55,0,55,63,0.0,0.0
1004,1069,24-09-2019 23:16:00,0,4890.0,4659.0,0.953,24.422,197,136,97,39,61,0,61,70,0.0,0.0
1004,1070,24-09-2019 23:18:00,0,5084.0,4856.0,0.955,25.407,138,96,53,43,42,2,40,46,0.0,0.1
1004,1071,24-09-2019 23:20:00,0,5084.0,4847.0,0.953,25.395,132,91,52,39,41,1,40,49,0.0,0.08
1004,1072,24-09-2019 23:22:00,0,5081.0,4903.0,0.965,25.446,194,110,78,32,84,54,30,13,0.08,0.06
1004,1073,24-09-2019 23:24:00,0,4827.0,4530.0,0.938,24.033,232,116,85,31,116,80,36,59,0.03,0.0
1004,1074,24-09-2019 23:26:00,0,4983.5,4651.5,0.9335,24.784,284,172,135,37,112,90,22,24,0.02,0.0
1004,1075,24-09-2019 23:28:00,0,5140.0,4773.0,0.929,25.535,373,228,174,54,145,101,44,53,0.03,0.0
1004,1076,24-09-2019 23:30:00,0,4836.0,4480.0,0.926,24.015,188,130,81,49,58,2,56,62,0.02,0.0
1004,1077,24-09-2019 23:32:00,0,5255.0,5054.0,0.962,26.298,192,114,72,42,78,38,40,38,0.0,0.0
1004,1078,24-09-2019 23:34:00,0,4807.0,4574.0,0.952,24.003,17,2,1,1,15,4,11,0,0.0,0.01
1004,1079,24-09-2019 23:36:00,0,4628.0,4363.0,0.943,23.066,97,48,20,28,49,20,29,3,0.0,0.0
1004,1080,24-09-2019 23:38:00,0,4736.0,4485.0,0.947,23.625,71,34,15,19,37,23,14,0,0.0,0.0
1004,1081,24-09-2019 23:40:00,0,4826.0,4521.0,0.937,24.018,43,4,3,1,39,2,37,0,0.0,0.0
1004,1082,24-09-2019 23:42:00,0,4928.0,4596.0,0.933,24.503,4,3,0,3,1,1,0,0,0.0,0.0
1004,1083,24-09-2019 23:44:00,0,4603.0,4493.0,0.976,23.109,25,2,1,1,23,4,19,0,0.0,0.0
1004,1084,24-09-2019 23:46:00,0,4436.0,4309.0,0.971,22.248,8,2,0,2,6,1,5,0,0.0,0.0
1004,1085,24-09-2019 23:48:00,0,4264.0,4091.0,0.959,21.328,10,3,1,2,7,5,2,0,0.0,0.0
1004,1086,24-09-2019 23:50:00,0,4155.0,3915.0,0.942,20.705,44,27,12,15,17,10,7,0,0.0,0.0
1004,1087,24-09-2019 23:52:00,0,3980.0,3805.0,0.956,19.894,4,3,1,2,1,0,1,0,0.0,0.0
1004,1088,24-09-2019 23:54:00,0,3783.0,3642.0,0.963,18.935,15,2,0,2,13,1,12,0,0.0,0.0
1004,1089,24-09-2019 23:56:00,0,3810.0,3528.0,0.926,18.919,26,5,0,5,21,0,21,0,0.0,0.01
1004,1090,24-09-2019 23:58:00,0,3503.0,3396.0,0.969,17.559,11,0,0,0,11,0,11,0,0.0,0.0
1004,1091,25-09-2019 00:00:00,0,3434.0,3217.5,0.936,17.0905,9,4,2,2,5,0,5,0,0.0,0.0
1004,1092,25-09-2019 00:02:00,0,3365.0,3039.0,0.903,16.622,32,14,8,6,18,14,4,0,0.0,0.0
1004,1093,25-09-2019 00:04:00,0,3138.0,2960.0,0.943,15.64,2,2,0,2,0,0,0,0,0.0,0.0
1004,1094,25-09-2019 00:06:00,0,3182.0,2857.0,0.898,15.698,21,12,7,5,9,5,4,0,0.0,0.0
1004,1095,25-09-2019 00:08:00,0,3149.0,2940.0,0.933,15.663,0,0,0,0,0,0,0,0,0.0,0.0
1004,1096,25-09-2019 00:10:00,0,3173.0,2882.0,0.908,15.692,14,6,2,4,8,1,7,0,0.0,0.0
1004,1097,25-09-2019 00:12:00,0,3183.0,2840.0,0.892,15.685,7,5,1,4,2,2,0,0,0.0,0.0
1004,1098,25-09-2019 00:14:00,0,2892.0,2663.0,0.921,14.341,38,15,9,6,23,15,8,9,0.0,0.0
1004,1099,25-09-2019 00:16:00,0,3076.0,2815.0,0.915,15.237,120,79,42,37,41,4,37,66,0.0,0.0
1004,1100,25-09-2019 00:18:00,0,3360.0,3110.0,0.926,16.683,152,98,57,41,54,6,48,76,0.0,0.0
1004,1101,25-09-2019 00:20:00,0,3501.0,3304.0,0.944,17.451,161,104,64,40,57,0,57,94,0.0,0.0
1004,1102,25-09-2019 00:22:00,0,3500.0,3407.0,0.973,17.563,224,131,85,46,93,60,33,11,0.0,0.05
1004,1103,25-09-2019 00:24:00,0,3427.0,3255.0,0.95,17.105,367,208,156,52,159,119,40,47,0.04,0.0
1004,1104,25-09-2019 00:26:00,0,4001.0,3772.0,0.943,19.94,171,106,66,40,65,11,54,83,0.0,0.0
1004,1105,25-09-2019 00:28:00,0,3953.0,3814.0,0.965,19.799,161,101,62,39,60,0,60,80,0.0,0.0
1004,1106,25-09-2019 00:30:00,0,4266.0,4011.0,0.94,21.249,170,111,67,44,59,18,41,52,0.01,0.01
1004,1107,25-09-2019 00:32:00,0,3800.0,3576.0,0.941,18.929,138,79,50,29,59,31,28,90,0.0,0.0
1004,1108,25-09-2019 00:34:00,0,4128.5,3882.0,0.94,20.5635,328,188,138,50,140,106,34,136,0.08,0.0
1004,1109,25-09-2019 00:36:00,0,4457.0,4188.0,0.939,22.198,164,115,67,48,49,0,49,58,0.01,0.03
1004,1110,25-09-2019 00:38:00,0,4616.0,4457.0,0.965,23.121,220,139,96,43,81,36,45,61,0.0,0.01
1004,1111,25-09-2019 00:40:00,0,4416.0,4321.0,0.978,22.182,157,104,61,43,53,5,48,83,0.01,0.0
1004,1112,25-09-2019 00:42:00,0,4649.0,4347.0,0.935,23.131,166,100,64,36,66,9,57,82,0.0,0.01
1004,1113,25-09-2019 00:44:00,0,4707.0,4522.0,0.961,23.551,155,104,62,42,51,2,49,62,0.0,0.06
1004,1114,25-09-2019 00:46:00,0,4838.0,4567.0,0.944,24.117,150,100,55,45,50,0,50,73,0.0,0.0
1004,1115,25-09-2019 00:48:00,0,4884.0,4707.0,0.964,24.453,166,89,50,39,77,26,51,63,0.0,0.0
1004,1116,25-09-2019 00:50:00,0,4435.0,4263.0,0.961,22.193,245,124,94,30,121,87,34,70,0.01,0.04
1004,1117,25-09-2019 00:52:00,0,4611.0,4449.0,0.965,23.094,299,129,86,43,170,121,49,17,0.01,0.0
1004,1118,25-09-2019 00:54:00,0,4819.0,4562.0,0.947,24.035,254,126,95,31,128,93,35,46,0.07,0.0
1004,1119,25-09-2019 00:56:00,0,4724.0,4497.0,0.952,23.591,133,91,47,44,42,11,31,50,0.01,0.0
1004,1120,25-09-2019 00:58:00,0,4929.0,4571.0,0.927,24.481,128,79,43,36,49,0,49,73,0.01,0.0
1004,1121,25-09-2019 01:00:00,0,5090.0,4889.0,0.961,25.467,155,100,62,38,55,0,55,77,0.0,0.0
1004,1122,25-09-2019 01:02:00,0,5183.0,5018.0,0.968,25.977,140,78,36,42,62,0,62,75,0.0,0.0
1004,1123,25-09-2019 01:04:00,0,5254.0,5077.0,0.966,26.322,136,80,37,43,56,0,56,63,0.0,0.0
1004,1124,25-09-2019 01:06:00,0,5448.0,5204.0,0.955,27.227,138,84,36,48,54,0,54,58,0.0,0.0
1004,1125,25-09-2019 01:08:00,0,5301.0,5130.0,0.968,26.5655,139,90,47,43,49,0,49,63,0.0,0.0
1004,1126,25-09-2019 01:10:00,0,5154.0,5056.0,0.981,25.904,149,92,51,41,57,2,55,68,0.0,0.16
1004,1127,25-09-2019 01:12:00,0,5166.0,4984.0,0.965,25.873,136,86,47,39,50,0,50,67,0.0,0.07
1004,1128,25-09-2019 01:14:00,0,5250.0,5108.0,0.973,26.342,121,75,33,42,46,0,46,71,0.0,0.05
1004,1129,25-09-2019 01:16:00,0,5144.0,5092.0,0.99,25.902,142,96,56,40,46,0,46,70,0.0,0.05
1004,1130,25-09-2019 01:18:00,0,4961.0,4933.0,0.994,25.007,263,133,93,40,130,94,36,15,0.19,0.07
1004,1131,25-09-2019 01:20:00,0,4814.0,4608.0,0.957,24.069,337,198,153,45,139,108,31,79,0.02,0.05
1004,1132,25-09-2019 01:22:00,0,4794.0,4659.0,0.972,24.045,261,142,115,27,119,89,30,185,0.13,0.0
1004,1133,25-09-2019 01:24:00,0,5162.0,4947.0,0.958,25.816,162,103,57,46,59,0,59,96,0.01,0.0
1004,1134,25-09-2019 01:26:00,0,5356.0,5157.0,0.963,26.811,150,95,53,42,55,7,48,66,0.0,0.11
1004,1135,25-09-2019 01:28:00,0,5154.0,5036.0,0.977,25.883,180,97,60,37,83,58,25,6,0.07,0.0
1004,1136,25-09-2019 01:30:00,0,4151.0,4075.0,0.982,20.868,415,253,209,44,162,123,39,97,0.05,0.0
1004,1137,25-09-2019 01:32:00,0,5394.0,5385.0,0.998,27.215,282,145,111,34,137,98,39,60,0.11,0.0
1004,1138,25-09-2019 01:34:00,0,4950.0,4946.0,0.999,24.978,255,115,86,29,140,102,38,0,0.0,0.07
1004,1139,25-09-2019 01:36:00,0,4509.0,4422.0,0.981,22.66,109,58,35,23,51,24,27,23,0.0,0.0
1004,1140,25-09-2019 01:38:00,0,4991.0,4760.0,0.954,24.935,150,97,61,36,53,0,53,78,0.01,0.0
1004,1141,25-09-2019 01:40:00,0,5169.0,4965.0,0.961,25.86,119,74,39,35,45,0,45,55,0.0,0.12
1004,1142,25-09-2019 01:42:00,0,5209.5,5049.0,0.9695,26.1145,212,110,74,36,102,48,54,39,0.0,0.19
1004,1143,25-09-2019 01:44:00,0,5250.0,5133.0,0.978,26.369,307,185,142,43,122,86,36,54,0.18,0.0
1004,1144,25-09-2019 01:46:00,0,4893.0,4686.0,0.958,24.467,179,107,83,24,72,45,27,12,0.0,0.0
1004,1145,25-09-2019 01:48:00,0,4237.0,4011.0,0.947,21.135,97,48,22,26,49,21,28,0,0.0,0.0
1004,1146,25-09-2019 01:50:00,0,4276.0,3982.0,0.931,21.257,59,33,10,23,26,12,14,0,0.0,0.0
1004,1147,25-09-2019 01:52:00,0,3980.0,3752.0,0.943,19.836,91,45,21,24,46,28,18,2,0.0,0.0
1004,1148,25-09-2019 01:54:00,0,4895.0,4698.0,0.96,24.488,461,266,201,65,195,141,54,15,0.0,0.0
1004,1149,25-09-2019 01:56:00,0,4632.0,4462.0,0.963,23.191,356,202,155,47,154,113,41,26,0.04,0.0
1004,1150,25-09-2019 01:58:00,0,4910.0,4589.0,0.935,24.427,324,200,165,35,124,95,29,187,0.0,0.0
1004,1151,25-09-2019 02:00:00,0,4703.0,4522.0,0.962,23.534,236,117,93,24,119,93,26,198,0.04,0.0
1004,1152,25-09-2019 02:02:00,0,5255.0,5074.0,0.966,26.32,154,80,57,23,74,43,31,7,0.07,0.0
1004,1153,25-09-2019 02:04:00,0,4282.0,3967.0,0.926,21.264,53,31,10,21,22,9,13,12,0.0,0.0
1004,1154,25-09-2019 02:06:00,0,4451.0,4162.0,0.935,22.145,69,48,21,27,21,5,16,0,0.0,0.0
1004,1155,25-09-2019 02:08:00,0,4656.0,4340.0,0.932,23.149,74,26,8,18,48,18,30,1,0.0,0.0
1004,1156,25-09-2019 02:10:00,0,4532.0,4249.0,0.937,22.56,129,82,56,26,47,23,24,30,0.0,0.0
1004,1157,25-09-2019 02:12:00,0,5006.0,4755.0,0.95,24.989,101,66,45,21,35,0,35,51,0.0,0.17
1004,1158,25-09-2019 02:14:00,0,4886.0,4707.0,0.963,24.461,34,34,1,33,0,0,0,0,0.0,0.0
1004,1159,25-09-2019 02:16:00,0,4597.5,4494.5,0.9785,23.09,53,38,11,27,15,9,6,0,0.0,0.02
1004,1160,25-09-2019 02:18:00,0,4309.0,4282.0,0.994,21.719,97,49,31,18,48,21,27,0,0.0,0.0
1004,1161,25-09-2019 02:20:00,0,4145.0,4001.0,0.965,20.759,69,46,20,26,23,0,23,0,0.0,0.0
1004,1162,25-09-2019 02:22:00,0,4354.0,4108.0,0.944,21.702,22,20,5,15,2,2,0,0,0.0,0.0
1004,1163,25-09-2019 02:24:00,0,4156.0,3994.0,0.961,20.797,2,1,1,0,1,0,1,0,0.0,0.0
1004,1164,25-09-2019 02:26:00,0,4171.0,3977.0,0.953,20.836,0,0,0,0,0,0,0,0,0.01,0.0
1004,1165,25-09-2019 02:28:00,0,3856.0,3815.0,0.989,19.418,25,10,2,8,15,2,13,0,0.0,0.0
1004,1166,25-09-2019 02:30:00,0,3883.0,3755.0,0.967,19.457,4,4,0,4,0,0,0,0,0.0,0.0
1004,1167,25-09-2019 02:32:00,0,3681.0,3551.0,0.965,18.433,2,2,1,1,0,0,0,0,0.0,0.0
1004,1168,25-09-2019 02:34:00,0,3682.0,3569.0,0.969,18.459,22,22,9,13,0,0,0,0,0.0,0.0
1004,1169,25-09-2019 02:36:00,0,3609.0,3439.0,0.953,18.025,46,35,18,17,11,5,6,0,0.0,0.0
1004,1170,25-09-2019 02:38:00,0,3396.0,3402.0,1.002,17.146,548,293,224,69,255,199,56,48,0.0,0.0
1004,1171,25-09-2019 02:40:00,0,3869.0,3776.0,0.976,19.424,516,305,230,75,211,160,51,15,0.12,0.0
1004,1172,25-09-2019 02:42:00,0,3778.0,3714.0,0.983,18.996,475,218,169,49,257,194,63,38,0.06,0.06
1004,1173,25-09-2019 02:44:00,0,3848.0,3823.0,0.994,19.392,177,110,73,37,67,35,32,0,0.0,0.0
1004,1174,25-09-2019 02:46:00,0,3884.0,3726.0,0.959,19.429,461,200,149,51,261,192,69,7,0.0,0.0
1004,1175,25-09-2019 02:48:00,0,4145.0,4005.0,0.966,20.764,525,298,242,56,227,174,53,56,0.0,0.0
1004,1176,25-09-2019 02:50:00,0,4059.5,3919.0,0.965,20.333,283,151,116,35,132,91,41,137,0.03,0.0
1004,1177,25-09-2019 02:52:00,0,3974.0,3833.0,0.964,19.902,102,60,40,20,42,26,16,49,0.05,0.0
1004,1178,25-09-2019 02:54:00,0,4170.0,3908.0,0.937,20.756,197,68,32,36,129,87,42,0,0.0,0.0
1004,1179,25-09-2019 02:56:00,0,3991.0,3740.0,0.937,19.867,349,166,126,40,183,136,47,14,0.01,0.02
1004,1180,25-09-2019 02:58:00,0,3970.0,3846.0,0.969,19.898,182,105,72,33,77,37,40,0,0.0,0.0
1004,1181,25-09-2019 03:00:00,0,3984.0,3790.0,0.951,19.893,66,29,5,24,37,8,29,0,0.0,0.0
1004,1182,25-09-2019 03:02:00,0,3982.0,3753.0,0.942,19.844,66,43,7,36,23,4,19,0,0.0,0.0
1004,1183,25-09-2019 03:04:00,0,4005.0,3695.0,0.923,19.871,125,63,34,29,62,32,30,0,0.0,0.0
1004,1184,25-09-2019 03:06:00,0,4065.0,3871.0,0.952,20.301,47,20,5,15,27,4,23,0,0.0,0.0
1004,1185,25-09-2019 03:08:00,0,3977.0,3799.0,0.955,19.874,2,0,0,0,2,0,2,0,0.01,0.0
1004,1186,25-09-2019 03:10:00,0,3915.0,3648.0,0.932,19.463,10,2,0,2,8,3,5,0,0.0,0.0
1004,1187,25-09-2019 03:12:00,0,3835.0,3495.0,0.911,18.981,11,4,1,3,7,0,7,0,0.0,0.0
1004,1188,25-09-2019 03:14:00,0,3500.0,3351.0,0.957,17.498,45,29,16,13,16,7,9,0,0.0,0.0
1004,1189,25-09-2019 03:16:00,0,3599.0,3433.0,0.954,17.982,18,18,2,16,0,0,0,0,0.0,0.0
1004,1190,25-09-2019 03:18:00,0,3609.0,3475.0,0.963,18.065,14,7,1,6,7,1,6,0,0.0,0.0
1004,1191,25-09-2019 03:20:00,0,3329.0,3143.0,0.944,16.597,0,0,0,0,0,0,0,0,0.0,0.0
1004,1192,25-09-2019 03:22:00,0,3177.0,2952.0,0.929,15.786,8,1,1,0,7,2,5,0,0.0,0.0
1004,1193,25-09-2019 03:24:00,0,3218.5,2986.5,0.928,15.9885,2,2,1,1,0,0,0,0,0.0,0.0
1004,1194,25-09-2019 03:26:00,0,3260.0,3021.0,0.927,16.191,4,3,1,2,1,0,1,0,0.0,0.0
1004,1195,25-09-2019 03:28:00,0,3250.0,3027.0,0.932,16.155,7,5,3,2,2,1,1,0,0.0,0.0
1004,1196,25-09-2019 03:30:00,0,3361.0,3062.0,0.911,16.633,8,7,4,3,1,0,1,0,0.0,0.0
1004,1197,25-09-2019 03:32:00,0,3251.0,3054.0,0.94,16.19,17,13,3,10,4,2,2,0,0.0,0.0
1004,1198,25-09-2019 03:34:00,0,3252.0,3076.0,0.946,16.218,29,16,10,6,13,8,5,0,0.0,0.0
1004,1199,25-09-2019 03:36:00,0,3245.0,3055.0,0.941,16.168,0,0,0,0,0,0,0,0,0.0,0.0
1004,1200,25-09-2019 03:38:00,0,3161.0,2954.0,0.935,15.725,9,0,0,0,9,1,8,0,0.0,0.0
1004,1201,25-09-2019 03:40:00,0,3167.0,2894.0,0.914,15.682,20,8,3,5,12,5,7,0,0.0,0.0
1004,1202,25-09-2019 03:42:00,0,3168.0,2928.0,0.924,15.723,0,0,0,0,0,0,0,0,0.0,0.0
1004,1203,25-09-2019 03:44:00,0,3176.0,2873.0,0.905,15.692,0,0,0,0,0,0,0,0,0.0,0.0
1004,1204,25-09-2019 03:46:00,0,3085.0,2832.0,0.918,15.29,14,7,4,3,7,4,3,0,0.0,0.0
1004,1205,25-09-2019 03:48:00,0,3150.0,2982.0,0.947,15.713,6,2,0,2,4,0,4,0,0.0,0.0
1004,1206,25-09-2019 03:50:00,0,3158.0,2937.0,0.93,15.694,30,16,7,9,14,5,9,0,0.0,0.0
1004,1207,25-09-2019 03:52:00,0,3182.0,2869.0,0.902,15.712,8,7,1,6,1,0,1,0,0.0,0.0
1004,1208,25-09-2019 03:54:00,0,2980.0,2786.0,0.935,14.826,81,44,32,12,37,26,11,19,0.0,0.0
1004,1209,25-09-2019 03:56:00,0,3139.0,3006.0,0.958,15.697,196,109,74,35,87,57,30,6,0.0,0.0
1004,1210,25-09-2019 03:58:00,0,3358.5,3249.5,0.967,16.83,70,34,16,18,36,16,20,0,0.0,0.0
1004,1211,25-09-2019 04:00:00,0,3578.0,3493.0,0.976,17.963,42,20,3,17,22,6,16,0,0.0,0.0
1004,1212,25-09-2019 04:02:00,0,3466.0,3488.0,1.006,17.518,95,55,22,33,40,10,30,1,0.0,0.0
1004,1213,25-09-2019 04:04:00,0,3800.0,3634.0,0.956,18.996,37,19,6,13,18,3,15,0,0.0,0.0
1004,1214,25-09-2019 04:06:00,0,3601.0,3461.0,0.961,18.021,152,99,70,29,53,26,27,7,0.0,0.0
1004,1215,25-09-2019 04:08:00,0,4006.0,3728.0,0.931,19.913,190,107,79,28,83,52,31,98,0.0,0.0
1004,1216,25-09-2019 04:10:00,0,3796.0,3603.0,0.949,18.943,224,143,97,46,81,50,31,112,0.0,0.0
1004,1217,25-09-2019 04:12:00,0,3960.0,3866.0,0.976,19.882,179,100,65,35,79,43,36,43,0.0,0.0
1004,1218,25-09-2019 04:14:00,0,3786.0,3673.0,0.97,18.982,160,101,59,42,59,2,57,85,0.0,0.0
1004,1219,25-09-2019 04:16:00,0,4162.0,3920.0,0.942,20.74,148,95,52,43,53,4,49,87,0.0,0.0
1004,1220,25-09-2019 04:18:00,0,4265.0,4041.0,0.947,21.278,125,80,48,32,45,2,43,57,0.0,0.0
1004,1221,25-09-2019 04:20:00,0,3966.0,3843.0,0.969,19.879,376,249,196,53,127,95,32,25,0.0,0.0
1004,1222,25-09-2019 04:22:00,0,4169.0,3911.0,0.938,20.756,212,121,89,32,91,53,38,35,0.04,0.0
1004,1223,25-09-2019 04:24:00,0,4243.0,4079.0,0.961,21.231,160,102,61,41,58,0,58,77,0.01,0.0
1004,1224,25-09-2019 04:26:00,0,4441.0,4238.0,0.954,22.188,135,82,40,42,53,0,53,68,0.0,0.0
1004,1225,25-09-2019 04:28:00,0,4429.0,4318.0,0.975,22.229,167,92,52,40,75,29,46,59,0.08,0.05
1004,1226,25-09-2019 04:30:00,0,4240.0,4056.0,0.957,21.194,481,261,207,54,220,166,54,18,0.01,0.03
1004,1227,25-09-2019 04:32:00,0,4519.5,4340.5,0.9605,22.6105,260,158,123,35,102,68,34,124,0.0,0.0
1004,1228,25-09-2019 04:34:00,0,4799.0,4625.0,0.964,24.027,264,159,117,42,105,65,40,57,0.01,0.0
1004,1229,25-09-2019 04:36:00,0,3777.0,3631.0,0.961,18.9,65,45,29,16,20,11,9,1,0.0,0.0
1004,1230,25-09-2019 04:38:00,0,3645.0,3350.0,0.919,18.071,61,44,19,25,17,2,15,1,0.0,0.0
1004,1231,25-09-2019 04:40:00,0,3975.0,3785.0,0.952,19.854,60,24,4,20,36,7,29,0,0.0,0.0
1004,1232,25-09-2019 04:42:00,0,3998.0,3739.0,0.935,19.891,0,0,0,0,0,0,0,0,0.0,0.0
1004,1233,25-09-2019 04:44:00,0,3823.0,3565.0,0.933,19.012,13,12,5,7,1,0,1,0,0.0,0.0
1004,1234,25-09-2019 04:46:00,0,3849.0,3438.0,0.893,18.973,11,6,2,4,5,2,3,0,0.0,0.0
1004,1235,25-09-2019 04:48:00,0,3826.0,3444.0,0.9,18.886,7,7,1,6,0,0,0,0,0.0,0.0
1004,1236,25-09-2019 04:50:00,0,3525.0,3389.0,0.961,17.64,8,8,6,2,0,0,0,0,0.0,0.0
1004,1237,25-09-2019 04:52:00,0,3524.0,3294.0,0.935,17.53,6,4,2,2,2,1,1,0,0.0,0.0
1004,1238,25-09-2019 04:54:00,0,3453.0,3193.0,0.925,17.141,6,6,1,5,0,0,0,0,0.0,0.0
1004,1239,25-09-2019 04:56:00,0,3351.0,3089.0,0.922,16.624,8,8,0,8,0,0,0,0,0.0,0.0
1004,1240,25-09-2019 04:58:00,0,3366.0,2996.0,0.89,16.577,27,23,12,11,4,3,1,0,0.0,0.0
1004,1241,25-09-2019 05:00:00,0,3258.0,2976.0,0.914,16.13,0,0,0,0,0,0,0,0,0.0,0.0
1004,1242,25-09-2019 05:02:00,0,3162.0,2923.0,0.925,15.695,3,3,1,2,0,0,0,0,0.0,0.0
1004,1243,25-09-2019 05:04:00,0,3179.0,2904.0,0.914,15.741,7,5,2,3,2,0,2,0,0.0,0.0
1004,1244,25-09-2019 05:06:00,0,3182.0,2870.5,0.9025,15.7155,2,0,0,0,2,0,2,0,0.0,0.0
1004,1245,25-09-2019 05:08:00,0,3185.0,2837.0,0.891,15.69,2,0,0,0,2,0,2,0,0.0,0.0
1004,1246,25-09-2019 05:10:00,0,3174.0,2927.0,0.922,15.746,7,6,0,6,1,0,1,0,0.0,0.0
1004,1247,25-09-2019 05:12:00,0,3165.0,2945.0,0.931,15.731,9,5,4,1,4,1,3,0,0.0,0.0
1004,1248,25-09-2019 05:14:00,0,3165.0,2928.0,0.925,15.712,0,0,0,0,0,0,0,0,0.0,0.0
1004,1249,25-09-2019 05:16:00,0,3159.0,2885.0,0.913,15.64,1,1,1,0,0,0,0,0,0.01,0.0
1004,1250,25-09-2019 05:18:00,0,3180.0,2888.0,0.908,15.724,35,23,14,9,12,8,4,2,0.0,0.0
1004,1251,25-09-2019 05:20:00,0,3155.0,2988.0,0.947,15.739,155,77,39,38,78,43,35,37,0.0,0.0
1004,1252,25-09-2019 05:22:00,0,3504.0,3383.0,0.966,17.549,143,98,55,43,45,5,40,71,0.0,0.0
1004,1253,25-09-2019 05:24:00,0,3807.0,3569.0,0.938,18.95,128,68,34,34,60,23,37,59,0.0,0.0
1004,1254,25-09-2019 05:26:00,0,3501.0,3425.0,0.978,17.584,137,77,45,32,60,23,37,23,0.0,0.0
1004,1255,25-09-2019 05:28:00,0,3790.0,3657.0,0.965,18.982,161,90,56,34,71,43,28,35,0.0,0.1
1004,1256,25-09-2019 05:30:00,0,3958.0,3822.0,0.966,19.828,211,119,72,47,92,26,66,65,0.0,0.0
1004,1257,25-09-2019 05:32:00,0,4272.0,4022.0,0.941,21.285,125,76,37,39,49,0,49,51,0.0,0.0
1004,1258,25-09-2019 05:34:00,0,4236.0,4086.0,0.965,21.214,257,153,102,51,104,49,55,61,0.0,0.0
1004,1259,25-09-2019 05:36:00,0,3872.0,3727.0,0.963,19.381,286,154,124,30,132,94,38,99,0.0,0.0
1004,1260,25-09-2019 05:38:00,0,3972.0,3834.0,0.965,19.896,167,90,53,37,77,29,48,53,0.06,0.0
1004,1261,25-09-2019 05:40:00,0,4150.5,4042.0,0.9735,20.829,203,117,82,35,86,47,39,64,0.01,0.0
1004,1262,25-09-2019 05:42:00,0,4329.0,4250.0,0.982,21.762,187,87,56,31,100,57,43,34,0.0,0.0
1004,1263,25-09-2019 05:44:00,0,4142.0,4027.0,0.972,20.778,109,52,38,14,57,32,25,7,0.0,0.01
1004,1264,25-09-2019 05:46:00,0,3959.0,3925.0,0.992,19.943,234,133,100,33,101,71,30,14,0.0,0.0
1004,1265,25-09-2019 05:48:00,0,3047.0,2924.0,0.96,15.24,61,32,25,7,29,15,14,1,0.0,0.0
1004,1266,25-09-2019 05:50:00,0,3330.0,3181.0,0.955,16.644,91,27,13,14,64,25,39,0,0.0,0.0
1004,1267,25-09-2019 05:52:00,0,3681.0,3538.0,0.961,18.422,65,21,5,16,44,22,22,0,0.0,0.0
1004,1268,25-09-2019 05:54:00,0,3734.0,3446.0,0.923,18.527,6,6,0,6,0,0,0,0,0.0,0.0
1004,1269,25-09-2019 05:56:00,0,3412.0,3268.0,0.958,17.062,0,0,0,0,0,0,0,0,0.0,0.0
1004,1270,25-09-2019 05:58:00,0,3224.0,3145.0,0.975,16.185,18,11,5,6,7,2,5,0,0.0,0.0
1004,1271,25-09-2019 06:00:00,1,3252.0,3052.0,0.938,16.193,19,0,0,0,19,1,18,0,0.0,0.0
1004,1272,25-09-2019 06:02:00,1,3246.0,3043.0,0.937,16.158,22,3,0,3,19,5,14,0,0.0,0.0
1004,1273,25-09-2019 06:04:00,1,3325.0,3164.0,0.951,16.605,45,26,15,11,19,5,14,0,0.01,0.0
1004,1274,25-09-2019 06:06:00,1,3407.0,3346.0,0.982,17.127,20,8,5,3,12,6,6,0,0.0,0.0
1004,1275,25-09-2019 06:08:00,1,3221.0,3143.0,0.976,16.171,4,1,0,1,3,1,2,0,0.0,0.0
1004,1276,25-09-2019 06:10:00,1,3268.0,2977.0,0.911,16.172,47,29,12,17,18,9,9,0,0.0,0.0
1004,1277,25-09-2019 06:12:00,1,3263.0,3026.0,0.927,16.209,4,2,1,1,2,0,2,0,0.0,0.0
1004,1278,25-09-2019 06:14:00,1,3168.0,2947.0,0.93,15.747,0,0,0,0,0,0,0,0,0.0,0.0
1004,1279,25-09-2019 06:16:00,1,3073.0,2868.0,0.933,15.285,0,0,0,0,0,0,0,0,0.0,0.0
1004,1280,25-09-2019 06:18:00,1,3075.0,2802.0,0.911,15.219,7,1,0,1,6,1,5,0,0.0,0.0
1004,1281,25-09-2019 06:20:00,1,2761.0,2680.0,0.97,13.847,3,0,0,0,3,0,3,0,0.0,0.0
1004,1282,25-09-2019 06:22:00,1,2772.0,2614.0,0.943,13.814,2,0,0,0,2,1,1,0,0.0,0.0
1004,1283,25-09-2019 06:24:00,1,2808.0,2570.0,0.915,13.909,22,10,8,2,12,7,5,0,0.0,0.0
1004,1284,25-09-2019 06:26:00,1,2800.0,2534.0,0.905,13.835,0,0,0,0,0,0,0,0,0.0,0.0
1004,1285,25-09-2019 06:28:00,1,2609.0,2428.0,0.931,12.967,18,12,4,8,6,3,3,0,0.0,0.0
1004,1286,25-09-2019 06:30:00,1,2595.0,2435.0,0.938,12.918,81,41,18,23,40,20,20,3,0.0,0.0
1004,1287,25-09-2019 06:32:00,1,2771.0,2661.0,0.961,13.863,67,43,23,20,24,13,11,61,0.0,0.0
1004,1288,25-09-2019 06:34:00,1,3078.0,2841.0,0.923,15.273,137,93,56,37,44,23,21,18,0.01,0.0
1004,1289,25-09-2019 06:36:00,1,2769.0,2640.0,0.954,13.831,180,98,77,21,82,59,23,42,0.0,0.0
1004,1290,25-09-2019 06:38:00,1,3162.0,2892.0,0.915,15.658,136,72,53,19,64,42,22,27,0.0,0.0
1004,1291,25-09-2019 06:40:00,1,3077.0,2830.0,0.92,15.258,61,37,18,19,24,13,11,0,0.0,0.0
1004,1292,25-09-2019 06:42:00,1,3079.0,2801.0,0.91,15.233,37,23,8,15,14,1,13,0,0.0,0.0
1004,1293,25-09-2019 06:44:00,1,3275.0,2993.0,0.914,16.217,65,45,13,32,20,9,11,0,0.0,0.0
1004,1294,25-09-2019 06:46:00,1,3248.0,3034.0,0.934,16.155,6,0,0,0,6,1,5,0,0.0,0.0
1004,1295,25-09-2019 06:48:00,1,3162.5,2924.0,0.9245,15.697,0,0,0,0,0,0,0,0,0.0,0.0
1004,1296,25-09-2019 06:50:00,1,3077.0,2814.0,0.915,15.239,14,2,1,1,12,6,6,0,0.0,0.0
1004,1297,25-09-2019 06:52:00,1,3089.0,2712.0,0.878,15.174,17,2,1,1,15,3,12,0,0.0,0.0
1004,1298,25-09-2019 06:54:00,1,2785.0,2583.0,0.928,13.831,9,3,2,1,6,4,2,0,0.0,0.0
1004,1299,25-09-2019 06:56:00,1,2785.0,2597.0,0.932,13.848,4,0,0,0,4,1,3,0,0.0,0.0
1004,1300,25-09-2019 06:58:00,1,2812.0,2529.0,0.899,13.88,4,0,0,0,4,0,4,0,0.0,0.0
1004,1301,25-09-2019 07:00:00,1,2824.0,2488.0,0.881,13.883,2,0,0,0,2,0,2,0,0.0,0.0
1004,1302,25-09-2019 07:02:00,1,2723.0,2435.0,0.894,13.426,0,0,0,0,0,0,0,0,0.0,0.0
1004,1303,25-09-2019 07:04:00,1,2616.0,2398.0,0.917,12.961,1,0,0,0,1,0,1,0,0.0,0.0
1004,1304,25-09-2019 07:06:00,1,2617.0,2330.0,0.891,12.889,21,0,0,0,21,0,21,0,0.0,0.0
1004,1305,25-09-2019 07:08:00,1,2620.0,2310.0,0.882,12.882,16,7,5,2,9,3,6,0,0.0,0.0
1004,1306,25-09-2019 07:10:00,1,2648.0,2268.0,0.856,12.944,0,0,0,0,0,0,0,0,0.0,0.0
1004,1307,25-09-2019 07:12:00,1,2436.0,2151.0,0.883,11.981,6,0,0,0,6,3,3,0,0.0,0.0
1004,1308,25-09-2019 07:14:00,1,2444.0,2166.0,0.886,12.029,19,5,1,4,14,5,9,0,0.0,0.0
1004,1309,25-09-2019 07:16:00,1,2444.0,2164.0,0.885,12.026,2,2,1,1,0,0,0,0,0.0,0.0
1004,1310,25-09-2019 07:18:00,1,2451.0,2146.0,0.876,12.033,19,13,7,6,6,0,6,0,0.0,0.0
1004,1311,25-09-2019 07:20:00,1,2656.0,2210.0,0.832,12.913,10,5,2,3,5,0,5,0,0.0,0.0
1004,1312,25-09-2019 07:22:00,1,2807.0,2309.0,0.823,13.617,0,0,0,0,0,0,0,0,0.0,0.0
1004,1313,25-09-2019 07:24:00,1,2958.0,2408.0,0.814,14.321,8,6,2,4,2,0,2,0,0.0,0.0
1004,1314,25-09-2019 07:26:00,1,2931.0,2471.0,0.843,14.285,3,2,1,1,1,0,1,0,0.0,0.0
1004,1315,25-09-2019 07:28:00,1,2971.0,2374.0,0.799,14.334,15,9,0,9,6,0,6,0,0.0,0.0
1004,1316,25-09-2019 07:30:00,1,2768.0,2251.0,0.813,13.396,10,0,0,0,10,0,10,0,0.0,0.0
1004,1317,25-09-2019 07:32:00,1,2777.0,2246.0,0.809,13.428,18,3,0,3,15,0,15,0,0.0,0.0
1004,1318,25-09-2019 07:34:00,1,2770.0,2230.0,0.805,13.385,10,2,0,2,8,0,8,0,0.0,0.0
1004,1319,25-09-2019 07:36:00,1,2773.0,2187.0,0.789,13.348,32,20,11,9,12,7,5,0,0.0,0.0
1004,1320,25-09-2019 07:38:00,1,2576.0,2072.0,0.804,12.443,56,29,19,10,27,19,8,0,0.0,0.0
1004,1321,25-09-2019 07:40:00,1,2974.0,2363.0,0.794,14.334,55,48,27,21,7,0,7,0,0.0,0.0
1004,1322,25-09-2019 07:42:00,1,2945.0,2456.0,0.834,14.325,47,25,9,16,22,7,15,7,0.0,0.0
1004,1323,25-09-2019 07:44:00,1,3260.0,2597.0,0.797,15.72,106,42,25,17,64,13,51,76,0.0,0.0
1004,1324,25-09-2019 07:46:00,1,3250.0,2618.0,0.806,15.703,113,66,41,25,47,15,32,64,0.0,0.0
1004,1325,25-09-2019 07:48:00,1,3441.0,2728.0,0.793,16.579,116,72,42,30,44,11,33,60,0.0,0.0
1004,1326,25-09-2019 07:50:00,1,3451.0,2770.0,0.803,16.665,161,104,77,27,57,33,24,6,0.0,0.0
1004,1327,25-09-2019 07:52:00,1,3051.0,2491.0,0.816,14.778,177,109,77,32,68,40,28,13,0.0,0.0
1004,1328,25-09-2019 07:54:00,1,3447.0,2791.0,0.81,16.67,144,87,54,33,57,12,45,85,0.0,0.0
1004,1329,25-09-2019 07:56:00,1,3516.0,2930.5,0.833,17.0975,139,88,57,31,51,13,38,76,0.0,0.0
1004,1330,25-09-2019 07:58:00,1,3585.0,3070.0,0.856,17.525,391,248,191,57,143,100,43,28,0.0,0.0
1004,1331,25-09-2019 08:00:00,1,3414.0,2853.0,0.835,16.611,404,235,188,47,169,118,51,15,0.0,0.04
1004,1332,25-09-2019 08:02:00,1,3154.0,2527.0,0.801,15.227,82,40,26,14,42,11,31,0,0.0,0.0
1004,1333,25-09-2019 08:04:00,1,3332.0,2713.0,0.814,16.133,84,46,12,34,38,18,20,0,0.0,0.0
1004,1334,25-09-2019 08:06:00,1,3217.0,2688.0,0.835,15.652,47,30,9,21,17,4,13,0,0.0,0.0
1004,1335,25-09-2019 08:08:00,1,3431.0,2769.0,0.807,16.584,21,10,2,8,11,2,9,0,0.0,0.0
1004,1336,25-09-2019 08:10:00,1,3431.0,2795.0,0.814,16.613,72,18,2,16,54,25,29,0,0.0,0.0
1004,1337,25-09-2019 08:12:00,1,3409.0,2859.0,0.839,16.597,47,13,4,9,34,18,16,0,0.0,0.0
1004,1338,25-09-2019 08:14:00,1,3421.0,2850.0,0.833,16.634,1,1,0,1,0,0,0,0,0.0,0.0
1004,1339,25-09-2019 08:16:00,1,3437.0,2800.0,0.815,16.64,10,6,0,6,4,1,3,0,0.0,0.0
1004,1340,25-09-2019 08:18:00,1,3317.0,2762.0,0.833,16.128,34,4,1,3,30,1,29,0,0.0,0.0
1004,1341,25-09-2019 08:20:00,1,3224.0,2668.0,0.827,15.658,24,9,2,7,15,5,10,0,0.0,0.0
1004,1342,25-09-2019 08:22:00,1,3249.0,2568.0,0.791,15.645,1,0,0,0,1,1,0,0,0.0,0.0
1004,1343,25-09-2019 08:24:00,1,2940.0,2483.0,0.844,14.333,1,1,0,1,0,0,0,0,0.0,0.0
1004,1344,25-09-2019 08:26:00,1,2955.0,2402.0,0.813,14.303,4,2,0,2,2,0,2,0,0.0,0.0
1004,1345,25-09-2019 08:28:00,1,2966.0,2379.0,0.802,14.318,0,0,0,0,0,0,0,0,0.0,0.0
1004,1346,25-09-2019 08:30:00,1,2863.5,2312.0,0.8075,13.8405,20,13,3,10,7,1,6,0,0.0,0.0
1004,1347,25-09-2019 08:32:00,1,2761.0,2245.0,0.813,13.363,13,3,0,3,10,4,6,0,0.0,0.0
1004,1348,25-09-2019 08:34:00,1,2780.0,2166.0,0.779,13.353,14,7,3,4,7,3,4,0,0.0,0.0
1004,1349,25-09-2019 08:36:00,1,2792.0,2140.0,0.766,13.369,28,8,6,2,20,3,17,0,0.0,0.0
1004,1350,25-09-2019 08:38:00,1,2685.0,2099.0,0.782,12.902,0,0,0,0,0,0,0,0,0.0,0.0
1004,1351,25-09-2019 08:40:00,1,2607.0,1988.0,0.763,12.472,5,2,0,2,3,1,2,0,0.0,0.0
1004,1352,25-09-2019 08:42:00,1,2606.0,1942.0,0.745,12.419,0,0,0,0,0,0,0,0,0.0,0.0
1004,1353,25-09-2019 08:44:00,1,2591.0,1996.0,0.77,12.42,0,0,0,0,0,0,0,0,0.0,0.0
1004,1354,25-09-2019 08:46:00,1,2603.0,2041.0,0.784,12.515,20,14,6,8,6,3,3,0,0.0,0.0
1004,1355,25-09-2019 08:48:00,1,2805.0,2106.0,0.751,13.382,12,9,4,5,3,0,3,0,0.0,0.0
1004,1356,25-09-2019 08:50:00,1,2781.0,2150.0,0.773,13.339,10,4,1,3,6,0,6,0,0.0,0.0
1004,1357,25-09-2019 08:52:00,1,2795.0,2104.0,0.753,13.343,26,26,0,26,0,0,0,0,0.0,0.0
1004,1358,25-09-2019 08:54:00,1,2701.0,2013.0,0.746,12.87,12,6,4,2,6,1,5,0,0.0,0.0
1004,1359,25-09-2019 08:56:00,1,2597.0,1981.0,0.763,12.428,13,4,2,2,9,3,6,0,0.0,0.0
1004,1360,25-09-2019 08:58:00,1,2812.0,2066.0,0.735,13.367,2,2,1,1,0,0,0,0,0.0,0.0
1004,1361,25-09-2019 09:00:00,1,2715.0,2013.0,0.742,12.927,9,9,5,4,0,0,0,0,0.0,0.0
1004,1362,25-09-2019 09:02:00,1,2837.0,2021.0,0.712,13.414,2,2,2,0,0,0,0,0,0.0,0.0
1004,1363,25-09-2019 09:04:00,1,2763.0,2027.0,0.734,13.129,15,10,7,3,5,3,2,0,0.0,0.0
1004,1364,25-09-2019 09:06:00,1,2689.0,2033.0,0.756,12.844,15,13,4,9,2,0,2,0,0.0,0.0
1004,1365,25-09-2019 09:08:00,1,2715.0,2007.0,0.739,12.919,14,4,2,2,10,4,6,0,0.0,0.0
1004,1366,25-09-2019 09:10:00,1,2704.0,1993.0,0.737,12.862,77,38,26,12,39,23,16,4,0.0,0.0
1004,1367,25-09-2019 09:12:00,1,2792.0,2135.0,0.765,13.365,92,37,19,18,55,37,18,0,0.0,0.0
1004,1368,25-09-2019 09:14:00,1,2885.0,2274.0,0.788,13.885,79,25,7,18,54,22,32,0,0.0,0.0
1004,1369,25-09-2019 09:16:00,1,2868.0,2279.0,0.795,13.825,87,36,9,27,51,24,27,0,0.0,0.0
1004,1370,25-09-2019 09:18:00,1,2849.0,2334.0,0.819,13.811,151,106,68,38,45,24,21,15,0.0,0.0
1004,1371,25-09-2019 09:20:00,1,2951.0,2383.0,0.807,14.266,153,87,63,24,66,37,29,80,0.0,0.0
1004,1372,25-09-2019 09:22:00,1,3148.0,2563.0,0.814,15.241,140,96,55,41,44,29,15,1,0.0,0.06
1004,1373,25-09-2019 09:24:00,1,3181.0,2471.0,0.777,15.268,96,54,30,24,42,24,18,12,0.0,0.0
1004,1374,25-09-2019 09:26:00,1,3144.0,2561.0,0.815,15.222,171,107,84,23,64,38,26,27,0.0,0.0
1004,1375,25-09-2019 09:28:00,1,2866.0,2314.0,0.807,13.855,36,29,14,15,7,3,4,0,0.0,0.0
1004,1376,25-09-2019 09:30:00,1,2869.0,2293.0,0.799,13.844,303,165,123,42,138,93,45,24,0.0,0.0
1004,1377,25-09-2019 09:32:00,1,2958.0,2389.0,0.808,14.299,43,23,8,15,20,9,11,0,0.0,0.0
1004,1378,25-09-2019 09:34:00,1,2962.0,2390.0,0.807,14.318,65,20,6,14,45,29,16,0,0.0,0.0
1004,1379,25-09-2019 09:36:00,1,2961.0,2391.0,0.807,14.316,85,31,4,27,54,14,40,1,0.0,0.0
1004,1380,25-09-2019 09:38:00,1,2977.0,2309.5,0.7755,14.288,44,30,19,11,14,5,9,0,0.0,0.0
1004,1381,25-09-2019 09:40:00,1,2993.0,2228.0,0.744,14.26,0,0,0,0,0,0,0,0,0.0,0.0
1004,1382,25-09-2019 09:42:00,1,2785.0,2157.0,0.775,13.364,3,0,0,0,3,0,3,0,0.0,0.0
1004,1383,25-09-2019 09:44:00,1,2802.0,2110.0,0.753,13.376,4,2,0,2,2,0,2,0,0.0,0.0
1004,1384,25-09-2019 09:46:00,1,2818.0,2063.0,0.732,13.388,0,0,0,0,0,0,0,0,0.0,0.0
1004,1385,25-09-2019 09:48:00,1,2596.0,2001.0,0.771,12.443,8,6,1,5,2,0,2,0,0.0,0.0
1004,1386,25-09-2019 09:50:00,1,2612.0,1951.0,0.747,12.453,28,20,8,12,8,2,6,0,0.01,0.0
1004,1387,25-09-2019 09:52:00,1,2610.0,1946.0,0.746,12.438,1,1,1,0,0,0,0,0,0.0,0.0
1004,1388,25-09-2019 09:54:00,1,2519.0,1864.0,0.74,11.99,0,0,0,0,0,0,0,0,0.0,0.0
1004,1389,25-09-2019 09:56:00,1,2313.0,1751.0,0.757,11.05,21,11,2,9,10,7,3,0,0.0,0.0
1004,1390,25-09-2019 09:58:00,1,2314.0,1756.0,0.759,11.06,0,0,0,0,0,0,0,0,0.0,0.0
1004,1391,25-09-2019 10:00:00,1,2302.0,1797.0,0.781,11.059,7,5,0,5,2,0,2,0,0.0,0.0
1004,1392,25-09-2019 10:02:00,1,2529.0,1840.0,0.727,12.004,12,4,2,2,8,2,6,0,0.0,0.0
1004,1393,25-09-2019 10:04:00,1,2626.0,1862.0,0.709,12.408,0,0,0,0,0,0,0,0,0.0,0.0
1004,1394,25-09-2019 10:06:00,1,2630.0,1877.0,0.714,12.439,7,4,1,3,3,2,1,0,0.0,0.0
1004,1395,25-09-2019 10:08:00,1,2627.0,1874.0,0.713,12.427,1,1,0,1,0,0,0,0,0.0,0.0
1004,1396,25-09-2019 10:10:00,1,2622.0,1887.0,0.72,12.422,17,7,2,5,10,2,8,0,0.0,0.0
1004,1397,25-09-2019 10:12:00,1,2638.0,1843.0,0.699,12.4365,7,7,1,6,0,0,0,0,0.0,0.0
1004,1398,25-09-2019 10:14:00,1,2654.0,1799.0,0.678,12.451,3,2,0,2,1,0,1,0,0.0,0.0
1004,1399,25-09-2019 10:16:00,1,2645.0,1832.0,0.693,12.45,3,1,0,1,2,0,2,0,0.0,0.0
1004,1400,25-09-2019 10:18:00,1,2644.0,1838.0,0.695,12.451,4,2,0,2,2,0,2,0,0.0,0.0
1004,1401,25-09-2019 10:20:00,1,2616.0,1886.0,0.721,12.394,1,0,0,0,1,0,1,0,0.0,0.0
1004,1402,25-09-2019 10:22:00,1,2727.0,1926.0,0.706,12.878,2,2,1,1,0,0,0,0,0.0,0.0
1004,1403,25-09-2019 10:24:00,1,2617.0,1911.0,0.73,12.427,11,5,0,5,6,2,4,0,0.0,0.0
1004,1404,25-09-2019 10:26:00,1,2628.0,1906.0,0.725,12.464,9,2,0,2,7,1,6,0,0.0,0.0
1004,1405,25-09-2019 10:28:00,1,2631.0,1887.0,0.717,12.458,5,0,0,0,5,2,3,0,0.0,0.0
1004,1406,25-09-2019 10:30:00,1,2620.0,1914.0,0.73,12.443,8,8,1,7,0,0,0,0,0.0,0.0
1004,1407,25-09-2019 10:32:00,1,2628.0,1904.0,0.725,12.464,0,0,0,0,0,0,0,0,0.0,0.0
1004,1408,25-09-2019 10:34:00,1,2644.0,1843.0,0.697,12.459,3,2,1,1,1,0,1,0,0.0,0.0
1004,1409,25-09-2019 10:36:00,1,2641.0,1819.0,0.689,12.418,0,0,0,0,0,0,0,0,0.0,0.0
1004,1410,25-09-2019 10:38:00,1,2638.0,1829.0,0.693,12.42,0,0,0,0,0,0,0,0,0.0,0.0
1004,1411,25-09-2019 10:40:00,1,2644.0,1800.0,0.681,12.412,0,0,0,0,0,0,0,0,0.0,0.0
1004,1412,25-09-2019 10:42:00,1,2661.0,1776.0,0.667,12.45,65,32,20,12,33,22,11,0,0.0,0.0
1004,1413,25-09-2019 10:44:00,1,2627.0,1889.0,0.719,12.442,12,6,1,5,6,2,4,0,0.0,0.0
1004,1414,25-09-2019 10:46:00,1,2721.0,1983.5,0.7285,12.9175,58,44,14,30,14,3,11,0,0.0,0.0
1004,1415,25-09-2019 10:48:00,1,2815.0,2078.0,0.738,13.393,106,50,21,29,56,32,24,10,0.0,0.0
1004,1416,25-09-2019 10:50:00,1,2807.0,2094.0,0.746,13.379,117,74,42,32,43,33,10,11,0.0,0.0
1004,1417,25-09-2019 10:52:00,1,2789.0,2133.0,0.765,13.353,229,133,101,32,96,68,28,66,0.0,0.0
1004,1418,25-09-2019 10:54:00,1,2894.0,2160.0,0.746,13.793,196,109,74,35,87,53,34,37,0.0,0.0
1004,1419,25-09-2019 10:56:00,1,3005.0,2227.0,0.741,14.305,106,71,46,25,35,23,12,0,0.0,0.0
1004,1420,25-09-2019 10:58:00,1,3010.0,2206.0,0.733,14.303,144,108,80,28,36,23,13,23,0.0,0.0
1004,1421,25-09-2019 11:00:00,1,3100.0,2305.0,0.744,14.765,297,208,162,46,89,48,41,70,0.0,0.0
1004,1422,25-09-2019 11:02:00,1,2995.0,2288.0,0.764,14.335,109,58,33,25,51,4,47,81,0.0,0.0
1004,1423,25-09-2019 11:04:00,1,3200.0,2340.0,0.731,15.2,146,83,37,46,63,0,63,62,0.0,0.0
1004,1424,25-09-2019 11:06:00,1,3288.0,2459.0,0.748,15.678,122,69,26,43,53,0,53,49,0.0,0.0
1004,1425,25-09-2019 11:08:00,1,3370.0,2536.0,0.753,16.085,118,59,26,33,59,0,59,53,0.0,0.0
1004,1426,25-09-2019 11:10:00,1,3673.0,2747.0,0.748,17.516,126,79,34,45,47,0,47,59,0.0,0.0
1004,1427,25-09-2019 11:12:00,1,3675.0,2786.0,0.758,17.565,114,66,21,45,48,0,48,48,0.0,0.0
1004,1428,25-09-2019 11:14:00,1,3847.0,2978.0,0.774,18.453,139,76,32,44,63,0,63,61,0.0,0.0
1004,1429,25-09-2019 11:16:00,1,3929.0,3058.0,0.778,18.867,120,58,22,36,62,0,62,55,0.0,0.0
1004,1430,25-09-2019 11:18:00,1,4112.0,3251.0,0.791,19.802,105,66,26,40,39,0,39,44,0.0,0.04
1004,1431,25-09-2019 11:20:00,1,3857.0,3096.0,0.804,18.625,118,53,23,30,65,9,56,43,0.0,0.04
1004,1432,25-09-2019 11:22:00,1,3602.0,2941.0,0.817,17.448,373,235,190,45,138,106,32,51,0.28,0.0
1004,1433,25-09-2019 11:24:00,1,3438.0,2754.0,0.801,16.597,280,190,146,44,90,62,28,6,0.0,0.0
1004,1434,25-09-2019 11:26:00,1,3276.0,2501.0,0.763,15.675,353,231,176,55,122,82,40,8,0.0,0.05
1004,1435,25-09-2019 11:28:00,1,3911.0,3150.0,0.806,18.896,203,85,57,28,118,48,70,61,0.01,0.0
1004,1436,25-09-2019 11:30:00,1,3606.0,3017.0,0.837,17.548,107,54,41,13,53,36,17,0,0.0,0.0
1004,1437,25-09-2019 11:32:00,1,3274.0,2534.0,0.774,15.706,237,131,95,36,106,68,38,2,0.0,0.0
1004,1438,25-09-2019 11:34:00,1,3912.0,3198.0,0.818,18.953,185,101,54,47,84,53,31,0,0.07,0.0
1004,1439,25-09-2019 11:36:00,1,3429.0,2856.0,0.833,16.673,184,105,65,40,79,47,32,0,0.0,0.0
1004,1440,25-09-2019 11:38:00,1,3324.0,2753.0,0.828,16.146,8,3,1,2,5,4,1,0,0.01,0.0
1004,1441,25-09-2019 11:40:00,1,3395.0,2934.0,0.864,16.626,102,33,13,20,69,37,32,1,0.0,0.0
1004,1442,25-09-2019 11:42:00,1,3397.0,2927.0,0.862,16.624,116,64,31,33,52,16,36,0,0.0,0.0
1004,1443,25-09-2019 11:44:00,1,3389.0,2900.0,0.856,16.564,15,12,4,8,3,1,2,0,0.0,0.0
1004,1444,25-09-2019 11:46:00,1,3422.0,2852.0,0.834,16.639,11,4,3,1,7,4,3,0,0.0,0.0
1004,1445,25-09-2019 11:48:00,1,3208.0,2768.0,0.863,15.704,0,0,0,0,0,0,0,0,0.0,0.0
1004,1446,25-09-2019 11:50:00,1,3204.0,2714.0,0.847,15.629,11,3,0,3,8,4,4,0,0.0,0.0
1004,1447,25-09-2019 11:52:00,1,3218.0,2709.0,0.842,15.676,5,5,0,5,0,0,0,0,0.0,0.0
1004,1448,25-09-2019 11:54:00,1,3222.0,2700.5,0.838,15.6835,9,5,0,5,4,1,3,0,0.0,0.0
1004,1449,25-09-2019 11:56:00,1,3226.0,2692.0,0.834,15.691,7,2,0,2,5,2,3,0,0.0,0.0
1004,1450,25-09-2019 11:58:00,1,3214.0,2722.0,0.847,15.677,29,13,2,11,16,6,10,0,0.0,0.0
1004,1451,25-09-2019 12:00:00,1,3215.0,2751.0,0.856,15.711,0,0,0,0,0,0,0,0,0.0,0.0
1004,1452,25-09-2019 12:02:00,1,3219.0,2744.0,0.853,15.72,24,11,4,7,13,7,6,0,0.02,0.0
1004,1453,25-09-2019 12:04:00,1,3212.0,2705.0,0.842,15.65,15,13,1,12,2,0,2,0,0.0,0.0
1004,1454,25-09-2019 12:06:00,1,3016.0,2640.0,0.875,14.807,16,12,1,11,4,1,3,0,0.0,0.0
1004,1455,25-09-2019 12:08:00,1,2915.0,2528.0,0.867,14.282,27,17,4,13,10,5,5,0,0.0,0.0
1004,1456,25-09-2019 12:10:00,1,2932.0,2489.0,0.849,14.307,11,5,1,4,6,2,4,0,0.0,0.0
1004,1457,25-09-2019 12:12:00,1,2932.0,2493.0,0.85,14.312,18,11,3,8,7,2,5,0,0.0,0.0
1004,1458,25-09-2019 12:14:00,1,2926.0,2514.0,0.859,14.31,17,5,4,1,12,3,9,0,0.0,0.0
1004,1459,25-09-2019 12:16:00,1,2932.0,2506.0,0.855,14.327,14,0,0,0,14,0,14,0,0.0,0.0
1004,1460,25-09-2019 12:18:00,1,2943.0,2463.0,0.837,14.321,0,0,0,0,0,0,0,0,0.0,0.0
1004,1461,25-09-2019 12:20:00,1,2959.0,2384.0,0.806,14.298,0,0,0,0,0,0,0,0,0.0,0.0
1004,1462,25-09-2019 12:22:00,1,2859.0,2337.0,0.817,13.852,176,101,58,43,75,34,41,13,0.0,0.0
1004,1463,25-09-2019 12:24:00,1,3037.0,2583.0,0.851,14.826,136,74,33,41,62,5,57,60,0.0,0.0
1004,1464,25-09-2019 12:26:00,1,3246.0,2675.0,0.824,15.749,110,58,26,32,52,0,52,68,0.0,0.0
1004,1465,25-09-2019 12:28:00,1,3328.5,2765.0,0.8305,16.1745,92,47,14,33,45,0,45,38,0.0,0.0
1004,1466,25-09-2019 12:30:00,1,3411.0,2855.0,0.837,16.6,141,75,39,36,66,27,39,22,0.0,0.0
1004,1467,25-09-2019 12:32:00,1,2930.0,2502.0,0.854,14.315,118,25,8,17,93,41,52,0,0.0,0.0
1004,1468,25-09-2019 12:34:00,1,2760.0,2303.0,0.834,13.423,58,38,24,14,20,9,11,0,0.0,0.0
1004,1469,25-09-2019 12:36:00,1,2927.0,2514.0,0.859,14.317,74,27,6,21,47,22,25,0,0.0,0.0
1004,1470,25-09-2019 12:38:00,1,3420.0,2863.0,0.837,16.643,118,50,19,31,68,26,42,0,0.0,0.0
1004,1471,25-09-2019 12:40:00,1,3592.0,3087.0,0.859,17.57,134,39,13,26,95,57,38,0,0.0,0.0
1004,1472,25-09-2019 12:42:00,1,3569.0,3180.0,0.891,17.581,43,23,5,18,20,1,19,0,0.0,0.0
1004,1473,25-09-2019 12:44:00,1,3580.0,3119.0,0.871,17.557,24,14,6,8,10,1,9,0,0.0,0.0
1004,1474,25-09-2019 12:46:00,1,3602.0,3063.0,0.85,17.584,0,0,0,0,0,0,0,0,0.0,0.0
1004,1475,25-09-2019 12:48:00,1,3395.0,2924.0,0.861,16.615,8,0,0,0,8,0,8,0,0.0,0.0
1004,1476,25-09-2019 12:50:00,1,3312.0,2788.0,0.842,16.137,1,0,0,0,1,0,1,0,0.0,0.01
1004,1477,25-09-2019 12:52:00,1,3235.0,2656.0,0.821,15.686,11,8,0,8,3,1,2,0,0.0,0.0
1004,1478,25-09-2019 12:54:00,1,2921.0,2527.0,0.865,14.307,7,1,0,1,6,2,4,0,0.0,0.0
1004,1479,25-09-2019 12:56:00,1,2953.0,2455.0,0.831,14.355,1,0,0,0,1,0,1,0,0.0,0.0
1004,1480,25-09-2019 12:58:00,1,2949.0,2401.0,0.814,14.276,7,0,0,0,7,1,6,0,0.0,0.0
1004,1481,25-09-2019 13:00:00,1,2966.0,2392.0,0.807,14.335,0,0,0,0,0,0,0,0,0.0,0.0
1004,1482,25-09-2019 13:02:00,1,2856.0,2335.5,0.8185,13.839,5,1,0,1,4,2,2,0,0.0,0.0
1004,1483,25-09-2019 13:04:00,1,2746.0,2279.0,0.83,13.343,8,3,2,1,5,4,1,0,0.0,0.0
1004,1484,25-09-2019 13:06:00,1,2774.0,2229.0,0.804,13.398,2,0,0,0,2,0,2,0,0.0,0.0
1004,1485,25-09-2019 13:08:00,1,2789.0,2178.0,0.781,13.402,0,0,0,0,0,0,0,0,0.0,0.0
1004,1486,25-09-2019 13:10:00,1,2566.0,2105.0,0.82,12.44,13,0,0,0,13,0,13,0,0.0,0.0
1004,1487,25-09-2019 13:12:00,1,2578.0,2052.0,0.796,12.429,0,0,0,0,0,0,0,0,0.0,0.0
1004,1488,25-09-2019 13:14:00,1,2612.0,1977.0,0.757,12.481,11,4,3,1,7,4,3,0,0.0,0.0
1004,1489,25-09-2019 13:16:00,1,2599.0,1994.0,0.767,12.449,0,0,0,0,0,0,0,0,0.0,0.0
1004,1490,25-09-2019 13:18:00,1,2617.0,1964.0,0.75,12.486,1,0,0,0,1,0,1,0,0.0,0.0
1004,1491,25-09-2019 13:20:00,1,2614.0,1959.0,0.749,12.468,0,0,0,0,0,0,0,0,0.0,0.01
1004,1492,25-09-2019 13:22:00,1,2612.0,1972.0,0.755,12.477,0,0,0,0,0,0,0,0,0.0,0.0
1004,1493,25-09-2019 13:24:00,1,2593.0,1970.0,0.76,12.397,44,26,21,5,18,9,9,0,0.0,0.0
1004,1494,25-09-2019 13:26:00,1,2691.0,2060.0,0.766,12.883,8,6,4,2,2,0,2,0,0.0,0.0
1004,1495,25-09-2019 13:28:00,1,2602.0,2029.0,0.78,12.497,2,2,1,1,0,0,0,0,0.0,0.0
1004,1496,25-09-2019 13:30:00,1,2591.0,2026.0,0.782,12.452,17,7,4,3,10,6,4,0,0.0,0.0
1004,1497,25-09-2019 13:32:00,1,2817.0,2095.0,0.744,13.419,12,2,0,2,10,0,10,0,0.0,0.0
1004,1498,25-09-2019 13:34:00,1,2694.0,2060.0,0.764,12.896,17,5,1,4,12,2,10,0,0.0,0.0
1004,1499,25-09-2019 13:36:00,1,2842.0,2155.5,0.7585,13.584,159,86,53,33,73,31,42,47,0.0,0.0
1004,1500,25-09-2019 13:38:00,1,2990.0,2251.0,0.753,14.272,81,39,8,31,42,2,40,37,0.0,0.0
1004,1501,25-09-2019 13:40:00,1,3283.0,2489.0,0.758,15.691,103,54,23,31,49,0,49,35,0.0,0.0
1004,1502,25-09-2019 13:42:00,1,3471.0,2686.0,0.774,16.651,88,54,18,36,34,0,34,40,0.0,0.0
1004,1503,25-09-2019 13:44:00,1,3441.0,2758.0,0.802,16.611,119,59,21,38,60,2,58,70,0.0,0.0
1004,1504,25-09-2019 13:46:00,1,3519.0,2840.0,0.807,17.011,133,87,48,39,46,13,33,66,0.0,0.06
1004,1505,25-09-2019 13:48:00,1,3611.0,3013.0,0.835,17.562,153,90,59,31,63,11,52,88,0.0,0.0
1004,1506,25-09-2019 13:50:00,1,3895.0,3188.0,0.818,18.876,338,207,168,39,131,95,36,14,0.1,0.08
1004,1507,25-09-2019 13:52:00,1,3409.0,2914.0,0.855,16.657,240,134,105,29,106,61,45,86,0.01,0.01
1004,1508,25-09-2019 13:54:00,1,3888.0,3263.0,0.839,18.931,587,374,298,76,213,156,57,11,0.0,0.0
1004,1509,25-09-2019 13:56:00,1,3408.0,2909.0,0.854,16.649,424,251,189,62,173,126,47,0,0.1,0.0
1004,1510,25-09-2019 13:58:00,1,3429.0,2825.0,0.824,16.639,59,31,14,17,28,3,25,0,0.0,0.0
1004,1511,25-09-2019 14:00:00,1,3479.0,2960.0,0.851,16.986,108,39,15,24,69,32,37,0,0.0,0.0
1004,1512,25-09-2019 14:02:00,1,3393.0,2934.0,0.865,16.616,32,13,0,13,19,3,16,0,0.0,0.0
1004,1513,25-09-2019 14:04:00,1,3396.0,2900.0,0.854,16.592,3,0,0,0,3,2,1,0,0.0,0.0
1004,1514,25-09-2019 14:06:00,1,3418.0,2831.0,0.828,16.602,5,2,1,1,3,1,2,0,0.0,0.0
1004,1515,25-09-2019 14:08:00,1,3208.0,2764.0,0.862,15.701,0,0,0,0,0,0,0,0,0.0,0.0
1004,1516,25-09-2019 14:10:00,1,3217.5,2734.0,0.85,15.7045,5,1,1,0,4,2,2,0,0.0,0.0
1004,1517,25-09-2019 14:12:00,1,3227.0,2704.0,0.838,15.708,0,0,0,0,0,0,0,0,0.0,0.0
1004,1518,25-09-2019 14:14:00,1,3190.0,2798.0,0.877,15.667,23,7,1,6,16,3,13,0,0.0,0.0
1004,1519,25-09-2019 14:16:00,1,3290.0,2856.0,0.868,16.124,3,0,0,0,3,1,2,0,0.0,0.0
1004,1520,25-09-2019 14:18:00,1,3204.0,2840.0,0.886,15.766,24,9,4,5,15,3,12,0,0.0,0.0
1004,1521,25-09-2019 14:20:00,1,3203.0,2765.0,0.863,15.679,0,0,0,0,0,0,0,0,0.01,0.0
1004,1522,25-09-2019 14:22:00,1,3205.0,2850.0,0.889,15.784,0,0,0,0,0,0,0,0,0.0,0.0
1004,1523,25-09-2019 14:24:00,1,3198.0,2798.0,0.875,15.697,1,0,0,0,1,0,1,0,0.0,0.0
1004,1524,25-09-2019 14:26:00,1,3212.0,2719.0,0.846,15.666,2,1,0,1,1,0,1,0,0.0,0.0
1004,1525,25-09-2019 14:28:00,1,2907.0,2588.0,0.89,14.32,3,3,0,3,0,0,0,0,0.0,0.0
1004,1526,25-09-2019 14:30:00,1,2938.0,2487.0,0.847,14.329,0,0,0,0,0,0,0,0,0.0,0.0
1004,1527,25-09-2019 14:32:00,1,2949.0,2418.0,0.82,14.296,11,0,0,0,11,1,10,0,0.0,0.0
1004,1528,25-09-2019 14:34:00,1,2740.0,2361.0,0.862,13.409,25,5,2,3,20,2,18,0,0.0,0.0
1004,1529,25-09-2019 14:36:00,1,2742.0,2304.0,0.84,13.354,0,0,0,0,0,0,0,0,0.0,0.0
1004,1530,25-09-2019 14:38:00,1,2748.0,2331.0,0.848,13.408,0,0,0,0,0,0,0,0,0.0,0.0
1004,1531,25-09-2019 14:40:00,1,2738.0,2295.0,0.838,13.327,1,0,0,0,1,1,0,0,0.0,0.0
1004,1532,25-09-2019 14:42:00,1,2747.0,2296.0,0.836,13.364,1,0,0,0,1,0,1,0,0.0,0.0
1004,1533,25-09-2019 14:44:00,1,2749.5,2289.5,0.833,13.3665,0,0,0,0,0,0,0,0,0.0,0.0
1004,1534,25-09-2019 14:46:00,1,2752.0,2283.0,0.83,13.369,4,0,0,0,4,2,2,0,0.0,0.0
1004,1535,25-09-2019 14:48:00,1,2750.0,2283.0,0.83,13.362,18,7,5,2,11,6,5,0,0.0,0.0
1004,1536,25-09-2019 14:50:00,1,2768.0,2263.0,0.818,13.41,77,28,6,22,49,14,35,0,0.0,0.0
1004,1537,25-09-2019 14:52:00,1,2948.0,2389.0,0.81,14.262,31,20,1,19,11,4,7,1,0.0,0.01
1004,1538,25-09-2019 14:54:00,1,3124.0,2619.0,0.838,15.206,51,22,5,17,29,5,24,1,0.0,0.0
1004,1539,25-09-2019 14:56:00,1,3113.0,2638.0,0.848,15.187,7,3,1,2,4,2,2,0,0.0,0.0
1004,1540,25-09-2019 14:58:00,1,3025.0,2592.0,0.857,14.788,116,45,22,23,71,41,30,14,0.0,0.0
1004,1541,25-09-2019 15:00:00,1,3226.0,2659.0,0.824,15.655,164,97,62,35,67,4,63,82,0.0,0.02
1004,1542,25-09-2019 15:02:00,1,3409.0,2928.0,0.859,16.672,121,68,39,29,53,6,47,63,0.0,0.01
1004,1543,25-09-2019 15:04:00,1,3385.0,2960.0,0.874,16.615,104,58,36,22,46,2,44,65,0.0,0.06
1004,1544,25-09-2019 15:06:00,1,3594.0,3090.0,0.86,17.583,95,47,29,18,48,2,46,58,0.0,0.09
1004,1545,25-09-2019 15:08:00,1,3559.0,3157.0,0.887,17.518,258,134,103,31,124,78,46,75,0.1,0.03
1004,1546,25-09-2019 15:10:00,1,3377.0,3057.0,0.905,16.688,49,21,11,10,28,9,19,2,0.0,0.0
1004,1547,25-09-2019 15:12:00,1,3305.0,2845.0,0.861,16.172,18,0,0,0,18,0,18,0,0.0,0.0
1004,1548,25-09-2019 15:14:00,1,3207.0,2802.0,0.874,15.736,21,12,1,11,9,0,9,0,0.01,0.01
1004,1549,25-09-2019 15:16:00,1,3198.0,2799.0,0.875,15.699,0,0,0,0,0,0,0,0,0.0,0.0
1004,1550,25-09-2019 15:18:00,1,3195.5,2805.0,0.8775,15.6965,0,0,0,0,0,0,0,0,0.0,0.0
1004,1551,25-09-2019 15:20:00,1,3193.0,2811.0,0.88,15.694,14,5,2,3,9,4,5,0,0.0,0.0
1004,1552,25-09-2019 15:22:00,1,3241.0,2693.0,0.831,15.75,0,0,0,0,0,0,0,0,0.0,0.0
1004,1553,25-09-2019 15:24:00,1,2991.0,2638.0,0.882,14.707,5,5,3,2,0,0,0,0,0.0,0.0
1004,1554,25-09-2019 15:26:00,1,3114.0,2668.0,0.857,15.221,0,0,0,0,0,0,0,0,0.0,0.0
1004,1555,25-09-2019 15:28:00,1,3115.0,2681.0,0.861,15.242,0,0,0,0,0,0,0,0,0.0,0.0
1004,1556,25-09-2019 15:30:00,1,3000.0,2671.0,0.89,14.777,4,0,0,0,4,1,3,0,0.0,0.0
1004,1557,25-09-2019 15:32:00,1,2999.0,2716.0,0.906,14.821,2,1,0,1,1,1,0,0,0.0,0.0
1004,1558,25-09-2019 15:34:00,1,2885.0,2700.0,0.936,14.358,0,0,0,0,0,0,0,0,0.01,0.01
1004,1559,25-09-2019 15:36:00,1,2886.0,2660.0,0.922,14.317,0,0,0,0,0,0,0,0,0.0,0.0
1004,1560,25-09-2019 15:38:00,1,2889.0,2625.0,0.909,14.289,15,10,5,5,5,3,2,0,0.0,0.0
1004,1561,25-09-2019 15:40:00,1,3081.0,2780.0,0.902,15.219,0,0,0,0,0,0,0,0,0.0,0.0
1004,1562,25-09-2019 15:42:00,1,3180.0,2852.0,0.897,15.689,1,1,0,1,0,0,0,0,0.0,0.0
1004,1563,25-09-2019 15:44:00,1,3211.0,2794.0,0.87,15.746,3,3,0,3,0,0,0,0,0.0,0.0
1004,1564,25-09-2019 15:46:00,1,3215.0,2797.0,0.87,15.764,0,0,0,0,0,0,0,0,0.0,0.0
1004,1565,25-09-2019 15:48:00,1,3205.0,2769.0,0.864,15.691,4,4,0,4,0,0,0,0,0.0,0.0
1004,1566,25-09-2019 15:50:00,1,2998.0,2714.0,0.906,14.816,0,0,0,0,0,0,0,0,0.0,0.0
1004,1567,25-09-2019 15:52:00,1,2959.0,2621.5,0.886,14.56,0,0,0,0,0,0,0,0,0.0,0.0
1004,1568,25-09-2019 15:54:00,1,2920.0,2529.0,0.866,14.304,104,58,35,23,46,26,20,1,0.0,0.0
1004,1569,25-09-2019 15:56:00,1,2920.0,2548.0,0.873,14.327,131,70,42,28,61,29,32,47,0.0,0.0
1004,1570,25-09-2019 15:58:00,1,3223.0,2759.0,0.856,15.752,150,73,43,30,77,36,41,59,0.05,0.02
1004,1571,25-09-2019 16:00:00,1,2906.0,2600.0,0.895,14.328,55,17,10,7,38,17,21,0,0.0,0.01
1004,1572,25-09-2019 16:02:00,1,2825.0,2490.0,0.881,13.889,147,76,45,31,71,27,44,0,0.0,0.0
1004,1573,25-09-2019 16:04:00,1,3204.0,2771.0,0.865,15.69,44,19,2,17,25,3,22,0,0.0,0.0
1004,1574,25-09-2019 16:06:00,1,3198.0,2840.0,0.888,15.746,25,17,2,15,8,2,6,0,0.0,0.0
1004,1575,25-09-2019 16:08:00,1,3263.0,2962.0,0.908,16.135,12,11,4,7,1,0,1,0,0.0,0.0
1004,1576,25-09-2019 16:10:00,1,3166.0,2913.0,0.92,15.7,0,0,0,0,0,0,0,0,0.0,0.0
1004,1577,25-09-2019 16:12:00,1,3187.0,2914.0,0.914,15.783,3,2,0,2,1,0,1,0,0.01,0.0
1004,1578,25-09-2019 16:14:00,1,3171.0,2867.0,0.904,15.668,3,1,0,1,2,0,2,0,0.01,0.01
1004,1579,25-09-2019 16:16:00,1,3201.0,2842.0,0.888,15.76,1,0,0,0,1,0,1,0,0.0,0.0
1004,1580,25-09-2019 16:18:00,1,3084.0,2796.0,0.907,15.245,2,1,0,1,1,0,1,0,0.0,0.0
1004,1581,25-09-2019 16:20:00,1,3191.0,2813.0,0.881,15.686,3,2,1,1,1,0,1,0,0.0,0.0
1004,1582,25-09-2019 16:22:00,1,2975.0,2748.0,0.924,14.762,7,1,0,1,6,4,2,0,0.0,0.01
1004,1583,25-09-2019 16:24:00,1,2978.0,2740.0,0.92,14.767,0,0,0,0,0,0,0,0,0.0,0.0
1004,1584,25-09-2019 16:26:00,1,2926.0,2723.0,0.931,14.5435,7,0,0,0,7,0,7,0,0.0,0.0
1004,1585,25-09-2019 16:28:00,1,2874.0,2706.0,0.942,14.32,1,0,0,0,1,0,1,0,0.0,0.0
1004,1586,25-09-2019 16:30:00,1,2976.0,2735.0,0.919,14.754,0,0,0,0,0,0,0,0,0.0,0.0
1004,1587,25-09-2019 16:32:00,1,2885.0,2650.0,0.919,14.3,26,7,3,4,19,10,9,0,0.0,0.0
1004,1588,25-09-2019 16:34:00,1,2895.0,2613.0,0.903,14.3,0,0,0,0,0,0,0,0,0.0,0.0
1004,1589,25-09-2019 16:36:00,1,2911.0,2540.0,0.873,14.282,6,4,1,3,2,1,1,0,0.0,0.0
1004,1590,25-09-2019 16:38:00,1,2935.0,2509.0,0.855,14.341,17,5,0,5,12,4,8,0,0.0,0.0
1004,1591,25-09-2019 16:40:00,1,2833.0,2461.0,0.869,13.885,5,0,0,0,5,5,0,0,0.0,0.0
1004,1592,25-09-2019 16:42:00,1,2716.0,2442.0,0.899,13.403,3,0,0,0,3,1,2,0,0.0,0.0
1004,1593,25-09-2019 16:44:00,1,2704.0,2443.0,0.903,13.358,2,0,0,0,2,2,0,0,0.0,0.0
1004,1594,25-09-2019 16:46:00,1,2737.0,2375.0,0.868,13.415,3,0,0,0,3,0,3,0,0.0,0.0
1004,1595,25-09-2019 16:48:00,1,2632.0,2299.0,0.874,12.916,1,0,0,0,1,0,1,0,0.0,0.0
1004,1596,25-09-2019 16:50:00,1,2533.0,2257.0,0.891,12.481,31,15,4,11,16,8,8,0,0.0,0.0
1004,1597,25-09-2019 16:52:00,1,2734.0,2382.0,0.871,13.409,89,53,19,34,36,3,33,0,0.0,0.0
1004,1598,25-09-2019 16:54:00,1,2906.0,2574.0,0.886,14.299,108,57,28,29,51,22,29,0,0.0,0.0
1004,1599,25-09-2019 16:56:00,1,2891.0,2653.0,0.918,14.328,117,68,34,34,49,15,34,0,0.0,0.0
1004,1600,25-09-2019 16:58:00,1,3100.0,2718.0,0.877,15.224,152,82,42,40,70,35,35,48,0.0,0.0
1004,1601,25-09-2019 17:00:00,1,3242.0,2831.0,0.8735,15.909,99,56,31,25,43,2,41,63,0.0,0.06
1004,1602,25-09-2019 17:02:00,1,3384.0,2944.0,0.87,16.594,111,65,35,30,46,2,44,69,0.0,0.05
1004,1603,25-09-2019 17:04:00,1,3355.0,3069.0,0.915,16.616,113,60,33,27,53,31,22,33,0.09,0.06
1004,1604,25-09-2019 17:06:00,1,3201.0,2783.0,0.87,15.693,18,9,2,7,9,0,9,0,0.0,0.0
1004,1605,25-09-2019 17:08:00,1,3220.0,2697.0,0.837,15.673,1,0,0,0,1,0,1,0,0.0,0.0
1004,1606,25-09-2019 17:10:00,1,3014.0,2627.0,0.872,14.782,8,7,3,4,1,0,1,0,0.0,0.0
1004,1607,25-09-2019 17:12:00,1,3118.0,2656.0,0.852,15.227,7,6,2,4,1,1,0,0,0.0,0.0
1004,1608,25-09-2019 17:14:00,1,3109.0,2714.0,0.873,15.253,23,16,8,8,7,1,6,0,0.0,0.0
1004,1609,25-09-2019 17:16:00,1,3097.0,2709.0,0.875,15.202,7,1,0,1,6,1,5,0,0.0,0.0
1004,1610,25-09-2019 17:18:00,1,3120.0,2709.0,0.868,15.293,3,1,1,0,2,1,1,0,0.0,0.0
1004,1611,25-09-2019 17:20:00,1,3095.0,2717.0,0.878,15.204,1,0,0,0,1,0,1,0,0.0,0.0
1004,1612,25-09-2019 17:22:00,1,2987.0,2706.0,0.906,14.764,3,0,0,0,3,0,3,0,0.01,0.01
1004,1613,25-09-2019 17:24:00,1,2902.0,2646.0,0.912,14.364,11,2,1,1,9,3,6,0,0.0,0.0
1004,1614,25-09-2019 17:26:00,1,2887.0,2628.0,0.91,14.283,16,5,2,3,11,5,6,0,0.0,0.0
1004,1615,25-09-2019 17:28:00,1,2873.0,2692.0,0.937,14.302,0,0,0,0,0,0,0,0,0.0,0.0
1004,1616,25-09-2019 17:30:00,1,2876.0,2707.0,0.941,14.327,7,2,1,1,5,4,1,0,0.0,0.0
1004,1617,25-09-2019 17:32:00,1,2969.0,2758.0,0.929,14.75,0,0,0,0,0,0,0,0,0.0,0.0
1004,1618,25-09-2019 17:34:00,1,3066.0,2835.5,0.925,15.218,0,0,0,0,0,0,0,0,0.0,0.0
1004,1619,25-09-2019 17:36:00,1,3163.0,2913.0,0.921,15.686,1,0,0,0,1,0,1,0,0.0,0.0
1004,1620,25-09-2019 17:38:00,1,3093.0,2788.0,0.901,15.275,2,0,0,0,2,1,1,0,0.0,0.0
1004,1621,25-09-2019 17:40:00,1,3089.0,2790.0,0.903,15.259,3,2,1,1,1,0,1,0,0.0,0.0
1004,1622,25-09-2019 17:42:00,1,2980.0,2736.0,0.918,14.769,1,1,0,1,0,0,0,0,0.0,0.0
1004,1623,25-09-2019 17:44:00,1,2893.0,2661.0,0.92,14.344,43,19,12,7,24,16,8,0,0.0,0.0
1004,1624,25-09-2019 17:46:00,1,3187.0,2837.0,0.89,15.696,61,22,8,14,39,4,35,0,0.0,0.0
1004,1625,25-09-2019 17:48:00,1,3354.0,3101.0,0.925,16.648,117,54,21,33,63,41,22,0,0.0,0.0
1004,1626,25-09-2019 17:50:00,1,3340.0,3143.0,0.941,16.637,120,29,14,15,91,43,48,0,0.0,0.0
1004,1627,25-09-2019 17:52:00,1,3526.0,3306.0,0.938,17.552,130,70,28,42,60,28,32,0,0.0,0.0
1004,1628,25-09-2019 17:54:00,1,3523.0,3323.0,0.943,17.559,57,23,10,13,34,15,19,1,0.0,0.0
1004,1629,25-09-2019 17:56:00,1,3618.0,3430.0,0.948,18.052,157,85,48,37,72,28,44,48,0.0,0.0
1004,1630,25-09-2019 17:58:00,1,3820.0,3485.0,0.912,18.909,143,90,51,39,53,4,49,60,0.0,0.02
1004,1631,25-09-2019 18:00:00,0,4032.0,3596.0,0.892,19.868,129,81,51,30,48,0,48,61,0.0,0.13
1004,1632,25-09-2019 18:02:00,0,4005.0,3633.0,0.907,19.803,448,262,208,54,186,137,49,102,0.01,0.01
1004,1633,25-09-2019 18:04:00,0,3813.0,3519.0,0.923,18.918,305,157,127,30,148,113,35,133,0.0,0.0
1004,1634,25-09-2019 18:06:00,0,4024.0,3587.0,0.891,19.827,440,241,202,39,199,153,46,114,0.04,0.02
1004,1635,25-09-2019 18:08:00,0,4012.5,3661.5,0.9125,19.8625,171,97,54,43,74,46,28,22,0.0,0.0
1004,1636,25-09-2019 18:10:00,0,4001.0,3736.0,0.934,19.898,142,96,62,34,46,12,34,67,0.0,0.01
1004,1637,25-09-2019 18:12:00,0,4490.0,4092.0,0.911,22.222,80,64,40,24,16,3,13,34,0.0,0.13
1004,1638,25-09-2019 18:14:00,0,4475.0,4097.0,0.915,22.168,76,42,16,26,34,12,22,21,0.02,0.1
1004,1639,25-09-2019 18:16:00,0,4456.0,4151.0,0.932,22.152,169,86,43,43,83,50,33,1,0.08,0.0
1004,1640,25-09-2019 18:18:00,0,3816.0,3438.0,0.901,18.841,79,56,18,38,23,4,19,0,0.0,0.0
1004,1641,25-09-2019 18:20:00,0,4039.0,3571.0,0.884,19.869,52,43,10,33,9,0,9,0,0.0,0.0
1004,1642,25-09-2019 18:22:00,0,3996.0,3752.0,0.939,19.899,22,3,1,2,19,8,11,0,0.0,0.0
1004,1643,25-09-2019 18:24:00,0,4029.0,3643.0,0.904,19.908,9,0,0,0,9,6,3,0,0.0,0.0
1004,1644,25-09-2019 18:26:00,0,4023.0,3583.0,0.89,19.819,114,61,43,18,53,35,18,5,0.18,0.0
1004,1645,25-09-2019 18:28:00,0,4358.0,4058.0,0.931,21.664,43,29,15,14,14,4,10,21,0.0,0.29
1004,1646,25-09-2019 18:30:00,0,4357.0,4104.0,0.942,21.71,7,7,0,7,0,0,0,0,0.0,0.0
1004,1647,25-09-2019 18:32:00,0,4282.0,3968.0,0.927,21.264,359,208,175,33,151,114,37,123,0.11,0.03
1004,1648,25-09-2019 18:34:00,0,4249.0,4040.0,0.951,21.213,141,72,44,28,69,37,32,4,0.04,0.0
1004,1649,25-09-2019 18:36:00,0,4275.0,4034.0,0.944,21.31,81,35,16,19,46,14,32,0,0.01,0.0
1004,1650,25-09-2019 18:38:00,0,4265.0,4042.0,0.948,21.277,84,57,29,28,27,5,22,0,0.0,0.0
1004,1651,25-09-2019 18:40:00,0,4245.0,4035.0,0.95,21.193,57,2,1,1,55,46,9,0,0.0,0.0
1004,1652,25-09-2019 18:42:00,0,4291.5,4074.0,0.949,21.4195,8,8,0,8,0,0,0,0,0.01,0.0
1004,1653,25-09-2019 18:44:00,0,4338.0,4113.0,0.948,21.646,21,21,2,19,0,0,0,0,0.0,0.0
1004,1654,25-09-2019 18:46:00,0,3965.0,3847.0,0.97,19.882,6,5,1,4,1,1,0,0,0.0,0.0
1004,1655,25-09-2019 18:48:00,0,3999.0,3683.0,0.921,19.835,0,0,0,0,0,0,0,0,0.0,0.0
1004,1656,25-09-2019 18:50:00,0,3808.0,3562.0,0.935,18.947,99,63,42,21,36,24,12,1,0.0,0.0
1004,1657,25-09-2019 18:52:00,0,4014.0,3665.0,0.913,19.871,76,73,54,19,3,0,3,0,0.0,0.0
1004,1658,25-09-2019 18:54:00,0,3786.0,3649.0,0.964,18.956,82,48,24,24,34,21,13,0,0.0,0.0
1004,1659,25-09-2019 18:56:00,0,4171.0,3988.0,0.956,20.848,153,73,34,39,80,46,34,13,0.07,0.0
1004,1660,25-09-2019 18:58:00,0,4180.0,3963.0,0.948,20.857,190,101,73,28,89,67,22,16,0.05,0.0
1004,1661,25-09-2019 19:00:00,0,3868.0,3661.0,0.947,19.291,57,19,6,13,38,21,17,0,0.0,0.0
1004,1662,25-09-2019 19:02:00,0,4002.0,3695.0,0.923,19.858,274,128,97,31,146,110,36,117,0.0,0.01
1004,1663,25-09-2019 19:04:00,0,4254.0,4029.0,0.947,21.221,193,106,74,32,87,62,25,95,0.14,0.0
1004,1664,25-09-2019 19:06:00,0,4230.0,4147.0,0.98,21.258,211,133,86,47,78,36,42,28,0.0,0.0
1004,1665,25-09-2019 19:08:00,0,4072.0,3953.0,0.971,20.419,145,71,42,29,74,45,29,21,0.0,0.0
1004,1666,25-09-2019 19:10:00,0,4433.0,4199.0,0.947,22.115,116,76,50,26,40,22,18,17,0.01,0.0
1004,1667,25-09-2019 19:12:00,0,3331.0,3186.0,0.956,16.653,233,133,104,29,100,65,35,19,0.0,0.0
1004,1668,25-09-2019 19:14:00,0,4273.0,4019.0,0.941,21.285,131,88,49,39,43,2,41,69,0.0,0.02
1004,1669,25-09-2019 19:16:00,0,4441.0,4238.0,0.954,22.189,146,95,45,50,51,7,44,70,0.0,0.01
1004,1670,25-09-2019 19:18:00,0,4609.0,4457.0,0.967,23.093,144,99,61,38,45,6,39,76,0.0,0.06
1004,1671,25-09-2019 19:20:00,0,4819.0,4594.0,0.953,24.074,218,119,82,37,99,56,43,60,0.0,0.04
1004,1672,25-09-2019 19:22:00,0,4270.0,4065.0,0.952,21.322,332,188,153,35,144,116,28,248,0.0,0.0
1004,1673,25-09-2019 19:24:00,0,4446.0,4263.0,0.959,22.235,288,173,126,47,115,85,30,134,0.07,0.02
1004,1674,25-09-2019 19:26:00,0,4592.0,4516.0,0.984,23.092,356,215,170,45,141,104,37,73,0.11,0.0
1004,1675,25-09-2019 19:28:00,0,4634.0,4405.0,0.951,23.133,374,213,150,63,161,105,56,2,0.0,0.0
1004,1676,25-09-2019 19:30:00,0,4450.0,4201.0,0.944,22.184,356,191,144,47,165,117,48,1,0.0,0.0
1004,1677,25-09-2019 19:32:00,0,4241.0,4078.0,0.962,21.225,398,240,179,61,158,103,55,49,0.0,0.0
1004,1678,25-09-2019 19:34:00,0,4932.0,4633.0,0.939,24.563,111,78,43,35,33,2,31,75,0.0,0.0
1004,1679,25-09-2019 19:36:00,0,4804.0,4612.0,0.96,24.035,85,59,32,27,26,2,24,51,0.0,0.09
1004,1680,25-09-2019 19:38:00,0,4817.0,4602.0,0.955,24.074,122,80,49,31,42,2,40,75,0.0,0.07
1004,1681,25-09-2019 19:40:00,0,4908.0,4671.0,0.952,24.508,123,57,31,26,66,36,30,21,0.0,0.17
1004,1682,25-09-2019 19:42:00,0,4523.0,4352.0,0.962,22.64,102,63,29,34,39,15,24,0,0.0,0.0
1004,1683,25-09-2019 19:44:00,0,4793.0,4568.0,0.953,23.943,39,38,0,38,1,0,1,0,0.0,0.0
1004,1684,25-09-2019 19:46:00,0,4795.0,4609.0,0.961,23.995,113,69,30,39,44,22,22,0,0.0,0.0
1004,1685,25-09-2019 19:48:00,0,4890.0,4699.0,0.961,24.468,196,9,4,5,187,142,45,0,0.0,0.0
1004,1686,25-09-2019 19:50:00,0,4668.0,4459.5,0.955,23.3285,3,0,0,0,3,0,3,0,0.0,0.0
1004,1687,25-09-2019 19:52:00,0,4446.0,4220.0,0.949,22.189,14,6,1,5,8,4,4,0,0.0,0.0
1004,1688,25-09-2019 19:54:00,0,4341.0,4175.0,0.962,21.724,126,126,105,21,0,0,0,0,0.0,0.0
1004,1689,25-09-2019 19:56:00,0,4240.0,4154.0,0.98,21.304,4,4,1,3,0,0,0,0,0.0,0.0
1004,1690,25-09-2019 19:58:00,0,4164.0,4004.0,0.962,20.836,12,12,2,10,0,0,0,0,0.0,0.0
1004,1691,25-09-2019 20:00:00,0,3974.0,3827.0,0.963,19.893,29,22,1,21,7,1,6,0,0.0,0.0
1004,1692,25-09-2019 20:02:00,0,3785.0,3700.0,0.978,19.008,17,14,2,12,3,0,3,0,0.0,0.0
1004,1693,25-09-2019 20:04:00,0,3793.0,3607.0,0.951,18.936,16,9,3,6,7,3,4,0,0.0,0.0
1004,1694,25-09-2019 20:06:00,0,3595.0,3491.0,0.971,18.029,19,5,3,2,14,2,12,0,0.0,0.0
1004,1695,25-09-2019 20:08:00,0,3491.0,3436.0,0.984,17.559,8,6,1,5,2,0,2,0,0.0,0.0
1004,1696,25-09-2019 20:10:00,0,3509.0,3288.0,0.937,17.466,37,18,11,7,19,9,10,1,0.0,0.0
1004,1697,25-09-2019 20:12:00,0,3306.0,3281.0,0.992,16.658,65,29,19,10,36,25,11,1,0.0,0.0
1004,1698,25-09-2019 20:14:00,0,3409.0,3293.0,0.966,17.079,12,9,4,5,3,0,3,0,0.0,0.0
1004,1699,25-09-2019 20:16:00,0,3332.0,3207.0,0.963,16.678,122,54,30,24,68,26,42,0,0.0,0.0
1004,1700,25-09-2019 20:18:00,0,3489.0,3436.0,0.985,17.55,135,55,33,22,80,46,34,86,0.0,0.0
1004,1701,25-09-2019 20:20:00,0,3591.0,3512.0,0.978,18.035,256,121,88,33,135,98,37,100,0.05,0.0
1004,1702,25-09-2019 20:22:00,0,3801.0,3614.0,0.951,18.976,113,66,31,35,47,5,42,80,0.0,0.0
1004,1703,25-09-2019 20:24:00,0,3893.5,3679.5,0.9455,19.4125,131,54,30,24,77,34,43,31,0.08,0.0
1004,1704,25-09-2019 20:26:00,0,3986.0,3745.0,0.94,19.849,226,143,98,45,83,33,50,54,0.0,0.0
1004,1705,25-09-2019 20:28:00,0,3945.0,3919.0,0.993,19.882,126,67,42,25,59,22,37,53,0.06,0.01
1004,1706,25-09-2019 20:30:00,0,4238.0,4076.0,0.962,21.209,348,191,151,40,157,109,48,61,0.02,0.01
1004,1707,25-09-2019 20:32:00,0,4228.0,4120.0,0.975,21.218,242,124,88,36,118,89,29,28,0.01,0.0
1004,1708,25-09-2019 20:34:00,0,4248.0,4132.0,0.973,21.314,61,32,5,27,29,3,26,0,0.0,0.0
1004,1709,25-09-2019 20:36:00,0,4282.0,4030.0,0.941,21.332,53,34,10,24,19,4,15,0,0.0,0.0
1004,1710,25-09-2019 20:38:00,0,3965.0,3883.0,0.979,19.92,4,0,0,0,4,0,4,0,0.0,0.0
1004,1711,25-09-2019 20:40:00,0,3897.0,3699.0,0.949,19.451,4,1,0,1,3,0,3,0,0.0,0.0
1004,1712,25-09-2019 20:42:00,0,3797.0,3562.0,0.938,18.903,27,0,0,0,27,0,27,0,0.0,0.0
1004,1713,25-09-2019 20:44:00,0,3613.0,3451.0,0.955,18.054,10,0,0,0,10,0,10,0,0.0,0.0
1004,1714,25-09-2019 20:46:00,0,3524.0,3323.0,0.943,17.563,0,0,0,0,0,0,0,0,0.0,0.0
1004,1715,25-09-2019 20:48:00,0,3331.0,3198.0,0.96,16.664,0,0,0,0,0,0,0,0,0.0,0.0
1004,1716,25-09-2019 20:50:00,0,3353.0,3095.0,0.923,16.639,0,0,0,0,0,0,0,0,0.0,0.0
1004,1717,25-09-2019 20:52:00,0,3245.0,3065.0,0.945,16.177,0,0,0,0,0,0,0,0,0.0,0.0
1004,1718,25-09-2019 20:54:00,0,3246.0,3057.0,0.942,16.172,13,13,1,12,0,0,0,0,0.01,0.01
1004,1719,25-09-2019 20:56:00,0,3135.0,3055.0,0.975,15.733,58,36,20,16,22,14,8,0,0.0,0.0
1004,1720,25-09-2019 20:58:00,0,3230.5,3115.5,0.965,16.1765,1,1,0,1,0,0,0,0,0.0,0.0
1004,1721,25-09-2019 21:00:00,0,3326.0,3176.0,0.955,16.62,11,8,4,4,3,1,2,0,0.0,0.0
1004,1722,25-09-2019 21:02:00,0,3333.0,3207.0,0.962,16.681,50,23,18,5,27,18,9,3,0.0,0.0
1004,1723,25-09-2019 21:04:00,0,3320.0,3188.0,0.96,16.612,108,66,23,43,42,20,22,9,0.0,0.0
1004,1724,25-09-2019 21:06:00,0,3300.0,3317.0,1.005,16.673,107,43,24,19,64,26,38,22,0.01,0.0
1004,1725,25-09-2019 21:08:00,0,3451.0,3520.0,1.02,17.495,161,98,64,34,63,24,39,70,0.0,0.0
1004,1726,25-09-2019 21:10:00,0,3468.0,3535.0,1.019,17.577,110,61,17,44,49,11,38,1,0.0,0.0
1004,1727,25-09-2019 21:12:00,0,3684.0,3548.0,0.963,18.444,137,83,50,33,54,18,36,59,0.0,0.0
1004,1728,25-09-2019 21:14:00,0,3765.0,3719.0,0.988,18.949,131,83,54,29,48,0,48,78,0.0,0.07
1004,1729,25-09-2019 21:16:00,0,3985.0,3773.0,0.947,19.878,271,136,101,35,135,82,53,72,0.05,0.06
1004,1730,25-09-2019 21:18:00,0,3939.0,3953.0,1.003,19.897,179,78,49,29,101,64,37,14,0.01,0.0
1004,1731,25-09-2019 21:20:00,0,3511.0,3379.0,0.963,17.573,340,197,151,46,143,109,34,73,0.0,0.03
1004,1732,25-09-2019 21:22:00,0,3955.0,3877.0,0.98,19.873,49,22,8,14,27,5,22,0,0.0,0.0
1004,1733,25-09-2019 21:24:00,0,4254.0,4056.0,0.954,21.251,53,21,4,17,32,7,25,0,0.0,0.0
1004,1734,25-09-2019 21:26:00,0,4041.0,3976.0,0.984,20.322,68,33,6,27,35,5,30,0,0.0,0.0
1004,1735,25-09-2019 21:28:00,0,4148.0,3979.0,0.959,20.747,22,4,3,1,18,3,15,0,0.0,0.0
1004,1736,25-09-2019 21:30:00,0,4244.0,4048.0,0.954,21.203,3,0,0,0,3,2,1,0,0.0,0.0
1004,1737,25-09-2019 21:32:00,0,4016.5,3860.5,0.9615,20.0995,0,0,0,0,0,0,0,0,0.0,0.0
1004,1738,25-09-2019 21:34:00,0,3789.0,3673.0,0.969,18.996,0,0,0,0,0,0,0,0,0.0,0.0
1004,1739,25-09-2019 21:36:00,0,3693.0,3544.0,0.96,18.476,0,0,0,0,0,0,0,0,0.0,0.0
1004,1740,25-09-2019 21:38:00,0,3513.0,3419.0,0.973,17.624,1,0,0,0,1,0,1,0,0.0,0.0
1004,1741,25-09-2019 21:40:00,0,3520.0,3375.0,0.959,17.604,10,10,0,10,0,0,0,0,0.0,0.0
1004,1742,25-09-2019 21:42:00,0,3323.0,3188.0,0.96,16.622,85,59,27,32,26,11,15,0,0.0,0.0
1004,1743,25-09-2019 21:44:00,0,3528.0,3296.0,0.934,17.55,108,65,29,36,43,22,21,0,0.0,0.0
1004,1744,25-09-2019 21:46:00,0,3520.0,3310.0,0.94,17.533,111,74,38,36,37,9,28,65,0.01,0.0
1004,1745,25-09-2019 21:48:00,0,3821.0,3562.0,0.932,18.997,92,53,29,24,39,0,39,61,0.0,0.03
1004,1746,25-09-2019 21:50:00,0,3791.0,3604.0,0.951,18.924,86,53,29,24,33,0,33,47,0.0,0.1
1004,1747,25-09-2019 21:52:00,0,3799.0,3651.0,0.961,19.009,51,31,18,13,20,1,19,22,0.0,0.1
1004,1748,25-09-2019 21:54:00,0,3710.0,3497.0,0.943,18.488,166,109,84,25,57,41,16,36,0.09,0.05
1004,1749,25-09-2019 21:56:00,0,3872.0,3736.0,0.965,19.393,112,67,43,24,45,25,20,0,0.01,0.0
1004,1750,25-09-2019 21:58:00,0,4140.0,4013.0,0.969,20.752,270,170,128,42,100,69,31,4,0.03,0.0
1004,1751,25-09-2019 22:00:00,0,3786.0,3616.0,0.955,18.921,207,122,91,31,85,51,34,3,0.0,0.06
1004,1752,25-09-2019 22:02:00,0,3972.0,3850.0,0.969,19.914,277,144,106,38,133,97,36,30,0.04,0.0
1004,1753,25-09-2019 22:04:00,0,3953.0,3809.0,0.964,19.792,11,9,3,6,2,1,1,0,0.01,0.0
1004,1754,25-09-2019 22:06:00,0,3873.0,3702.0,0.956,19.358,7,7,2,5,0,0,0,0,0.0,0.0
1004,1755,25-09-2019 22:08:00,0,3793.0,3595.0,0.948,18.924,0,0,0,0,0,0,0,0,0.0,0.0
1004,1756,25-09-2019 22:10:00,0,3814.0,3586.0,0.94,18.999,9,8,2,6,1,1,0,0,0.0,0.0
1004,1757,25-09-2019 22:12:00,0,3584.0,3481.0,0.971,17.973,17,11,5,6,6,3,3,0,0.0,0.0
1004,1758,25-09-2019 22:14:00,0,3481.0,3434.0,0.986,17.518,0,0,0,0,0,0,0,0,0.0,0.0
1004,1759,25-09-2019 22:16:00,0,3414.0,3265.0,0.956,17.067,0,0,0,0,0,0,0,0,0.0,0.0
1004,1760,25-09-2019 22:18:00,0,3339.0,3198.0,0.958,16.697,3,3,1,2,0,0,0,0,0.01,0.0
1004,1761,25-09-2019 22:20:00,0,3321.0,3132.0,0.943,16.553,0,0,0,0,0,0,0,0,0.0,0.0
1004,1762,25-09-2019 22:22:00,0,3357.0,3128.0,0.932,16.692,22,11,6,5,11,8,3,0,0.0,0.0
1004,1763,25-09-2019 22:24:00,0,3331.0,3197.0,0.96,16.665,11,0,0,0,11,2,9,0,0.0,0.0
1004,1764,25-09-2019 22:26:00,0,3343.0,3141.0,0.939,16.65,13,6,3,3,7,3,4,0,0.0,0.0
1004,1765,25-09-2019 22:28:00,0,3328.0,3199.0,0.961,16.654,1,1,1,0,0,0,0,0,0.0,0.0
1004,1766,25-09-2019 22:30:00,0,3340.0,3122.0,0.935,16.616,0,0,0,0,0,0,0,0,0.0,0.0
1004,1767,25-09-2019 22:32:00,0,3138.0,3013.0,0.96,15.7,6,6,0,6,0,0,0,0,0.0,0.0
1004,1768,25-09-2019 22:34:00,0,3140.0,3017.0,0.961,15.709,25,13,13,0,12,5,7,0,0.0,0.0
1004,1769,25-09-2019 22:36:00,0,3343.0,3132.0,0.937,16.64,3,1,1,0,2,1,1,0,0.0,0.0
1004,1770,25-09-2019 22:38:00,0,3333.0,3153.0,0.946,16.623,49,27,13,14,22,15,7,0,0.01,0.0
1004,1771,25-09-2019 22:40:00,0,3321.0,3211.5,0.967,16.641,14,12,1,11,2,0,2,0,0.0,0.0
1004,1772,25-09-2019 22:42:00,0,3309.0,3270.0,0.988,16.659,154,7,0,7,147,129,18,0,0.0,0.0
1004,1773,25-09-2019 22:44:00,0,3310.0,3299.0,0.997,16.695,23,4,2,2,19,7,12,0,0.0,0.0
1004,1774,25-09-2019 22:46:00,0,3341.0,3175.0,0.95,16.677,28,24,17,7,4,0,4,0,0.0,0.0
1004,1775,25-09-2019 22:48:00,0,3135.0,3034.0,0.968,15.711,23,18,3,15,5,1,4,0,0.0,0.0
1004,1776,25-09-2019 22:50:00,0,3150.0,2958.0,0.939,15.686,3,1,1,0,2,1,1,0,0.0,0.0
1004,1777,25-09-2019 22:52:00,0,2972.0,2842.0,0.956,14.857,3,0,0,0,3,1,2,0,0.0,0.0
1004,1778,25-09-2019 22:54:00,0,2835.0,2862.0,1.01,14.339,10,0,0,0,10,1,9,0,0.0,0.0
1004,1779,25-09-2019 22:56:00,0,2847.0,2803.0,0.985,14.318,5,3,2,1,2,0,2,0,0.0,0.0
1004,1780,25-09-2019 22:58:00,0,2865.0,2769.0,0.967,14.355,59,35,22,13,24,18,6,33,0.0,0.0
1004,1781,25-09-2019 23:00:00,0,3109.0,3104.0,0.998,15.686,52,43,24,19,9,3,6,45,0.0,0.0
1004,1782,25-09-2019 23:02:00,0,3325.0,3236.0,0.973,16.684,35,32,19,13,3,2,1,36,0.0,0.09
1004,1783,25-09-2019 23:04:00,0,3285.0,3340.0,1.017,16.64,54,35,9,26,19,0,19,8,0.0,0.27
1004,1784,25-09-2019 23:06:00,0,3320.0,3204.0,0.965,16.627,99,45,22,23,54,20,34,2,0.05,0.0
1004,1785,25-09-2019 23:08:00,0,3298.0,3307.0,1.003,16.654,88,32,7,25,56,18,38,0,0.0,0.0
1004,1786,25-09-2019 23:10:00,0,3687.0,3560.0,0.966,18.467,151,72,35,37,79,45,34,1,0.0,0.0
1004,1787,25-09-2019 23:12:00,0,3467.0,3488.0,1.006,17.522,117,58,28,30,59,27,32,0,0.01,0.0
1004,1788,25-09-2019 23:14:00,0,3841.5,3852.0,1.003,19.4005,351,194,162,32,157,115,42,210,0.0,0.0
1004,1789,25-09-2019 23:16:00,0,4216.0,4216.0,1.0,21.279,338,169,135,34,169,124,45,161,0.07,0.0
1004,1790,25-09-2019 23:18:00,0,4212.0,4245.0,1.008,21.294,326,184,143,41,142,114,28,217,0.19,0.0
1004,1791,25-09-2019 23:20:00,0,4388.0,4435.0,1.011,22.2,58,28,24,4,30,23,7,7,0.0,0.0
1004,1792,25-09-2019 23:22:00,0,4610.0,4519.0,0.98,23.165,212,95,66,29,117,83,34,51,0.0,0.0
1004,1793,25-09-2019 23:24:00,0,4428.0,4311.0,0.974,22.22,359,175,136,39,184,139,45,128,0.1,0.04
1004,1794,25-09-2019 23:26:00,0,4799.0,4672.0,0.974,24.079,484,242,178,64,242,185,57,8,0.0,0.02
1004,1795,25-09-2019 23:28:00,0,4444.0,4265.0,0.96,22.23,414,247,198,49,167,126,41,119,0.0,0.0
1004,1796,25-09-2019 23:30:00,0,4387.0,4394.0,1.002,22.15,282,146,92,54,136,89,47,4,0.14,0.0
1004,1797,25-09-2019 23:32:00,0,4420.0,4279.0,0.968,22.151,45,25,10,15,20,12,8,0,0.0,0.0
1004,1798,25-09-2019 23:34:00,0,4414.0,4314.0,0.977,22.168,133,73,37,36,60,19,41,0,0.0,0.0
1004,1799,25-09-2019 23:36:00,0,4319.0,4191.0,0.97,21.658,50,20,4,16,30,0,30,0,0.02,0.0
1004,1800,25-09-2019 23:38:00,0,4251.0,4117.0,0.969,21.306,104,49,23,26,55,22,33,0,0.0,0.0
1004,1801,25-09-2019 23:40:00,0,4174.0,3971.0,0.951,20.842,72,43,18,25,29,14,15,0,0.0,0.0
1004,1802,25-09-2019 23:42:00,0,4254.0,4083.0,0.96,21.281,39,26,17,9,13,5,8,0,0.0,0.0
1004,1803,25-09-2019 23:44:00,0,3956.0,3856.0,0.975,19.854,6,3,1,2,3,0,3,0,0.0,0.0
1004,1804,25-09-2019 23:46:00,0,4008.0,3701.0,0.923,19.888,22,19,2,17,3,2,1,0,0.0,0.0
1004,1805,25-09-2019 23:48:00,0,3945.5,3706.5,0.9395,19.6485,11,8,1,7,3,0,3,0,0.0,0.0
1004,1806,25-09-2019 23:50:00,0,3883.0,3712.0,0.956,19.409,13,12,0,12,1,0,1,0,0.0,0.0
1004,1807,25-09-2019 23:52:00,0,3777.0,3680.0,0.974,18.957,186,97,71,26,89,53,36,33,0.0,0.0
1004,1808,25-09-2019 23:54:00,0,4258.0,4080.0,0.958,21.292,161,107,66,41,54,8,46,84,0.0,0.0
1004,1809,25-09-2019 23:56:00,0,4228.0,4119.0,0.974,21.218,244,154,109,45,90,32,58,56,0.03,0.0
1004,1810,25-09-2019 23:58:00,0,4250.0,4116.0,0.969,21.301,369,218,164,54,151,95,56,51,0.0,0.01
1004,1811,26-09-2019 00:00:00,0,3939.0,3883.0,0.986,19.82,254,153,99,54,101,57,44,45,0.0,0.06
1004,1812,26-09-2019 00:02:00,0,4446.0,4261.0,0.958,22.237,200,124,80,44,76,19,57,52,0.0,0.0
1004,1813,26-09-2019 00:04:00,0,4431.0,4316.0,0.974,22.237,550,301,247,54,249,196,53,19,0.05,0.0
1004,1814,26-09-2019 00:06:00,0,4388.0,4389.0,1.0,22.148,208,104,71,33,104,81,23,71,0.0,0.04
1004,1815,26-09-2019 00:08:00,0,4059.0,3958.0,0.975,20.373,244,132,103,29,112,88,24,209,0.0,0.0
1004,1816,26-09-2019 00:10:00,0,3606.0,3487.0,0.967,18.069,137,116,70,46,21,11,10,86,0.0,0.0
1004,1817,26-09-2019 00:12:00,0,3178.0,2896.0,0.911,15.728,324,191,155,36,133,94,39,69,0.08,0.0
1004,1818,26-09-2019 00:14:00,0,4420.0,4345.0,0.983,22.226,310,214,150,64,96,65,31,79,0.0,0.0
1004,1819,26-09-2019 00:16:00,0,4608.0,4432.0,0.962,23.062,132,85,47,38,47,2,45,74,0.0,0.0
1004,1820,26-09-2019 00:18:00,0,4886.0,4773.0,0.977,24.535,114,70,43,27,44,2,42,52,0.0,0.09
1004,1821,26-09-2019 00:20:00,0,4890.0,4685.0,0.958,24.454,116,82,55,27,34,4,30,42,0.0,0.05
1004,1822,26-09-2019 00:22:00,0,4741.5,4621.5,0.975,23.798,108,73,47,26,35,5,30,51,0.0,0.05
1004,1823,26-09-2019 00:24:00,0,4593.0,4558.0,0.992,23.142,343,195,150,45,148,113,35,103,0.0,0.06
1004,1824,26-09-2019 00:26:00,0,4874.0,4815.0,0.988,24.535,192,106,73,33,86,64,22,132,0.0,0.0
1004,1825,26-09-2019 00:28:00,0,3997.0,3771.0,0.943,19.925,210,110,69,41,100,82,18,38,0.01,0.02
1004,1826,26-09-2019 00:30:00,0,4679.0,4574.0,0.978,23.498,382,207,176,31,175,137,38,184,0.05,0.0
1004,1827,26-09-2019 00:32:00,0,4415.0,4312.0,0.977,22.17,373,185,134,51,188,136,52,79,0.09,0.0
1004,1828,26-09-2019 00:34:00,0,4928.0,4668.0,0.947,24.586,456,212,153,59,244,180,64,0,0.0,0.0
1004,1829,26-09-2019 00:36:00,0,4515.0,4400.0,0.975,22.661,385,187,138,49,198,141,57,4,0.0,0.0
1004,1830,26-09-2019 00:38:00,0,4630.0,4460.0,0.963,23.18,245,122,82,40,123,81,42,3,0.0,0.0
1004,1831,26-09-2019 00:40:00,0,4881.0,4836.0,0.991,24.582,213,64,43,21,149,99,50,20,0.01,0.0
1004,1832,26-09-2019 00:42:00,0,4412.0,4373.0,0.991,22.226,170,87,60,27,83,60,23,80,0.05,0.0
1004,1833,26-09-2019 00:44:00,0,5057.0,4919.0,0.973,25.369,324,192,142,50,132,96,36,54,0.01,0.0
1004,1834,26-09-2019 00:46:00,0,4886.0,4690.0,0.96,24.443,232,163,116,47,69,38,31,67,0.0,0.0
1004,1835,26-09-2019 00:48:00,0,4694.0,4564.0,0.972,23.547,205,170,126,44,35,10,25,79,0.0,0.0
1004,1836,26-09-2019 00:50:00,0,4617.0,4415.0,0.956,23.078,182,148,106,42,34,1,33,71,0.0,0.09
1004,1837,26-09-2019 00:52:00,0,4606.0,4582.0,0.995,23.218,211,150,104,46,61,27,34,63,0.0,0.0
1004,1838,26-09-2019 00:54:00,0,4508.0,4401.0,0.976,22.633,205,119,80,39,86,63,23,117,0.0,0.0
1004,1839,26-09-2019 00:56:00,0,4549.0,4472.0,0.983,22.874,147,90,64,26,57,29,28,134,0.0,0.0
1004,1840,26-09-2019 00:58:00,0,4590.0,4543.0,0.99,23.115,347,231,175,56,116,69,47,73,0.0,0.0
1004,1841,26-09-2019 01:00:00,0,4912.0,4619.0,0.94,24.468,227,187,148,39,40,11,29,51,0.0,0.0
1004,1842,26-09-2019 01:02:00,0,4691.0,4560.0,0.972,23.531,206,118,80,38,88,55,33,43,0.0,0.04
1004,1843,26-09-2019 01:04:00,0,4578.0,4530.0,0.989,23.051,197,92,61,31,105,72,33,38,0.08,0.0
1004,1844,26-09-2019 01:06:00,0,4620.0,4472.0,0.968,23.155,347,188,139,49,159,110,49,0,0.0,0.0
1004,1845,26-09-2019 01:08:00,0,4238.0,4076.0,0.962,21.21,409,234,192,42,175,142,33,175,0.06,0.0
1004,1846,26-09-2019 01:10:00,0,4594.0,4552.0,0.991,23.14,274,161,110,51,113,70,43,90,0.01,0.0
1004,1847,26-09-2019 01:12:00,0,4900.0,4784.0,0.976,24.601,208,153,107,46,55,25,30,48,0.0,0.03
1004,1848,26-09-2019 01:14:00,0,4871.0,4754.0,0.976,24.455,285,190,137,53,95,47,48,58,0.0,0.0
1004,1849,26-09-2019 01:16:00,0,4597.0,4489.0,0.977,23.079,220,131,101,30,89,64,25,117,0.0,0.0
1004,1850,26-09-2019 01:18:00,0,4059.0,3884.0,0.957,20.293,160,84,58,26,76,44,32,8,0.06,0.0
1004,1851,26-09-2019 01:20:00,0,5092.0,4876.0,0.958,25.46,86,47,12,35,39,9,30,0,0.0,0.0
1004,1852,26-09-2019 01:22:00,0,4869.0,4815.0,0.989,24.514,107,70,24,46,37,14,23,0,0.0,0.0
1004,1853,26-09-2019 01:24:00,0,4996.0,4847.0,0.97,25.048,104,56,31,25,48,22,26,1,0.0,0.0
1004,1854,26-09-2019 01:26:00,0,4882.0,4721.0,0.967,24.462,288,142,106,36,146,98,48,1,0.0,0.0
1004,1855,26-09-2019 01:28:00,0,4618.0,4505.0,0.976,23.18,177,76,54,22,101,63,38,21,0.0,0.13
1004,1856,26-09-2019 01:30:00,0,4511.0,4403.0,0.9765,22.647,290,161,120,41,129,82,47,59,0.0,0.0
1004,1857,26-09-2019 01:32:00,0,4404.0,4301.0,0.977,22.114,159,112,71,41,47,8,39,82,0.0,0.0
1004,1858,26-09-2019 01:34:00,0,4595.0,4499.0,0.979,23.084,177,134,90,44,43,4,39,85,0.0,0.0
1004,1859,26-09-2019 01:36:00,0,4640.0,4397.0,0.948,23.15,173,119,82,37,54,5,49,85,0.0,0.0
1004,1860,26-09-2019 01:38:00,0,4516.0,4367.0,0.967,22.628,184,94,66,28,90,60,30,8,0.02,0.0
1004,1861,26-09-2019 01:40:00,0,4545.0,4390.0,0.966,22.768,32,14,3,11,18,8,10,0,0.0,0.0
1004,1862,26-09-2019 01:42:00,0,4903.0,4690.0,0.956,24.511,55,30,6,24,25,3,22,0,0.0,0.0
1004,1863,26-09-2019 01:44:00,0,4629.0,4473.0,0.966,23.192,14,13,0,13,1,0,1,0,0.0,0.0
1004,1864,26-09-2019 01:46:00,0,4337.0,4203.0,0.969,21.739,0,0,0,0,0,0,0,0,0.0,0.0
1004,1865,26-09-2019 01:48:00,0,4281.0,4001.0,0.935,21.295,16,5,2,3,11,2,9,0,0.0,0.0
1004,1866,26-09-2019 01:50:00,0,3971.0,3801.0,0.957,19.855,12,2,0,2,10,6,4,0,0.0,0.0
1004,1867,26-09-2019 01:52:00,0,3797.0,3610.0,0.951,18.956,187,106,81,25,81,58,23,0,0.0,0.0
1004,1868,26-09-2019 01:54:00,0,3795.0,3662.0,0.965,19.007,308,174,129,45,134,92,42,57,0.0,0.0
1004,1869,26-09-2019 01:56:00,0,3979.0,3811.0,0.958,19.896,152,91,58,33,61,24,37,64,0.0,0.0
1004,1870,26-09-2019 01:58:00,0,3973.0,3794.0,0.955,19.856,69,63,33,30,6,1,5,36,0.0,0.0
1004,1871,26-09-2019 02:00:00,0,4263.0,4060.0,0.952,21.292,98,80,44,36,18,9,9,43,0.0,0.0
1004,1872,26-09-2019 02:02:00,0,4371.0,4142.0,0.948,21.807,103,82,35,47,21,2,19,28,0.0,0.09
1004,1873,26-09-2019 02:04:00,0,4400.0,4219.5,0.959,22.008,561,362,285,77,199,153,46,62,0.06,0.09
1004,1874,26-09-2019 02:06:00,0,4429.0,4297.0,0.97,22.209,253,145,113,32,108,76,32,65,0.0,0.0
1004,1875,26-09-2019 02:08:00,0,4257.0,4005.0,0.941,21.205,579,333,258,75,246,175,71,11,0.0,0.0
1004,1876,26-09-2019 02:10:00,0,3507.0,3341.0,0.953,17.517,275,156,124,32,119,85,34,97,0.0,0.0
1004,1877,26-09-2019 02:12:00,0,4419.0,4299.0,0.973,22.169,203,97,70,27,106,59,47,54,0.06,0.0
1004,1878,26-09-2019 02:14:00,0,4418.0,4286.0,0.97,22.15,228,100,75,25,128,81,47,0,0.01,0.0
1004,1879,26-09-2019 02:16:00,0,4168.0,3970.0,0.953,20.815,485,253,191,62,232,180,52,6,0.06,0.0
1004,1880,26-09-2019 02:18:00,0,5042.0,5021.0,0.996,25.422,163,68,44,24,95,57,38,8,0.02,0.0
1004,1881,26-09-2019 02:20:00,0,4452.0,4216.0,0.947,22.207,151,48,21,27,103,66,37,0,0.0,0.0
1004,1882,26-09-2019 02:22:00,0,4425.0,4243.0,0.959,22.132,74,36,5,31,38,15,23,0,0.0,0.0
1004,1883,26-09-2019 02:24:00,0,4241.0,4133.0,0.975,21.283,49,21,7,14,28,8,20,0,0.0,0.0
1004,1884,26-09-2019 02:26:00,0,4267.0,4029.0,0.944,21.271,11,9,2,7,2,2,0,0,0.0,0.0
1004,1885,26-09-2019 02:28:00,0,3952.0,3820.0,0.966,19.801,5,3,1,2,2,0,2,0,0.0,0.0
1004,1886,26-09-2019 02:30:00,0,3997.0,3704.0,0.927,19.848,4,4,1,3,0,0,0,0,0.0,0.0
1004,1887,26-09-2019 02:32:00,0,3822.0,3505.0,0.917,18.937,1,1,0,1,0,0,0,0,0.0,0.0
1004,1888,26-09-2019 02:34:00,0,3493.0,3420.0,0.979,17.549,13,8,4,4,5,1,4,0,0.0,0.0
1004,1889,26-09-2019 02:36:00,0,3505.0,3375.0,0.963,17.547,1,0,0,0,1,0,1,0,0.0,0.0
1004,1890,26-09-2019 02:38:00,0,3412.5,3298.0,0.9665,17.096,6,5,2,3,1,0,1,0,0.0,0.0
1004,1891,26-09-2019 02:40:00,0,3320.0,3221.0,0.97,16.645,11,5,4,1,6,4,2,0,0.0,0.0
1004,1892,26-09-2019 02:42:00,0,3311.0,3202.0,0.967,16.589,2,2,0,2,0,0,0,0,0.0,0.0
1004,1893,26-09-2019 02:44:00,0,3332.0,3134.0,0.941,16.598,13,13,0,13,0,0,0,0,0.0,0.0
1004,1894,26-09-2019 02:46:00,0,3364.0,3078.0,0.915,16.661,14,0,0,0,14,1,13,0,0.0,0.0
1004,1895,26-09-2019 02:48:00,0,3352.0,3084.0,0.92,16.622,0,0,0,0,0,0,0,0,0.0,0.0
1004,1896,26-09-2019 02:50:00,0,3132.0,3020.0,0.964,15.685,13,9,7,2,4,0,4,0,0.0,0.0
1004,1897,26-09-2019 02:52:00,0,3239.0,3084.0,0.952,16.177,0,0,0,0,0,0,0,0,0.0,0.0
1004,1898,26-09-2019 02:54:00,0,3126.0,3050.0,0.976,15.694,33,15,8,7,18,8,10,0,0.0,0.0
1004,1899,26-09-2019 02:56:00,0,3169.0,2925.0,0.923,15.723,41,10,7,3,31,15,16,0,0.0,0.0
1004,1900,26-09-2019 02:58:00,0,3157.0,2903.0,0.92,15.652,2,1,1,0,1,0,1,0,0.0,0.0
1004,1901,26-09-2019 03:00:00,0,3190.0,2863.0,0.898,15.739,28,0,0,0,28,0,28,0,0.0,0.0
1004,1902,26-09-2019 03:02:00,0,3077.0,2813.0,0.914,15.238,7,2,0,2,5,2,3,0,0.0,0.0
1004,1903,26-09-2019 03:04:00,0,3072.0,2815.0,0.916,15.22,10,1,0,1,9,3,6,0,0.0,0.0
1004,1904,26-09-2019 03:06:00,0,3163.0,2898.0,0.916,15.672,20,1,0,1,19,6,13,0,0.0,0.0
1004,1905,26-09-2019 03:08:00,0,3176.0,2909.0,0.916,15.733,210,113,73,40,97,55,42,58,0.0,0.0
1004,1906,26-09-2019 03:10:00,0,3320.0,3206.0,0.966,16.629,138,91,55,36,47,1,46,76,0.0,0.0
1004,1907,26-09-2019 03:12:00,0,3558.0,3393.5,0.9545,17.775,69,54,18,36,15,0,15,28,0.0,0.0
1004,1908,26-09-2019 03:14:00,0,3796.0,3581.0,0.943,18.921,194,99,67,32,95,71,24,51,0.0,0.02
1004,1909,26-09-2019 03:16:00,0,3515.0,3358.0,0.955,17.567,137,37,10,27,100,48,52,3,0.0,0.0
1004,1910,26-09-2019 03:18:00,0,3786.0,3657.0,0.966,18.964,57,34,12,22,23,3,20,0,0.0,0.0
1004,1911,26-09-2019 03:20:00,0,3968.0,3900.0,0.983,19.952,101,45,18,27,56,17,39,0,0.0,0.0
1004,1912,26-09-2019 03:22:00,0,4056.0,3984.0,0.982,20.39,232,119,79,40,113,70,43,32,0.0,0.0
1004,1913,26-09-2019 03:24:00,0,4142.0,4019.0,0.97,20.77,235,139,103,36,96,68,28,137,0.0,0.0
1004,1914,26-09-2019 03:26:00,0,4244.0,4085.0,0.963,21.243,184,137,104,33,47,11,36,93,0.0,0.0
1004,1915,26-09-2019 03:28:00,0,4254.0,4067.0,0.956,21.264,87,52,18,34,35,22,13,33,0.0,0.0
1004,1916,26-09-2019 03:30:00,0,4434.0,4282.0,0.966,22.211,100,53,29,24,47,26,21,30,0.0,0.07
1004,1917,26-09-2019 03:32:00,0,4409.0,4294.0,0.974,22.127,141,78,38,40,63,24,39,33,0.0,0.07
1004,1918,26-09-2019 03:34:00,0,4514.0,4325.0,0.958,22.572,210,103,75,28,107,68,39,17,0.0,0.03
1004,1919,26-09-2019 03:36:00,0,4431.0,4256.0,0.96,22.171,343,188,143,45,155,109,46,95,0.08,0.0
1004,1920,26-09-2019 03:38:00,0,4156.0,3993.0,0.961,20.795,221,139,101,38,82,57,25,5,0.0,0.01
1004,1921,26-09-2019 03:40:00,0,3962.0,3858.0,0.974,19.881,320,195,140,55,125,86,39,3,0.02,0.0
1004,1922,26-09-2019 03:42:00,0,4610.0,4485.0,0.973,23.13,145,68,35,33,77,59,18,35,0.0,0.04
1004,1923,26-09-2019 03:44:00,0,4621.0,4410.0,0.954,23.088,44,37,16,21,7,2,5,28,0.0,0.08
1004,1924,26-09-2019 03:46:00,0,4530.0,4320.5,0.9535,22.6305,134,80,46,34,54,41,13,27,0.0,0.05
1004,1925,26-09-2019 03:48:00,0,4439.0,4231.0,0.953,22.173,488,261,190,71,227,173,54,31,0.06,0.0
1004,1926,26-09-2019 03:50:00,0,4340.0,4194.0,0.966,21.742,172,76,52,24,96,70,26,68,0.07,0.0
1004,1927,26-09-2019 03:52:00,0,4515.0,4354.0,0.964,22.61,40,12,4,8,28,7,21,0,0.0,0.02
1004,1928,26-09-2019 03:54:00,0,4615.0,4432.0,0.96,23.09,17,4,1,3,13,0,13,0,0.0,0.0
1004,1929,26-09-2019 03:56:00,0,4463.0,4202.0,0.942,22.234,17,1,0,1,16,0,16,0,0.0,0.0
1004,1930,26-09-2019 03:58:00,0,4172.0,3976.0,0.953,20.839,17,11,0,11,6,0,6,0,0.0,0.0
1004,1931,26-09-2019 04:00:00,0,3984.0,3752.0,0.942,19.85,30,18,2,16,12,0,12,0,0.0,0.0
1004,1932,26-09-2019 04:02:00,0,3796.0,3610.0,0.951,18.953,0,0,0,0,0,0,0,0,0.0,0.0
1004,1933,26-09-2019 04:04:00,0,3716.0,3450.0,0.928,18.462,6,3,2,1,3,2,1,0,0.0,0.0
1004,1934,26-09-2019 04:06:00,0,3495.0,3424.0,0.98,17.56,6,0,0,0,6,0,6,0,0.0,0.0
1004,1935,26-09-2019 04:08:00,0,3539.0,3251.0,0.919,17.544,2,0,0,0,2,0,2,0,0.0,0.0
1004,1936,26-09-2019 04:10:00,0,3344.0,3131.0,0.936,16.643,32,15,9,6,17,10,7,0,0.0,0.0
1004,1937,26-09-2019 04:12:00,0,3521.0,3359.0,0.954,17.592,0,0,0,0,0,0,0,0,0.0,0.0
1004,1938,26-09-2019 04:14:00,0,3539.0,3287.0,0.929,17.581,0,0,0,0,0,0,0,0,0.0,0.0
1004,1939,26-09-2019 04:16:00,0,3315.0,3198.0,0.965,16.604,25,5,2,3,20,12,8,0,0.0,0.0
1004,1940,26-09-2019 04:18:00,0,3321.0,3198.0,0.963,16.624,4,3,1,2,1,0,1,0,0.0,0.0
1004,1941,26-09-2019 04:20:00,0,3340.5,3169.0,0.9485,16.669,32,17,5,12,15,5,10,1,0.0,0.0
1004,1942,26-09-2019 04:22:00,0,3360.0,3140.0,0.934,16.714,79,30,10,20,49,14,35,2,0.0,0.0
1004,1943,26-09-2019 04:24:00,0,3339.0,3162.0,0.947,16.658,240,130,95,35,110,80,30,4,0.0,0.0
1004,1944,26-09-2019 04:26:00,0,3322.0,3196.0,0.962,16.626,333,192,145,47,141,105,36,21,0.0,0.0
1004,1945,26-09-2019 04:28:00,0,3308.0,3289.0,0.994,16.674,256,142,111,31,114,79,35,123,0.0,0.0
1004,1946,26-09-2019 04:30:00,0,3805.0,3579.0,0.941,18.952,554,256,198,58,298,224,74,25,0.0,0.0
1004,1947,26-09-2019 04:32:00,0,3589.0,3502.0,0.976,18.017,133,93,56,37,40,4,36,92,0.02,0.05
1004,1948,26-09-2019 04:34:00,0,3808.0,3562.0,0.935,18.948,349,199,148,51,150,104,46,10,0.0,0.12
1004,1949,26-09-2019 04:36:00,0,3988.0,3715.0,0.932,19.825,358,218,173,45,140,103,37,33,0.0,0.0
1004,1950,26-09-2019 04:38:00,0,3830.0,3538.0,0.924,19.007,218,101,66,35,117,74,43,2,0.0,0.0
1004,1951,26-09-2019 04:40:00,0,3580.0,3466.0,0.968,17.944,364,217,160,57,147,92,55,7,0.0,0.0
1004,1952,26-09-2019 04:42:00,0,4002.0,3730.0,0.932,19.899,402,200,152,48,202,151,51,80,0.0,0.0
1004,1953,26-09-2019 04:44:00,0,3816.0,3560.0,0.933,18.977,176,98,74,24,78,53,25,50,0.0,0.0
1004,1954,26-09-2019 04:46:00,0,3805.0,3540.0,0.93,18.91,66,41,19,22,25,3,22,32,0.0,0.0
1004,1955,26-09-2019 04:48:00,0,4256.0,4052.0,0.952,21.253,51,50,19,31,1,1,0,39,0.0,0.0
1004,1956,26-09-2019 04:50:00,0,4455.0,4206.0,0.944,22.209,408,203,145,58,205,148,57,42,0.0,0.0
1004,1957,26-09-2019 04:52:00,0,3979.0,3822.0,0.96,19.909,317,166,136,30,151,109,42,112,0.05,0.0
1004,1958,26-09-2019 04:54:00,0,3992.5,3761.0,0.9415,19.894,385,176,123,53,209,171,38,2,0.01,0.0
1004,1959,26-09-2019 04:56:00,0,4006.0,3700.0,0.923,19.879,112,94,70,24,18,4,14,1,0.0,0.0
1004,1960,26-09-2019 04:58:00,0,3188.0,2817.0,0.884,15.681,97,42,29,13,55,40,15,7,0.0,0.0
1004,1961,26-09-2019 05:00:00,0,4015.0,3684.0,0.918,19.896,146,29,12,17,117,92,25,2,0.0,0.0
1004,1962,26-09-2019 05:02:00,0,4258.0,4028.0,0.946,21.234,212,34,11,23,178,149,29,0,0.0,0.0
1004,1963,26-09-2019 05:04:00,0,4420.0,4216.0,0.954,22.081,19,13,4,9,6,1,5,0,0.01,0.0
1004,1964,26-09-2019 05:06:00,0,4266.0,4031.0,0.945,21.271,0,0,0,0,0,0,0,0,0.0,0.0
1004,1965,26-09-2019 05:08:00,0,3977.0,3818.0,0.96,19.896,5,4,3,1,1,0,1,0,0.0,0.0
1004,1966,26-09-2019 05:10:00,0,3804.0,3585.0,0.943,18.956,3,3,1,2,0,0,0,0,0.0,0.0
1004,1967,26-09-2019 05:12:00,0,3509.0,3327.0,0.948,17.509,21,19,12,7,2,0,2,0,0.0,0.0
1004,1968,26-09-2019 05:14:00,0,3427.0,3222.0,0.94,17.068,6,6,4,2,0,0,0,0,0.0,0.0
1004,1969,26-09-2019 05:16:00,0,3348.0,3143.0,0.939,16.671,0,0,0,0,0,0,0,0,0.0,0.0
1004,1970,26-09-2019 05:18:00,0,3349.0,3077.0,0.919,16.6,10,10,5,5,0,0,0,0,0.0,0.0
1004,1971,26-09-2019 05:20:00,0,3266.0,3016.0,0.924,16.207,0,0,0,0,0,0,0,0,0.0,0.0
1004,1972,26-09-2019 05:22:00,0,3157.0,2949.0,0.934,15.705,82,39,28,11,43,28,15,0,0.0,0.0
1004,1973,26-09-2019 05:24:00,0,3252.0,3042.0,0.935,16.179,18,18,2,16,0,0,0,0,0.0,0.0
1004,1974,26-09-2019 05:26:00,0,3153.0,2979.0,0.945,15.721,25,25,11,14,0,0,0,0,0.0,0.0
1004,1975,26-09-2019 05:28:00,0,3155.0,2954.0,0.9365,15.7005,6,6,3,3,0,0,0,0,0.0,0.01
1004,1976,26-09-2019 05:30:00,0,3157.0,2929.0,0.928,15.68,23,22,13,9,1,0,1,2,0.0,0.0
1004,1977,26-09-2019 05:32:00,0,3235.0,3061.0,0.946,16.135,168,86,53,33,82,46,36,5,0.0,0.0
1004,1978,26-09-2019 05:34:00,0,3325.0,3169.0,0.953,16.607,109,61,35,26,48,26,22,1,0.0,0.0
1004,1979,26-09-2019 05:36:00,0,3520.0,3254.0,0.924,17.471,95,89,43,46,6,2,4,0,0.0,0.0
1004,1980,26-09-2019 05:38:00,0,3513.0,3273.0,0.932,17.465,441,251,187,64,190,142,48,75,0.0,0.0
1004,1981,26-09-2019 05:40:00,0,3492.0,3448.0,0.987,17.575,161,104,70,34,57,33,24,55,0.0,0.01
1004,1982,26-09-2019 05:42:00,0,3819.0,3525.0,0.923,18.947,91,65,25,40,26,2,24,58,0.0,0.04
1004,1983,26-09-2019 05:44:00,0,4009.0,3736.0,0.932,19.933,96,58,27,31,38,15,23,43,0.01,0.09
1004,1984,26-09-2019 05:46:00,0,4285.0,3966.0,0.926,21.273,113,57,28,29,56,2,54,30,0.0,0.3
1004,1985,26-09-2019 05:48:00,0,4273.0,4086.0,0.956,21.357,270,128,101,27,142,102,40,40,0.08,0.04
1004,1986,26-09-2019 05:50:00,0,4523.0,4368.0,0.966,22.655,432,254,206,48,178,130,48,33,0.0,0.0
1004,1987,26-09-2019 05:52:00,0,3986.0,3779.0,0.948,19.889,221,130,100,30,91,74,17,148,0.01,0.0
1004,1988,26-09-2019 05:54:00,0,4237.0,4060.0,0.958,21.188,382,243,202,41,139,115,24,183,0.09,0.0
1004,1989,26-09-2019 05:56:00,0,3999.0,3727.0,0.932,19.884,412,240,197,43,172,133,39,187,0.0,0.0
1004,1990,26-09-2019 05:58:00,0,4266.0,4003.0,0.938,21.239,335,180,137,43,155,109,46,59,0.02,0.0
1004,1991,26-09-2019 06:00:00,1,4017.0,3688.0,0.918,19.911,346,202,162,40,144,112,32,55,0.0,0.0
1004,1992,26-09-2019 06:02:00,1,4111.5,3795.5,0.923,20.401,170,93,66,27,77,57,20,30,0.0,0.0
1004,1993,26-09-2019 06:04:00,1,4206.0,3903.0,0.928,20.891,209,119,89,30,90,55,35,2,0.0,0.0
1004,1994,26-09-2019 06:06:00,1,4008.0,3660.0,0.913,19.845,208,94,72,22,114,83,31,34,0.0,0.0
1004,1995,26-09-2019 06:08:00,1,4188.0,3911.0,0.934,20.829,238,105,76,29,133,94,39,16,0.01,0.0
1004,1996,26-09-2019 06:10:00,1,4251.0,4110.0,0.967,21.298,92,57,44,13,35,27,8,1,0.0,0.0
1004,1997,26-09-2019 06:12:00,1,4234.0,4035.0,0.953,21.15,60,31,17,14,29,14,15,0,0.0,0.0
1004,1998,26-09-2019 06:14:00,1,4166.0,3915.0,0.94,20.749,47,28,4,24,19,3,16,0,0.0,0.0
1004,1999,26-09-2019 06:16:00,1,4257.0,3979.0,0.935,21.178,112,87,50,37,25,8,17,0,0.0,0.0
1004,2000,26-09-2019 06:18:00,1,3974.0,3785.0,0.952,19.849,358,269,212,57,89,50,39,3,0.0,0.0
1004,2001,26-09-2019 06:20:00,1,4284.0,3970.0,0.927,21.274,45,28,20,8,17,6,11,1,0.01,0.0
1004,2002,26-09-2019 06:22:00,1,3951.0,3839.0,0.972,19.818,44,12,2,10,32,6,26,0,0.0,0.0
1004,2003,26-09-2019 06:24:00,1,4292.0,3961.0,0.923,21.295,0,0,0,0,0,0,0,0,0.0,0.0
1004,2004,26-09-2019 06:26:00,1,3905.0,3650.0,0.935,19.428,0,0,0,0,0,0,0,0,0.0,0.0
1004,2005,26-09-2019 06:28:00,1,3618.0,3428.0,0.947,18.051,0,0,0,0,0,0,0,0,0.0,0.0
1004,2006,26-09-2019 06:30:00,1,3540.0,3259.0,0.921,17.556,0,0,0,0,0,0,0,0,0.01,0.0
1004,2007,26-09-2019 06:32:00,1,3449.0,3217.0,0.933,17.149,0,0,0,0,0,0,0,0,0.0,0.0
1004,2008,26-09-2019 06:34:00,1,3345.0,3131.0,0.936,16.647,0,0,0,0,0,0,0,0,0.0,0.0
1004,2009,26-09-2019 06:36:00,1,3303.0,3059.5,0.926,16.401,0,0,0,0,0,0,0,0,0.0,0.0
1004,2010,26-09-2019 06:38:00,1,3261.0,2988.0,0.916,16.155,4,0,0,0,4,0,4,0,0.0,0.0
1004,2011,26-09-2019 06:40:00,1,3371.0,3029.0,0.899,16.633,0,0,0,0,0,0,0,0,0.0,0.0
1004,2012,26-09-2019 06:42:00,1,3346.0,3055.0,0.913,16.565,1,0,0,0,1,0,1,0,0.0,0.0
1004,2013,26-09-2019 06:44:00,1,3324.0,3218.0,0.968,16.658,0,0,0,0,0,0,0,0,0.0,0.0
1004,2014,26-09-2019 06:46:00,1,3322.0,3160.0,0.951,16.588,0,0,0,0,0,0,0,0,0.0,0.0
1004,2015,26-09-2019 06:48:00,1,3323.0,3212.0,0.967,16.649,0,0,0,0,0,0,0,0,0.0,0.0
1004,2016,26-09-2019 06:50:00,1,3349.0,3091.0,0.923,16.615,5,5,1,4,0,0,0,0,0.0,0.0
1004,2017,26-09-2019 06:52:00,1,3130.0,3026.0,0.967,15.682,31,21,14,7,10,6,4,0,0.0,0.0
1004,2018,26-09-2019 06:54:00,1,3351.0,3112.0,0.929,16.649,10,7,2,5,3,1,2,0,0.0,0.0
1004,2019,26-09-2019 06:56:00,1,2970.0,2766.0,0.931,14.762,15,9,4,5,6,4,2,0,0.0,0.0
1004,2020,26-09-2019 06:58:00,1,2882.0,2704.0,0.938,14.349,0,0,0,0,0,0,0,0,0.0,0.0
1004,2021,26-09-2019 07:00:00,1,2992.0,2730.0,0.912,14.812,6,6,4,2,0,0,0,0,0.0,0.0
1004,2022,26-09-2019 07:02:00,1,3148.0,2970.0,0.943,15.692,0,0,0,0,0,0,0,0,0.0,0.0
1004,2023,26-09-2019 07:04:00,1,3126.0,3057.0,0.978,15.7,30,26,18,8,4,2,2,0,0.0,0.0
1004,2024,26-09-2019 07:06:00,1,3159.0,2886.0,0.914,15.64,7,7,0,7,0,0,0,0,0.0,0.0
1004,2025,26-09-2019 07:08:00,1,3195.0,2844.0,0.89,15.738,7,6,0,6,1,0,1,0,0.0,0.0
1004,2026,26-09-2019 07:10:00,1,3137.5,2805.5,0.8945,15.468,0,0,0,0,0,0,0,0,0.0,0.0
1004,2027,26-09-2019 07:12:00,1,3080.0,2767.0,0.899,15.198,1,0,0,0,1,0,1,0,0.0,0.0
1004,2028,26-09-2019 07:14:00,1,3090.0,2813.0,0.911,15.288,65,52,27,25,13,6,7,0,0.0,0.0
1004,2029,26-09-2019 07:16:00,1,3164.0,2887.0,0.912,15.663,272,147,109,38,125,91,34,18,0.0,0.0
1004,2030,26-09-2019 07:18:00,1,2869.0,2718.0,0.948,14.311,272,175,130,45,97,68,29,5,0.0,0.0
1004,2031,26-09-2019 07:20:00,1,2979.0,2757.0,0.926,14.79,241,112,73,39,129,101,28,14,0.0,0.0
1004,2032,26-09-2019 07:22:00,1,3349.0,3110.0,0.929,16.636,98,63,50,13,35,21,14,43,0.0,0.01
1004,2033,26-09-2019 07:24:00,1,3340.0,3183.0,0.953,16.683,132,63,35,28,69,48,21,7,0.02,0.0
1004,2034,26-09-2019 07:26:00,1,3322.0,3192.0,0.961,16.622,414,240,182,58,174,117,57,6,0.02,0.0
1004,2035,26-09-2019 07:28:00,1,3332.0,3139.0,0.942,16.603,62,40,21,19,22,3,19,0,0.0,0.0
1004,2036,26-09-2019 07:30:00,1,3534.0,3328.0,0.942,17.609,89,47,27,20,42,9,33,0,0.0,0.0
1004,2037,26-09-2019 07:32:00,1,3551.0,3238.0,0.912,17.575,83,56,35,21,27,6,21,0,0.0,0.0
1004,2038,26-09-2019 07:34:00,1,3535.0,3283.0,0.929,17.563,61,36,15,21,25,12,13,0,0.0,0.0
1004,2039,26-09-2019 07:36:00,1,3709.0,3455.0,0.931,18.439,63,24,5,19,39,8,31,0,0.0,0.0
1004,2040,26-09-2019 07:38:00,1,3520.0,3342.0,0.949,17.567,38,16,4,12,22,4,18,0,0.0,0.0
1004,2041,26-09-2019 07:40:00,1,3382.0,3025.0,0.895,16.673,38,24,11,13,14,2,12,0,0.0,0.0
1004,2042,26-09-2019 07:42:00,1,3367.0,3009.0,0.894,16.598,0,0,0,0,0,0,0,0,0.0,0.0
1004,2043,26-09-2019 07:44:00,1,3188.0,2836.0,0.8895,15.7,3,2,1,1,1,1,0,0,0.0,0.0
1004,2044,26-09-2019 07:46:00,1,3009.0,2663.0,0.885,14.802,0,0,0,0,0,0,0,0,0.0,0.0
1004,2045,26-09-2019 07:48:00,1,2909.0,2604.0,0.895,14.346,4,4,3,1,0,0,0,0,0.0,0.0
1004,2046,26-09-2019 07:50:00,1,2900.0,2582.0,0.89,14.285,9,5,0,5,4,0,4,0,0.0,0.0
1004,2047,26-09-2019 07:52:00,1,2922.0,2569.0,0.879,14.358,2,1,0,1,1,0,1,0,0.0,0.0
1004,2048,26-09-2019 07:54:00,1,2933.0,2519.0,0.859,14.344,27,27,0,27,0,0,0,0,0.0,0.0
1004,2049,26-09-2019 07:56:00,1,2915.0,2500.0,0.858,14.253,17,15,0,15,2,1,1,0,0.0,0.0
1004,2050,26-09-2019 07:58:00,1,2910.0,2614.0,0.898,14.358,30,22,14,8,8,4,4,0,0.0,0.0
1004,2051,26-09-2019 08:00:00,1,3189.0,2827.0,0.887,15.693,2,1,0,1,1,1,0,0,0.0,0.0
1004,2052,26-09-2019 08:02:00,1,3183.0,2852.0,0.896,15.699,2,1,0,1,1,0,1,0,0.0,0.0
1004,2053,26-09-2019 08:04:00,1,3195.0,2832.0,0.886,15.722,0,0,0,0,0,0,0,0,0.01,0.0
1004,2054,26-09-2019 08:06:00,1,3209.0,2751.0,0.857,15.69,15,3,0,3,12,7,5,0,0.0,0.0
1004,2055,26-09-2019 08:08:00,1,3205.0,2794.0,0.872,15.72,0,0,0,0,0,0,0,0,0.0,0.0
1004,2056,26-09-2019 08:10:00,1,3202.0,2799.0,0.874,15.715,1,1,1,0,0,0,0,0,0.0,0.0
1004,2057,26-09-2019 08:12:00,1,3195.0,2826.0,0.885,15.718,44,22,11,11,22,15,7,0,0.0,0.0
1004,2058,26-09-2019 08:14:00,1,3201.0,2818.0,0.88,15.73,68,30,9,21,38,11,27,0,0.0,0.0
1004,2059,26-09-2019 08:16:00,1,3194.0,2801.0,0.877,15.684,38,21,14,7,17,6,11,0,0.0,0.0
1004,2060,26-09-2019 08:18:00,1,3199.0,2812.5,0.879,15.716,1,1,0,1,0,0,0,0,0.0,0.0
1004,2061,26-09-2019 08:20:00,1,3204.0,2824.0,0.881,15.748,5,5,1,4,0,0,0,0,0.0,0.0
1004,2062,26-09-2019 08:22:00,1,3088.0,2723.0,0.882,15.181,1,1,0,1,0,0,0,0,0.0,0.0
1004,2063,26-09-2019 08:24:00,1,3098.0,2714.0,0.876,15.211,27,19,14,5,8,2,6,0,0.0,0.0
1004,2064,26-09-2019 08:26:00,1,2890.0,2610.0,0.903,14.277,9,0,0,0,9,0,9,0,0.0,0.0
1004,2065,26-09-2019 08:28:00,1,2912.0,2522.0,0.866,14.264,2,1,0,1,1,0,1,0,0.0,0.0
1004,2066,26-09-2019 08:30:00,1,2927.0,2462.0,0.841,14.26,1,1,0,1,0,0,0,0,0.0,0.0
1004,2067,26-09-2019 08:32:00,1,2920.0,2529.0,0.866,14.306,0,0,0,0,0,0,0,0,0.0,0.0
1004,2068,26-09-2019 08:34:00,1,2936.0,2458.0,0.837,14.288,2,0,0,0,2,1,1,0,0.0,0.0
1004,2069,26-09-2019 08:36:00,1,2839.0,2417.0,0.851,13.862,175,80,64,16,95,73,22,6,0.0,0.0
1004,2070,26-09-2019 08:38:00,1,2749.0,2327.0,0.847,13.405,96,45,36,9,51,38,13,5,0.0,0.0
1004,2071,26-09-2019 08:40:00,1,2738.0,2293.0,0.837,13.327,12,0,0,0,12,3,9,0,0.0,0.0
1004,2072,26-09-2019 08:42:00,1,2744.0,2371.0,0.864,13.435,1,0,0,0,1,0,1,0,0.0,0.0
1004,2073,26-09-2019 08:44:00,1,2841.0,2390.0,0.841,13.838,3,0,0,0,3,0,3,0,0.0,0.0
1004,2074,26-09-2019 08:46:00,1,2950.0,2431.0,0.824,14.313,4,0,0,0,4,0,4,0,0.0,0.0
1004,2075,26-09-2019 08:48:00,1,2743.0,2357.0,0.859,13.418,4,0,0,0,4,2,2,0,0.0,0.0
1004,2076,26-09-2019 08:50:00,1,2842.0,2354.0,0.828,13.803,1,0,0,0,1,0,1,0,0.0,0.0
1004,2077,26-09-2019 08:52:00,1,2789.5,2341.5,0.8395,13.5835,0,0,0,0,0,0,0,0,0.0,0.0
1004,2078,26-09-2019 08:54:00,1,2737.0,2329.0,0.851,13.364,1,0,0,0,1,0,1,0,0.0,0.0
1004,2079,26-09-2019 08:56:00,1,2734.0,2322.0,0.849,13.344,7,3,2,1,4,2,2,0,0.0,0.0
1004,2080,26-09-2019 08:58:00,1,2946.0,2424.0,0.823,14.291,4,2,0,2,2,0,2,0,0.0,0.0
1004,2081,26-09-2019 09:00:00,1,2933.0,2458.0,0.838,14.278,1,0,0,0,1,0,1,0,0.0,0.0
1004,2082,26-09-2019 09:02:00,1,2939.0,2456.0,0.836,14.299,2,1,1,0,1,0,1,0,0.0,0.0
1004,2083,26-09-2019 09:04:00,1,2955.0,2413.0,0.817,14.314,6,4,1,3,2,0,2,0,0.0,0.0
1004,2084,26-09-2019 09:06:00,1,2856.0,2356.0,0.825,13.86,9,6,0,6,3,0,3,0,0.0,0.0
1004,2085,26-09-2019 09:08:00,1,2766.0,2292.0,0.829,13.434,28,6,0,6,22,3,19,0,0.0,0.0
1004,2086,26-09-2019 09:10:00,1,2866.0,2306.0,0.805,13.845,129,58,25,33,71,37,34,0,0.0,0.0
1004,2087,26-09-2019 09:12:00,1,2940.0,2482.0,0.844,14.331,199,31,7,24,168,116,52,0,0.0,0.0
1004,2088,26-09-2019 09:14:00,1,2930.0,2456.0,0.838,14.263,84,36,17,19,48,22,26,2,0.0,0.0
1004,2089,26-09-2019 09:16:00,1,3218.0,2708.0,0.842,15.676,126,60,36,24,66,21,45,72,0.0,0.0
1004,2090,26-09-2019 09:18:00,1,3225.0,2680.0,0.831,15.673,89,52,27,25,37,7,30,73,0.0,0.05
1004,2091,26-09-2019 09:20:00,1,3322.0,2788.0,0.839,16.175,113,69,47,22,44,26,18,19,0.0,0.0
1004,2092,26-09-2019 09:22:00,1,3139.0,2601.0,0.829,15.247,223,130,95,35,93,60,33,23,0.0,0.0
1004,2093,26-09-2019 09:24:00,1,3414.0,2839.0,0.832,16.596,74,51,34,17,23,9,14,0,0.0,0.0
1004,2094,26-09-2019 09:26:00,1,3311.5,2807.5,0.8485,16.1565,204,123,79,44,81,60,21,0,0.0,0.0
1004,2095,26-09-2019 09:28:00,1,3209.0,2776.0,0.865,15.717,286,223,175,48,63,33,30,0,0.0,0.0
1004,2096,26-09-2019 09:30:00,1,3408.0,2873.0,0.843,16.609,249,95,62,33,154,112,42,0,0.0,0.0
1004,2097,26-09-2019 09:32:00,1,3569.0,3151.0,0.883,17.55,245,97,68,29,148,117,31,58,0.09,0.0
1004,2098,26-09-2019 09:34:00,1,3594.0,3072.0,0.855,17.562,188,108,67,41,80,46,34,2,0.0,0.0
1004,2099,26-09-2019 09:36:00,1,3579.0,3147.0,0.879,17.587,404,222,167,55,182,124,58,1,0.02,0.02
1004,2100,26-09-2019 09:38:00,1,3565.0,3137.0,0.88,17.519,368,233,167,66,135,100,35,15,0.0,0.07
1004,2101,26-09-2019 09:40:00,1,3878.0,3285.0,0.847,18.918,91,69,39,30,22,8,14,0,0.0,0.0
1004,2102,26-09-2019 09:42:00,1,3557.0,3212.0,0.903,17.572,48,32,9,23,16,5,11,0,0.0,0.0
1004,2103,26-09-2019 09:44:00,1,3544.0,3209.0,0.905,17.516,22,17,3,14,5,0,5,0,0.0,0.0
1004,2104,26-09-2019 09:46:00,1,3562.0,3184.0,0.894,17.558,48,29,6,23,19,4,15,1,0.0,0.0
1004,2105,26-09-2019 09:48:00,1,3378.0,3001.0,0.888,16.633,29,14,3,11,15,2,13,0,0.0,0.0
1004,2106,26-09-2019 09:50:00,1,3330.0,2792.0,0.839,16.211,20,18,11,7,2,1,1,0,0.0,0.0
1004,2107,26-09-2019 09:52:00,1,3234.0,2641.0,0.817,15.665,47,40,20,20,7,1,6,1,0.0,0.0
1004,2108,26-09-2019 09:54:00,1,3427.0,2832.0,0.826,16.636,3,3,1,2,0,0,0,0,0.0,0.0
1004,2109,26-09-2019 09:56:00,1,3215.0,2751.0,0.856,15.711,3,2,0,2,1,0,1,0,0.0,0.0
1004,2110,26-09-2019 09:58:00,1,3222.0,2730.0,0.847,15.718,1,0,0,0,1,0,1,0,0.0,0.0
1004,2111,26-09-2019 10:00:00,1,3116.5,2647.0,0.8495,15.2095,4,2,0,2,2,0,2,0,0.0,0.0
1004,2112,26-09-2019 10:02:00,1,3011.0,2564.0,0.852,14.701,0,0,0,0,0,0,0,0,0.0,0.0
1004,2113,26-09-2019 10:04:00,1,2943.0,2465.0,0.838,14.323,10,7,2,5,3,0,3,0,0.0,0.0
1004,2114,26-09-2019 10:06:00,1,2962.0,2373.0,0.801,14.297,0,0,0,0,0,0,0,0,0.0,0.0
1004,2115,26-09-2019 10:08:00,1,2748.0,2316.0,0.843,13.39,11,11,6,5,0,0,0,0,0.0,0.0
1004,2116,26-09-2019 10:10:00,1,2960.0,2370.0,0.801,14.287,9,9,2,7,0,0,0,0,0.0,0.0
1004,2117,26-09-2019 10:12:00,1,2967.0,2398.0,0.808,14.347,17,12,5,7,5,4,1,0,0.0,0.0
1004,2118,26-09-2019 10:14:00,1,2960.0,2351.0,0.794,14.267,0,0,0,0,0,0,0,0,0.0,0.0
1004,2119,26-09-2019 10:16:00,1,2778.0,2167.0,0.78,13.346,11,5,1,4,6,5,1,0,0.0,0.0
1004,2120,26-09-2019 10:18:00,1,2787.0,2196.0,0.788,13.414,3,0,0,0,3,0,3,0,0.0,0.0
1004,2121,26-09-2019 10:20:00,1,2776.0,2163.0,0.779,13.335,0,0,0,0,0,0,0,0,0.0,0.0
1004,2122,26-09-2019 10:22:00,1,2784.0,2158.0,0.775,13.359,2,0,0,0,2,1,1,0,0.0,0.0
1004,2123,26-09-2019 10:24:00,1,2788.0,2147.0,0.77,13.363,2,0,0,0,2,0,2,0,0.0,0.0
1004,2124,26-09-2019 10:26:00,1,2583.0,2052.0,0.794,12.449,6,0,0,0,6,0,6,0,0.0,0.0
1004,2125,26-09-2019 10:28:00,1,2592.0,2016.0,0.778,12.445,2,0,0,0,2,0,2,0,0.0,0.0
1004,2126,26-09-2019 10:30:00,1,2585.0,2053.0,0.794,12.457,27,17,8,9,10,3,7,0,0.0,0.0
1004,2127,26-09-2019 10:32:00,1,2807.0,2100.0,0.748,13.385,157,60,33,27,97,63,34,15,0.0,0.0
1004,2128,26-09-2019 10:34:00,1,2790.0,2158.0,0.7735,13.383,320,181,137,44,139,100,39,56,0.0,0.0
1004,2129,26-09-2019 10:36:00,1,2773.0,2216.0,0.799,13.381,125,83,50,33,42,13,29,73,0.0,0.0
1004,2130,26-09-2019 10:38:00,1,2972.0,2345.0,0.789,14.306,73,55,28,27,18,0,18,59,0.0,0.0
1004,2131,26-09-2019 10:40:00,1,3165.0,2476.0,0.782,15.213,373,179,143,36,194,139,55,17,0.0,0.0
1004,2132,26-09-2019 10:42:00,1,3170.0,2455.0,0.774,15.21,544,249,186,63,295,224,71,1,0.04,0.0
1004,2133,26-09-2019 10:44:00,1,3285.0,2475.0,0.753,15.685,332,176,136,40,156,110,46,0,0.0,0.0
1004,2134,26-09-2019 10:46:00,1,3277.0,2536.0,0.774,15.718,221,89,52,37,132,95,37,3,0.0,0.0
1004,2135,26-09-2019 10:48:00,1,3272.0,2572.0,0.786,15.738,135,82,55,27,53,20,33,0,0.0,0.0
1004,2136,26-09-2019 10:50:00,1,3271.0,2502.0,0.765,15.657,90,71,32,39,19,4,15,3,0.0,0.0
1004,2137,26-09-2019 10:52:00,1,3252.0,2550.0,0.784,15.638,95,59,20,39,36,7,29,3,0.0,0.0
1004,2138,26-09-2019 10:54:00,1,3428.0,2793.0,0.815,16.597,24,6,0,6,18,2,16,0,0.0,0.0
1004,2139,26-09-2019 10:56:00,1,3400.0,2874.0,0.845,16.579,23,9,0,9,14,1,13,0,0.0,0.0
1004,2140,26-09-2019 10:58:00,1,3438.0,2755.0,0.801,16.594,10,1,0,1,9,0,9,0,0.0,0.0
1004,2141,26-09-2019 11:00:00,1,3255.0,2590.0,0.796,15.692,0,0,0,0,0,0,0,0,0.0,0.0
1004,2142,26-09-2019 11:02:00,1,3050.0,2477.0,0.812,14.759,2,0,0,0,2,0,2,0,0.0,0.0
1004,2143,26-09-2019 11:04:00,1,2959.0,2411.0,0.815,14.326,4,4,3,1,0,0,0,0,0.0,0.0
1004,2144,26-09-2019 11:06:00,1,2955.0,2422.0,0.82,14.325,0,0,0,0,0,0,0,0,0.0,0.0
1004,2145,26-09-2019 11:08:00,1,2955.0,2410.5,0.816,14.3115,3,0,0,0,3,0,3,0,0.0,0.0
1004,2146,26-09-2019 11:10:00,1,2955.0,2399.0,0.812,14.298,6,3,1,2,3,0,3,0,0.0,0.0
1004,2147,26-09-2019 11:12:00,1,3060.0,2433.0,0.795,14.75,1,0,0,0,1,1,0,0,0.0,0.0
1004,2148,26-09-2019 11:14:00,1,2997.0,2261.0,0.754,14.31,0,0,0,0,0,0,0,0,0.0,0.0
1004,2149,26-09-2019 11:16:00,1,2785.0,2180.0,0.783,13.388,6,0,0,0,6,3,3,0,0.0,0.0
1004,2150,26-09-2019 11:18:00,1,2781.0,2168.0,0.78,13.356,4,0,0,0,4,2,2,0,0.0,0.0
1004,2151,26-09-2019 11:20:00,1,2812.0,2095.0,0.745,13.398,0,0,0,0,0,0,0,0,0.0,0.0
1004,2152,26-09-2019 11:22:00,1,2790.0,2102.0,0.753,13.321,20,6,4,2,14,8,6,0,0.0,0.0
1004,2153,26-09-2019 11:24:00,1,2972.0,2313.0,0.778,14.273,5,2,1,1,3,3,0,0,0.0,0.0
1004,2154,26-09-2019 11:26:00,1,2987.0,2268.0,0.759,14.281,1,1,0,1,0,0,0,0,0.0,0.0
1004,2155,26-09-2019 11:28:00,1,2985.0,2300.0,0.77,14.308,0,0,0,0,0,0,0,0,0.0,0.0
1004,2156,26-09-2019 11:30:00,1,2994.0,2259.0,0.754,14.297,0,0,0,0,0,0,0,0,0.0,0.0
1004,2157,26-09-2019 11:32:00,1,3001.0,2202.0,0.734,14.264,2,2,1,1,0,0,0,0,0.0,0.0
1004,2158,26-09-2019 11:34:00,1,3019.0,2185.0,0.724,14.317,16,8,4,4,8,8,0,0,0.0,0.0
1004,2159,26-09-2019 11:36:00,1,2995.0,2247.0,0.75,14.289,0,0,0,0,0,0,0,0,0.0,0.0
1004,2160,26-09-2019 11:38:00,1,3014.0,2199.0,0.729,14.309,21,14,8,6,7,2,5,0,0.0,0.0
1004,2161,26-09-2019 11:40:00,1,3003.0,2217.0,0.738,14.288,4,3,1,2,1,1,0,0,0.0,0.0
1004,2162,26-09-2019 11:42:00,1,2809.0,2078.0,0.74,13.37,2,2,0,2,0,0,0,0,0.0,0.0
1004,2163,26-09-2019 11:44:00,1,2615.0,1939.0,0.742,12.452,48,23,13,10,25,11,14,0,0.0,0.0
1004,2164,26-09-2019 11:46:00,1,3018.0,2210.0,0.732,14.339,196,112,62,50,84,53,31,4,0.0,0.0
1004,2165,26-09-2019 11:48:00,1,3009.0,2263.0,0.752,14.362,180,115,80,35,65,45,20,120,0.0,0.0
1004,2166,26-09-2019 11:50:00,1,3081.0,2361.0,0.766,14.755,111,52,24,28,59,0,59,58,0.0,0.0
1004,2167,26-09-2019 11:52:00,1,3187.0,2423.0,0.76,15.239,110,64,37,27,46,0,46,43,0.0,0.0
1004,2168,26-09-2019 11:54:00,1,3255.0,2569.0,0.789,15.668,166,121,78,43,45,1,44,48,0.0,0.01
1004,2169,26-09-2019 11:56:00,1,3068.0,2456.0,0.801,14.806,406,271,217,54,135,94,41,4,0.0,0.02
1004,2170,26-09-2019 11:58:00,1,3454.0,2691.0,0.779,16.587,507,338,268,70,169,129,40,26,0.0,0.0
1004,2171,26-09-2019 12:00:00,1,2942.0,2437.0,0.829,14.289,276,116,86,30,160,130,30,5,0.0,0.0
1004,2172,26-09-2019 12:02:00,1,3332.0,2708.0,0.813,16.124,218,100,72,28,118,80,38,87,0.01,0.0
1004,2173,26-09-2019 12:04:00,1,3404.0,2899.0,0.852,16.623,316,152,112,40,164,121,43,6,0.0,0.0
1004,2174,26-09-2019 12:06:00,1,3607.0,2975.0,0.825,17.504,126,56,32,24,70,31,39,0,0.06,0.0
1004,2175,26-09-2019 12:08:00,1,3513.0,2949.0,0.839,17.106,112,70,34,36,42,25,17,0,0.0,0.0
1004,2176,26-09-2019 12:10:00,1,3597.0,3065.0,0.852,17.564,62,28,15,13,34,10,24,0,0.0,0.0
1004,2177,26-09-2019 12:12:00,1,3401.0,2908.0,0.855,16.621,68,25,9,16,43,14,29,0,0.0,0.0
1004,2178,26-09-2019 12:14:00,1,3604.0,3057.0,0.848,17.584,61,30,12,18,31,15,16,0,0.0,0.0
1004,2179,26-09-2019 12:16:00,1,3408.5,2873.5,0.8425,16.6105,6,4,1,3,2,0,2,0,0.0,0.0
1004,2180,26-09-2019 12:18:00,1,3213.0,2690.0,0.837,15.637,2,2,0,2,0,0,0,0,0.0,0.0
1004,2181,26-09-2019 12:20:00,1,3244.0,2615.0,0.806,15.678,7,3,0,3,4,1,3,0,0.0,0.0
1004,2182,26-09-2019 12:22:00,1,3050.0,2534.0,0.831,14.822,11,9,0,9,2,0,2,0,0.0,0.0
1004,2183,26-09-2019 12:24:00,1,2945.0,2442.0,0.829,14.305,25,7,4,3,18,11,7,0,0.0,0.0
1004,2184,26-09-2019 12:26:00,1,2950.0,2392.0,0.811,14.27,5,1,0,1,4,0,4,0,0.0,0.0
1004,2185,26-09-2019 12:28:00,1,2739.0,2331.0,0.851,13.371,2,0,0,0,2,1,1,0,0.0,0.0
1004,2186,26-09-2019 12:30:00,1,2754.0,2300.0,0.835,13.397,12,4,2,2,8,1,7,0,0.0,0.0
1004,2187,26-09-2019 12:32:00,1,2969.0,2369.0,0.798,14.321,6,2,0,2,4,2,2,0,0.0,0.0
1004,2188,26-09-2019 12:34:00,1,2957.0,2383.0,0.806,14.29,5,2,1,1,3,0,3,0,0.0,0.0
1004,2189,26-09-2019 12:36:00,1,2943.0,2453.0,0.833,14.31,25,13,5,8,12,6,6,0,0.0,0.0
1004,2190,26-09-2019 12:38:00,1,2942.0,2431.0,0.826,14.284,0,0,0,0,0,0,0,0,0.0,0.0
1004,2191,26-09-2019 12:40:00,1,2957.0,2354.0,0.796,14.258,6,5,1,4,1,0,1,0,0.0,0.0
1004,2192,26-09-2019 12:42:00,1,2978.0,2306.0,0.774,14.285,28,15,9,6,13,5,8,0,0.0,0.0
1004,2193,26-09-2019 12:44:00,1,2963.0,2362.0,0.797,14.289,9,0,0,0,9,1,8,0,0.0,0.0
1004,2194,26-09-2019 12:46:00,1,2943.0,2425.0,0.824,14.281,25,18,5,13,7,2,5,0,0.0,0.0
1004,2195,26-09-2019 12:48:00,1,3246.0,2610.0,0.804,15.68,20,2,2,0,18,8,10,0,0.0,0.0
1004,2196,26-09-2019 12:50:00,1,3115.5,2451.0,0.786,14.989,7,3,2,1,4,3,1,0,0.0,0.0
1004,2197,26-09-2019 12:52:00,1,2985.0,2292.0,0.768,14.298,0,0,0,0,0,0,0,0,0.0,0.0
1004,2198,26-09-2019 12:54:00,1,2782.0,2189.0,0.787,13.385,0,0,0,0,0,0,0,0,0.0,0.0
1004,2199,26-09-2019 12:56:00,1,2804.0,2143.0,0.764,13.422,40,18,12,6,22,16,6,0,0.0,0.0
1004,2200,26-09-2019 12:58:00,1,2881.0,2249.0,0.781,13.843,0,0,0,0,0,0,0,0,0.0,0.0
1004,2201,26-09-2019 13:00:00,1,2986.0,2280.0,0.764,14.291,0,0,0,0,0,0,0,0,0.0,0.0
1004,2202,26-09-2019 13:02:00,1,2875.0,2256.0,0.785,13.824,0,0,0,0,0,0,0,0,0.0,0.0
1004,2203,26-09-2019 13:04:00,1,2983.0,2254.0,0.755,14.25,7,0,0,0,7,1,6,0,0.0,0.0
1004,2204,26-09-2019 13:06:00,1,2883.0,2226.0,0.772,13.825,15,6,3,3,9,4,5,0,0.0,0.0
1004,2205,26-09-2019 13:08:00,1,2788.0,2181.0,0.782,13.398,45,19,11,8,26,20,6,0,0.0,0.0
1004,2206,26-09-2019 13:10:00,1,2788.0,2146.0,0.77,13.361,13,11,5,6,2,1,1,0,0.0,0.0
1004,2207,26-09-2019 13:12:00,1,2588.0,2039.0,0.788,12.456,8,4,2,2,4,2,2,0,0.0,0.0
1004,2208,26-09-2019 13:14:00,1,2705.0,2045.0,0.756,12.924,21,12,4,8,9,1,8,0,0.0,0.0
1004,2209,26-09-2019 13:16:00,1,2988.0,2263.0,0.757,14.279,17,1,0,1,16,12,4,0,0.0,0.0
1004,2210,26-09-2019 13:18:00,1,2775.0,2219.0,0.799,13.392,12,3,2,1,9,5,4,0,0.0,0.0
1004,2211,26-09-2019 13:20:00,1,2783.0,2185.0,0.785,13.383,5,1,1,0,4,2,2,0,0.0,0.0
1004,2212,26-09-2019 13:22:00,1,2800.0,2124.0,0.759,13.385,15,8,4,4,7,4,3,0,0.0,0.0
1004,2213,26-09-2019 13:24:00,1,2779.5,2165.5,0.7795,13.3495,135,66,42,24,69,42,27,17,0.0,0.0
1004,2214,26-09-2019 13:26:00,1,2759.0,2207.0,0.8,13.314,24,21,7,14,3,0,3,0,0.0,0.0
1004,2215,26-09-2019 13:28:00,1,2971.0,2328.0,0.784,14.284,41,36,15,21,5,0,5,1,0.0,0.0
1004,2216,26-09-2019 13:30:00,1,3263.0,2517.0,0.771,15.643,86,67,32,35,19,6,13,1,0.0,0.0
1004,2217,26-09-2019 13:32:00,1,3254.0,2546.0,0.782,15.639,172,110,80,30,62,41,21,26,0.0,0.0
1004,2218,26-09-2019 13:34:00,1,3457.0,2731.0,0.79,16.644,104,79,41,38,25,11,14,2,0.0,0.0
1004,2219,26-09-2019 13:36:00,1,3442.0,2748.0,0.798,16.605,63,44,29,15,19,10,9,0,0.0,0.0
1004,2220,26-09-2019 13:38:00,1,3266.0,2582.0,0.791,15.728,35,11,0,11,24,1,23,0,0.0,0.0
1004,2221,26-09-2019 13:40:00,1,3270.0,2527.0,0.773,15.684,64,22,6,16,42,7,35,0,0.0,0.0
1004,2222,26-09-2019 13:42:00,1,3454.0,2710.0,0.784,16.61,56,25,6,19,31,9,22,0,0.0,0.0
1004,2223,26-09-2019 13:44:00,1,3436.0,2737.0,0.797,16.571,30,4,1,3,26,6,20,0,0.0,0.0
1004,2224,26-09-2019 13:46:00,1,3234.0,2678.0,0.828,15.707,29,0,0,0,29,11,18,0,0.0,0.0
1004,2225,26-09-2019 13:48:00,1,3170.0,2493.0,0.787,15.248,3,0,0,0,3,0,3,0,0.0,0.0
1004,2226,26-09-2019 13:50:00,1,2996.0,2285.0,0.763,14.336,3,0,0,0,3,0,3,0,0.0,0.0
1004,2227,26-09-2019 13:52:00,1,2798.0,2150.0,0.768,13.404,1,0,0,0,1,0,1,0,0.0,0.0
1004,2228,26-09-2019 13:54:00,1,2700.0,2075.0,0.768,12.935,0,0,0,0,0,0,0,0,0.0,0.0
1004,2229,26-09-2019 13:56:00,1,2599.0,2008.0,0.772,12.465,9,5,3,2,4,0,4,0,0.0,0.0
1004,2230,26-09-2019 13:58:00,1,2593.5,1999.5,0.7705,12.434,0,0,0,0,0,0,0,0,0.0,0.0
1004,2231,26-09-2019 14:00:00,1,2588.0,1991.0,0.769,12.403,0,0,0,0,0,0,0,0,0.0,0.0
1004,2232,26-09-2019 14:02:00,1,2602.0,2024.0,0.778,12.493,27,19,9,10,8,3,5,0,0.0,0.0
1004,2233,26-09-2019 14:04:00,1,2799.0,2095.0,0.748,13.346,8,6,2,4,2,0,2,0,0.0,0.0
1004,2234,26-09-2019 14:06:00,1,2888.0,2204.0,0.763,13.818,0,0,0,0,0,0,0,0,0.0,0.0
1004,2235,26-09-2019 14:08:00,1,2794.0,2133.0,0.763,13.371,14,12,5,7,2,0,2,0,0.0,0.0
1004,2236,26-09-2019 14:10:00,1,2795.0,2157.0,0.772,13.402,0,0,0,0,0,0,0,0,0.0,0.0
1004,2237,26-09-2019 14:12:00,1,2787.0,2175.0,0.78,13.388,0,0,0,0,0,0,0,0,0.0,0.0
1004,2238,26-09-2019 14:14:00,1,2899.0,2162.0,0.746,13.815,8,7,4,3,1,0,1,0,0.0,0.0
1004,2239,26-09-2019 14:16:00,1,2814.0,2047.0,0.728,13.354,4,4,1,3,0,0,0,0,0.0,0.0
1004,2240,26-09-2019 14:18:00,1,2830.0,2018.0,0.713,13.387,0,0,0,0,0,0,0,0,0.0,0.0
1004,2241,26-09-2019 14:20:00,1,2715.0,1993.0,0.734,12.904,2,2,1,1,0,0,0,0,0.0,0.0
1004,2242,26-09-2019 14:22:00,1,2717.0,2003.0,0.737,12.922,6,6,1,5,0,0,0,0,0.0,0.0
1004,2243,26-09-2019 14:24:00,1,2821.0,2056.0,0.729,13.392,0,0,0,0,0,0,0,0,0.0,0.0
1004,2244,26-09-2019 14:26:00,1,2839.0,2001.0,0.705,13.403,3,0,0,0,3,1,2,0,0.0,0.0
1004,2245,26-09-2019 14:28:00,1,2720.0,1969.0,0.724,12.896,1,1,0,1,0,0,0,0,0.0,0.0
1004,2246,26-09-2019 14:30:00,1,2623.0,1934.0,0.737,12.475,2,2,2,0,0,0,0,0,0.0,0.0
1004,2247,26-09-2019 14:32:00,1,2623.0,1922.5,0.733,12.462,0,0,0,0,0,0,0,0,0.0,0.0
1004,2248,26-09-2019 14:34:00,1,2623.0,1911.0,0.729,12.449,5,3,1,2,2,0,2,0,0.0,0.0
1004,2249,26-09-2019 14:36:00,1,2632.0,1877.0,0.713,12.448,3,0,0,0,3,0,3,0,0.0,0.0
1004,2250,26-09-2019 14:38:00,1,2516.0,1808.0,0.719,11.915,47,26,17,9,21,12,9,0,0.0,0.0
1004,2251,26-09-2019 14:40:00,1,2721.0,1971.0,0.724,12.902,71,31,20,11,40,29,11,6,0.0,0.0
1004,2252,26-09-2019 14:42:00,1,2811.0,2058.0,0.732,13.356,119,61,31,30,58,21,37,0,0.0,0.0
1004,2253,26-09-2019 14:44:00,1,2990.0,2242.0,0.75,14.262,144,85,46,39,59,35,24,0,0.0,0.0
1004,2254,26-09-2019 14:46:00,1,3072.0,2373.0,0.772,14.733,106,63,33,30,43,16,27,22,0.0,0.0
1004,2255,26-09-2019 14:48:00,1,3184.0,2423.0,0.761,15.229,83,58,24,34,25,2,23,56,0.0,0.0
1004,2256,26-09-2019 14:50:00,1,3265.0,2539.0,0.778,15.677,119,86,50,36,33,2,31,83,0.0,0.0
1004,2257,26-09-2019 14:52:00,1,3362.0,2614.0,0.777,16.142,73,44,17,27,29,2,27,61,0.0,0.07
1004,2258,26-09-2019 14:54:00,1,3486.0,2637.0,0.756,16.653,102,65,29,36,37,0,37,43,0.0,0.09
1004,2259,26-09-2019 14:56:00,1,3455.0,2726.0,0.789,16.633,301,169,138,31,132,93,39,43,0.07,0.0
1004,2260,26-09-2019 14:58:00,1,3424.0,2830.0,0.826,16.623,114,47,20,27,67,32,35,0,0.0,0.0
1004,2261,26-09-2019 15:00:00,1,3529.0,2833.0,0.803,17.043,14,9,1,8,5,1,4,0,0.0,0.0
1004,2262,26-09-2019 15:02:00,1,3436.0,2788.0,0.811,16.626,45,13,8,5,32,8,24,0,0.0,0.0
1004,2263,26-09-2019 15:04:00,1,3410.0,2788.0,0.817,16.524,26,8,1,7,18,3,15,0,0.01,0.0
1004,2264,26-09-2019 15:06:00,1,3404.5,2812.0,0.8255,16.5285,5,2,0,2,3,1,2,0,0.0,0.0
1004,2265,26-09-2019 15:08:00,1,3399.0,2836.0,0.834,16.533,0,0,0,0,0,0,0,0,0.0,0.0
1004,2266,26-09-2019 15:10:00,1,3212.0,2720.0,0.847,15.665,5,2,0,2,3,1,2,0,0.0,0.0
1004,2267,26-09-2019 15:12:00,1,2951.0,2378.0,0.806,14.259,1,0,0,0,1,0,1,0,0.0,0.0
1004,2268,26-09-2019 15:14:00,1,2759.0,2231.0,0.809,13.34,12,0,0,0,12,2,10,0,0.0,0.0
1004,2269,26-09-2019 15:16:00,1,2787.0,2182.0,0.783,13.396,17,5,1,4,12,0,12,0,0.0,0.0
1004,2270,26-09-2019 15:18:00,1,2683.0,2135.0,0.796,12.935,13,11,0,11,2,0,2,0,0.0,0.0
1004,2271,26-09-2019 15:20:00,1,2674.0,2162.0,0.808,12.931,2,2,0,2,0,0,0,0,0.0,0.0
1004,2272,26-09-2019 15:22:00,1,2763.0,2221.0,0.804,13.345,1,1,0,1,0,0,0,0,0.0,0.0
1004,2273,26-09-2019 15:24:00,1,2751.0,2266.0,0.824,13.347,14,8,5,3,6,1,5,0,0.0,0.0
1004,2274,26-09-2019 15:26:00,1,2859.0,2343.0,0.82,13.857,1,0,0,0,1,0,1,0,0.0,0.0
1004,2275,26-09-2019 15:28:00,1,2949.0,2426.0,0.823,14.304,3,0,0,0,3,0,3,0,0.0,0.0
1004,2276,26-09-2019 15:30:00,1,2937.0,2453.0,0.835,14.287,7,0,0,0,7,0,7,0,0.0,0.0
1004,2277,26-09-2019 15:32:00,1,2937.0,2418.0,0.823,14.247,1,0,0,0,1,0,1,0,0.0,0.0
1004,2278,26-09-2019 15:34:00,1,2859.0,2276.0,0.796,13.784,26,17,5,12,9,4,5,0,0.0,0.0
1004,2279,26-09-2019 15:36:00,1,2982.0,2313.0,0.776,14.311,3,3,0,3,0,0,0,0,0.0,0.0
1004,2280,26-09-2019 15:38:00,1,2759.0,2240.0,0.812,13.351,12,12,0,12,0,0,0,0,0.0,0.0
1004,2281,26-09-2019 15:40:00,1,2813.0,2254.5,0.802,13.579,4,4,0,4,0,0,0,0,0.0,0.0
1004,2282,26-09-2019 15:42:00,1,2867.0,2269.0,0.792,13.807,25,25,0,25,0,0,0,0,0.0,0.0
1004,2283,26-09-2019 15:44:00,1,2970.0,2360.0,0.795,14.315,5,1,0,1,4,1,3,0,0.0,0.0
1004,2284,26-09-2019 15:46:00,1,2881.0,2273.0,0.789,13.869,25,12,8,4,13,5,8,0,0.0,0.0
1004,2285,26-09-2019 15:48:00,1,2969.0,2383.0,0.803,14.336,6,4,0,4,2,0,2,0,0.0,0.0
1004,2286,26-09-2019 15:50:00,1,2950.0,2450.0,0.83,14.334,1,0,0,0,1,0,1,0,0.0,0.0
1004,2287,26-09-2019 15:52:00,1,2947.0,2418.0,0.82,14.29,48,8,6,2,40,26,14,9,0.0,0.0
1004,2288,26-09-2019 15:54:00,1,2965.0,2389.0,0.806,14.326,105,75,36,39,30,0,30,56,0.0,0.0
1004,2289,26-09-2019 15:56:00,1,3275.0,2501.0,0.764,15.671,133,74,41,33,59,0,59,79,0.0,0.0
1004,2290,26-09-2019 15:58:00,1,3250.0,2574.0,0.792,15.655,117,72,31,41,45,0,45,37,0.0,0.0
1004,2291,26-09-2019 16:00:00,1,3243.0,2670.0,0.823,15.735,186,127,82,45,59,18,41,41,0.15,0.06
1004,2292,26-09-2019 16:02:00,1,3404.0,2862.0,0.841,16.58,143,88,55,33,55,27,28,12,0.0,0.01
1004,2293,26-09-2019 16:04:00,1,3605.0,3006.0,0.834,17.534,89,26,8,18,63,33,30,0,0.0,0.01
1004,2294,26-09-2019 16:06:00,1,3576.0,3084.0,0.862,17.505,79,12,5,7,67,35,32,0,0.0,0.0
1004,2295,26-09-2019 16:08:00,1,3586.0,3087.0,0.861,17.549,76,34,12,22,42,10,32,0,0.0,0.0
1004,2296,26-09-2019 16:10:00,1,3579.0,3061.0,0.855,17.492,55,29,9,20,26,5,21,0,0.0,0.0
1004,2297,26-09-2019 16:12:00,1,3590.0,3038.0,0.846,17.508,37,9,1,8,28,10,18,0,0.0,0.0
1004,2298,26-09-2019 16:14:00,1,3419.5,2839.5,0.8295,16.616,0,0,0,0,0,0,0,0,0.0,0.0
1004,2299,26-09-2019 16:16:00,1,3249.0,2641.0,0.813,15.724,0,0,0,0,0,0,0,0,0.0,0.0
1004,2300,26-09-2019 16:18:00,1,3041.0,2520.0,0.829,14.77,0,0,0,0,0,0,0,0,0.0,0.0
1004,2301,26-09-2019 16:20:00,1,2929.0,2498.0,0.853,14.305,8,2,1,1,6,3,3,0,0.0,0.0
1004,2302,26-09-2019 16:22:00,1,2927.0,2461.0,0.841,14.257,4,1,1,0,3,0,3,0,0.0,0.01
1004,2303,26-09-2019 16:24:00,1,2942.0,2502.0,0.85,14.363,4,3,1,2,1,0,1,0,0.0,0.0
1004,2304,26-09-2019 16:26:00,1,2925.0,2529.0,0.865,14.324,22,20,4,16,2,1,1,0,0.0,0.0
1004,2305,26-09-2019 16:28:00,1,2921.0,2562.0,0.877,14.347,3,3,0,3,0,0,0,0,0.0,0.0
1004,2306,26-09-2019 16:30:00,1,2928.0,2467.0,0.843,14.267,6,6,0,6,0,0,0,0,0.0,0.0
1004,2307,26-09-2019 16:32:00,1,2947.0,2432.0,0.825,14.302,0,0,0,0,0,0,0,0,0.0,0.0
1004,2308,26-09-2019 16:34:00,1,2739.0,2371.0,0.866,13.415,5,4,1,3,1,0,1,0,0.0,0.0
1004,2309,26-09-2019 16:36:00,1,2748.0,2315.0,0.843,13.392,3,0,0,0,3,0,3,0,0.0,0.0
1004,2310,26-09-2019 16:38:00,1,2662.0,2209.0,0.83,12.935,5,0,0,0,5,0,5,0,0.0,0.0
1004,2311,26-09-2019 16:40:00,1,2772.0,2220.0,0.801,13.382,4,0,0,0,4,0,4,0,0.0,0.0
1004,2312,26-09-2019 16:42:00,1,2763.0,2249.0,0.814,13.378,2,0,0,0,2,0,2,0,0.0,0.0
1004,2313,26-09-2019 16:44:00,1,2748.0,2269.0,0.826,13.34,4,3,0,3,1,0,1,0,0.0,0.0
1004,2314,26-09-2019 16:46:00,1,2949.0,2478.0,0.84,14.362,11,9,2,7,2,0,2,0,0.0,0.0
1004,2315,26-09-2019 16:48:00,1,2988.5,2506.0,0.8385,14.5485,25,13,4,9,12,6,6,0,0.0,0.0
1004,2316,26-09-2019 16:50:00,1,3028.0,2534.0,0.837,14.735,1,0,0,0,1,0,1,0,0.0,0.0
1004,2317,26-09-2019 16:52:00,1,2962.0,2356.0,0.795,14.278,2,0,0,0,2,1,1,0,0.0,0.0
1004,2318,26-09-2019 16:54:00,1,2740.0,2304.0,0.841,13.345,10,5,2,3,5,2,3,0,0.0,0.0
1004,2319,26-09-2019 16:56:00,1,2964.0,2372.0,0.8,14.307,20,8,3,5,12,6,6,0,0.0,0.0
1004,2320,26-09-2019 16:58:00,1,2942.0,2450.0,0.833,14.306,37,22,5,17,15,3,12,0,0.0,0.0
1004,2321,26-09-2019 17:00:00,1,3036.0,2502.0,0.824,14.732,100,60,32,28,40,18,22,1,0.0,0.01
1004,2322,26-09-2019 17:02:00,1,3445.0,2777.0,0.806,16.649,118,68,44,24,50,21,29,1,0.0,0.0
1004,2323,26-09-2019 17:04:00,1,3418.0,2888.0,0.845,16.664,176,98,61,37,78,43,35,35,0.0,0.0
1004,2324,26-09-2019 17:06:00,1,3396.0,2958.0,0.871,16.657,125,80,50,30,45,0,45,75,0.0,0.02
1004,2325,26-09-2019 17:08:00,1,3595.0,3000.0,0.835,17.484,134,75,41,34,59,11,48,84,0.0,0.04
1004,2326,26-09-2019 17:10:00,1,3589.0,3065.0,0.854,17.534,142,89,52,37,53,1,52,68,0.0,0.05
1004,2327,26-09-2019 17:12:00,1,3567.0,3121.0,0.875,17.508,351,149,108,41,202,150,52,38,0.0,0.01
1004,2328,26-09-2019 17:14:00,1,3793.0,3198.0,0.843,18.484,176,36,7,29,140,113,27,0,0.0,0.0
1004,2329,26-09-2019 17:16:00,1,3877.0,3307.0,0.853,18.938,89,32,5,27,57,30,27,0,0.0,0.0
1004,2330,26-09-2019 17:18:00,1,3593.0,3025.0,0.842,17.507,74,48,13,35,26,11,15,0,0.0,0.0
1004,2331,26-09-2019 17:20:00,1,3778.0,3229.0,0.855,18.462,85,44,23,21,41,13,28,0,0.0,0.01
1004,2332,26-09-2019 17:22:00,1,3598.5,3037.0,0.8435,17.5415,24,7,2,5,17,3,14,0,0.0,0.0
1004,2333,26-09-2019 17:24:00,1,3419.0,2845.0,0.832,16.621,99,97,68,29,2,0,2,0,0.0,0.0
1004,2334,26-09-2019 17:26:00,1,3324.0,2761.0,0.831,16.155,10,7,2,5,3,0,3,0,0.0,0.0
1004,2335,26-09-2019 17:28:00,1,3217.0,2674.0,0.831,15.637,11,3,1,2,8,5,3,0,0.0,0.0
1004,2336,26-09-2019 17:30:00,1,3253.0,2632.0,0.809,15.73,8,7,0,7,1,1,0,0,0.0,0.0
1004,2337,26-09-2019 17:32:00,1,3246.0,2633.0,0.811,15.704,34,11,5,6,23,9,14,0,0.0,0.0
1004,2338,26-09-2019 17:34:00,1,3229.0,2683.0,0.831,15.691,46,28,5,23,18,0,18,0,0.0,0.01
1004,2339,26-09-2019 17:36:00,1,3211.0,2726.0,0.849,15.67,7,3,0,3,4,4,0,0,0.0,0.0
1004,2340,26-09-2019 17:38:00,1,3198.0,2763.0,0.864,15.66,35,14,12,2,21,13,8,0,0.0,0.0
1004,2341,26-09-2019 17:40:00,1,3124.0,2616.0,0.837,15.206,8,5,3,2,3,1,2,0,0.0,0.0
1004,2342,26-09-2019 17:42:00,1,3221.0,2715.0,0.843,15.695,20,17,2,15,3,2,1,0,0.0,0.01
1004,2343,26-09-2019 17:44:00,1,3130.0,2590.0,0.827,15.201,116,57,30,27,59,28,31,0,0.0,0.0
1004,2344,26-09-2019 17:46:00,1,3388.0,3007.0,0.888,16.68,143,75,29,46,68,33,35,9,0.0,0.0
1004,2345,26-09-2019 17:48:00,1,3530.0,3248.0,0.92,17.504,128,91,52,39,37,0,37,84,0.0,0.04
1004,2346,26-09-2019 17:50:00,1,3862.0,3387.0,0.877,18.966,132,82,47,35,50,0,50,82,0.0,0.0
1004,2347,26-09-2019 17:52:00,1,3947.0,3458.0,0.876,19.381,96,51,23,28,45,0,45,64,0.0,0.0
1004,2348,26-09-2019 17:54:00,1,3947.0,3458.0,0.876,19.378,165,92,55,37,73,33,40,50,0.03,0.02
1004,2349,26-09-2019 17:56:00,1,3897.5,3448.0,0.8845,19.1735,151,102,62,40,49,12,37,66,0.0,0.04
1004,2350,26-09-2019 17:58:00,1,3848.0,3438.0,0.893,18.969,263,156,117,39,107,80,27,64,0.08,0.1
1004,2351,26-09-2019 18:00:00,0,3821.0,3435.0,0.899,18.86,227,122,85,37,105,61,44,58,0.0,0.0
1004,2352,26-09-2019 18:02:00,0,4294.0,4009.0,0.933,21.358,651,494,409,85,157,120,37,26,0.0,0.0
1004,2353,26-09-2019 18:04:00,0,4474.0,4057.0,0.907,22.121,395,193,143,50,202,155,47,38,0.0,0.0
1004,2354,26-09-2019 18:06:00,0,4472.0,4081.0,0.912,22.139,468,256,197,59,212,151,61,60,0.03,0.0
1004,2355,26-09-2019 18:08:00,0,4296.0,3859.0,0.898,21.2,208,116,74,42,92,49,43,26,0.0,0.0
1004,2356,26-09-2019 18:10:00,0,4287.0,3935.0,0.918,21.247,45,37,16,21,8,3,5,0,0.0,0.0
1004,2357,26-09-2019 18:12:00,0,4280.0,3944.0,0.922,21.228,37,35,5,30,2,1,1,0,0.0,0.0
1004,2358,26-09-2019 18:14:00,0,4275.0,3946.0,0.923,21.212,99,67,30,37,32,10,22,3,0.0,0.0
1004,2359,26-09-2019 18:16:00,0,4276.0,4024.0,0.941,21.301,65,49,24,25,16,5,11,5,0.0,0.0
1004,2360,26-09-2019 18:18:00,0,4291.0,3892.0,0.907,21.215,20,20,8,12,0,0,0,0,0.0,0.0
1004,2361,26-09-2019 18:20:00,0,4015.0,3698.0,0.921,19.914,29,28,15,13,1,0,1,0,0.0,0.0
1004,2362,26-09-2019 18:22:00,0,3927.0,3529.0,0.899,19.377,15,12,4,8,3,1,2,0,0.0,0.0
1004,2363,26-09-2019 18:24:00,0,3840.0,3514.0,0.915,19.018,9,5,0,5,4,0,4,0,0.0,0.0
1004,2364,26-09-2019 18:26:00,0,3639.0,3307.0,0.909,17.998,8,1,1,0,7,0,7,0,0.0,0.0
1004,2365,26-09-2019 18:28:00,0,3525.0,3251.0,0.922,17.488,81,61,26,35,20,1,19,1,0.0,0.0
1004,2366,26-09-2019 18:30:00,0,3775.5,3431.5,0.9095,18.6755,477,352,292,60,125,89,36,39,0.0,0.0
1004,2367,26-09-2019 18:32:00,0,4026.0,3612.0,0.897,19.863,364,213,162,51,151,115,36,43,0.0,0.0
1004,2368,26-09-2019 18:34:00,0,3927.0,3580.0,0.912,19.438,255,137,102,35,118,87,31,12,0.0,0.0
1004,2369,26-09-2019 18:36:00,0,3631.0,3325.0,0.916,17.986,414,280,218,62,134,101,33,56,0.0,0.0
1004,2370,26-09-2019 18:38:00,0,4028.0,3571.0,0.887,19.824,140,91,53,38,49,26,23,6,0.0,0.0
1004,2371,26-09-2019 18:40:00,0,3947.0,3535.0,0.896,19.467,259,137,110,27,122,90,32,23,0.0,0.0
1004,2372,26-09-2019 18:42:00,0,3840.0,3419.0,0.89,18.916,176,108,75,33,68,46,22,50,0.0,0.0
1004,2373,26-09-2019 18:44:00,0,3959.0,3478.0,0.878,19.45,104,80,29,51,24,5,19,1,0.0,0.0
1004,2374,26-09-2019 18:46:00,0,3883.0,3344.0,0.861,19.001,267,182,138,44,85,58,27,26,0.0,0.0
1004,2375,26-09-2019 18:48:00,0,3948.0,3460.0,0.876,19.387,400,253,202,51,147,102,45,160,0.0,0.0
1004,2376,26-09-2019 18:50:00,0,4142.0,3601.0,0.869,20.306,152,44,30,14,108,87,21,22,0.02,0.0
1004,2377,26-09-2019 18:52:00,0,3783.0,3226.0,0.853,18.477,236,174,120,54,62,47,15,25,0.0,0.0
1004,2378,26-09-2019 18:54:00,0,3873.0,3292.0,0.85,18.904,96,73,39,34,23,9,14,0,0.0,0.0
1004,2379,26-09-2019 18:56:00,0,3693.0,3103.0,0.84,17.985,76,63,32,31,13,2,11,7,0.0,0.0
1004,2380,26-09-2019 18:58:00,0,3899.0,3200.0,0.821,18.904,91,53,31,22,38,25,13,7,0.0,0.0
1004,2381,26-09-2019 19:00:00,0,3890.0,3223.0,0.829,18.895,142,72,41,31,70,51,19,15,0.01,0.0
1004,2382,26-09-2019 19:02:00,0,3894.0,3197.0,0.821,18.88,108,74,47,27,34,12,22,3,0.0,0.0
1004,2383,26-09-2019 19:04:00,0,3899.0,3183.5,0.8165,18.885,136,83,54,29,53,36,17,16,0.0,0.0
1004,2384,26-09-2019 19:06:00,0,3904.0,3170.0,0.812,18.89,92,58,33,25,34,17,17,9,0.0,0.0
1004,2385,26-09-2019 19:08:00,0,3910.0,3176.0,0.812,18.923,81,61,28,33,20,6,14,1,0.0,0.0
1004,2386,26-09-2019 19:10:00,0,3904.0,3189.0,0.817,18.913,25,17,7,10,8,3,5,0,0.0,0.0
1004,2387,26-09-2019 19:12:00,0,3598.0,3005.0,0.835,17.504,3,1,0,1,2,1,1,0,0.0,0.0
1004,2388,26-09-2019 19:14:00,0,3417.0,2839.0,0.831,16.608,0,0,0,0,0,0,0,0,0.0,0.0
1004,2389,26-09-2019 19:16:00,0,3451.0,2702.0,0.783,16.588,2,2,0,2,0,0,0,0,0.0,0.0
1004,2390,26-09-2019 19:18:00,0,3241.0,2625.0,0.81,15.675,41,39,16,23,2,2,0,0,0.0,0.0
1004,2391,26-09-2019 19:20:00,0,3429.0,2789.0,0.814,16.598,18,18,11,7,0,0,0,0,0.0,0.0
1004,2392,26-09-2019 19:22:00,0,3448.0,2748.0,0.797,16.627,21,21,13,8,0,0,0,0,0.0,0.0
1004,2393,26-09-2019 19:24:00,0,3257.0,2577.0,0.791,15.686,15,15,10,5,0,0,0,0,0.0,0.0
1004,2394,26-09-2019 19:26:00,0,2949.0,2441.0,0.828,14.321,36,18,12,6,18,9,9,0,0.0,0.0
1004,2395,26-09-2019 19:28:00,0,2971.0,2394.0,0.806,14.355,208,103,66,37,105,76,29,6,0.0,0.0
1004,2396,26-09-2019 19:30:00,0,3159.0,2454.0,0.777,15.165,49,30,12,18,19,4,15,2,0.0,0.0
1004,2397,26-09-2019 19:32:00,0,3249.0,2615.0,0.805,15.695,248,143,102,41,105,78,27,15,0.0,0.0
1004,2398,26-09-2019 19:34:00,0,2960.0,2411.0,0.814,14.332,170,114,71,43,56,35,21,9,0.0,0.0
1004,2399,26-09-2019 19:36:00,0,3477.0,2686.0,0.772,16.674,288,162,114,48,126,97,29,47,0.0,0.0
1004,2400,26-09-2019 19:38:00,0,3465.0,2708.0,0.7815,16.6505,116,80,51,29,36,17,19,18,0.0,0.0
1004,2401,26-09-2019 19:40:00,0,3453.0,2730.0,0.791,16.627,261,155,118,37,106,78,28,55,0.0,0.0
1004,2402,26-09-2019 19:42:00,0,3450.0,2761.0,0.8,16.651,147,90,55,35,57,31,26,10,0.0,0.0
1004,2403,26-09-2019 19:44:00,0,3436.0,2766.0,0.805,16.599,386,190,146,44,196,146,50,30,0.0,0.0
1004,2404,26-09-2019 19:46:00,0,3651.0,2826.0,0.774,17.513,203,134,95,39,69,39,30,10,0.0,0.0
1004,2405,26-09-2019 19:48:00,0,3477.0,2589.0,0.745,16.568,308,234,168,66,74,43,31,13,0.0,0.0
1004,2406,26-09-2019 19:50:00,0,3545.0,2779.0,0.784,17.047,215,144,112,32,71,51,20,78,0.0,0.0
1004,2407,26-09-2019 19:52:00,0,3447.0,2751.0,0.798,16.628,434,237,194,43,197,150,47,25,0.0,0.0
1004,2408,26-09-2019 19:54:00,0,3683.0,2754.0,0.748,17.56,60,37,17,20,23,8,15,2,0.0,0.0
1004,2409,26-09-2019 19:56:00,0,3469.0,2624.0,0.756,16.573,181,115,75,40,66,47,19,24,0.03,0.0
1004,2410,26-09-2019 19:58:00,0,3457.0,2701.0,0.781,16.613,115,73,39,34,42,27,15,7,0.0,0.0
1004,2411,26-09-2019 20:00:00,0,3306.0,2421.0,0.732,15.709,167,81,63,18,86,59,27,40,0.0,0.0
1004,2412,26-09-2019 20:02:00,0,3465.0,2705.0,0.781,16.649,250,114,85,29,136,81,55,25,0.07,0.0
1004,2413,26-09-2019 20:04:00,0,3497.0,2567.0,0.734,16.619,136,80,55,25,56,42,14,22,0.0,0.0
1004,2414,26-09-2019 20:06:00,0,3483.0,2601.0,0.747,16.601,86,46,22,24,40,18,22,8,0.0,0.0
1004,2415,26-09-2019 20:08:00,0,3305.0,2398.0,0.725,15.677,20,9,4,5,11,0,11,4,0.0,0.0
1004,2416,26-09-2019 20:10:00,0,3399.0,2490.0,0.733,16.147,25,12,3,9,13,4,9,7,0.0,0.0
1004,2417,26-09-2019 20:12:00,0,3451.0,2519.0,0.7305,16.385,10,0,0,0,10,0,10,12,0.0,0.0
1004,2418,26-09-2019 20:14:00,0,3503.0,2548.0,0.728,16.623,23,7,4,3,16,2,14,6,0.0,0.0
1004,2419,26-09-2019 20:16:00,0,3320.0,2334.0,0.703,15.667,20,1,0,1,19,0,19,14,0.0,0.0
1004,2420,26-09-2019 20:18:00,0,3013.0,2212.0,0.734,14.32,102,62,44,18,40,28,12,7,0.0,0.0
1004,2421,26-09-2019 20:20:00,0,3021.0,2157.0,0.714,14.293,11,1,0,1,10,4,6,8,0.0,0.0
1004,2422,26-09-2019 20:22:00,0,2821.0,2061.0,0.731,13.398,27,0,0,0,27,2,25,6,0.0,0.0
1004,2423,26-09-2019 20:24:00,0,2840.0,1966.0,0.692,13.367,26,0,0,0,26,0,26,9,0.0,0.0
1004,2424,26-09-2019 20:26:00,0,2617.0,1896.0,0.725,12.411,26,6,4,2,20,0,20,4,0.0,0.0
1004,2425,26-09-2019 20:28:00,0,2633.0,1872.0,0.711,12.448,12,3,2,1,9,0,9,6,0.0,0.0
1004,2426,26-09-2019 20:30:00,0,2663.0,1814.0,0.681,12.502,6,0,0,0,6,0,6,4,0.0,0.0
1004,2427,26-09-2019 20:32:00,0,2545.0,1767.0,0.694,11.983,43,25,3,22,18,7,11,8,0.0,0.0
1004,2428,26-09-2019 20:34:00,0,2637.0,1867.0,0.708,12.456,290,142,95,47,148,108,40,38,0.0,0.0
1004,2429,26-09-2019 20:36:00,0,2618.0,1912.0,0.73,12.433,279,134,87,47,145,107,38,85,0.0,0.0
1004,2430,26-09-2019 20:38:00,0,3098.0,2259.0,0.729,14.709,282,151,109,42,131,97,34,52,0.0,0.0
1004,2431,26-09-2019 20:40:00,0,3321.0,2320.0,0.699,15.653,239,149,111,38,90,70,20,44,0.0,0.0
1004,2432,26-09-2019 20:42:00,0,3221.0,2265.0,0.703,15.199,62,36,21,15,26,18,8,17,0.0,0.0
1004,2433,26-09-2019 20:44:00,0,3325.0,2330.0,0.701,15.68,223,177,133,44,46,23,23,63,0.04,0.0
1004,2434,26-09-2019 20:46:00,0,3421.5,2394.0,0.7,16.1305,156,64,47,17,92,67,25,19,0.0,0.0
1004,2435,26-09-2019 20:48:00,0,3518.0,2458.0,0.699,16.581,253,158,112,46,95,70,25,31,0.0,0.0
1004,2436,26-09-2019 20:50:00,0,3522.0,2452.0,0.696,16.59,168,101,64,37,67,36,31,20,0.0,0.0
1004,2437,26-09-2019 20:52:00,0,3690.0,2703.0,0.733,17.531,210,145,94,51,65,40,25,11,0.0,0.0
1004,2438,26-09-2019 20:54:00,0,3488.0,2556.0,0.733,16.574,186,152,99,53,34,12,22,9,0.0,0.0
1004,2439,26-09-2019 20:56:00,0,3689.0,2681.0,0.727,17.502,314,188,129,59,126,100,26,22,0.0,0.0
1004,2440,26-09-2019 20:58:00,0,3603.0,2629.0,0.73,17.106,130,88,56,32,42,23,19,14,0.0,0.0
1004,2441,26-09-2019 21:00:00,0,3528.0,2422.0,0.686,16.58,90,79,34,45,11,2,9,10,0.0,0.0
1004,2442,26-09-2019 21:02:00,0,3503.0,2527.0,0.721,16.6,186,128,91,37,58,30,28,31,0.0,0.0
1004,2443,26-09-2019 21:04:00,0,3683.0,2719.0,0.738,17.522,327,198,151,47,129,89,40,116,0.05,0.0
1004,2444,26-09-2019 21:06:00,0,3669.0,2784.0,0.759,17.537,132,92,58,34,40,23,17,47,0.0,0.0
1004,2445,26-09-2019 21:08:00,0,3705.0,2659.0,0.718,17.54,84,64,29,35,20,9,11,6,0.01,0.0
1004,2446,26-09-2019 21:10:00,0,3692.0,2641.0,0.715,17.47,90,40,22,18,50,28,22,8,0.0,0.0
1004,2447,26-09-2019 21:12:00,0,3764.0,2798.0,0.743,17.93,217,133,95,38,84,56,28,28,0.02,0.0
1004,2448,26-09-2019 21:14:00,0,3688.0,2732.0,0.741,17.556,138,97,59,38,41,25,16,0,0.0,0.0
1004,2449,26-09-2019 21:16:00,0,3384.0,2435.0,0.72,16.03,224,111,69,42,113,75,38,32,0.0,0.0
1004,2450,26-09-2019 21:18:00,0,3674.0,2773.0,0.755,17.545,267,158,123,35,109,77,32,127,0.02,0.0
1004,2451,26-09-2019 21:20:00,0,3665.0,2776.0,0.7575,17.5145,45,12,8,4,33,8,25,8,0.07,0.0
1004,2452,26-09-2019 21:22:00,0,3656.0,2779.0,0.76,17.484,50,8,3,5,42,6,36,1,0.04,0.0
1004,2453,26-09-2019 21:24:00,0,3966.0,2945.0,0.742,18.889,207,114,79,35,93,65,28,18,0.01,0.0
1004,2454,26-09-2019 21:26:00,0,3670.0,2781.0,0.758,17.538,469,208,160,48,261,186,75,46,0.0,0.0
1004,2455,26-09-2019 21:28:00,0,3474.0,2583.0,0.744,16.547,236,139,102,37,97,67,30,22,0.0,0.0
1004,2456,26-09-2019 21:30:00,0,3495.0,2597.0,0.743,16.645,53,14,5,9,39,21,18,4,0.0,0.0
1004,2457,26-09-2019 21:32:00,0,3488.0,2595.0,0.744,16.616,102,57,27,30,45,16,29,8,0.0,0.0
1004,2458,26-09-2019 21:34:00,0,3488.0,2569.0,0.737,16.589,295,156,113,43,139,109,30,24,0.0,0.0
1004,2459,26-09-2019 21:36:00,0,3506.0,2526.0,0.72,16.61,120,74,45,29,46,20,26,3,0.0,0.0
1004,2460,26-09-2019 21:38:00,0,3505.0,2482.0,0.708,16.559,49,24,7,17,25,10,15,1,0.0,0.0
1004,2461,26-09-2019 21:40:00,0,3325.0,2290.0,0.689,15.638,2,2,0,2,0,0,0,7,0.0,0.0
1004,2462,26-09-2019 21:42:00,0,3129.0,2178.0,0.696,14.739,0,0,0,0,0,0,0,1,0.0,0.0
1004,2463,26-09-2019 21:44:00,0,3040.0,2090.0,0.687,14.292,7,6,2,4,1,0,1,2,0.0,0.0
1004,2464,26-09-2019 21:46:00,0,3048.0,2047.0,0.672,14.278,1,0,0,0,1,1,0,4,0.0,0.0
1004,2465,26-09-2019 21:48:00,0,2830.0,1976.0,0.698,13.338,1,1,0,1,0,0,0,4,0.0,0.0
1004,2466,26-09-2019 21:50:00,0,2846.0,1937.0,0.681,13.358,0,0,0,0,0,0,0,5,0.0,0.0
1004,2467,26-09-2019 21:52:00,0,2635.0,1852.0,0.703,12.433,35,25,16,9,10,4,6,3,0.0,0.0
1004,2468,26-09-2019 21:54:00,0,2827.0,1997.0,0.706,13.349,293,166,116,50,127,96,31,26,0.0,0.0
1004,2469,26-09-2019 21:56:00,0,3019.0,2142.0,0.709,14.265,276,146,107,39,130,96,34,35,0.0,0.0
1004,2470,26-09-2019 21:58:00,0,3217.0,2284.0,0.71,15.206,309,170,123,47,139,108,31,19,0.0,0.0
1004,2471,26-09-2019 22:00:00,0,3012.0,2185.0,0.726,14.285,108,74,37,37,34,18,16,5,0.0,0.0
1004,2472,26-09-2019 22:02:00,0,3020.0,2152.0,0.713,14.282,113,85,44,41,28,10,18,4,0.0,0.0
1004,2473,26-09-2019 22:04:00,0,3325.0,2337.0,0.703,15.69,369,253,192,61,116,88,28,32,0.0,0.0
1004,2474,26-09-2019 22:06:00,0,3324.0,2353.0,0.708,15.704,141,67,47,20,74,55,19,102,0.0,0.0
1004,2475,26-09-2019 22:08:00,0,3520.0,2466.0,0.701,16.598,452,222,162,60,230,170,60,37,0.0,0.0
1004,2476,26-09-2019 22:10:00,0,3696.0,2673.0,0.723,17.521,304,186,122,64,118,85,33,33,0.0,0.0
1004,2477,26-09-2019 22:12:00,0,3701.0,2663.0,0.719,17.531,389,259,200,59,130,96,34,47,0.0,0.0
1004,2478,26-09-2019 22:14:00,0,3708.0,2639.0,0.712,17.532,331,228,159,69,103,75,28,46,0.0,0.0
1004,2479,26-09-2019 22:16:00,0,3707.0,2600.0,0.701,17.487,108,63,33,30,45,17,28,25,0.0,0.0
1004,2480,26-09-2019 22:18:00,0,3491.0,2517.0,0.721,16.54,61,51,20,31,10,4,6,13,0.0,0.0
1004,2481,26-09-2019 22:20:00,0,3489.0,2558.0,0.733,16.578,357,195,149,46,162,117,45,150,0.0,0.0
1004,2482,26-09-2019 22:22:00,0,3696.0,2696.0,0.729,17.548,262,129,94,35,133,101,32,118,0.0,0.0
1004,2483,26-09-2019 22:24:00,0,3497.0,2507.0,0.717,16.554,74,42,27,15,32,19,13,34,0.0,0.0
1004,2484,26-09-2019 22:26:00,0,3702.0,2636.0,0.712,17.506,197,118,93,25,79,53,26,103,0.0,0.0
1004,2485,26-09-2019 22:28:00,0,3704.0,2609.0,0.7045,17.4835,148,73,36,37,75,37,38,13,0.0,0.0
1004,2486,26-09-2019 22:30:00,0,3706.0,2582.0,0.697,17.461,146,73,40,33,73,38,35,28,0.0,0.0
1004,2487,26-09-2019 22:32:00,0,3692.0,2671.0,0.723,17.505,342,203,143,60,139,101,38,41,0.0,0.0
1004,2488,26-09-2019 22:34:00,0,4008.0,2805.0,0.7,18.896,189,87,50,37,102,61,41,13,0.0,0.0
1004,2489,26-09-2019 22:36:00,0,3704.0,2651.0,0.716,17.529,41,13,6,7,28,16,12,9,0.0,0.0
1004,2490,26-09-2019 22:38:00,0,3986.0,2806.0,0.704,18.813,134,67,37,30,67,41,26,13,0.0,0.0
1004,2491,26-09-2019 22:40:00,0,3500.0,2494.0,0.712,16.553,93,76,38,38,17,3,14,7,0.0,0.0
1004,2492,26-09-2019 22:42:00,0,3505.0,2531.0,0.722,16.613,100,65,40,25,35,20,15,12,0.0,0.0
1004,2493,26-09-2019 22:44:00,0,3605.0,2585.0,0.717,17.068,249,121,91,30,128,87,41,139,0.0,0.0
1004,2494,26-09-2019 22:46:00,0,3980.0,2891.0,0.726,18.882,156,84,44,40,72,51,21,40,0.04,0.0
1004,2495,26-09-2019 22:48:00,0,3487.0,2568.0,0.737,16.583,157,114,62,52,43,19,24,9,0.0,0.0
1004,2496,26-09-2019 22:50:00,0,3703.0,2701.0,0.729,17.583,420,318,234,84,102,68,34,47,0.0,0.0
1004,2497,26-09-2019 22:52:00,0,3897.0,2795.0,0.717,18.449,474,311,227,84,163,119,44,36,0.0,0.0
1004,2498,26-09-2019 22:54:00,0,3982.0,2905.0,0.73,18.907,261,144,106,38,117,83,34,11,0.02,0.0
1004,2499,26-09-2019 22:56:00,0,3989.0,2859.0,0.717,18.883,204,120,84,36,84,66,18,8,0.0,0.0
1004,2500,26-09-2019 22:58:00,0,4006.0,2800.0,0.699,18.886,271,121,81,40,150,116,34,6,0.0,0.0
1004,2501,26-09-2019 23:00:00,0,3998.0,2843.0,0.711,18.899,268,149,95,54,119,86,33,5,0.0,0.0
1004,2502,26-09-2019 23:02:00,0,3657.5,2609.0,0.7135,17.298,136,87,65,22,49,38,11,10,0.0,0.0
1004,2503,26-09-2019 23:04:00,0,3317.0,2375.0,0.716,15.697,260,164,127,37,96,69,27,82,0.0,0.0
1004,2504,26-09-2019 23:06:00,0,3713.0,2646.0,0.713,17.561,173,93,66,27,80,51,29,30,0.0,0.0
1004,2505,26-09-2019 23:08:00,0,3786.0,2694.0,0.712,17.899,205,96,55,41,109,83,26,10,0.0,0.0
1004,2506,26-09-2019 23:10:00,0,3521.0,2448.0,0.695,16.583,191,133,79,54,58,36,22,4,0.0,0.0
1004,2507,26-09-2019 23:12:00,0,3731.0,2558.0,0.686,17.533,207,123,81,42,84,45,39,13,0.0,0.0
1004,2508,26-09-2019 23:14:00,0,3520.0,2452.0,0.697,16.585,224,103,71,32,121,88,33,59,0.0,0.0
1004,2509,26-09-2019 23:16:00,0,3706.0,2662.0,0.718,17.548,211,127,92,35,84,56,28,34,0.08,0.0
1004,2510,26-09-2019 23:18:00,0,3505.0,2549.0,0.727,16.63,117,93,70,23,24,11,13,24,0.0,0.0
1004,2511,26-09-2019 23:20:00,0,3501.0,2555.0,0.73,16.623,68,36,20,16,32,17,15,4,0.0,0.0
1004,2512,26-09-2019 23:22:00,0,3691.0,2640.0,0.715,17.465,350,212,175,37,138,100,38,98,0.02,0.0
1004,2513,26-09-2019 23:24:00,0,3700.0,2666.0,0.721,17.533,359,189,145,44,170,125,45,65,0.03,0.0
1004,2514,26-09-2019 23:26:00,0,3684.0,2689.0,0.73,17.491,454,153,104,49,301,230,71,11,0.0,0.0
1004,2515,26-09-2019 23:28:00,0,4027.0,2795.0,0.694,18.963,385,169,115,54,216,161,55,9,0.0,0.0
1004,2516,26-09-2019 23:30:00,0,3695.0,2682.0,0.726,17.529,401,251,180,71,150,109,41,31,0.0,0.0
1004,2517,26-09-2019 23:32:00,0,3507.0,2463.0,0.702,16.544,100,58,26,32,42,28,14,6,0.0,0.0
1004,2518,26-09-2019 23:34:00,0,3618.0,2527.0,0.698,17.055,147,101,51,50,46,26,20,39,0.0,0.0
1004,2519,26-09-2019 23:36:00,0,3560.0,2509.5,0.705,16.8055,108,81,44,37,27,10,17,7,0.01,0.0
1004,2520,26-09-2019 23:38:00,0,3502.0,2492.0,0.712,16.556,459,231,173,58,228,180,48,75,0.01,0.0
1004,2521,26-09-2019 23:40:00,0,3732.0,2597.0,0.696,17.578,106,83,54,29,23,13,10,125,0.0,0.0
1004,2522,26-09-2019 23:42:00,0,3698.0,2573.0,0.696,17.419,313,189,141,48,124,91,33,146,0.02,0.0
1004,2523,26-09-2019 23:44:00,0,3705.0,2605.0,0.703,17.484,71,28,17,11,43,27,16,27,0.0,0.0
1004,2524,26-09-2019 23:46:00,0,3706.0,2571.0,0.694,17.449,180,81,52,29,99,69,30,9,0.0,0.0
1004,2525,26-09-2019 23:48:00,0,3509.0,2541.0,0.724,16.637,164,66,46,20,98,67,31,7,0.0,0.0
1004,2526,26-09-2019 23:50:00,0,3502.0,2511.0,0.717,16.579,49,21,2,19,28,2,26,1,0.0,0.0
1004,2527,26-09-2019 23:52:00,0,3513.0,2451.0,0.698,16.553,107,45,24,21,62,28,34,2,0.0,0.0
1004,2528,26-09-2019 23:54:00,0,3333.0,2279.0,0.684,15.656,155,113,76,37,42,33,9,7,0.0,0.0
1004,2529,26-09-2019 23:56:00,0,3728.0,2570.0,0.689,17.535,393,240,177,63,153,112,41,43,0.01,0.0
1004,2530,26-09-2019 23:58:00,0,3619.0,2526.0,0.698,17.055,384,232,166,66,152,114,38,38,0.0,0.0
1004,2531,27-09-2019 00:00:00,0,3722.0,2592.0,0.696,17.536,322,272,199,73,50,35,15,19,0.0,0.0
1004,2532,27-09-2019 00:02:00,0,3726.0,2586.0,0.694,17.544,315,228,169,59,87,47,40,17,0.0,0.0
1004,2533,27-09-2019 00:04:00,0,3709.0,2612.0,0.704,17.507,264,196,136,60,68,48,20,11,0.0,0.0
1004,2534,27-09-2019 00:06:00,0,3695.0,2657.0,0.719,17.503,433,208,169,39,225,165,60,50,0.0,0.0
1004,2535,27-09-2019 00:08:00,0,3525.0,2487.0,0.706,16.641,266,135,100,35,131,100,31,74,0.0,0.0
1004,2536,27-09-2019 00:10:00,0,3633.0,2515.5,0.693,17.098,83,47,28,19,36,15,21,12,0.0,0.0
1004,2537,27-09-2019 00:12:00,0,3741.0,2544.0,0.68,17.555,243,146,103,43,97,62,35,19,0.0,0.0
1004,2538,27-09-2019 00:14:00,0,3609.0,2527.0,0.7,17.018,134,65,40,25,69,40,29,11,0.0,0.0
1004,2539,27-09-2019 00:16:00,0,3517.0,2492.0,0.708,16.616,282,141,100,41,141,99,42,92,0.05,0.0
1004,2540,27-09-2019 00:18:00,0,3518.0,2518.0,0.716,16.65,94,61,31,30,33,19,14,3,0.0,0.0
1004,2541,27-09-2019 00:20:00,0,3524.0,2388.0,0.678,16.532,149,41,23,18,108,92,16,0,0.0,0.0
1004,2542,27-09-2019 00:22:00,0,3528.0,2452.0,0.695,16.617,216,4,1,3,212,196,16,0,0.0,0.0
1004,2543,27-09-2019 00:24:00,0,3440.0,2341.0,0.681,16.146,10,3,2,1,7,6,1,0,0.0,0.0
1004,2544,27-09-2019 00:26:00,0,3366.0,2195.0,0.652,15.693,9,6,0,6,3,0,3,0,0.0,0.0
1004,2545,27-09-2019 00:28:00,0,3053.0,2090.0,0.685,14.342,28,16,6,10,12,3,9,0,0.0,0.0
1004,2546,27-09-2019 00:30:00,0,3050.0,1974.0,0.647,14.204,25,0,0,0,25,0,25,0,0.0,0.0
1004,2547,27-09-2019 00:32:00,0,2855.0,1899.0,0.665,13.353,31,10,7,3,21,3,18,0,0.0,0.0
1004,2548,27-09-2019 00:34:00,0,2863.0,1908.0,0.666,13.395,0,0,0,0,0,0,0,0,0.0,0.0
1004,2549,27-09-2019 00:36:00,0,2759.0,1841.0,0.667,12.91,17,12,3,9,5,1,4,0,0.0,0.0
1004,2550,27-09-2019 00:38:00,0,2642.0,1796.0,0.68,12.398,21,20,8,12,1,0,1,0,0.0,0.0
1004,2551,27-09-2019 00:40:00,0,2669.0,1727.0,0.647,12.427,3,0,0,0,3,1,2,0,0.0,0.0
1004,2552,27-09-2019 00:42:00,0,2467.0,1649.0,0.668,11.547,1,0,0,0,1,0,1,0,0.0,0.0
1004,2553,27-09-2019 00:44:00,0,2564.0,1724.5,0.6725,12.012,109,60,33,27,49,20,29,0,0.0,0.0
1004,2554,27-09-2019 00:46:00,0,2661.0,1800.0,0.677,12.477,209,138,86,52,71,42,29,21,0.0,0.0
1004,2555,27-09-2019 00:48:00,0,2842.0,1929.0,0.679,13.335,229,153,99,54,76,45,31,13,0.0,0.0
1004,2556,27-09-2019 00:50:00,0,3022.0,2114.0,0.699,14.248,306,210,144,66,96,67,29,16,0.0,0.0
1004,2557,27-09-2019 00:52:00,0,3235.0,2214.0,0.684,15.199,409,235,172,63,174,125,49,28,0.0,0.0
1004,2558,27-09-2019 00:54:00,0,3121.0,2179.0,0.698,14.71,114,71,45,26,43,33,10,4,0.0,0.0
1004,2559,27-09-2019 00:56:00,0,3134.0,2159.0,0.689,14.74,284,145,105,40,139,105,34,103,0.0,0.0
1004,2560,27-09-2019 00:58:00,0,3361.0,2254.0,0.671,15.737,357,212,163,49,145,105,40,107,0.0,0.0
1004,2561,27-09-2019 01:00:00,0,3417.0,2349.0,0.687,16.066,228,101,81,20,127,86,41,95,0.08,0.0
1004,2562,27-09-2019 01:02:00,0,3325.0,2304.0,0.693,15.653,110,81,55,26,29,14,15,11,0.0,0.0
1004,2563,27-09-2019 01:04:00,0,3529.0,2375.0,0.673,16.534,276,144,108,36,132,98,34,116,0.0,0.0
1004,2564,27-09-2019 01:06:00,0,3518.0,2509.0,0.713,16.638,462,190,140,50,272,202,70,54,0.0,0.0
1004,2565,27-09-2019 01:08:00,0,3515.0,2521.0,0.717,16.641,105,61,45,16,44,32,12,9,0.0,0.0
1004,2566,27-09-2019 01:10:00,0,3507.0,2481.0,0.708,16.567,57,33,11,22,24,8,16,1,0.0,0.0
1004,2567,27-09-2019 01:12:00,0,3609.0,2513.0,0.696,17.002,83,60,38,22,23,15,8,7,0.0,0.0
1004,2568,27-09-2019 01:14:00,0,3505.0,2509.0,0.716,16.586,184,90,66,24,94,72,22,68,0.0,0.0
1004,2569,27-09-2019 01:16:00,0,3520.0,2465.0,0.7,16.598,165,84,51,33,81,50,31,1,0.03,0.0
1004,2570,27-09-2019 01:18:00,0,3526.5,2426.0,0.688,16.5795,188,101,72,29,87,61,26,11,0.0,0.0
1004,2571,27-09-2019 01:20:00,0,3533.0,2387.0,0.676,16.561,194,127,97,30,67,41,26,17,0.0,0.0
1004,2572,27-09-2019 01:22:00,0,3538.0,2363.0,0.668,16.557,161,85,51,34,76,44,32,0,0.0,0.0
1004,2573,27-09-2019 01:24:00,0,3546.0,2424.0,0.683,16.656,76,36,13,23,40,24,16,0,0.0,0.0
1004,2574,27-09-2019 01:26:00,0,3321.0,2301.0,0.693,15.632,0,0,0,0,0,0,0,0,0.0,0.0
1004,2575,27-09-2019 01:28:00,0,3354.0,2191.0,0.653,15.641,7,0,0,0,7,1,6,2,0.0,0.0
1004,2576,27-09-2019 01:30:00,0,3047.0,2058.0,0.676,14.283,1,0,0,0,1,1,0,1,0.0,0.0
1004,2577,27-09-2019 01:32:00,0,2954.0,1980.0,0.67,13.832,1,0,0,0,1,0,1,0,0.0,0.0
1004,2578,27-09-2019 01:34:00,0,2847.0,1946.0,0.684,13.37,6,2,0,2,4,2,2,0,0.0,0.0
1004,2579,27-09-2019 01:36:00,0,2864.0,1884.0,0.658,13.37,6,0,0,0,6,0,6,1,0.0,0.0
1004,2580,27-09-2019 01:38:00,0,2652.0,1824.0,0.688,12.47,2,0,0,0,2,0,2,0,0.0,0.0
1004,2581,27-09-2019 01:40:00,0,2670.0,1754.0,0.657,12.46,0,0,0,0,0,0,0,0,0.0,0.0
1004,2582,27-09-2019 01:42:00,0,2563.0,1689.0,0.659,11.968,0,0,0,0,0,0,0,0,0.0,0.0
1004,2583,27-09-2019 01:44:00,0,2468.0,1654.0,0.67,11.557,14,2,1,1,12,0,12,0,0.0,0.0
1004,2584,27-09-2019 01:46:00,0,2350.0,1627.0,0.692,11.061,4,0,0,0,4,0,4,1,0.0,0.0
1004,2585,27-09-2019 01:48:00,0,2352.0,1576.0,0.67,11.013,22,6,4,2,16,12,4,0,0.0,0.0
1004,2586,27-09-2019 01:50:00,0,2368.0,1551.0,0.655,11.049,20,0,0,0,20,9,11,1,0.0,0.0
1004,2587,27-09-2019 01:52:00,0,2266.0,1494.0,0.6595,10.5835,25,9,0,9,16,4,12,0,0.0,0.0
1004,2588,27-09-2019 01:54:00,0,2164.0,1437.0,0.664,10.118,26,3,0,3,23,6,17,1,0.0,0.0
1004,2589,27-09-2019 01:56:00,0,2168.0,1451.0,0.669,10.148,29,8,1,7,21,7,14,1,0.0,0.0
1004,2590,27-09-2019 01:58:00,0,2162.0,1439.0,0.665,10.113,47,23,2,21,24,8,16,0,0.0,0.0
1004,2591,27-09-2019 02:00:00,0,2170.0,1425.0,0.657,10.127,28,6,0,6,22,8,14,0,0.0,0.0
1004,2592,27-09-2019 02:02:00,0,2173.0,1393.0,0.641,10.106,34,31,0,31,3,1,2,5,0.0,0.0
1004,2593,27-09-2019 02:04:00,0,2178.0,1401.0,0.643,10.135,247,169,127,42,78,51,27,16,0.0,0.0
1004,2594,27-09-2019 02:06:00,0,2571.0,1698.0,0.66,12.011,138,52,23,29,86,62,24,8,0.0,0.0
1004,2595,27-09-2019 02:08:00,0,2570.0,1679.0,0.653,11.983,172,71,36,35,101,64,37,14,0.0,0.0
1004,2596,27-09-2019 02:10:00,0,2648.0,1782.0,0.673,12.405,282,169,127,42,113,80,33,38,0.0,0.0
1004,2597,27-09-2019 02:12:00,0,2639.0,1872.0,0.709,12.472,173,124,93,31,49,29,20,19,0.0,0.0
1004,2598,27-09-2019 02:14:00,0,2865.0,1897.0,0.662,13.391,142,76,58,18,66,50,16,73,0.0,0.0
1004,2599,27-09-2019 02:16:00,0,3239.0,2183.0,0.674,15.178,150,76,52,24,74,53,21,19,0.0,0.0
1004,2600,27-09-2019 02:18:00,0,3031.0,2110.0,0.696,14.279,258,106,71,35,152,105,47,46,0.0,0.0
1004,2601,27-09-2019 02:20:00,0,3448.0,2336.0,0.677,16.172,268,104,74,30,164,122,42,132,0.04,0.0
1004,2602,27-09-2019 02:22:00,0,3341.0,2291.0,0.686,15.702,414,241,195,46,173,126,47,228,0.0,0.0
1004,2603,27-09-2019 02:24:00,0,3531.0,2383.0,0.675,16.552,334,165,121,44,169,124,45,69,0.0,0.0
1004,2604,27-09-2019 02:26:00,0,3615.5,2497.5,0.6905,17.012,308,82,51,31,226,172,54,61,0.07,0.0
1004,2605,27-09-2019 02:28:00,0,3700.0,2612.0,0.706,17.472,163,102,67,35,61,36,25,20,0.05,0.0
1004,2606,27-09-2019 02:30:00,0,3421.0,2316.0,0.677,16.043,80,70,41,29,10,4,6,0,0.0,0.0
1004,2607,27-09-2019 02:32:00,0,3539.0,2375.0,0.671,16.573,210,121,82,39,89,64,25,37,0.0,0.0
1004,2608,27-09-2019 02:34:00,0,3531.0,2396.0,0.679,16.566,182,94,59,35,88,64,24,146,0.0,0.0
1004,2609,27-09-2019 02:36:00,0,3541.0,2379.0,0.672,16.585,117,43,23,20,74,46,28,6,0.01,0.0
1004,2610,27-09-2019 02:38:00,0,3533.0,2316.0,0.655,16.486,40,15,6,9,25,9,16,0,0.02,0.0
1004,2611,27-09-2019 02:40:00,0,3344.0,2225.0,0.665,15.641,75,42,14,28,33,9,24,1,0.0,0.0
1004,2612,27-09-2019 02:42:00,0,3348.0,2256.0,0.674,15.691,180,109,72,37,71,43,28,0,0.0,0.0
1004,2613,27-09-2019 02:44:00,0,3518.0,2453.0,0.697,16.577,229,74,48,26,155,117,38,60,0.0,0.0
1004,2614,27-09-2019 02:46:00,0,3628.0,2479.0,0.683,17.039,213,71,45,26,142,94,48,11,0.0,0.0
1004,2615,27-09-2019 02:48:00,0,3449.0,2311.0,0.67,16.148,21,16,2,14,5,2,3,13,0.0,0.0
1004,2616,27-09-2019 02:50:00,0,3359.0,2184.0,0.65,15.656,61,34,12,22,27,8,19,12,0.0,0.0
1004,2617,27-09-2019 02:52:00,0,3029.0,2111.0,0.697,14.272,16,3,1,2,13,4,9,7,0.0,0.0
1004,2618,27-09-2019 02:54:00,0,3063.0,2012.0,0.657,14.297,62,4,1,3,58,35,23,12,0.0,0.0
1004,2619,27-09-2019 02:56:00,0,2848.0,1919.0,0.674,13.346,95,5,0,5,90,55,35,10,0.0,0.0
1004,2620,27-09-2019 02:58:00,0,2873.0,1847.0,0.643,13.364,62,1,0,1,61,28,33,12,0.0,0.0
1004,2621,27-09-2019 03:00:00,0,2869.5,1878.5,0.655,13.3855,22,9,2,7,13,5,8,12,0.0,0.0
1004,2622,27-09-2019 03:02:00,0,2866.0,1910.0,0.667,13.407,0,0,0,0,0,0,0,6,0.0,0.0
1004,2623,27-09-2019 03:04:00,0,2860.0,1893.0,0.662,13.365,7,6,1,5,1,0,1,11,0.0,0.0
1004,2624,27-09-2019 03:06:00,0,2648.0,1817.0,0.686,12.446,0,0,0,0,0,0,0,6,0.0,0.0
1004,2625,27-09-2019 03:08:00,0,2664.0,1731.0,0.65,12.413,0,0,0,0,0,0,0,11,0.0,0.0
1004,2626,27-09-2019 03:10:00,0,2568.0,1687.0,0.657,11.985,0,0,0,0,0,0,0,7,0.0,0.0
1004,2627,27-09-2019 03:12:00,0,2457.0,1649.0,0.671,11.508,0,0,0,0,0,0,0,6,0.0,0.0
1004,2628,27-09-2019 03:14:00,0,2358.0,1593.0,0.676,11.053,17,8,5,3,9,5,4,7,0.0,0.0
1004,2629,27-09-2019 03:16:00,0,2371.0,1515.0,0.639,11.019,202,98,67,31,104,68,36,29,0.0,0.0
1004,2630,27-09-2019 03:18:00,0,2266.0,1520.0,0.671,10.612,284,121,82,39,163,110,53,7,0.0,0.0
1004,2631,27-09-2019 03:20:00,0,2668.0,1781.0,0.668,12.484,132,19,8,11,113,72,41,3,0.0,0.0
1004,2632,27-09-2019 03:22:00,0,2632.0,1845.0,0.701,12.412,134,66,44,22,68,38,30,29,0.0,0.0
1004,2633,27-09-2019 03:24:00,0,2562.0,1688.0,0.659,11.965,223,100,79,21,123,88,35,29,0.0,0.0
1004,2634,27-09-2019 03:26:00,0,2678.0,1736.0,0.648,12.473,124,42,20,22,82,54,28,15,0.0,0.0
1004,2635,27-09-2019 03:28:00,0,2642.0,1829.0,0.692,12.436,242,143,105,38,99,68,31,65,0.0,0.0
1004,2636,27-09-2019 03:30:00,0,2858.0,1899.0,0.664,13.362,330,139,104,35,191,138,53,98,0.01,0.0
1004,2637,27-09-2019 03:32:00,0,2745.0,1858.0,0.677,12.871,92,36,12,24,56,43,13,16,0.0,0.0
1004,2638,27-09-2019 03:34:00,0,2790.0,1907.0,0.6835,13.1035,104,39,18,21,65,53,12,18,0.0,0.0
1004,2639,27-09-2019 03:36:00,0,2835.0,1956.0,0.69,13.336,226,58,30,28,168,143,25,13,0.01,0.0
1004,2640,27-09-2019 03:38:00,0,2842.0,1972.0,0.694,13.382,0,0,0,0,0,0,0,23,0.0,0.0
1004,2641,27-09-2019 03:40:00,0,2856.0,1876.0,0.657,13.33,0,0,0,0,0,0,0,18,0.0,0.0
1004,2642,27-09-2019 03:42:00,0,2653.0,1800.0,0.678,12.447,0,0,0,0,0,0,0,25,0.0,0.0
1004,2643,27-09-2019 03:44:00,0,2667.0,1726.0,0.647,12.42,542,0,0,0,542,491,51,23,0.0,0.0
1004,2644,27-09-2019 03:46:00,0,2565.0,1653.0,0.644,11.937,273,0,0,0,273,254,19,16,0.0,0.0
1004,2645,27-09-2019 03:48:00,0,2355.0,1622.0,0.689,11.074,175,0,0,0,175,158,17,13,0.0,0.0
1004,2646,27-09-2019 03:50:00,0,2357.0,1567.0,0.665,11.022,56,8,4,4,48,40,8,10,0.0,0.0
1004,2647,27-09-2019 03:52:00,0,2579.0,1689.0,0.655,12.033,98,57,17,40,41,14,27,2,0.0,0.0
1004,2648,27-09-2019 03:54:00,0,2659.0,1744.0,0.656,12.408,295,139,115,24,156,120,36,78,0.02,0.0
1004,2649,27-09-2019 03:56:00,0,2664.0,1755.0,0.659,12.439,221,122,86,36,99,70,29,93,0.0,0.0
1004,2650,27-09-2019 03:58:00,0,2651.0,1786.0,0.674,12.425,38,32,11,21,6,1,5,0,0.0,0.0
1004,2651,27-09-2019 04:00:00,0,2660.0,1757.0,0.661,12.425,47,42,19,23,5,2,3,1,0.0,0.0
1004,2652,27-09-2019 04:02:00,0,2846.0,1939.0,0.681,13.361,46,24,7,17,22,8,14,0,0.0,0.0
1004,2653,27-09-2019 04:04:00,0,2944.0,1990.0,0.676,13.804,202,96,77,19,106,75,31,16,0.03,0.0
1004,2654,27-09-2019 04:06:00,0,2834.0,1988.0,0.702,13.366,199,104,66,38,95,67,28,48,0.02,0.0
1004,2655,27-09-2019 04:08:00,0,2949.5,2010.0,0.6825,13.8455,92,89,63,26,3,1,2,14,0.01,0.0
1004,2656,27-09-2019 04:10:00,0,3065.0,2032.0,0.663,14.325,85,44,21,23,41,22,19,2,0.01,0.0
1004,2657,27-09-2019 04:12:00,0,3047.0,2053.0,0.674,14.277,21,17,9,8,4,1,3,2,0.0,0.0
1004,2658,27-09-2019 04:14:00,0,2846.0,1959.0,0.688,13.383,0,0,0,0,0,0,0,5,0.0,0.0
1004,2659,27-09-2019 04:16:00,0,2866.0,1855.0,0.647,13.345,6,0,0,0,6,1,5,0,0.0,0.0
1004,2660,27-09-2019 04:18:00,0,2653.0,1771.0,0.668,12.413,10,0,0,0,10,0,10,1,0.0,0.0
1004,2661,27-09-2019 04:20:00,0,2571.0,1692.0,0.658,12.003,9,0,0,0,9,0,9,2,0.0,0.0
1004,2662,27-09-2019 04:22:00,0,2356.0,1619.0,0.687,11.076,159,157,120,37,2,0,2,0,0.0,0.0
1004,2663,27-09-2019 04:24:00,0,2367.0,1577.0,0.666,11.073,99,81,48,33,18,3,15,0,0.0,0.0
1004,2664,27-09-2019 04:26:00,0,2383.0,1496.0,0.628,11.045,62,47,32,15,15,5,10,3,0.0,0.0
1004,2665,27-09-2019 04:28:00,0,2358.0,1605.0,0.681,11.066,0,0,0,0,0,0,0,1,0.0,0.0
1004,2666,27-09-2019 04:30:00,0,2366.0,1564.0,0.661,11.055,5,3,2,1,2,1,1,4,0.0,0.0
1004,2667,27-09-2019 04:32:00,0,2275.0,1455.0,0.64,10.577,3,0,0,0,3,1,2,1,0.0,0.0
1004,2668,27-09-2019 04:34:00,0,2176.0,1392.0,0.64,10.115,0,0,0,0,0,0,0,0,0.0,0.0
1004,2669,27-09-2019 04:36:00,0,2195.0,1352.0,0.616,10.144,6,0,0,0,6,0,6,2,0.0,0.0
1004,2670,27-09-2019 04:38:00,0,2085.0,1319.0,0.633,9.674,14,10,0,10,4,0,4,1,0.0,0.0
1004,2671,27-09-2019 04:40:00,0,2083.0,1307.0,0.628,9.654,3,3,0,3,0,0,0,3,0.0,0.0
1004,2672,27-09-2019 04:42:00,0,2031.5,1291.0,0.636,9.4335,51,24,3,21,27,9,18,1,0.0,0.0
1004,2673,27-09-2019 04:44:00,0,1980.0,1275.0,0.644,9.213,45,23,13,10,22,14,8,1,0.0,0.0
1004,2674,27-09-2019 04:46:00,0,2082.0,1313.0,0.631,9.659,55,42,29,13,13,6,7,1,0.0,0.0
1004,2675,27-09-2019 04:48:00,0,1967.0,1309.0,0.665,9.201,40,35,11,24,5,0,5,1,0.0,0.0
1004,2676,27-09-2019 04:50:00,0,1965.0,1311.0,0.667,9.196,8,7,2,5,1,0,1,0,0.0,0.0
1004,2677,27-09-2019 04:52:00,0,1974.0,1294.0,0.655,9.212,1,1,0,1,0,0,0,3,0.0,0.0
1004,2678,27-09-2019 04:54:00,0,1859.0,1274.0,0.685,8.734,0,0,0,0,0,0,0,2,0.0,0.0
1004,2679,27-09-2019 04:56:00,0,1881.0,1231.0,0.654,8.773,130,62,39,23,68,49,19,16,0.0,0.0
1004,2680,27-09-2019 04:58:00,0,2175.0,1400.0,0.644,10.119,137,58,36,22,79,48,31,34,0.0,0.0
1004,2681,27-09-2019 05:00:00,0,2149.0,1523.0,0.709,10.154,279,155,116,39,124,88,36,98,0.0,0.0
1004,2682,27-09-2019 05:02:00,0,2351.0,1603.0,0.682,11.04,294,127,95,32,167,129,38,35,0.0,0.0
1004,2683,27-09-2019 05:04:00,0,2351.0,1613.0,0.686,11.05,96,77,50,27,19,13,6,6,0.0,0.0
1004,2684,27-09-2019 05:06:00,0,2644.0,1815.0,0.687,12.426,216,101,64,37,115,91,24,73,0.0,0.0
1004,2685,27-09-2019 05:08:00,0,2651.0,1825.0,0.688,12.468,162,118,68,50,44,30,14,2,0.0,0.0
1004,2686,27-09-2019 05:10:00,0,2837.0,1938.0,0.683,13.326,120,67,45,22,53,31,22,6,0.0,0.0
1004,2687,27-09-2019 05:12:00,0,3050.0,2034.0,0.667,14.27,233,102,74,28,131,88,43,13,0.0,0.0
1004,2688,27-09-2019 05:14:00,0,2948.0,1984.0,0.673,13.813,80,51,24,27,29,17,12,1,0.0,0.0
1004,2689,27-09-2019 05:16:00,0,3002.0,2003.5,0.6675,14.047,60,36,19,17,24,14,10,2,0.0,0.0
1004,2690,27-09-2019 05:18:00,0,3056.0,2023.0,0.662,14.281,139,73,48,25,66,46,20,49,0.0,0.0
1004,2691,27-09-2019 05:20:00,0,3042.0,2061.0,0.678,14.267,341,145,105,40,196,154,42,69,0.14,0.0
1004,2692,27-09-2019 05:22:00,0,3139.0,2133.0,0.68,14.73,361,181,131,50,180,137,43,4,0.0,0.0
1004,2693,27-09-2019 05:24:00,0,3045.0,2069.0,0.679,14.287,43,30,17,13,13,0,13,2,0.0,0.0
1004,2694,27-09-2019 05:26:00,0,3060.0,2027.0,0.662,14.301,113,59,31,28,54,22,32,0,0.0,0.0
1004,2695,27-09-2019 05:28:00,0,3254.0,2174.0,0.668,15.229,266,91,57,34,175,133,42,4,0.0,0.0
1004,2696,27-09-2019 05:30:00,0,3033.0,2112.0,0.696,14.291,370,179,131,48,191,136,55,12,0.02,0.0
1004,2697,27-09-2019 05:32:00,0,3033.0,2079.0,0.685,14.254,329,151,111,40,178,125,53,12,0.0,0.0
1004,2698,27-09-2019 05:34:00,0,3045.0,2039.0,0.67,14.255,169,109,93,16,60,42,18,5,0.0,0.0
1004,2699,27-09-2019 05:36:00,0,3073.0,1977.0,0.643,14.296,21,7,3,4,14,2,12,5,0.0,0.0
1004,2700,27-09-2019 05:38:00,0,2959.0,1962.0,0.663,13.831,6,0,0,0,6,2,4,6,0.0,0.0
1004,2701,27-09-2019 05:40:00,0,2756.0,1819.0,0.66,12.874,15,6,4,2,9,2,7,7,0.0,0.0
1004,2702,27-09-2019 05:42:00,0,2666.0,1724.0,0.647,12.413,0,0,0,0,0,0,0,5,0.0,0.0
1004,2703,27-09-2019 05:44:00,0,2574.0,1639.0,0.637,11.956,3,3,2,1,0,0,0,6,0.0,0.0
1004,2704,27-09-2019 05:46:00,0,2361.0,1600.0,0.678,11.073,9,0,0,0,9,0,9,6,0.0,0.0
1004,2705,27-09-2019 05:48:00,0,2369.0,1528.0,0.645,11.027,19,16,7,9,3,0,3,11,0.0,0.0
1004,2706,27-09-2019 05:50:00,0,2375.0,1517.0,0.6385,11.0375,12,6,3,3,6,5,1,6,0.01,0.0
1004,2707,27-09-2019 05:52:00,0,2381.0,1506.0,0.632,11.048,1,1,0,1,0,0,0,0,0.0,0.0
1004,2708,27-09-2019 05:54:00,0,2272.0,1480.0,0.652,10.59,0,0,0,0,0,0,0,1,0.0,0.0
1004,2709,27-09-2019 05:56:00,0,2168.0,1448.0,0.668,10.146,0,0,0,0,0,0,0,2,0.0,0.0
1004,2710,27-09-2019 05:58:00,0,2181.0,1386.0,0.636,10.127,3,0,0,0,3,0,3,7,0.0,0.0
1004,2711,27-09-2019 06:00:00,1,2192.0,1349.0,0.615,10.13,57,42,30,12,15,7,8,5,0.0,0.0
1004,2712,27-09-2019 06:02:00,1,2153.0,1513.0,0.703,10.159,285,194,141,53,91,62,29,21,0.0,0.0
1004,2713,27-09-2019 06:04:00,1,2370.0,1557.0,0.657,11.062,159,111,79,32,48,17,31,69,0.0,0.0
1004,2714,27-09-2019 06:06:00,1,2642.0,1830.0,0.693,12.436,81,49,29,20,32,3,29,59,0.0,0.0
1004,2715,27-09-2019 06:08:00,1,3267.0,2133.0,0.653,15.233,183,104,80,24,79,28,51,53,0.0,0.08
1004,2716,27-09-2019 06:10:00,1,3512.0,2493.0,0.71,16.598,90,55,22,33,35,4,31,49,0.0,0.0
1004,2717,27-09-2019 06:12:00,1,3703.0,2642.0,0.714,17.514,120,69,40,29,51,0,51,62,0.0,0.08
1004,2718,27-09-2019 06:14:00,1,3894.0,2788.0,0.716,18.429,78,55,28,27,23,2,21,40,0.0,0.11
1004,2719,27-09-2019 06:16:00,1,3961.0,2961.0,0.748,18.884,122,85,55,30,37,0,37,76,0.0,0.04
1004,2720,27-09-2019 06:18:00,1,4147.0,3122.0,0.753,19.796,116,80,44,36,36,3,33,49,0.0,0.09
1004,2721,27-09-2019 06:20:00,1,4216.0,3300.0,0.783,20.264,279,158,123,35,121,71,50,43,0.24,0.0
1004,2722,27-09-2019 06:22:00,1,4137.0,3155.0,0.763,19.794,109,65,41,24,44,1,43,85,0.0,0.02
1004,2723,27-09-2019 06:24:00,1,4276.0,3299.0,0.7715,20.5005,133,86,47,39,47,1,46,87,0.0,0.0
1004,2724,27-09-2019 06:26:00,1,4415.0,3443.0,0.78,21.207,240,118,84,34,122,71,51,46,0.31,0.07
1004,2725,27-09-2019 06:28:00,1,4407.0,3445.0,0.782,21.18,115,54,18,36,61,2,59,50,0.01,0.0
1004,2726,27-09-2019 06:30:00,1,4392.0,3523.0,0.802,21.204,127,85,38,47,42,0,42,46,0.0,0.09
1004,2727,27-09-2019 06:32:00,1,4592.0,3670.0,0.799,22.156,110,75,42,33,35,0,35,36,0.0,0.01
1004,2728,27-09-2019 06:34:00,1,4798.0,3859.0,0.804,23.177,135,86,41,45,49,0,49,56,0.0,0.07
1004,2729,27-09-2019 06:36:00,1,4737.0,3925.0,0.828,23.011,151,70,39,31,81,41,40,16,0.17,0.2
1004,2730,27-09-2019 06:38:00,1,4555.0,3853.0,0.846,22.212,286,156,118,38,130,82,48,88,0.16,0.0
1004,2731,27-09-2019 06:40:00,1,5024.0,4191.0,0.834,24.436,137,79,38,41,58,14,44,60,0.01,0.0
1004,2732,27-09-2019 06:42:00,1,4837.0,4055.0,0.838,23.546,117,70,26,44,47,0,47,46,0.0,0.0
1004,2733,27-09-2019 06:44:00,1,5000.0,4313.0,0.863,24.476,150,96,52,44,54,0,54,52,0.0,0.01
1004,2734,27-09-2019 06:46:00,1,4719.0,4047.0,0.858,23.073,125,75,34,41,50,6,44,44,0.01,0.01
1004,2735,27-09-2019 06:48:00,1,4522.0,3941.0,0.871,22.181,155,84,51,33,71,32,39,43,0.22,0.1
1004,2736,27-09-2019 06:50:00,1,4455.0,3770.0,0.846,21.728,187,151,106,45,36,1,35,69,0.01,0.0
1004,2737,27-09-2019 06:52:00,1,4359.0,3672.0,0.842,21.238,186,112,80,32,74,40,34,45,0.05,0.0
1004,2738,27-09-2019 06:54:00,1,4338.0,3778.0,0.871,21.276,123,82,39,43,41,1,40,50,0.01,0.04
1004,2739,27-09-2019 06:56:00,1,4778.0,4209.0,0.881,23.485,126,84,41,43,42,0,42,36,0.0,0.01
1004,2740,27-09-2019 06:58:00,1,4648.5,4069.5,0.8755,22.8195,184,121,83,38,63,31,32,36,0.0,0.07
1004,2741,27-09-2019 07:00:00,1,4519.0,3930.0,0.87,22.154,175,99,67,32,76,47,29,19,0.26,0.0
1004,2742,27-09-2019 07:02:00,1,4515.0,3917.0,0.868,22.124,111,69,33,36,42,19,23,1,0.06,0.0
1004,2743,27-09-2019 07:04:00,1,4726.0,4131.0,0.874,23.196,85,35,19,16,50,23,27,9,0.0,0.0
1004,2744,27-09-2019 07:06:00,1,4428.0,3841.0,0.867,21.698,103,73,41,32,30,2,28,48,0.0,0.09
1004,2745,27-09-2019 07:08:00,1,4347.0,3689.0,0.849,21.212,82,42,20,22,40,23,17,26,0.0,0.04
1004,2746,27-09-2019 07:10:00,1,4498.0,4008.0,0.891,22.159,288,138,103,35,150,112,38,7,0.08,0.0
1004,2747,27-09-2019 07:12:00,1,3770.0,3223.0,0.855,18.424,49,31,25,6,18,3,15,5,0.0,0.25
1004,2748,27-09-2019 07:14:00,1,4235.0,3709.0,0.876,20.793,49,30,10,20,19,13,6,5,0.0,0.01
1004,2749,27-09-2019 07:16:00,1,4296.0,3873.0,0.901,21.215,8,0,0,0,8,1,7,0,0.0,0.0
1004,2750,27-09-2019 07:18:00,1,4484.0,4007.0,0.894,22.104,11,3,2,1,8,2,6,0,0.0,0.0
1004,2751,27-09-2019 07:20:00,1,4345.0,3762.0,0.866,21.285,14,2,0,2,12,0,12,0,0.0,0.0
1004,2752,27-09-2019 07:22:00,1,4043.0,3581.0,0.886,19.892,6,1,0,1,5,1,4,0,0.0,0.0
1004,2753,27-09-2019 07:24:00,1,3841.0,3417.0,0.89,18.916,7,0,0,0,7,0,7,0,0.0,0.0
1004,2754,27-09-2019 07:26:00,1,3757.0,3312.0,0.882,18.468,42,23,16,7,19,11,8,0,0.0,0.0
1004,2755,27-09-2019 07:28:00,1,3553.0,3272.0,0.921,17.62,4,0,0,0,4,1,3,0,0.0,0.0
1004,2756,27-09-2019 07:30:00,1,3471.0,3065.0,0.883,17.07,5,0,0,0,5,2,3,0,0.0,0.0
1004,2757,27-09-2019 07:32:00,1,3434.0,3000.5,0.8735,16.8525,2,0,0,0,2,1,1,0,0.0,0.0
1004,2758,27-09-2019 07:34:00,1,3397.0,2936.0,0.864,16.635,11,4,2,2,7,2,5,0,0.0,0.0
1004,2759,27-09-2019 07:36:00,1,3390.0,2918.0,0.861,16.587,60,27,20,7,33,19,14,0,0.0,0.0
1004,2760,27-09-2019 07:38:00,1,3290.0,2870.0,0.873,16.139,0,0,0,0,0,0,0,0,0.0,0.0
1004,2761,27-09-2019 07:40:00,1,3223.0,2779.0,0.862,15.774,0,0,0,0,0,0,0,0,0.0,0.0
1004,2762,27-09-2019 07:42:00,1,3204.0,2783.0,0.869,15.706,26,14,10,4,12,5,7,0,0.0,0.0
1004,2763,27-09-2019 07:44:00,1,3212.0,2762.0,0.86,15.712,0,0,0,0,0,0,0,0,0.0,0.0
1004,2764,27-09-2019 07:46:00,1,3196.0,2777.0,0.869,15.667,0,0,0,0,0,0,0,0,0.0,0.0
1004,2765,27-09-2019 07:48:00,1,3195.0,2762.0,0.864,15.647,0,0,0,0,0,0,0,0,0.0,0.0
1004,2766,27-09-2019 07:50:00,1,3008.0,2706.0,0.9,14.845,28,23,2,21,5,2,3,0,0.0,0.0
1004,2767,27-09-2019 07:52:00,1,3095.0,2748.0,0.888,15.237,92,34,23,11,58,39,19,10,0.11,0.0
1004,2768,27-09-2019 07:54:00,1,3171.0,2937.0,0.926,15.747,149,69,46,23,80,56,24,67,0.01,0.0
1004,2769,27-09-2019 07:56:00,1,3164.0,2940.0,0.929,15.723,112,89,64,25,23,6,17,36,0.0,0.1
1004,2770,27-09-2019 07:58:00,1,3373.0,3030.0,0.898,16.645,113,72,50,22,41,0,41,97,0.01,0.0
1004,2771,27-09-2019 08:00:00,1,3324.0,3128.0,0.941,16.561,25,11,7,4,14,9,5,7,0.01,0.0
1004,2772,27-09-2019 08:02:00,1,3329.0,3128.0,0.939,16.579,41,21,5,16,20,4,16,0,0.0,0.0
1004,2773,27-09-2019 08:04:00,1,3526.0,3338.0,0.947,17.588,162,83,54,29,79,53,26,3,0.1,0.0
1004,2774,27-09-2019 08:06:00,1,3533.0,3335.5,0.944,17.613,378,184,143,41,194,144,50,4,0.01,0.0
1004,2775,27-09-2019 08:08:00,1,3540.0,3333.0,0.941,17.638,225,116,72,44,109,62,47,41,0.08,0.0
1004,2776,27-09-2019 08:10:00,1,3806.0,3541.0,0.93,18.917,213,133,97,36,80,51,29,38,0.0,0.0
1004,2777,27-09-2019 08:12:00,1,3615.0,3386.0,0.937,17.993,138,92,44,48,46,4,42,43,0.0,0.0
1004,2778,27-09-2019 08:14:00,1,3729.0,3400.0,0.912,18.457,142,89,52,37,53,12,41,49,0.04,0.0
1004,2779,27-09-2019 08:16:00,1,3837.0,3515.0,0.916,19.01,108,59,24,35,49,30,19,4,0.0,0.0
1004,2780,27-09-2019 08:18:00,1,3810.0,3594.0,0.943,18.991,72,38,11,27,34,14,20,2,0.09,0.0
1004,2781,27-09-2019 08:20:00,1,3803.0,3594.0,0.945,18.964,40,28,5,23,12,3,9,0,0.0,0.0
1004,2782,27-09-2019 08:22:00,1,3831.0,3471.0,0.906,18.938,31,20,0,20,11,1,10,0,0.0,0.0
1004,2783,27-09-2019 08:24:00,1,3843.0,3433.0,0.893,18.941,0,0,0,0,0,0,0,0,0.0,0.0
1004,2784,27-09-2019 08:26:00,1,3528.0,3304.0,0.937,17.558,5,1,0,1,4,1,3,0,0.0,0.0
1004,2785,27-09-2019 08:28:00,1,3349.0,3129.0,0.934,16.659,1,0,0,0,1,0,1,0,0.0,0.0
1004,2786,27-09-2019 08:30:00,1,3195.0,2858.0,0.894,15.753,26,14,1,13,12,7,5,0,0.0,0.0
1004,2787,27-09-2019 08:32:00,1,3000.0,2676.0,0.892,14.784,52,3,1,2,49,2,47,0,0.0,0.0
1004,2788,27-09-2019 08:34:00,1,3008.0,2646.0,0.879,14.782,40,0,0,0,40,0,40,0,0.0,0.0
1004,2789,27-09-2019 08:36:00,1,2905.0,2567.0,0.884,14.289,32,0,0,0,32,0,32,0,0.0,0.0
1004,2790,27-09-2019 08:38:00,1,2915.0,2504.0,0.859,14.257,81,32,11,21,49,3,46,0,0.0,0.0
1004,2791,27-09-2019 08:40:00,1,3060.5,2645.0,0.864,14.987,53,12,1,11,41,6,35,0,0.0,0.0
1004,2792,27-09-2019 08:42:00,1,3206.0,2786.0,0.869,15.717,8,8,1,7,0,0,0,0,0.0,0.0
1004,2793,27-09-2019 08:44:00,1,3189.0,2818.0,0.884,15.685,9,4,2,2,5,0,5,0,0.0,0.0
1004,2794,27-09-2019 08:46:00,1,2977.0,2785.0,0.935,14.814,1,0,0,0,1,0,1,0,0.0,0.0
1004,2795,27-09-2019 08:48:00,1,2896.0,2658.0,0.918,14.353,2,0,0,0,2,0,2,0,0.0,0.0
1004,2796,27-09-2019 08:50:00,1,2896.0,2674.0,0.923,14.371,4,3,1,2,1,1,0,0,0.0,0.0
1004,2797,27-09-2019 08:52:00,1,2876.0,2671.0,0.929,14.289,28,12,8,4,16,9,7,0,0.0,0.0
1004,2798,27-09-2019 08:54:00,1,2688.0,2535.0,0.943,13.396,17,17,3,14,0,0,0,0,0.0,0.0
1004,2799,27-09-2019 08:56:00,1,2726.0,2405.0,0.882,13.404,84,69,44,25,15,9,6,0,0.0,0.0
1004,2800,27-09-2019 08:58:00,1,2797.0,2582.0,0.923,13.881,144,68,23,45,76,33,43,0,0.0,0.0
1004,2801,27-09-2019 09:00:00,1,2910.0,2553.0,0.878,14.291,47,36,10,26,11,2,9,0,0.0,0.0
1004,2802,27-09-2019 09:02:00,1,2876.0,2728.0,0.949,14.35,42,13,7,6,29,10,19,0,0.0,0.0
1004,2803,27-09-2019 09:04:00,1,3192.0,2855.0,0.894,15.736,2,0,0,0,2,0,2,0,0.0,0.0
1004,2804,27-09-2019 09:06:00,1,3091.0,2777.0,0.898,15.254,9,7,2,5,2,0,2,0,0.0,0.0
1004,2805,27-09-2019 09:08:00,1,3087.0,2778.0,0.9,15.239,19,19,0,19,0,0,0,0,0.0,0.0
1004,2806,27-09-2019 09:10:00,1,2880.0,2639.0,0.916,14.269,4,3,2,1,1,0,1,0,0.0,0.0
1004,2807,27-09-2019 09:12:00,1,2912.0,2609.0,0.896,14.362,17,11,4,7,6,0,6,0,0.0,0.0
1004,2808,27-09-2019 09:14:00,1,2907.5,2581.5,0.888,14.313,5,5,0,5,0,0,0,0,0.0,0.0
1004,2809,27-09-2019 09:16:00,1,2903.0,2554.0,0.88,14.264,10,8,4,4,2,1,1,0,0.0,0.0
1004,2810,27-09-2019 09:18:00,1,2889.0,2612.0,0.904,14.273,65,40,27,13,25,14,11,0,0.0,0.0
1004,2811,27-09-2019 09:20:00,1,2697.0,2464.0,0.913,13.354,1,1,0,1,0,0,0,0,0.0,0.0
1004,2812,27-09-2019 09:22:00,1,2511.0,2344.0,0.934,12.487,2,2,0,2,0,0,0,0,0.0,0.0
1004,2813,27-09-2019 09:24:00,1,2511.0,2317.0,0.923,12.459,1,1,0,1,0,0,0,0,0.0,0.0
1004,2814,27-09-2019 09:26:00,1,2524.0,2239.0,0.887,12.423,4,0,0,0,4,3,1,0,0.0,0.0
1004,2815,27-09-2019 09:28:00,1,2531.0,2285.0,0.903,12.5,1,1,0,1,0,0,0,0,0.0,0.0
1004,2816,27-09-2019 09:30:00,1,2503.0,2328.0,0.93,12.438,0,0,0,0,0,0,0,0,0.0,0.0
1004,2817,27-09-2019 09:32:00,1,2616.0,2387.0,0.912,12.949,6,0,0,0,6,1,5,0,0.0,0.0
1004,2818,27-09-2019 09:34:00,1,2708.0,2448.0,0.904,13.379,95,49,32,17,46,22,24,23,0.0,0.0
1004,2819,27-09-2019 09:36:00,1,2896.0,2640.0,0.911,14.333,87,52,31,21,35,2,33,42,0.0,0.0
1004,2820,27-09-2019 09:38:00,1,2855.0,2727.0,0.955,14.266,88,58,25,33,30,2,28,62,0.0,0.0
1004,2821,27-09-2019 09:40:00,1,3162.0,2942.0,0.93,15.716,135,75,37,38,60,2,58,75,0.0,0.0
1004,2822,27-09-2019 09:42:00,1,3263.0,3001.0,0.92,16.178,122,79,47,32,43,2,41,58,0.0,0.02
1004,2823,27-09-2019 09:44:00,1,3417.0,3215.0,0.941,17.021,137,82,42,40,55,7,48,75,0.0,0.0
1004,2824,27-09-2019 09:46:00,1,3608.0,3463.0,0.96,18.047,135,84,52,32,51,0,51,73,0.0,0.08
1004,2825,27-09-2019 09:48:00,1,3805.5,3579.0,0.9415,18.9555,112,68,28,40,44,0,44,44,0.0,0.04
1004,2826,27-09-2019 09:50:00,1,4003.0,3695.0,0.923,19.864,154,108,67,41,46,0,46,77,0.0,0.14
1004,2827,27-09-2019 09:52:00,1,4016.0,3691.0,0.919,19.909,174,95,67,28,79,52,27,29,0.07,0.0
1004,2828,27-09-2019 09:54:00,1,3515.0,3285.0,0.935,17.485,222,123,84,39,99,51,48,70,0.08,0.0
1004,2829,27-09-2019 09:56:00,1,3982.0,3788.0,0.951,19.884,119,69,42,27,50,0,50,44,0.01,0.0
1004,2830,27-09-2019 09:58:00,1,4262.0,3981.0,0.934,21.199,112,70,34,36,42,0,42,31,0.0,0.0
1004,2831,27-09-2019 10:00:00,1,4447.0,4173.0,0.938,22.142,151,95,59,36,56,6,50,68,0.0,0.0
1004,2832,27-09-2019 10:02:00,1,4479.0,4117.0,0.919,22.205,130,84,50,34,46,0,46,41,0.0,0.0
1004,2833,27-09-2019 10:04:00,1,4551.0,4277.0,0.94,22.666,108,66,42,24,42,12,30,36,0.0,0.21
1004,2834,27-09-2019 10:06:00,1,4462.0,4177.0,0.936,22.202,223,142,108,34,81,60,21,10,0.14,0.0
1004,2835,27-09-2019 10:08:00,1,3976.0,3815.0,0.96,19.89,164,105,70,35,59,35,24,1,0.0,0.0
1004,2836,27-09-2019 10:10:00,1,4177.0,3879.0,0.928,20.753,49,22,12,10,27,7,20,0,0.0,0.0
1004,2837,27-09-2019 10:12:00,1,4080.0,3809.0,0.933,20.293,68,44,20,24,24,5,19,0,0.0,0.0
1004,2838,27-09-2019 10:14:00,1,3978.0,3797.0,0.954,19.877,78,49,15,34,29,5,24,0,0.0,0.0
1004,2839,27-09-2019 10:16:00,1,4184.0,3905.0,0.933,20.808,14,3,2,1,11,1,10,0,0.0,0.0
1004,2840,27-09-2019 10:18:00,1,3812.0,3539.0,0.928,18.937,26,3,3,0,23,1,22,0,0.0,0.0
1004,2841,27-09-2019 10:20:00,1,3825.0,3534.0,0.924,18.981,7,0,0,0,7,1,6,0,0.0,0.0
1004,2842,27-09-2019 10:22:00,1,3733.5,3449.5,0.924,18.5275,16,6,1,5,10,0,10,0,0.0,0.0
1004,2843,27-09-2019 10:24:00,1,3642.0,3365.0,0.924,18.074,3,1,0,1,2,0,2,0,0.0,0.0
1004,2844,27-09-2019 10:26:00,1,3540.0,3249.0,0.918,17.544,16,8,4,4,8,3,5,0,0.0,0.0
1004,2845,27-09-2019 10:28:00,1,3566.0,3200.0,0.897,17.592,6,0,0,0,6,0,6,0,0.0,0.0
1004,2846,27-09-2019 10:30:00,1,3391.0,2982.0,0.879,16.662,0,0,0,0,0,0,0,0,0.0,0.0
1004,2847,27-09-2019 10:32:00,1,3182.0,2808.0,0.882,15.646,2,0,0,0,2,0,2,0,0.0,0.0
1004,2848,27-09-2019 10:34:00,1,3218.0,2760.0,0.858,15.734,4,4,1,3,0,0,0,0,0.0,0.0
1004,2849,27-09-2019 10:36:00,1,3083.0,2732.0,0.886,15.173,3,0,0,0,3,0,3,0,0.0,0.0
1004,2850,27-09-2019 10:38:00,1,3109.0,2722.0,0.876,15.262,15,6,2,4,9,2,7,0,0.0,0.0
1004,2851,27-09-2019 10:40:00,1,3095.0,2754.0,0.89,15.245,7,0,0,0,7,0,7,0,0.0,0.0
1004,2852,27-09-2019 10:42:00,1,2875.0,2713.0,0.944,14.331,1,0,0,0,1,0,1,0,0.0,0.0
1004,2853,27-09-2019 10:44:00,1,2884.0,2691.0,0.933,14.343,41,31,14,17,10,6,4,0,0.0,0.0
1004,2854,27-09-2019 10:46:00,1,2719.0,2406.0,0.885,13.379,49,19,14,5,30,18,12,6,0.0,0.0
1004,2855,27-09-2019 10:48:00,1,3182.0,2875.0,0.904,15.721,87,49,25,24,38,12,26,31,0.0,0.0
1004,2856,27-09-2019 10:50:00,1,3248.0,3045.0,0.937,16.167,88,48,16,32,40,7,33,1,0.0,0.0
1004,2857,27-09-2019 10:52:00,1,3157.0,2970.0,0.941,15.726,32,17,2,15,15,3,12,0,0.0,0.0
1004,2858,27-09-2019 10:54:00,1,3143.0,2976.0,0.947,15.678,41,31,12,19,10,2,8,0,0.0,0.0
1004,2859,27-09-2019 10:56:00,1,3337.0,3148.0,0.9435,16.632,37,22,6,16,15,2,13,0,0.0,0.0
1004,2860,27-09-2019 10:58:00,1,3531.0,3320.0,0.94,17.586,11,5,1,4,6,2,4,0,0.0,0.0
1004,2861,27-09-2019 11:00:00,1,3338.0,3121.0,0.935,16.607,21,11,4,7,10,0,10,0,0.0,0.0
1004,2862,27-09-2019 11:02:00,1,3385.0,3001.0,0.887,16.658,0,0,0,0,0,0,0,0,0.0,0.0
1004,2863,27-09-2019 11:04:00,1,3158.0,2907.0,0.921,15.659,0,0,0,0,0,0,0,0,0.0,0.0
1004,2864,27-09-2019 11:06:00,1,3181.0,2851.0,0.896,15.69,66,64,35,29,2,0,2,0,0.0,0.0
1004,2865,27-09-2019 11:08:00,1,3185.0,2850.0,0.895,15.706,8,8,1,7,0,0,0,0,0.0,0.0
1004,2866,27-09-2019 11:10:00,1,3086.0,2800.0,0.907,15.258,2,1,0,1,1,0,1,0,0.0,0.0
1004,2867,27-09-2019 11:12:00,1,2871.0,2674.0,0.931,14.272,21,15,11,4,6,1,5,0,0.0,0.0
1004,2868,27-09-2019 11:14:00,1,2894.0,2635.0,0.911,14.319,10,9,4,5,1,0,1,0,0.0,0.0
1004,2869,27-09-2019 11:16:00,1,2905.0,2652.0,0.913,14.381,21,14,9,5,7,1,6,0,0.0,0.0
1004,2870,27-09-2019 11:18:00,1,2870.0,2675.0,0.932,14.27,3,1,0,1,2,0,2,0,0.0,0.0
1004,2871,27-09-2019 11:20:00,1,2908.0,2594.0,0.892,14.329,7,1,0,1,6,0,6,0,0.0,0.0
1004,2872,27-09-2019 11:22:00,1,2901.0,2588.0,0.892,14.295,101,54,45,9,47,26,21,2,0.0,0.0
1004,2873,27-09-2019 11:24:00,1,2908.0,2622.0,0.902,14.359,13,0,0,0,13,0,13,0,0.0,0.0
1004,2874,27-09-2019 11:26:00,1,2920.0,2577.0,0.883,14.36,2,0,0,0,2,0,2,0,0.0,0.0
1004,2875,27-09-2019 11:28:00,1,2894.0,2604.0,0.9,14.284,1,0,0,0,1,0,1,0,0.0,0.0
1004,2876,27-09-2019 11:30:00,1,2897.0,2602.5,0.8985,14.294,4,2,0,2,2,0,2,0,0.0,0.0
1004,2877,27-09-2019 11:32:00,1,2900.0,2601.0,0.897,14.304,9,6,1,5,3,0,3,0,0.0,0.0
1004,2878,27-09-2019 11:34:00,1,2804.0,2542.0,0.907,13.863,57,38,19,19,19,2,17,0,0.0,0.0
1004,2879,27-09-2019 11:36:00,1,3177.0,2873.0,0.904,15.697,4,4,2,2,0,0,0,0,0.0,0.0
1004,2880,27-09-2019 11:38:00,1,3243.0,3055.0,0.942,16.158,16,4,0,4,12,2,10,0,0.0,0.0
1004,2881,27-09-2019 11:40:00,1,2965.0,2818.0,0.95,14.803,127,72,47,25,55,13,42,62,0.0,0.0
1004,2882,27-09-2019 11:42:00,1,3089.0,2785.0,0.901,15.255,102,62,31,31,40,1,39,31,0.0,0.0
1004,2883,27-09-2019 11:44:00,1,3358.0,3062.0,0.912,16.622,119,76,40,36,43,3,40,41,0.0,0.0
1004,2884,27-09-2019 11:46:00,1,3530.0,3258.0,0.923,17.515,133,89,54,35,44,2,42,41,0.0,0.0
1004,2885,27-09-2019 11:48:00,1,3615.0,3405.0,0.942,18.013,93,59,28,31,34,4,30,29,0.0,0.03
1004,2886,27-09-2019 11:50:00,1,3804.0,3555.0,0.935,18.924,101,67,33,34,34,4,30,33,0.0,0.07
1004,2887,27-09-2019 11:52:00,1,4024.0,3688.0,0.916,19.938,93,67,38,29,26,0,26,22,0.0,0.07
1004,2888,27-09-2019 11:54:00,1,3986.0,3778.0,0.948,19.886,105,73,44,29,32,0,32,49,0.0,0.01
1004,2889,27-09-2019 11:56:00,1,4283.0,3946.0,0.921,21.243,100,63,38,25,37,15,22,42,0.19,0.07
1004,2890,27-09-2019 11:58:00,1,4421.0,4279.0,0.968,22.158,453,251,190,61,202,149,53,70,0.08,0.0
1004,2891,27-09-2019 12:00:00,1,3702.0,3453.0,0.933,18.409,428,249,186,63,179,124,55,39,0.0,0.13
1004,2892,27-09-2019 12:02:00,1,3987.0,3754.0,0.942,19.865,160,130,79,51,30,2,28,49,0.0,0.0
1004,2893,27-09-2019 12:04:00,1,4224.0,3979.5,0.9425,21.049,99,74,46,28,25,0,25,22,0.01,0.0
1004,2894,27-09-2019 12:06:00,1,4461.0,4205.0,0.943,22.233,165,119,70,49,46,0,46,52,0.0,0.02
1004,2895,27-09-2019 12:08:00,1,4420.0,4260.0,0.964,22.131,256,149,106,43,107,60,47,30,0.14,0.04
1004,2896,27-09-2019 12:10:00,1,3966.0,3773.0,0.952,19.802,447,272,203,69,175,121,54,4,0.01,0.01
1004,2897,27-09-2019 12:12:00,1,4474.0,4117.0,0.92,22.185,348,184,141,43,164,121,43,16,0.03,0.02
1004,2898,27-09-2019 12:14:00,1,4183.0,3903.0,0.933,20.801,56,33,11,22,23,14,9,0,0.0,0.0
1004,2899,27-09-2019 12:16:00,1,4284.0,3948.0,0.922,21.248,169,74,45,29,95,55,40,1,0.0,0.0
1004,2900,27-09-2019 12:18:00,1,4461.0,4150.0,0.93,22.169,428,242,173,69,186,133,53,6,0.0,0.0
1004,2901,27-09-2019 12:20:00,1,4266.0,4026.0,0.944,21.266,85,62,34,28,23,8,15,0,0.0,0.0
1004,2902,27-09-2019 12:22:00,1,4269.0,4038.0,0.946,21.289,176,87,48,39,89,54,35,0,0.0,0.0
1004,2903,27-09-2019 12:24:00,1,4237.0,4075.0,0.962,21.204,41,25,8,17,16,4,12,0,0.0,0.0
1004,2904,27-09-2019 12:26:00,1,4278.0,4001.0,0.935,21.285,95,76,41,35,19,1,18,0,0.01,0.0
1004,2905,27-09-2019 12:28:00,1,4277.0,4002.0,0.936,21.28,2,2,1,1,0,0,0,0,0.0,0.0
1004,2906,27-09-2019 12:30:00,1,3994.0,3701.0,0.927,19.836,10,8,3,5,2,1,1,0,0.0,0.0
1004,2907,27-09-2019 12:32:00,1,3803.0,3620.0,0.952,18.99,1,1,0,1,0,0,0,0,0.0,0.0
1004,2908,27-09-2019 12:34:00,1,3717.0,3415.0,0.919,18.428,7,6,2,4,1,0,1,0,0.0,0.0
1004,2909,27-09-2019 12:36:00,1,3540.0,3318.0,0.937,17.62,1,1,0,1,0,0,0,0,0.0,0.0
1004,2910,27-09-2019 12:38:00,1,3361.0,3111.5,0.925,16.6875,5,2,0,2,3,0,3,0,0.0,0.0
1004,2911,27-09-2019 12:40:00,1,3182.0,2905.0,0.913,15.755,12,3,0,3,9,0,9,0,0.0,0.0
1004,2912,27-09-2019 12:42:00,1,3214.0,2734.0,0.851,15.69,46,37,22,15,9,1,8,0,0.0,0.0
1004,2913,27-09-2019 12:44:00,1,3175.0,2884.0,0.909,15.701,0,0,0,0,0,0,0,0,0.0,0.0
1004,2914,27-09-2019 12:46:00,1,2867.0,2681.0,0.935,14.264,0,0,0,0,0,0,0,0,0.0,0.0
1004,2915,27-09-2019 12:48:00,1,2886.0,2680.0,0.929,14.338,0,0,0,0,0,0,0,0,0.0,0.0
1004,2916,27-09-2019 12:50:00,1,2868.0,2719.0,0.948,14.311,22,18,7,11,4,2,2,0,0.0,0.0
1005,1,23-09-2019 11:40:00,1,4595.0,3533.0,0.769,22.019,239,151,110,41,88,56,32,33,0.01,0.0
1005,2,23-09-2019 11:42:00,1,4406.0,3449.0,0.783,21.177,92,66,37,29,26,8,18,12,0.0,0.0
1005,3,23-09-2019 11:44:00,1,4597.0,3561.0,0.775,22.054,127,93,57,36,34,9,25,2,0.0,0.0
1005,4,23-09-2019 11:46:00,1,4455.5,3461.0,0.777,21.386,83,64,29,35,19,2,17,6,0.0,0.0
1005,5,23-09-2019 11:48:00,1,4314.0,3361.0,0.779,20.718,98,66,35,31,32,15,17,17,0.0,0.0
1005,6,23-09-2019 11:50:00,1,4070.0,3332.0,0.819,19.726,142,95,62,33,47,21,26,11,0.0,0.0
1005,7,23-09-2019 11:52:00,1,4286.0,3407.0,0.795,20.658,75,51,37,14,24,14,10,9,0.0,0.0
1005,8,23-09-2019 11:54:00,1,3913.0,3090.0,0.79,18.838,374,253,197,56,121,85,36,60,0.0,0.0
1005,9,23-09-2019 11:56:00,1,3902.0,3077.0,0.789,18.783,107,67,29,38,40,15,25,0,0.0,0.0
1005,10,23-09-2019 11:58:00,1,3926.0,3041.0,0.775,18.838,148,123,92,31,25,8,17,6,0.0,0.01
1005,11,23-09-2019 12:00:00,1,3605.0,2905.0,0.806,17.419,172,123,97,26,49,31,18,8,0.0,0.01
1005,12,23-09-2019 12:02:00,1,3906.0,3044.0,0.779,18.758,81,57,32,25,24,8,16,4,0.0,0.0
1005,13,23-09-2019 12:04:00,1,3919.0,3021.0,0.771,18.788,141,91,62,29,50,33,17,15,0.0,0.0
1005,14,23-09-2019 12:06:00,1,3945.0,2977.0,0.755,18.84,67,36,10,26,31,3,28,0,0.0,0.0
1005,15,23-09-2019 12:08:00,1,3836.0,2999.0,0.782,18.435,157,113,71,42,44,18,26,18,0.0,0.0
1005,16,23-09-2019 12:10:00,1,3708.0,2958.0,0.798,17.885,232,147,114,33,85,58,27,95,0.0,0.0
1005,17,23-09-2019 12:12:00,1,3423.0,2747.0,0.802,16.528,531,451,373,78,80,50,30,10,0.0,0.0
1005,18,23-09-2019 12:14:00,1,3457.0,2647.0,0.766,16.55,235,190,143,47,45,22,23,16,0.0,0.0
1005,19,23-09-2019 12:16:00,1,3626.0,2858.0,0.788,17.45,97,79,49,30,18,7,11,7,0.0,0.0
1005,20,23-09-2019 12:18:00,1,3604.0,2893.0,0.803,17.402,103,74,36,38,29,4,25,1,0.0,0.0
1005,21,23-09-2019 12:20:00,1,3579.0,2780.0,0.7765,17.179,20,12,5,7,8,3,5,0,0.0,0.0
1005,22,23-09-2019 12:22:00,1,3554.0,2667.0,0.75,16.956,0,0,0,0,0,0,0,0,0.0,0.0
1005,23,23-09-2019 12:24:00,1,3258.0,2475.0,0.76,15.576,7,6,0,6,1,0,1,0,0.0,0.0
1005,24,23-09-2019 12:26:00,1,3292.0,2431.0,0.738,15.664,8,8,0,8,0,0,0,0,0.0,0.0
1005,25,23-09-2019 12:28:00,1,3063.0,2298.0,0.75,14.612,5,5,0,5,0,0,0,0,0.0,0.0
1005,26,23-09-2019 12:30:00,1,3118.0,2194.0,0.704,14.715,3,3,0,3,0,0,0,0,0.0,0.0
1005,27,23-09-2019 12:32:00,1,2783.0,2137.0,0.768,13.333,4,3,0,3,1,1,0,0,0.0,0.0
1005,28,23-09-2019 12:34:00,1,2807.0,2120.0,0.755,13.406,0,0,0,0,0,0,0,0,0.0,0.0
1005,29,23-09-2019 12:36:00,1,2793.0,2047.0,0.733,13.273,73,55,26,29,18,7,11,3,0.0,0.0
1005,30,23-09-2019 12:38:00,1,3071.0,2321.0,0.756,14.671,457,323,259,64,134,95,39,47,0.0,0.0
1005,31,23-09-2019 12:40:00,1,3252.0,2545.0,0.783,15.631,255,166,126,40,89,59,30,61,0.0,0.0
1005,32,23-09-2019 12:42:00,1,3247.0,2545.0,0.784,15.612,130,78,56,22,52,42,10,46,0.0,0.0
1005,33,23-09-2019 12:44:00,1,3753.0,2869.0,0.764,17.962,158,97,78,19,61,42,19,17,0.0,0.0
1005,34,23-09-2019 12:46:00,1,3525.0,2769.0,0.786,16.954,102,62,37,25,40,23,17,76,0.0,0.0
1005,35,23-09-2019 12:48:00,1,3554.0,2656.0,0.747,16.944,201,159,115,44,42,20,22,28,0.0,0.0
1005,36,23-09-2019 12:50:00,1,3339.0,2605.0,0.78,16.038,435,328,274,54,107,84,23,25,0.0,0.0
1005,37,23-09-2019 12:52:00,1,2909.0,2156.0,0.741,13.849,140,97,59,38,43,29,14,47,0.0,0.0
1005,38,23-09-2019 12:54:00,1,3124.5,2372.0,0.758,14.9365,34,26,13,13,8,1,7,0,0.0,0.0
1005,39,23-09-2019 12:56:00,1,3340.0,2588.0,0.775,16.024,95,72,37,35,23,4,19,3,0.0,0.0
1005,40,23-09-2019 12:58:00,1,3347.0,2603.0,0.778,16.07,108,90,55,35,18,3,15,1,0.0,0.0
1005,41,23-09-2019 13:00:00,1,3566.0,2678.0,0.751,17.016,54,39,27,12,15,4,11,11,0.0,0.0
1005,42,23-09-2019 13:02:00,1,3280.0,2462.0,0.751,15.648,2,1,1,0,1,0,1,0,0.0,0.0
1005,43,23-09-2019 13:04:00,1,3079.0,2266.0,0.736,14.639,0,0,0,0,0,0,0,0,0.0,0.0
1005,44,23-09-2019 13:06:00,1,2687.0,2036.0,0.758,12.843,1,0,0,0,1,0,1,0,0.0,0.0
1005,45,23-09-2019 13:08:00,1,2606.0,1892.0,0.726,12.364,3,1,0,1,2,0,2,0,0.0,0.0
1005,46,23-09-2019 13:10:00,1,2514.0,1874.0,0.746,11.98,0,0,0,0,0,0,0,0,0.0,0.0
1005,47,23-09-2019 13:12:00,1,2411.0,1830.0,0.759,11.528,22,19,8,11,3,1,2,0,0.0,0.0
1005,48,23-09-2019 13:14:00,1,2417.0,1759.0,0.727,11.472,15,15,0,15,0,0,0,0,0.0,0.0
1005,49,23-09-2019 13:16:00,1,2412.0,1760.0,0.73,11.453,23,22,11,11,1,1,0,0,0.0,0.0
1005,50,23-09-2019 13:18:00,1,2431.0,1734.0,0.713,11.5,1,1,0,1,0,0,0,0,0.0,0.0
1005,51,23-09-2019 13:20:00,1,2402.0,1813.0,0.755,11.471,0,0,0,0,0,0,0,0,0.0,0.0
1005,52,23-09-2019 13:22:00,1,2514.0,1874.0,0.746,11.979,27,21,10,11,6,3,3,0,0.0,0.0
1005,53,23-09-2019 13:24:00,1,2211.0,1672.0,0.757,10.562,0,0,0,0,0,0,0,0,0.0,0.0
1005,54,23-09-2019 13:26:00,1,2097.0,1640.0,0.782,10.078,0,0,0,0,0,0,0,0,0.0,0.0
1005,55,23-09-2019 13:28:00,1,2486.5,1922.5,0.7745,11.926,106,81,54,27,25,15,10,4,0.0,0.0
1005,56,23-09-2019 13:30:00,1,2876.0,2205.0,0.767,13.774,237,170,125,45,67,49,18,70,0.0,0.0
1005,57,23-09-2019 13:32:00,1,3259.0,2576.0,0.79,15.694,222,119,90,29,103,65,38,55,0.0,0.0
1005,58,23-09-2019 13:34:00,1,3344.0,2589.0,0.774,16.042,113,83,52,31,30,9,21,62,0.0,0.0
1005,59,23-09-2019 13:36:00,1,3549.0,2681.0,0.755,16.953,132,98,64,34,34,12,22,62,0.0,0.0
1005,60,23-09-2019 13:38:00,1,3247.0,2533.0,0.78,15.597,204,156,106,50,48,33,15,38,0.0,0.0
1005,61,23-09-2019 13:40:00,1,3164.0,2442.0,0.772,15.172,196,126,91,35,70,44,26,44,0.0,0.0
1005,62,23-09-2019 13:42:00,1,3087.0,2296.0,0.744,14.705,56,43,14,29,13,3,10,1,0.0,0.0
1005,63,23-09-2019 13:44:00,1,3074.0,2333.0,0.759,14.697,15,15,0,15,0,0,0,0,0.0,0.0
1005,64,23-09-2019 13:46:00,1,3048.0,2439.0,0.8,14.711,94,83,41,42,11,2,9,11,0.0,0.0
1005,65,23-09-2019 13:48:00,1,3229.0,2608.0,0.808,15.608,147,119,84,35,28,8,20,12,0.0,0.0
1005,66,23-09-2019 13:50:00,1,3135.0,2474.0,0.789,15.093,336,245,189,56,91,53,38,0,0.0,0.0
1005,67,23-09-2019 13:52:00,1,2573.0,2012.0,0.782,12.365,542,395,321,74,147,100,47,3,0.0,0.0
1005,68,23-09-2019 13:54:00,1,2968.0,2256.0,0.76,14.191,489,377,312,65,112,70,42,11,0.0,0.0
1005,69,23-09-2019 13:56:00,1,3046.0,2451.0,0.805,14.716,263,164,129,35,99,60,39,14,0.0,0.0
1005,70,23-09-2019 13:58:00,1,2866.0,2234.0,0.78,13.766,41,26,7,19,15,0,15,0,0.0,0.0
1005,71,23-09-2019 14:00:00,1,2781.0,2188.0,0.787,13.378,25,24,0,24,1,0,1,0,0.0,0.0
1005,72,23-09-2019 14:02:00,1,3002.0,2429.5,0.808,14.5165,49,44,14,30,5,0,5,2,0.0,0.0
1005,73,23-09-2019 14:04:00,1,3223.0,2671.0,0.829,15.655,44,29,14,15,15,2,13,0,0.0,0.0
1005,74,23-09-2019 14:06:00,1,2785.0,2127.0,0.764,13.329,0,0,0,0,0,0,0,0,0.0,0.0
1005,75,23-09-2019 14:08:00,1,2591.0,1988.0,0.767,12.41,0,0,0,0,0,0,0,0,0.0,0.0
1005,76,23-09-2019 14:10:00,1,2389.0,1857.0,0.777,11.47,3,0,0,0,3,0,3,0,0.0,0.0
1005,77,23-09-2019 14:12:00,1,2588.0,1987.0,0.768,12.398,36,23,13,10,13,0,13,0,0.0,0.0
1005,78,23-09-2019 14:14:00,1,2604.0,1911.0,0.734,12.375,31,31,1,30,0,0,0,0,0.0,0.0
1005,79,23-09-2019 14:16:00,1,2491.0,1912.0,0.767,11.931,11,9,2,7,2,0,2,0,0.0,0.0
1005,80,23-09-2019 14:18:00,1,2404.0,1800.0,0.749,11.466,5,3,0,3,2,0,2,0,0.0,0.0
1005,81,23-09-2019 14:20:00,1,2423.0,1758.0,0.725,11.493,3,2,0,2,1,0,1,0,0.0,0.0
1005,82,23-09-2019 14:22:00,1,2498.0,1896.0,0.759,11.942,11,10,5,5,1,0,1,0,0.0,0.0
1005,83,23-09-2019 14:24:00,1,2409.0,1818.0,0.755,11.504,0,0,0,0,0,0,0,0,0.0,0.0
1005,84,23-09-2019 14:26:00,1,2401.0,1849.0,0.77,11.505,0,0,0,0,0,0,0,0,0.0,0.0
1005,85,23-09-2019 14:28:00,1,2505.0,1901.0,0.759,11.974,2,1,0,1,1,0,1,0,0.0,0.0
1005,86,23-09-2019 14:30:00,1,2416.0,1749.0,0.724,11.457,8,5,3,2,3,0,3,0,0.0,0.0
1005,87,23-09-2019 14:32:00,1,2390.0,1812.0,0.758,11.422,3,1,0,1,2,0,2,0,0.0,0.0
1005,88,23-09-2019 14:34:00,1,2413.0,1793.0,0.743,11.491,0,0,0,0,0,0,0,0,0.0,0.0
1005,89,23-09-2019 14:36:00,1,2363.5,1760.5,0.745,11.2605,6,1,1,0,5,0,5,0,0.0,0.0
1005,90,23-09-2019 14:38:00,1,2314.0,1728.0,0.747,11.03,0,0,0,0,0,0,0,0,0.0,0.0
1005,91,23-09-2019 14:40:00,1,2407.0,1759.0,0.731,11.433,1,0,0,0,1,0,1,0,0.0,0.0
1005,92,23-09-2019 14:42:00,1,2417.0,1770.0,0.733,11.482,1,0,0,0,1,0,1,0,0.0,0.0
1005,93,23-09-2019 14:44:00,1,2432.0,1744.0,0.717,11.512,0,0,0,0,0,0,0,0,0.0,0.0
1005,94,23-09-2019 14:46:00,1,2405.0,1855.0,0.772,11.528,15,11,6,5,4,0,4,0,0.0,0.0
1005,95,23-09-2019 14:48:00,1,2409.0,1787.0,0.742,11.47,0,0,0,0,0,0,0,0,0.0,0.0
1005,96,23-09-2019 14:50:00,1,2390.0,1843.0,0.771,11.458,0,0,0,0,0,0,0,0,0.0,0.0
1005,97,23-09-2019 14:52:00,1,2410.0,1794.0,0.745,11.481,0,0,0,0,0,0,0,0,0.0,0.0
1005,98,23-09-2019 14:54:00,1,2312.0,1706.0,0.738,10.998,2,2,0,2,0,0,0,0,0.0,0.0
1005,99,23-09-2019 14:56:00,1,2305.0,1738.0,0.754,11.007,0,0,0,0,0,0,0,0,0.0,0.0
1005,100,23-09-2019 14:58:00,1,2404.0,1801.0,0.749,11.464,0,0,0,0,0,0,0,0,0.0,0.0
1005,101,23-09-2019 15:00:00,1,2409.0,1810.0,0.751,11.496,0,0,0,0,0,0,0,0,0.0,0.0
1005,102,23-09-2019 15:02:00,1,2399.0,1818.0,0.758,11.467,1,0,0,0,1,1,0,0,0.0,0.0
1005,103,23-09-2019 15:04:00,1,2414.0,1816.0,0.752,11.522,0,0,0,0,0,0,0,0,0.0,0.0
1005,104,23-09-2019 15:06:00,1,2400.0,1808.0,0.753,11.458,0,0,0,0,0,0,0,0,0.0,0.0
1005,105,23-09-2019 15:08:00,1,2316.0,1704.0,0.736,11.013,0,0,0,0,0,0,0,0,0.0,0.0
1005,106,23-09-2019 15:10:00,1,2455.5,1823.5,0.7425,11.6935,32,19,7,12,13,3,10,1,0.0,0.0
1005,107,23-09-2019 15:12:00,1,2595.0,1943.0,0.749,12.374,4,3,0,3,1,0,1,0,0.0,0.0
1005,108,23-09-2019 15:14:00,1,2380.0,1864.0,0.783,11.443,2,1,0,1,1,0,1,0,0.0,0.0
1005,109,23-09-2019 15:16:00,1,2395.0,1825.0,0.762,11.456,1,1,0,1,0,0,0,0,0.0,0.0
1005,110,23-09-2019 15:18:00,1,2401.0,1850.0,0.771,11.508,0,0,0,0,0,0,0,0,0.0,0.0
1005,111,23-09-2019 15:20:00,1,2396.0,1882.0,0.785,11.525,10,6,2,4,4,0,4,0,0.0,0.0
1005,112,23-09-2019 15:22:00,1,2383.0,1904.0,0.799,11.496,16,10,6,4,6,0,6,0,0.0,0.0
1005,113,23-09-2019 15:24:00,1,2595.0,1999.0,0.77,12.437,1,1,1,0,0,0,0,0,0.0,0.0
1005,114,23-09-2019 15:26:00,1,2403.0,1843.0,0.767,11.51,4,1,0,1,3,0,3,0,0.0,0.0
1005,115,23-09-2019 15:28:00,1,2410.0,1829.0,0.759,11.521,0,0,0,0,0,0,0,0,0.0,0.0
1005,116,23-09-2019 15:30:00,1,2394.0,1822.0,0.761,11.451,4,3,1,2,1,0,1,0,0.0,0.0
1005,117,23-09-2019 15:32:00,1,2379.0,1871.0,0.786,11.445,4,1,0,1,3,0,3,0,0.0,0.0
1005,118,23-09-2019 15:34:00,1,2388.0,1838.0,0.77,11.444,10,0,0,0,10,0,10,0,0.0,0.0
1005,119,23-09-2019 15:36:00,1,2382.0,1882.0,0.79,11.47,3,0,0,0,3,0,3,0,0.0,0.0
1005,120,23-09-2019 15:38:00,1,2384.0,1897.0,0.795,11.495,2,1,1,0,1,0,1,0,0.0,0.0
1005,121,23-09-2019 15:40:00,1,2389.0,1885.0,0.789,11.499,8,2,0,2,6,0,6,0,0.0,0.0
1005,122,23-09-2019 15:42:00,1,2395.0,1852.0,0.773,11.489,1,0,0,0,1,0,1,0,0.0,0.0
1005,123,23-09-2019 15:44:00,1,2390.0,1858.0,0.7775,11.4745,0,0,0,0,0,0,0,0,0.0,0.0
1005,124,23-09-2019 15:46:00,1,2385.0,1864.0,0.782,11.46,0,0,0,0,0,0,0,0,0.0,0.0
1005,125,23-09-2019 15:48:00,1,2387.0,1855.0,0.777,11.457,67,42,14,28,25,4,21,0,0.0,0.0
1005,126,23-09-2019 15:50:00,1,2853.0,2315.0,0.811,13.803,189,143,102,41,46,28,18,43,0.0,0.06
1005,127,23-09-2019 15:52:00,1,3241.0,2606.0,0.804,15.655,202,150,107,43,52,31,21,39,0.0,0.0
1005,128,23-09-2019 15:54:00,1,3234.0,2609.0,0.807,15.633,161,99,67,32,62,32,30,54,0.0,0.0
1005,129,23-09-2019 15:56:00,1,3427.0,2748.0,0.802,16.545,118,73,44,29,45,28,17,46,0.0,0.0
1005,130,23-09-2019 15:58:00,1,3429.0,2719.0,0.793,16.523,90,62,28,34,28,5,23,56,0.0,0.0
1005,131,23-09-2019 16:00:00,1,3522.0,2813.0,0.799,16.992,91,20,6,14,71,46,25,32,0.0,0.0
1005,132,23-09-2019 16:02:00,1,3515.0,2895.0,0.824,17.053,143,38,17,21,105,61,44,38,0.0,0.0
1005,133,23-09-2019 16:04:00,1,3510.0,2843.0,0.81,16.977,100,49,23,26,51,11,40,50,0.0,0.0
1005,134,23-09-2019 16:06:00,1,3238.0,2588.0,0.799,15.622,295,219,163,56,76,49,27,14,0.0,0.0
1005,135,23-09-2019 16:08:00,1,2546.0,2160.0,0.849,12.421,330,197,147,50,133,85,48,35,0.0,0.0
1005,136,23-09-2019 16:10:00,1,3526.0,2817.0,0.799,17.013,103,34,13,21,69,38,31,36,0.0,0.0
1005,137,23-09-2019 16:12:00,1,3677.0,3042.0,0.827,17.856,126,26,4,22,100,45,55,51,0.0,0.0
1005,138,23-09-2019 16:14:00,1,3668.0,3090.0,0.843,17.874,115,59,30,29,56,8,48,50,0.0,0.0
1005,139,23-09-2019 16:16:00,1,3484.0,2981.0,0.855,17.028,249,150,104,46,99,63,36,54,0.0,0.0
1005,140,23-09-2019 16:18:00,1,3261.0,2739.5,0.8385,15.882,108,78,49,29,30,13,17,12,0.0,0.0
1005,141,23-09-2019 16:20:00,1,3038.0,2498.0,0.822,14.736,86,52,18,34,34,3,31,1,0.0,0.0
1005,142,23-09-2019 16:22:00,1,3022.0,2563.0,0.848,14.746,71,49,16,33,22,0,22,0,0.0,0.0
1005,143,23-09-2019 16:24:00,1,2985.0,2645.0,0.886,14.69,73,59,10,49,14,0,14,0,0.0,0.0
1005,144,23-09-2019 16:26:00,1,3217.0,2677.0,0.832,15.638,74,55,22,33,19,2,17,0,0.0,0.1
1005,145,23-09-2019 16:28:00,1,3023.0,2499.0,0.826,14.678,37,13,4,9,24,0,24,0,0.0,0.0
1005,146,23-09-2019 16:30:00,1,2734.0,2321.0,0.849,13.341,1,1,0,1,0,0,0,0,0.0,0.0
1005,147,23-09-2019 16:32:00,1,2624.0,2248.0,0.857,12.827,0,0,0,0,0,0,0,0,0.0,0.0
1005,148,23-09-2019 16:34:00,1,2530.0,2186.0,0.864,12.39,0,0,0,0,0,0,0,0,0.0,0.0
1005,149,23-09-2019 16:36:00,1,2560.0,2125.0,0.83,12.441,0,0,0,0,0,0,0,0,0.0,0.0
1005,150,23-09-2019 16:38:00,1,2445.0,2089.0,0.854,11.947,1,1,0,1,0,0,0,0,0.0,0.0
1005,151,23-09-2019 16:40:00,1,2344.0,2014.0,0.859,11.467,0,0,0,0,0,0,0,0,0.0,0.0
1005,152,23-09-2019 16:42:00,1,2360.0,2003.0,0.849,11.516,6,0,0,0,6,0,6,0,0.0,0.0
1005,153,23-09-2019 16:44:00,1,2351.0,2029.0,0.863,11.51,22,17,7,10,5,0,5,0,0.0,0.0
1005,154,23-09-2019 16:46:00,1,2332.0,2035.0,0.872,11.443,3,2,0,2,1,0,1,0,0.0,0.0
1005,155,23-09-2019 16:48:00,1,2352.0,2022.0,0.86,11.505,9,8,2,6,1,0,1,0,0.0,0.0
1005,156,23-09-2019 16:50:00,1,2547.0,2102.0,0.825,12.363,18,17,9,8,1,0,1,0,0.0,0.0
1005,157,23-09-2019 16:52:00,1,2457.5,2005.0,0.8155,11.903,6,2,1,1,4,1,3,0,0.0,0.0
1005,158,23-09-2019 16:54:00,1,2368.0,1908.0,0.806,11.443,0,0,0,0,0,0,0,0,0.0,0.0
1005,159,23-09-2019 16:56:00,1,2347.0,2014.0,0.858,11.479,2,0,0,0,2,1,1,0,0.0,0.0
1005,160,23-09-2019 16:58:00,1,2344.0,2024.0,0.863,11.477,3,0,0,0,3,0,3,0,0.0,0.0
1005,161,23-09-2019 17:00:00,1,2354.0,2047.0,0.87,11.539,1,0,0,0,1,0,1,0,0.0,0.0
1005,162,23-09-2019 17:02:00,1,2373.0,1959.0,0.825,11.52,3,0,0,0,3,0,3,0,0.0,0.0
1005,163,23-09-2019 17:04:00,1,2354.0,2028.0,0.861,11.519,3,0,0,0,3,0,3,0,0.0,0.0
1005,164,23-09-2019 17:06:00,1,2368.0,1975.0,0.834,11.518,4,0,0,0,4,0,4,0,0.0,0.0
1005,165,23-09-2019 17:08:00,1,2362.0,1965.0,0.832,11.484,5,3,2,1,2,0,2,0,0.0,0.0
1005,166,23-09-2019 17:10:00,1,2373.0,1987.0,0.837,11.549,7,3,3,0,4,0,4,0,0.0,0.0
1005,167,23-09-2019 17:12:00,1,2337.0,2007.0,0.859,11.432,50,33,19,14,17,8,9,8,0.0,0.0
1005,168,23-09-2019 17:14:00,1,2827.0,2356.0,0.833,13.749,101,73,36,37,28,2,26,0,0.0,0.0
1005,169,23-09-2019 17:16:00,1,3208.0,2666.0,0.831,15.593,171,115,76,39,56,37,19,51,0.0,0.0
1005,170,23-09-2019 17:18:00,1,3248.0,2632.0,0.81,15.71,107,83,43,40,24,9,15,57,0.0,0.0
1005,171,23-09-2019 17:20:00,1,3484.0,2954.0,0.848,16.999,82,34,19,15,48,25,23,18,0.0,0.0
1005,172,23-09-2019 17:22:00,1,3196.0,2732.0,0.855,15.617,199,130,85,45,69,50,19,46,0.0,0.0
1005,173,23-09-2019 17:24:00,1,3242.0,2620.0,0.808,15.675,89,41,20,21,48,22,26,30,0.0,0.0
1005,174,23-09-2019 17:26:00,1,3388.5,2721.0,0.803,16.3645,129,80,42,38,49,8,41,58,0.0,0.0
1005,175,23-09-2019 17:28:00,1,3535.0,2822.0,0.798,17.054,124,32,16,16,92,55,37,42,0.0,0.0
1005,176,23-09-2019 17:30:00,1,3683.0,3065.0,0.832,17.902,102,51,25,26,51,23,28,32,0.0,0.0
1005,177,23-09-2019 17:32:00,1,3026.0,2489.0,0.822,14.68,61,41,15,26,20,2,18,0,0.0,0.0
1005,178,23-09-2019 17:34:00,1,3221.0,2607.0,0.809,15.579,25,19,2,17,6,2,4,0,0.0,0.0
1005,179,23-09-2019 17:36:00,1,2933.0,2401.0,0.819,14.214,45,41,17,24,4,2,2,3,0.0,0.0
1005,180,23-09-2019 17:38:00,1,3477.0,2995.0,0.861,17.016,69,41,14,27,28,9,19,1,0.0,0.0
1005,181,23-09-2019 17:40:00,1,3199.0,2706.0,0.846,15.599,21,8,0,8,13,1,12,0,0.0,0.0
1005,182,23-09-2019 17:42:00,1,2833.0,2387.0,0.843,13.805,7,2,0,2,5,0,5,0,0.0,0.0
1005,183,23-09-2019 17:44:00,1,2736.0,2312.0,0.845,13.341,15,10,6,4,5,2,3,0,0.0,0.0
1005,184,23-09-2019 17:46:00,1,2832.0,2411.0,0.852,13.826,0,0,0,0,0,0,0,0,0.0,0.0
1005,185,23-09-2019 17:48:00,1,2730.0,2371.0,0.868,13.383,11,10,2,8,1,1,0,0,0.0,0.0
1005,186,23-09-2019 17:50:00,1,2722.0,2411.0,0.886,13.394,15,9,5,4,6,3,3,0,0.0,0.0
1005,187,23-09-2019 17:52:00,1,2643.0,2255.0,0.853,12.91,4,4,1,3,0,0,0,0,0.0,0.0
1005,188,23-09-2019 17:54:00,1,2527.0,2215.0,0.876,12.409,31,16,8,8,15,6,9,0,0.0,0.0
1005,189,23-09-2019 17:56:00,1,2350.0,2019.0,0.859,11.496,3,0,0,0,3,1,2,0,0.0,0.0
1005,190,23-09-2019 17:58:00,1,2556.0,2092.0,0.819,12.387,52,43,17,26,9,3,6,0,0.0,0.0
1005,191,23-09-2019 18:00:00,0,2549.0,2119.0,0.8315,12.389,159,94,53,41,65,36,29,5,0.0,0.0
1005,192,23-09-2019 18:02:00,0,2542.0,2146.0,0.844,12.391,308,187,144,43,121,86,35,62,0.0,0.0
1005,193,23-09-2019 18:04:00,0,3041.0,2474.0,0.813,14.722,247,153,98,55,94,65,29,18,0.0,0.0
1005,194,23-09-2019 18:06:00,0,2766.0,2243.0,0.811,13.382,422,225,169,56,197,146,51,74,0.0,0.0
1005,195,23-09-2019 18:08:00,0,3047.0,2448.0,0.803,14.717,176,89,59,30,87,44,43,43,0.0,0.0
1005,196,23-09-2019 18:10:00,0,3515.0,2842.0,0.809,16.997,121,92,46,46,29,13,16,46,0.0,0.0
1005,197,23-09-2019 18:12:00,0,3668.0,3075.0,0.839,17.856,167,80,33,47,87,41,46,52,0.0,0.0
1005,198,23-09-2019 18:14:00,0,3664.0,3098.0,0.845,17.867,162,46,16,30,116,63,53,52,0.0,0.0
1005,199,23-09-2019 18:16:00,0,3769.0,3130.0,0.83,18.316,321,151,116,35,170,114,56,53,0.0,0.0
1005,200,23-09-2019 18:18:00,0,3286.0,2857.0,0.869,16.11,428,195,157,38,233,179,54,77,0.05,0.0
1005,201,23-09-2019 18:20:00,0,3207.0,2694.0,0.84,15.618,284,150,110,40,134,91,43,59,0.0,0.0
1005,202,23-09-2019 18:22:00,0,3983.0,3273.0,0.822,19.317,166,32,6,26,134,74,60,54,0.0,0.0
1005,203,23-09-2019 18:24:00,0,3942.0,3416.0,0.867,19.312,147,59,19,40,88,54,34,48,0.0,0.0
1005,204,23-09-2019 18:26:00,0,3766.0,3267.0,0.868,18.455,215,112,83,29,103,62,41,43,0.0,0.0
1005,205,23-09-2019 18:28:00,0,3487.0,3000.0,0.86,17.059,172,88,58,30,84,55,29,28,0.0,0.0
1005,206,23-09-2019 18:30:00,0,3168.0,2865.0,0.904,15.654,144,92,68,24,52,41,11,26,0.0,0.0
1005,207,23-09-2019 18:32:00,0,3496.0,2933.0,0.839,17.022,75,24,7,17,51,17,34,0,0.0,0.0
1005,208,23-09-2019 18:34:00,0,3480.5,2982.0,0.857,17.0145,133,26,9,17,107,63,44,0,0.0,0.0
1005,209,23-09-2019 18:36:00,0,3465.0,3031.0,0.875,17.007,30,12,7,5,18,11,7,5,0.0,0.0
1005,210,23-09-2019 18:38:00,0,3192.0,2722.0,0.853,15.59,7,0,0,0,7,3,4,0,0.0,0.0
1005,211,23-09-2019 18:40:00,0,2985.0,2672.0,0.895,14.72,6,4,1,3,2,1,1,0,0.0,0.0
1005,212,23-09-2019 18:42:00,0,3023.0,2560.0,0.847,14.745,46,20,11,9,26,16,10,0,0.0,0.0
1005,213,23-09-2019 18:44:00,0,2800.0,2464.0,0.88,13.761,24,6,4,2,18,6,12,0,0.0,0.0
1005,214,23-09-2019 18:46:00,0,2715.0,2420.0,0.891,13.374,6,2,0,2,4,2,2,0,0.0,0.0
1005,215,23-09-2019 18:48:00,0,2714.0,2402.0,0.885,13.351,19,5,0,5,14,7,7,0,0.0,0.0
1005,216,23-09-2019 18:50:00,0,2729.0,2371.0,0.869,13.376,18,3,0,3,15,8,7,0,0.0,0.0
1005,217,23-09-2019 18:52:00,0,2733.0,2334.0,0.854,13.353,14,8,0,8,6,2,4,0,0.0,0.0
1005,218,23-09-2019 18:54:00,0,3165.0,2847.0,0.9,15.623,112,35,22,13,77,43,34,12,0.0,0.0
1005,219,23-09-2019 18:56:00,0,2974.0,2666.0,0.896,14.671,196,106,74,32,90,54,36,45,0.0,0.0
1005,220,23-09-2019 18:58:00,0,3160.0,2850.0,0.902,15.605,111,33,10,23,78,30,48,36,0.0,0.0
1005,221,23-09-2019 19:00:00,0,3469.0,3038.0,0.876,17.031,109,35,6,29,74,19,55,41,0.0,0.0
1005,222,23-09-2019 19:02:00,0,3560.0,3083.0,0.866,17.441,148,50,26,24,98,48,50,62,0.0,0.0
1005,223,23-09-2019 19:04:00,0,3686.0,3097.0,0.84,17.951,142,81,51,30,61,26,35,61,0.0,0.0
1005,224,23-09-2019 19:06:00,0,3662.0,3154.0,0.861,17.922,420,225,186,39,195,150,45,87,0.0,0.0
1005,225,23-09-2019 19:08:00,0,3667.5,3118.5,0.85,17.9025,429,217,169,48,212,159,53,95,0.0,0.0
1005,226,23-09-2019 19:10:00,0,3673.0,3083.0,0.839,17.883,351,203,155,48,148,112,36,111,0.0,0.0
1005,227,23-09-2019 19:12:00,0,3960.0,3428.0,0.866,19.399,450,251,209,42,199,146,53,96,0.0,0.0
1005,228,23-09-2019 19:14:00,0,3974.0,3330.0,0.838,19.346,258,131,83,48,127,64,63,58,0.0,0.0
1005,229,23-09-2019 19:16:00,0,4153.0,3535.0,0.851,20.276,182,54,22,32,128,74,54,66,0.0,0.0
1005,230,23-09-2019 19:18:00,0,3961.0,3390.0,0.856,19.36,200,106,68,38,94,50,44,60,0.0,0.0
1005,231,23-09-2019 19:20:00,0,4132.0,3649.0,0.883,20.319,157,64,29,35,93,42,51,52,0.0,0.0
1005,232,23-09-2019 19:22:00,0,4224.0,3731.0,0.883,20.772,213,114,80,34,99,66,33,35,0.0,0.0
1005,233,23-09-2019 19:24:00,0,3671.0,3176.0,0.865,17.981,479,249,198,51,230,181,49,63,0.0,0.03
1005,234,23-09-2019 19:26:00,0,4015.0,3603.0,0.897,19.808,334,145,106,39,189,129,60,72,0.0,0.0
1005,235,23-09-2019 19:28:00,0,4180.0,3724.0,0.891,20.593,119,8,0,8,111,73,38,35,0.0,0.0
1005,236,23-09-2019 19:30:00,0,3934.0,3506.0,0.891,19.381,126,60,36,24,66,42,24,5,0.0,0.0
1005,237,23-09-2019 19:32:00,0,3646.0,3204.0,0.879,17.911,244,129,99,30,115,80,35,63,0.0,0.01
1005,238,23-09-2019 19:34:00,0,3909.0,3494.0,0.894,19.27,330,140,101,39,190,140,50,49,0.0,0.0
1005,239,23-09-2019 19:36:00,0,3913.0,3518.0,0.899,19.314,236,102,69,33,134,92,42,71,0.0,0.0
1005,240,23-09-2019 19:38:00,0,3453.0,3067.0,0.888,17.001,395,192,152,40,203,146,57,49,0.0,0.01
1005,241,23-09-2019 19:40:00,0,3644.0,3239.0,0.889,17.943,200,69,37,32,131,74,57,59,0.0,0.0
1005,242,23-09-2019 19:42:00,0,3598.5,3218.0,0.8945,17.741,147,52,23,29,95,61,34,34,0.0,0.0
1005,243,23-09-2019 19:44:00,0,3553.0,3197.0,0.9,17.539,434,204,162,42,230,171,59,91,0.0,0.01
1005,244,23-09-2019 19:46:00,0,3613.0,3265.0,0.904,17.85,711,286,226,60,425,348,77,69,0.0,0.01
1005,245,23-09-2019 19:48:00,0,4181.0,3789.0,0.906,20.666,175,89,55,34,86,44,42,59,0.0,0.05
1005,246,23-09-2019 19:50:00,0,4297.0,3857.0,0.898,21.2,153,78,46,32,75,40,35,58,0.0,0.0
1005,247,23-09-2019 19:52:00,0,4123.0,3638.0,0.882,20.274,180,91,61,30,89,45,44,46,0.0,0.0
1005,248,23-09-2019 19:54:00,0,3479.0,3060.0,0.879,17.095,246,142,104,38,104,73,31,36,0.0,0.0
1005,249,23-09-2019 19:56:00,0,4095.0,3771.0,0.921,20.309,121,49,32,17,72,40,32,53,0.0,0.0
1005,250,23-09-2019 19:58:00,0,4130.0,3665.0,0.888,20.328,170,101,71,30,69,45,24,56,0.0,0.0
1005,251,23-09-2019 20:00:00,0,3618.0,3314.0,0.916,17.922,112,61,41,20,51,19,32,53,0.0,0.0
1005,252,23-09-2019 20:02:00,0,4089.0,3726.0,0.911,20.238,347,193,150,43,154,119,35,58,0.0,0.0
1005,253,23-09-2019 20:04:00,0,3902.0,3617.0,0.927,19.377,508,267,210,57,241,186,55,38,0.0,0.0
1005,254,23-09-2019 20:06:00,0,3594.0,3424.0,0.953,17.95,311,137,98,39,174,127,47,78,0.0,0.0
1005,255,23-09-2019 20:08:00,0,4067.0,3769.0,0.927,20.198,349,198,150,48,151,99,52,80,0.0,0.0
1005,256,23-09-2019 20:10:00,0,3937.0,3421.0,0.869,19.3,226,166,111,55,60,36,24,69,0.0,0.0
1005,257,23-09-2019 20:12:00,0,3883.0,3605.0,0.928,19.292,152,117,75,42,35,6,29,40,0.0,0.0
1005,258,23-09-2019 20:14:00,0,4087.0,3741.0,0.915,20.246,207,89,48,41,118,59,59,48,0.0,0.0
1005,259,23-09-2019 20:16:00,0,4038.5,3717.0,0.9205,20.027,112,45,22,23,67,32,35,26,0.0,0.03
1005,260,23-09-2019 20:18:00,0,3990.0,3693.0,0.926,19.808,95,52,25,27,43,8,35,48,0.0,0.0
1005,261,23-09-2019 20:20:00,0,4075.0,3816.0,0.937,20.279,152,57,31,26,95,49,46,39,0.0,0.0
1005,262,23-09-2019 20:22:00,0,4096.0,3769.0,0.92,20.311,198,110,67,43,88,49,39,75,0.0,0.0
1005,263,23-09-2019 20:24:00,0,3517.0,3245.0,0.923,17.449,336,189,150,39,147,117,30,79,0.0,0.01
1005,264,23-09-2019 20:26:00,0,3882.0,3625.0,0.934,19.306,182,113,78,35,69,29,40,62,0.0,0.0
1005,265,23-09-2019 20:28:00,0,4089.0,3740.0,0.915,20.252,158,111,76,35,47,20,27,33,0.0,0.03
1005,266,23-09-2019 20:30:00,0,3576.0,3438.0,0.961,17.897,591,309,239,70,282,224,58,98,0.0,0.0
1005,267,23-09-2019 20:32:00,0,3875.0,3633.0,0.938,19.288,189,104,71,33,85,41,44,79,0.0,0.0
1005,268,23-09-2019 20:34:00,0,4104.0,3686.0,0.898,20.249,180,138,95,43,42,14,28,54,0.0,0.0
1005,269,23-09-2019 20:36:00,0,4263.0,3940.0,0.924,21.157,165,98,62,36,67,17,50,63,0.0,0.0
1005,270,23-09-2019 20:38:00,0,4363.0,4007.0,0.918,21.624,207,152,91,61,55,12,43,63,0.0,0.0
1005,271,23-09-2019 20:40:00,0,4285.0,3853.0,0.899,21.15,173,108,63,45,65,27,38,54,0.0,0.0
1005,272,23-09-2019 20:42:00,0,4199.0,3844.0,0.915,20.802,129,82,39,43,47,26,21,16,0.14,0.02
1005,273,23-09-2019 20:44:00,0,3431.0,3183.0,0.928,17.042,262,146,109,37,116,79,37,62,0.0,0.01
1005,274,23-09-2019 20:46:00,0,3620.0,3354.0,0.927,17.974,589,299,222,77,290,234,56,45,0.01,0.0
1005,275,23-09-2019 20:48:00,0,3623.0,3338.0,0.922,17.969,251,139,90,49,112,62,50,91,0.0,0.0
1005,276,23-09-2019 20:50:00,0,4097.0,3725.0,0.911,20.2655,159,104,63,41,55,18,37,53,0.0,0.0
1005,277,23-09-2019 20:52:00,0,4571.0,4112.0,0.9,22.562,197,130,85,45,67,30,37,56,0.0,0.0
1005,278,23-09-2019 20:54:00,0,4649.0,4244.0,0.913,23.015,110,29,9,20,81,42,39,47,0.0,0.0
1005,279,23-09-2019 20:56:00,0,4629.0,4239.0,0.916,22.93,213,56,38,18,157,106,51,47,0.0,0.06
1005,280,23-09-2019 20:58:00,0,4579.0,4085.0,0.892,22.562,160,56,32,24,104,66,38,61,0.0,0.0
1005,281,23-09-2019 21:00:00,0,3805.0,3521.0,0.925,18.891,450,233,177,56,217,178,39,81,0.06,0.03
1005,282,23-09-2019 21:02:00,0,4274.0,3960.0,0.927,21.223,184,72,38,34,112,65,47,62,0.0,0.0
1005,283,23-09-2019 21:04:00,0,4745.0,4341.0,0.915,23.5,123,57,21,36,66,20,46,51,0.0,0.0
1005,284,23-09-2019 21:06:00,0,4720.0,4430.0,0.938,23.5,132,33,3,30,99,49,50,37,0.0,0.0
1005,285,23-09-2019 21:08:00,0,4745.0,4380.0,0.923,23.547,145,47,24,23,98,53,45,41,0.0,0.02
1005,286,23-09-2019 21:10:00,0,3599.0,3430.0,0.953,17.975,143,50,25,25,93,54,39,16,0.0,0.01
1005,287,23-09-2019 21:12:00,0,4556.0,4195.0,0.921,22.597,174,32,5,27,142,86,56,43,0.01,0.0
1005,288,23-09-2019 21:14:00,0,4736.0,4334.0,0.915,23.458,158,37,6,31,121,76,45,31,0.0,0.03
1005,289,23-09-2019 21:16:00,0,4539.0,4156.0,0.916,22.485,139,42,12,30,97,52,45,23,0.0,0.03
1005,290,23-09-2019 21:18:00,0,4731.0,4330.0,0.915,23.435,170,39,12,27,131,73,58,38,0.0,0.0
1005,291,23-09-2019 21:20:00,0,4219.0,4094.0,0.971,21.155,152,61,31,30,91,60,31,19,0.16,0.04
1005,292,23-09-2019 21:22:00,0,4126.0,3983.0,0.965,20.664,294,122,89,33,172,124,48,51,0.01,0.02
1005,293,23-09-2019 21:24:00,0,4282.0,4061.5,0.949,21.3665,163,19,5,14,144,85,59,41,0.0,0.0
1005,294,23-09-2019 21:26:00,0,4438.0,4140.0,0.933,22.069,320,114,82,32,206,141,65,57,0.02,0.0
1005,295,23-09-2019 21:28:00,0,4724.0,4449.0,0.942,23.537,199,73,36,37,126,67,59,45,0.0,0.0
1005,296,23-09-2019 21:30:00,0,4693.0,4467.0,0.952,23.434,170,89,48,41,81,40,41,52,0.0,0.01
1005,297,23-09-2019 21:32:00,0,4911.0,4603.0,0.937,24.444,130,38,6,32,92,54,38,35,0.0,0.0
1005,298,23-09-2019 21:34:00,0,4799.0,4570.0,0.952,23.968,79,21,3,18,58,37,21,12,0.0,0.06
1005,299,23-09-2019 21:36:00,0,4515.0,4249.0,0.941,22.493,240,132,95,37,108,77,31,49,0.0,0.01
1005,300,23-09-2019 21:38:00,0,4575.0,4416.0,0.965,22.914,320,152,111,41,168,121,47,67,0.01,0.01
1005,301,23-09-2019 21:40:00,0,4702.0,4524.0,0.962,23.533,204,54,22,32,150,84,66,45,0.0,0.0
1005,302,23-09-2019 21:42:00,0,3973.0,3795.0,0.955,19.854,91,30,19,11,61,35,26,1,0.13,0.03
1005,303,23-09-2019 21:44:00,0,4491.0,4285.0,0.954,22.438,167,37,9,28,130,68,62,39,0.0,0.0
1005,304,23-09-2019 21:46:00,0,4698.0,4505.0,0.959,23.498,145,44,13,31,101,51,50,32,0.01,0.0
1005,305,23-09-2019 21:48:00,0,4984.0,4646.0,0.932,24.782,126,22,7,15,104,48,56,32,0.0,0.0
1005,306,23-09-2019 21:50:00,0,4773.0,4594.0,0.963,23.892,281,132,93,39,149,97,52,67,0.0,0.04
1005,307,23-09-2019 21:52:00,0,4703.0,4515.0,0.96,23.529,171,36,20,16,135,72,63,49,0.01,0.0
1005,308,23-09-2019 21:54:00,0,4960.0,4730.0,0.954,24.778,135,31,3,28,104,64,40,17,0.0,0.01
1005,309,23-09-2019 21:56:00,0,4982.0,4813.0,0.966,24.959,125,32,8,24,93,60,33,16,0.0,0.04
1005,310,23-09-2019 21:58:00,0,4831.5,4714.0,0.976,24.2565,124,53,28,25,71,37,34,13,0.0,0.01
1005,311,23-09-2019 22:00:00,0,4681.0,4615.0,0.986,23.554,154,31,17,14,123,73,50,21,0.0,0.01
1005,312,23-09-2019 22:02:00,0,4407.0,4276.0,0.97,22.099,117,46,22,24,71,44,27,4,0.13,0.01
1005,313,23-09-2019 22:04:00,0,4664.0,4620.0,0.991,23.49,508,258,206,52,250,191,59,77,0.03,0.03
1005,314,23-09-2019 22:06:00,0,4502.0,4271.0,0.949,22.467,237,49,18,31,188,118,70,47,0.0,0.0
1005,315,23-09-2019 22:08:00,0,4974.0,4694.0,0.944,24.795,184,14,1,13,170,119,51,28,0.0,0.0
1005,316,23-09-2019 22:10:00,0,4667.0,4559.0,0.977,23.435,82,36,12,24,46,22,24,7,0.0,0.02
1005,317,23-09-2019 22:12:00,0,3573.0,3512.0,0.983,17.966,152,53,26,27,99,64,35,22,0.01,0.16
1005,318,23-09-2019 22:14:00,0,4759.0,4646.0,0.976,23.892,175,54,26,28,121,65,56,32,0.0,0.0
1005,319,23-09-2019 22:16:00,0,4486.0,4395.0,0.98,22.542,232,97,65,32,135,77,58,72,0.0,0.0
1005,320,23-09-2019 22:18:00,0,4991.0,4764.0,0.955,24.937,176,37,12,25,139,80,59,39,0.0,0.0
1005,321,23-09-2019 22:20:00,0,4295.0,4213.0,0.981,21.586,138,33,16,17,105,58,47,24,0.0,0.0
1005,322,23-09-2019 22:22:00,0,4010.0,4056.0,1.011,20.291,23,8,1,7,15,10,5,0,0.0,0.0
1005,323,23-09-2019 22:24:00,0,4513.0,4266.0,0.945,22.504,137,30,12,18,107,67,40,28,0.0,0.0
1005,324,23-09-2019 22:26:00,0,4020.0,3948.0,0.982,20.212,53,17,11,6,36,19,17,0,0.0,0.0
1005,325,23-09-2019 22:28:00,0,4124.0,4063.0,0.985,20.746,198,66,51,15,132,78,54,59,0.0,0.0
1005,326,23-09-2019 22:30:00,0,4035.0,3988.0,0.988,20.314,292,165,124,41,127,85,42,74,0.09,0.0
1005,327,23-09-2019 22:32:00,0,4356.5,4298.0,0.9865,21.924,288,64,36,28,224,164,60,44,0.01,0.0
1005,328,23-09-2019 22:34:00,0,4678.0,4608.0,0.985,23.534,329,123,81,42,206,143,63,65,0.0,0.0
1005,329,23-09-2019 22:36:00,0,4675.0,4644.0,0.993,23.561,215,46,14,32,169,110,59,58,0.0,0.0
1005,330,23-09-2019 22:38:00,0,4647.0,4692.0,1.01,23.504,183,36,5,31,147,84,63,52,0.0,0.0
1005,331,23-09-2019 22:40:00,0,4945.0,4781.0,0.967,24.776,324,118,78,40,206,147,59,52,0.0,0.0
1005,332,23-09-2019 22:42:00,0,4014.0,3952.0,0.984,20.19,159,44,22,22,115,62,53,40,0.16,0.0
1005,333,23-09-2019 22:44:00,0,4759.0,4654.0,0.978,23.902,162,29,2,27,133,75,58,50,0.0,0.0
1005,334,23-09-2019 22:46:00,0,4844.0,4734.0,0.977,24.328,202,48,12,36,154,87,67,58,0.0,0.0
1005,335,23-09-2019 22:48:00,0,4965.0,4765.0,0.96,24.835,176,48,28,20,128,78,50,54,0.0,0.01
1005,336,23-09-2019 22:50:00,0,4966.0,4874.0,0.982,24.963,163,53,27,26,110,57,53,34,0.13,0.05
1005,337,23-09-2019 22:52:00,0,4765.0,4718.0,0.99,23.998,225,79,54,25,146,86,60,89,0.01,0.0
1005,338,23-09-2019 22:54:00,0,4659.0,4649.0,0.998,23.501,238,77,47,30,161,108,53,42,0.01,0.01
1005,339,23-09-2019 22:56:00,0,4485.0,4472.0,0.997,22.621,486,179,128,51,307,250,57,56,0.0,0.03
1005,340,23-09-2019 22:58:00,0,4000.0,4022.0,1.006,20.214,506,238,179,59,268,207,61,58,0.02,0.0
1005,341,23-09-2019 23:00:00,0,4668.0,4633.0,0.993,23.521,219,47,10,37,172,104,68,55,0.0,0.0
1005,342,23-09-2019 23:02:00,0,4586.0,4503.0,0.982,23.052,191,47,14,33,144,90,54,43,0.01,0.03
1005,343,23-09-2019 23:04:00,0,4952.0,4790.0,0.967,24.814,154,29,6,23,125,70,55,56,0.0,0.0
1005,344,23-09-2019 23:06:00,0,4956.5,4780.5,0.9645,24.822,131,28,6,22,103,47,56,54,0.0,0.0
1005,345,23-09-2019 23:08:00,0,4961.0,4771.0,0.962,24.83,110,22,9,13,88,36,52,61,0.0,0.0
1005,346,23-09-2019 23:10:00,0,4957.0,4760.0,0.96,24.799,110,40,28,12,70,41,29,47,0.0,0.07
1005,347,23-09-2019 23:12:00,0,4625.0,4685.0,1.013,23.41,120,31,3,28,89,33,56,60,0.0,0.0
1005,348,23-09-2019 23:14:00,0,4956.0,4788.0,0.966,24.827,88,22,10,12,66,31,35,57,0.0,0.0
1005,349,23-09-2019 23:16:00,0,4923.0,4885.0,0.992,24.802,173,33,7,26,140,73,67,51,0.0,0.0
1005,350,23-09-2019 23:18:00,0,4935.0,4903.0,0.994,24.871,98,27,11,16,71,29,42,57,0.0,0.0
1005,351,23-09-2019 23:20:00,0,4956.0,4907.0,0.99,24.958,177,35,11,24,142,84,58,62,0.0,0.0
1005,352,23-09-2019 23:22:00,0,4906.0,4918.0,1.002,24.774,146,26,8,18,120,58,62,59,0.0,0.0
1005,353,23-09-2019 23:24:00,0,4850.0,4800.0,0.99,24.423,297,120,92,28,177,118,59,21,0.09,0.21
1005,354,23-09-2019 23:26:00,0,4577.0,4507.0,0.985,23.021,376,212,170,42,164,118,46,74,0.06,0.08
1005,355,23-09-2019 23:28:00,0,4577.0,4561.0,0.996,23.082,322,107,74,33,215,153,62,53,0.05,0.0
1005,356,23-09-2019 23:30:00,0,4909.0,4985.0,1.015,24.86,166,79,52,27,87,54,33,53,0.0,0.0
1005,357,23-09-2019 23:32:00,0,5141.0,5048.0,0.982,25.844,136,41,20,21,95,52,43,55,0.0,0.0
1005,358,23-09-2019 23:34:00,0,5144.0,5056.0,0.983,25.864,196,79,53,26,117,65,52,54,0.0,0.0
1005,359,23-09-2019 23:36:00,0,4479.0,4445.0,0.992,22.57,298,134,106,28,164,120,44,48,0.07,0.02
1005,360,23-09-2019 23:38:00,0,4468.0,4484.0,1.003,22.569,342,170,133,37,172,129,43,107,0.06,0.0
1005,361,23-09-2019 23:40:00,0,4704.0,4654.0,0.99,23.6865,450,248,198,50,202,152,50,69,0.0,0.0
1005,362,23-09-2019 23:42:00,0,4940.0,4824.0,0.977,24.804,150,119,74,45,31,12,19,68,0.0,0.0
1005,363,23-09-2019 23:44:00,0,4486.0,4480.0,0.999,22.635,136,24,15,9,112,62,50,48,0.0,0.07
1005,364,23-09-2019 23:46:00,0,4895.0,4933.0,1.008,24.745,128,37,24,13,91,53,38,52,0.0,0.0
1005,365,23-09-2019 23:48:00,0,5032.0,5052.0,1.004,25.42,146,98,66,32,48,15,33,58,0.0,0.0
1005,366,23-09-2019 23:50:00,0,4974.0,4804.0,0.966,24.917,119,76,37,39,43,23,20,63,0.0,0.0
1005,367,23-09-2019 23:52:00,0,4750.0,4738.0,0.997,23.958,145,48,25,23,97,47,50,48,0.0,0.18
1005,368,23-09-2019 23:54:00,0,4648.0,4693.0,1.01,23.508,49,11,4,7,38,15,23,3,0.0,0.29
1005,369,23-09-2019 23:56:00,0,4477.0,4486.0,1.002,22.605,279,126,100,26,153,106,47,34,0.0,0.0
1005,370,23-09-2019 23:58:00,0,4460.0,4426.0,0.992,22.471,550,216,175,41,334,286,48,45,0.12,0.0
1005,371,24-09-2019 00:00:00,0,4294.0,4339.0,1.011,21.721,534,193,143,50,341,283,58,71,0.02,0.0
1005,372,24-09-2019 00:02:00,0,4038.0,3976.0,0.985,20.311,552,182,139,43,370,308,62,38,0.07,0.02
1005,373,24-09-2019 00:04:00,0,4933.0,4936.0,1.001,24.9,518,229,180,49,289,251,38,76,0.03,0.0
1005,374,24-09-2019 00:06:00,0,3882.0,3981.0,1.026,19.701,428,199,148,51,229,187,42,78,0.04,0.01
1005,375,24-09-2019 00:08:00,0,4907.0,4962.0,1.011,24.828,516,240,181,59,276,223,53,17,0.02,0.0
1005,376,24-09-2019 00:10:00,0,3891.0,3995.0,1.027,19.751,632,280,214,66,352,281,71,27,0.0,0.14
1005,377,24-09-2019 00:12:00,0,3740.0,3724.0,0.996,18.859,302,99,77,22,203,150,53,40,0.0,0.0
1005,378,24-09-2019 00:14:00,0,3413.0,3439.5,1.0095,17.255,318,54,22,32,264,194,70,2,0.0,0.0
1005,379,24-09-2019 00:16:00,0,3086.0,3155.0,1.023,15.651,459,164,128,36,295,244,51,24,0.0,0.0
1005,380,24-09-2019 00:18:00,0,4662.0,4715.0,1.011,23.587,125,35,23,12,90,71,19,6,0.04,0.0
1005,381,24-09-2019 00:20:00,0,4899.0,5006.0,1.022,24.842,36,5,4,1,31,13,18,0,0.01,0.0
1005,382,24-09-2019 00:22:00,0,4824.0,4858.0,1.007,24.384,371,176,134,42,195,144,51,10,0.0,0.0
1005,383,24-09-2019 00:24:00,0,4440.0,4518.0,1.018,22.495,339,184,141,43,155,113,42,12,0.0,0.0
1005,384,24-09-2019 00:26:00,0,3896.0,3979.0,1.021,19.756,160,132,99,33,28,11,17,3,0.0,0.0
1005,385,24-09-2019 00:28:00,0,3913.0,3945.0,1.008,19.785,504,270,214,56,234,188,46,45,0.07,0.0
1005,386,24-09-2019 00:30:00,0,3834.0,3882.0,1.012,19.403,446,227,169,58,219,157,62,9,0.0,0.0
1005,387,24-09-2019 00:32:00,0,4274.0,4362.0,1.021,21.667,189,119,74,45,70,48,22,0,0.0,0.0
1005,388,24-09-2019 00:34:00,0,3984.0,4194.0,1.053,20.339,98,75,45,30,23,0,23,0,0.0,0.0
1005,389,24-09-2019 00:36:00,0,4167.0,4250.0,1.02,21.121,45,24,4,20,21,2,19,0,0.0,0.0
1005,390,24-09-2019 00:38:00,0,4450.0,4482.0,1.007,22.494,405,211,174,37,194,149,45,68,0.01,0.0
1005,391,24-09-2019 00:40:00,0,3970.0,4173.0,1.051,20.261,348,191,146,45,157,114,43,87,0.0,0.0
1005,392,24-09-2019 00:42:00,0,4185.0,4276.0,1.022,21.222,38,19,9,10,19,7,12,0,0.0,0.0
1005,393,24-09-2019 00:44:00,0,3546.0,3633.0,1.024,17.993,20,8,1,7,12,3,9,0,0.0,0.0
1005,394,24-09-2019 00:46:00,0,3547.0,3620.0,1.02,17.983,22,10,1,9,12,0,12,0,0.0,0.0
1005,395,24-09-2019 00:48:00,0,3502.0,3563.0,1.017,17.7415,7,6,1,5,1,1,0,0,0.0,0.0
1005,396,24-09-2019 00:50:00,0,3457.0,3506.0,1.014,17.5,17,12,6,6,5,2,3,0,0.0,0.0
1005,397,24-09-2019 00:52:00,0,3437.0,3523.0,1.025,17.442,3,3,1,2,0,0,0,0,0.0,0.0
1005,398,24-09-2019 00:54:00,0,3391.0,3324.0,0.98,17.041,0,0,0,0,0,0,0,0,0.0,0.0
1005,399,24-09-2019 00:56:00,0,3080.0,3162.0,1.026,15.636,0,0,0,0,0,0,0,0,0.0,0.0
1005,400,24-09-2019 00:58:00,0,3080.0,3153.0,1.024,15.624,1,0,0,0,1,0,1,0,0.0,0.0
1005,401,24-09-2019 01:00:00,0,3092.0,3159.0,1.021,15.681,12,3,1,2,9,5,4,0,0.0,0.0
1005,402,24-09-2019 01:02:00,0,3052.0,3247.0,1.064,15.619,3,2,0,2,1,0,1,0,0.0,0.0
1005,403,24-09-2019 01:04:00,0,3056.0,3304.0,1.081,15.696,4,2,0,2,2,0,2,0,0.0,0.0
1005,404,24-09-2019 01:06:00,0,3080.0,3182.0,1.033,15.657,1,1,0,1,0,0,0,0,0.0,0.0
1005,405,24-09-2019 01:08:00,0,2984.0,3080.0,1.032,15.168,5,5,0,5,0,0,0,0,0.0,0.0
1005,406,24-09-2019 01:10:00,0,3115.0,3110.0,0.999,15.715,6,3,0,3,3,0,3,0,0.0,0.0
1005,407,24-09-2019 01:12:00,0,2994.0,3114.0,1.04,15.245,216,124,91,33,92,58,34,28,0.0,0.0
1005,408,24-09-2019 01:14:00,0,2884.0,3001.0,1.041,14.685,279,158,122,36,121,86,35,64,0.0,0.0
1005,409,24-09-2019 01:16:00,0,3039.0,3317.0,1.091,15.646,114,72,35,37,42,10,32,72,0.01,0.0
1005,410,24-09-2019 01:18:00,0,3339.0,3494.0,1.046,17.025,109,76,40,36,33,7,26,17,0.0,0.0
1005,411,24-09-2019 01:20:00,0,3029.0,3295.0,1.088,15.582,188,123,89,34,65,31,34,67,0.0,0.0
1005,412,24-09-2019 01:22:00,0,3091.0,3307.0,1.0705,15.839,197,123,88,35,74,44,30,48,0.0,0.0
1005,413,24-09-2019 01:24:00,0,3153.0,3319.0,1.053,16.096,0,0,0,0,0,0,0,0,0.0,0.0
1005,414,24-09-2019 01:26:00,0,3052.0,3323.0,1.089,15.704,21,10,6,4,11,3,8,0,0.0,0.0
1005,415,24-09-2019 01:28:00,0,3314.0,3579.0,1.08,17.018,55,35,8,27,20,0,20,1,0.0,0.0
1005,416,24-09-2019 01:30:00,0,3521.0,3728.0,1.059,18.0,106,79,39,40,27,6,21,0,0.0,0.0
1005,417,24-09-2019 01:32:00,0,3532.0,3710.0,1.051,18.021,114,67,40,27,47,15,32,28,0.0,0.0
1005,418,24-09-2019 01:34:00,0,3343.0,3513.0,1.051,17.06,183,125,105,20,58,43,15,37,0.06,0.0
1005,419,24-09-2019 01:36:00,0,3724.0,3802.0,1.021,18.88,7,4,2,2,3,0,3,0,0.0,0.0
1005,420,24-09-2019 01:38:00,0,3363.0,3457.0,1.028,17.078,1,0,0,0,1,0,1,0,0.01,0.0
1005,421,24-09-2019 01:40:00,0,3065.0,3228.0,1.053,15.65,15,10,7,3,5,2,3,0,0.0,0.0
1005,422,24-09-2019 01:42:00,0,3370.0,3415.0,1.014,17.058,1,1,0,1,0,0,0,0,0.0,0.0
1005,423,24-09-2019 01:44:00,0,3057.0,3253.0,1.064,15.645,7,4,1,3,3,0,3,0,0.0,0.0
1005,424,24-09-2019 01:46:00,0,2989.0,3093.0,1.035,15.201,2,1,0,1,1,1,0,0,0.0,0.0
1005,425,24-09-2019 01:48:00,0,2927.0,2914.0,0.996,14.758,0,0,0,0,0,0,0,0,0.0,0.0
1005,426,24-09-2019 01:50:00,0,2934.0,2875.0,0.98,14.744,1,1,0,1,0,0,0,0,0.0,0.0
1005,427,24-09-2019 01:52:00,0,2924.0,2873.0,0.983,14.701,19,12,5,7,7,3,4,0,0.0,0.0
1005,428,24-09-2019 01:54:00,0,2622.0,2751.0,1.05,13.375,8,7,3,4,1,0,1,0,0.0,0.0
1005,429,24-09-2019 01:56:00,0,2578.5,2679.5,1.039,13.1255,11,6,1,5,5,3,2,0,0.0,0.0
1005,430,24-09-2019 01:58:00,0,2535.0,2608.0,1.028,12.876,7,7,1,6,0,0,0,0,0.0,0.0
1005,431,24-09-2019 02:00:00,0,2544.0,2658.0,1.045,12.964,34,26,9,17,8,3,5,0,0.0,0.0
1005,432,24-09-2019 02:02:00,0,2593.0,2841.0,1.096,13.363,0,0,0,0,0,0,0,0,0.0,0.0
1005,433,24-09-2019 02:04:00,0,2629.0,2747.0,1.045,13.4,1,0,0,0,1,1,0,0,0.0,0.0
1005,434,24-09-2019 02:06:00,0,2619.0,2704.0,1.032,13.312,2,2,1,1,0,0,0,0,0.0,0.0
1005,435,24-09-2019 02:08:00,0,2626.0,2698.0,1.027,13.335,7,5,1,4,2,1,1,0,0.0,0.0
1005,436,24-09-2019 02:10:00,0,2436.0,2579.0,1.059,12.452,24,19,5,14,5,0,5,0,0.0,0.0
1005,437,24-09-2019 02:12:00,0,2718.0,2845.0,1.047,13.858,123,80,40,40,43,14,29,0,0.0,0.0
1005,438,24-09-2019 02:14:00,0,2898.0,2957.0,1.02,14.692,53,33,8,25,20,4,16,0,0.0,0.0
1005,439,24-09-2019 02:16:00,0,2887.0,2972.0,1.03,14.664,64,45,24,21,19,1,18,0,0.0,0.0
1005,440,24-09-2019 02:18:00,0,3143.0,3371.0,1.073,16.114,25,18,5,13,7,0,7,0,0.0,0.22
1005,441,24-09-2019 02:20:00,0,3088.0,3242.0,1.05,15.754,9,9,1,8,0,0,0,0,0.0,0.0
1005,442,24-09-2019 02:22:00,0,2916.0,2955.0,1.013,14.761,7,1,0,1,6,0,6,0,0.0,0.0
1005,443,24-09-2019 02:24:00,0,2913.0,2911.0,0.999,14.7,8,0,0,0,8,0,8,0,0.0,0.0
1005,444,24-09-2019 02:26:00,0,2732.0,2802.0,1.026,13.865,78,60,41,19,18,11,7,22,0.0,0.0
1005,445,24-09-2019 02:28:00,0,3074.0,3268.0,1.063,15.73,173,115,67,48,58,22,36,80,0.0,0.0
1005,446,24-09-2019 02:30:00,0,3312.0,3435.0,1.039,16.8515,238,160,112,48,78,50,28,72,0.0,0.0
1005,447,24-09-2019 02:32:00,0,3550.0,3602.0,1.015,17.973,206,132,97,35,74,37,37,69,0.01,0.0
1005,448,24-09-2019 02:34:00,0,3502.0,3732.0,1.066,17.928,276,165,105,60,111,74,37,67,0.0,0.0
1005,449,24-09-2019 02:36:00,0,3528.0,3664.0,1.038,17.957,178,104,71,33,74,35,39,56,0.0,0.0
1005,450,24-09-2019 02:38:00,0,3849.0,3850.0,1.0,19.428,201,129,89,40,72,36,36,54,0.0,0.0
1005,451,24-09-2019 02:40:00,0,3635.0,3760.0,1.034,18.486,163,126,87,39,37,7,30,53,0.0,0.0
1005,452,24-09-2019 02:42:00,0,3440.0,3524.0,1.025,17.455,89,60,37,23,29,0,29,47,0.0,0.0
1005,453,24-09-2019 02:44:00,0,3560.0,3566.0,1.002,17.975,169,122,75,47,47,20,27,76,0.0,0.0
1005,454,24-09-2019 02:46:00,0,3553.0,3636.0,1.023,18.025,110,69,35,34,41,0,41,68,0.0,0.0
1005,455,24-09-2019 02:48:00,0,3848.0,3804.0,0.989,19.371,246,137,99,38,109,64,45,55,0.0,0.0
1005,456,24-09-2019 02:50:00,0,3524.0,3635.0,1.032,17.909,220,148,110,38,72,36,36,38,0.19,0.0
1005,457,24-09-2019 02:52:00,0,3980.0,4210.0,1.058,20.341,344,178,130,48,166,118,48,39,0.0,0.0
1005,458,24-09-2019 02:54:00,0,4164.0,4310.0,1.035,21.18,131,87,60,27,44,19,25,34,0.13,0.0
1005,459,24-09-2019 02:56:00,0,3984.0,4097.0,1.028,20.231,226,151,99,52,75,29,46,61,0.01,0.0
1005,460,24-09-2019 02:58:00,0,3795.0,4006.0,1.056,19.385,287,176,138,38,111,60,51,84,0.0,0.0
1005,461,24-09-2019 03:00:00,0,3805.0,3914.0,1.029,19.325,87,58,35,23,29,12,17,0,0.0,0.0
1005,462,24-09-2019 03:02:00,0,4363.0,4472.0,1.025,22.139,0,0,0,0,0,0,0,0,0.0,0.0
1005,463,24-09-2019 03:04:00,0,4157.0,4364.0,1.051,21.209,13,0,0,0,13,0,13,0,0.0,0.0
1005,464,24-09-2019 03:06:00,0,3951.0,4256.0,1.077,20.279,21,8,3,5,13,4,9,0,0.0,0.0
1005,465,24-09-2019 03:08:00,0,3375.0,3355.0,0.994,17.013,2,0,0,0,2,0,2,0,0.0,0.0
1005,466,24-09-2019 03:10:00,0,3056.0,3223.0,1.055,15.609,2,0,0,0,2,0,2,0,0.0,0.0
1005,467,24-09-2019 03:12:00,0,3115.0,3097.0,0.994,15.703,51,36,20,16,15,6,9,0,0.0,0.0
1005,468,24-09-2019 03:14:00,0,3397.0,3350.0,0.986,17.093,3,1,1,0,2,0,2,0,0.0,0.0
1005,469,24-09-2019 03:16:00,0,3265.0,3319.0,1.017,16.539,2,2,1,1,0,0,0,0,0.0,0.0
1005,470,24-09-2019 03:18:00,0,3064.0,3278.0,1.07,15.7,12,10,2,8,2,0,2,0,0.0,0.0
1005,471,24-09-2019 03:20:00,0,3065.0,3245.0,1.059,15.669,9,7,3,4,2,1,1,0,0.0,0.0
1005,472,24-09-2019 03:22:00,0,2911.0,3020.0,1.037,14.813,16,12,2,10,4,0,4,0,0.0,0.0
1005,473,24-09-2019 03:24:00,0,3100.0,3093.0,0.998,15.639,4,3,0,3,1,0,1,0,0.0,0.0
1005,474,24-09-2019 03:26:00,0,3084.0,3116.0,1.01,15.6,31,19,8,11,12,4,8,0,0.0,0.0
1005,475,24-09-2019 03:28:00,0,3339.0,3456.0,1.035,16.981,7,5,1,4,2,0,2,0,0.0,0.0
1005,476,24-09-2019 03:30:00,0,3255.0,3340.0,1.026,16.521,5,5,0,5,0,0,0,0,0.0,0.0
1005,477,24-09-2019 03:32:00,0,3056.0,3261.0,1.067,15.651,6,6,0,6,0,0,0,0,0.0,0.0
1005,478,24-09-2019 03:34:00,0,3063.0,3229.0,1.054,15.645,4,4,2,2,0,0,0,0,0.0,0.0
1005,479,24-09-2019 03:36:00,0,3071.0,3175.0,1.034,15.615,2,2,1,1,0,0,0,0,0.0,0.0
1005,480,24-09-2019 03:38:00,0,3064.5,3189.5,1.041,15.604,139,108,74,34,31,9,22,4,0.0,0.0
1005,481,24-09-2019 03:40:00,0,3058.0,3204.0,1.048,15.593,306,179,134,45,127,87,40,48,0.03,0.0
1005,482,24-09-2019 03:42:00,0,3153.0,3313.0,1.051,16.091,113,82,56,26,31,17,14,27,0.0,0.0
1005,483,24-09-2019 03:44:00,0,2879.0,3040.0,1.056,14.709,382,213,159,54,169,126,43,87,0.0,0.0
1005,484,24-09-2019 03:46:00,0,3265.0,3337.0,1.022,16.558,110,71,40,31,39,18,21,22,0.0,0.0
1005,485,24-09-2019 03:48:00,0,3513.0,3654.0,1.04,17.886,92,62,28,34,30,4,26,2,0.0,0.0
1005,486,24-09-2019 03:50:00,0,3509.0,3773.0,1.075,18.001,233,161,126,35,72,42,30,56,0.0,0.0
1005,487,24-09-2019 03:52:00,0,3792.0,3923.0,1.034,19.283,169,120,73,47,49,17,32,56,0.02,0.0
1005,488,24-09-2019 03:54:00,0,3821.0,3884.0,1.016,19.355,124,63,36,27,61,16,45,52,0.0,0.0
1005,489,24-09-2019 03:56:00,0,3988.0,4066.0,1.02,20.214,161,99,61,38,62,24,38,57,0.0,0.0
1005,490,24-09-2019 03:58:00,0,4169.0,4294.0,1.03,21.18,34,11,9,2,23,4,19,12,0.0,0.21
1005,491,24-09-2019 04:00:00,0,3542.0,3648.0,1.03,17.994,6,0,0,0,6,0,6,0,0.0,0.0
1005,492,24-09-2019 04:02:00,0,3530.0,3672.0,1.04,17.971,52,32,11,21,20,2,18,2,0.0,0.0
1005,493,24-09-2019 04:04:00,0,3821.0,3839.0,1.005,19.305,101,60,46,14,41,20,21,4,0.0,0.0
1005,494,24-09-2019 04:06:00,0,3627.0,3699.0,1.02,18.386,246,119,80,39,127,90,37,79,0.1,0.0
1005,495,24-09-2019 04:08:00,0,4191.0,4236.0,1.011,21.202,141,54,33,21,87,49,38,29,0.0,0.0
1005,496,24-09-2019 04:10:00,0,4457.0,4538.0,1.018,22.583,126,82,43,39,44,9,35,62,0.01,0.0
1005,497,24-09-2019 04:12:00,0,4427.0,4464.0,1.008,22.383,147,60,36,24,87,37,50,51,0.0,0.0
1005,498,24-09-2019 04:14:00,0,4397.0,4390.0,0.998,22.183,165,110,68,42,55,12,43,71,0.0,0.0
1005,499,24-09-2019 04:16:00,0,4180.0,4257.0,1.019,21.181,160,109,73,36,51,27,24,18,0.14,0.0
1005,500,24-09-2019 04:18:00,0,3095.0,3186.0,1.03,15.721,242,108,73,35,134,93,41,17,0.0,0.0
1005,501,24-09-2019 04:20:00,0,3797.0,3947.0,1.04,19.329,280,143,109,34,137,98,39,79,0.04,0.0
1005,502,24-09-2019 04:22:00,0,3914.0,4040.0,1.032,19.892,182,85,55,30,97,58,39,10,0.01,0.0
1005,503,24-09-2019 04:24:00,0,2848.0,2783.0,0.977,14.303,178,56,34,22,122,70,52,2,0.0,0.01
1005,504,24-09-2019 04:26:00,0,4165.0,4242.0,1.019,21.106,215,144,108,36,71,46,25,29,0.0,0.01
1005,505,24-09-2019 04:28:00,0,4202.0,4260.0,1.014,21.272,152,92,59,33,60,26,34,58,0.01,0.0
1005,506,24-09-2019 04:30:00,0,4910.0,4911.0,1.0,24.78,120,56,25,31,64,18,46,53,0.0,0.0
1005,507,24-09-2019 04:32:00,0,4593.0,4782.0,1.041,23.392,115,55,29,26,60,23,37,37,0.0,0.03
1005,508,24-09-2019 04:34:00,0,4439.0,4553.0,1.026,22.529,110,18,5,13,92,42,50,44,0.0,0.01
1005,509,24-09-2019 04:36:00,0,4368.0,4365.0,0.999,22.04,145,56,27,29,89,42,47,24,0.0,0.03
1005,510,24-09-2019 04:38:00,0,3903.0,3938.0,1.009,19.738,366,165,126,39,201,159,42,35,0.09,0.11
1005,511,24-09-2019 04:40:00,0,4306.0,4361.0,1.013,21.794,219,120,76,44,99,54,45,51,0.01,0.0
1005,512,24-09-2019 04:42:00,0,3529.0,3632.0,1.029,17.924,227,73,44,29,154,104,50,19,0.0,0.0
1005,513,24-09-2019 04:44:00,0,3849.0,3812.0,0.991,19.383,78,50,28,22,28,9,19,0,0.0,0.0
1005,514,24-09-2019 04:46:00,0,3395.0,3300.0,0.9695,17.0285,179,77,45,32,102,68,34,5,0.01,0.0
1005,515,24-09-2019 04:48:00,0,2941.0,2788.0,0.948,14.674,362,211,153,58,151,101,50,21,0.0,0.0
1005,516,24-09-2019 04:50:00,0,3975.0,4229.0,1.064,20.343,190,102,75,27,88,56,32,111,0.04,0.0
1005,517,24-09-2019 04:52:00,0,4448.0,4479.0,1.007,22.485,223,161,106,55,62,36,26,24,0.0,0.0
1005,518,24-09-2019 04:54:00,0,3996.0,4053.0,1.014,20.231,594,319,245,74,275,211,64,7,0.0,0.0
1005,519,24-09-2019 04:56:00,0,3651.0,3679.0,1.008,18.457,691,466,378,88,225,174,51,7,0.0,0.0
1005,520,24-09-2019 04:58:00,0,3831.0,3793.0,0.99,19.295,421,274,209,65,147,98,49,26,0.01,0.0
1005,521,24-09-2019 05:00:00,0,4283.0,4304.0,1.005,21.638,120,71,40,31,49,13,36,55,0.0,0.0
1005,522,24-09-2019 05:02:00,0,4400.0,4396.0,0.999,22.204,166,115,81,34,51,21,30,75,0.0,0.0
1005,523,24-09-2019 05:04:00,0,4462.0,4410.0,0.988,22.463,191,83,51,32,108,57,51,58,0.0,0.0
1005,524,24-09-2019 05:06:00,0,4009.0,4100.0,1.023,20.334,78,43,17,26,35,6,29,0,0.0,0.0
1005,525,24-09-2019 05:08:00,0,4178.0,4240.0,1.015,21.154,232,151,106,45,81,51,30,43,0.0,0.0
1005,526,24-09-2019 05:10:00,0,3633.0,3706.0,1.02,18.416,137,102,64,38,35,21,14,10,0.0,0.0
1005,527,24-09-2019 05:12:00,0,3987.0,4135.0,1.037,20.286,168,125,86,39,43,25,18,36,0.0,0.0
1005,528,24-09-2019 05:14:00,0,3534.0,3656.0,1.035,17.97,198,126,87,39,72,42,30,40,0.0,0.0
1005,529,24-09-2019 05:16:00,0,3822.0,3873.0,1.013,19.345,68,41,24,17,27,2,25,0,0.0,0.0
1005,530,24-09-2019 05:18:00,0,3929.0,3976.0,1.012,19.883,74,51,25,26,23,3,20,0,0.0,0.0
1005,531,24-09-2019 05:20:00,0,3879.5,3953.5,1.019,19.6615,52,47,7,40,5,1,4,0,0.0,0.0
1005,532,24-09-2019 05:22:00,0,3830.0,3931.0,1.026,19.44,63,39,10,29,24,3,21,0,0.0,0.0
1005,533,24-09-2019 05:24:00,0,4015.0,3975.0,0.99,20.22,214,172,115,57,42,23,19,9,0.0,0.0
1005,534,24-09-2019 05:26:00,0,3906.0,3995.0,1.023,19.812,250,166,121,45,84,54,30,62,0.0,0.0
1005,535,24-09-2019 05:28:00,0,3847.0,3791.0,0.985,19.353,95,55,29,26,40,20,20,11,0.0,0.0
1005,536,24-09-2019 05:30:00,0,3834.0,3770.0,0.983,19.28,3,1,0,1,2,0,2,0,0.02,0.0
1005,537,24-09-2019 05:32:00,0,3541.0,3592.0,1.014,17.929,23,13,4,9,10,0,10,0,0.0,0.0
1005,538,24-09-2019 05:34:00,0,3363.0,3395.0,1.01,17.006,2,0,0,0,2,0,2,0,0.0,0.0
1005,539,24-09-2019 05:36:00,0,3388.0,3268.0,0.965,16.966,11,1,0,1,10,0,10,0,0.0,0.0
1005,540,24-09-2019 05:38:00,0,3087.0,3117.0,1.01,15.612,95,75,38,37,20,10,10,0,0.0,0.0
1005,541,24-09-2019 05:40:00,0,3103.0,3097.0,0.998,15.655,8,0,0,0,8,0,8,0,0.0,0.0
1005,542,24-09-2019 05:42:00,0,3128.0,3007.0,0.961,15.652,1,0,0,0,1,0,1,0,0.0,0.0
1005,543,24-09-2019 05:44:00,0,2906.0,2915.0,1.003,14.678,3,0,0,0,3,0,3,0,0.0,0.0
1005,544,24-09-2019 05:46:00,0,2937.0,2830.0,0.964,14.707,7,3,2,1,4,0,4,0,0.0,0.0
1005,545,24-09-2019 05:48:00,0,2733.0,2765.0,1.012,13.828,8,6,2,4,2,1,1,0,0.0,0.0
1005,546,24-09-2019 05:50:00,0,2645.0,2702.0,1.021,13.414,14,9,5,4,5,4,1,0,0.0,0.0
1005,547,24-09-2019 05:52:00,0,2638.0,2713.0,1.029,13.395,2,2,1,1,0,0,0,0,0.0,0.0
1005,548,24-09-2019 05:54:00,0,2655.0,2648.5,0.998,13.392,7,7,0,7,0,0,0,0,0.0,0.0
1005,549,24-09-2019 05:56:00,0,2672.0,2584.0,0.967,13.389,0,0,0,0,0,0,0,0,0.0,0.0
1005,550,24-09-2019 05:58:00,0,2670.0,2555.0,0.957,13.348,74,54,28,26,20,7,13,0,0.0,0.0
1005,551,24-09-2019 06:00:00,1,3016.0,2952.0,0.978,15.152,289,195,153,42,94,62,32,23,0.0,0.0
1005,552,24-09-2019 06:02:00,1,3095.0,3143.0,1.015,15.673,206,129,86,43,77,56,21,70,0.0,0.0
1005,553,24-09-2019 06:04:00,1,2923.0,2865.0,0.98,14.687,234,134,98,36,100,64,36,29,0.0,0.0
1005,554,24-09-2019 06:06:00,1,3556.0,3519.0,0.99,17.905,86,42,16,26,44,9,35,53,0.0,0.0
1005,555,24-09-2019 06:08:00,1,3846.0,3726.0,0.969,19.277,133,66,36,30,67,27,40,41,0.0,0.0
1005,556,24-09-2019 06:10:00,1,3998.0,4029.0,1.008,20.211,166,39,17,22,127,78,49,50,0.0,0.0
1005,557,24-09-2019 06:12:00,1,3933.0,3896.0,0.99,19.81,206,91,61,30,115,82,33,34,0.0,0.0
1005,558,24-09-2019 06:14:00,1,3495.0,3362.0,0.962,17.49,188,66,37,29,122,69,53,53,0.0,0.0
1005,559,24-09-2019 06:16:00,1,4037.0,3961.0,0.981,20.289,156,86,51,35,70,37,33,50,0.0,0.0
1005,560,24-09-2019 06:18:00,1,3863.0,3769.0,0.976,19.391,131,76,49,27,55,20,35,43,0.0,0.01
1005,561,24-09-2019 06:20:00,1,4052.0,3926.0,0.969,20.313,123,52,30,22,71,33,38,49,0.0,0.0
1005,562,24-09-2019 06:22:00,1,4000.0,4102.0,1.025,20.3,429,217,176,41,212,158,54,35,0.0,0.0
1005,563,24-09-2019 06:24:00,1,3574.0,3511.0,0.982,17.968,240,95,62,33,145,92,53,29,0.02,0.0
1005,564,24-09-2019 06:26:00,1,4006.0,4062.0,1.014,20.281,263,122,81,41,141,105,36,45,0.0,0.11
1005,565,24-09-2019 06:28:00,1,3930.0,3931.0,1.0,19.836,329,163,132,31,166,124,42,52,0.0,0.0
1005,566,24-09-2019 06:30:00,1,3854.0,3800.0,0.986,19.391,336,196,144,52,140,94,46,110,0.01,0.0
1005,567,24-09-2019 06:32:00,1,3825.0,3909.0,1.022,19.397,142,76,43,33,66,31,35,28,0.04,0.0
1005,568,24-09-2019 06:34:00,1,4086.0,4081.0,0.999,20.618,367,207,167,40,160,122,38,63,0.0,0.0
1005,569,24-09-2019 06:36:00,1,3224.0,3086.0,0.957,16.117,281,158,125,33,123,93,30,70,0.0,0.0
1005,570,24-09-2019 06:38:00,1,3952.0,3915.0,0.991,19.904,145,77,44,33,68,25,43,49,0.02,0.0
1005,571,24-09-2019 06:40:00,1,4310.0,4208.0,0.976,21.638,128,44,17,27,84,40,44,61,0.0,0.0
1005,572,24-09-2019 06:42:00,1,4218.0,4136.0,0.981,21.2,63,20,4,16,43,15,28,42,0.0,0.0
1005,573,24-09-2019 06:44:00,1,4309.0,4217.0,0.979,21.643,297,162,131,31,135,95,40,31,0.0,0.0
1005,574,24-09-2019 06:46:00,1,3196.0,3208.0,1.004,16.142,193,114,76,38,79,59,20,10,0.0,0.0
1005,575,24-09-2019 06:48:00,1,3475.0,3388.0,0.975,17.443,49,34,4,30,15,0,15,0,0.0,0.0
1005,576,24-09-2019 06:50:00,1,3570.0,3535.0,0.99,17.981,67,43,12,31,24,0,24,0,0.0,0.0
1005,577,24-09-2019 06:52:00,1,3861.0,3762.0,0.974,19.377,88,56,28,28,32,12,20,1,0.0,0.0
1005,578,24-09-2019 06:54:00,1,3841.0,3717.0,0.968,19.247,8,2,1,1,6,0,6,0,0.0,0.0
1005,579,24-09-2019 06:56:00,1,3561.0,3578.0,1.005,17.991,1,1,0,1,0,0,0,0,0.0,0.0
1005,580,24-09-2019 06:58:00,1,3614.0,3425.0,0.948,18.03,25,9,8,1,16,5,11,0,0.0,0.0
1005,581,24-09-2019 07:00:00,1,3410.0,3178.0,0.932,16.952,43,23,13,10,20,8,12,0,0.0,0.0
1005,582,24-09-2019 07:02:00,1,3273.0,3039.0,0.9285,16.2595,8,2,0,2,6,2,4,0,0.0,0.0
1005,583,24-09-2019 07:04:00,1,3136.0,2900.0,0.925,15.567,0,0,0,0,0,0,0,0,0.0,0.0
1005,584,24-09-2019 07:06:00,1,2949.0,2788.0,0.946,14.705,1,1,0,1,0,0,0,0,0.0,0.0
1005,585,24-09-2019 07:08:00,1,2983.0,2662.0,0.892,14.699,55,34,17,17,21,14,7,0,0.0,0.0
1005,586,24-09-2019 07:10:00,1,2969.0,2700.0,0.909,14.689,6,1,0,1,5,1,4,0,0.0,0.0
1005,587,24-09-2019 07:12:00,1,2774.0,2639.0,0.951,13.849,3,0,0,0,3,1,2,0,0.0,0.0
1005,588,24-09-2019 07:14:00,1,2676.0,2508.0,0.937,13.32,20,5,2,3,15,4,11,0,0.0,0.0
1005,589,24-09-2019 07:16:00,1,2671.0,2533.0,0.949,13.328,21,12,0,12,9,0,9,0,0.0,0.0
1005,590,24-09-2019 07:18:00,1,2649.0,2592.0,0.978,13.307,3,1,0,1,2,0,2,0,0.0,0.0
1005,591,24-09-2019 07:20:00,1,2676.0,2600.0,0.972,13.424,15,3,1,2,12,6,6,0,0.0,0.0
1005,592,24-09-2019 07:22:00,1,2673.0,2494.0,0.933,13.293,10,7,0,7,3,2,1,0,0.0,0.0
1005,593,24-09-2019 07:24:00,1,2689.0,2460.0,0.915,13.317,18,3,0,3,15,5,10,0,0.0,0.0
1005,594,24-09-2019 07:26:00,1,2699.0,2484.0,0.92,13.386,11,0,0,0,11,4,7,0,0.0,0.0
1005,595,24-09-2019 07:28:00,1,2693.0,2420.0,0.899,13.29,15,2,0,2,13,2,11,0,0.0,0.0
1005,596,24-09-2019 07:30:00,1,2695.0,2487.0,0.923,13.37,3,1,0,1,2,1,1,0,0.0,0.0
1005,597,24-09-2019 07:32:00,1,2672.0,2497.0,0.935,13.293,1,0,0,0,1,0,1,0,0.0,0.0
1005,598,24-09-2019 07:34:00,1,2691.0,2446.0,0.909,13.311,3,0,0,0,3,0,3,0,0.0,0.0
1005,599,24-09-2019 07:36:00,1,2697.5,2412.5,0.8945,13.299,0,0,0,0,0,0,0,0,0.0,0.0
1005,600,24-09-2019 07:38:00,1,2704.0,2379.0,0.88,13.287,4,1,0,1,3,2,1,0,0.0,0.0
1005,601,24-09-2019 07:40:00,1,2689.0,2483.0,0.923,13.345,5,0,0,0,5,2,3,0,0.0,0.0
1005,602,24-09-2019 07:42:00,1,2679.0,2495.0,0.931,13.318,3,0,0,0,3,1,2,0,0.0,0.0
1005,603,24-09-2019 07:44:00,1,2698.0,2458.0,0.911,13.351,13,8,1,7,5,2,3,0,0.0,0.0
1005,604,24-09-2019 07:46:00,1,2710.0,2424.0,0.895,13.362,0,0,0,0,0,0,0,0,0.0,0.0
1005,605,24-09-2019 07:48:00,1,2712.0,2403.0,0.886,13.345,76,40,25,15,36,16,20,0,0.0,0.0
1005,606,24-09-2019 07:50:00,1,2967.0,2711.0,0.913,14.693,121,70,42,28,51,24,27,23,0.0,0.0
1005,607,24-09-2019 07:52:00,1,3147.0,2903.0,0.922,15.611,17,17,0,17,0,0,0,0,0.0,0.0
1005,608,24-09-2019 07:54:00,1,3174.0,2847.0,0.897,15.66,183,106,64,42,77,48,29,26,0.0,0.0
1005,609,24-09-2019 07:56:00,1,2896.0,2596.0,0.896,14.287,191,99,69,30,92,52,40,63,0.0,0.0
1005,610,24-09-2019 07:58:00,1,3415.0,3208.0,0.94,17.005,111,57,27,30,54,15,39,56,0.0,0.0
1005,611,24-09-2019 08:00:00,1,3528.0,3220.0,0.913,17.464,143,87,63,24,56,32,24,8,0.0,0.0
1005,612,24-09-2019 08:02:00,1,2965.0,2734.0,0.922,14.711,215,110,81,29,105,79,26,25,0.0,0.0
1005,613,24-09-2019 08:04:00,1,3418.0,3207.0,0.938,17.018,188,122,79,43,66,31,35,66,0.0,0.0
1005,614,24-09-2019 08:06:00,1,3940.0,3464.0,0.879,19.36,348,189,129,60,159,115,44,45,0.0,0.0
1005,615,24-09-2019 08:08:00,1,3355.0,3008.0,0.897,16.549,68,44,23,21,24,12,12,17,0.0,0.0
1005,616,24-09-2019 08:10:00,1,3252.5,2951.5,0.908,16.0825,306,228,178,50,78,51,27,0,0.0,0.05
1005,617,24-09-2019 08:12:00,1,3150.0,2895.0,0.919,15.616,458,331,253,78,127,90,37,10,0.0,0.0
1005,618,24-09-2019 08:14:00,1,3354.0,3014.0,0.899,16.553,950,639,537,102,311,234,77,4,0.0,0.0
1005,619,24-09-2019 08:16:00,1,3457.0,3059.0,0.885,17.008,476,285,234,51,191,141,50,75,0.0,0.0
1005,620,24-09-2019 08:18:00,1,3436.0,3179.0,0.925,17.058,290,184,137,47,106,73,33,48,0.0,0.0
1005,621,24-09-2019 08:20:00,1,3448.0,3042.0,0.882,16.951,362,281,226,55,81,54,27,1,0.0,0.0
1005,622,24-09-2019 08:22:00,1,3480.0,2997.0,0.861,17.03,96,68,40,28,28,9,19,0,0.0,0.0
1005,623,24-09-2019 08:24:00,1,3368.0,3002.0,0.891,16.595,546,424,334,90,122,79,43,26,0.0,0.0
1005,624,24-09-2019 08:26:00,1,3454.0,3120.0,0.903,17.065,575,343,281,62,232,164,68,34,0.0,0.0
1005,625,24-09-2019 08:28:00,1,3455.0,3055.0,0.884,16.993,341,191,146,45,150,109,41,4,0.01,0.0
1005,626,24-09-2019 08:30:00,1,3379.0,2948.0,0.872,16.577,17,6,4,2,11,2,9,0,0.0,0.0
1005,627,24-09-2019 08:32:00,1,3264.0,2923.0,0.895,16.097,10,0,0,0,10,0,10,0,0.0,0.0
1005,628,24-09-2019 08:34:00,1,3087.0,2704.0,0.876,15.155,0,0,0,0,0,0,0,0,0.0,0.0
1005,629,24-09-2019 08:36:00,1,3008.0,2581.0,0.858,14.707,28,24,2,22,4,1,3,0,0.0,0.0
1005,630,24-09-2019 08:38:00,1,3185.0,2734.0,0.859,15.575,118,84,40,44,34,23,11,12,0.0,0.0
1005,631,24-09-2019 08:40:00,1,2981.0,2678.0,0.898,14.708,343,242,198,44,101,64,37,33,0.0,0.0
1005,632,24-09-2019 08:42:00,1,3205.0,2717.0,0.848,15.635,57,30,11,19,27,16,11,0,0.0,0.0
1005,633,24-09-2019 08:44:00,1,2962.0,2553.0,0.863,14.4965,0,0,0,0,0,0,0,0,0.0,0.0
1005,634,24-09-2019 08:46:00,1,2719.0,2389.0,0.878,13.358,0,0,0,0,0,0,0,0,0.0,0.0
1005,635,24-09-2019 08:48:00,1,2638.0,2257.0,0.856,12.891,1,1,1,0,0,0,0,0,0.0,0.0
1005,636,24-09-2019 08:50:00,1,2545.0,2183.0,0.858,12.445,6,6,0,6,0,0,0,0,0.0,0.0
1005,637,24-09-2019 08:52:00,1,2521.0,2240.0,0.889,12.413,34,13,9,4,21,8,13,0,0.0,0.0
1005,638,24-09-2019 08:54:00,1,2555.0,2156.0,0.844,12.455,14,8,2,6,6,2,4,0,0.0,0.0
1005,639,24-09-2019 08:56:00,1,2534.0,2173.0,0.858,12.39,4,1,0,1,3,1,2,0,0.0,0.0
1005,640,24-09-2019 08:58:00,1,2528.0,2180.0,0.862,12.375,2,0,0,0,2,0,2,0,0.0,0.0
1005,641,24-09-2019 09:00:00,1,2334.0,2040.0,0.874,11.454,16,5,3,2,11,2,9,0,0.0,0.0
1005,642,24-09-2019 09:02:00,1,2453.0,2040.0,0.831,11.924,4,0,0,0,4,1,3,0,0.0,0.0
1005,643,24-09-2019 09:04:00,1,2460.0,2055.0,0.835,11.967,11,0,0,0,11,0,11,0,0.0,0.0
1005,644,24-09-2019 09:06:00,1,2456.0,2053.0,0.836,11.948,3,3,0,3,0,0,0,0,0.0,0.0
1005,645,24-09-2019 09:08:00,1,2453.0,2030.0,0.828,11.912,7,4,1,3,3,1,2,0,0.0,0.0
1005,646,24-09-2019 09:10:00,1,2559.0,2110.0,0.825,12.417,0,0,0,0,0,0,0,0,0.0,0.0
1005,647,24-09-2019 09:12:00,1,2573.0,2080.0,0.808,12.439,0,0,0,0,0,0,0,0,0.0,0.0
1005,648,24-09-2019 09:14:00,1,2565.0,2046.0,0.798,12.372,0,0,0,0,0,0,0,0,0.0,0.0
1005,649,24-09-2019 09:16:00,1,2571.0,2023.0,0.787,12.368,25,14,7,7,11,8,3,0,0.0,0.0
1005,650,24-09-2019 09:18:00,1,2569.5,2054.0,0.7995,12.396,0,0,0,0,0,0,0,0,0.0,0.0
1005,651,24-09-2019 09:20:00,1,2568.0,2085.0,0.812,12.424,0,0,0,0,0,0,0,0,0.0,0.0
1005,652,24-09-2019 09:22:00,1,2543.0,2096.0,0.824,12.342,0,0,0,0,0,0,0,0,0.0,0.0
1005,653,24-09-2019 09:24:00,1,2565.0,2073.0,0.808,12.4,3,3,1,2,0,0,0,0,0.0,0.0
1005,654,24-09-2019 09:26:00,1,2573.0,2053.0,0.798,12.412,9,5,2,3,4,2,2,0,0.0,0.0
1005,655,24-09-2019 09:28:00,1,2560.0,2040.0,0.797,12.346,13,0,0,0,13,1,12,0,0.0,0.0
1005,656,24-09-2019 09:30:00,1,2493.0,1961.0,0.787,11.993,15,5,1,4,10,0,10,0,0.0,0.0
1005,657,24-09-2019 09:32:00,1,2411.0,1817.0,0.753,11.513,15,1,0,1,14,1,13,0,0.0,0.0
1005,658,24-09-2019 09:34:00,1,2374.0,1864.0,0.785,11.418,0,0,0,0,0,0,0,0,0.0,0.0
1005,659,24-09-2019 09:36:00,1,2373.0,1914.0,0.806,11.469,0,0,0,0,0,0,0,0,0.0,0.0
1005,660,24-09-2019 09:38:00,1,2383.0,1914.0,0.803,11.51,0,0,0,0,0,0,0,0,0.0,0.0
1005,661,24-09-2019 09:40:00,1,2397.0,1887.0,0.787,11.533,18,10,5,5,8,3,5,0,0.0,0.0
1005,662,24-09-2019 09:42:00,1,2681.0,2094.0,0.781,12.881,4,4,0,4,0,0,0,0,0.0,0.0
1005,663,24-09-2019 09:44:00,1,2678.0,2118.0,0.791,12.898,1,1,0,1,0,0,0,0,0.0,0.0
1005,664,24-09-2019 09:46:00,1,2574.0,2080.0,0.808,12.444,0,0,0,0,0,0,0,0,0.0,0.0
1005,665,24-09-2019 09:48:00,1,2780.0,2106.0,0.758,13.284,3,3,2,1,0,0,0,0,0.0,0.0
1005,666,24-09-2019 09:50:00,1,2570.0,2035.0,0.792,12.38,9,3,0,3,6,1,5,0,0.0,0.0
1005,667,24-09-2019 09:52:00,1,2477.0,1959.0,0.791,11.928,2,0,0,0,2,0,2,0,0.0,0.0
1005,668,24-09-2019 09:54:00,1,2384.0,1883.0,0.79,11.476,4,4,2,2,0,0,0,0,0.0,0.0
1005,669,24-09-2019 09:56:00,1,2295.0,1772.0,0.772,11.003,12,11,2,9,1,1,0,0,0.0,0.0
1005,670,24-09-2019 09:58:00,1,2403.0,1812.0,0.754,11.473,4,4,0,4,0,0,0,0,0.0,0.0
1005,671,24-09-2019 10:00:00,1,2422.0,1792.0,0.74,11.526,8,4,0,4,4,0,4,0,0.0,0.0
1005,672,24-09-2019 10:02:00,1,2484.0,1915.0,0.771,11.906,5,1,0,1,4,2,2,0,0.0,0.0
1005,673,24-09-2019 10:04:00,1,2497.0,1936.0,0.775,11.982,23,15,9,6,8,5,3,0,0.0,0.0
1005,674,24-09-2019 10:06:00,1,2774.0,2169.0,0.782,13.331,2,2,1,1,0,0,0,0,0.0,0.0
1005,675,24-09-2019 10:08:00,1,2660.0,2107.0,0.792,12.813,8,8,4,4,0,0,0,0,0.0,0.0
1005,676,24-09-2019 10:10:00,1,2566.0,2110.0,0.822,12.446,13,13,8,5,0,0,0,0,0.0,0.0
1005,677,24-09-2019 10:12:00,1,2562.0,2052.0,0.801,12.368,2,0,0,0,2,1,1,0,0.0,0.0
1005,678,24-09-2019 10:14:00,1,2573.0,2016.0,0.783,12.371,4,1,1,0,3,0,3,0,0.0,0.0
1005,679,24-09-2019 10:16:00,1,2592.0,1973.0,0.761,12.395,2,2,0,2,0,0,0,0,0.0,0.0
1005,680,24-09-2019 10:18:00,1,2410.0,1780.0,0.739,11.464,0,0,0,0,0,0,0,0,0.0,0.0
1005,681,24-09-2019 10:20:00,1,2317.0,1709.0,0.738,11.023,9,8,4,4,1,0,1,0,0.0,0.0
1005,682,24-09-2019 10:22:00,1,2595.0,1972.0,0.76,12.409,54,42,10,32,12,7,5,0,0.0,0.0
1005,683,24-09-2019 10:24:00,1,2771.0,2204.0,0.795,13.359,156,84,53,31,72,48,24,15,0.0,0.0
1005,684,24-09-2019 10:26:00,1,2865.5,2256.0,0.7875,13.7875,99,52,30,22,47,18,29,17,0.0,0.0
1005,685,24-09-2019 10:28:00,1,2960.0,2308.0,0.78,14.216,138,111,72,39,27,6,21,52,0.0,0.0
1005,686,24-09-2019 10:30:00,1,3331.0,2708.0,0.813,16.122,74,43,22,21,31,4,27,39,0.0,0.0
1005,687,24-09-2019 10:32:00,1,3506.0,2861.0,0.816,16.98,254,174,128,46,80,54,26,56,0.0,0.0
1005,688,24-09-2019 10:34:00,1,3508.0,2897.0,0.826,17.029,166,134,95,39,32,11,21,54,0.0,0.0
1005,689,24-09-2019 10:36:00,1,3509.0,2851.0,0.813,16.984,170,115,82,33,55,37,18,39,0.0,0.0
1005,690,24-09-2019 10:38:00,1,3512.0,2850.0,0.811,16.995,105,54,25,29,51,25,26,30,0.0,0.0
1005,691,24-09-2019 10:40:00,1,3223.0,2639.0,0.819,15.619,57,37,16,21,20,3,17,0,0.0,0.0
1005,692,24-09-2019 10:42:00,1,3035.0,2500.0,0.824,14.725,213,142,111,31,71,42,29,9,0.0,0.0
1005,693,24-09-2019 10:44:00,1,2743.0,2250.0,0.82,13.297,271,200,154,46,71,39,32,8,0.0,0.0
1005,694,24-09-2019 10:46:00,1,3204.0,2677.0,0.836,15.586,578,336,272,64,242,185,57,63,0.0,0.04
1005,695,24-09-2019 10:48:00,1,3204.0,2697.0,0.842,15.611,179,109,71,38,70,46,24,0,0.0,0.0
1005,696,24-09-2019 10:50:00,1,3227.0,2633.0,0.816,15.628,445,267,191,76,178,132,46,10,0.0,0.0
1005,697,24-09-2019 10:52:00,1,3205.0,2723.0,0.849,15.644,85,54,27,27,31,12,19,0,0.0,0.0
1005,698,24-09-2019 10:54:00,1,3237.0,2619.0,0.809,15.652,447,330,259,71,117,86,31,4,0.0,0.0
1005,699,24-09-2019 10:56:00,1,3037.0,2501.0,0.823,14.735,62,34,15,19,28,5,23,0,0.0,0.0
1005,700,24-09-2019 10:58:00,1,3020.0,2512.0,0.832,14.68,14,10,1,9,4,1,3,0,0.0,0.0
1005,701,24-09-2019 11:00:00,1,3125.5,2565.5,0.8215,15.155,40,28,5,23,12,1,11,0,0.0,0.0
1005,702,24-09-2019 11:02:00,1,3231.0,2619.0,0.811,15.63,153,101,69,32,52,21,31,10,0.0,0.0
1005,703,24-09-2019 11:04:00,1,3203.0,2745.0,0.857,15.657,130,92,63,29,38,16,22,10,0.0,0.0
1005,704,24-09-2019 11:06:00,1,3213.0,2696.0,0.839,15.643,98,84,60,24,14,7,7,15,0.0,0.0
1005,705,24-09-2019 11:08:00,1,3042.0,2438.0,0.801,14.685,7,7,1,6,0,0,0,0,0.0,0.0
1005,706,24-09-2019 11:10:00,1,2744.0,2277.0,0.83,13.334,10,7,3,4,3,1,2,0,0.0,0.0
1005,707,24-09-2019 11:12:00,1,2655.0,2165.0,0.816,12.857,14,14,0,14,0,0,0,0,0.0,0.0
1005,708,24-09-2019 11:14:00,1,2567.0,2049.0,0.798,12.382,30,18,11,7,12,2,10,0,0.0,0.0
1005,709,24-09-2019 11:16:00,1,2556.0,2061.0,0.806,12.353,2,0,0,0,2,0,2,0,0.0,0.0
1005,710,24-09-2019 11:18:00,1,2368.0,1959.0,0.828,11.497,2,2,1,1,0,0,0,0,0.0,0.0
1005,711,24-09-2019 11:20:00,1,2363.0,1971.0,0.834,11.492,0,0,0,0,0,0,0,0,0.0,0.0
1005,712,24-09-2019 11:22:00,1,2358.0,1961.0,0.832,11.462,18,8,2,6,10,1,9,0,0.0,0.0
1005,713,24-09-2019 11:24:00,1,2582.0,2021.0,0.783,12.412,0,0,0,0,0,0,0,0,0.0,0.0
1005,714,24-09-2019 11:26:00,1,2370.0,1953.0,0.824,11.5,5,3,0,3,2,0,2,0,0.0,0.0
1005,715,24-09-2019 11:28:00,1,2481.0,1981.0,0.798,11.971,0,0,0,0,0,0,0,0,0.0,0.0
1005,716,24-09-2019 11:30:00,1,2586.0,2010.0,0.777,12.414,7,4,1,3,3,3,0,0,0.0,0.0
1005,717,24-09-2019 11:32:00,1,2591.0,2025.0,0.782,12.452,1,1,0,1,0,0,0,0,0.0,0.0
1005,718,24-09-2019 11:34:00,1,2581.5,2039.0,0.79,12.429,0,0,0,0,0,0,0,0,0.0,0.0
1005,719,24-09-2019 11:36:00,1,2572.0,2053.0,0.798,12.406,0,0,0,0,0,0,0,0,0.0,0.0
1005,720,24-09-2019 11:38:00,1,2569.0,2067.0,0.805,12.409,17,11,7,4,6,3,3,0,0.0,0.0
1005,721,24-09-2019 11:40:00,1,2654.0,2139.0,0.806,12.825,1,0,0,0,1,0,1,0,0.0,0.0
1005,722,24-09-2019 11:42:00,1,2568.0,2074.0,0.808,12.416,0,0,0,0,0,0,0,0,0.0,0.0
1005,723,24-09-2019 11:44:00,1,2577.0,2067.0,0.802,12.444,5,5,3,2,0,0,0,0,0.0,0.0
1005,724,24-09-2019 11:46:00,1,2598.0,2006.0,0.772,12.457,11,10,5,5,1,0,1,0,0.0,0.0
1005,725,24-09-2019 11:48:00,1,2483.0,1947.0,0.784,11.939,18,16,3,13,2,0,2,0,0.0,0.0
1005,726,24-09-2019 11:50:00,1,2379.0,1918.0,0.806,11.496,3,0,0,0,3,0,3,0,0.0,0.0
1005,727,24-09-2019 11:52:00,1,2391.0,1872.0,0.783,11.494,22,12,3,9,10,1,9,0,0.0,0.0
1005,728,24-09-2019 11:54:00,1,2590.0,2010.0,0.776,12.43,2,2,0,2,0,0,0,0,0.0,0.0
1005,729,24-09-2019 11:56:00,1,2589.0,1976.0,0.763,12.388,5,5,0,5,0,0,0,0,0.0,0.0
1005,730,24-09-2019 11:58:00,1,2599.0,1996.0,0.768,12.45,1,1,1,0,0,0,0,0,0.0,0.0
1005,731,24-09-2019 12:00:00,1,2481.0,1947.0,0.785,11.931,2,2,1,1,0,0,0,0,0.0,0.0
1005,732,24-09-2019 12:02:00,1,2387.0,1907.0,0.799,11.516,0,0,0,0,0,0,0,0,0.0,0.0
1005,733,24-09-2019 12:04:00,1,2376.0,1892.0,0.796,11.456,33,28,9,19,5,1,4,0,0.0,0.0
1005,734,24-09-2019 12:06:00,1,2480.0,1931.0,0.779,11.907,29,17,8,9,12,0,12,0,0.0,0.0
1005,735,24-09-2019 12:08:00,1,2534.0,1949.0,0.7695,12.141,2,2,2,0,0,0,0,0,0.0,0.0
1005,736,24-09-2019 12:10:00,1,2588.0,1967.0,0.76,12.375,14,13,3,10,1,0,1,0,0.0,0.0
1005,737,24-09-2019 12:12:00,1,2597.0,1959.0,0.755,12.402,14,10,5,5,4,1,3,0,0.0,0.0
1005,738,24-09-2019 12:14:00,1,2609.0,1948.0,0.747,12.435,12,12,4,8,0,0,0,0,0.0,0.0
1005,739,24-09-2019 12:16:00,1,2498.0,1923.0,0.77,11.97,6,5,1,4,1,1,0,0,0.0,0.0
1005,740,24-09-2019 12:18:00,1,2493.0,1929.0,0.774,11.959,2,2,0,2,0,0,0,0,0.0,0.0
1005,741,24-09-2019 12:20:00,1,2607.0,1953.0,0.749,12.434,0,0,0,0,0,0,0,0,0.0,0.0
1005,742,24-09-2019 12:22:00,1,2599.0,1951.0,0.751,12.399,3,3,0,3,0,0,0,0,0.0,0.0
1005,743,24-09-2019 12:24:00,1,2597.0,1967.0,0.758,12.409,5,1,0,1,4,1,3,0,0.0,0.0
1005,744,24-09-2019 12:26:00,1,2498.0,1919.0,0.768,11.967,0,0,0,0,0,0,0,0,0.0,0.0
1005,745,24-09-2019 12:28:00,1,2406.0,1789.0,0.744,11.459,11,2,1,1,9,0,9,0,0.0,0.0
1005,746,24-09-2019 12:30:00,1,2407.0,1811.0,0.752,11.488,1,1,0,1,0,0,0,0,0.0,0.0
1005,747,24-09-2019 12:32:00,1,2399.0,1827.0,0.762,11.476,1,1,0,1,0,0,0,0,0.0,0.0
1005,748,24-09-2019 12:34:00,1,2395.0,1787.0,0.746,11.415,8,5,0,5,3,0,3,0,0.0,0.0
1005,749,24-09-2019 12:36:00,1,2401.0,1830.0,0.762,11.486,4,4,0,4,0,0,0,0,0.0,0.0
1005,750,24-09-2019 12:38:00,1,2307.0,1769.0,0.767,11.047,2,2,0,2,0,0,0,0,0.0,0.0
1005,751,24-09-2019 12:40:00,1,2409.0,1807.0,0.75,11.49,47,35,18,17,12,6,6,0,0.0,0.0
1005,752,24-09-2019 12:42:00,1,2357.5,1786.0,0.7575,11.2655,12,2,1,1,10,0,10,0,0.0,0.0
1005,753,24-09-2019 12:44:00,1,2306.0,1765.0,0.765,11.041,5,1,0,1,4,0,4,0,0.0,0.0
1005,754,24-09-2019 12:46:00,1,2204.0,1729.0,0.785,10.596,8,1,0,1,7,0,7,0,0.0,0.0
1005,755,24-09-2019 12:48:00,1,2315.0,1744.0,0.754,11.052,6,6,2,4,0,0,0,0,0.0,0.0
1005,756,24-09-2019 12:50:00,1,2311.0,1745.0,0.755,11.039,3,3,0,3,0,0,0,0,0.0,0.0
1005,757,24-09-2019 12:52:00,1,2200.0,1704.0,0.774,10.556,23,12,4,8,11,0,11,0,0.0,0.0
1005,758,24-09-2019 12:54:00,1,2298.0,1757.0,0.764,11.001,25,13,7,6,12,1,11,0,0.0,0.0
1005,759,24-09-2019 12:56:00,1,2582.0,2000.0,0.774,12.387,0,0,0,0,0,0,0,0,0.0,0.0
1005,760,24-09-2019 12:58:00,1,2370.0,1912.0,0.807,11.456,7,3,1,2,4,1,3,0,0.0,0.0
1005,761,24-09-2019 13:00:00,1,2382.0,1884.0,0.791,11.472,8,4,1,3,4,0,4,0,0.0,0.0
1005,762,24-09-2019 13:02:00,1,2481.0,1923.0,0.775,11.904,0,0,0,0,0,0,0,0,0.0,0.0
1005,763,24-09-2019 13:04:00,1,2607.0,1939.0,0.744,12.421,4,2,1,1,2,0,2,0,0.0,0.0
1005,764,24-09-2019 13:06:00,1,2603.0,1950.0,0.749,12.417,40,38,2,36,2,1,1,0,0.0,0.0
1005,765,24-09-2019 13:08:00,1,2675.0,2113.0,0.79,12.88,74,47,16,31,27,6,21,0,0.0,0.0
1005,766,24-09-2019 13:10:00,1,2751.0,2254.0,0.819,13.335,67,48,21,27,19,4,15,0,0.0,0.0
1005,767,24-09-2019 13:12:00,1,3090.0,2323.0,0.752,14.747,37,12,2,10,25,0,25,0,0.0,0.0
1005,768,24-09-2019 13:14:00,1,3077.0,2322.0,0.755,14.694,43,30,18,12,13,0,13,0,0.0,0.0
1005,769,24-09-2019 13:16:00,1,3061.5,2372.0,0.775,14.6895,306,178,131,47,128,95,33,77,0.0,0.0
1005,770,24-09-2019 13:18:00,1,3046.0,2422.0,0.795,14.685,114,37,27,10,77,32,45,38,0.0,0.0
1005,771,24-09-2019 13:20:00,1,3543.0,2776.0,0.784,17.033,91,13,3,10,78,44,34,45,0.0,0.0
1005,772,24-09-2019 13:22:00,1,3328.0,2694.0,0.809,16.094,134,14,1,13,120,83,37,41,0.0,0.0
1005,773,24-09-2019 13:24:00,1,3507.0,2892.0,0.825,17.019,136,29,8,21,107,53,54,36,0.0,0.0
1005,774,24-09-2019 13:26:00,1,3207.0,2666.0,0.831,15.588,61,28,0,28,33,3,30,39,0.0,0.0
1005,775,24-09-2019 13:28:00,1,3520.0,2819.0,0.801,16.991,45,10,0,10,35,6,29,45,0.0,0.0
1005,776,24-09-2019 13:30:00,1,3695.0,2980.0,0.807,17.857,43,2,0,2,41,15,26,34,0.0,0.03
1005,777,24-09-2019 13:32:00,1,3694.0,3023.0,0.818,17.901,67,14,0,14,53,14,39,33,0.0,0.0
1005,778,24-09-2019 13:34:00,1,3698.0,3052.0,0.825,17.949,84,17,2,15,67,31,36,39,0.0,0.05
1005,779,24-09-2019 13:36:00,1,3746.0,3229.0,0.862,18.333,70,19,2,17,51,12,39,45,0.0,0.07
1005,780,24-09-2019 13:38:00,1,3658.0,3223.0,0.881,17.981,63,8,1,7,55,20,35,30,0.01,0.01
1005,781,24-09-2019 13:40:00,1,3490.0,2931.0,0.84,16.998,421,189,142,47,232,181,51,37,0.06,0.06
1005,782,24-09-2019 13:42:00,1,3004.0,2603.0,0.867,14.718,417,223,175,48,194,142,52,12,0.05,0.04
1005,783,24-09-2019 13:44:00,1,3184.0,2823.0,0.887,15.67,552,297,238,59,255,186,69,8,0.08,0.0
1005,784,24-09-2019 13:46:00,1,3475.0,3005.0,0.865,17.017,599,326,257,69,273,198,75,9,0.0,0.0
1005,785,24-09-2019 13:48:00,1,3340.0,2986.0,0.894,16.465,482,275,209,66,207,140,67,2,0.0,0.0
1005,786,24-09-2019 13:50:00,1,3390.0,3075.5,0.907,16.762,743,384,301,83,359,276,83,29,0.0,0.02
1005,787,24-09-2019 13:52:00,1,3440.0,3165.0,0.92,17.059,271,130,98,32,141,89,52,5,0.0,0.08
1005,788,24-09-2019 13:54:00,1,3447.0,3110.0,0.902,17.023,68,22,2,20,46,0,46,0,0.0,0.0
1005,789,24-09-2019 13:56:00,1,3632.0,3224.0,0.888,17.878,65,24,5,19,41,0,41,0,0.0,0.0
1005,790,24-09-2019 13:58:00,1,3808.0,3447.0,0.905,18.819,60,11,1,10,49,4,45,0,0.0,0.0
1005,791,24-09-2019 14:00:00,1,3618.0,3381.0,0.935,17.996,10,2,0,2,8,6,2,0,0.0,0.0
1005,792,24-09-2019 14:02:00,1,3429.0,3138.0,0.915,16.984,7,3,1,2,4,1,3,0,0.0,0.0
1005,793,24-09-2019 14:04:00,1,3161.0,2930.0,0.927,15.7,0,0,0,0,0,0,0,0,0.01,0.0
1005,794,24-09-2019 14:06:00,1,3161.0,2823.0,0.893,15.581,42,27,14,13,15,7,8,0,0.0,0.0
1005,795,24-09-2019 14:08:00,1,3143.0,2955.0,0.94,15.655,38,27,5,22,11,3,8,0,0.0,0.0
1005,796,24-09-2019 14:10:00,1,3072.0,2835.0,0.923,15.243,24,24,2,22,0,0,0,0,0.0,0.0
1005,797,24-09-2019 14:12:00,1,2958.0,2732.0,0.924,14.679,12,12,3,9,0,0,0,0,0.0,0.0
1005,798,24-09-2019 14:14:00,1,2984.0,2670.0,0.895,14.712,0,0,0,0,0,0,0,0,0.0,0.0
1005,799,24-09-2019 14:16:00,1,2762.0,2607.0,0.944,13.768,46,28,6,22,18,11,7,0,0.0,0.0
1005,800,24-09-2019 14:18:00,1,2663.0,2570.0,0.965,13.336,12,10,0,10,2,0,2,0,0.0,0.0
1005,801,24-09-2019 14:20:00,1,2668.0,2509.0,0.941,13.288,10,10,0,10,0,0,0,0,0.0,0.0
1005,802,24-09-2019 14:22:00,1,2466.0,2427.0,0.984,12.403,29,28,0,28,1,0,1,0,0.0,0.0
1005,803,24-09-2019 14:24:00,1,2524.5,2454.0,0.9725,12.663,25,23,0,23,2,0,2,0,0.0,0.0
1005,804,24-09-2019 14:26:00,1,2583.0,2481.0,0.961,12.923,10,9,0,9,1,0,1,0,0.01,0.0
1005,805,24-09-2019 14:28:00,1,2692.0,2498.0,0.928,13.372,3,1,0,1,2,0,2,0,0.0,0.0
1005,806,24-09-2019 14:30:00,1,2590.0,2461.0,0.95,12.93,26,13,7,6,13,6,7,0,0.0,0.0
1005,807,24-09-2019 14:32:00,1,2657.0,2579.0,0.971,13.323,4,1,0,1,3,0,3,0,0.0,0.0
1005,808,24-09-2019 14:34:00,1,2672.0,2583.0,0.967,13.389,34,7,5,2,27,11,16,0,0.0,0.0
1005,809,24-09-2019 14:36:00,1,2655.0,2590.0,0.976,13.327,46,34,0,34,12,0,12,0,0.0,0.0
1005,810,24-09-2019 14:38:00,1,2674.0,2578.0,0.964,13.391,7,3,0,3,4,0,4,0,0.0,0.0
1005,811,24-09-2019 14:40:00,1,2668.0,2541.0,0.953,13.324,22,4,1,3,18,6,12,0,0.0,0.0
1005,812,24-09-2019 14:42:00,1,2682.0,2520.0,0.94,13.355,18,8,6,2,10,2,8,0,0.0,0.0
1005,813,24-09-2019 14:44:00,1,2480.0,2399.0,0.967,12.426,6,3,0,3,3,0,3,0,0.0,0.0
1005,814,24-09-2019 14:46:00,1,2484.0,2345.0,0.944,12.381,13,8,2,6,5,1,4,0,0.0,0.0
1005,815,24-09-2019 14:48:00,1,2488.0,2371.0,0.953,12.428,0,0,0,0,0,0,0,0,0.0,0.0
1005,816,24-09-2019 14:50:00,1,2493.0,2335.0,0.937,12.408,10,7,0,7,3,0,3,0,0.0,0.0
1005,817,24-09-2019 14:52:00,1,2505.0,2293.0,0.916,12.407,29,14,10,4,15,8,7,0,0.0,0.0
1005,818,24-09-2019 14:54:00,1,2656.0,2594.0,0.977,13.335,0,0,0,0,0,0,0,0,0.0,0.0
1005,819,24-09-2019 14:56:00,1,2668.0,2620.0,0.982,13.411,3,3,0,3,0,0,0,0,0.0,0.0
1005,820,24-09-2019 14:58:00,1,2675.0,2561.0,0.9575,13.3735,0,0,0,0,0,0,0,0,0.0,0.0
1005,821,24-09-2019 15:00:00,1,2682.0,2502.0,0.933,13.336,9,3,0,3,6,1,5,0,0.0,0.0
1005,822,24-09-2019 15:02:00,1,2685.0,2527.0,0.941,13.377,10,3,0,3,7,4,3,0,0.0,0.0
1005,823,24-09-2019 15:04:00,1,2691.0,2490.0,0.925,13.361,17,10,5,5,7,3,4,0,0.0,0.0
1005,824,24-09-2019 15:06:00,1,2491.0,2408.0,0.966,12.48,27,14,6,8,13,6,7,0,0.0,0.0
1005,825,24-09-2019 15:08:00,1,2688.0,2488.0,0.925,13.346,193,126,84,42,67,38,29,11,0.0,0.06
1005,826,24-09-2019 15:10:00,1,2678.0,2495.0,0.932,13.312,81,21,1,20,60,18,42,0,0.0,0.0
1005,827,24-09-2019 15:12:00,1,2874.0,2648.0,0.921,14.253,183,111,70,41,72,48,24,45,0.01,0.0
1005,828,24-09-2019 15:14:00,1,3046.0,2828.0,0.928,15.132,79,5,3,2,74,22,52,40,0.0,0.0
1005,829,24-09-2019 15:16:00,1,3118.0,3073.0,0.985,15.688,93,23,3,20,70,20,50,41,0.0,0.0
1005,830,24-09-2019 15:18:00,1,3422.0,3168.0,0.926,16.991,69,21,1,20,48,4,44,40,0.0,0.0
1005,831,24-09-2019 15:20:00,1,3424.0,3206.0,0.936,17.038,73,15,0,15,58,12,46,24,0.0,0.0
1005,832,24-09-2019 15:22:00,1,3428.0,3177.0,0.927,17.025,111,50,28,22,61,16,45,29,0.0,0.13
1005,833,24-09-2019 15:24:00,1,2963.0,2723.0,0.919,14.688,417,230,174,56,187,140,47,45,0.07,0.0
1005,834,24-09-2019 15:26:00,1,2651.0,2639.0,0.996,13.365,236,141,104,37,95,74,21,25,0.0,0.0
1005,835,24-09-2019 15:28:00,1,3046.0,2911.0,0.956,15.223,52,25,12,13,27,0,27,0,0.0,0.0
1005,836,24-09-2019 15:30:00,1,3136.0,3019.0,0.963,15.696,48,34,22,12,14,0,14,0,0.0,0.0
1005,837,24-09-2019 15:32:00,1,3275.0,3132.0,0.957,16.369,32,25,0,25,7,1,6,0,0.01,0.0
1005,838,24-09-2019 15:34:00,1,3414.0,3245.0,0.951,17.042,14,6,2,4,8,2,6,0,0.0,0.0
1005,839,24-09-2019 15:36:00,1,3114.0,2998.0,0.963,15.588,4,0,0,0,4,0,4,0,0.0,0.0
1005,840,24-09-2019 15:38:00,1,3165.0,2891.0,0.914,15.67,2,0,0,0,2,0,2,0,0.0,0.0
1005,841,24-09-2019 15:40:00,1,2954.0,2823.0,0.956,14.763,17,7,4,3,10,1,9,0,0.0,0.0
1005,842,24-09-2019 15:42:00,1,2925.0,2836.0,0.97,14.662,7,6,1,5,1,0,1,0,0.0,0.0
1005,843,24-09-2019 15:44:00,1,2925.0,2898.0,0.991,14.731,3,2,0,2,1,0,1,0,0.0,0.0
1005,844,24-09-2019 15:46:00,1,2953.0,2803.0,0.949,14.738,0,0,0,0,0,0,0,0,0.0,0.0
1005,845,24-09-2019 15:48:00,1,2860.0,2729.0,0.954,14.289,28,24,7,17,4,0,4,0,0.0,0.0
1005,846,24-09-2019 15:50:00,1,2848.0,2742.0,0.963,14.259,0,0,0,0,0,0,0,0,0.0,0.0
1005,847,24-09-2019 15:52:00,1,2964.0,2804.0,0.946,14.781,2,1,1,0,1,0,1,0,0.0,0.0
1005,848,24-09-2019 15:54:00,1,2965.0,2805.0,0.946,14.786,0,0,0,0,0,0,0,0,0.0,0.0
1005,849,24-09-2019 15:56:00,1,2748.0,2725.0,0.992,13.842,5,4,0,4,1,0,1,0,0.0,0.0
1005,850,24-09-2019 15:58:00,1,2640.0,2696.0,1.021,13.386,0,0,0,0,0,0,0,0,0.0,0.0
1005,851,24-09-2019 16:00:00,1,2663.0,2643.0,0.993,13.417,10,4,1,3,6,1,5,0,0.0,0.0
1005,852,24-09-2019 16:02:00,1,2651.0,2578.0,0.972,13.3,14,6,1,5,8,0,8,0,0.0,0.0
1005,853,24-09-2019 16:04:00,1,2664.0,2589.0,0.972,13.363,12,12,0,12,0,0,0,0,0.0,0.0
1005,854,24-09-2019 16:06:00,1,2705.0,2668.0,0.986,13.6125,74,48,34,14,26,11,15,0,0.0,0.0
1005,855,24-09-2019 16:08:00,1,2746.0,2747.0,1.0,13.862,7,0,0,0,7,3,4,0,0.0,0.0
1005,856,24-09-2019 16:10:00,1,2651.0,2604.0,0.982,13.328,24,9,2,7,15,4,11,0,0.0,0.0
1005,857,24-09-2019 16:12:00,1,2936.0,2813.0,0.958,14.683,59,49,22,27,10,4,6,0,0.0,0.0
1005,858,24-09-2019 16:14:00,1,3110.0,3022.0,0.972,15.598,45,32,11,21,13,0,13,0,0.0,0.0
1005,859,24-09-2019 16:16:00,1,3119.0,3010.0,0.965,15.622,14,14,5,9,0,0,0,0,0.0,0.0
1005,860,24-09-2019 16:18:00,1,2945.0,2829.0,0.961,14.733,0,0,0,0,0,0,0,0,0.0,0.0
1005,861,24-09-2019 16:20:00,1,2749.0,2721.0,0.99,13.845,1,1,1,0,0,0,0,0,0.0,0.0
1005,862,24-09-2019 16:22:00,1,2643.0,2604.0,0.985,13.294,45,30,12,18,15,3,12,0,0.0,0.0
1005,863,24-09-2019 16:24:00,1,2942.0,2802.0,0.953,14.692,3,3,1,2,0,0,0,0,0.0,0.0
1005,864,24-09-2019 16:26:00,1,2962.0,2818.0,0.951,14.79,15,13,1,12,2,1,1,0,0.0,0.0
1005,865,24-09-2019 16:28:00,1,2737.0,2783.0,1.017,13.865,15,10,7,3,5,0,5,0,0.0,0.0
1005,866,24-09-2019 16:30:00,1,2647.0,2675.0,1.01,13.392,10,1,0,1,9,0,9,0,0.0,0.0
1005,867,24-09-2019 16:32:00,1,2651.0,2586.0,0.976,13.308,61,29,13,16,32,11,21,29,0.01,0.0
1005,868,24-09-2019 16:34:00,1,3304.0,3269.0,0.989,16.635,59,17,1,16,42,10,32,25,0.0,0.0
1005,869,24-09-2019 16:36:00,1,3351.0,3401.0,1.015,16.968,90,19,0,19,71,26,45,30,0.0,0.0
1005,870,24-09-2019 16:38:00,1,3459.0,3479.0,1.006,17.481,91,28,0,28,63,11,52,41,0.0,0.0
1005,871,24-09-2019 16:40:00,1,3416.5,3430.0,1.004,17.2585,93,18,0,18,75,42,33,37,0.0,0.05
1005,872,24-09-2019 16:42:00,1,3374.0,3381.0,1.002,17.036,56,14,4,10,42,6,36,39,0.0,0.0
1005,873,24-09-2019 16:44:00,1,3387.0,3317.0,0.979,17.018,125,72,45,27,53,24,29,27,0.13,0.08
1005,874,24-09-2019 16:46:00,1,2556.0,2522.0,0.987,12.862,393,194,146,48,199,161,38,36,0.0,0.01
1005,875,24-09-2019 16:48:00,1,2467.0,2452.0,0.994,12.435,467,256,195,61,211,147,64,6,0.09,0.01
1005,876,24-09-2019 16:50:00,1,3140.0,2976.0,0.948,15.665,38,18,4,14,20,5,15,0,0.0,0.0
1005,877,24-09-2019 16:52:00,1,3090.0,3175.0,1.028,15.692,34,30,6,24,4,0,4,0,0.01,0.0
1005,878,24-09-2019 16:54:00,1,3571.0,3515.0,0.984,17.959,86,65,24,41,21,5,16,0,0.0,0.0
1005,879,24-09-2019 16:56:00,1,3404.0,3347.0,0.983,17.118,94,60,24,36,34,7,27,0,0.0,0.0
1005,880,24-09-2019 16:58:00,1,3578.0,3474.0,0.971,17.944,46,18,4,14,28,14,14,0,0.0,0.0
1005,881,24-09-2019 17:00:00,1,3386.0,3394.0,1.002,17.098,0,0,0,0,0,0,0,0,0.0,0.0
1005,882,24-09-2019 17:02:00,1,3397.0,3297.0,0.971,17.036,15,7,4,3,8,5,3,0,0.0,0.0
1005,883,24-09-2019 17:04:00,1,3413.0,3303.0,0.968,17.103,10,7,2,5,3,1,2,0,0.0,0.0
1005,884,24-09-2019 17:06:00,1,3191.0,3167.0,0.993,16.078,8,0,0,0,8,0,8,0,0.0,0.0
1005,885,24-09-2019 17:08:00,1,3120.0,3056.0,0.979,15.674,12,5,2,3,7,1,6,0,0.0,0.0
1005,886,24-09-2019 17:10:00,1,3125.0,2983.0,0.955,15.613,3,1,0,1,2,1,1,0,0.0,0.0
1005,887,24-09-2019 17:12:00,1,2904.0,2929.0,1.009,14.682,25,14,6,8,11,4,7,0,0.0,0.0
1005,888,24-09-2019 17:14:00,1,2919.0,2887.0,0.9895,14.696,2,2,0,2,0,0,0,0,0.0,0.0
1005,889,24-09-2019 17:16:00,1,2934.0,2845.0,0.97,14.71,6,6,0,6,0,0,0,0,0.0,0.0
1005,890,24-09-2019 17:18:00,1,2946.0,2804.0,0.952,14.709,0,0,0,0,0,0,0,0,0.0,0.0
1005,891,24-09-2019 17:20:00,1,2745.0,2753.0,1.003,13.863,4,3,1,2,1,0,1,0,0.0,0.01
1005,892,24-09-2019 17:22:00,1,2636.0,2690.0,1.02,13.366,17,15,1,14,2,0,2,0,0.0,0.0
1005,893,24-09-2019 17:24:00,1,2649.0,2632.0,0.994,13.351,15,8,4,4,7,2,5,0,0.0,0.0
1005,894,24-09-2019 17:26:00,1,2549.0,2581.0,1.013,12.901,22,22,0,22,0,0,0,0,0.0,0.0
1005,895,24-09-2019 17:28:00,1,2655.0,2602.0,0.98,13.342,10,5,0,5,5,1,4,0,0.0,0.0
1005,896,24-09-2019 17:30:00,1,2658.0,2652.0,0.998,13.409,16,5,4,1,11,7,4,0,0.0,0.0
1005,897,24-09-2019 17:32:00,1,2907.0,2970.0,1.022,14.742,9,2,1,1,7,0,7,0,0.0,0.0
1005,898,24-09-2019 17:34:00,1,2904.0,3001.0,1.033,14.762,4,3,1,2,1,0,1,0,0.0,0.0
1005,899,24-09-2019 17:36:00,1,2901.0,2957.0,1.02,14.702,10,5,1,4,5,1,4,0,0.0,0.0
1005,900,24-09-2019 17:38:00,1,2956.0,2774.0,0.938,14.718,98,54,28,26,44,19,25,27,0.0,0.0
1005,901,24-09-2019 17:40:00,1,3381.0,3328.0,0.984,17.007,189,80,59,21,109,64,45,46,0.0,0.0
1005,902,24-09-2019 17:42:00,1,3060.0,3215.0,1.051,15.618,289,82,58,24,207,148,59,37,0.01,0.0
1005,903,24-09-2019 17:44:00,1,3538.0,3656.0,1.033,17.988,72,17,2,15,55,10,45,36,0.0,0.02
1005,904,24-09-2019 17:46:00,1,3524.0,3689.0,1.047,17.97,55,14,0,14,41,4,37,27,0.0,0.0
1005,905,24-09-2019 17:48:00,1,3673.0,3804.5,1.0365,18.684,74,16,0,16,58,2,56,34,0.0,0.1
1005,906,24-09-2019 17:50:00,1,3822.0,3920.0,1.026,19.398,88,25,1,24,63,15,48,25,0.0,0.0
1005,907,24-09-2019 17:52:00,1,3815.0,3939.0,1.032,19.391,180,16,6,10,164,105,59,40,0.0,0.11
1005,908,24-09-2019 17:54:00,1,3817.0,3920.0,1.027,19.379,229,83,56,27,146,98,48,51,0.09,0.05
1005,909,24-09-2019 17:56:00,1,3027.0,2985.0,0.986,15.23,346,176,131,45,170,125,45,74,0.06,0.0
1005,910,24-09-2019 17:58:00,1,3557.0,3606.0,1.014,18.006,210,122,88,34,88,61,27,3,0.0,0.0
1005,911,24-09-2019 18:00:00,0,3292.0,3259.0,0.99,16.578,116,69,30,39,47,26,21,0,0.0,0.0
1005,912,24-09-2019 18:02:00,0,3821.0,3886.0,1.017,19.355,73,52,33,19,21,7,14,0,0.0,0.0
1005,913,24-09-2019 18:04:00,0,3804.0,3939.0,1.036,19.348,35,19,2,17,16,4,12,0,0.0,0.01
1005,914,24-09-2019 18:06:00,0,3730.0,3730.0,1.0,18.824,13,7,3,4,6,2,4,0,0.0,0.0
1005,915,24-09-2019 18:08:00,0,3541.0,3661.0,1.034,18.005,5,5,0,5,0,0,0,0,0.0,0.0
1005,916,24-09-2019 18:10:00,0,3543.0,3560.0,1.005,17.901,1,0,0,0,1,1,0,0,0.0,0.0
1005,917,24-09-2019 18:12:00,0,3566.0,3561.0,0.999,17.992,27,18,7,11,9,1,8,0,0.0,0.0
1005,918,24-09-2019 18:14:00,0,3361.0,3386.0,1.007,16.989,0,0,0,0,0,0,0,0,0.0,0.0
1005,919,24-09-2019 18:16:00,0,3392.0,3340.0,0.985,17.061,8,1,0,1,7,0,7,0,0.0,0.0
1005,920,24-09-2019 18:18:00,0,3086.0,3199.0,1.037,15.698,76,32,16,16,44,26,18,0,0.0,0.0
1005,921,24-09-2019 18:20:00,0,3546.0,3544.0,0.999,17.893,227,138,97,41,89,61,28,12,0.07,0.0
1005,922,24-09-2019 18:22:00,0,3690.0,3653.5,0.9905,18.582,188,133,88,45,55,31,24,13,0.0,0.0
1005,923,24-09-2019 18:24:00,0,3834.0,3763.0,0.982,19.271,98,62,32,30,36,9,27,1,0.0,0.0
1005,924,24-09-2019 18:26:00,0,3837.0,3892.0,1.014,19.427,289,149,121,28,140,96,44,42,0.0,0.0
1005,925,24-09-2019 18:28:00,0,3741.0,3697.0,0.988,18.833,20,6,0,6,14,0,14,0,0.0,0.01
1005,926,24-09-2019 18:30:00,0,3541.0,3570.0,1.008,17.902,2,2,1,1,0,0,0,0,0.0,0.0
1005,927,24-09-2019 18:32:00,0,3555.0,3552.0,0.999,17.939,4,1,0,1,3,2,1,0,0.0,0.0
1005,928,24-09-2019 18:34:00,0,3466.0,3505.0,1.011,17.535,3,0,0,0,3,0,3,0,0.0,0.0
1005,929,24-09-2019 18:36:00,0,3377.0,3386.0,1.003,17.055,10,5,2,3,5,0,5,0,0.0,0.0
1005,930,24-09-2019 18:38:00,0,3375.0,3352.0,0.993,17.007,81,27,5,22,54,10,44,38,0.0,0.0
1005,931,24-09-2019 18:40:00,0,4181.0,4318.0,1.033,21.252,89,13,0,13,76,22,54,26,0.0,0.06
1005,932,24-09-2019 18:42:00,0,3993.0,4146.0,1.038,20.323,134,35,25,10,99,40,59,24,0.0,0.34
1005,933,24-09-2019 18:44:00,0,2931.0,2909.0,0.993,14.766,8,0,0,0,8,0,8,0,0.0,0.0
1005,934,24-09-2019 18:46:00,0,2316.0,2166.0,0.935,11.524,9,0,0,0,9,1,8,0,0.0,0.0
1005,935,24-09-2019 18:48:00,0,2013.0,1988.0,0.987,10.132,341,158,123,35,183,132,51,36,0.07,0.0
1005,936,24-09-2019 18:50:00,0,3918.0,4008.0,1.023,19.872,352,198,154,44,154,118,36,104,0.0,0.0
1005,937,24-09-2019 18:52:00,0,4446.0,4484.0,1.009,22.482,370,188,150,38,182,144,38,72,0.04,0.0
1005,938,24-09-2019 18:54:00,0,3817.0,3892.0,1.02,19.347,329,175,141,34,154,99,55,35,0.0,0.0
1005,939,24-09-2019 18:56:00,0,3819.0,3873.5,1.0145,19.3355,326,158,126,32,168,120,48,51,0.07,0.01
1005,940,24-09-2019 18:58:00,0,3821.0,3855.0,1.009,19.324,97,85,50,35,12,4,8,0,0.01,0.0
1005,941,24-09-2019 19:00:00,0,3995.0,4116.0,1.03,20.298,46,27,14,13,19,0,19,0,0.0,0.0
1005,942,24-09-2019 19:02:00,0,3985.0,4095.0,1.028,20.232,70,35,5,30,35,0,35,0,0.0,0.0
1005,943,24-09-2019 19:04:00,0,3986.0,4152.0,1.042,20.302,42,33,10,23,9,3,6,0,0.0,0.0
1005,944,24-09-2019 19:06:00,0,4009.0,4041.0,1.008,20.268,12,12,4,8,0,0,0,0,0.0,0.0
1005,945,24-09-2019 19:08:00,0,3935.0,3955.0,1.005,19.883,2,2,1,1,0,0,0,0,0.0,0.0
1005,946,24-09-2019 19:10:00,0,3836.0,3832.0,0.999,19.354,11,8,6,2,3,1,2,0,0.0,0.0
1005,947,24-09-2019 19:12:00,0,3848.0,3738.0,0.971,19.3,7,6,4,2,1,0,1,0,0.0,0.0
1005,948,24-09-2019 19:14:00,0,3863.0,3750.0,0.971,19.372,16,12,5,7,4,3,1,0,0.0,0.0
1005,949,24-09-2019 19:16:00,0,3847.0,3741.0,0.972,19.3,1,0,0,0,1,1,0,0,0.01,0.0
1005,950,24-09-2019 19:18:00,0,3541.0,3594.0,1.015,17.932,10,6,3,3,4,1,3,0,0.0,0.0
1005,951,24-09-2019 19:20:00,0,3554.0,3562.0,1.002,17.946,0,0,0,0,0,0,0,0,0.0,0.0
1005,952,24-09-2019 19:22:00,0,3568.0,3517.0,0.986,17.953,16,5,3,2,11,0,11,0,0.0,0.0
1005,953,24-09-2019 19:24:00,0,3359.0,3487.0,1.038,17.092,7,7,0,7,0,0,0,0,0.0,0.0
1005,954,24-09-2019 19:26:00,0,3363.0,3411.0,1.014,17.025,7,7,0,7,0,0,0,0,0.0,0.0
1005,955,24-09-2019 19:28:00,0,3376.0,3345.0,0.991,17.006,5,2,1,1,3,0,3,0,0.0,0.0
1005,956,24-09-2019 19:30:00,0,3384.0,3347.5,0.989,17.0395,42,27,8,19,15,2,13,0,0.0,0.0
1005,957,24-09-2019 19:32:00,0,3392.0,3350.0,0.987,17.073,292,203,163,40,89,55,34,34,0.0,0.0
1005,958,24-09-2019 19:34:00,0,3451.0,3553.0,1.03,17.531,254,134,100,34,120,85,35,76,0.0,0.0
1005,959,24-09-2019 19:36:00,0,3521.0,3645.0,1.035,17.909,79,47,21,26,32,8,24,0,0.0,0.0
1005,960,24-09-2019 19:38:00,0,3543.0,3656.0,1.032,18.007,39,21,3,18,18,2,16,0,0.0,0.0
1005,961,24-09-2019 19:40:00,0,3849.0,3757.0,0.976,19.323,170,118,83,35,52,30,22,43,0.0,0.0
1005,962,24-09-2019 19:42:00,0,3996.0,4081.0,1.021,20.26,320,170,130,40,150,111,39,103,0.02,0.0
1005,963,24-09-2019 19:44:00,0,3800.0,4023.0,1.059,19.424,228,135,102,33,93,65,28,30,0.0,0.0
1005,964,24-09-2019 19:46:00,0,3757.0,3717.0,0.989,18.917,192,99,81,18,93,58,35,69,0.0,0.0
1005,965,24-09-2019 19:48:00,0,3823.0,3905.0,1.021,19.387,378,203,163,40,175,129,46,48,0.07,0.02
1005,966,24-09-2019 19:50:00,0,3803.0,3926.0,1.032,19.331,365,191,153,38,174,130,44,117,0.0,0.0
1005,967,24-09-2019 19:52:00,0,3796.0,3945.0,1.039,19.324,248,151,109,42,97,66,31,63,0.0,0.01
1005,968,24-09-2019 19:54:00,0,3921.0,3978.0,1.015,19.85,245,146,112,34,99,59,40,53,0.0,0.0
1005,969,24-09-2019 19:56:00,0,4105.0,4157.0,1.013,20.775,65,9,1,8,56,28,28,40,0.0,0.0
1005,970,24-09-2019 19:58:00,0,4291.0,4355.0,1.015,21.728,152,63,41,22,89,52,37,21,0.0,0.06
1005,971,24-09-2019 20:00:00,0,3086.0,3135.0,1.016,15.631,213,117,89,28,96,65,31,47,0.0,0.0
1005,972,24-09-2019 20:02:00,0,3921.0,3935.0,1.003,19.805,127,67,41,26,60,37,23,3,0.08,0.08
1005,973,24-09-2019 20:04:00,0,3952.0,4013.5,1.015,20.013,61,36,8,28,25,4,21,0,0.0,0.0
1005,974,24-09-2019 20:06:00,0,3983.0,4092.0,1.027,20.221,111,51,25,26,60,17,43,0,0.0,0.0
1005,975,24-09-2019 20:08:00,0,4158.0,4299.0,1.034,21.142,57,31,10,21,26,17,9,3,0.01,0.0
1005,976,24-09-2019 20:10:00,0,4087.0,4188.0,1.025,20.741,15,1,0,1,14,1,13,0,0.0,0.0
1005,977,24-09-2019 20:12:00,0,3922.0,3918.0,0.999,19.791,2,1,0,1,1,0,1,0,0.0,0.0
1005,978,24-09-2019 20:14:00,0,3742.0,3671.0,0.981,18.807,167,123,83,40,44,18,26,52,0.0,0.0
1005,979,24-09-2019 20:16:00,0,3835.0,3762.0,0.981,19.276,152,61,33,28,91,50,41,48,0.0,0.0
1005,980,24-09-2019 20:18:00,0,4196.0,4277.0,1.019,21.267,151,52,29,23,99,53,46,58,0.0,0.0
1005,981,24-09-2019 20:20:00,0,3651.0,3688.0,1.01,18.467,167,125,83,42,42,16,26,44,0.11,0.03
1005,982,24-09-2019 20:22:00,0,3375.0,3348.0,0.992,17.004,322,153,115,38,169,123,46,48,0.01,0.08
1005,983,24-09-2019 20:24:00,0,3859.0,3756.0,0.973,19.361,210,124,89,35,86,51,35,47,0.0,0.0
1005,984,24-09-2019 20:26:00,0,3006.0,2972.0,0.989,15.132,232,130,97,33,102,74,28,37,0.0,0.0
1005,985,24-09-2019 20:28:00,0,3838.0,3845.0,1.002,19.378,161,134,99,35,27,11,16,0,0.0,0.0
1005,986,24-09-2019 20:30:00,0,4194.0,4195.0,1.0,21.167,83,59,29,30,24,8,16,1,0.0,0.0
1005,987,24-09-2019 20:32:00,0,4199.0,4192.0,0.998,21.186,100,73,32,41,27,14,13,0,0.0,0.0
1005,988,24-09-2019 20:34:00,0,4182.0,4261.0,1.019,21.192,3,3,0,3,0,0,0,0,0.0,0.0
1005,989,24-09-2019 20:36:00,0,4015.0,4001.0,0.997,20.249,3,2,0,2,1,1,0,0,0.0,0.0
1005,990,24-09-2019 20:38:00,0,4005.0,4022.5,1.0045,20.233,167,66,30,36,101,53,48,45,0.01,0.0
1005,991,24-09-2019 20:40:00,0,3995.0,4044.0,1.012,20.217,70,19,6,13,51,10,41,48,0.01,0.0
1005,992,24-09-2019 20:42:00,0,4211.0,4203.0,0.998,21.243,80,18,3,15,62,23,39,39,0.0,0.06
1005,993,24-09-2019 20:44:00,0,3968.0,4095.0,1.032,20.165,124,27,7,20,97,51,46,42,0.0,0.06
1005,994,24-09-2019 20:46:00,0,4387.0,4353.0,0.992,22.106,187,84,52,32,103,64,39,35,0.1,0.04
1005,995,24-09-2019 20:48:00,0,3474.0,3452.0,0.994,17.507,327,163,121,42,164,128,36,54,0.04,0.2
1005,996,24-09-2019 20:50:00,0,3547.0,3514.0,0.991,17.866,221,130,95,35,91,59,32,47,0.02,0.0
1005,997,24-09-2019 20:52:00,0,3553.0,3604.0,1.014,17.987,229,146,97,49,83,55,28,26,0.07,0.0
1005,998,24-09-2019 20:54:00,0,3989.0,4142.0,1.038,20.3,120,35,15,20,85,46,39,48,0.01,0.0
1005,999,24-09-2019 20:56:00,0,4516.0,4361.0,0.966,22.622,129,34,5,29,95,56,39,42,0.0,0.0
1005,1000,24-09-2019 20:58:00,0,4673.0,4576.0,0.979,23.478,153,14,3,11,139,85,54,22,0.01,0.0
1005,1001,24-09-2019 21:00:00,0,4855.0,4778.0,0.984,24.419,129,18,1,17,111,59,52,12,0.0,0.0
1005,1002,24-09-2019 21:02:00,0,4561.0,4486.0,0.983,22.936,115,12,5,7,103,59,44,37,0.0,0.0
1005,1003,24-09-2019 21:04:00,0,4954.0,4840.0,0.977,24.876,178,54,29,25,124,85,39,16,0.11,0.09
1005,1004,24-09-2019 21:06:00,0,4182.0,4192.0,1.002,21.117,300,134,108,26,166,119,47,41,0.0,0.0
1005,1005,24-09-2019 21:08:00,0,3543.0,3572.0,1.008,17.913,93,32,20,12,61,30,31,0,0.06,0.0
1005,1006,24-09-2019 21:10:00,0,3833.0,3749.0,0.978,19.254,68,26,13,13,42,20,22,0,0.0,0.0
1005,1007,24-09-2019 21:12:00,0,3750.0,3660.5,0.976,18.829,82,48,28,20,34,15,19,0,0.0,0.0
1005,1008,24-09-2019 21:14:00,0,3667.0,3572.0,0.974,18.404,7,4,1,3,3,3,0,0,0.0,0.0
1005,1009,24-09-2019 21:16:00,0,3824.0,3828.0,1.001,19.306,8,3,1,2,5,4,1,0,0.0,0.0
1005,1010,24-09-2019 21:18:00,0,4040.0,3943.0,0.976,20.282,6,2,1,1,4,2,2,0,0.0,0.0
1005,1011,24-09-2019 21:20:00,0,4013.0,4077.0,1.016,20.323,32,19,9,10,13,6,7,0,0.0,0.0
1005,1012,24-09-2019 21:22:00,0,4023.0,4012.0,0.997,20.294,23,10,1,9,13,5,8,0,0.0,0.0
1005,1013,24-09-2019 21:24:00,0,3843.0,3836.0,0.998,19.39,26,14,4,10,12,4,8,0,0.0,0.0
1005,1014,24-09-2019 21:26:00,0,3848.0,3728.0,0.969,19.287,27,6,1,5,21,3,18,0,0.0,0.0
1005,1015,24-09-2019 21:28:00,0,3762.0,3715.0,0.987,18.936,56,25,14,11,31,14,17,0,0.01,0.0
1005,1016,24-09-2019 21:30:00,0,3835.0,3888.0,1.014,19.412,1,0,0,0,1,1,0,0,0.0,0.0
1005,1017,24-09-2019 21:32:00,0,3821.0,3858.0,1.01,19.325,2,1,0,1,1,1,0,0,0.0,0.0
1005,1018,24-09-2019 21:34:00,0,3740.0,3699.0,0.989,18.832,27,17,10,7,10,4,6,0,0.0,0.0
1005,1019,24-09-2019 21:36:00,0,3873.0,3744.0,0.967,19.404,237,107,71,36,130,75,55,50,0.0,0.0
1005,1020,24-09-2019 21:38:00,0,3796.0,3917.0,1.032,19.29,138,68,36,32,70,46,24,17,0.0,0.0
1005,1021,24-09-2019 21:40:00,0,3533.0,3589.0,1.016,17.894,334,148,109,39,186,138,48,43,0.0,0.0
1005,1022,24-09-2019 21:42:00,0,3462.0,3434.0,0.992,17.441,244,115,82,33,129,83,46,40,0.0,0.0
1005,1023,24-09-2019 21:44:00,0,3832.0,3919.0,1.023,19.436,261,134,96,38,127,80,47,51,0.03,0.0
1005,1024,24-09-2019 21:46:00,0,3918.0,3983.5,1.017,19.8465,341,142,110,32,199,144,55,29,0.0,0.0
1005,1025,24-09-2019 21:48:00,0,4004.0,4048.0,1.011,20.257,201,81,51,30,120,70,50,66,0.04,0.0
1005,1026,24-09-2019 21:50:00,0,4477.0,4476.0,1.0,22.595,148,25,7,18,123,61,62,44,0.0,0.03
1005,1027,24-09-2019 21:52:00,0,4562.0,4581.0,1.004,23.047,117,33,11,22,84,27,57,34,0.0,0.04
1005,1028,24-09-2019 21:54:00,0,4680.0,4591.0,0.981,23.52,122,41,5,36,81,27,54,51,0.0,0.05
1005,1029,24-09-2019 21:56:00,0,4481.0,4485.0,1.001,22.622,115,32,15,17,83,37,46,35,0.0,0.08
1005,1030,24-09-2019 21:58:00,0,4488.0,4418.0,0.984,22.574,96,33,3,30,63,2,61,46,0.0,0.06
1005,1031,24-09-2019 22:00:00,0,4665.0,4582.0,0.982,23.452,120,52,17,35,68,26,42,21,0.09,0.14
1005,1032,24-09-2019 22:02:00,0,3470.0,3468.0,0.999,17.511,473,224,171,53,249,185,64,49,0.01,0.0
1005,1033,24-09-2019 22:04:00,0,3883.0,3724.0,0.959,19.421,393,187,144,43,206,151,55,23,0.09,0.0
1005,1034,24-09-2019 22:06:00,0,4090.0,4117.0,1.007,20.672,380,195,147,48,185,145,40,84,0.03,0.0
1005,1035,24-09-2019 22:08:00,0,3557.0,3552.0,0.998,17.947,80,42,23,19,38,22,16,0,0.0,0.0
1005,1036,24-09-2019 22:10:00,0,3976.0,4073.0,1.025,20.173,27,2,2,0,25,14,11,0,0.0,0.0
1005,1037,24-09-2019 22:12:00,0,3984.0,4095.0,1.028,20.229,9,4,4,0,5,3,2,0,0.0,0.0
1005,1038,24-09-2019 22:14:00,0,3990.0,4097.0,1.027,20.257,4,1,1,0,3,2,1,0,0.0,0.0
1005,1039,24-09-2019 22:16:00,0,4196.0,4234.0,1.009,21.219,46,18,12,6,28,17,11,0,0.0,0.0
1005,1040,24-09-2019 22:18:00,0,4087.0,4162.0,1.018,20.711,15,3,0,3,12,8,4,0,0.0,0.0
1005,1041,24-09-2019 22:20:00,0,3964.0,3967.0,1.0,20.011,12,4,0,4,8,7,1,0,0.0,0.0
1005,1042,24-09-2019 22:22:00,0,3841.0,3772.0,0.982,19.311,17,3,2,1,14,5,9,0,0.0,0.0
1005,1043,24-09-2019 22:24:00,0,3545.0,3597.0,1.015,17.95,3,1,0,1,2,1,1,0,0.0,0.0
1005,1044,24-09-2019 22:26:00,0,3552.0,3599.0,1.013,17.977,13,3,1,2,10,6,4,0,0.0,0.0
1005,1045,24-09-2019 22:28:00,0,3574.0,3491.0,0.977,17.947,63,29,13,16,34,25,9,0,0.01,0.0
1005,1046,24-09-2019 22:30:00,0,3585.0,3504.0,0.977,18.002,44,0,0,0,44,24,20,0,0.0,0.0
1005,1047,24-09-2019 22:32:00,0,3469.0,3476.0,1.002,17.516,17,0,0,0,17,2,15,0,0.0,0.0
1005,1048,24-09-2019 22:34:00,0,3406.0,3304.0,0.97,17.079,135,54,30,24,81,38,43,6,0.0,0.0
1005,1049,24-09-2019 22:36:00,0,3853.0,3779.0,0.981,19.364,78,22,10,12,56,10,46,59,0.0,0.0
1005,1050,24-09-2019 22:38:00,0,4286.0,4370.0,1.02,21.724,140,19,3,16,121,63,58,32,0.0,0.0
1005,1051,24-09-2019 22:40:00,0,4488.0,4432.0,0.988,22.587,128,28,4,24,100,44,56,36,0.0,0.28
1005,1052,24-09-2019 22:42:00,0,3842.0,3733.0,0.971,19.271,46,0,0,0,46,2,44,0,0.0,0.01
1005,1053,24-09-2019 22:44:00,0,3764.0,3650.0,0.97,18.871,42,0,0,0,42,2,40,0,0.0,0.01
1005,1054,24-09-2019 22:46:00,0,3853.0,3659.0,0.95,19.231,69,8,3,5,61,19,42,1,0.0,0.3
1005,1055,24-09-2019 22:48:00,0,4157.0,4276.0,1.029,21.11,352,127,96,31,225,164,61,44,0.08,0.03
1005,1056,24-09-2019 22:50:00,0,4030.0,3988.0,0.99,20.291,355,223,180,43,132,94,38,7,0.09,0.0
1005,1057,24-09-2019 22:52:00,0,3993.0,4062.0,1.017,20.227,476,216,160,56,260,193,67,11,0.0,0.0
1005,1058,24-09-2019 22:54:00,0,3919.5,3942.5,1.0055,19.8055,272,88,56,32,184,124,60,30,0.0,0.0
1005,1059,24-09-2019 22:56:00,0,3846.0,3823.0,0.994,19.384,462,213,165,48,249,197,52,99,0.02,0.0
1005,1060,24-09-2019 22:58:00,0,3915.0,4012.0,1.025,19.866,527,245,186,59,282,221,61,36,0.07,0.0
1005,1061,24-09-2019 23:00:00,0,4393.0,4377.0,0.996,22.152,172,82,48,34,90,55,35,17,0.0,0.0
1005,1062,24-09-2019 23:02:00,0,4377.0,4392.0,1.003,22.108,247,159,112,47,88,60,28,19,0.0,0.0
1005,1063,24-09-2019 23:04:00,0,4453.0,4586.0,1.03,22.62,268,142,106,36,126,100,26,33,0.06,0.0
1005,1064,24-09-2019 23:06:00,0,4453.0,4482.0,1.007,22.506,193,119,78,41,74,40,34,11,0.0,0.0
1005,1065,24-09-2019 23:08:00,0,4623.0,4663.0,1.009,23.375,223,125,87,38,98,64,34,61,0.0,0.0
1005,1066,24-09-2019 23:10:00,0,4204.0,4235.0,1.007,21.253,158,58,43,15,100,59,41,38,0.0,0.0
1005,1067,24-09-2019 23:12:00,0,4473.0,4380.0,0.979,22.473,163,74,46,28,89,48,41,26,0.0,0.0
1005,1068,24-09-2019 23:14:00,0,3835.0,3862.0,1.007,19.385,264,87,58,29,177,126,51,90,0.0,0.0
1005,1069,24-09-2019 23:16:00,0,4934.0,4920.0,0.997,24.887,238,83,55,28,155,110,45,39,0.0,0.0
1005,1070,24-09-2019 23:18:00,0,4458.0,4507.0,1.011,22.555,188,90,54,36,98,59,39,8,0.07,0.0
1005,1071,24-09-2019 23:20:00,0,3836.0,3913.0,1.02,19.444,20,12,5,7,8,3,5,0,0.01,0.0
1005,1072,24-09-2019 23:22:00,0,3976.0,4063.0,1.022,20.164,82,38,9,29,44,22,22,0,0.0,0.0
1005,1073,24-09-2019 23:24:00,0,4497.0,4403.0,0.979,22.592,80,52,22,30,28,8,20,0,0.0,0.0
1005,1074,24-09-2019 23:26:00,0,4400.0,4356.0,0.99,22.157,57,30,14,16,27,13,14,0,0.0,0.0
1005,1075,24-09-2019 23:28:00,0,4195.5,4230.5,1.009,21.2135,11,3,1,2,8,2,6,0,0.0,0.0
1005,1076,24-09-2019 23:30:00,0,3991.0,4105.0,1.028,20.27,3,3,0,3,0,0,0,0,0.0,0.0
1005,1077,24-09-2019 23:32:00,0,4001.0,4003.0,1.0,20.195,0,0,0,0,0,0,0,0,0.0,0.0
1005,1078,24-09-2019 23:34:00,0,3823.0,3904.0,1.021,19.385,57,18,7,11,39,19,20,0,0.0,0.0
1005,1079,24-09-2019 23:36:00,0,4013.0,3975.0,0.991,20.21,200,84,57,27,116,70,46,22,0.0,0.0
1005,1080,24-09-2019 23:38:00,0,4011.0,3998.0,0.997,20.229,303,132,97,35,171,130,41,80,0.0,0.0
1005,1081,24-09-2019 23:40:00,0,3801.0,3910.0,1.029,19.303,305,141,97,44,164,112,52,66,0.0,0.0
1005,1082,24-09-2019 23:42:00,0,3842.0,3862.0,1.005,19.413,317,131,94,37,186,140,46,33,0.08,0.0
1005,1083,24-09-2019 23:44:00,0,3845.0,3763.0,0.979,19.314,167,102,68,34,65,33,32,68,0.0,0.0
1005,1084,24-09-2019 23:46:00,0,4199.0,4207.0,1.002,21.203,123,78,45,33,45,5,40,53,0.0,0.0
1005,1085,24-09-2019 23:48:00,0,4186.0,4260.0,1.018,21.207,213,138,94,44,75,35,40,56,0.01,0.0
1005,1086,24-09-2019 23:50:00,0,4271.0,4286.0,1.003,21.573,173,128,89,39,45,0,45,66,0.0,0.0
1005,1087,24-09-2019 23:52:00,0,4390.0,4346.0,0.99,22.108,180,117,69,48,63,18,45,61,0.0,0.0
1005,1088,24-09-2019 23:54:00,0,4085.0,4238.0,1.037,20.788,415,248,189,59,167,129,38,45,0.0,0.0
1005,1089,24-09-2019 23:56:00,0,4000.0,4113.0,1.028,20.312,133,59,31,28,74,47,27,2,0.08,0.0
1005,1090,24-09-2019 23:58:00,0,4019.0,4071.0,1.013,20.341,18,6,2,4,12,7,5,0,0.0,0.0
1005,1091,25-09-2019 00:00:00,0,4100.0,4173.0,1.018,20.774,2,0,0,0,2,1,1,0,0.0,0.0
1005,1092,25-09-2019 00:02:00,0,4012.0,4064.0,1.013,20.3055,1,0,0,0,1,0,1,0,0.0,0.0
1005,1093,25-09-2019 00:04:00,0,3924.0,3955.0,1.008,19.837,7,5,3,2,2,1,1,0,0.0,0.0
1005,1094,25-09-2019 00:06:00,0,3742.0,3708.0,0.991,18.847,46,42,27,15,4,1,3,0,0.0,0.0
1005,1095,25-09-2019 00:08:00,0,3348.0,3441.0,1.028,17.002,18,12,7,5,6,3,3,0,0.0,0.0
1005,1096,25-09-2019 00:10:00,0,3292.0,3239.0,0.984,16.556,17,3,2,1,14,6,8,0,0.0,0.0
1005,1097,25-09-2019 00:12:00,0,3184.0,3216.0,1.01,16.104,3,0,0,0,3,0,3,0,0.0,0.0
1005,1098,25-09-2019 00:14:00,0,3188.0,3202.0,1.004,16.104,40,1,1,0,39,26,13,0,0.02,0.0
1005,1099,25-09-2019 00:16:00,0,3393.0,3302.0,0.973,17.023,188,101,55,46,87,48,39,17,0.0,0.0
1005,1100,25-09-2019 00:18:00,0,3552.0,3634.0,1.023,18.019,341,188,136,52,153,102,51,69,0.0,0.0
1005,1101,25-09-2019 00:20:00,0,3857.0,3780.0,0.98,19.381,259,95,62,33,164,116,48,40,0.0,0.0
1005,1102,25-09-2019 00:22:00,0,3824.0,3835.0,1.003,19.312,104,63,32,31,41,3,38,41,0.0,0.0
1005,1103,25-09-2019 00:24:00,0,3931.0,3964.0,1.008,19.876,92,47,27,20,45,15,30,38,0.0,0.0
1005,1104,25-09-2019 00:26:00,0,4030.0,3991.0,0.99,20.297,315,139,94,45,176,126,50,35,0.0,0.0
1005,1105,25-09-2019 00:28:00,0,3358.0,3421.0,1.019,17.02,240,139,101,38,101,67,34,29,0.0,0.0
1005,1106,25-09-2019 00:30:00,0,3815.0,3914.0,1.026,19.363,199,84,53,31,115,80,35,3,0.0,0.0
1005,1107,25-09-2019 00:32:00,0,3832.0,3897.0,1.017,19.41,84,53,27,26,31,19,12,0,0.0,0.0
1005,1108,25-09-2019 00:34:00,0,4022.0,4034.0,1.003,20.312,135,96,59,37,39,16,23,29,0.0,0.0
1005,1109,25-09-2019 00:36:00,0,4252.0,4228.0,0.995,21.433,98,59,24,35,39,1,38,44,0.0,0.0
1005,1110,25-09-2019 00:38:00,0,4482.0,4422.0,0.987,22.554,105,50,30,20,55,26,29,56,0.0,0.0
1005,1111,25-09-2019 00:40:00,0,4497.0,4393.0,0.977,22.58,168,35,15,20,133,74,59,48,0.0,0.0
1005,1112,25-09-2019 00:42:00,0,4652.0,4584.0,0.985,23.405,74,6,0,6,68,32,36,36,0.0,0.0
1005,1113,25-09-2019 00:44:00,0,4468.0,4500.0,1.007,22.585,69,23,1,22,46,23,23,28,0.0,0.04
1005,1114,25-09-2019 00:46:00,0,4689.0,4568.0,0.974,23.533,105,36,0,36,69,40,29,20,0.01,0.03
1005,1115,25-09-2019 00:48:00,0,4458.0,4480.0,1.005,22.523,173,79,44,35,94,60,34,24,0.12,0.08
1005,1116,25-09-2019 00:50:00,0,3365.0,3385.0,1.006,17.004,366,191,137,54,175,128,47,31,0.04,0.0
1005,1117,25-09-2019 00:52:00,0,3188.0,3157.0,0.99,16.054,142,73,53,20,69,37,32,3,0.0,0.0
1005,1118,25-09-2019 00:54:00,0,3824.0,3850.0,1.007,19.329,471,329,270,59,142,114,28,5,0.0,0.0
1005,1119,25-09-2019 00:56:00,0,2914.0,2890.0,0.992,14.681,304,155,126,29,149,108,41,8,0.01,0.0
1005,1120,25-09-2019 00:58:00,0,3568.0,3511.0,0.984,17.945,154,98,79,19,56,41,15,16,0.01,0.0
1005,1121,25-09-2019 01:00:00,0,4383.0,4372.0,0.997,22.11,353,175,127,48,178,133,45,99,0.09,0.0
1005,1122,25-09-2019 01:02:00,0,3979.0,4077.0,1.025,20.191,318,159,103,56,159,112,47,85,0.0,0.0
1005,1123,25-09-2019 01:04:00,0,3818.0,3915.0,1.026,19.376,297,135,101,34,162,121,41,108,0.0,0.0
1005,1124,25-09-2019 01:06:00,0,4186.0,4219.0,1.008,21.164,64,16,5,11,48,32,16,70,0.0,0.0
1005,1125,25-09-2019 01:08:00,0,4922.0,4976.0,1.011,24.902,61,5,2,3,56,16,40,22,0.0,0.0
1005,1126,25-09-2019 01:10:00,0,5012.0,5008.5,0.9995,25.291,85,8,0,8,77,25,52,37,0.01,0.0
1005,1127,25-09-2019 01:12:00,0,5102.0,5041.0,0.988,25.68,117,6,0,6,111,56,55,43,0.0,0.0
1005,1128,25-09-2019 01:14:00,0,4650.0,4716.0,1.014,23.543,303,157,109,48,146,100,46,17,0.09,0.09
1005,1129,25-09-2019 01:16:00,0,3868.0,3719.0,0.962,19.357,204,91,65,26,113,70,43,2,0.0,0.0
1005,1130,25-09-2019 01:18:00,0,4041.0,3972.0,0.983,20.317,405,263,215,48,142,102,40,0,0.0,0.0
1005,1131,25-09-2019 01:20:00,0,4108.0,4169.0,1.015,20.802,438,300,245,55,138,98,40,16,0.0,0.04
1005,1132,25-09-2019 01:22:00,0,4114.0,4134.0,1.005,20.784,683,376,309,67,307,239,68,6,0.0,0.0
1005,1133,25-09-2019 01:24:00,0,4492.0,4411.0,0.982,22.583,338,238,190,48,100,70,30,3,0.0,0.0
1005,1134,25-09-2019 01:26:00,0,4572.0,4590.0,1.004,23.095,210,110,69,41,100,65,35,15,0.0,0.0
1005,1135,25-09-2019 01:28:00,0,4482.0,4452.0,0.993,22.589,190,94,47,47,96,55,41,1,0.0,0.0
1005,1136,25-09-2019 01:30:00,0,4644.0,4634.0,0.998,23.426,75,42,21,21,33,13,20,0,0.0,0.0
1005,1137,25-09-2019 01:32:00,0,4481.0,4444.0,0.992,22.575,50,25,4,21,25,7,18,0,0.0,0.0
1005,1138,25-09-2019 01:34:00,0,4479.0,4361.0,0.974,22.475,70,37,13,24,33,3,30,0,0.0,0.0
1005,1139,25-09-2019 01:36:00,0,4490.0,4431.0,0.987,22.596,109,83,41,42,26,13,13,0,0.0,0.0
1005,1140,25-09-2019 01:38:00,0,4100.0,4125.0,1.006,20.721,63,44,12,32,19,5,14,0,0.0,0.0
1005,1141,25-09-2019 01:40:00,0,4172.0,4227.0,1.013,21.118,108,59,20,39,49,24,25,0,0.0,0.0
1005,1142,25-09-2019 01:42:00,0,4002.0,4047.0,1.011,20.246,42,21,2,19,21,11,10,0,0.0,0.0
1005,1143,25-09-2019 01:44:00,0,3928.5,3871.5,0.985,19.764,0,0,0,0,0,0,0,0,0.0,0.0
1005,1144,25-09-2019 01:46:00,0,3855.0,3696.0,0.959,19.282,0,0,0,0,0,0,0,0,0.0,0.0
1005,1145,25-09-2019 01:48:00,0,3542.0,3555.0,1.004,17.891,42,25,11,14,17,10,7,0,0.0,0.0
1005,1146,25-09-2019 01:50:00,0,3558.0,3552.0,0.998,17.951,0,0,0,0,0,0,0,0,0.0,0.0
1005,1147,25-09-2019 01:52:00,0,3477.0,3461.0,0.995,17.532,11,7,4,3,4,1,3,0,0.0,0.0
1005,1148,25-09-2019 01:54:00,0,3344.0,3436.0,1.027,16.977,7,1,0,1,6,2,4,0,0.0,0.0
1005,1149,25-09-2019 01:56:00,0,3406.0,3335.0,0.979,17.113,2,2,1,1,0,0,0,0,0.0,0.0
1005,1150,25-09-2019 01:58:00,0,3090.0,3187.0,1.031,15.703,0,0,0,0,0,0,0,0,0.0,0.0
1005,1151,25-09-2019 02:00:00,0,3097.0,3120.0,1.007,15.658,0,0,0,0,0,0,0,0,0.0,0.0
1005,1152,25-09-2019 02:02:00,0,3129.0,3045.0,0.973,15.698,69,41,26,15,28,17,11,0,0.0,0.0
1005,1153,25-09-2019 02:04:00,0,3273.0,3252.0,0.994,16.496,233,122,91,31,111,72,39,89,0.0,0.0
1005,1154,25-09-2019 02:06:00,0,3375.0,3406.0,1.009,17.068,312,136,91,45,176,112,64,31,0.0,0.0
1005,1155,25-09-2019 02:08:00,0,3367.0,3484.0,1.035,17.124,362,194,153,41,168,125,43,62,0.0,0.0
1005,1156,25-09-2019 02:10:00,0,3367.0,3360.0,0.998,16.985,517,270,209,61,247,163,84,16,0.01,0.0
1005,1157,25-09-2019 02:12:00,0,3470.0,3493.0,1.007,17.538,267,147,109,38,120,77,43,22,0.0,0.0
1005,1158,25-09-2019 02:14:00,0,3846.0,3761.0,0.978,19.316,302,109,82,27,193,140,53,76,0.0,0.0
1005,1159,25-09-2019 02:16:00,0,3577.0,3479.0,0.973,17.946,84,42,24,18,42,29,13,0,0.0,0.0
1005,1160,25-09-2019 02:18:00,0,3561.5,3534.0,0.9925,17.9455,137,68,30,38,69,41,28,0,0.0,0.0
1005,1161,25-09-2019 02:20:00,0,3546.0,3589.0,1.012,17.945,73,52,26,26,21,4,17,0,0.0,0.0
1005,1162,25-09-2019 02:22:00,0,3547.0,3612.0,1.018,17.975,115,48,19,29,67,24,43,0,0.0,0.0
1005,1163,25-09-2019 02:24:00,0,3647.0,3650.0,1.001,18.412,78,41,12,29,37,20,17,0,0.0,0.0
1005,1164,25-09-2019 02:26:00,0,3558.0,3546.0,0.997,17.942,6,4,2,2,2,0,2,0,0.0,0.0
1005,1165,25-09-2019 02:28:00,0,3388.0,3377.0,0.997,17.085,0,0,0,0,0,0,0,0,0.0,0.0
1005,1166,25-09-2019 02:30:00,0,3392.0,3263.0,0.962,16.978,30,20,12,8,10,4,6,0,0.0,0.0
1005,1167,25-09-2019 02:32:00,0,3401.0,3287.0,0.966,17.039,1,0,0,0,1,0,1,0,0.0,0.0
1005,1168,25-09-2019 02:34:00,0,3190.0,3217.0,1.009,16.131,4,3,0,3,1,0,1,0,0.0,0.0
1005,1169,25-09-2019 02:36:00,0,3084.0,3146.0,1.02,15.632,12,7,1,6,5,1,4,0,0.0,0.0
1005,1170,25-09-2019 02:38:00,0,3133.0,2994.0,0.956,15.659,31,16,6,10,15,8,7,0,0.0,0.0
1005,1171,25-09-2019 02:40:00,0,3082.0,3169.0,1.028,15.65,19,2,2,0,17,2,15,0,0.0,0.0
1005,1172,25-09-2019 02:42:00,0,3299.0,3262.0,0.989,16.612,0,0,0,0,0,0,0,0,0.0,0.0
1005,1173,25-09-2019 02:44:00,0,3179.0,3296.0,1.037,16.173,2,0,0,0,2,1,1,0,0.0,0.0
1005,1174,25-09-2019 02:46:00,0,2907.0,2945.0,1.013,14.714,0,0,0,0,0,0,0,0,0.0,0.0
1005,1175,25-09-2019 02:48:00,0,2947.0,2857.0,0.969,14.774,52,36,18,18,16,7,9,0,0.0,0.0
1005,1176,25-09-2019 02:50:00,0,3096.0,3169.0,1.024,15.705,120,54,28,26,66,29,37,0,0.0,0.0
1005,1177,25-09-2019 02:52:00,0,3097.5,3138.0,1.013,15.6775,8,1,0,1,7,0,7,0,0.0,0.0
1005,1178,25-09-2019 02:54:00,0,3099.0,3107.0,1.002,15.65,0,0,0,0,0,0,0,0,0.0,0.0
1005,1179,25-09-2019 02:56:00,0,3124.0,3060.0,0.979,15.695,10,3,1,2,7,1,6,0,0.0,0.0
1005,1180,25-09-2019 02:58:00,0,2901.0,2967.0,1.023,14.715,13,3,0,3,10,3,7,0,0.0,0.0
1005,1181,25-09-2019 03:00:00,0,2923.0,2957.0,1.012,14.791,9,0,0,0,9,4,5,0,0.0,0.0
1005,1182,25-09-2019 03:02:00,0,2888.0,2995.0,1.037,14.692,74,44,31,13,30,18,12,4,0.0,0.0
1005,1183,25-09-2019 03:04:00,0,3090.0,3109.0,1.006,15.617,137,63,33,30,74,41,33,0,0.0,0.0
1005,1184,25-09-2019 03:06:00,0,3079.0,3147.0,1.022,15.615,148,32,8,24,116,85,31,0,0.0,0.0
1005,1185,25-09-2019 03:08:00,0,3366.0,3371.0,1.001,16.994,249,140,95,45,109,67,42,15,0.0,0.0
1005,1186,25-09-2019 03:10:00,0,3163.0,3266.0,1.033,16.08,130,32,21,11,98,50,48,49,0.0,0.0
1005,1187,25-09-2019 03:12:00,0,3737.0,3697.0,0.989,18.816,98,32,10,22,66,15,51,50,0.0,0.0
1005,1188,25-09-2019 03:14:00,0,3857.0,3752.0,0.973,19.352,62,16,5,11,46,13,33,64,0.0,0.0
1005,1189,25-09-2019 03:16:00,0,3863.0,3729.0,0.965,19.35,69,26,21,5,43,15,28,35,0.0,0.05
1005,1190,25-09-2019 03:18:00,0,3814.0,3866.0,1.014,19.308,106,34,19,15,72,37,35,45,0.0,0.0
1005,1191,25-09-2019 03:20:00,0,3828.0,3862.0,1.009,19.358,224,81,54,27,143,86,57,54,0.0,0.08
1005,1192,25-09-2019 03:22:00,0,3658.0,3608.0,0.986,18.407,61,11,7,4,50,8,42,56,0.0,0.0
1005,1193,25-09-2019 03:24:00,0,4284.0,4318.0,1.008,21.659,38,1,1,0,37,0,37,49,0.0,0.03
1005,1194,25-09-2019 03:26:00,0,4049.5,4067.5,1.004,20.4585,125,40,28,12,85,43,42,17,0.12,0.08
1005,1195,25-09-2019 03:28:00,0,3815.0,3817.0,1.0,19.258,290,144,114,30,146,107,39,39,0.1,0.0
1005,1196,25-09-2019 03:30:00,0,3535.0,3646.0,1.031,17.964,439,198,159,39,241,188,53,39,0.02,0.0
1005,1197,25-09-2019 03:32:00,0,4193.0,4234.0,1.01,21.206,36,11,10,1,25,18,7,49,0.0,0.0
1005,1198,25-09-2019 03:34:00,0,4682.0,4564.0,0.975,23.501,1,0,0,0,1,1,0,43,0.0,0.03
1005,1199,25-09-2019 03:36:00,0,4475.0,4505.0,1.007,22.62,0,0,0,0,0,0,0,46,0.0,0.05
1005,1200,25-09-2019 03:38:00,0,4680.0,4511.0,0.964,23.433,201,102,75,27,99,69,30,57,0.09,0.03
1005,1201,25-09-2019 03:40:00,0,3215.0,3141.0,0.977,16.143,50,42,12,30,8,1,7,0,0.0,0.0
1005,1202,25-09-2019 03:42:00,0,3392.0,3331.0,0.982,17.052,82,48,17,31,34,9,25,0,0.0,0.01
1005,1203,25-09-2019 03:44:00,0,3678.0,3604.0,0.98,18.482,26,18,6,12,8,1,7,0,0.0,0.0
1005,1204,25-09-2019 03:46:00,0,4283.0,4317.0,1.008,21.655,60,40,14,26,20,5,15,0,0.0,0.0
1005,1205,25-09-2019 03:48:00,0,3989.0,4132.0,1.036,20.292,11,7,0,7,4,0,4,0,0.0,0.0
1005,1206,25-09-2019 03:50:00,0,4027.0,3959.0,0.983,20.251,8,3,1,2,5,1,4,0,0.0,0.0
1005,1207,25-09-2019 03:52:00,0,3849.0,3807.0,0.989,19.38,41,10,7,3,31,2,29,0,0.0,0.0
1005,1208,25-09-2019 03:54:00,0,4054.0,3944.0,0.973,20.34,5,0,0,0,5,0,5,0,0.01,0.0
1005,1209,25-09-2019 03:56:00,0,3827.0,3871.0,1.012,19.363,7,0,0,0,7,0,7,0,0.0,0.0
1005,1210,25-09-2019 03:58:00,0,3857.0,3790.0,0.982,19.394,27,2,1,1,25,0,25,0,0.0,0.0
1005,1211,25-09-2019 04:00:00,0,3705.0,3662.5,0.9885,18.6535,66,29,16,13,37,21,16,0,0.0,0.0
1005,1212,25-09-2019 04:02:00,0,3553.0,3535.0,0.995,17.913,5,0,0,0,5,1,4,0,0.0,0.0
1005,1213,25-09-2019 04:04:00,0,3374.0,3390.0,1.004,17.047,7,0,0,0,7,2,5,0,0.0,0.0
1005,1214,25-09-2019 04:06:00,0,3385.0,3303.0,0.976,16.995,6,1,0,1,5,0,5,0,0.0,0.0
1005,1215,25-09-2019 04:08:00,0,3396.0,3230.0,0.951,16.955,34,24,6,18,10,5,5,0,0.0,0.0
1005,1216,25-09-2019 04:10:00,0,3389.0,3298.0,0.973,17.002,5,0,0,0,5,1,4,0,0.0,0.0
1005,1217,25-09-2019 04:12:00,0,3283.0,3240.0,0.987,16.524,9,2,0,2,7,1,6,0,0.0,0.0
1005,1218,25-09-2019 04:14:00,0,3399.0,3270.0,0.962,17.013,2,2,0,2,0,0,0,0,0.0,0.0
1005,1219,25-09-2019 04:16:00,0,3375.0,3353.0,0.994,17.01,2,1,0,1,1,0,1,0,0.0,0.0
1005,1220,25-09-2019 04:18:00,0,3371.0,3382.0,1.003,17.025,2,0,0,0,2,1,1,0,0.0,0.0
1005,1221,25-09-2019 04:20:00,0,3384.0,3407.0,1.007,17.105,0,0,0,0,0,0,0,0,0.0,0.0
1005,1222,25-09-2019 04:22:00,0,3376.0,3385.0,1.003,17.049,0,0,0,0,0,0,0,0,0.0,0.0
1005,1223,25-09-2019 04:24:00,0,3394.0,3323.0,0.979,17.049,1,0,0,0,1,0,1,0,0.0,0.0
1005,1224,25-09-2019 04:26:00,0,3406.0,3299.0,0.969,17.071,14,1,1,0,13,7,6,0,0.0,0.0
1005,1225,25-09-2019 04:28:00,0,3100.0,3171.0,1.023,15.722,0,0,0,0,0,0,0,0,0.0,0.0
1005,1226,25-09-2019 04:30:00,0,3121.0,3057.0,0.979,15.68,22,10,1,9,12,0,12,0,0.0,0.0
1005,1227,25-09-2019 04:32:00,0,3100.0,3130.0,1.01,15.68,19,6,0,6,13,0,13,0,0.0,0.0
1005,1228,25-09-2019 04:34:00,0,3113.5,3084.5,0.991,15.6825,12,3,1,2,9,1,8,0,0.01,0.01
1005,1229,25-09-2019 04:36:00,0,3127.0,3039.0,0.972,15.685,3,2,1,1,1,0,1,0,0.0,0.0
1005,1230,25-09-2019 04:38:00,0,2924.0,2935.0,1.004,14.77,151,73,38,35,78,36,42,0,0.0,0.0
1005,1231,25-09-2019 04:40:00,0,3074.0,3162.0,1.029,15.611,329,113,70,43,216,162,54,22,0.0,0.05
1005,1232,25-09-2019 04:42:00,0,3099.0,3132.0,1.011,15.676,209,132,89,43,77,46,31,11,0.0,0.0
1005,1233,25-09-2019 04:44:00,0,3099.0,3145.0,1.015,15.693,52,28,10,18,24,6,18,0,0.0,0.0
1005,1234,25-09-2019 04:46:00,0,3415.0,3258.0,0.954,17.06,60,30,11,19,30,5,25,0,0.0,0.0
1005,1235,25-09-2019 04:48:00,0,3395.0,3339.0,0.983,17.073,59,24,10,14,35,22,13,0,0.0,0.0
1005,1236,25-09-2019 04:50:00,0,3372.0,3393.0,1.006,17.044,10,2,1,1,8,3,5,0,0.0,0.0
1005,1237,25-09-2019 04:52:00,0,3315.0,3215.0,0.97,16.62,0,0,0,0,0,0,0,0,0.0,0.0
1005,1238,25-09-2019 04:54:00,0,3196.0,3190.0,0.998,16.123,8,4,1,3,4,0,4,0,0.0,0.0
1005,1239,25-09-2019 04:56:00,0,3198.0,3202.0,1.001,16.144,14,7,2,5,7,2,5,0,0.0,0.0
1005,1240,25-09-2019 04:58:00,0,3179.0,3213.0,1.011,16.081,8,6,2,4,2,1,1,0,0.0,0.0
1005,1241,25-09-2019 05:00:00,0,3111.0,3088.0,0.993,15.676,3,0,0,0,3,1,2,0,0.0,0.0
1005,1242,25-09-2019 05:02:00,0,3131.0,2986.0,0.954,15.641,144,87,50,37,57,33,24,38,0.0,0.0
1005,1243,25-09-2019 05:04:00,0,3377.0,3398.0,1.006,17.066,58,23,8,15,35,1,34,38,0.0,0.0
1005,1244,25-09-2019 05:06:00,0,3542.0,3626.0,1.024,17.971,48,23,9,14,25,0,25,40,0.0,0.0
1005,1245,25-09-2019 05:08:00,0,3734.5,3772.0,1.011,18.89,76,58,24,34,18,1,17,52,0.0,0.06
1005,1246,25-09-2019 05:10:00,0,3927.0,3918.0,0.998,19.809,62,45,22,23,17,0,17,60,0.0,0.08
1005,1247,25-09-2019 05:12:00,0,4032.0,3986.0,0.989,20.298,91,49,23,26,42,3,39,49,0.0,0.0
1005,1248,25-09-2019 05:14:00,0,3996.0,4067.0,1.018,20.246,156,67,39,28,89,48,41,60,0.09,0.09
1005,1249,25-09-2019 05:16:00,0,3353.0,3432.0,1.024,17.009,474,246,199,47,228,171,57,17,0.0,0.08
1005,1250,25-09-2019 05:18:00,0,4021.0,3995.0,0.993,20.267,556,303,237,66,253,198,55,7,0.1,0.0
1005,1251,25-09-2019 05:20:00,0,3645.0,3630.0,0.996,18.38,414,153,119,34,261,202,59,50,0.01,0.0
1005,1252,25-09-2019 05:22:00,0,4013.0,4037.0,1.006,20.282,66,47,26,21,19,4,15,55,0.0,0.0
1005,1253,25-09-2019 05:24:00,0,4486.0,4503.0,1.004,22.659,29,6,3,3,23,13,10,60,0.0,0.03
1005,1254,25-09-2019 05:26:00,0,4486.0,4362.0,0.973,22.503,46,23,12,11,23,9,14,18,0.0,0.31
1005,1255,25-09-2019 05:28:00,0,4025.0,4011.0,0.996,20.3,5,5,1,4,0,0,0,0,0.0,0.0
1005,1256,25-09-2019 05:30:00,0,4015.0,3979.0,0.991,20.224,128,93,62,31,35,22,13,0,0.0,0.0
1005,1257,25-09-2019 05:32:00,0,4296.0,4231.0,0.985,21.61,208,133,103,30,75,45,30,4,0.09,0.04
1005,1258,25-09-2019 05:34:00,0,4197.0,4191.0,0.999,21.175,320,185,136,49,135,90,45,13,0.02,0.0
1005,1259,25-09-2019 05:36:00,0,3391.0,3238.0,0.955,16.945,270,95,64,31,175,121,54,32,0.0,0.0
1005,1260,25-09-2019 05:38:00,0,4498.0,4334.0,0.964,22.519,153,78,62,16,75,58,17,15,0.0,0.0
1005,1261,25-09-2019 05:40:00,0,4882.0,4990.0,1.022,24.759,339,177,131,46,162,127,35,107,0.11,0.0
1005,1262,25-09-2019 05:42:00,0,4333.0,4306.0,0.9895,21.8385,339,151,114,37,188,127,61,58,0.01,0.0
1005,1263,25-09-2019 05:44:00,0,3784.0,3622.0,0.957,18.918,291,165,118,47,126,80,46,2,0.0,0.0
1005,1264,25-09-2019 05:46:00,0,4492.0,4407.0,0.981,22.575,482,277,216,61,205,138,67,0,0.0,0.0
1005,1265,25-09-2019 05:48:00,0,4305.0,4284.0,0.995,21.704,306,225,182,43,81,54,27,0,0.0,0.0
1005,1266,25-09-2019 05:50:00,0,4278.0,4249.0,0.993,21.559,515,327,264,63,188,134,54,8,0.0,0.06
1005,1267,25-09-2019 05:52:00,0,3994.0,4013.0,1.005,20.178,227,115,89,26,112,76,36,13,0.0,0.0
1005,1268,25-09-2019 05:54:00,0,4413.0,4319.0,0.979,22.168,286,145,97,48,141,100,41,7,0.05,0.0
1005,1269,25-09-2019 05:56:00,0,4162.0,4255.0,1.022,21.107,217,90,57,33,127,91,36,3,0.0,0.0
1005,1270,25-09-2019 05:58:00,0,4195.0,4189.0,0.999,21.167,34,14,3,11,20,5,15,0,0.0,0.0
1005,1271,25-09-2019 06:00:00,1,4503.0,4307.0,0.956,22.509,162,56,40,16,106,75,31,29,0.0,0.0
1005,1272,25-09-2019 06:02:00,1,4494.0,4309.0,0.959,22.477,238,109,77,32,129,91,38,123,0.0,0.04
1005,1273,25-09-2019 06:04:00,1,4483.0,4411.0,0.984,22.545,160,90,54,36,70,48,22,10,0.01,0.0
1005,1274,25-09-2019 06:06:00,1,4215.0,4132.0,0.98,21.182,134,9,3,6,125,82,43,0,0.0,0.0
1005,1275,25-09-2019 06:08:00,1,4219.0,4117.0,0.976,21.179,55,30,14,16,25,8,17,0,0.0,0.0
1005,1276,25-09-2019 06:10:00,1,4306.0,4237.0,0.984,21.656,90,45,24,21,45,16,29,0,0.0,0.0
1005,1277,25-09-2019 06:12:00,1,4013.0,4033.0,1.005,20.277,24,9,3,6,15,5,10,0,0.0,0.0
1005,1278,25-09-2019 06:14:00,1,4005.0,3995.0,0.998,20.201,8,5,2,3,3,1,2,0,0.0,0.0
1005,1279,25-09-2019 06:16:00,1,3786.5,3767.5,0.995,19.09,5,1,0,1,4,2,2,0,0.0,0.0
1005,1280,25-09-2019 06:18:00,1,3568.0,3540.0,0.992,17.979,7,0,0,0,7,0,7,0,0.0,0.0
1005,1281,25-09-2019 06:20:00,1,3599.0,3417.0,0.949,17.962,3,1,0,1,2,0,2,0,0.0,0.0
1005,1282,25-09-2019 06:22:00,1,3376.0,3390.0,1.004,17.054,1,0,0,0,1,0,1,0,0.0,0.0
1005,1283,25-09-2019 06:24:00,1,3368.0,3365.0,0.999,16.997,0,0,0,0,0,0,0,0,0.0,0.0
1005,1284,25-09-2019 06:26:00,1,3318.0,3199.0,0.964,16.613,0,0,0,0,0,0,0,0,0.0,0.0
1005,1285,25-09-2019 06:28:00,1,3106.0,3103.0,0.999,15.671,5,1,0,1,4,1,3,0,0.0,0.0
1005,1286,25-09-2019 06:30:00,1,3074.0,3126.0,1.017,15.57,1,1,0,1,0,0,0,0,0.0,0.0
1005,1287,25-09-2019 06:32:00,1,3100.0,3088.0,0.996,15.631,0,0,0,0,0,0,0,0,0.0,0.0
1005,1288,25-09-2019 06:34:00,1,3109.0,3133.0,1.008,15.719,14,7,2,5,7,4,3,0,0.0,0.0
1005,1289,25-09-2019 06:36:00,1,3387.0,3378.0,0.997,17.082,11,7,6,1,4,2,2,0,0.0,0.0
1005,1290,25-09-2019 06:38:00,1,3380.0,3401.0,1.006,17.081,11,0,0,0,11,1,10,0,0.0,0.0
1005,1291,25-09-2019 06:40:00,1,3370.0,3348.0,0.994,16.983,7,4,1,3,3,0,3,0,0.0,0.0
1005,1292,25-09-2019 06:42:00,1,3391.0,3256.0,0.96,16.963,14,1,0,1,13,7,6,0,0.0,0.0
1005,1293,25-09-2019 06:44:00,1,3416.0,3283.0,0.961,17.095,7,0,0,0,7,3,4,0,0.0,0.0
1005,1294,25-09-2019 06:46:00,1,3094.0,3174.0,1.026,15.705,15,0,0,0,15,6,9,0,0.0,0.0
1005,1295,25-09-2019 06:48:00,1,3092.0,3087.0,0.998,15.599,16,3,1,2,13,3,10,0,0.0,0.0
1005,1296,25-09-2019 06:50:00,1,3112.0,3025.0,0.972,15.61,2,1,1,0,1,0,1,0,0.0,0.0
1005,1297,25-09-2019 06:52:00,1,3132.0,2963.0,0.946,15.621,225,137,92,45,88,56,32,13,0.01,0.0
1005,1298,25-09-2019 06:54:00,1,3076.0,3155.0,1.025,15.613,75,57,27,30,18,6,12,0,0.01,0.0
1005,1299,25-09-2019 06:56:00,1,3379.0,3337.0,0.987,17.008,51,32,10,22,19,7,12,0,0.0,0.0
1005,1300,25-09-2019 06:58:00,1,3379.0,3383.0,1.001,17.057,134,61,36,25,73,40,33,11,0.0,0.0
1005,1301,25-09-2019 07:00:00,1,3376.0,3375.0,1.0,17.04,195,113,89,24,82,60,22,2,0.0,0.0
1005,1302,25-09-2019 07:02:00,1,3647.0,3607.0,0.989,18.363,189,111,88,23,78,58,20,16,0.0,0.0
1005,1303,25-09-2019 07:04:00,1,3527.0,3616.0,1.025,17.898,179,89,68,21,90,55,35,45,0.0,0.0
1005,1304,25-09-2019 07:06:00,1,3575.0,3584.0,1.003,18.052,107,58,35,23,49,33,16,20,0.0,0.0
1005,1305,25-09-2019 07:08:00,1,3586.0,3463.0,0.966,17.962,480,325,251,74,155,101,54,0,0.0,0.0
1005,1306,25-09-2019 07:10:00,1,3375.0,3354.0,0.994,17.01,363,212,171,41,151,98,53,4,0.09,0.0
1005,1307,25-09-2019 07:12:00,1,3555.0,3585.0,1.009,17.975,275,123,93,30,152,111,41,90,0.01,0.0
1005,1308,25-09-2019 07:14:00,1,3554.0,3542.0,0.997,17.926,264,137,99,38,127,85,42,57,0.0,0.0
1005,1309,25-09-2019 07:16:00,1,3572.0,3479.0,0.974,17.924,233,112,74,38,121,78,43,0,0.0,0.0
1005,1310,25-09-2019 07:18:00,1,3580.0,3445.0,0.962,17.92,137,52,30,22,85,44,41,0,0.0,0.0
1005,1311,25-09-2019 07:20:00,1,3605.0,3421.0,0.949,17.989,193,115,82,33,78,43,35,6,0.0,0.0
1005,1312,25-09-2019 07:22:00,1,3591.0,3453.0,0.962,17.97,80,27,14,13,53,14,39,0,0.0,0.0
1005,1313,25-09-2019 07:24:00,1,3591.0,3421.0,0.953,17.936,39,28,0,28,11,1,10,0,0.0,0.0
1005,1314,25-09-2019 07:26:00,1,3591.0,3389.0,0.944,17.902,63,34,15,19,29,13,16,0,0.0,0.0
1005,1315,25-09-2019 07:28:00,1,3590.0,3448.0,0.961,17.961,21,21,1,20,0,0,0,0,0.0,0.0
1005,1316,25-09-2019 07:30:00,1,3412.0,3241.0,0.95,17.031,4,2,0,2,2,2,0,0,0.0,0.0
1005,1317,25-09-2019 07:32:00,1,3110.0,3053.0,0.982,15.635,4,1,0,1,3,0,3,0,0.0,0.0
1005,1318,25-09-2019 07:34:00,1,3039.0,2863.0,0.942,15.143,1,1,0,1,0,0,0,0,0.0,0.0
1005,1319,25-09-2019 07:36:00,1,2963.0,2771.0,0.935,14.741,16,10,2,8,6,0,6,0,0.0,0.0
1005,1320,25-09-2019 07:38:00,1,2987.0,2698.0,0.903,14.755,33,22,7,15,11,7,4,0,0.0,0.0
1005,1321,25-09-2019 07:40:00,1,3042.0,2869.0,0.943,15.162,0,0,0,0,0,0,0,0,0.0,0.0
1005,1322,25-09-2019 07:42:00,1,3146.0,2909.0,0.925,15.615,0,0,0,0,0,0,0,0,0.0,0.0
1005,1323,25-09-2019 07:44:00,1,3151.0,2959.0,0.939,15.692,12,9,0,9,3,1,2,0,0.0,0.0
1005,1324,25-09-2019 07:46:00,1,3158.0,2925.0,0.926,15.68,5,0,0,0,5,0,5,0,0.0,0.0
1005,1325,25-09-2019 07:48:00,1,3125.0,2955.0,0.946,15.583,21,9,1,8,12,0,12,0,0.0,0.0
1005,1326,25-09-2019 07:50:00,1,3127.0,3011.0,0.963,15.653,4,4,0,4,0,0,0,0,0.0,0.0
1005,1327,25-09-2019 07:52:00,1,3123.0,2971.0,0.951,15.592,3,2,0,2,1,1,0,0,0.01,0.0
1005,1328,25-09-2019 07:54:00,1,3150.0,2939.0,0.933,15.664,25,12,4,8,13,2,11,0,0.0,0.0
1005,1329,25-09-2019 07:56:00,1,3139.0,2961.0,0.943,15.647,9,7,2,5,2,1,1,0,0.0,0.0
1005,1330,25-09-2019 07:58:00,1,3052.5,2835.0,0.928,15.166,6,2,1,1,4,1,3,0,0.0,0.0
1005,1331,25-09-2019 08:00:00,1,2966.0,2709.0,0.913,14.685,102,52,36,16,50,33,17,3,0.0,0.0
1005,1332,25-09-2019 08:02:00,1,2934.0,2896.0,0.987,14.766,7,0,0,0,7,3,4,0,0.0,0.0
1005,1333,25-09-2019 08:04:00,1,3116.0,3006.0,0.965,15.605,0,0,0,0,0,0,0,0,0.0,0.0
1005,1334,25-09-2019 08:06:00,1,3111.0,3020.0,0.971,15.601,2,0,0,0,2,0,2,0,0.0,0.0
1005,1335,25-09-2019 08:08:00,1,3130.0,2969.0,0.949,15.618,5,1,0,1,4,2,2,0,0.0,0.0
1005,1336,25-09-2019 08:10:00,1,3027.0,2913.0,0.962,15.151,15,13,9,4,2,0,2,0,0.0,0.0
1005,1337,25-09-2019 08:12:00,1,2950.0,2799.0,0.949,14.723,7,5,1,4,2,0,2,0,0.0,0.0
1005,1338,25-09-2019 08:14:00,1,2961.0,2728.0,0.921,14.688,13,7,3,4,6,0,6,0,0.0,0.0
1005,1339,25-09-2019 08:16:00,1,2981.0,2711.0,0.91,14.746,99,72,38,34,27,13,14,0,0.0,0.0
1005,1340,25-09-2019 08:18:00,1,2967.0,2755.0,0.929,14.74,76,50,21,29,26,11,15,0,0.0,0.0
1005,1341,25-09-2019 08:20:00,1,3118.0,2986.0,0.958,15.591,82,39,26,13,43,31,12,2,0.0,0.0
1005,1342,25-09-2019 08:22:00,1,3127.0,3020.0,0.966,15.662,109,57,47,10,52,36,16,54,0.0,0.0
1005,1343,25-09-2019 08:24:00,1,3410.0,3326.0,0.975,17.117,10,5,3,2,5,4,1,60,0.0,0.0
1005,1344,25-09-2019 08:26:00,1,3691.0,3509.0,0.951,18.427,2,0,0,0,2,1,1,48,0.0,0.0
1005,1345,25-09-2019 08:28:00,1,3904.0,3579.0,0.917,19.346,3,0,0,0,3,0,3,49,0.0,0.0
1005,1346,25-09-2019 08:30:00,1,3897.0,3663.0,0.94,19.408,11,2,2,0,9,5,4,42,0.0,0.02
1005,1347,25-09-2019 08:32:00,1,3562.0,3383.5,0.951,17.779,392,211,178,33,181,134,47,8,0.0,0.07
1005,1348,25-09-2019 08:34:00,1,3227.0,3104.0,0.962,16.15,385,166,133,33,219,167,52,16,0.0,0.0
1005,1349,25-09-2019 08:36:00,1,3435.0,3167.0,0.922,17.041,268,140,102,38,128,94,34,11,0.0,0.0
1005,1350,25-09-2019 08:38:00,1,4042.0,3835.0,0.949,20.173,299,172,112,60,127,80,47,0,0.0,0.0
1005,1351,25-09-2019 08:40:00,1,3921.0,3631.0,0.926,19.469,87,42,27,15,45,25,20,0,0.0,0.0
1005,1352,25-09-2019 08:42:00,1,3565.0,3469.0,0.973,17.886,43,31,0,31,12,5,7,0,0.0,0.0
1005,1353,25-09-2019 08:44:00,1,3776.0,3611.0,0.956,18.875,94,48,7,41,46,12,34,0,0.0,0.0
1005,1354,25-09-2019 08:46:00,1,3896.0,3632.0,0.932,19.371,36,9,0,9,27,16,11,0,0.0,0.0
1005,1355,25-09-2019 08:48:00,1,3555.0,3495.0,0.983,17.874,6,0,0,0,6,2,4,0,0.0,0.0
1005,1356,25-09-2019 08:50:00,1,3591.0,3488.0,0.971,18.01,8,0,0,0,8,4,4,0,0.0,0.0
1005,1357,25-09-2019 08:52:00,1,3497.0,3352.0,0.959,17.488,18,15,1,14,3,0,3,0,0.0,0.0
1005,1358,25-09-2019 08:54:00,1,3427.0,3236.0,0.944,17.087,41,28,15,13,13,7,6,0,0.0,0.0
1005,1359,25-09-2019 08:56:00,1,3391.0,3344.0,0.986,17.062,25,24,3,21,1,0,1,0,0.0,0.0
1005,1360,25-09-2019 08:58:00,1,3374.0,3345.0,0.992,16.995,13,9,3,6,4,2,2,0,0.0,0.0
1005,1361,25-09-2019 09:00:00,1,3372.0,3360.0,0.996,17.007,69,57,38,19,12,4,8,0,0.01,0.0
1005,1362,25-09-2019 09:02:00,1,3426.0,3242.0,0.946,17.086,69,29,15,14,40,17,23,0,0.0,0.0
1005,1363,25-09-2019 09:04:00,1,3092.0,3108.0,1.005,15.624,2,0,0,0,2,0,2,0,0.0,0.0
1005,1364,25-09-2019 09:06:00,1,3099.0,3069.5,0.9905,15.608,3,1,0,1,2,0,2,0,0.0,0.0
1005,1365,25-09-2019 09:08:00,1,3106.0,3031.0,0.976,15.592,0,0,0,0,0,0,0,0,0.0,0.0
1005,1366,25-09-2019 09:10:00,1,3127.0,2969.0,0.949,15.605,60,27,12,15,33,20,13,0,0.0,0.0
1005,1367,25-09-2019 09:12:00,1,3200.0,3134.0,0.979,16.077,14,2,1,1,12,5,7,0,0.0,0.0
1005,1368,25-09-2019 09:14:00,1,3304.0,3182.0,0.963,16.538,23,14,5,9,9,2,7,0,0.0,0.0
1005,1369,25-09-2019 09:16:00,1,3209.0,3170.0,0.988,16.151,33,29,4,25,4,3,1,0,0.0,0.0
1005,1370,25-09-2019 09:18:00,1,3103.0,3094.0,0.997,15.652,3,2,0,2,1,1,0,0,0.0,0.0
1005,1371,25-09-2019 09:20:00,1,3105.0,3074.0,0.99,15.635,10,6,4,2,4,3,1,0,0.0,0.0
1005,1372,25-09-2019 09:22:00,1,3137.0,2985.0,0.951,15.663,45,25,12,13,20,13,7,0,0.0,0.0
1005,1373,25-09-2019 09:24:00,1,3134.0,3037.0,0.969,15.709,2,0,0,0,2,1,1,0,0.0,0.0
1005,1374,25-09-2019 09:26:00,1,3118.0,3015.0,0.967,15.624,7,5,2,3,2,0,2,0,0.0,0.0
1005,1375,25-09-2019 09:28:00,1,3121.0,3027.0,0.97,15.649,44,21,13,8,23,9,14,0,0.0,0.0
1005,1376,25-09-2019 09:30:00,1,3124.0,3052.0,0.977,15.688,17,3,0,3,14,6,8,0,0.0,0.0
1005,1377,25-09-2019 09:32:00,1,3158.0,2900.0,0.918,15.653,6,4,0,4,2,1,1,0,0.0,0.0
1005,1378,25-09-2019 09:34:00,1,3152.0,2956.0,0.938,15.693,8,1,0,1,7,3,4,0,0.0,0.0
1005,1379,25-09-2019 09:36:00,1,3143.0,3001.0,0.955,15.707,0,0,0,0,0,0,0,0,0.0,0.0
1005,1380,25-09-2019 09:38:00,1,3144.0,2966.0,0.943,15.67,108,62,35,27,46,24,22,0,0.0,0.0
1005,1381,25-09-2019 09:40:00,1,3278.0,3069.5,0.9365,16.3125,104,74,30,44,30,5,25,0,0.0,0.0
1005,1382,25-09-2019 09:42:00,1,3412.0,3173.0,0.93,16.955,103,52,27,25,51,20,31,0,0.0,0.0
1005,1383,25-09-2019 09:44:00,1,3415.0,3249.0,0.951,17.053,222,139,99,40,83,63,20,34,0.0,0.0
1005,1384,25-09-2019 09:46:00,1,3409.0,3284.0,0.963,17.068,340,157,123,34,183,125,58,41,0.0,0.04
1005,1385,25-09-2019 09:48:00,1,3393.0,3345.0,0.986,17.072,10,4,0,4,6,3,3,0,0.0,0.0
1005,1386,25-09-2019 09:50:00,1,3400.0,3251.0,0.956,16.994,2,0,0,0,2,0,2,0,0.0,0.0
1005,1387,25-09-2019 09:52:00,1,3095.0,3091.0,0.999,15.617,29,13,6,7,16,11,5,0,0.0,0.0
1005,1388,25-09-2019 09:54:00,1,3154.0,2938.0,0.931,15.68,0,0,0,0,0,0,0,0,0.0,0.0
1005,1389,25-09-2019 09:56:00,1,2955.0,2846.0,0.963,14.796,17,2,0,2,15,1,14,0,0.0,0.0
1005,1390,25-09-2019 09:58:00,1,2949.0,2783.0,0.943,14.701,23,9,2,7,14,4,10,0,0.0,0.0
1005,1391,25-09-2019 10:00:00,1,2981.0,2667.0,0.895,14.699,9,6,0,6,3,1,2,0,0.0,0.0
1005,1392,25-09-2019 10:02:00,1,2885.0,2607.0,0.904,14.254,0,0,0,0,0,0,0,0,0.0,0.0
1005,1393,25-09-2019 10:04:00,1,2683.0,2548.0,0.949,13.393,6,5,0,5,1,0,1,0,0.0,0.0
1005,1394,25-09-2019 10:06:00,1,2777.0,2591.0,0.933,13.809,9,4,0,4,5,3,2,0,0.0,0.0
1005,1395,25-09-2019 10:08:00,1,3003.0,2639.0,0.879,14.752,24,18,11,7,6,2,4,0,0.0,0.0
1005,1396,25-09-2019 10:10:00,1,3076.0,2791.0,0.907,15.211,4,3,1,2,1,0,1,0,0.0,0.0
1005,1397,25-09-2019 10:12:00,1,2977.0,2753.0,0.925,14.779,2,1,0,1,1,1,0,0,0.01,0.0
1005,1398,25-09-2019 10:14:00,1,2989.0,2706.5,0.9055,14.773,10,5,0,5,5,1,4,0,0.0,0.0
1005,1399,25-09-2019 10:16:00,1,3001.0,2660.0,0.886,14.767,19,14,2,12,5,2,3,0,0.0,0.0
1005,1400,25-09-2019 10:18:00,1,3002.0,2650.0,0.883,14.76,12,5,1,4,7,3,4,0,0.0,0.0
1005,1401,25-09-2019 10:20:00,1,2693.0,2483.0,0.922,13.36,50,23,10,13,27,15,12,0,0.0,0.0
1005,1402,25-09-2019 10:22:00,1,3005.0,2609.0,0.868,14.728,2,0,0,0,2,1,1,0,0.0,0.0
1005,1403,25-09-2019 10:24:00,1,3080.0,2772.0,0.9,15.205,46,26,13,13,20,16,4,9,0.0,0.0
1005,1404,25-09-2019 10:26:00,1,3251.0,3037.0,0.934,16.172,94,49,24,25,45,17,28,2,0.0,0.0
1005,1405,25-09-2019 10:28:00,1,3090.0,2763.0,0.894,15.233,114,26,10,16,88,52,36,0,0.0,0.0
1005,1406,25-09-2019 10:30:00,1,3194.0,2772.0,0.868,15.653,83,29,10,19,54,23,31,0,0.0,0.0
1005,1407,25-09-2019 10:32:00,1,3197.0,2824.0,0.883,15.723,49,27,11,16,22,7,15,0,0.0,0.0
1005,1408,25-09-2019 10:34:00,1,3076.0,2752.0,0.895,15.167,27,8,1,7,19,8,11,0,0.0,0.0
1005,1409,25-09-2019 10:36:00,1,2981.0,2670.0,0.896,14.7,0,0,0,0,0,0,0,0,0.0,0.0
1005,1410,25-09-2019 10:38:00,1,2991.0,2634.0,0.881,14.699,6,0,0,0,6,2,4,0,0.0,0.0
1005,1411,25-09-2019 10:40:00,1,3024.0,2565.0,0.848,14.756,31,14,4,10,17,3,14,0,0.0,0.0
1005,1412,25-09-2019 10:42:00,1,3024.0,2539.0,0.84,14.724,0,0,0,0,0,0,0,0,0.0,0.0
1005,1413,25-09-2019 10:44:00,1,3018.0,2521.0,0.835,14.683,0,0,0,0,0,0,0,0,0.0,0.0
1005,1414,25-09-2019 10:46:00,1,2917.0,2483.0,0.851,14.24,1,0,0,0,1,1,0,0,0.0,0.0
1005,1415,25-09-2019 10:48:00,1,2965.5,2541.5,0.857,14.4975,188,94,48,46,94,52,42,0,0.0,0.0
1005,1416,25-09-2019 10:50:00,1,3014.0,2600.0,0.863,14.755,148,47,14,33,101,49,52,0,0.0,0.0
1005,1417,25-09-2019 10:52:00,1,3174.0,2783.0,0.877,15.587,44,19,14,5,25,14,11,53,0.0,0.0
1005,1418,25-09-2019 10:54:00,1,3738.0,3259.0,0.872,18.338,4,2,2,0,2,2,0,51,0.0,0.0
1005,1419,25-09-2019 10:56:00,1,3945.0,3357.0,0.851,19.262,0,0,0,0,0,0,0,50,0.0,0.0
1005,1420,25-09-2019 10:58:00,1,3928.0,3399.0,0.865,19.238,0,0,0,0,0,0,0,50,0.0,0.1
1005,1421,25-09-2019 11:00:00,1,3954.0,3347.0,0.846,19.284,27,5,4,1,22,15,7,49,0.0,0.0
1005,1422,25-09-2019 11:02:00,1,3929.0,3411.0,0.868,19.255,208,83,56,27,125,99,26,20,0.0,0.0
1005,1423,25-09-2019 11:04:00,1,3188.0,2749.0,0.863,15.603,310,196,160,36,114,80,34,4,0.0,0.1
1005,1424,25-09-2019 11:06:00,1,3716.0,3328.0,0.896,18.327,563,315,251,64,248,183,65,3,0.06,0.0
1005,1425,25-09-2019 11:08:00,1,3912.0,3515.0,0.899,19.306,504,303,244,59,201,147,54,26,0.0,0.0
1005,1426,25-09-2019 11:10:00,1,3901.0,3519.0,0.902,19.264,419,235,188,47,184,142,42,9,0.06,0.0
1005,1427,25-09-2019 11:12:00,1,3903.0,3672.0,0.941,19.442,253,149,109,40,104,78,26,76,0.0,0.0
1005,1428,25-09-2019 11:14:00,1,3431.0,3184.0,0.928,17.045,37,25,8,17,12,6,6,0,0.0,0.0
1005,1429,25-09-2019 11:16:00,1,3438.0,3185.0,0.926,17.073,62,39,14,25,23,10,13,0,0.0,0.0
1005,1430,25-09-2019 11:18:00,1,3471.0,3017.0,0.869,17.015,37,14,0,14,23,9,14,0,0.0,0.0
1005,1431,25-09-2019 11:20:00,1,3450.0,3158.0,0.915,17.09,70,53,29,24,17,9,8,0,0.0,0.0
1005,1432,25-09-2019 11:22:00,1,3638.0,3316.5,0.9115,18.007,273,149,99,50,124,81,43,39,0.0,0.0
1005,1433,25-09-2019 11:24:00,1,3826.0,3475.0,0.908,18.924,414,213,161,52,201,144,57,5,0.0,0.0
1005,1434,25-09-2019 11:26:00,1,3677.0,3456.0,0.94,18.314,30,13,7,6,17,4,13,0,0.0,0.0
1005,1435,25-09-2019 11:28:00,1,3418.0,3208.0,0.939,17.019,21,10,2,8,11,3,8,0,0.01,0.0
1005,1436,25-09-2019 11:30:00,1,3439.0,3182.0,0.925,17.072,78,37,12,25,41,12,29,0,0.0,0.0
1005,1437,25-09-2019 11:32:00,1,3449.0,3103.0,0.9,17.025,2,0,0,0,2,0,2,0,0.0,0.0
1005,1438,25-09-2019 11:34:00,1,3150.0,2921.0,0.927,15.643,9,7,0,7,2,0,2,0,0.0,0.0
1005,1439,25-09-2019 11:36:00,1,3157.0,2866.0,0.908,15.612,7,7,0,7,0,0,0,0,0.0,0.0
1005,1440,25-09-2019 11:38:00,1,2954.0,2785.0,0.943,14.723,2,1,0,1,1,1,0,0,0.0,0.0
1005,1441,25-09-2019 11:40:00,1,2979.0,2723.0,0.914,14.751,17,6,2,4,11,7,4,0,0.0,0.0
1005,1442,25-09-2019 11:42:00,1,2985.0,2696.0,0.903,14.744,1,0,0,0,1,1,0,0,0.0,0.0
1005,1443,25-09-2019 11:44:00,1,2976.0,2684.0,0.902,14.698,115,0,0,0,115,70,45,0,0.0,0.0
1005,1444,25-09-2019 11:46:00,1,2973.0,2720.0,0.915,14.725,25,0,0,0,25,6,19,0,0.0,0.0
1005,1445,25-09-2019 11:48:00,1,3178.0,2826.0,0.889,15.649,26,2,0,2,24,10,14,0,0.0,0.0
1005,1446,25-09-2019 11:50:00,1,2964.0,2694.0,0.909,14.663,0,0,0,0,0,0,0,0,0.0,0.0
1005,1447,25-09-2019 11:52:00,1,3194.0,2805.0,0.878,15.691,2,0,0,0,2,1,1,0,0.0,0.0
1005,1448,25-09-2019 11:54:00,1,3181.0,2821.0,0.887,15.654,16,0,0,0,16,2,14,0,0.0,0.0
1005,1449,25-09-2019 11:56:00,1,3182.5,2813.0,0.884,15.653,5,0,0,0,5,3,2,0,0.0,0.0
1005,1450,25-09-2019 11:58:00,1,3184.0,2805.0,0.881,15.652,8,2,2,0,6,4,2,0,0.0,0.0
1005,1451,25-09-2019 12:00:00,1,2991.0,2723.0,0.91,14.799,2,0,0,0,2,1,1,0,0.0,0.0
1005,1452,25-09-2019 12:02:00,1,3002.0,2571.0,0.856,14.676,2,0,0,0,2,1,1,0,0.0,0.0
1005,1453,25-09-2019 12:04:00,1,3011.0,2610.0,0.867,14.753,27,12,7,5,15,10,5,0,0.0,0.0
1005,1454,25-09-2019 12:06:00,1,3009.0,2553.0,0.848,14.682,7,0,0,0,7,0,7,0,0.0,0.0
1005,1455,25-09-2019 12:08:00,1,2720.0,2408.0,0.885,13.383,10,0,0,0,10,0,10,0,0.0,0.0
1005,1456,25-09-2019 12:10:00,1,2722.0,2359.0,0.866,13.337,10,5,2,3,5,0,5,0,0.0,0.0
1005,1457,25-09-2019 12:12:00,1,2720.0,2384.0,0.877,13.356,20,17,10,7,3,2,1,0,0.0,0.0
1005,1458,25-09-2019 12:14:00,1,3036.0,2464.0,0.812,14.692,47,28,15,13,19,11,8,0,0.0,0.0
1005,1459,25-09-2019 12:16:00,1,3013.0,2571.0,0.854,14.717,2,0,0,0,2,1,1,0,0.0,0.0
1005,1460,25-09-2019 12:18:00,1,3037.0,2522.0,0.83,14.759,47,15,8,7,32,15,17,0,0.0,0.0
1005,1461,25-09-2019 12:20:00,1,2999.0,2561.0,0.854,14.651,0,0,0,0,0,0,0,0,0.0,0.0
1005,1462,25-09-2019 12:22:00,1,3106.0,2634.0,0.848,15.156,19,0,0,0,19,3,16,0,0.0,0.0
1005,1463,25-09-2019 12:24:00,1,3005.0,2572.0,0.856,14.685,2,0,0,0,2,1,1,0,0.0,0.0
1005,1464,25-09-2019 12:26:00,1,2986.0,2611.0,0.874,14.656,0,0,0,0,0,0,0,0,0.0,0.0
1005,1465,25-09-2019 12:28:00,1,3009.0,2592.0,0.861,14.727,10,4,1,3,6,5,1,0,0.0,0.0
1005,1466,25-09-2019 12:30:00,1,3019.5,2527.5,0.837,14.697,2,1,0,1,1,0,1,0,0.0,0.0
1005,1467,25-09-2019 12:32:00,1,3030.0,2463.0,0.813,14.667,41,22,14,8,19,12,7,0,0.0,0.0
1005,1468,25-09-2019 12:34:00,1,3021.0,2523.0,0.835,14.698,51,28,21,7,23,16,7,0,0.0,0.0
1005,1469,25-09-2019 12:36:00,1,3119.0,2613.0,0.838,15.183,4,0,0,0,4,2,2,0,0.0,0.0
1005,1470,25-09-2019 12:38:00,1,3002.0,2601.0,0.867,14.709,0,0,0,0,0,0,0,0,0.0,0.0
1005,1471,25-09-2019 12:40:00,1,3004.0,2556.0,0.851,14.668,15,1,0,1,14,8,6,0,0.0,0.0
1005,1472,25-09-2019 12:42:00,1,3025.0,2501.0,0.827,14.689,99,35,4,31,64,32,32,0,0.0,0.0
1005,1473,25-09-2019 12:44:00,1,3028.0,2491.0,0.823,14.689,50,35,16,19,15,6,9,0,0.0,0.0
1005,1474,25-09-2019 12:46:00,1,3029.0,2515.0,0.83,14.719,61,37,20,17,24,6,18,0,0.0,0.0
1005,1475,25-09-2019 12:48:00,1,3006.0,2612.0,0.869,14.737,28,10,1,9,18,6,12,0,0.0,0.0
1005,1476,25-09-2019 12:50:00,1,3011.0,2583.0,0.858,14.725,137,61,38,23,76,40,36,0,0.0,0.0
1005,1477,25-09-2019 12:52:00,1,3201.0,2731.0,0.853,15.634,252,131,82,49,121,86,35,27,0.0,0.0
1005,1478,25-09-2019 12:54:00,1,3490.0,2916.0,0.836,16.977,233,112,90,22,121,83,38,82,0.0,0.0
1005,1479,25-09-2019 12:56:00,1,3493.0,2957.0,0.847,17.037,1,0,0,0,1,0,1,43,0.0,0.0
1005,1480,25-09-2019 12:58:00,1,3683.0,3085.0,0.838,17.928,3,0,0,0,3,0,3,47,0.0,0.0
1005,1481,25-09-2019 13:00:00,1,3654.0,3157.0,0.864,17.891,1,0,0,0,1,0,1,59,0.01,0.0
1005,1482,25-09-2019 13:02:00,1,3887.0,3268.0,0.841,18.932,452,220,175,45,232,178,54,25,0.09,0.03
1005,1483,25-09-2019 13:04:00,1,3785.5,3187.5,0.842,18.443,339,155,120,35,184,142,42,25,0.0,0.24
1005,1484,25-09-2019 13:06:00,1,3684.0,3107.0,0.843,17.954,289,176,142,34,113,85,28,30,0.0,0.0
1005,1485,25-09-2019 13:08:00,1,3953.0,3388.0,0.857,19.327,101,59,36,23,42,30,12,37,0.0,0.0
1005,1486,25-09-2019 13:10:00,1,3456.0,2997.0,0.867,16.935,68,49,14,35,19,5,14,0,0.0,0.0
1005,1487,25-09-2019 13:12:00,1,3284.0,2901.0,0.883,16.151,6,6,2,4,0,0,0,0,0.0,0.0
1005,1488,25-09-2019 13:14:00,1,3264.0,2908.0,0.891,16.077,2,0,0,0,2,1,1,0,0.0,0.0
1005,1489,25-09-2019 13:16:00,1,3468.0,3062.0,0.883,17.053,24,13,8,5,11,8,3,0,0.0,0.0
1005,1490,25-09-2019 13:18:00,1,3454.0,3031.0,0.878,16.965,3,1,0,1,2,0,2,0,0.0,0.0
1005,1491,25-09-2019 13:20:00,1,3166.0,2918.0,0.922,15.703,22,16,3,13,6,1,5,0,0.0,0.0
1005,1492,25-09-2019 13:22:00,1,3154.0,2945.0,0.934,15.689,3,0,0,0,3,1,2,0,0.0,0.0
1005,1493,25-09-2019 13:24:00,1,3133.0,2971.0,0.948,15.633,6,2,1,1,4,2,2,0,0.0,0.0
1005,1494,25-09-2019 13:26:00,1,3367.0,3043.0,0.904,16.637,10,10,0,10,0,0,0,0,0.0,0.0
1005,1495,25-09-2019 13:28:00,1,3442.0,3061.0,0.889,16.953,6,0,0,0,6,1,5,0,0.0,0.0
1005,1496,25-09-2019 13:30:00,1,3429.0,3114.0,0.908,16.957,7,1,0,1,6,2,4,0,0.0,0.0
1005,1497,25-09-2019 13:32:00,1,3447.0,3154.0,0.915,17.072,71,3,0,3,68,40,28,0,0.0,0.0
1005,1498,25-09-2019 13:34:00,1,3439.0,3137.0,0.912,17.025,19,0,0,0,19,2,17,0,0.0,0.0
1005,1499,25-09-2019 13:36:00,1,3340.0,3039.0,0.91,16.525,28,0,0,0,28,2,26,0,0.0,0.0
1005,1500,25-09-2019 13:38:00,1,3238.5,2975.0,0.919,16.0545,1,0,0,0,1,1,0,0,0.0,0.0
1005,1501,25-09-2019 13:40:00,1,3137.0,2911.0,0.928,15.584,55,40,23,17,15,6,9,0,0.0,0.0
1005,1502,25-09-2019 13:42:00,1,3132.0,2954.0,0.943,15.61,12,11,0,11,1,0,1,0,0.0,0.0
1005,1503,25-09-2019 13:44:00,1,3160.0,2871.0,0.909,15.631,18,17,3,14,1,0,1,0,0.0,0.0
1005,1504,25-09-2019 13:46:00,1,3175.0,2756.0,0.868,15.561,27,8,0,8,19,6,13,0,0.0,0.0
1005,1505,25-09-2019 13:48:00,1,3081.0,2748.0,0.892,15.181,12,5,2,3,7,4,3,0,0.0,0.0
1005,1506,25-09-2019 13:50:00,1,2968.0,2699.0,0.91,14.682,0,0,0,0,0,0,0,0,0.0,0.0
1005,1507,25-09-2019 13:52:00,1,3070.0,2715.0,0.885,15.1,53,31,12,19,22,14,8,0,0.0,0.0
1005,1508,25-09-2019 13:54:00,1,3175.0,2813.0,0.886,15.623,199,17,3,14,182,159,23,0,0.0,0.0
1005,1509,25-09-2019 13:56:00,1,3159.0,2918.0,0.924,15.677,122,7,0,7,115,96,19,0,0.0,0.0
1005,1510,25-09-2019 13:58:00,1,3248.0,2934.0,0.903,16.047,222,36,18,18,186,139,47,0,0.0,0.0
1005,1511,25-09-2019 14:00:00,1,3362.0,2942.0,0.875,16.504,16,3,2,1,13,4,9,0,0.0,0.0
1005,1512,25-09-2019 14:02:00,1,3181.0,2764.0,0.869,15.592,2,0,0,0,2,1,1,0,0.0,0.0
1005,1513,25-09-2019 14:04:00,1,3092.0,2714.0,0.878,15.188,13,7,1,6,6,1,5,0,0.0,0.0
1005,1514,25-09-2019 14:06:00,1,3094.0,2715.0,0.878,15.197,0,0,0,0,0,0,0,0,0.0,0.0
1005,1515,25-09-2019 14:08:00,1,2987.0,2621.0,0.877,14.671,63,26,8,18,37,21,16,0,0.0,0.0
1005,1516,25-09-2019 14:10:00,1,3187.0,2774.0,0.871,15.629,193,43,6,37,150,68,82,0,0.0,0.0
1005,1517,25-09-2019 14:12:00,1,3281.0,2878.0,0.877,16.1145,126,38,11,27,88,53,35,0,0.0,0.0
1005,1518,25-09-2019 14:14:00,1,3375.0,2982.0,0.883,16.6,58,26,10,16,32,7,25,0,0.0,0.0
1005,1519,25-09-2019 14:16:00,1,3151.0,2869.0,0.91,15.591,105,43,25,18,62,41,21,17,0.0,0.0
1005,1520,25-09-2019 14:18:00,1,3457.0,3064.0,0.887,17.012,0,0,0,0,0,0,0,59,0.0,0.0
1005,1521,25-09-2019 14:20:00,1,3635.0,3264.0,0.898,17.937,0,0,0,0,0,0,0,49,0.0,0.0
1005,1522,25-09-2019 14:22:00,1,3638.0,3224.0,0.886,17.904,134,72,57,15,62,43,19,45,0.0,0.0
1005,1523,25-09-2019 14:24:00,1,3420.0,3162.0,0.925,16.975,104,53,27,26,51,18,33,1,0.09,0.0
1005,1524,25-09-2019 14:26:00,1,3184.0,2755.0,0.865,15.596,15,14,5,9,1,1,0,0,0.0,0.0
1005,1525,25-09-2019 14:28:00,1,3188.0,2765.0,0.867,15.623,33,31,7,24,2,1,1,0,0.0,0.0
1005,1526,25-09-2019 14:30:00,1,2977.0,2733.0,0.918,14.755,18,16,8,8,2,1,1,0,0.0,0.0
1005,1527,25-09-2019 14:32:00,1,2988.0,2658.0,0.89,14.716,15,14,0,14,1,0,1,0,0.0,0.0
1005,1528,25-09-2019 14:34:00,1,2996.0,2631.0,0.878,14.716,0,0,0,0,0,0,0,0,0.0,0.0
1005,1529,25-09-2019 14:36:00,1,3005.0,2594.0,0.863,14.712,3,1,0,1,2,0,2,0,0.0,0.0
1005,1530,25-09-2019 14:38:00,1,3009.0,2574.0,0.855,14.707,3,3,0,3,0,0,0,0,0.0,0.0
1005,1531,25-09-2019 14:40:00,1,3004.0,2622.0,0.873,14.737,22,18,9,9,4,3,1,0,0.0,0.0
1005,1532,25-09-2019 14:42:00,1,2983.0,2638.0,0.884,14.673,0,0,0,0,0,0,0,0,0.0,0.0
1005,1533,25-09-2019 14:44:00,1,2994.0,2645.0,0.883,14.726,6,4,1,3,2,1,1,0,0.0,0.0
1005,1534,25-09-2019 14:46:00,1,3090.5,2691.0,0.871,15.157,7,6,4,2,1,1,0,0,0.0,0.0
1005,1535,25-09-2019 14:48:00,1,3187.0,2737.0,0.859,15.588,30,18,8,10,12,8,4,0,0.0,0.0
1005,1536,25-09-2019 14:50:00,1,3165.0,2836.0,0.896,15.608,0,0,0,0,0,0,0,0,0.0,0.0
1005,1537,25-09-2019 14:52:00,1,2992.0,2659.0,0.888,14.734,4,4,0,4,0,0,0,0,0.01,0.0
1005,1538,25-09-2019 14:54:00,1,3011.0,2618.0,0.869,14.762,80,48,36,12,32,23,9,2,0.0,0.0
1005,1539,25-09-2019 14:56:00,1,3163.0,2843.0,0.899,15.608,23,21,13,8,2,1,1,0,0.0,0.0
1005,1540,25-09-2019 14:58:00,1,2969.0,2714.0,0.914,14.702,1,0,0,0,1,1,0,0,0.0,0.0
1005,1541,25-09-2019 15:00:00,1,2999.0,2549.0,0.85,14.637,102,52,38,14,50,31,19,11,0.0,0.0
1005,1542,25-09-2019 15:02:00,1,3185.0,2835.0,0.89,15.687,117,69,40,29,48,21,27,0,0.0,0.0
1005,1543,25-09-2019 15:04:00,1,3157.0,2937.0,0.93,15.692,161,89,58,31,72,47,25,0,0.0,0.0
1005,1544,25-09-2019 15:06:00,1,3145.0,2910.0,0.925,15.614,126,51,28,23,75,31,44,0,0.0,0.0
1005,1545,25-09-2019 15:08:00,1,3456.0,3048.0,0.882,16.989,78,38,26,12,40,30,10,40,0.0,0.0
1005,1546,25-09-2019 15:10:00,1,3608.0,3293.0,0.913,17.861,4,1,1,0,3,2,1,48,0.0,0.0
1005,1547,25-09-2019 15:12:00,1,3939.0,3441.0,0.874,19.329,2,0,0,0,2,2,0,56,0.0,0.0
1005,1548,25-09-2019 15:14:00,1,3931.0,3431.0,0.873,19.286,17,3,2,1,14,4,10,37,0.02,0.0
1005,1549,25-09-2019 15:16:00,1,3907.0,3496.0,0.895,19.264,142,19,9,10,123,87,36,44,0.0,0.09
1005,1550,25-09-2019 15:18:00,1,3910.0,3557.0,0.91,19.345,130,19,8,11,111,81,30,49,0.0,0.09
1005,1551,25-09-2019 15:20:00,1,3764.0,3431.5,0.912,18.63,139,50,25,25,89,71,18,34,0.0,0.09
1005,1552,25-09-2019 15:22:00,1,3618.0,3306.0,0.914,17.915,247,138,98,40,109,78,31,15,0.11,0.0
1005,1553,25-09-2019 15:24:00,1,3631.0,3295.0,0.907,17.955,591,325,247,78,266,214,52,8,0.04,0.04
1005,1554,25-09-2019 15:26:00,1,3889.0,3584.0,0.922,19.29,265,131,89,42,134,99,35,0,0.01,0.0
1005,1555,25-09-2019 15:28:00,1,3248.0,3042.0,0.937,16.166,234,109,77,32,125,81,44,21,0.0,0.0
1005,1556,25-09-2019 15:30:00,1,3352.0,3069.0,0.915,16.606,45,21,6,15,24,9,15,0,0.0,0.0
1005,1557,25-09-2019 15:32:00,1,3440.0,3062.0,0.89,16.945,13,13,1,12,0,0,0,0,0.0,0.0
1005,1558,25-09-2019 15:34:00,1,3441.0,3155.0,0.917,17.052,70,57,21,36,13,2,11,0,0.0,0.0
1005,1559,25-09-2019 15:36:00,1,3591.0,3394.0,0.945,17.905,45,27,8,19,18,6,12,0,0.0,0.0
1005,1560,25-09-2019 15:38:00,1,3618.0,3333.0,0.921,17.945,1,0,0,0,1,1,0,0,0.0,0.0
1005,1561,25-09-2019 15:40:00,1,3414.0,3204.0,0.939,16.998,1,1,1,0,0,0,0,0,0.0,0.0
1005,1562,25-09-2019 15:42:00,1,3431.0,3158.0,0.921,17.015,12,9,4,5,3,2,1,0,0.02,0.0
1005,1563,25-09-2019 15:44:00,1,3403.0,3253.0,0.956,17.01,0,0,0,0,0,0,0,0,0.0,0.0
1005,1564,25-09-2019 15:46:00,1,3426.0,3210.0,0.937,17.053,17,10,3,7,7,6,1,0,0.0,0.0
1005,1565,25-09-2019 15:48:00,1,3424.0,3187.0,0.931,17.019,0,0,0,0,0,0,0,0,0.0,0.0
1005,1566,25-09-2019 15:50:00,1,3403.0,3282.0,0.965,17.041,0,0,0,0,0,0,0,0,0.0,0.0
1005,1567,25-09-2019 15:52:00,1,3398.0,3274.0,0.964,17.012,2,0,0,0,2,0,2,0,0.0,0.0
1005,1568,25-09-2019 15:54:00,1,3251.0,3200.0,0.9855,16.352,1,0,0,0,1,1,0,0,0.0,0.0
1005,1569,25-09-2019 15:56:00,1,3104.0,3126.0,1.007,15.692,0,0,0,0,0,0,0,0,0.0,0.0
1005,1570,25-09-2019 15:58:00,1,3095.0,3132.0,1.012,15.663,3,2,1,1,1,0,1,0,0.0,0.0
1005,1571,25-09-2019 16:00:00,1,3098.0,3122.0,1.008,15.662,1,0,0,0,1,0,1,0,0.0,0.0
1005,1572,25-09-2019 16:02:00,1,3121.0,3058.0,0.98,15.681,4,0,0,0,4,3,1,0,0.0,0.0
1005,1573,25-09-2019 16:04:00,1,3125.0,3038.0,0.972,15.676,7,5,2,3,2,2,0,0,0.0,0.0
1005,1574,25-09-2019 16:06:00,1,2919.0,2945.0,1.009,14.762,9,6,2,4,3,2,1,0,0.0,0.0
1005,1575,25-09-2019 16:08:00,1,2934.0,2922.0,0.996,14.796,9,5,2,3,4,2,2,0,0.0,0.0
1005,1576,25-09-2019 16:10:00,1,2924.0,2900.0,0.992,14.729,13,11,3,8,2,1,1,0,0.0,0.0
1005,1577,25-09-2019 16:12:00,1,2922.0,2864.0,0.98,14.682,28,28,0,28,0,0,0,0,0.0,0.0
1005,1578,25-09-2019 16:14:00,1,2957.0,2866.0,0.969,14.821,2,2,0,2,0,0,0,0,0.0,0.0
1005,1579,25-09-2019 16:16:00,1,2934.0,2856.0,0.973,14.724,2,2,0,2,0,0,0,0,0.0,0.0
1005,1580,25-09-2019 16:18:00,1,2938.0,2880.0,0.98,14.764,1,0,0,0,1,1,0,0,0.0,0.0
1005,1581,25-09-2019 16:20:00,1,2932.0,2879.0,0.982,14.739,66,43,22,21,23,17,6,0,0.0,0.0
1005,1582,25-09-2019 16:22:00,1,3126.0,3018.0,0.966,15.657,9,8,1,7,1,0,1,0,0.0,0.0
1005,1583,25-09-2019 16:24:00,1,2918.0,2984.0,1.023,14.802,0,0,0,0,0,0,0,0,0.0,0.0
1005,1584,25-09-2019 16:26:00,1,2920.0,2913.0,0.998,14.728,0,0,0,0,0,0,0,0,0.0,0.0
1005,1585,25-09-2019 16:28:00,1,2926.5,2895.0,0.9895,14.734,0,0,0,0,0,0,0,0,0.0,0.0
1005,1586,25-09-2019 16:30:00,1,2933.0,2877.0,0.981,14.74,26,0,0,0,26,13,13,0,0.0,0.0
1005,1587,25-09-2019 16:32:00,1,2939.0,2821.0,0.96,14.705,31,9,7,2,22,18,4,1,0.0,0.0
1005,1588,25-09-2019 16:34:00,1,3032.0,2916.0,0.962,15.173,27,3,2,1,24,16,8,18,0.0,0.27
1005,1589,25-09-2019 16:36:00,1,3396.0,3267.0,0.962,16.999,0,0,0,0,0,0,0,0,0.0,0.0
1005,1590,25-09-2019 16:38:00,1,3384.0,3312.0,0.979,16.999,9,0,0,0,9,0,9,0,0.0,0.0
1005,1591,25-09-2019 16:40:00,1,3377.0,3373.0,0.999,17.04,14,0,0,0,14,0,14,0,0.0,0.01
1005,1592,25-09-2019 16:42:00,1,3648.0,3588.0,0.984,18.346,264,140,106,34,124,79,45,28,0.16,0.0
1005,1593,25-09-2019 16:44:00,1,3389.0,3361.0,0.992,17.075,216,81,53,28,135,84,51,36,0.02,0.05
1005,1594,25-09-2019 16:46:00,1,3459.0,3457.0,1.0,17.455,192,91,58,33,101,62,39,4,0.0,0.0
1005,1595,25-09-2019 16:48:00,1,3396.0,3295.0,0.97,17.027,65,30,9,21,35,8,27,0,0.0,0.0
1005,1596,25-09-2019 16:50:00,1,3414.0,3263.0,0.956,17.064,32,18,6,12,14,0,14,0,0.01,0.0
1005,1597,25-09-2019 16:52:00,1,3377.0,3359.0,0.995,17.022,36,24,5,19,12,2,10,0,0.0,0.0
1005,1598,25-09-2019 16:54:00,1,3529.0,3613.0,1.024,17.902,4,0,0,0,4,0,4,0,0.0,0.0
1005,1599,25-09-2019 16:56:00,1,3565.0,3589.0,1.007,18.02,10,2,1,1,8,3,5,0,0.0,0.0
1005,1600,25-09-2019 16:58:00,1,3559.0,3582.0,1.006,17.988,3,2,0,2,1,1,0,0,0.0,0.0
1005,1601,25-09-2019 17:00:00,1,3569.0,3544.0,0.993,17.986,4,4,0,4,0,0,0,0,0.0,0.0
1005,1602,25-09-2019 17:02:00,1,3466.5,3502.0,1.0105,17.5345,20,19,0,19,1,0,1,0,0.0,0.0
1005,1603,25-09-2019 17:04:00,1,3364.0,3460.0,1.028,17.083,1,0,0,0,1,0,1,0,0.0,0.0
1005,1604,25-09-2019 17:06:00,1,3386.0,3373.0,0.996,17.076,11,7,0,7,4,2,2,0,0.0,0.0
1005,1605,25-09-2019 17:08:00,1,3386.0,3352.0,0.99,17.05,1,0,0,0,1,0,1,0,0.0,0.0
1005,1606,25-09-2019 17:10:00,1,3398.0,3332.0,0.981,17.075,10,4,0,4,6,2,4,0,0.0,0.0
1005,1607,25-09-2019 17:12:00,1,3278.0,3255.0,0.993,16.518,5,2,1,1,3,0,3,0,0.0,0.0
1005,1608,25-09-2019 17:14:00,1,3400.0,3322.0,0.977,17.072,10,3,0,3,7,0,7,0,0.0,0.0
1005,1609,25-09-2019 17:16:00,1,3395.0,3343.0,0.985,17.079,22,16,8,8,6,2,4,0,0.0,0.0
1005,1610,25-09-2019 17:18:00,1,3177.0,3269.0,1.029,16.136,40,24,19,5,16,12,4,0,0.0,0.0
1005,1611,25-09-2019 17:20:00,1,3193.0,3258.0,1.021,16.187,1,1,0,1,0,0,0,0,0.0,0.0
1005,1612,25-09-2019 17:22:00,1,3280.0,3303.0,1.007,16.579,26,23,1,22,3,0,3,0,0.0,0.0
1005,1613,25-09-2019 17:24:00,1,3177.0,3244.0,1.021,16.11,10,7,3,4,3,1,2,0,0.0,0.0
1005,1614,25-09-2019 17:26:00,1,3095.0,3179.0,1.027,15.712,22,21,11,10,1,1,0,0,0.0,0.0
1005,1615,25-09-2019 17:28:00,1,3103.0,3081.0,0.993,15.638,14,14,5,9,0,0,0,0,0.0,0.0
1005,1616,25-09-2019 17:30:00,1,3088.0,3174.0,1.028,15.68,42,18,8,10,24,6,18,0,0.0,0.0
1005,1617,25-09-2019 17:32:00,1,3085.0,3099.0,1.005,15.587,31,15,4,11,16,5,11,0,0.0,0.0
1005,1618,25-09-2019 17:34:00,1,3104.0,3147.0,1.014,15.712,16,11,5,6,5,1,4,0,0.0,0.0
1005,1619,25-09-2019 17:36:00,1,3060.5,3068.5,1.0025,15.4535,8,4,0,4,4,1,3,0,0.0,0.0
1005,1620,25-09-2019 17:38:00,1,3017.0,2990.0,0.991,15.195,66,22,14,8,44,22,22,0,0.0,0.0
1005,1621,25-09-2019 17:40:00,1,3117.0,3067.0,0.984,15.675,65,36,10,26,29,14,15,0,0.0,0.0
1005,1622,25-09-2019 17:42:00,1,3082.0,3219.0,1.044,15.708,67,41,14,27,26,3,23,0,0.0,0.0
1005,1623,25-09-2019 17:44:00,1,3407.0,3347.0,0.982,17.129,58,43,14,29,15,3,12,0,0.0,0.0
1005,1624,25-09-2019 17:46:00,1,3406.0,3306.0,0.971,17.079,3,2,1,1,1,0,1,0,0.01,0.0
1005,1625,25-09-2019 17:48:00,1,3197.0,3215.0,1.006,16.154,5,3,1,2,2,1,1,0,0.0,0.0
1005,1626,25-09-2019 17:50:00,1,3078.0,3161.0,1.027,15.628,68,39,18,21,29,16,13,0,0.0,0.0
1005,1627,25-09-2019 17:52:00,1,3398.0,3328.0,0.979,17.071,94,21,3,18,73,38,35,0,0.0,0.0
1005,1628,25-09-2019 17:54:00,1,3360.0,3457.0,1.029,17.066,21,15,9,6,6,2,4,0,0.0,0.0
1005,1629,25-09-2019 17:56:00,1,3365.0,3446.0,1.024,17.073,177,150,112,38,27,5,22,0,0.0,0.0
1005,1630,25-09-2019 17:58:00,1,3362.0,3450.0,1.026,17.066,138,117,66,51,21,7,14,0,0.01,0.0
1005,1631,25-09-2019 18:00:00,0,3553.0,3532.0,0.994,17.91,53,32,6,26,21,3,18,0,0.0,0.0
1005,1632,25-09-2019 18:02:00,0,3566.0,3490.0,0.979,17.914,14,6,4,2,8,2,6,0,0.0,0.0
1005,1633,25-09-2019 18:04:00,0,3379.0,3366.0,0.996,17.039,190,82,65,17,108,80,28,14,0.0,0.0
1005,1634,25-09-2019 18:06:00,0,3549.0,3550.0,1.0,17.913,145,76,47,29,69,46,23,36,0.0,0.0
1005,1635,25-09-2019 18:08:00,0,3761.0,3703.0,0.985,18.916,215,126,88,38,89,44,45,24,0.0,0.0
1005,1636,25-09-2019 18:10:00,0,3810.5,3691.0,0.969,19.099,107,74,32,42,33,3,30,0,0.0,0.0
1005,1637,25-09-2019 18:12:00,0,3860.0,3679.0,0.953,19.282,52,23,6,17,29,10,19,0,0.0,0.0
1005,1638,25-09-2019 18:14:00,0,3863.0,3719.0,0.963,19.338,49,19,4,15,30,8,22,0,0.0,0.0
1005,1639,25-09-2019 18:16:00,0,3830.0,3768.0,0.984,19.264,234,93,64,29,141,96,45,11,0.0,0.0
1005,1640,25-09-2019 18:18:00,0,4219.0,4103.0,0.973,21.164,366,156,125,31,210,167,43,110,0.02,0.0
1005,1641,25-09-2019 18:20:00,0,4020.0,3999.0,0.995,20.264,0,0,0,0,0,0,0,54,0.01,0.0
1005,1642,25-09-2019 18:22:00,0,4309.0,4150.0,0.963,21.574,1,0,0,0,1,1,0,58,0.0,0.0
1005,1643,25-09-2019 18:24:00,0,4221.0,4124.0,0.977,21.196,0,0,0,0,0,0,0,17,0.0,0.13
1005,1644,25-09-2019 18:26:00,0,4034.0,3928.0,0.974,20.241,197,114,86,28,83,55,28,33,0.06,0.05
1005,1645,25-09-2019 18:28:00,0,3782.0,3587.0,0.948,18.873,268,140,105,35,128,96,32,86,0.0,0.0
1005,1646,25-09-2019 18:30:00,0,4504.0,4340.0,0.964,22.549,445,241,185,56,204,155,49,94,0.0,0.0
1005,1647,25-09-2019 18:32:00,0,3878.0,3706.0,0.956,19.382,413,186,139,47,227,171,56,25,0.01,0.0
1005,1648,25-09-2019 18:34:00,0,3856.0,3709.0,0.962,19.3,426,176,141,35,250,202,48,95,0.03,0.0
1005,1649,25-09-2019 18:36:00,0,4120.0,4043.0,0.981,20.709,64,30,10,20,34,13,21,0,0.02,0.0
1005,1650,25-09-2019 18:38:00,0,4068.0,3893.0,0.957,20.336,151,82,59,23,69,48,21,50,0.0,0.0
1005,1651,25-09-2019 18:40:00,0,4511.0,4335.0,0.961,22.57,102,56,46,10,46,29,17,65,0.0,0.0
1005,1652,25-09-2019 18:42:00,0,4229.0,4118.0,0.974,21.222,205,97,78,19,108,79,29,83,0.0,0.0
1005,1653,25-09-2019 18:44:00,0,4127.0,4025.0,0.9755,20.717,183,102,62,40,81,52,29,0,0.03,0.01
1005,1654,25-09-2019 18:46:00,0,4025.0,3932.0,0.977,20.212,85,57,14,43,28,15,13,0,0.0,0.0
1005,1655,25-09-2019 18:48:00,0,4020.0,4005.0,0.996,20.271,132,94,43,51,38,8,30,0,0.0,0.0
1005,1656,25-09-2019 18:50:00,0,4213.0,4129.0,0.98,21.17,234,130,80,50,104,58,46,0,0.0,0.0
1005,1657,25-09-2019 18:52:00,0,4418.0,4240.0,0.96,22.101,135,101,62,39,34,17,17,0,0.0,0.0
1005,1658,25-09-2019 18:54:00,0,3886.0,3645.0,0.938,19.346,62,21,0,21,41,15,26,0,0.0,0.0
1005,1659,25-09-2019 18:56:00,0,3591.0,3419.0,0.952,17.934,19,5,2,3,14,10,4,0,0.0,0.0
1005,1660,25-09-2019 18:58:00,0,3386.0,3318.0,0.98,17.015,22,11,5,6,11,7,4,0,0.0,0.0
1005,1661,25-09-2019 19:00:00,0,3564.0,3529.0,0.99,17.951,15,7,0,7,8,1,7,0,0.0,0.0
1005,1662,25-09-2019 19:02:00,0,3661.0,3573.0,0.976,18.381,5,1,1,0,4,1,3,0,0.0,0.0
1005,1663,25-09-2019 19:04:00,0,3665.0,3607.0,0.984,18.435,8,4,1,3,4,2,2,0,0.0,0.0
1005,1664,25-09-2019 19:06:00,0,3590.0,3484.0,0.971,18.0,3,3,0,3,0,0,0,0,0.0,0.0
1005,1665,25-09-2019 19:08:00,0,3372.0,3344.0,0.992,16.989,119,80,44,36,39,18,21,24,0.0,0.0
1005,1666,25-09-2019 19:10:00,0,3658.0,3615.0,0.988,18.414,231,116,87,29,115,79,36,25,0.0,0.07
1005,1667,25-09-2019 19:12:00,0,3823.0,3837.0,1.004,19.309,0,0,0,0,0,0,0,51,0.0,0.0
1005,1668,25-09-2019 19:14:00,0,4014.0,4026.0,1.003,20.272,0,0,0,0,0,0,0,63,0.0,0.0
1005,1669,25-09-2019 19:16:00,0,4192.0,4245.0,1.013,21.217,0,0,0,0,0,0,0,52,0.0,0.05
1005,1670,25-09-2019 19:18:00,0,4298.0,4287.5,0.998,21.6805,1,0,0,0,1,1,0,44,0.0,0.06
1005,1671,25-09-2019 19:20:00,0,4404.0,4330.0,0.983,22.144,155,87,71,16,68,53,15,59,0.05,0.02
1005,1672,25-09-2019 19:22:00,0,3820.0,3789.0,0.992,19.246,424,223,192,31,201,143,58,104,0.03,0.03
1005,1673,25-09-2019 19:24:00,0,4210.0,4090.0,0.972,21.113,83,46,35,11,37,30,7,62,0.01,0.0
1005,1674,25-09-2019 19:26:00,0,3590.0,3477.0,0.968,17.993,306,139,107,32,167,124,43,48,0.05,0.0
1005,1675,25-09-2019 19:28:00,0,3671.0,3587.0,0.977,18.434,313,146,108,38,167,123,44,98,0.0,0.0
1005,1676,25-09-2019 19:30:00,0,4511.0,4323.0,0.958,22.559,221,103,84,19,118,93,25,100,0.01,0.0
1005,1677,25-09-2019 19:32:00,0,4650.0,4659.0,1.002,23.479,47,37,30,7,10,5,5,64,0.0,0.01
1005,1678,25-09-2019 19:34:00,0,4638.0,4713.0,1.016,23.491,379,181,149,32,198,154,44,54,0.07,0.02
1005,1679,25-09-2019 19:36:00,0,4661.0,4640.0,0.996,23.501,246,146,111,35,100,71,29,14,0.0,0.0
1005,1680,25-09-2019 19:38:00,0,3391.0,3354.0,0.989,17.076,96,40,20,20,56,27,29,0,0.0,0.0
1005,1681,25-09-2019 19:40:00,0,4201.0,4195.0,0.999,21.194,101,65,30,35,36,12,24,0,0.0,0.0
1005,1682,25-09-2019 19:42:00,0,4506.0,4457.0,0.989,22.688,128,85,36,49,43,20,23,0,0.0,0.0
1005,1683,25-09-2019 19:44:00,0,4481.0,4478.0,0.999,22.611,9,4,4,0,5,3,2,0,0.0,0.0
1005,1684,25-09-2019 19:46:00,0,4508.0,4375.0,0.971,22.606,1,0,0,0,1,1,0,0,0.0,0.0
1005,1685,25-09-2019 19:48:00,0,4301.0,4246.0,0.987,21.647,5,0,0,0,5,0,5,0,0.01,0.0
1005,1686,25-09-2019 19:50:00,0,4282.0,4292.0,1.002,21.623,4,0,0,0,4,3,1,0,0.0,0.0
1005,1687,25-09-2019 19:52:00,0,4062.0,4054.0,0.9975,20.4925,10,0,0,0,10,2,8,0,0.0,0.0
1005,1688,25-09-2019 19:54:00,0,3842.0,3816.0,0.993,19.362,3,1,1,0,2,0,2,0,0.0,0.0
1005,1689,25-09-2019 19:56:00,0,3662.0,3635.0,0.992,18.454,180,81,65,16,99,79,20,47,0.0,0.0
1005,1690,25-09-2019 19:58:00,0,4003.0,4048.0,1.011,20.254,109,57,44,13,52,42,10,55,0.0,0.01
1005,1691,25-09-2019 20:00:00,0,4216.0,4139.0,0.982,21.192,109,49,32,17,60,30,30,38,0.0,0.01
1005,1692,25-09-2019 20:02:00,0,4402.0,4288.0,0.974,22.089,82,69,38,31,13,0,13,45,0.0,0.07
1005,1693,25-09-2019 20:04:00,0,4482.0,4374.0,0.976,22.5,56,31,19,12,25,10,15,45,0.0,0.01
1005,1694,25-09-2019 20:06:00,0,4479.0,4504.0,1.006,22.632,125,9,2,7,116,51,65,53,0.0,0.0
1005,1695,25-09-2019 20:08:00,0,4665.0,4552.0,0.976,23.42,219,102,70,32,117,74,43,61,0.09,0.16
1005,1696,25-09-2019 20:10:00,0,3851.0,3741.0,0.971,19.316,379,198,160,38,181,139,42,90,0.0,0.0
1005,1697,25-09-2019 20:12:00,0,3943.0,3828.0,0.971,19.774,124,82,54,28,42,6,36,51,0.0,0.0
1005,1698,25-09-2019 20:14:00,0,4512.0,4368.0,0.968,22.614,107,67,36,31,40,1,39,31,0.0,0.02
1005,1699,25-09-2019 20:16:00,0,4643.0,4633.0,0.998,23.42,70,33,17,16,37,20,17,30,0.0,0.09
1005,1700,25-09-2019 20:18:00,0,4930.0,4841.0,0.982,24.782,168,16,3,13,152,84,68,43,0.01,0.05
1005,1701,25-09-2019 20:20:00,0,5090.0,5099.0,1.002,25.7,152,23,7,16,129,83,46,43,0.0,0.08
1005,1702,25-09-2019 20:22:00,0,4565.0,4479.0,0.981,22.946,421,210,166,44,211,165,46,63,0.09,0.0
1005,1703,25-09-2019 20:24:00,0,3571.0,3548.0,0.994,17.997,355,166,121,45,189,142,47,27,0.06,0.0
1005,1704,25-09-2019 20:26:00,0,3629.0,3499.5,0.965,18.172,52,25,9,16,27,14,13,0,0.02,0.0
1005,1705,25-09-2019 20:28:00,0,3687.0,3451.0,0.936,18.347,229,144,93,51,85,54,31,34,0.0,0.01
1005,1706,25-09-2019 20:30:00,0,4456.0,4471.0,1.003,22.507,189,130,83,47,59,37,22,27,0.0,0.0
1005,1707,25-09-2019 20:32:00,0,4035.0,3970.0,0.984,20.291,208,108,83,25,100,76,24,60,0.0,0.0
1005,1708,25-09-2019 20:34:00,0,4002.0,4021.0,1.005,20.22,75,57,38,19,18,7,11,0,0.0,0.0
1005,1709,25-09-2019 20:36:00,0,4666.0,4580.0,0.982,23.454,109,64,33,31,45,15,30,0,0.0,0.0
1005,1710,25-09-2019 20:38:00,0,4635.0,4642.0,1.002,23.4,95,63,30,33,32,10,22,0,0.0,0.0
1005,1711,25-09-2019 20:40:00,0,4625.0,4667.0,1.009,23.389,11,9,5,4,2,0,2,0,0.0,0.0
1005,1712,25-09-2019 20:42:00,0,4732.0,4783.0,1.011,23.94,14,13,4,9,1,1,0,0,0.0,0.0
1005,1713,25-09-2019 20:44:00,0,4659.0,4570.0,0.981,23.416,7,7,5,2,0,0,0,0,0.0,0.0
1005,1714,25-09-2019 20:46:00,0,4463.0,4436.0,0.994,22.496,39,29,19,10,10,6,4,0,0.0,0.0
1005,1715,25-09-2019 20:48:00,0,3934.0,3922.0,0.997,19.843,12,4,4,0,8,6,2,0,0.0,0.0
1005,1716,25-09-2019 20:50:00,0,3836.0,3805.0,0.992,19.328,37,23,15,8,14,6,8,0,0.0,0.0
1005,1717,25-09-2019 20:52:00,0,3538.0,3596.0,1.016,17.919,11,11,1,10,0,0,0,0,0.0,0.0
1005,1718,25-09-2019 20:54:00,0,3829.0,3744.0,0.978,19.231,20,8,5,3,12,2,10,0,0.0,0.0
1005,1719,25-09-2019 20:56:00,0,4024.0,3969.0,0.986,20.247,1,0,0,0,1,0,1,0,0.0,0.01
1005,1720,25-09-2019 20:58:00,0,4007.0,3959.0,0.988,20.171,6,3,2,1,3,2,1,0,0.0,0.0
1005,1721,25-09-2019 21:00:00,0,3823.0,3815.0,0.9985,19.286,10,10,1,9,0,0,0,0,0.0,0.0
1005,1722,25-09-2019 21:02:00,0,3639.0,3671.0,1.009,18.401,11,7,4,3,4,1,3,0,0.0,0.0
1005,1723,25-09-2019 21:04:00,0,3562.0,3501.0,0.983,17.911,1,0,0,0,1,1,0,0,0.0,0.0
1005,1724,25-09-2019 21:06:00,0,3367.0,3371.0,1.001,16.996,133,55,34,21,78,44,34,39,0.0,0.0
1005,1725,25-09-2019 21:08:00,0,3872.0,3746.0,0.968,19.404,87,28,10,18,59,11,48,38,0.0,0.04
1005,1726,25-09-2019 21:10:00,0,3811.0,3855.0,1.012,19.284,98,32,0,32,66,10,56,47,0.0,0.0
1005,1727,25-09-2019 21:12:00,0,4000.0,4085.0,1.021,20.282,102,27,6,21,75,16,59,50,0.0,0.12
1005,1728,25-09-2019 21:14:00,0,3975.0,4152.0,1.045,20.256,73,23,16,7,50,19,31,51,0.0,0.1
1005,1729,25-09-2019 21:16:00,0,4192.0,4257.0,1.015,21.23,217,101,67,34,116,82,34,45,0.1,0.03
1005,1730,25-09-2019 21:18:00,0,3584.0,3466.0,0.967,17.957,308,147,105,42,161,121,40,33,0.06,0.2
1005,1731,25-09-2019 21:20:00,0,3817.0,3849.0,1.008,19.298,558,309,252,57,249,191,58,7,0.0,0.0
1005,1732,25-09-2019 21:22:00,0,3649.0,3614.0,0.99,18.38,305,114,89,25,191,140,51,31,0.0,0.0
1005,1733,25-09-2019 21:24:00,0,3461.0,3438.0,0.993,17.444,263,131,92,39,132,96,36,33,0.06,0.0
1005,1734,25-09-2019 21:26:00,0,3367.0,3355.0,0.996,16.978,227,76,50,26,151,101,50,33,0.0,0.0
1005,1735,25-09-2019 21:28:00,0,4105.0,4089.0,0.996,20.7,95,23,3,20,72,15,57,51,0.0,0.0
1005,1736,25-09-2019 21:30:00,0,4741.0,4764.0,1.005,23.953,128,28,2,26,100,48,52,46,0.0,0.0
1005,1737,25-09-2019 21:32:00,0,4628.0,4697.0,1.015,23.435,170,55,29,26,115,68,47,32,0.08,0.0
1005,1738,25-09-2019 21:34:00,0,4549.5,4617.0,1.015,23.036,308,139,99,40,169,122,47,47,0.1,0.0
1005,1739,25-09-2019 21:36:00,0,4471.0,4537.0,1.015,22.637,310,168,123,45,142,95,47,39,0.01,0.0
1005,1740,25-09-2019 21:38:00,0,4108.0,4089.0,0.995,20.71,253,111,84,27,142,89,53,34,0.0,0.1
1005,1741,25-09-2019 21:40:00,0,4366.0,4308.0,0.987,21.971,620,329,247,82,291,220,71,0,0.0,0.0
1005,1742,25-09-2019 21:42:00,0,4641.0,4777.0,1.029,23.572,581,347,268,79,234,175,59,4,0.01,0.0
1005,1743,25-09-2019 21:44:00,0,4663.0,4650.0,0.997,23.521,614,323,251,72,291,227,64,49,0.03,0.0
1005,1744,25-09-2019 21:46:00,0,4936.0,4823.0,0.977,24.787,91,50,19,31,41,16,25,0,0.01,0.0
1005,1745,25-09-2019 21:48:00,0,4679.0,4613.0,0.986,23.543,134,67,29,38,67,30,37,0,0.0,0.0
1005,1746,25-09-2019 21:50:00,0,4839.0,4829.0,0.998,24.41,158,57,27,30,101,59,42,0,0.0,0.0
1005,1747,25-09-2019 21:52:00,0,4633.0,4689.0,1.012,23.444,40,6,5,1,34,16,18,0,0.0,0.0
1005,1748,25-09-2019 21:54:00,0,4655.0,4618.0,0.992,23.453,141,70,43,27,71,28,43,0,0.0,0.0
1005,1749,25-09-2019 21:56:00,0,4468.0,4451.0,0.996,22.529,117,27,13,14,90,34,56,0,0.0,0.0
1005,1750,25-09-2019 21:58:00,0,4502.0,4342.0,0.964,22.545,45,0,0,0,45,2,43,0,0.0,0.0
1005,1751,25-09-2019 22:00:00,0,4284.0,4284.0,1.0,21.622,38,0,0,0,38,2,36,0,0.0,0.0
1005,1752,25-09-2019 22:02:00,0,4187.0,4171.0,0.996,21.116,39,0,0,0,39,0,39,0,0.0,0.0
1005,1753,25-09-2019 22:04:00,0,3998.0,4054.0,1.014,20.242,125,62,32,30,63,28,35,0,0.0,0.0
1005,1754,25-09-2019 22:06:00,0,4013.0,4074.0,1.015,20.321,233,125,84,41,108,64,44,20,0.0,0.0
1005,1755,25-09-2019 22:08:00,0,4005.0,4104.0,1.0245,20.323,204,136,92,44,68,45,23,31,0.0,0.0
1005,1756,25-09-2019 22:10:00,0,3997.0,4134.0,1.034,20.325,170,66,53,13,104,65,39,73,0.08,0.0
1005,1757,25-09-2019 22:12:00,0,4267.0,4281.0,1.003,21.55,49,8,4,4,41,24,17,65,0.0,0.0
1005,1758,25-09-2019 22:14:00,0,4486.0,4445.0,0.991,22.597,113,49,32,17,64,40,24,52,0.0,0.03
1005,1759,25-09-2019 22:16:00,0,4469.0,4547.0,1.017,22.641,85,47,31,16,38,19,19,25,0.0,0.27
1005,1760,25-09-2019 22:18:00,0,4264.0,4320.0,1.013,21.582,8,7,0,7,1,1,0,0,0.0,0.0
1005,1761,25-09-2019 22:20:00,0,4281.0,4267.0,0.997,21.591,39,17,9,8,22,13,9,4,0.02,0.0
1005,1762,25-09-2019 22:22:00,0,4276.0,4337.0,1.014,21.649,339,175,134,41,164,122,42,57,0.07,0.0
1005,1763,25-09-2019 22:24:00,0,4018.0,4083.0,1.016,20.351,495,207,163,44,288,219,69,27,0.0,0.0
1005,1764,25-09-2019 22:26:00,0,4658.0,4656.0,1.0,23.505,438,224,178,46,214,150,64,54,0.06,0.0
1005,1765,25-09-2019 22:28:00,0,4481.0,4434.0,0.99,22.562,420,178,136,42,242,182,60,87,0.02,0.0
1005,1766,25-09-2019 22:30:00,0,4438.0,4526.0,1.02,22.495,163,76,51,25,87,36,51,0,0.0,0.0
1005,1767,25-09-2019 22:32:00,0,4456.0,4554.0,1.022,22.596,85,36,20,16,49,18,31,0,0.0,0.0
1005,1768,25-09-2019 22:34:00,0,4467.0,4417.0,0.989,22.489,43,22,7,15,21,9,12,0,0.01,0.0
1005,1769,25-09-2019 22:36:00,0,4503.0,4409.0,0.979,22.622,47,25,11,14,22,10,12,0,0.0,0.0
1005,1770,25-09-2019 22:38:00,0,4000.0,4110.0,1.027,20.31,49,19,11,8,30,12,18,0,0.0,0.0
1005,1771,25-09-2019 22:40:00,0,4026.0,3988.0,0.99,20.279,37,0,0,0,37,4,33,0,0.0,0.0
1005,1772,25-09-2019 22:42:00,0,3898.5,3831.5,0.9825,19.602,156,7,4,3,149,96,53,0,0.0,0.0
1005,1773,25-09-2019 22:44:00,0,3771.0,3675.0,0.975,18.925,127,19,11,8,108,66,42,0,0.0,0.0
1005,1774,25-09-2019 22:46:00,0,3764.0,3679.0,0.977,18.905,37,11,3,8,26,3,23,0,0.0,0.0
1005,1775,25-09-2019 22:48:00,0,3549.0,3591.0,1.012,17.956,18,1,0,1,17,0,17,0,0.0,0.0
1005,1776,25-09-2019 22:50:00,0,3575.0,3567.0,0.998,18.036,20,1,1,0,19,2,17,0,0.0,0.0
1005,1777,25-09-2019 22:52:00,0,3451.0,3470.0,1.006,17.437,37,15,0,15,22,8,14,0,0.0,0.0
1005,1778,25-09-2019 22:54:00,0,3348.0,3486.0,1.041,17.05,24,5,0,5,19,2,17,0,0.0,0.0
1005,1779,25-09-2019 22:56:00,0,3378.0,3411.0,1.01,17.085,32,13,7,6,19,1,18,0,0.0,0.0
1005,1780,25-09-2019 22:58:00,0,3364.0,3452.0,1.026,17.075,50,35,20,15,15,6,9,0,0.0,0.0
1005,1781,25-09-2019 23:00:00,0,3359.0,3404.0,1.014,17.003,1,0,0,0,1,1,0,0,0.0,0.0
1005,1782,25-09-2019 23:02:00,0,3397.0,3358.0,0.988,17.103,16,15,8,7,1,0,1,0,0.0,0.0
1005,1783,25-09-2019 23:04:00,0,3284.0,3288.0,1.001,16.577,6,0,0,0,6,3,3,0,0.0,0.0
1005,1784,25-09-2019 23:06:00,0,3403.0,3338.0,0.981,17.104,208,136,95,41,72,49,23,10,0.0,0.0
1005,1785,25-09-2019 23:08:00,0,3622.0,3703.0,1.022,18.368,131,35,12,23,96,57,39,4,0.0,0.0
1005,1786,25-09-2019 23:10:00,0,3846.0,3827.0,0.995,19.389,210,90,55,35,120,77,43,27,0.0,0.0
1005,1787,25-09-2019 23:12:00,0,3843.0,3816.0,0.993,19.365,233,71,48,23,162,96,66,8,0.0,0.0
1005,1788,25-09-2019 23:14:00,0,3835.0,3860.0,1.006,19.384,225,78,45,33,147,96,51,26,0.0,0.0
1005,1789,25-09-2019 23:16:00,0,3932.0,3963.0,1.0075,19.879,121,41,25,16,80,41,39,63,0.0,0.0
1005,1790,25-09-2019 23:18:00,0,4029.0,4066.0,1.009,20.374,183,132,84,48,51,18,33,58,0.01,0.05
1005,1791,25-09-2019 23:20:00,0,4207.0,4207.0,1.0,21.233,180,122,82,40,58,25,33,60,0.0,0.06
1005,1792,25-09-2019 23:22:00,0,4009.0,4074.0,1.016,20.307,268,150,114,36,118,68,50,66,0.06,0.0
1005,1793,25-09-2019 23:24:00,0,4203.0,4271.0,1.016,21.286,302,143,102,41,159,114,45,112,0.06,0.01
1005,1794,25-09-2019 23:26:00,0,4176.0,4239.0,1.015,21.148,246,120,93,27,126,84,42,49,0.07,0.01
1005,1795,25-09-2019 23:28:00,0,4080.0,4177.0,1.024,20.699,223,45,21,24,178,120,58,4,0.01,0.01
1005,1796,25-09-2019 23:30:00,0,4282.0,4302.0,1.005,21.633,145,46,10,36,99,53,46,0,0.0,0.0
1005,1797,25-09-2019 23:32:00,0,4288.0,4344.0,1.013,21.701,65,7,0,7,58,6,52,0,0.0,0.0
1005,1798,25-09-2019 23:34:00,0,4378.0,4369.0,0.998,22.087,59,4,1,3,55,9,46,0,0.0,0.0
1005,1799,25-09-2019 23:36:00,0,4201.0,4214.0,1.003,21.216,77,16,8,8,61,9,52,0,0.0,0.0
1005,1800,25-09-2019 23:38:00,0,4019.0,4026.0,1.002,20.292,52,19,12,7,33,24,9,0,0.0,0.0
1005,1801,25-09-2019 23:40:00,0,3837.0,3864.0,1.007,19.394,59,11,6,5,48,20,28,0,0.0,0.0
1005,1802,25-09-2019 23:42:00,0,3650.0,3701.0,1.014,18.478,94,3,3,0,91,47,44,0,0.0,0.0
1005,1803,25-09-2019 23:44:00,0,3548.0,3673.0,1.035,18.043,85,7,1,6,78,28,50,0,0.0,0.0
1005,1804,25-09-2019 23:46:00,0,3565.0,3501.0,0.982,17.92,286,62,37,25,224,159,65,0,0.0,0.0
1005,1805,25-09-2019 23:48:00,0,3648.0,3679.0,1.009,18.447,348,151,99,52,197,139,58,6,0.0,0.0
1005,1806,25-09-2019 23:50:00,0,3816.0,3894.5,1.02,19.347,177,84,51,33,93,66,27,40,0.0,0.05
1005,1807,25-09-2019 23:52:00,0,3984.0,4110.0,1.031,20.247,89,60,35,25,29,8,21,40,0.0,0.0
1005,1808,25-09-2019 23:54:00,0,4014.0,4092.0,1.019,20.347,297,214,153,61,83,41,42,61,0.0,0.03
1005,1809,25-09-2019 23:56:00,0,3824.0,3838.0,1.004,19.317,197,141,104,37,56,36,20,5,0.0,0.04
1005,1810,25-09-2019 23:58:00,0,3828.0,3834.0,1.002,19.325,394,232,186,46,162,110,52,18,0.0,0.0
1005,1811,26-09-2019 00:00:00,0,3551.0,3564.0,1.004,17.937,556,288,246,42,268,203,65,49,0.04,0.01
1005,1812,26-09-2019 00:02:00,0,3981.0,4127.0,1.037,20.254,762,384,288,96,378,292,86,6,0.01,0.0
1005,1813,26-09-2019 00:04:00,0,3962.0,4124.0,1.041,20.175,833,454,357,97,379,284,95,42,0.0,0.0
1005,1814,26-09-2019 00:06:00,0,4169.0,4305.0,1.032,21.192,619,310,248,62,309,238,71,22,0.02,0.0
1005,1815,26-09-2019 00:08:00,0,3848.0,3801.0,0.988,19.368,342,167,113,54,175,113,62,81,0.0,0.0
1005,1816,26-09-2019 00:10:00,0,4667.0,4630.0,0.992,23.514,163,110,65,45,53,17,36,54,0.0,0.0
1005,1817,26-09-2019 00:12:00,0,4648.0,4647.0,1.0,23.459,153,69,41,28,84,47,37,63,0.0,0.0
1005,1818,26-09-2019 00:14:00,0,4852.0,4783.0,0.986,24.412,186,113,76,37,73,30,43,50,0.0,0.02
1005,1819,26-09-2019 00:16:00,0,3752.0,3685.0,0.982,18.864,293,171,129,42,122,86,36,30,0.0,0.03
1005,1820,26-09-2019 00:18:00,0,4171.0,4288.0,1.028,21.18,587,372,282,90,215,148,67,8,0.0,0.01
1005,1821,26-09-2019 00:20:00,0,4482.0,4493.0,1.002,22.633,314,173,132,41,141,95,46,56,0.0,0.0
1005,1822,26-09-2019 00:22:00,0,4489.0,4384.0,0.977,22.538,461,256,199,57,205,147,58,4,0.07,0.0
1005,1823,26-09-2019 00:24:00,0,4581.5,4468.5,0.9755,22.997,323,151,118,33,172,125,47,0,0.0,0.0
1005,1824,26-09-2019 00:26:00,0,4674.0,4553.0,0.974,23.456,350,236,181,55,114,58,56,67,0.0,0.0
1005,1825,26-09-2019 00:28:00,0,4206.0,4172.0,0.992,21.189,226,94,67,27,132,90,42,18,0.0,0.0
1005,1826,26-09-2019 00:30:00,0,3834.0,3874.0,1.01,19.397,179,52,21,31,127,73,54,0,0.0,0.0
1005,1827,26-09-2019 00:32:00,0,4105.0,4110.0,1.001,20.723,96,41,13,28,55,18,37,0,0.0,0.0
1005,1828,26-09-2019 00:34:00,0,4388.0,4291.0,0.978,22.041,107,34,14,20,73,38,35,0,0.0,0.0
1005,1829,26-09-2019 00:36:00,0,4014.0,4079.0,1.016,20.329,87,13,6,7,74,47,27,0,0.0,0.0
1005,1830,26-09-2019 00:38:00,0,3982.0,4058.0,1.019,20.181,29,2,1,1,27,11,16,0,0.0,0.0
1005,1831,26-09-2019 00:40:00,0,4032.0,3966.0,0.984,20.276,27,0,0,0,27,18,9,0,0.0,0.0
1005,1832,26-09-2019 00:42:00,0,3938.0,3896.0,0.989,19.828,51,22,10,12,29,15,14,0,0.0,0.0
1005,1833,26-09-2019 00:44:00,0,3798.0,3898.0,1.026,19.28,62,17,8,9,45,27,18,0,0.0,0.0
1005,1834,26-09-2019 00:46:00,0,3848.0,3777.0,0.982,19.343,32,5,1,4,27,15,12,0,0.0,0.0
1005,1835,26-09-2019 00:48:00,0,3552.0,3603.0,1.014,17.984,25,1,0,1,24,10,14,0,0.0,0.0
1005,1836,26-09-2019 00:50:00,0,3560.0,3481.0,0.978,17.88,44,9,4,5,35,15,20,0,0.0,0.0
1005,1837,26-09-2019 00:52:00,0,3566.0,3605.0,1.011,18.039,137,52,26,26,85,44,41,0,0.0,0.0
1005,1838,26-09-2019 00:54:00,0,3848.0,3796.0,0.987,19.363,170,45,12,33,125,74,51,0,0.0,0.0
1005,1839,26-09-2019 00:56:00,0,3821.0,3851.0,1.008,19.319,271,130,91,39,141,92,49,43,0.0,0.0
1005,1840,26-09-2019 00:58:00,0,3933.5,3917.5,0.9965,19.8345,240,128,81,47,112,69,43,59,0.0,0.0
1005,1841,26-09-2019 01:00:00,0,4046.0,3984.0,0.985,20.35,200,134,88,46,66,16,50,58,0.0,0.01
1005,1842,26-09-2019 01:02:00,0,3971.0,4103.0,1.033,20.189,98,58,29,29,40,12,28,62,0.0,0.0
1005,1843,26-09-2019 01:04:00,0,4199.0,4154.0,0.989,21.143,115,77,39,38,38,9,29,66,0.01,0.0
1005,1844,26-09-2019 01:06:00,0,4528.0,4368.0,0.965,22.677,57,15,8,7,42,24,18,54,0.0,0.0
1005,1845,26-09-2019 01:08:00,0,4188.0,4156.0,0.992,21.104,155,57,21,36,98,48,50,59,0.0,0.0
1005,1846,26-09-2019 01:10:00,0,4205.0,4168.0,0.991,21.183,283,171,131,40,112,73,39,42,0.01,0.11
1005,1847,26-09-2019 01:12:00,0,4193.0,4127.0,0.984,21.089,423,216,173,43,207,151,56,76,0.06,0.03
1005,1848,26-09-2019 01:14:00,0,3846.0,3764.0,0.979,19.319,185,83,60,23,102,77,25,67,0.01,0.0
1005,1849,26-09-2019 01:16:00,0,3938.0,3809.0,0.967,19.731,208,70,39,31,138,85,53,6,0.0,0.0
1005,1850,26-09-2019 01:18:00,0,4284.0,4244.0,0.991,21.575,173,33,11,22,140,62,78,0,0.0,0.0
1005,1851,26-09-2019 01:20:00,0,4203.0,4229.0,1.006,21.243,46,14,2,12,32,16,16,0,0.0,0.0
1005,1852,26-09-2019 01:22:00,0,3851.0,3764.0,0.978,19.339,6,0,0,0,6,0,6,0,0.0,0.0
1005,1853,26-09-2019 01:24:00,0,3649.0,3563.0,0.977,18.32,17,5,1,4,12,5,7,0,0.0,0.0
1005,1854,26-09-2019 01:26:00,0,3843.0,3868.0,1.007,19.422,18,3,0,3,15,8,7,0,0.0,0.0
1005,1855,26-09-2019 01:28:00,0,3835.0,3835.0,1.0,19.356,45,21,11,10,24,16,8,0,0.0,0.0
1005,1856,26-09-2019 01:30:00,0,3843.0,3846.0,1.001,19.397,3,0,0,0,3,0,3,0,0.0,0.0
1005,1857,26-09-2019 01:32:00,0,3795.5,3782.5,0.9965,19.14,12,3,0,3,9,0,9,0,0.0,0.0
1005,1858,26-09-2019 01:34:00,0,3748.0,3719.0,0.992,18.883,22,0,0,0,22,9,13,0,0.0,0.0
1005,1859,26-09-2019 01:36:00,0,3645.0,3672.0,1.007,18.424,21,2,1,1,19,11,8,0,0.0,0.0
1005,1860,26-09-2019 01:38:00,0,3568.0,3592.0,1.007,18.034,30,0,0,0,30,11,19,0,0.0,0.0
1005,1861,26-09-2019 01:40:00,0,3578.0,3477.0,0.972,17.947,17,0,0,0,17,6,11,0,0.0,0.0
1005,1862,26-09-2019 01:42:00,0,3389.0,3371.0,0.995,17.084,7,0,0,0,7,4,3,0,0.0,0.0
1005,1863,26-09-2019 01:44:00,0,3401.0,3293.0,0.968,17.046,51,11,6,5,40,22,18,0,0.0,0.0
1005,1864,26-09-2019 01:46:00,0,3571.0,3488.0,0.977,17.932,10,4,3,1,6,2,4,0,0.0,0.0
1005,1865,26-09-2019 01:48:00,0,3592.0,3455.0,0.962,17.977,38,13,5,8,25,14,11,0,0.0,0.0
1005,1866,26-09-2019 01:50:00,0,3411.0,3299.0,0.967,17.09,9,3,0,3,6,2,4,0,0.0,0.0
1005,1867,26-09-2019 01:52:00,0,3187.0,3179.0,0.998,16.074,8,1,0,1,7,1,6,0,0.0,0.0
1005,1868,26-09-2019 01:54:00,0,3308.0,3202.0,0.968,16.579,13,8,3,5,5,2,3,0,0.0,0.0
1005,1869,26-09-2019 01:56:00,0,3407.0,3331.0,0.978,17.11,19,1,0,1,18,8,10,0,0.0,0.0
1005,1870,26-09-2019 01:58:00,0,3590.0,3479.0,0.969,17.996,25,0,0,0,25,18,7,0,0.0,0.0
1005,1871,26-09-2019 02:00:00,0,3589.0,3504.0,0.976,18.019,56,34,11,23,22,13,9,0,0.0,0.0
1005,1872,26-09-2019 02:02:00,0,3574.0,3498.0,0.979,17.954,95,75,32,43,20,10,10,0,0.0,0.0
1005,1873,26-09-2019 02:04:00,0,3566.0,3577.0,1.003,18.008,124,62,37,25,62,30,32,56,0.0,0.0
1005,1874,26-09-2019 02:06:00,0,3655.5,3694.0,1.01,18.4915,69,38,18,20,31,15,16,45,0.0,0.0
1005,1875,26-09-2019 02:08:00,0,3745.0,3811.0,1.017,18.975,34,18,10,8,16,10,6,32,0.0,0.0
1005,1876,26-09-2019 02:10:00,0,3729.0,3805.0,1.02,18.903,96,50,32,18,46,17,29,47,0.01,0.0
1005,1877,26-09-2019 02:12:00,0,3943.0,3884.0,0.985,19.836,200,140,95,45,60,21,39,61,0.0,0.12
1005,1878,26-09-2019 02:14:00,0,3736.0,3808.0,1.019,18.936,468,268,209,59,200,143,57,19,0.07,0.08
1005,1879,26-09-2019 02:16:00,0,3736.0,3798.0,1.017,18.926,84,47,26,21,37,10,27,46,0.01,0.0
1005,1880,26-09-2019 02:18:00,0,4312.0,4263.0,0.989,21.707,130,19,3,16,111,68,43,44,0.0,0.0
1005,1881,26-09-2019 02:20:00,0,4058.0,4226.0,1.042,20.667,94,35,14,21,59,31,28,40,0.0,0.0
1005,1882,26-09-2019 02:22:00,0,4008.0,4105.0,1.024,20.337,450,169,131,38,281,207,74,17,0.1,0.16
1005,1883,26-09-2019 02:24:00,0,4478.0,4511.0,1.007,22.639,317,177,132,45,140,105,35,40,0.0,0.0
1005,1884,26-09-2019 02:26:00,0,3373.0,3430.0,1.017,17.089,507,286,230,56,221,171,50,77,0.12,0.0
1005,1885,26-09-2019 02:28:00,0,4754.0,4768.0,1.003,24.007,534,307,254,53,227,174,53,31,0.0,0.0
1005,1886,26-09-2019 02:30:00,0,3462.0,3514.0,1.015,17.531,638,355,286,69,283,207,76,56,0.0,0.0
1005,1887,26-09-2019 02:32:00,0,4419.0,4289.0,0.97,22.159,580,336,252,84,244,179,65,31,0.0,0.0
1005,1888,26-09-2019 02:34:00,0,3908.0,3980.0,1.019,19.804,239,82,43,39,157,53,104,0,0.0,0.0
1005,1889,26-09-2019 02:36:00,0,4183.0,4212.0,1.007,21.144,638,371,297,74,267,191,76,1,0.0,0.0
1005,1890,26-09-2019 02:38:00,0,4576.0,4560.0,0.996,23.077,360,216,156,60,144,91,53,27,0.0,0.0
1005,1891,26-09-2019 02:40:00,0,4550.5,4611.5,1.013,23.0345,110,47,26,21,63,42,21,0,0.0,0.0
1005,1892,26-09-2019 02:42:00,0,4525.0,4663.0,1.03,22.992,260,125,92,33,135,95,40,0,0.0,0.0
1005,1893,26-09-2019 02:44:00,0,4364.0,4445.0,1.019,22.117,552,340,278,62,212,166,46,15,0.0,0.0
1005,1894,26-09-2019 02:46:00,0,4300.0,4316.0,1.004,21.719,175,64,42,22,111,80,31,15,0.02,0.0
1005,1895,26-09-2019 02:48:00,0,4187.0,4277.0,1.021,21.233,74,6,2,4,68,35,33,0,0.0,0.0
1005,1896,26-09-2019 02:50:00,0,3987.0,4070.0,1.021,20.214,11,1,0,1,10,6,4,0,0.0,0.0
1005,1897,26-09-2019 02:52:00,0,3918.0,3934.0,1.004,19.79,26,3,0,3,23,14,9,0,0.0,0.0
1005,1898,26-09-2019 02:54:00,0,3714.0,3808.0,1.025,18.847,23,4,1,3,19,11,8,0,0.0,0.0
1005,1899,26-09-2019 02:56:00,0,3745.0,3665.0,0.979,18.814,4,0,0,0,4,2,2,0,0.0,0.0
1005,1900,26-09-2019 02:58:00,0,3460.0,3575.0,1.033,17.59,18,4,2,2,14,4,10,0,0.0,0.0
1005,1901,26-09-2019 03:00:00,0,3462.0,3431.0,0.991,17.438,19,2,0,2,17,9,8,0,0.0,0.0
1005,1902,26-09-2019 03:02:00,0,3254.0,3350.0,1.03,16.527,42,7,2,5,35,21,14,0,0.0,0.0
1005,1903,26-09-2019 03:04:00,0,3271.0,3372.0,1.031,16.622,49,15,9,6,34,14,20,0,0.0,0.0
1005,1904,26-09-2019 03:06:00,0,3294.0,3257.0,0.989,16.586,35,1,0,1,34,22,12,0,0.0,0.0
1005,1905,26-09-2019 03:08:00,0,3295.0,3212.0,0.975,16.538,25,3,0,3,22,9,13,0,0.0,0.0
1005,1906,26-09-2019 03:10:00,0,3211.0,3159.0,0.984,16.149,29,8,4,4,21,13,8,0,0.0,0.0
1005,1907,26-09-2019 03:12:00,0,3189.0,3187.0,0.999,16.091,4,0,0,0,4,0,4,0,0.0,0.0
1005,1908,26-09-2019 03:14:00,0,3297.5,3222.0,0.9775,16.5575,7,5,2,3,2,1,1,0,0.0,0.0
1005,1909,26-09-2019 03:16:00,0,3406.0,3257.0,0.956,17.024,6,0,0,0,6,1,5,0,0.0,0.0
1005,1910,26-09-2019 03:18:00,0,3424.0,3251.0,0.95,17.088,47,9,6,3,38,21,17,0,0.0,0.0
1005,1911,26-09-2019 03:20:00,0,3224.0,3083.0,0.957,16.115,22,4,2,2,18,11,7,0,0.0,0.0
1005,1912,26-09-2019 03:22:00,0,3431.0,3178.0,0.926,17.037,29,17,14,3,12,5,7,0,0.0,0.0
1005,1913,26-09-2019 03:24:00,0,3434.0,3206.0,0.934,17.077,9,2,1,1,7,3,4,0,0.0,0.0
1005,1914,26-09-2019 03:26:00,0,3227.0,3089.0,0.957,16.132,105,5,2,3,100,61,39,0,0.0,0.0
1005,1915,26-09-2019 03:28:00,0,3585.0,3421.0,0.954,17.913,141,39,19,20,102,58,44,0,0.0,0.0
1005,1916,26-09-2019 03:30:00,0,3594.0,3444.0,0.958,17.973,194,32,18,14,162,112,50,0,0.0,0.0
1005,1917,26-09-2019 03:32:00,0,3595.0,3500.0,0.974,18.041,104,40,9,31,64,30,34,0,0.0,0.0
1005,1918,26-09-2019 03:34:00,0,3914.0,3605.0,0.921,19.412,68,25,11,14,43,24,19,0,0.0,0.0
1005,1919,26-09-2019 03:36:00,0,3615.0,3360.0,0.93,17.962,42,8,1,7,34,8,26,0,0.0,0.0
1005,1920,26-09-2019 03:38:00,0,3423.0,3255.0,0.951,17.092,21,9,4,5,12,6,6,0,0.0,0.0
1005,1921,26-09-2019 03:40:00,0,3411.0,3278.0,0.961,17.067,11,0,0,0,11,7,4,0,0.0,0.0
1005,1922,26-09-2019 03:42:00,0,3427.0,3193.0,0.932,17.036,14,0,0,0,14,1,13,0,0.0,0.0
1005,1923,26-09-2019 03:44:00,0,3120.0,3027.0,0.97,15.646,46,28,4,24,18,8,10,0,0.0,0.0
1005,1924,26-09-2019 03:46:00,0,3138.0,2974.0,0.948,15.655,42,16,10,6,26,17,9,0,0.0,0.0
1005,1925,26-09-2019 03:48:00,0,3384.0,3151.5,0.9325,16.8205,314,172,128,44,142,92,50,63,0.0,0.0
1005,1926,26-09-2019 03:50:00,0,3630.0,3329.0,0.917,17.986,113,60,31,29,53,24,29,69,0.0,0.02
1005,1927,26-09-2019 03:52:00,0,3875.0,3630.0,0.937,19.288,92,27,17,10,65,38,27,51,0.01,0.02
1005,1928,26-09-2019 03:54:00,0,4063.0,3806.0,0.937,20.223,132,33,10,23,99,56,43,55,0.0,0.0
1005,1929,26-09-2019 03:56:00,0,4095.0,3755.0,0.917,20.292,73,29,13,16,44,20,24,53,0.0,0.14
1005,1930,26-09-2019 03:58:00,0,4148.0,3978.0,0.959,20.748,118,41,13,28,77,20,57,51,0.0,0.0
1005,1931,26-09-2019 04:00:00,0,4258.0,4029.0,0.946,21.237,107,40,26,14,67,37,30,12,0.1,0.01
1005,1932,26-09-2019 04:02:00,0,3400.0,3275.0,0.963,17.021,42,7,4,3,35,16,19,0,0.0,0.0
1005,1933,26-09-2019 04:04:00,0,3576.0,3484.0,0.974,17.946,8,1,0,1,7,0,7,0,0.0,0.0
1005,1934,26-09-2019 04:06:00,0,3900.0,3610.0,0.926,19.364,10,5,2,3,5,0,5,0,0.0,0.0
1005,1935,26-09-2019 04:08:00,0,3879.0,3666.0,0.945,19.343,19,11,3,8,8,2,6,0,0.0,0.0
1005,1936,26-09-2019 04:10:00,0,3854.0,3744.0,0.971,19.329,11,3,0,3,8,4,4,0,0.0,0.0
1005,1937,26-09-2019 04:12:00,0,3866.0,3769.0,0.975,19.405,69,29,13,16,40,21,19,0,0.0,0.0
1005,1938,26-09-2019 04:14:00,0,3871.0,3699.0,0.956,19.348,37,7,4,3,30,14,16,0,0.0,0.0
1005,1939,26-09-2019 04:16:00,0,3673.0,3592.0,0.978,18.449,58,13,8,5,45,30,15,0,0.0,0.0
1005,1940,26-09-2019 04:18:00,0,3797.0,3608.0,0.95,18.953,12,0,0,0,12,4,8,0,0.0,0.0
1005,1941,26-09-2019 04:20:00,0,3594.0,3442.0,0.958,17.97,5,0,0,0,5,2,3,0,0.0,0.0
1005,1942,26-09-2019 04:22:00,0,3494.0,3386.5,0.9695,17.5145,42,9,3,6,33,16,17,0,0.01,0.02
1005,1943,26-09-2019 04:24:00,0,3394.0,3331.0,0.981,17.059,14,3,0,3,11,5,6,0,0.01,0.01
1005,1944,26-09-2019 04:26:00,0,3122.0,3057.0,0.979,15.683,43,6,2,4,37,16,21,0,0.0,0.0
1005,1945,26-09-2019 04:28:00,0,3363.0,3395.0,1.009,17.009,46,3,1,2,43,11,32,0,0.0,0.0
1005,1946,26-09-2019 04:30:00,0,3377.0,3336.0,0.988,16.997,39,8,2,6,31,20,11,0,0.0,0.0
1005,1947,26-09-2019 04:32:00,0,3406.0,3294.0,0.967,17.068,20,0,0,0,20,8,12,0,0.0,0.0
1005,1948,26-09-2019 04:34:00,0,3399.0,3305.0,0.972,17.049,15,0,0,0,15,5,10,0,0.0,0.0
1005,1949,26-09-2019 04:36:00,0,3377.0,3356.0,0.994,17.019,167,47,24,23,120,86,34,0,0.0,0.0
1005,1950,26-09-2019 04:38:00,0,3598.0,3416.0,0.949,17.956,111,39,12,27,72,40,32,0,0.0,0.0
1005,1951,26-09-2019 04:40:00,0,3570.0,3529.0,0.989,17.971,162,49,21,28,113,76,37,3,0.04,0.0
1005,1952,26-09-2019 04:42:00,0,3786.0,3583.0,0.946,18.884,356,153,106,47,203,147,56,43,0.0,0.0
1005,1953,26-09-2019 04:44:00,0,3797.0,3570.0,0.94,18.91,105,45,23,22,60,26,34,78,0.0,0.0
1005,1954,26-09-2019 04:46:00,0,3872.0,3667.0,0.947,19.317,84,33,14,19,51,13,38,68,0.0,0.0
1005,1955,26-09-2019 04:48:00,0,4063.0,3823.0,0.941,20.241,68,19,7,12,49,10,39,48,0.0,0.0
1005,1956,26-09-2019 04:50:00,0,4032.0,4000.0,0.992,20.316,119,46,21,25,73,16,57,55,0.0,0.15
1005,1957,26-09-2019 04:52:00,0,4222.0,4104.0,0.972,21.18,99,47,25,22,52,28,24,20,0.1,0.54
1005,1958,26-09-2019 04:54:00,0,3610.0,3396.0,0.941,17.984,25,5,3,2,20,8,12,0,0.0,0.0
1005,1959,26-09-2019 04:56:00,0,3645.0,3501.5,0.9605,18.238,8,0,0,0,8,3,5,0,0.0,0.0
1005,1960,26-09-2019 04:58:00,0,3680.0,3607.0,0.98,18.492,18,0,0,0,18,10,8,0,0.0,0.0
1005,1961,26-09-2019 05:00:00,0,3748.0,3714.0,0.991,18.88,11,6,5,1,5,1,4,0,0.0,0.0
1005,1962,26-09-2019 05:02:00,0,3774.0,3645.0,0.966,18.905,8,3,0,3,5,0,5,0,0.0,0.0
1005,1963,26-09-2019 05:04:00,0,3563.0,3592.0,1.008,18.015,6,0,0,0,6,2,4,0,0.01,0.0
1005,1964,26-09-2019 05:06:00,0,3457.0,3513.0,1.016,17.509,4,0,0,0,4,2,2,0,0.0,0.0
1005,1965,26-09-2019 05:08:00,0,3467.0,3505.0,1.011,17.54,8,0,0,0,8,6,2,0,0.0,0.0
1005,1966,26-09-2019 05:10:00,0,3434.0,3579.0,1.042,17.492,77,34,18,16,43,30,13,0,0.0,0.0
1005,1967,26-09-2019 05:12:00,0,3760.0,3712.0,0.987,18.923,230,98,62,36,132,96,36,17,0.0,0.0
1005,1968,26-09-2019 05:14:00,0,3744.0,3733.0,0.997,18.883,187,97,63,34,90,49,41,37,0.0,0.0
1005,1969,26-09-2019 05:16:00,0,3827.0,3889.0,1.016,19.383,184,125,76,49,59,20,39,71,0.0,0.0
1005,1970,26-09-2019 05:18:00,0,3919.0,4002.0,1.021,19.871,207,102,69,33,105,67,38,42,0.14,0.0
1005,1971,26-09-2019 05:20:00,0,4093.0,4158.0,1.016,20.729,73,32,13,19,41,8,33,52,0.0,0.0
1005,1972,26-09-2019 05:22:00,0,4163.0,4262.0,1.024,21.119,79,40,20,20,39,8,31,63,0.0,0.0
1005,1973,26-09-2019 05:24:00,0,4399.0,4403.0,1.001,22.206,82,32,22,10,50,14,36,78,0.0,0.0
1005,1974,26-09-2019 05:26:00,0,4383.0,4342.0,0.991,22.076,233,125,84,41,108,66,42,41,0.13,0.0
1005,1975,26-09-2019 05:28:00,0,2972.0,3122.0,1.05,15.167,296,199,149,50,97,73,24,49,0.0,0.0
1005,1976,26-09-2019 05:30:00,0,3275.5,3314.5,1.015,16.5755,392,201,156,45,191,144,47,36,0.07,0.0
1005,1977,26-09-2019 05:32:00,0,3579.0,3507.0,0.98,17.984,416,216,173,43,200,154,46,140,0.0,0.0
1005,1978,26-09-2019 05:34:00,0,3914.0,3953.0,1.01,19.796,553,258,201,57,295,227,68,88,0.01,0.0
1005,1979,26-09-2019 05:36:00,0,4966.0,5175.0,1.042,25.294,413,169,129,40,244,187,57,43,0.08,0.0
1005,1980,26-09-2019 05:38:00,0,4190.0,4171.0,0.995,21.127,523,327,255,72,196,149,47,60,0.0,0.0
1005,1981,26-09-2019 05:40:00,0,4540.0,4661.0,1.027,23.049,493,183,134,49,310,201,109,0,0.0,0.0
1005,1982,26-09-2019 05:42:00,0,4110.0,4117.0,1.002,20.753,473,276,205,71,197,138,59,2,0.0,0.0
1005,1983,26-09-2019 05:44:00,0,4194.0,4252.0,1.014,21.23,482,283,210,73,199,144,55,0,0.0,0.0
1005,1984,26-09-2019 05:46:00,0,4552.0,4577.0,1.006,23.002,473,240,188,52,233,182,51,28,0.01,0.0
1005,1985,26-09-2019 05:48:00,0,4211.0,4242.0,1.007,21.285,740,298,230,68,442,382,60,23,0.0,0.0
1005,1986,26-09-2019 05:50:00,0,4512.0,4616.0,1.023,22.886,251,121,75,46,130,106,24,65,0.0,0.0
1005,1987,26-09-2019 05:52:00,0,4532.0,4632.0,1.022,22.985,766,379,303,76,387,314,73,13,0.0,0.0
1005,1988,26-09-2019 05:54:00,0,4105.0,4210.0,1.025,20.835,679,320,254,66,359,278,81,6,0.0,0.0
1005,1989,26-09-2019 05:56:00,0,4062.0,4168.0,1.026,20.619,480,254,201,53,226,166,60,8,0.0,0.0
1005,1990,26-09-2019 05:58:00,0,4129.0,4154.0,1.006,20.868,74,34,9,25,40,31,9,0,0.0,0.0
1005,1991,26-09-2019 06:00:00,1,3932.0,3931.0,1.0,19.845,304,211,157,54,93,62,31,42,0.0,0.0
1005,1992,26-09-2019 06:02:00,1,4173.0,4212.0,1.009,21.102,501,253,204,49,248,198,50,125,0.01,0.0
1005,1993,26-09-2019 06:04:00,1,4145.0,4164.0,1.0045,20.94,385,159,122,37,226,181,45,19,0.09,0.0
1005,1994,26-09-2019 06:06:00,1,4117.0,4116.0,1.0,20.778,457,181,139,42,276,198,78,0,0.01,0.0
1005,1995,26-09-2019 06:08:00,1,4185.0,4196.0,1.003,21.132,656,348,273,75,308,248,60,20,0.0,0.0
1005,1996,26-09-2019 06:10:00,1,4112.0,4166.0,1.013,20.813,197,104,75,29,93,56,37,6,0.0,0.0
1005,1997,26-09-2019 06:12:00,1,4094.0,4089.0,0.999,20.656,76,58,29,29,18,11,7,0,0.0,0.0
1005,1998,26-09-2019 06:14:00,1,3915.0,3942.0,1.007,19.791,224,51,21,30,173,113,60,0,0.0,0.0
1005,1999,26-09-2019 06:16:00,1,3911.0,3949.0,1.01,19.779,28,7,0,7,21,9,12,0,0.0,0.0
1005,2000,26-09-2019 06:18:00,1,3740.0,3662.0,0.979,18.79,53,9,5,4,44,18,26,0,0.0,0.0
1005,2001,26-09-2019 06:20:00,1,3565.0,3481.0,0.977,17.9,20,0,0,0,20,4,16,0,0.0,0.0
1005,2002,26-09-2019 06:22:00,1,3492.0,3330.0,0.953,17.446,22,0,0,0,22,9,13,0,0.0,0.0
1005,2003,26-09-2019 06:24:00,1,3290.0,3207.0,0.975,16.511,17,6,4,2,11,1,10,0,0.0,0.0
1005,2004,26-09-2019 06:26:00,1,3307.0,3225.0,0.975,16.6,6,0,0,0,6,1,5,0,0.0,0.0
1005,2005,26-09-2019 06:28:00,1,3202.0,3129.0,0.977,16.08,10,4,2,2,6,0,6,0,0.0,0.0
1005,2006,26-09-2019 06:30:00,1,3312.0,3172.0,0.958,16.56,32,10,5,5,22,5,17,0,0.0,0.0
1005,2007,26-09-2019 06:32:00,1,3007.0,3003.0,0.999,15.171,19,6,0,6,13,1,12,0,0.0,0.0
1005,2008,26-09-2019 06:34:00,1,3018.0,2984.0,0.989,15.195,9,0,0,0,9,0,9,0,0.0,0.0
1005,2009,26-09-2019 06:36:00,1,3024.0,2947.0,0.975,15.175,15,0,0,0,15,3,12,0,0.0,0.0
1005,2010,26-09-2019 06:38:00,1,3071.5,2989.5,0.9735,15.4105,34,11,5,6,23,9,14,0,0.0,0.0
1005,2011,26-09-2019 06:40:00,1,3119.0,3032.0,0.972,15.646,13,2,0,2,11,0,11,0,0.0,0.0
1005,2012,26-09-2019 06:42:00,1,3143.0,2913.0,0.927,15.609,22,14,4,10,8,2,6,0,0.0,0.0
1005,2013,26-09-2019 06:44:00,1,3161.0,2930.0,0.927,15.7,17,8,5,3,9,0,9,0,0.0,0.0
1005,2014,26-09-2019 06:46:00,1,2953.0,2814.0,0.953,14.75,23,8,5,3,15,5,10,0,0.0,0.0
1005,2015,26-09-2019 06:48:00,1,2964.0,2744.0,0.926,14.717,16,7,2,5,9,2,7,0,0.0,0.0
1005,2016,26-09-2019 06:50:00,1,2968.0,2770.0,0.933,14.761,11,0,0,0,11,0,11,0,0.0,0.0
1005,2017,26-09-2019 06:52:00,1,2968.0,2751.0,0.927,14.741,44,16,10,6,28,14,14,0,0.0,0.0
1005,2018,26-09-2019 06:54:00,1,3146.0,2952.0,0.938,15.662,252,140,97,43,112,69,43,4,0.01,0.0
1005,2019,26-09-2019 06:56:00,1,3428.0,3225.0,0.941,17.078,63,36,4,32,27,15,12,0,0.0,0.0
1005,2020,26-09-2019 06:58:00,1,3430.0,3239.0,0.944,17.101,53,32,5,27,21,11,10,0,0.0,0.0
1005,2021,26-09-2019 07:00:00,1,3421.0,3240.0,0.947,17.064,102,14,10,4,88,52,36,0,0.0,0.0
1005,2022,26-09-2019 07:02:00,1,3426.0,3223.0,0.941,17.067,30,1,1,0,29,6,23,0,0.0,0.0
1005,2023,26-09-2019 07:04:00,1,3115.0,3064.0,0.984,15.666,16,4,2,2,12,4,8,0,0.0,0.0
1005,2024,26-09-2019 07:06:00,1,3126.0,2956.0,0.946,15.59,11,3,1,2,8,0,8,0,0.0,0.0
1005,2025,26-09-2019 07:08:00,1,3164.0,2886.0,0.912,15.661,10,2,0,2,8,2,6,0,0.0,0.0
1005,2026,26-09-2019 07:10:00,1,2948.0,2775.0,0.941,14.688,7,0,0,0,7,1,6,0,0.0,0.0
1005,2027,26-09-2019 07:12:00,1,2896.5,2786.0,0.962,14.4965,158,58,18,40,100,60,40,0,0.0,0.0
1005,2028,26-09-2019 07:14:00,1,2845.0,2797.0,0.983,14.305,173,72,34,38,101,54,47,0,0.0,0.0
1005,2029,26-09-2019 07:16:00,1,3030.0,2912.0,0.961,15.16,219,82,35,47,137,85,52,0,0.0,0.0
1005,2030,26-09-2019 07:18:00,1,3018.0,2986.0,0.989,15.197,127,56,28,28,71,40,31,0,0.0,0.0
1005,2031,26-09-2019 07:20:00,1,3314.0,3154.0,0.952,16.549,118,75,58,17,43,33,10,19,0.0,0.0
1005,2032,26-09-2019 07:22:00,1,3317.0,3154.0,0.951,16.559,177,77,52,25,100,73,27,25,0.0,0.0
1005,2033,26-09-2019 07:24:00,1,3495.0,3367.0,0.964,17.496,95,47,35,12,48,37,11,0,0.0,0.0
1005,2034,26-09-2019 07:26:00,1,3519.0,3286.0,0.934,17.502,250,162,119,43,88,62,26,20,0.0,0.0
1005,2035,26-09-2019 07:28:00,1,3519.0,3292.0,0.936,17.508,177,78,56,22,99,70,29,7,0.0,0.0
1005,2036,26-09-2019 07:30:00,1,3515.0,3288.0,0.936,17.488,213,163,121,42,50,26,24,0,0.0,0.0
1005,2037,26-09-2019 07:32:00,1,3508.0,3342.0,0.953,17.522,537,265,207,58,272,214,58,17,0.0,0.0
1005,2038,26-09-2019 07:34:00,1,3520.0,3314.0,0.941,17.537,573,280,224,56,293,213,80,7,0.0,0.0
1005,2039,26-09-2019 07:36:00,1,3501.0,3378.0,0.965,17.532,407,212,166,46,195,144,51,40,0.0,0.0
1005,2040,26-09-2019 07:38:00,1,3692.0,3424.0,0.927,18.338,86,19,4,15,67,27,40,56,0.0,0.0
1005,2041,26-09-2019 07:40:00,1,3816.0,3526.0,0.924,18.938,79,21,6,15,58,18,40,56,0.0,0.05
1005,2042,26-09-2019 07:42:00,1,3760.0,3662.0,0.974,18.866,247,131,93,38,116,71,45,27,0.0,0.13
1005,2043,26-09-2019 07:44:00,1,3526.0,3310.0,0.939,17.555,474,237,183,54,237,167,70,8,0.0,0.0
1005,2044,26-09-2019 07:46:00,1,3427.0,3207.0,0.936,17.051,337,125,85,40,212,146,66,0,0.0,0.0
1005,2045,26-09-2019 07:48:00,1,3328.0,3104.0,0.933,16.547,464,239,187,52,225,181,44,1,0.0,0.0
1005,2046,26-09-2019 07:50:00,1,3491.0,3382.0,0.969,17.498,613,333,259,74,280,205,75,0,0.03,0.0
1005,2047,26-09-2019 07:52:00,1,3775.0,3546.0,0.939,18.8,107,29,6,23,78,39,39,0,0.0,0.0
1005,2048,26-09-2019 07:54:00,1,3473.0,3417.0,0.984,17.468,35,2,0,2,33,12,21,0,0.01,0.0
1005,2049,26-09-2019 07:56:00,1,3482.0,3402.0,0.977,17.485,74,14,3,11,60,27,33,0,0.0,0.0
1005,2050,26-09-2019 07:58:00,1,3763.0,3604.0,0.958,18.815,96,22,9,13,74,39,35,0,0.0,0.0
1005,2051,26-09-2019 08:00:00,1,3779.0,3540.0,0.937,18.809,46,0,0,0,46,10,36,0,0.0,0.0
1005,2052,26-09-2019 08:02:00,1,3482.0,3394.0,0.975,17.474,46,5,3,2,41,20,21,0,0.0,0.0
1005,2053,26-09-2019 08:04:00,1,3291.0,3305.0,1.004,16.626,25,0,0,0,25,11,14,0,0.0,0.0
1005,2054,26-09-2019 08:06:00,1,3297.0,3198.0,0.97,16.531,21,0,0,0,21,3,18,0,0.0,0.0
1005,2055,26-09-2019 08:08:00,1,3317.0,3134.0,0.945,16.54,36,4,3,1,32,5,27,0,0.0,0.0
1005,2056,26-09-2019 08:10:00,1,3012.0,3031.0,1.007,15.222,40,13,3,10,27,3,24,0,0.0,0.0
1005,2057,26-09-2019 08:12:00,1,3023.0,2989.0,0.989,15.22,33,4,2,2,29,10,19,0,0.0,0.0
1005,2058,26-09-2019 08:14:00,1,3063.0,2883.0,0.941,15.258,49,12,5,7,37,18,19,0,0.0,0.0
1005,2059,26-09-2019 08:16:00,1,3039.0,2850.0,0.938,15.13,22,2,0,2,20,4,16,0,0.0,0.0
1005,2060,26-09-2019 08:18:00,1,2849.0,2794.0,0.981,14.319,31,8,0,8,23,2,21,0,0.0,0.0
1005,2061,26-09-2019 08:20:00,1,2852.5,2764.0,0.969,14.2985,55,21,0,21,34,6,28,0,0.0,0.0
1005,2062,26-09-2019 08:22:00,1,2856.0,2734.0,0.957,14.278,25,0,0,0,25,0,25,0,0.0,0.0
1005,2063,26-09-2019 08:24:00,1,2860.0,2726.0,0.953,14.287,47,7,4,3,40,14,26,0,0.0,0.0
1005,2064,26-09-2019 08:26:00,1,2843.0,2777.0,0.977,14.274,24,6,0,6,18,2,16,0,0.0,0.0
1005,2065,26-09-2019 08:28:00,1,2837.0,2799.0,0.986,14.278,18,0,0,0,18,2,16,0,0.0,0.0
1005,2066,26-09-2019 08:30:00,1,2849.0,2817.0,0.989,14.343,19,0,0,0,19,2,17,0,0.0,0.0
1005,2067,26-09-2019 08:32:00,1,2834.0,2776.0,0.979,14.239,14,0,0,0,14,0,14,0,0.0,0.0
1005,2068,26-09-2019 08:34:00,1,3060.0,2883.0,0.942,15.246,84,5,1,4,79,32,47,0,0.0,0.0
1005,2069,26-09-2019 08:36:00,1,3028.0,2985.0,0.986,15.234,62,0,0,0,62,22,40,0,0.0,0.0
1005,2070,26-09-2019 08:38:00,1,3007.0,3019.0,1.004,15.191,59,1,0,1,58,25,33,0,0.0,0.0
1005,2071,26-09-2019 08:40:00,1,3049.0,2850.0,0.935,15.168,63,4,1,3,59,25,34,0,0.0,0.0
1005,2072,26-09-2019 08:42:00,1,2970.0,2762.0,0.93,14.761,58,9,1,8,49,17,32,0,0.0,0.0
1005,2073,26-09-2019 08:44:00,1,2864.0,2671.0,0.933,14.241,82,12,3,9,70,27,43,0,0.0,0.0
1005,2074,26-09-2019 08:46:00,1,2883.0,2631.0,0.913,14.271,93,17,0,17,76,36,40,0,0.0,0.0
1005,2075,26-09-2019 08:48:00,1,2897.0,2580.0,0.891,14.269,120,9,1,8,111,79,32,0,0.0,0.0
1005,2076,26-09-2019 08:50:00,1,2907.0,2588.0,0.89,14.318,25,9,2,7,16,1,15,0,0.0,0.0
1005,2077,26-09-2019 08:52:00,1,2913.0,2518.0,0.864,14.265,52,13,9,4,39,15,24,0,0.0,0.0
1005,2078,26-09-2019 08:54:00,1,2948.0,2618.0,0.8875,14.5135,70,10,3,7,60,26,34,0,0.0,0.0
1005,2079,26-09-2019 08:56:00,1,2983.0,2718.0,0.911,14.762,62,0,0,0,62,13,49,0,0.0,0.0
1005,2080,26-09-2019 08:58:00,1,3073.0,2729.0,0.888,15.128,81,1,0,1,80,41,39,0,0.0,0.0
1005,2081,26-09-2019 09:00:00,1,3094.0,2671.0,0.863,15.146,60,0,0,0,60,29,31,0,0.0,0.0
1005,2082,26-09-2019 09:02:00,1,2887.0,2624.0,0.909,14.282,65,0,0,0,65,28,37,0,0.0,0.0
1005,2083,26-09-2019 09:04:00,1,2884.0,2610.0,0.905,14.253,101,3,2,1,98,52,46,0,0.0,0.0
1005,2084,26-09-2019 09:06:00,1,2888.0,2617.0,0.906,14.275,39,4,2,2,35,21,14,0,0.0,0.0
1005,2085,26-09-2019 09:08:00,1,2592.0,2385.0,0.92,12.852,2,0,0,0,2,0,2,0,0.0,0.0
1005,2086,26-09-2019 09:10:00,1,2614.0,2302.0,0.881,12.848,90,0,0,0,90,60,30,0,0.0,0.0
1005,2087,26-09-2019 09:12:00,1,2613.0,2297.0,0.879,12.839,79,6,2,4,73,20,53,0,0.0,0.0
1005,2088,26-09-2019 09:14:00,1,2821.0,2413.0,0.855,13.785,283,32,2,30,251,174,77,0,0.0,0.0
1005,2089,26-09-2019 09:16:00,1,2893.0,2567.0,0.887,14.24,181,41,5,36,140,89,51,0,0.0,0.0
1005,2090,26-09-2019 09:18:00,1,2882.0,2600.0,0.902,14.235,160,13,5,8,147,88,59,0,0.0,0.0
1005,2091,26-09-2019 09:20:00,1,2979.0,2648.0,0.889,14.668,80,6,2,4,74,50,24,0,0.0,0.0
1005,2092,26-09-2019 09:22:00,1,2912.0,2495.0,0.857,14.237,15,0,0,0,15,6,9,0,0.0,0.0
1005,2093,26-09-2019 09:24:00,1,2925.0,2488.0,0.85,14.279,147,69,51,18,78,53,25,30,0.0,0.0
1005,2094,26-09-2019 09:26:00,1,3081.0,2767.0,0.898,15.201,83,28,14,14,55,22,33,28,0.0,0.0
1005,2095,26-09-2019 09:28:00,1,3123.5,2809.0,0.8995,15.416,35,5,2,3,30,1,29,6,0.0,0.17
1005,2096,26-09-2019 09:30:00,1,3166.0,2851.0,0.901,15.631,25,0,0,0,25,0,25,0,0.0,0.01
1005,2097,26-09-2019 09:32:00,1,3177.0,2834.0,0.892,15.654,114,61,42,19,53,26,27,0,0.0,0.0
1005,2098,26-09-2019 09:34:00,1,3386.0,2945.0,0.87,16.601,597,340,279,61,257,209,48,12,0.0,0.0
1005,2099,26-09-2019 09:36:00,1,3328.0,3114.0,0.936,16.56,588,323,262,61,265,209,56,1,0.1,0.0
1005,2100,26-09-2019 09:38:00,1,3317.0,3143.0,0.948,16.547,566,298,231,67,268,202,66,8,0.0,0.0
1005,2101,26-09-2019 09:40:00,1,3526.0,3220.0,0.913,17.455,194,101,63,38,93,54,39,0,0.0,0.0
1005,2102,26-09-2019 09:42:00,1,3438.0,3207.0,0.933,17.097,146,45,27,18,101,63,38,0,0.0,0.0
1005,2103,26-09-2019 09:44:00,1,3331.0,3121.0,0.937,16.58,39,7,1,6,32,14,18,0,0.0,0.0
1005,2104,26-09-2019 09:46:00,1,3342.0,3084.0,0.923,16.582,66,4,0,4,62,31,31,0,0.0,0.0
1005,2105,26-09-2019 09:48:00,1,3522.0,3295.0,0.936,17.525,106,21,8,13,85,43,42,0,0.0,0.0
1005,2106,26-09-2019 09:50:00,1,3496.0,3349.0,0.958,17.48,80,38,11,27,42,11,31,0,0.0,0.0
1005,2107,26-09-2019 09:52:00,1,3492.0,3351.0,0.96,17.47,32,0,0,0,32,0,32,0,0.0,0.0
1005,2108,26-09-2019 09:54:00,1,3305.0,3180.0,0.962,16.542,33,9,2,7,24,2,22,0,0.0,0.0
1005,2109,26-09-2019 09:56:00,1,3037.0,2940.0,0.968,15.221,21,3,0,3,18,0,18,0,0.0,0.0
1005,2110,26-09-2019 09:58:00,1,3024.0,2924.0,0.967,15.153,28,5,4,1,23,2,21,0,0.0,0.0
1005,2111,26-09-2019 10:00:00,1,3222.0,3058.0,0.949,16.079,34,11,1,10,23,0,23,0,0.0,0.0
1005,2112,26-09-2019 10:02:00,1,3218.5,3049.0,0.9475,16.056,39,13,0,13,26,0,26,0,0.0,0.0
1005,2113,26-09-2019 10:04:00,1,3215.0,3040.0,0.946,16.033,28,2,0,2,26,0,26,0,0.0,0.0
1005,2114,26-09-2019 10:06:00,1,3141.0,2975.0,0.947,15.671,39,14,0,14,25,4,21,0,0.0,0.01
1005,2115,26-09-2019 10:08:00,1,3113.0,2993.0,0.961,15.58,85,40,16,24,45,15,30,0,0.0,0.0
1005,2116,26-09-2019 10:10:00,1,3399.0,3227.0,0.949,16.967,34,0,0,0,34,2,32,0,0.0,0.0
1005,2117,26-09-2019 10:12:00,1,3428.0,3144.0,0.917,16.985,36,8,2,6,28,0,28,0,0.0,0.0
1005,2118,26-09-2019 10:14:00,1,3222.0,3116.0,0.967,16.144,37,6,0,6,31,0,31,0,0.0,0.0
1005,2119,26-09-2019 10:16:00,1,3126.0,2990.0,0.957,15.626,88,29,19,10,59,21,38,0,0.0,0.0
1005,2120,26-09-2019 10:18:00,1,3123.0,3038.0,0.973,15.666,21,0,0,0,21,0,21,0,0.0,0.0
1005,2121,26-09-2019 10:20:00,1,3132.0,3033.0,0.968,15.697,19,0,0,0,19,0,19,0,0.0,0.0
1005,2122,26-09-2019 10:22:00,1,3124.0,3027.0,0.969,15.66,43,2,1,1,41,17,24,0,0.01,0.0
1005,2123,26-09-2019 10:24:00,1,3116.0,2987.0,0.959,15.582,101,27,14,13,74,37,37,0,0.0,0.0
1005,2124,26-09-2019 10:26:00,1,3441.0,3172.0,0.922,17.071,134,1,0,1,133,92,41,0,0.0,0.0
1005,2125,26-09-2019 10:28:00,1,3118.0,3073.0,0.985,15.688,120,0,0,0,120,65,55,0,0.0,0.0
1005,2126,26-09-2019 10:30:00,1,3149.0,2974.0,0.945,15.699,156,10,7,3,146,83,63,0,0.0,0.0
1005,2127,26-09-2019 10:32:00,1,3105.0,3034.0,0.977,15.592,226,18,10,8,208,156,52,0,0.0,0.0
1005,2128,26-09-2019 10:34:00,1,3139.0,2922.0,0.931,15.602,88,5,2,3,83,63,20,0,0.0,0.0
1005,2129,26-09-2019 10:36:00,1,3152.5,2894.0,0.918,15.6245,77,6,4,2,71,55,16,0,0.0,0.0
1005,2130,26-09-2019 10:38:00,1,3166.0,2866.0,0.905,15.647,456,0,0,0,456,424,32,0,0.0,0.0
1005,2131,26-09-2019 10:40:00,1,3152.0,2866.0,0.909,15.59,176,4,2,2,172,154,18,0,0.0,0.0
1005,2132,26-09-2019 10:42:00,1,2962.0,2720.0,0.918,14.681,79,0,0,0,79,60,19,0,0.0,0.0
1005,2133,26-09-2019 10:44:00,1,2981.0,2726.0,0.915,14.764,381,5,1,4,376,318,58,0,0.0,0.0
1005,2134,26-09-2019 10:46:00,1,2967.0,2723.0,0.918,14.704,450,3,2,1,447,369,78,0,0.0,0.0
1005,2135,26-09-2019 10:48:00,1,2949.0,2776.0,0.941,14.692,799,11,1,10,788,739,49,0,0.0,0.0
1005,2136,26-09-2019 10:50:00,1,3165.0,2833.0,0.895,15.608,831,30,4,26,801,753,48,0,0.0,0.0
1005,2137,26-09-2019 10:52:00,1,3166.0,2844.0,0.898,15.621,479,66,46,20,413,364,49,4,0.0,0.0
1005,2138,26-09-2019 10:54:00,1,3157.0,2905.0,0.92,15.656,35,0,0,0,35,14,21,0,0.0,0.0
1005,2139,26-09-2019 10:56:00,1,3167.0,2836.0,0.896,15.619,76,3,0,3,73,61,12,0,0.0,0.0
1005,2140,26-09-2019 10:58:00,1,3170.0,2855.0,0.901,15.651,44,1,0,1,43,24,19,0,0.0,0.0
1005,2141,26-09-2019 11:00:00,1,3180.0,2845.0,0.895,15.681,36,16,0,16,20,5,15,0,0.0,0.0
1005,2142,26-09-2019 11:02:00,1,3161.0,2851.0,0.902,15.609,103,22,8,14,81,38,43,0,0.0,0.0
1005,2143,26-09-2019 11:04:00,1,3166.0,2856.0,0.902,15.634,150,77,62,15,73,41,32,0,0.01,0.0
1005,2144,26-09-2019 11:06:00,1,2981.0,2735.0,0.917,14.773,54,7,3,4,47,19,28,0,0.0,0.0
1005,2145,26-09-2019 11:08:00,1,3002.0,2588.0,0.862,14.693,63,0,0,0,63,37,26,0,0.0,0.0
1005,2146,26-09-2019 11:10:00,1,3043.5,2670.0,0.877,14.948,114,13,5,8,101,75,26,0,0.0,0.0
1005,2147,26-09-2019 11:12:00,1,3085.0,2752.0,0.892,15.203,61,0,0,0,61,53,8,0,0.0,0.0
1005,2148,26-09-2019 11:14:00,1,2983.0,2663.0,0.893,14.699,66,0,0,0,66,53,13,0,0.0,0.0
1005,2149,26-09-2019 11:16:00,1,2990.0,2672.0,0.894,14.739,107,0,0,0,107,93,14,0,0.0,0.0
1005,2150,26-09-2019 11:18:00,1,2985.0,2710.0,0.908,14.761,126,0,0,0,126,90,36,0,0.0,0.0
1005,2151,26-09-2019 11:20:00,1,2985.0,2672.0,0.895,14.72,140,16,1,15,124,58,66,0,0.0,0.0
1005,2152,26-09-2019 11:22:00,1,3097.0,2705.0,0.873,15.198,171,34,5,29,137,82,55,0,0.0,0.0
1005,2153,26-09-2019 11:24:00,1,3201.0,2728.0,0.852,15.634,152,41,10,31,111,61,50,0,0.0,0.0
1005,2154,26-09-2019 11:26:00,1,3167.0,2833.0,0.895,15.612,180,82,60,22,98,55,43,0,0.0,0.0
1005,2155,26-09-2019 11:28:00,1,3269.0,2949.0,0.902,16.146,134,57,32,25,77,39,38,0,0.0,0.0
1005,2156,26-09-2019 11:30:00,1,3366.0,2979.0,0.885,16.56,227,14,7,7,213,123,90,0,0.0,0.0
1005,2157,26-09-2019 11:32:00,1,3371.0,2957.0,0.877,16.557,123,0,0,0,123,90,33,0,0.0,0.0
1005,2158,26-09-2019 11:34:00,1,3167.0,2819.0,0.89,15.599,130,2,0,2,128,89,39,0,0.0,0.0
1005,2159,26-09-2019 11:36:00,1,3203.0,2716.0,0.848,15.627,161,70,53,17,91,58,33,18,0.0,0.0
1005,2160,26-09-2019 11:38:00,1,3168.0,2813.0,0.888,15.597,156,64,39,25,92,44,48,54,0.0,0.0
1005,2161,26-09-2019 11:40:00,1,3476.0,2914.0,0.838,16.922,180,75,47,28,105,62,43,7,0.0,0.03
1005,2162,26-09-2019 11:42:00,1,3201.0,2692.0,0.841,15.593,196,38,21,17,158,114,44,0,0.0,0.0
1005,2163,26-09-2019 11:44:00,1,3103.5,2636.5,0.8495,15.1475,21,1,0,1,20,1,19,0,0.0,0.0
1005,2164,26-09-2019 11:46:00,1,3006.0,2581.0,0.858,14.702,37,8,2,6,29,0,29,0,0.0,0.0
1005,2165,26-09-2019 11:48:00,1,3005.0,2547.0,0.848,14.659,81,9,7,2,72,50,22,0,0.0,0.0
1005,2166,26-09-2019 11:50:00,1,2970.0,2670.0,0.899,14.658,84,0,0,0,84,35,49,0,0.0,0.0
1005,2167,26-09-2019 11:52:00,1,2979.0,2696.0,0.905,14.723,34,0,0,0,34,10,24,0,0.0,0.0
1005,2168,26-09-2019 11:54:00,1,2975.0,2700.0,0.908,14.71,54,2,1,1,52,20,32,0,0.0,0.0
1005,2169,26-09-2019 11:56:00,1,3074.0,2728.0,0.887,15.132,25,0,0,0,25,6,19,0,0.0,0.0
1005,2170,26-09-2019 11:58:00,1,3089.0,2734.0,0.885,15.198,109,15,9,6,94,58,36,0,0.0,0.0
1005,2171,26-09-2019 12:00:00,1,3178.0,2767.0,0.871,15.584,185,3,2,1,182,118,64,0,0.0,0.01
1005,2172,26-09-2019 12:02:00,1,3083.0,2718.0,0.882,15.156,103,7,3,4,96,68,28,0,0.0,0.0
1005,2173,26-09-2019 12:04:00,1,2985.0,2702.0,0.905,14.753,39,4,1,3,35,13,22,0,0.0,0.0
1005,2174,26-09-2019 12:06:00,1,2996.0,2684.0,0.896,14.774,72,16,6,10,56,28,28,0,0.0,0.0
1005,2175,26-09-2019 12:08:00,1,2992.0,2658.0,0.888,14.731,93,9,0,9,84,72,12,0,0.0,0.0
1005,2176,26-09-2019 12:10:00,1,3005.0,2614.0,0.87,14.734,85,3,0,3,82,51,31,0,0.0,0.0
1005,2177,26-09-2019 12:12:00,1,3006.0,2604.0,0.866,14.725,90,14,0,14,76,65,11,0,0.0,0.0
1005,2178,26-09-2019 12:14:00,1,3010.0,2616.0,0.869,14.757,207,66,52,14,141,100,41,3,0.0,0.0
1005,2179,26-09-2019 12:16:00,1,3187.0,2773.0,0.87,15.625,88,6,5,1,82,48,34,0,0.0,0.0
1005,2180,26-09-2019 12:18:00,1,3202.0,2732.5,0.8535,15.6405,67,0,0,0,67,30,37,0,0.0,0.0
1005,2181,26-09-2019 12:20:00,1,3217.0,2692.0,0.837,15.656,102,3,2,1,99,61,38,0,0.0,0.0
1005,2182,26-09-2019 12:22:00,1,3198.0,2704.0,0.845,15.594,50,6,3,3,44,18,26,0,0.0,0.0
1005,2183,26-09-2019 12:24:00,1,3235.0,2676.0,0.827,15.71,82,12,2,10,70,41,29,0,0.0,0.0
1005,2184,26-09-2019 12:26:00,1,3216.0,2607.0,0.811,15.558,37,0,0,0,37,14,23,0,0.0,0.0
1005,2185,26-09-2019 12:28:00,1,3029.0,2553.0,0.843,14.76,120,8,4,4,112,81,31,0,0.0,0.0
1005,2186,26-09-2019 12:30:00,1,3008.0,2546.0,0.846,14.671,50,3,2,1,47,18,29,0,0.0,0.0
1005,2187,26-09-2019 12:32:00,1,3036.0,2468.0,0.813,14.696,118,30,14,16,88,52,36,0,0.0,0.0
1005,2188,26-09-2019 12:34:00,1,3027.0,2471.0,0.816,14.664,62,5,1,4,57,31,26,0,0.0,0.0
1005,2189,26-09-2019 12:36:00,1,3053.0,2492.0,0.816,14.788,77,25,13,12,52,28,24,3,0.0,0.0
1005,2190,26-09-2019 12:38:00,1,3049.0,2465.0,0.808,14.744,147,62,39,23,85,60,25,1,0.0,0.0
1005,2191,26-09-2019 12:40:00,1,3240.0,2622.0,0.809,15.668,139,65,29,36,74,41,33,0,0.0,0.0
1005,2192,26-09-2019 12:42:00,1,3238.0,2609.0,0.806,15.647,106,49,25,24,57,28,29,0,0.0,0.0
1005,2193,26-09-2019 12:44:00,1,3220.0,2701.0,0.839,15.677,81,36,18,18,45,22,23,0,0.0,0.0
1005,2194,26-09-2019 12:46:00,1,3409.0,2850.0,0.836,16.586,143,81,49,32,62,30,32,42,0.0,0.0
1005,2195,26-09-2019 12:48:00,1,3583.0,3018.0,0.842,17.459,97,52,29,23,45,22,23,37,0.0,0.01
1005,2196,26-09-2019 12:50:00,1,3468.0,2955.0,0.852,16.935,272,120,91,29,152,102,50,38,0.0,0.08
1005,2197,26-09-2019 12:52:00,1,3525.5,2985.5,0.847,17.195,413,161,114,47,252,192,60,27,0.04,0.03
1005,2198,26-09-2019 12:54:00,1,3583.0,3016.0,0.842,17.455,640,286,236,50,354,285,69,5,0.05,0.0
1005,2199,26-09-2019 12:56:00,1,3499.0,2877.0,0.822,16.971,320,40,29,11,280,220,60,10,0.0,0.0
1005,2200,26-09-2019 12:58:00,1,3411.0,2852.0,0.836,16.597,553,54,42,12,499,413,86,0,0.0,0.0
1005,2201,26-09-2019 13:00:00,1,3465.0,3031.0,0.875,17.01,584,249,199,50,335,257,78,3,0.0,0.0
1005,2202,26-09-2019 13:02:00,1,3475.0,2950.0,0.849,16.958,82,38,5,33,44,18,26,0,0.0,0.0
1005,2203,26-09-2019 13:04:00,1,3376.0,2855.0,0.846,16.461,68,24,2,22,44,18,26,0,0.0,0.0
1005,2204,26-09-2019 13:06:00,1,3497.0,2958.0,0.846,17.053,73,21,1,20,52,17,35,0,0.0,0.0
1005,2205,26-09-2019 13:08:00,1,3370.0,2893.0,0.858,16.482,17,0,0,0,17,2,15,0,0.0,0.0
1005,2206,26-09-2019 13:10:00,1,3176.0,2816.0,0.886,15.631,33,5,1,4,28,6,22,0,0.0,0.0
1005,2207,26-09-2019 13:12:00,1,3171.0,2834.0,0.894,15.63,16,1,0,1,15,0,15,0,0.0,0.0
1005,2208,26-09-2019 13:14:00,1,3172.0,2796.0,0.881,15.591,77,49,28,21,28,7,21,0,0.0,0.0
1005,2209,26-09-2019 13:16:00,1,3206.0,2722.0,0.849,15.646,14,0,0,0,14,2,12,0,0.0,0.0
1005,2210,26-09-2019 13:18:00,1,3098.0,2700.0,0.871,15.195,19,0,0,0,19,0,19,0,0.0,0.0
1005,2211,26-09-2019 13:20:00,1,3092.0,2694.0,0.871,15.164,122,16,7,9,106,90,16,0,0.0,0.0
1005,2212,26-09-2019 13:22:00,1,3197.0,2734.0,0.855,15.625,54,21,3,18,33,27,6,0,0.0,0.0
1005,2213,26-09-2019 13:24:00,1,3196.0,2777.0,0.869,15.668,63,21,2,19,42,38,4,0,0.0,0.0
1005,2214,26-09-2019 13:26:00,1,3143.5,2737.5,0.871,15.4155,568,9,0,9,559,516,43,0,0.0,0.0
1005,2215,26-09-2019 13:28:00,1,3091.0,2698.0,0.873,15.163,990,19,6,13,971,917,54,0,0.0,0.0
1005,2216,26-09-2019 13:30:00,1,3004.0,2659.0,0.885,14.78,653,0,0,0,653,590,63,0,0.0,0.0
1005,2217,26-09-2019 13:32:00,1,3009.0,2586.0,0.859,14.72,531,26,16,10,505,413,92,0,0.0,0.0
1005,2218,26-09-2019 13:34:00,1,3219.0,2708.0,0.841,15.681,510,3,1,2,507,438,69,0,0.0,0.0
1005,2219,26-09-2019 13:36:00,1,3202.0,2748.0,0.858,15.656,339,3,2,1,336,303,33,0,0.0,0.0
1005,2220,26-09-2019 13:38:00,1,3112.0,2628.0,0.844,15.172,284,3,1,2,281,237,44,0,0.0,0.0
1005,2221,26-09-2019 13:40:00,1,3004.0,2606.0,0.868,14.721,634,0,0,0,634,590,44,0,0.0,0.0
1005,2222,26-09-2019 13:42:00,1,3020.0,2553.0,0.846,14.724,93,1,0,1,92,36,56,0,0.0,0.0
1005,2223,26-09-2019 13:44:00,1,3027.0,2516.0,0.831,14.712,256,2,0,2,254,201,53,0,0.0,0.0
1005,2224,26-09-2019 13:46:00,1,3028.0,2519.0,0.832,14.721,136,11,2,9,125,115,10,0,0.0,0.0
1005,2225,26-09-2019 13:48:00,1,3040.0,2475.0,0.814,14.717,330,0,0,0,330,310,20,0,0.0,0.0
1005,2226,26-09-2019 13:50:00,1,3050.0,2466.0,0.809,14.746,213,0,0,0,213,176,37,0,0.0,0.0
1005,2227,26-09-2019 13:52:00,1,3049.0,2460.0,0.807,14.738,287,79,48,31,208,140,68,3,0.0,0.0
1005,2228,26-09-2019 13:54:00,1,3040.0,2461.0,0.81,14.702,116,5,2,3,111,59,52,0,0.0,0.0
1005,2229,26-09-2019 13:56:00,1,2959.0,2389.0,0.808,14.304,85,1,0,1,84,37,47,0,0.0,0.0
1005,2230,26-09-2019 13:58:00,1,2842.0,2342.0,0.824,13.792,100,10,5,5,90,55,35,0,0.0,0.0
1005,2231,26-09-2019 14:00:00,1,2789.5,2330.5,0.8355,13.572,146,32,19,13,114,63,51,0,0.0,0.0
1005,2232,26-09-2019 14:02:00,1,2737.0,2319.0,0.847,13.352,267,142,87,55,125,83,42,0,0.0,0.0
1005,2233,26-09-2019 14:04:00,1,3040.0,2427.0,0.798,14.667,116,72,33,39,44,19,25,0,0.0,0.0
1005,2234,26-09-2019 14:06:00,1,3022.0,2513.0,0.832,14.687,93,41,8,33,52,20,32,0,0.0,0.0
1005,2235,26-09-2019 14:08:00,1,3222.0,2681.0,0.832,15.663,178,92,58,34,86,47,39,32,0.0,0.0
1005,2236,26-09-2019 14:10:00,1,3295.0,2790.0,0.846,16.073,137,73,41,32,64,34,30,54,0.0,0.02
1005,2237,26-09-2019 14:12:00,1,3494.0,2903.0,0.831,16.98,107,21,15,6,86,52,34,39,0.0,0.0
1005,2238,26-09-2019 14:14:00,1,3485.0,2922.0,0.839,16.965,95,56,31,25,39,13,26,52,0.0,0.02
1005,2239,26-09-2019 14:16:00,1,3672.0,3087.0,0.841,17.886,105,20,9,11,85,48,37,47,0.0,0.11
1005,2240,26-09-2019 14:18:00,1,3670.0,3114.0,0.849,17.909,476,228,174,54,248,187,61,14,0.09,0.09
1005,2241,26-09-2019 14:20:00,1,3468.0,2984.0,0.861,16.968,849,394,319,75,455,354,101,2,0.0,0.0
1005,2242,26-09-2019 14:22:00,1,3279.0,2859.0,0.872,16.084,357,179,144,35,178,130,48,0,0.05,0.0
1005,2243,26-09-2019 14:24:00,1,3174.0,2822.0,0.889,15.629,20,0,0,0,20,3,17,0,0.0,0.0
1005,2244,26-09-2019 14:26:00,1,3185.0,2707.0,0.85,15.545,12,0,0,0,12,0,12,0,0.0,0.0
1005,2245,26-09-2019 14:28:00,1,3204.0,2692.0,0.84,15.606,20,2,0,2,18,2,16,0,0.0,0.0
1005,2246,26-09-2019 14:30:00,1,3090.0,2675.0,0.866,15.138,34,0,0,0,34,0,34,0,0.0,0.0
1005,2247,26-09-2019 14:32:00,1,3093.0,2682.0,0.867,15.157,18,0,0,0,18,2,16,0,0.0,0.0
1005,2248,26-09-2019 14:34:00,1,3043.5,2677.5,0.88,14.957,33,3,1,2,30,9,21,0,0.0,0.0
1005,2249,26-09-2019 14:36:00,1,2994.0,2673.0,0.893,14.757,17,0,0,0,17,1,16,0,0.0,0.0
1005,2250,26-09-2019 14:38:00,1,2959.0,2717.0,0.918,14.668,28,0,0,0,28,16,12,0,0.0,0.0
1005,2251,26-09-2019 14:40:00,1,3189.0,2778.0,0.871,15.638,90,0,0,0,90,45,45,0,0.01,0.0
1005,2252,26-09-2019 14:42:00,1,3156.0,2873.0,0.91,15.616,39,1,0,1,38,18,20,0,0.0,0.0
1005,2253,26-09-2019 14:44:00,1,3141.0,2990.0,0.952,15.685,25,0,0,0,25,8,17,0,0.0,0.0
1005,2254,26-09-2019 14:46:00,1,3142.0,2975.0,0.947,15.674,23,0,0,0,23,2,21,0,0.0,0.0
1005,2255,26-09-2019 14:48:00,1,3168.0,2847.0,0.899,15.632,23,12,4,8,11,2,9,0,0.0,0.0
1005,2256,26-09-2019 14:50:00,1,3066.0,2832.0,0.924,15.218,42,24,1,23,18,0,18,0,0.0,0.0
1005,2257,26-09-2019 14:52:00,1,3073.0,2814.0,0.916,15.222,15,0,0,0,15,2,13,0,0.0,0.0
1005,2258,26-09-2019 14:54:00,1,3182.0,2821.0,0.886,15.661,37,0,0,0,37,16,21,0,0.0,0.0
1005,2259,26-09-2019 14:56:00,1,3182.0,2832.0,0.89,15.673,77,0,0,0,77,55,22,0,0.0,0.0
1005,2260,26-09-2019 14:58:00,1,2969.0,2778.0,0.936,14.772,82,12,2,10,70,38,32,0,0.0,0.0
1005,2261,26-09-2019 15:00:00,1,3162.0,2891.0,0.914,15.658,60,1,0,1,59,30,29,0,0.0,0.0
1005,2262,26-09-2019 15:02:00,1,3165.0,2912.0,0.92,15.695,33,0,0,0,33,31,2,0,0.0,0.0
1005,2263,26-09-2019 15:04:00,1,3154.0,2823.0,0.895,15.553,93,0,0,0,93,51,42,0,0.0,0.0
1005,2264,26-09-2019 15:06:00,1,3180.0,2869.0,0.902,15.705,94,10,4,6,84,48,36,0,0.0,0.0
1005,2265,26-09-2019 15:08:00,1,3076.0,2763.0,0.898,15.1775,13,0,0,0,13,3,10,0,0.0,0.0
1005,2266,26-09-2019 15:10:00,1,2972.0,2657.0,0.894,14.65,33,7,4,3,26,15,11,0,0.0,0.0
1005,2267,26-09-2019 15:12:00,1,2993.0,2580.0,0.862,14.649,43,6,3,3,37,29,8,0,0.0,0.0
1005,2268,26-09-2019 15:14:00,1,2686.0,2485.0,0.925,13.333,97,16,8,8,81,50,31,0,0.0,0.0
1005,2269,26-09-2019 15:16:00,1,2673.0,2504.0,0.937,13.303,76,2,1,1,74,38,36,0,0.0,0.0
1005,2270,26-09-2019 15:18:00,1,2692.0,2509.0,0.932,13.382,25,0,0,0,25,11,14,0,0.0,0.0
1005,2271,26-09-2019 15:20:00,1,3004.0,2568.0,0.855,14.678,22,1,0,1,21,10,11,0,0.0,0.0
1005,2272,26-09-2019 15:22:00,1,3013.0,2602.0,0.863,14.753,80,2,1,1,78,47,31,0,0.0,0.0
1005,2273,26-09-2019 15:24:00,1,3028.0,2569.0,0.848,14.774,53,1,1,0,52,22,30,0,0.0,0.0
1005,2274,26-09-2019 15:26:00,1,2997.0,2578.0,0.86,14.661,64,9,0,9,55,33,22,0,0.0,0.0
1005,2275,26-09-2019 15:28:00,1,3018.0,2553.0,0.846,14.716,43,1,0,1,42,17,25,0,0.0,0.0
1005,2276,26-09-2019 15:30:00,1,3026.0,2527.0,0.835,14.722,106,3,1,2,103,62,41,0,0.0,0.0
1005,2277,26-09-2019 15:32:00,1,3016.0,2536.0,0.841,14.692,66,14,6,8,52,20,32,0,0.0,0.0
1005,2278,26-09-2019 15:34:00,1,3019.0,2565.0,0.85,14.736,104,32,13,19,72,45,27,0,0.0,0.0
1005,2279,26-09-2019 15:36:00,1,2925.0,2528.0,0.864,14.323,42,2,0,2,40,27,13,0,0.0,0.0
1005,2280,26-09-2019 15:38:00,1,2713.0,2387.0,0.88,13.331,38,2,1,1,36,27,9,0,0.0,0.0
1005,2281,26-09-2019 15:40:00,1,2626.0,2306.0,0.878,12.898,45,0,0,0,45,18,27,0,0.0,0.0
1005,2282,26-09-2019 15:42:00,1,2714.0,2386.0,0.879,13.3335,98,29,5,24,69,34,35,0,0.0,0.0
1005,2283,26-09-2019 15:44:00,1,2802.0,2466.0,0.88,13.769,122,28,7,21,94,45,49,1,0.0,0.0
1005,2284,26-09-2019 15:46:00,1,2996.0,2629.0,0.877,14.717,80,10,3,7,70,35,35,3,0.0,0.0
1005,2285,26-09-2019 15:48:00,1,3183.0,2821.0,0.886,15.664,170,54,37,17,116,58,58,35,0.0,0.0
1005,2286,26-09-2019 15:50:00,1,3475.0,3028.0,0.871,17.045,134,56,28,28,78,30,48,49,0.0,0.0
1005,2287,26-09-2019 15:52:00,1,3442.0,3073.0,0.893,16.964,201,81,56,25,120,66,54,45,0.01,0.05
1005,2288,26-09-2019 15:54:00,1,3358.0,3014.0,0.897,16.568,173,58,36,22,115,73,42,36,0.07,0.0
1005,2289,26-09-2019 15:56:00,1,3231.0,2992.0,0.926,16.043,383,122,90,32,261,203,58,40,0.0,0.01
1005,2290,26-09-2019 15:58:00,1,3344.0,3023.0,0.904,16.52,303,120,80,40,183,119,64,61,0.05,0.0
1005,2291,26-09-2019 16:00:00,1,3436.0,3176.0,0.924,17.053,531,229,182,47,302,238,64,41,0.03,0.0
1005,2292,26-09-2019 16:02:00,1,3461.0,3047.0,0.88,17.009,108,55,35,20,53,26,27,16,0.0,0.0
1005,2293,26-09-2019 16:04:00,1,3417.0,3216.0,0.941,17.021,137,43,34,9,94,58,36,0,0.0,0.0
1005,2294,26-09-2019 16:06:00,1,3416.0,3230.0,0.946,17.035,27,1,1,0,26,10,16,0,0.0,0.0
1005,2295,26-09-2019 16:08:00,1,3408.0,3186.0,0.935,16.955,25,0,0,0,25,9,16,0,0.0,0.0
1005,2296,26-09-2019 16:10:00,1,3416.0,3195.0,0.935,16.998,21,2,0,2,19,5,14,0,0.0,0.0
1005,2297,26-09-2019 16:12:00,1,3606.0,3350.0,0.929,17.918,51,6,3,3,45,20,25,0,0.0,0.0
1005,2298,26-09-2019 16:14:00,1,3588.0,3459.0,0.964,17.966,65,6,2,4,59,32,27,0,0.0,0.0
1005,2299,26-09-2019 16:16:00,1,3514.0,3314.5,0.9425,17.514,31,4,3,1,27,10,17,0,0.0,0.0
1005,2300,26-09-2019 16:18:00,1,3440.0,3170.0,0.921,17.062,23,0,0,0,23,7,16,0,0.0,0.0
1005,2301,26-09-2019 16:20:00,1,3346.0,3087.0,0.923,16.601,18,0,0,0,18,4,14,0,0.0,0.0
1005,2302,26-09-2019 16:22:00,1,3154.0,2928.0,0.928,15.667,25,0,0,0,25,6,19,0,0.01,0.0
1005,2303,26-09-2019 16:24:00,1,3151.0,2942.0,0.934,15.672,17,0,0,0,17,4,13,0,0.0,0.0
1005,2304,26-09-2019 16:26:00,1,3145.0,2951.0,0.938,15.658,13,0,0,0,13,0,13,0,0.0,0.0
1005,2305,26-09-2019 16:28:00,1,3143.0,2922.0,0.93,15.619,26,0,0,0,26,8,18,0,0.0,0.0
1005,2306,26-09-2019 16:30:00,1,3167.0,2821.0,0.891,15.601,13,0,0,0,13,0,13,0,0.0,0.0
1005,2307,26-09-2019 16:32:00,1,3173.0,2805.0,0.884,15.607,16,0,0,0,16,4,12,0,0.0,0.0
1005,2308,26-09-2019 16:34:00,1,3079.0,2767.0,0.899,15.196,39,0,0,0,39,9,30,0,0.0,0.0
1005,2309,26-09-2019 16:36:00,1,2970.0,2718.0,0.915,14.709,70,7,1,6,63,20,43,0,0.0,0.0
1005,2310,26-09-2019 16:38:00,1,3078.0,2728.0,0.886,15.148,38,3,3,0,35,16,19,0,0.0,0.0
1005,2311,26-09-2019 16:40:00,1,3093.0,2723.0,0.88,15.2,37,4,3,1,33,13,20,0,0.0,0.0
1005,2312,26-09-2019 16:42:00,1,2982.0,2650.0,0.888,14.683,41,0,0,0,41,27,14,0,0.0,0.0
1005,2313,26-09-2019 16:44:00,1,3016.0,2582.0,0.856,14.742,60,1,0,1,59,29,30,0,0.0,0.0
1005,2314,26-09-2019 16:46:00,1,2985.0,2620.0,0.878,14.66,28,0,0,0,28,8,20,0,0.0,0.0
1005,2315,26-09-2019 16:48:00,1,2933.0,2478.0,0.845,14.3,41,0,0,0,41,13,28,0,0.0,0.0
1005,2316,26-09-2019 16:50:00,1,2824.5,2419.0,0.857,13.8065,36,0,0,0,36,16,20,0,0.0,0.0
1005,2317,26-09-2019 16:52:00,1,2716.0,2360.0,0.869,13.313,33,0,0,0,33,13,20,0,0.0,0.0
1005,2318,26-09-2019 16:54:00,1,2733.0,2342.0,0.857,13.362,24,2,1,1,22,11,11,0,0.0,0.0
1005,2319,26-09-2019 16:56:00,1,2729.0,2348.0,0.86,13.353,49,3,2,1,46,25,21,0,0.0,0.0
1005,2320,26-09-2019 16:58:00,1,2728.0,2338.0,0.857,13.336,24,0,0,0,24,11,13,0,0.0,0.0
1005,2321,26-09-2019 17:00:00,1,2752.0,2277.0,0.828,13.364,119,47,35,12,72,31,41,31,0.0,0.0
1005,2322,26-09-2019 17:02:00,1,3121.0,2592.0,0.83,15.165,158,60,33,27,98,44,54,60,0.0,0.01
1005,2323,26-09-2019 17:04:00,1,3388.0,2832.0,0.836,16.484,129,52,20,32,77,26,51,60,0.0,0.0
1005,2324,26-09-2019 17:06:00,1,3394.0,2841.0,0.837,16.52,91,15,2,13,76,29,47,62,0.0,0.0
1005,2325,26-09-2019 17:08:00,1,3474.0,2942.0,0.847,16.946,126,49,20,29,77,30,47,48,0.0,0.11
1005,2326,26-09-2019 17:10:00,1,3682.0,3126.0,0.849,17.969,218,109,86,23,109,69,40,53,0.0,0.06
1005,2327,26-09-2019 17:12:00,1,3271.0,2880.0,0.88,16.078,193,65,32,33,128,81,47,0,0.0,0.0
1005,2328,26-09-2019 17:14:00,1,3255.0,2904.0,0.892,16.038,140,14,6,8,126,103,23,0,0.0,0.01
1005,2329,26-09-2019 17:16:00,1,3157.0,2858.0,0.905,15.605,117,5,1,4,112,83,29,0,0.0,0.0
1005,2330,26-09-2019 17:18:00,1,3146.0,2901.0,0.922,15.607,72,2,0,2,70,58,12,0,0.0,0.0
1005,2331,26-09-2019 17:20:00,1,3164.0,2882.0,0.911,15.656,87,1,0,1,86,63,23,0,0.0,0.0
1005,2332,26-09-2019 17:22:00,1,3186.0,2798.0,0.878,15.651,107,3,2,1,104,59,45,0,0.0,0.0
1005,2333,26-09-2019 17:24:00,1,3072.0,2769.0,0.902,15.17,247,1,0,1,246,192,54,0,0.0,0.0
1005,2334,26-09-2019 17:26:00,1,2958.0,2740.0,0.926,14.689,94,0,0,0,94,43,51,0,0.0,0.0
1005,2335,26-09-2019 17:28:00,1,2984.0,2716.0,0.91,14.763,104,0,0,0,104,58,46,0,0.0,0.0
1005,2336,26-09-2019 17:30:00,1,3184.0,2801.0,0.88,15.646,81,1,1,0,80,46,34,0,0.0,0.0
1005,2337,26-09-2019 17:32:00,1,3169.0,2862.0,0.903,15.653,87,1,1,0,86,56,30,0,0.0,0.0
1005,2338,26-09-2019 17:34:00,1,3180.0,2843.0,0.894,15.677,90,1,1,0,89,58,31,0,0.0,0.0
1005,2339,26-09-2019 17:36:00,1,3141.0,2870.0,0.914,15.551,84,1,1,0,83,46,37,0,0.0,0.0
1005,2340,26-09-2019 17:38:00,1,3169.0,2894.0,0.913,15.69,76,1,1,0,75,46,29,0,0.0,0.0
1005,2341,26-09-2019 17:40:00,1,3132.0,2943.0,0.94,15.598,85,2,0,2,83,47,36,0,0.0,0.0
1005,2342,26-09-2019 17:42:00,1,3158.0,2939.0,0.931,15.698,113,8,3,5,105,59,46,0,0.0,0.0
1005,2343,26-09-2019 17:44:00,1,3442.0,3173.0,0.922,17.076,146,19,11,8,127,73,54,0,0.0,0.0
1005,2344,26-09-2019 17:46:00,1,3378.0,3280.0,0.971,16.941,95,6,2,4,89,49,40,0,0.0,0.0
1005,2345,26-09-2019 17:48:00,1,3618.0,3413.0,0.943,18.035,133,1,1,0,132,82,50,0,0.0,0.0
1005,2346,26-09-2019 17:50:00,1,3580.0,3427.0,0.957,17.898,80,1,0,1,79,43,36,1,0.0,0.0
1005,2347,26-09-2019 17:52:00,1,3583.0,3443.0,0.961,17.93,124,11,6,5,113,68,45,0,0.0,0.0
1005,2348,26-09-2019 17:54:00,1,3899.0,3531.0,0.906,19.272,87,3,2,1,84,53,31,0,0.0,0.0
1005,2349,26-09-2019 17:56:00,1,3897.0,3553.0,0.912,19.288,73,0,0,0,73,42,31,0,0.0,0.0
1005,2350,26-09-2019 17:58:00,1,3670.0,3351.5,0.9135,18.1715,51,0,0,0,51,28,23,0,0.0,0.0
1005,2351,26-09-2019 18:00:00,0,3443.0,3150.0,0.915,17.055,243,101,81,20,142,91,51,1,0.01,0.0
1005,2352,26-09-2019 18:02:00,0,3425.0,3179.0,0.928,17.015,771,508,421,87,263,205,58,1,0.0,0.0
1005,2353,26-09-2019 18:04:00,0,4114.0,3663.0,0.89,20.267,647,366,285,81,281,222,59,24,0.0,0.0
1005,2354,26-09-2019 18:06:00,0,4102.0,3629.0,0.885,20.179,451,292,245,47,159,122,37,70,0.0,0.0
1005,2355,26-09-2019 18:08:00,0,4119.0,3684.0,0.894,20.308,447,234,185,49,213,175,38,70,0.0,0.0
1005,2356,26-09-2019 18:10:00,0,4103.0,3739.0,0.911,20.306,473,287,225,62,186,140,46,15,0.0,0.0
1005,2357,26-09-2019 18:12:00,0,4104.0,3697.0,0.901,20.265,268,179,128,51,89,50,39,13,0.0,0.0
1005,2358,26-09-2019 18:14:00,0,4127.0,3651.0,0.885,20.301,393,234,189,45,159,120,39,13,0.0,0.0
1005,2359,26-09-2019 18:16:00,0,4100.0,3670.0,0.895,20.217,596,325,270,55,271,209,62,10,0.0,0.0
1005,2360,26-09-2019 18:18:00,0,4117.0,3619.0,0.879,20.226,235,73,36,37,162,96,66,4,0.0,0.0
1005,2361,26-09-2019 18:20:00,0,4147.0,3476.0,0.838,20.187,167,65,35,30,102,59,43,1,0.0,0.0
1005,2362,26-09-2019 18:22:00,0,3929.0,3421.0,0.871,19.267,342,199,136,63,143,102,41,1,0.0,0.0
1005,2363,26-09-2019 18:24:00,0,3922.0,3454.0,0.881,19.277,165,42,23,19,123,83,40,0,0.0,0.0
1005,2364,26-09-2019 18:26:00,0,3953.0,3366.0,0.852,19.3,33,0,0,0,33,11,22,0,0.0,0.0
1005,2365,26-09-2019 18:28:00,0,3677.0,3122.0,0.849,17.943,35,1,1,0,34,3,31,0,0.0,0.0
1005,2366,26-09-2019 18:30:00,0,3496.0,2945.0,0.842,17.033,408,203,153,50,205,151,54,7,0.0,0.0
1005,2367,26-09-2019 18:32:00,0,3593.0,2989.0,0.832,17.4655,408,167,134,33,241,194,47,33,0.0,0.0
1005,2368,26-09-2019 18:34:00,0,3690.0,3033.0,0.822,17.898,776,2,0,2,774,691,83,0,0.0,0.0
1005,2369,26-09-2019 18:36:00,0,3505.0,2855.0,0.815,16.971,613,4,0,4,609,533,76,0,0.0,0.0
1005,2370,26-09-2019 18:38:00,0,3210.0,2702.0,0.842,15.638,370,4,2,2,366,324,42,0,0.0,0.0
1005,2371,26-09-2019 18:40:00,0,3135.0,2541.0,0.81,15.165,235,63,34,29,172,122,50,0,0.0,0.0
1005,2372,26-09-2019 18:42:00,0,3229.0,2646.0,0.82,15.65,365,182,135,47,183,137,46,0,0.0,0.0
1005,2373,26-09-2019 18:44:00,0,3511.0,2882.0,0.821,17.024,634,406,335,71,228,180,48,19,0.0,0.0
1005,2374,26-09-2019 18:46:00,0,3719.0,2995.0,0.805,17.968,185,73,39,34,112,84,28,1,0.0,0.0
1005,2375,26-09-2019 18:48:00,0,3704.0,2977.0,0.804,17.89,247,66,25,41,181,134,47,0,0.0,0.0
1005,2376,26-09-2019 18:50:00,0,3741.0,2924.0,0.782,17.98,301,170,128,42,131,97,34,9,0.0,0.0
1005,2377,26-09-2019 18:52:00,0,3625.0,2894.0,0.798,17.489,355,192,139,53,163,118,45,29,0.0,0.0
1005,2378,26-09-2019 18:54:00,0,3690.0,2978.0,0.807,17.834,434,224,175,49,210,156,54,92,0.0,0.0
1005,2379,26-09-2019 18:56:00,0,4010.0,3182.0,0.793,19.323,406,204,161,43,202,161,41,13,0.0,0.0
1005,2380,26-09-2019 18:58:00,0,4006.0,3093.0,0.772,19.207,439,266,217,49,173,120,53,42,0.0,0.0
1005,2381,26-09-2019 19:00:00,0,4018.0,3097.0,0.771,19.26,224,128,79,49,96,49,47,7,0.0,0.0
1005,2382,26-09-2019 19:02:00,0,4024.0,3072.0,0.763,19.255,423,237,172,65,186,138,48,27,0.0,0.0
1005,2383,26-09-2019 19:04:00,0,4004.0,3124.0,0.78,19.234,107,63,31,32,44,25,19,0,0.0,0.0
1005,2384,26-09-2019 19:06:00,0,3956.5,3095.0,0.782,19.015,60,48,17,31,12,7,5,0,0.0,0.0
1005,2385,26-09-2019 19:08:00,0,3909.0,3066.0,0.784,18.796,38,25,7,18,13,8,5,0,0.0,0.0
1005,2386,26-09-2019 19:10:00,0,3903.0,3100.0,0.794,18.812,17,3,0,3,14,7,7,0,0.0,0.0
1005,2387,26-09-2019 19:12:00,0,3624.0,2908.0,0.803,17.498,22,4,2,2,18,11,7,0,0.0,0.0
1005,2388,26-09-2019 19:14:00,0,3443.0,2679.0,0.778,16.53,20,2,1,1,18,14,4,0,0.0,0.0
1005,2389,26-09-2019 19:16:00,0,3261.0,2532.0,0.777,15.652,11,2,0,2,9,6,3,0,0.0,0.0
1005,2390,26-09-2019 19:18:00,0,3279.0,2463.0,0.751,15.646,23,20,10,10,3,2,1,0,0.0,0.0
1005,2391,26-09-2019 19:20:00,0,3063.0,2410.0,0.787,14.735,6,2,1,1,4,3,1,0,0.0,0.0
1005,2392,26-09-2019 19:22:00,0,3067.0,2374.0,0.774,14.712,1,0,0,0,1,1,0,0,0.0,0.0
1005,2393,26-09-2019 19:24:00,0,3100.0,2289.0,0.738,14.749,2,0,0,0,2,0,2,0,0.0,0.0
1005,2394,26-09-2019 19:26:00,0,2772.0,2184.0,0.788,13.341,11,4,2,2,7,2,5,0,0.0,0.0
1005,2395,26-09-2019 19:28:00,0,2784.0,2083.0,0.748,13.274,209,146,101,45,63,42,21,0,0.0,0.0
1005,2396,26-09-2019 19:30:00,0,3270.0,2476.0,0.757,15.627,129,78,57,21,51,24,27,3,0.0,0.0
1005,2397,26-09-2019 19:32:00,0,3248.0,2533.0,0.78,15.604,243,150,116,34,93,70,23,11,0.0,0.0
1005,2398,26-09-2019 19:34:00,0,3445.0,2617.0,0.76,16.472,221,89,61,28,132,91,41,23,0.0,0.0
1005,2399,26-09-2019 19:36:00,0,3537.0,2717.0,0.768,16.944,389,244,183,61,145,119,26,5,0.0,0.0
1005,2400,26-09-2019 19:38:00,0,3761.0,2846.0,0.757,17.967,197,143,104,39,54,39,15,22,0.02,0.0
1005,2401,26-09-2019 19:40:00,0,3751.5,2848.0,0.7595,17.9335,234,173,123,50,61,39,22,15,0.0,0.0
1005,2402,26-09-2019 19:42:00,0,3742.0,2850.0,0.762,17.9,304,150,120,30,154,116,38,57,0.0,0.0
1005,2403,26-09-2019 19:44:00,0,3724.0,2922.0,0.785,17.908,245,113,84,29,132,108,24,43,0.0,0.0
1005,2404,26-09-2019 19:46:00,0,3651.0,2804.0,0.768,17.49,182,113,79,34,69,32,37,9,0.0,0.0
1005,2405,26-09-2019 19:48:00,0,3746.0,2918.0,0.779,17.989,211,120,74,46,91,60,31,0,0.0,0.0
1005,2406,26-09-2019 19:50:00,0,3822.0,2929.0,0.766,18.304,187,149,93,56,38,27,11,1,0.0,0.0
1005,2407,26-09-2019 19:52:00,0,3650.0,2796.0,0.766,17.478,112,88,51,37,24,5,19,5,0.0,0.0
1005,2408,26-09-2019 19:54:00,0,3726.0,2893.0,0.776,17.884,511,288,228,60,223,168,55,94,0.0,0.0
1005,2409,26-09-2019 19:56:00,0,3712.0,2927.0,0.789,17.867,406,176,131,45,230,180,50,42,0.0,0.0
1005,2410,26-09-2019 19:58:00,0,4017.0,3082.0,0.767,19.241,278,122,82,40,156,109,47,5,0.0,0.0
1005,2411,26-09-2019 20:00:00,0,3717.0,2932.0,0.789,17.893,187,125,76,49,62,36,26,1,0.0,0.0
1005,2412,26-09-2019 20:02:00,0,3736.0,2903.0,0.777,17.933,87,39,14,25,48,23,25,0,0.0,0.0
1005,2413,26-09-2019 20:04:00,0,3637.0,2816.0,0.774,17.448,126,52,24,28,74,36,38,1,0.0,0.0
1005,2414,26-09-2019 20:06:00,0,3740.0,2861.0,0.765,17.902,114,54,22,32,60,32,28,0,0.0,0.0
1005,2415,26-09-2019 20:08:00,0,3532.0,2798.0,0.792,17.014,72,34,8,26,38,16,22,0,0.0,0.0
1005,2416,26-09-2019 20:10:00,0,3754.0,2887.0,0.769,17.988,277,141,96,45,136,95,41,12,0.0,0.0
1005,2417,26-09-2019 20:12:00,0,3520.0,2824.0,0.802,16.995,416,234,191,43,182,145,37,39,0.0,0.0
1005,2418,26-09-2019 20:14:00,0,3775.0,2959.5,0.785,18.1505,500,340,271,69,160,127,33,7,0.0,0.0
1005,2419,26-09-2019 20:16:00,0,4030.0,3095.0,0.768,19.306,683,445,369,76,238,199,39,18,0.0,0.0
1005,2420,26-09-2019 20:18:00,0,4031.0,3029.0,0.751,19.238,518,418,341,77,100,82,18,24,0.0,0.0
1005,2421,26-09-2019 20:20:00,0,4039.0,3006.0,0.744,19.242,433,323,258,65,110,88,22,14,0.0,0.0
1005,2422,26-09-2019 20:22:00,0,4039.0,3010.0,0.745,19.248,407,297,237,60,110,84,26,13,0.01,0.0
1005,2423,26-09-2019 20:24:00,0,3736.0,2883.0,0.772,17.913,115,90,50,40,25,10,15,3,0.0,0.0
1005,2424,26-09-2019 20:26:00,0,3943.0,2921.0,0.741,18.77,80,55,24,31,25,4,21,0,0.0,0.0
1005,2425,26-09-2019 20:28:00,0,4052.0,2975.0,0.734,19.257,102,25,11,14,77,46,31,0,0.0,0.0
1005,2426,26-09-2019 20:30:00,0,4022.0,3104.0,0.772,19.285,243,116,69,47,127,86,41,11,0.0,0.0
1005,2427,26-09-2019 20:32:00,0,3831.0,2964.0,0.774,18.377,294,139,91,48,155,113,42,8,0.0,0.0
1005,2428,26-09-2019 20:34:00,0,3542.0,2759.0,0.779,17.011,240,115,85,30,125,85,40,21,0.0,0.0
1005,2429,26-09-2019 20:36:00,0,4044.0,3029.0,0.749,19.287,405,245,188,57,160,113,47,32,0.0,0.0
1005,2430,26-09-2019 20:38:00,0,3739.0,2883.0,0.771,17.925,358,226,171,55,132,99,33,12,0.0,0.0
1005,2431,26-09-2019 20:40:00,0,3722.0,2968.0,0.798,17.951,309,167,129,38,142,101,41,38,0.0,0.0
1005,2432,26-09-2019 20:42:00,0,3735.0,2909.0,0.779,17.939,198,154,111,43,44,24,20,9,0.0,0.0
1005,2433,26-09-2019 20:44:00,0,3729.0,2878.0,0.772,17.88,198,120,84,36,78,52,26,22,0.0,0.0
1005,2434,26-09-2019 20:46:00,0,3722.0,2930.0,0.787,17.911,243,142,116,26,101,69,32,61,0.0,0.0
1005,2435,26-09-2019 20:48:00,0,3736.0,2881.5,0.7715,17.9115,396,217,162,55,179,140,39,6,0.01,0.0
1005,2436,26-09-2019 20:50:00,0,3750.0,2833.0,0.756,17.912,107,73,37,36,34,11,23,0,0.0,0.0
1005,2437,26-09-2019 20:52:00,0,3749.0,2875.0,0.767,17.953,157,104,70,34,53,35,18,2,0.0,0.0
1005,2438,26-09-2019 20:54:00,0,3719.0,2902.0,0.78,17.867,289,59,41,18,230,162,68,4,0.0,0.0
1005,2439,26-09-2019 20:56:00,0,3646.0,2812.0,0.771,17.478,381,192,152,40,189,146,43,34,0.0,0.0
1005,2440,26-09-2019 20:58:00,0,3527.0,2806.0,0.796,17.004,364,220,178,42,144,114,30,37,0.0,0.0
1005,2441,26-09-2019 21:00:00,0,3538.0,2752.0,0.778,16.987,288,154,117,37,134,113,21,11,0.0,0.0
1005,2442,26-09-2019 21:02:00,0,3547.0,2757.0,0.777,17.027,222,62,28,34,160,117,43,0,0.0,0.0
1005,2443,26-09-2019 21:04:00,0,3540.0,2731.0,0.772,16.971,220,34,18,16,186,151,35,0,0.0,0.0
1005,2444,26-09-2019 21:06:00,0,3564.0,2703.0,0.758,17.036,64,10,5,5,54,8,46,0,0.0,0.0
1005,2445,26-09-2019 21:08:00,0,3267.0,2520.0,0.771,15.663,319,1,0,1,318,265,53,0,0.0,0.0
1005,2446,26-09-2019 21:10:00,0,3071.0,2349.0,0.765,14.701,445,0,0,0,445,395,50,0,0.0,0.0
1005,2447,26-09-2019 21:12:00,0,3107.0,2238.0,0.72,14.72,199,1,0,1,198,139,59,0,0.0,0.0
1005,2448,26-09-2019 21:14:00,0,2784.0,2150.0,0.772,13.349,57,0,0,0,57,20,37,0,0.0,0.0
1005,2449,26-09-2019 21:16:00,0,2803.0,2082.0,0.743,13.35,237,7,1,6,230,164,66,0,0.0,0.0
1005,2450,26-09-2019 21:18:00,0,2688.0,2029.0,0.755,12.835,456,3,0,3,453,404,49,0,0.0,0.0
1005,2451,26-09-2019 21:20:00,0,2594.0,1976.0,0.762,12.41,208,34,20,14,174,115,59,0,0.0,0.0
1005,2452,26-09-2019 21:22:00,0,2828.0,2156.5,0.7625,13.5315,361,180,131,49,181,128,53,42,0.0,0.0
1005,2453,26-09-2019 21:24:00,0,3062.0,2337.0,0.763,14.653,355,177,134,43,178,143,35,20,0.0,0.0
1005,2454,26-09-2019 21:26:00,0,3052.0,2394.0,0.785,14.674,343,61,29,32,282,222,60,7,0.0,0.0
1005,2455,26-09-2019 21:28:00,0,3277.0,2478.0,0.756,15.657,141,86,52,34,55,40,15,1,0.0,0.0
1005,2456,26-09-2019 21:30:00,0,3563.0,2658.0,0.746,16.983,484,312,258,54,172,137,35,34,0.01,0.0
1005,2457,26-09-2019 21:32:00,0,3542.0,2738.0,0.773,16.989,553,357,293,64,196,151,45,18,0.02,0.0
1005,2458,26-09-2019 21:34:00,0,3568.0,2672.0,0.749,17.016,267,173,115,58,94,61,33,2,0.0,0.0
1005,2459,26-09-2019 21:36:00,0,3741.0,2867.0,0.766,17.915,466,340,268,72,126,88,38,16,0.0,0.0
1005,2460,26-09-2019 21:38:00,0,4044.0,3054.0,0.755,19.317,443,228,177,51,215,150,65,79,0.04,0.0
1005,2461,26-09-2019 21:40:00,0,3964.0,2926.0,0.738,18.859,511,267,224,43,244,186,58,57,0.0,0.0
1005,2462,26-09-2019 21:42:00,0,3664.0,2765.0,0.755,17.497,343,163,134,29,180,130,50,17,0.0,0.0
1005,2463,26-09-2019 21:44:00,0,3563.0,2723.0,0.764,17.051,95,57,27,30,38,24,14,15,0.0,0.0
1005,2464,26-09-2019 21:46:00,0,3757.0,2821.0,0.751,17.928,218,80,61,19,138,99,39,54,0.01,0.0
1005,2465,26-09-2019 21:48:00,0,4068.0,3008.0,0.739,19.357,260,75,35,40,185,122,63,0,0.0,0.0
1005,2466,26-09-2019 21:50:00,0,3862.0,2881.0,0.746,18.407,105,80,38,42,25,7,18,0,0.0,0.0
1005,2467,26-09-2019 21:52:00,0,3755.0,2744.0,0.731,17.833,482,257,200,57,225,178,47,29,0.02,0.0
1005,2468,26-09-2019 21:54:00,0,3859.0,2917.0,0.756,18.435,478,394,316,78,84,48,36,13,0.0,0.0
1005,2469,26-09-2019 21:56:00,0,3992.5,3021.5,0.757,19.0775,559,519,409,110,40,28,12,11,0.0,0.0
1005,2470,26-09-2019 21:58:00,0,4126.0,3126.0,0.758,19.72,493,390,309,81,103,70,33,14,0.0,0.0
1005,2471,26-09-2019 22:00:00,0,3947.0,2953.0,0.748,18.822,399,300,230,70,99,72,27,26,0.0,0.0
1005,2472,26-09-2019 22:02:00,0,4222.0,3170.0,0.751,20.146,639,434,343,91,205,156,49,32,0.0,0.0
1005,2473,26-09-2019 22:04:00,0,3967.0,2918.0,0.736,18.862,485,347,267,80,138,96,42,19,0.02,0.0
1005,2474,26-09-2019 22:06:00,0,4202.0,3228.0,0.768,20.131,537,400,308,92,137,95,42,18,0.03,0.0
1005,2475,26-09-2019 22:08:00,0,4217.0,3211.0,0.761,20.168,278,167,117,50,111,74,37,9,0.0,0.0
1005,2476,26-09-2019 22:10:00,0,4069.0,2897.0,0.712,19.242,295,90,66,24,205,160,45,26,0.0,0.0
1005,2477,26-09-2019 22:12:00,0,4252.0,3219.0,0.757,20.317,603,380,320,60,223,179,44,55,0.0,0.0
1005,2478,26-09-2019 22:14:00,0,4511.0,3342.0,0.741,21.475,388,212,156,56,176,133,43,43,0.0,0.0
1005,2479,26-09-2019 22:16:00,0,3974.0,2903.0,0.731,18.871,397,283,212,71,114,73,41,56,0.0,0.0
1005,2480,26-09-2019 22:18:00,0,4237.0,3112.0,0.734,20.142,692,500,395,105,192,149,43,28,0.01,0.0
1005,2481,26-09-2019 22:20:00,0,4060.0,2967.0,0.731,19.283,448,252,195,57,196,153,43,41,0.02,0.0
1005,2482,26-09-2019 22:22:00,0,4149.0,3124.0,0.753,19.806,482,246,185,61,236,187,49,33,0.0,0.0
1005,2483,26-09-2019 22:24:00,0,4253.0,3124.0,0.734,20.217,446,243,191,52,203,154,49,72,0.0,0.0
1005,2484,26-09-2019 22:26:00,0,4257.0,3128.0,0.735,20.238,503,385,288,97,118,90,28,40,0.01,0.0
1005,2485,26-09-2019 22:28:00,0,4214.0,3192.0,0.758,20.137,359,135,97,38,224,181,43,56,0.0,0.0
1005,2486,26-09-2019 22:30:00,0,4222.5,3218.5,0.7625,20.2005,287,74,38,36,213,182,31,2,0.0,0.0
1005,2487,26-09-2019 22:32:00,0,4231.0,3245.0,0.767,20.264,353,214,172,42,139,101,38,38,0.01,0.0
1005,2488,26-09-2019 22:34:00,0,4261.0,3125.0,0.733,20.248,249,124,92,32,125,91,34,0,0.0,0.0
1005,2489,26-09-2019 22:36:00,0,3866.0,2858.0,0.739,18.396,172,106,64,42,66,44,22,1,0.0,0.0
1005,2490,26-09-2019 22:38:00,0,4074.0,2905.0,0.713,19.27,168,80,42,38,88,61,27,0,0.0,0.0
1005,2491,26-09-2019 22:40:00,0,3761.0,2835.0,0.754,17.958,80,32,18,14,48,19,29,4,0.0,0.0
1005,2492,26-09-2019 22:42:00,0,3850.0,2880.0,0.748,18.359,377,268,218,50,109,76,33,18,0.0,0.0
1005,2493,26-09-2019 22:44:00,0,4048.0,2953.0,0.73,19.219,428,275,203,72,153,113,40,11,0.02,0.0
1005,2494,26-09-2019 22:46:00,0,4054.0,2946.0,0.727,19.235,391,189,158,31,202,155,47,74,0.0,0.0
1005,2495,26-09-2019 22:48:00,0,3566.0,2692.0,0.755,17.03,99,56,31,25,43,17,26,0,0.0,0.0
1005,2496,26-09-2019 22:50:00,0,3674.0,2680.0,0.729,17.445,358,249,188,61,109,69,40,20,0.0,0.0
1005,2497,26-09-2019 22:52:00,0,3743.0,2835.0,0.758,17.885,268,98,73,25,170,114,56,29,0.0,0.0
1005,2498,26-09-2019 22:54:00,0,3749.0,2850.0,0.76,17.927,461,87,61,26,374,314,60,4,0.0,0.0
1005,2499,26-09-2019 22:56:00,0,3771.0,2743.0,0.727,17.897,144,45,28,17,99,58,41,0,0.0,0.0
1005,2500,26-09-2019 22:58:00,0,3773.0,2821.0,0.748,17.99,359,151,117,34,208,160,48,31,0.0,0.0
1005,2501,26-09-2019 23:00:00,0,4074.0,2902.0,0.712,19.265,292,113,79,34,179,135,44,39,0.03,0.0
1005,2502,26-09-2019 23:02:00,0,3670.0,2719.0,0.741,17.47,287,119,80,39,168,117,51,7,0.0,0.0
1005,2503,26-09-2019 23:04:00,0,3715.0,2741.0,0.738,17.6725,498,244,188,56,254,188,66,44,0.0,0.0
1005,2504,26-09-2019 23:06:00,0,3760.0,2763.0,0.735,17.875,385,238,191,47,147,91,56,52,0.03,0.0
1005,2505,26-09-2019 23:08:00,0,3780.0,2756.0,0.729,17.946,437,220,177,43,217,158,59,75,0.0,0.0
1005,2506,26-09-2019 23:10:00,0,3763.0,2807.0,0.746,17.935,206,91,64,27,115,92,23,15,0.0,0.0
1005,2507,26-09-2019 23:12:00,0,3774.0,2757.0,0.73,17.923,56,24,12,12,32,16,16,16,0.0,0.0
1005,2508,26-09-2019 23:14:00,0,3770.0,2710.0,0.719,17.855,49,0,0,0,49,26,23,0,0.0,0.0
1005,2509,26-09-2019 23:16:00,0,3575.0,2615.0,0.732,16.98,319,246,198,48,73,46,27,9,0.0,0.0
1005,2510,26-09-2019 23:18:00,0,3663.0,2659.0,0.726,17.376,397,280,224,56,117,81,36,1,0.0,0.0
1005,2511,26-09-2019 23:20:00,0,3767.0,2726.0,0.724,17.859,304,178,129,49,126,95,31,19,0.02,0.0
1005,2512,26-09-2019 23:22:00,0,3313.0,2303.0,0.695,15.603,298,139,93,46,159,114,45,25,0.01,0.0
1005,2513,26-09-2019 23:24:00,0,3792.0,2727.0,0.719,17.962,309,124,101,23,185,137,48,33,0.0,0.0
1005,2514,26-09-2019 23:26:00,0,3560.0,2681.0,0.753,16.995,244,47,27,20,197,132,65,0,0.0,0.0
1005,2515,26-09-2019 23:28:00,0,3580.0,2595.0,0.725,16.978,157,67,26,41,90,49,41,0,0.0,0.0
1005,2516,26-09-2019 23:30:00,0,3610.0,2560.0,0.709,17.058,371,186,146,40,185,149,36,25,0.01,0.0
1005,2517,26-09-2019 23:32:00,0,3590.0,2576.0,0.718,16.999,295,90,52,38,205,142,63,1,0.01,0.0
1005,2518,26-09-2019 23:34:00,0,3560.0,2649.0,0.744,16.96,268,58,30,28,210,157,53,0,0.0,0.0
1005,2519,26-09-2019 23:36:00,0,3496.0,2518.0,0.72,16.56,131,58,42,16,73,43,30,13,0.0,0.0
1005,2520,26-09-2019 23:38:00,0,3397.0,2423.0,0.713,16.066,21,3,0,3,18,0,18,0,0.0,0.0
1005,2521,26-09-2019 23:40:00,0,3298.0,2328.0,0.706,15.572,21,6,0,6,15,2,13,0,0.0,0.0
1005,2522,26-09-2019 23:42:00,0,3099.0,2242.0,0.723,14.693,152,25,20,5,127,76,51,0,0.0,0.0
1005,2523,26-09-2019 23:44:00,0,3136.0,2138.0,0.682,14.723,96,0,0,0,96,40,56,0,0.0,0.0
1005,2524,26-09-2019 23:46:00,0,2818.0,2030.0,0.72,13.352,109,0,0,0,109,56,53,0,0.0,0.0
1005,2525,26-09-2019 23:48:00,0,2823.0,1934.0,0.685,13.264,96,0,0,0,96,45,51,0,0.01,0.0
1005,2526,26-09-2019 23:50:00,0,2639.0,1842.0,0.698,12.44,100,0,0,0,100,52,48,0,0.0,0.0
1005,2527,26-09-2019 23:52:00,0,2527.0,1745.0,0.691,11.887,298,0,0,0,298,243,55,0,0.0,0.0
1005,2528,26-09-2019 23:54:00,0,2432.0,1699.0,0.698,11.464,104,0,0,0,104,50,54,0,0.0,0.0
1005,2529,26-09-2019 23:56:00,0,2425.0,1692.0,0.698,11.429,120,0,0,0,120,63,57,0,0.0,0.0
1005,2530,26-09-2019 23:58:00,0,2444.0,1650.0,0.675,11.458,76,0,0,0,76,38,38,0,0.01,0.0
1005,2531,27-09-2019 00:00:00,0,2342.0,1592.0,0.68,10.993,104,0,0,0,104,51,53,0,0.0,0.0
1005,2532,27-09-2019 00:02:00,0,2347.0,1626.0,0.693,11.047,122,0,0,0,122,68,54,0,0.0,0.0
1005,2533,27-09-2019 00:04:00,0,2337.0,1598.0,0.684,10.976,82,0,0,0,82,32,50,0,0.0,0.0
1005,2534,27-09-2019 00:06:00,0,2131.0,1545.0,0.725,10.108,237,75,55,20,162,105,57,34,0.0,0.0
1005,2535,27-09-2019 00:08:00,0,2429.0,1781.0,0.733,11.541,644,374,304,70,270,207,63,57,0.0,0.0
1005,2536,27-09-2019 00:10:00,0,2617.0,1835.0,0.701,12.345,506,295,231,64,211,155,56,113,0.0,0.0
1005,2537,27-09-2019 00:12:00,0,2856.0,2021.0,0.707,13.4915,511,260,208,52,251,201,50,85,0.0,0.0
1005,2538,27-09-2019 00:14:00,0,3095.0,2207.0,0.713,14.638,558,365,283,82,193,147,46,60,0.01,0.0
1005,2539,27-09-2019 00:16:00,0,3290.0,2466.0,0.749,15.694,366,206,162,44,160,126,34,105,0.0,0.0
1005,2540,27-09-2019 00:18:00,0,3280.0,2438.0,0.743,15.623,179,60,29,31,119,79,40,7,0.0,0.0
1005,2541,27-09-2019 00:20:00,0,3584.0,2502.0,0.698,16.891,384,149,114,35,235,179,56,38,0.0,0.0
1005,2542,27-09-2019 00:22:00,0,3595.0,2589.0,0.72,17.033,667,446,348,98,221,171,50,26,0.0,0.0
1005,2543,27-09-2019 00:24:00,0,3773.0,2780.0,0.737,17.943,483,296,238,58,187,143,44,41,0.0,0.0
1005,2544,27-09-2019 00:26:00,0,3557.0,2669.0,0.75,16.972,288,121,77,44,167,115,52,19,0.0,0.0
1005,2545,27-09-2019 00:28:00,0,3788.0,2746.0,0.725,17.965,326,159,116,43,167,120,47,32,0.0,0.0
1005,2546,27-09-2019 00:30:00,0,3752.0,2752.0,0.733,17.828,205,58,33,25,147,93,54,4,0.0,0.0
1005,2547,27-09-2019 00:32:00,0,3876.0,2805.0,0.724,18.377,344,176,126,50,168,117,51,21,0.01,0.0
1005,2548,27-09-2019 00:34:00,0,3775.0,2692.0,0.713,17.852,451,174,130,44,277,212,65,22,0.01,0.0
1005,2549,27-09-2019 00:36:00,0,3760.0,2730.0,0.726,17.839,599,385,310,75,214,164,50,38,0.0,0.0
1005,2550,27-09-2019 00:38:00,0,3876.0,2806.0,0.724,18.379,300,178,136,42,122,83,39,10,0.0,0.0
1005,2551,27-09-2019 00:40:00,0,3574.0,2638.0,0.738,17.004,98,43,23,20,55,27,28,6,0.0,0.0
1005,2552,27-09-2019 00:42:00,0,4080.0,2875.0,0.705,19.259,342,163,130,33,179,142,37,40,0.0,0.0
1005,2553,27-09-2019 00:44:00,0,3762.0,2767.0,0.736,17.886,357,157,114,43,200,140,60,40,0.0,0.0
1005,2554,27-09-2019 00:46:00,0,3665.0,2696.0,0.736,17.425,402,254,188,66,148,107,41,11,0.03,0.0
1005,2555,27-09-2019 00:48:00,0,3568.0,2625.0,0.736,16.964,197,106,66,40,91,59,32,9,0.01,0.0
1005,2556,27-09-2019 00:50:00,0,3580.0,2618.0,0.731,17.004,148,83,33,50,65,34,31,0,0.0,0.0
1005,2557,27-09-2019 00:52:00,0,3762.0,2730.0,0.726,17.845,442,208,171,37,234,176,58,43,0.0,0.0
1005,2558,27-09-2019 00:54:00,0,3765.0,2757.0,0.732,17.887,38,18,7,11,20,13,7,0,0.02,0.0
1005,2559,27-09-2019 00:56:00,0,3681.0,2670.0,0.725,17.46,192,98,68,30,94,61,33,18,0.0,0.0
1005,2560,27-09-2019 00:58:00,0,3584.0,2559.0,0.714,16.954,197,79,52,27,118,71,47,0,0.01,0.0
1005,2561,27-09-2019 01:00:00,0,3575.0,2622.0,0.733,16.99,477,293,230,63,184,137,47,24,0.01,0.0
1005,2562,27-09-2019 01:02:00,0,3674.0,2653.0,0.722,17.413,480,359,283,76,121,78,43,11,0.01,0.0
1005,2563,27-09-2019 01:04:00,0,3582.0,2593.0,0.724,16.986,328,110,66,44,218,172,46,8,0.01,0.0
1005,2564,27-09-2019 01:06:00,0,3589.0,2541.0,0.708,16.957,292,93,47,46,199,136,63,4,0.01,0.0
1005,2565,27-09-2019 01:08:00,0,3573.0,2579.0,0.722,16.932,122,41,28,13,81,45,36,7,0.0,0.0
1005,2566,27-09-2019 01:10:00,0,3569.0,2595.0,0.727,16.936,165,17,8,9,148,87,61,0,0.0,0.0
1005,2567,27-09-2019 01:12:00,0,3294.0,2407.0,0.731,15.643,80,0,0,0,80,39,41,0,0.0,0.0
1005,2568,27-09-2019 01:14:00,0,3212.0,2271.0,0.707,15.172,92,0,0,0,92,46,46,0,0.0,0.0
1005,2569,27-09-2019 01:16:00,0,3123.0,2151.0,0.689,14.688,121,8,5,3,113,61,52,0,0.0,0.0
1005,2570,27-09-2019 01:18:00,0,3018.0,2078.0,0.689,14.19,130,0,0,0,130,69,61,0,0.0,0.0
1005,2571,27-09-2019 01:20:00,0,2929.0,2008.0,0.6855,13.763,142,0,0,0,142,74,68,0,0.0,0.0
1005,2572,27-09-2019 01:22:00,0,2840.0,1938.0,0.682,13.336,188,0,0,0,188,120,68,0,0.0,0.0
1005,2573,27-09-2019 01:24:00,0,2620.0,1864.0,0.712,12.388,108,0,0,0,108,62,46,0,0.0,0.0
1005,2574,27-09-2019 01:26:00,0,2638.0,1817.0,0.689,12.407,101,0,0,0,101,49,52,0,0.0,0.0
1005,2575,27-09-2019 01:28:00,0,2425.0,1755.0,0.724,11.496,130,2,0,2,128,66,62,0,0.0,0.0
1005,2576,27-09-2019 01:30:00,0,2426.0,1702.0,0.701,11.443,118,0,0,0,118,59,59,0,0.0,0.0
1005,2577,27-09-2019 01:32:00,0,2445.0,1694.0,0.693,11.509,154,0,0,0,154,94,60,0,0.0,0.0
1005,2578,27-09-2019 01:34:00,0,2450.0,1656.0,0.676,11.485,146,0,0,0,146,87,59,0,0.0,0.0
1005,2579,27-09-2019 01:36:00,0,2349.0,1608.0,0.685,11.034,353,136,100,36,217,153,64,4,0.0,0.0
1005,2580,27-09-2019 01:38:00,0,2419.0,1702.0,0.703,11.414,310,210,149,61,100,69,31,30,0.0,0.0
1005,2581,27-09-2019 01:40:00,0,2408.0,1785.0,0.742,11.464,339,229,165,64,110,67,43,16,0.0,0.0
1005,2582,27-09-2019 01:42:00,0,3016.0,2093.0,0.694,14.2,297,170,114,56,127,97,30,10,0.0,0.0
1005,2583,27-09-2019 01:44:00,0,2809.0,1986.0,0.707,13.267,361,246,200,46,115,82,33,45,0.0,0.0
1005,2584,27-09-2019 01:46:00,0,2799.0,2039.0,0.729,13.287,210,75,50,25,135,91,44,20,0.0,0.0
1005,2585,27-09-2019 01:48:00,0,3092.0,2247.0,0.727,14.671,335,160,123,37,175,131,44,28,0.0,0.0
1005,2586,27-09-2019 01:50:00,0,3105.0,2227.0,0.717,14.701,148,59,41,18,89,50,39,12,0.0,0.0
1005,2587,27-09-2019 01:52:00,0,3299.0,2335.0,0.708,15.585,456,229,186,43,227,170,57,87,0.02,0.0
1005,2588,27-09-2019 01:54:00,0,3442.0,2432.0,0.7065,16.2555,495,348,274,74,147,108,39,20,0.0,0.0
1005,2589,27-09-2019 01:56:00,0,3585.0,2529.0,0.705,16.926,507,312,246,66,195,153,42,124,0.0,0.0
1005,2590,27-09-2019 01:58:00,0,3589.0,2580.0,0.719,16.998,237,118,84,34,119,85,34,7,0.0,0.0
1005,2591,27-09-2019 02:00:00,0,3594.0,2550.0,0.71,16.983,196,69,52,17,127,85,42,21,0.0,0.0
1005,2592,27-09-2019 02:02:00,0,3289.0,2402.0,0.73,15.621,420,129,85,44,291,216,75,16,0.0,0.0
1005,2593,27-09-2019 02:04:00,0,3602.0,2519.0,0.699,16.982,649,312,257,55,337,258,79,66,0.0,0.0
1005,2594,27-09-2019 02:06:00,0,3586.0,2513.0,0.701,16.914,282,87,57,30,195,130,65,6,0.0,0.0
1005,2595,27-09-2019 02:08:00,0,3616.0,2500.0,0.691,17.016,355,211,168,43,144,101,43,12,0.0,0.0
1005,2596,27-09-2019 02:10:00,0,3379.0,2455.0,0.727,16.03,150,79,58,21,71,43,28,2,0.0,0.0
1005,2597,27-09-2019 02:12:00,0,3616.0,2534.0,0.701,17.053,466,212,169,43,254,190,64,49,0.03,0.0
1005,2598,27-09-2019 02:14:00,0,3613.0,2506.0,0.694,17.012,237,113,79,34,124,67,57,4,0.0,0.0
1005,2599,27-09-2019 02:16:00,0,3377.0,2441.0,0.723,16.007,89,36,21,15,53,25,28,0,0.0,0.0
1005,2600,27-09-2019 02:18:00,0,3292.0,2354.0,0.715,15.576,17,0,0,0,17,0,17,0,0.0,0.0
1005,2601,27-09-2019 02:20:00,0,3224.0,2262.0,0.702,15.207,21,1,0,1,20,0,20,0,0.0,0.0
1005,2602,27-09-2019 02:22:00,0,3119.0,2158.0,0.692,14.678,19,1,0,1,18,0,18,0,0.0,0.0
1005,2603,27-09-2019 02:24:00,0,3024.0,2075.0,0.686,14.214,29,5,0,5,24,0,24,0,0.0,0.0
1005,2604,27-09-2019 02:26:00,0,2810.0,1989.0,0.708,13.276,18,0,0,0,18,0,18,0,0.0,0.0
1005,2605,27-09-2019 02:28:00,0,2658.5,1913.0,0.7205,12.594,39,8,6,2,31,9,22,0,0.0,0.0
1005,2606,27-09-2019 02:30:00,0,2507.0,1837.0,0.733,11.912,39,4,2,2,35,14,21,0,0.0,0.0
1005,2607,27-09-2019 02:32:00,0,2513.0,1792.0,0.713,11.887,21,0,0,0,21,3,18,0,0.0,0.0
1005,2608,27-09-2019 02:34:00,0,2418.0,1744.0,0.721,11.459,31,6,0,6,25,0,25,0,0.0,0.0
1005,2609,27-09-2019 02:36:00,0,2316.0,1692.0,0.731,11.001,42,9,2,7,33,8,25,0,0.01,0.0
1005,2610,27-09-2019 02:38:00,0,2224.0,1596.0,0.718,10.532,36,0,0,0,36,15,21,0,0.0,0.0
1005,2611,27-09-2019 02:40:00,0,2227.0,1591.0,0.714,10.538,27,0,0,0,27,8,19,0,0.0,0.0
1005,2612,27-09-2019 02:42:00,0,2116.0,1566.0,0.74,10.071,32,0,0,0,32,18,14,0,0.0,0.0
1005,2613,27-09-2019 02:44:00,0,2027.0,1521.0,0.75,9.669,64,2,1,1,62,28,34,0,0.0,0.0
1005,2614,27-09-2019 02:46:00,0,2028.0,1451.0,0.716,9.595,85,10,0,10,75,37,38,0,0.0,0.0
1005,2615,27-09-2019 02:48:00,0,2045.0,1428.0,0.699,9.639,73,4,0,4,69,38,31,0,0.0,0.0
1005,2616,27-09-2019 02:50:00,0,2041.0,1395.0,0.684,9.585,77,3,0,3,74,40,34,0,0.0,0.0
1005,2617,27-09-2019 02:52:00,0,2048.0,1390.0,0.679,9.611,143,54,27,27,89,47,42,0,0.0,0.0
1005,2618,27-09-2019 02:54:00,0,2015.0,1535.0,0.762,9.638,367,206,158,48,161,120,41,32,0.0,0.0
1005,2619,27-09-2019 02:56:00,0,2401.0,1801.0,0.75,11.457,327,226,176,50,101,75,26,45,0.0,0.0
1005,2620,27-09-2019 02:58:00,0,2717.0,2011.0,0.74,12.933,322,246,184,62,76,44,32,26,0.0,0.0
1005,2621,27-09-2019 03:00:00,0,2708.0,1951.0,0.72,12.832,474,303,247,56,171,123,48,37,0.01,0.0
1005,2622,27-09-2019 03:02:00,0,3157.0,2235.5,0.7095,14.915,420,285,229,56,135,98,37,32,0.01,0.0
1005,2623,27-09-2019 03:04:00,0,3606.0,2520.0,0.699,16.998,393,175,129,46,218,170,48,83,0.0,0.0
1005,2624,27-09-2019 03:06:00,0,3312.0,2300.0,0.694,15.598,194,82,58,24,112,82,30,32,0.0,0.0
1005,2625,27-09-2019 03:08:00,0,3142.0,2152.0,0.685,14.763,237,115,77,38,122,85,37,27,0.0,0.0
1005,2626,27-09-2019 03:10:00,0,3313.0,2298.0,0.694,15.597,517,227,178,49,290,223,67,42,0.01,0.0
1005,2627,27-09-2019 03:12:00,0,3297.0,2332.0,0.707,15.573,282,170,136,34,112,73,39,9,0.0,0.0
1005,2628,27-09-2019 03:14:00,0,3210.0,2277.0,0.709,15.169,253,97,70,27,156,114,42,22,0.0,0.0
1005,2629,27-09-2019 03:16:00,0,3609.0,2527.0,0.7,17.016,541,260,197,63,281,204,77,120,0.0,0.0
1005,2630,27-09-2019 03:18:00,0,3508.0,2499.0,0.712,16.59,391,233,187,46,158,109,49,34,0.0,0.0
1005,2631,27-09-2019 03:20:00,0,3614.0,2533.0,0.701,17.045,221,95,59,36,126,87,39,13,0.05,0.0
1005,2632,27-09-2019 03:22:00,0,3304.0,2288.0,0.692,15.55,367,173,134,39,194,141,53,5,0.0,0.0
1005,2633,27-09-2019 03:24:00,0,3316.0,2350.0,0.709,15.669,163,20,6,14,143,99,44,0,0.0,0.0
1005,2634,27-09-2019 03:26:00,0,3303.0,2311.0,0.7,15.572,227,118,85,33,109,81,28,8,0.0,0.0
1005,2635,27-09-2019 03:28:00,0,3301.0,2301.0,0.697,15.552,151,43,24,19,108,66,42,0,0.0,0.0
1005,2636,27-09-2019 03:30:00,0,3103.0,2248.0,0.725,14.714,80,0,0,0,80,27,53,0,0.0,0.0
1005,2637,27-09-2019 03:32:00,0,3216.0,2273.0,0.707,15.188,112,0,0,0,112,48,64,0,0.0,0.0
1005,2638,27-09-2019 03:34:00,0,3123.0,2170.0,0.695,14.707,84,0,0,0,84,37,47,0,0.0,0.0
1005,2639,27-09-2019 03:36:00,0,2982.5,2047.0,0.686,14.017,90,2,1,1,88,38,50,0,0.0,0.0
1005,2640,27-09-2019 03:38:00,0,2842.0,1924.0,0.677,13.327,95,12,9,3,83,39,44,0,0.0,0.0
1005,2641,27-09-2019 03:40:00,0,2628.0,1830.0,0.696,12.381,27,2,0,2,25,0,25,0,0.0,0.0
1005,2642,27-09-2019 03:42:00,0,2651.0,1778.0,0.671,12.413,21,2,0,2,19,0,19,0,0.0,0.0
1005,2643,27-09-2019 03:44:00,0,2420.0,1726.0,0.713,11.446,22,0,0,0,22,0,22,0,0.0,0.0
1005,2644,27-09-2019 03:46:00,0,2440.0,1666.0,0.683,11.459,207,120,83,37,87,53,34,3,0.0,0.0
1005,2645,27-09-2019 03:48:00,0,2633.0,1829.0,0.695,12.398,395,243,190,53,152,114,38,46,0.0,0.0
1005,2646,27-09-2019 03:50:00,0,2717.0,1940.0,0.714,12.855,147,68,35,33,79,46,33,0,0.0,0.0
1005,2647,27-09-2019 03:52:00,0,2614.0,1891.0,0.723,12.395,208,53,23,30,155,90,65,0,0.0,0.0
1005,2648,27-09-2019 03:54:00,0,2821.0,1959.0,0.694,13.282,298,172,133,39,126,87,39,21,0.0,0.0
1005,2649,27-09-2019 03:56:00,0,2714.0,1964.0,0.724,12.867,261,83,53,30,178,125,53,0,0.0,0.0
1005,2650,27-09-2019 03:58:00,0,2829.0,1989.0,0.703,13.349,155,87,66,21,68,47,21,10,0.0,0.0
1005,2651,27-09-2019 04:00:00,0,3129.0,2154.0,0.688,14.714,525,292,238,54,233,182,51,47,0.0,0.0
1005,2652,27-09-2019 04:02:00,0,3114.0,2143.0,0.688,14.645,307,127,88,39,180,128,52,78,0.02,0.0
1005,2653,27-09-2019 04:04:00,0,2917.0,2092.0,0.717,13.809,89,54,30,24,35,11,24,0,0.0,0.0
1005,2654,27-09-2019 04:06:00,0,3140.0,2138.0,0.681,14.74,161,85,59,26,76,53,23,11,0.0,0.0
1005,2655,27-09-2019 04:08:00,0,2806.0,2031.0,0.724,13.306,24,3,0,3,21,4,17,0,0.0,0.0
1005,2656,27-09-2019 04:10:00,0,2806.0,2013.5,0.7175,13.2855,96,31,23,8,65,26,39,0,0.01,0.0
1005,2657,27-09-2019 04:12:00,0,2806.0,1996.0,0.711,13.265,79,1,0,1,78,26,52,0,0.0,0.0
1005,2658,27-09-2019 04:14:00,0,2839.0,1926.0,0.679,13.317,59,0,0,0,59,20,39,0,0.0,0.0
1005,2659,27-09-2019 04:16:00,0,2634.0,1835.0,0.697,12.409,49,2,0,2,47,19,28,0,0.0,0.0
1005,2660,27-09-2019 04:18:00,0,2540.0,1750.0,0.689,11.946,28,0,0,0,28,6,22,0,0.0,0.0
1005,2661,27-09-2019 04:20:00,0,2433.0,1663.0,0.683,11.429,16,2,0,2,14,0,14,0,0.0,0.0
1005,2662,27-09-2019 04:22:00,0,2352.0,1598.0,0.679,11.035,62,15,5,10,47,23,24,0,0.01,0.0
1005,2663,27-09-2019 04:24:00,0,2354.0,1603.0,0.681,11.05,88,27,10,17,61,26,35,0,0.0,0.0
1005,2664,27-09-2019 04:26:00,0,2229.0,1578.0,0.708,10.53,94,2,0,2,92,44,48,0,0.0,0.0
1005,2665,27-09-2019 04:28:00,0,2129.0,1546.0,0.726,10.1,55,1,0,1,54,24,30,0,0.0,0.0
1005,2666,27-09-2019 04:30:00,0,2142.0,1510.0,0.705,10.111,77,0,0,0,77,34,43,0,0.0,0.0
1005,2667,27-09-2019 04:32:00,0,2136.0,1512.0,0.708,10.091,55,0,0,0,55,15,40,0,0.0,0.0
1005,2668,27-09-2019 04:34:00,0,2151.0,1495.0,0.695,10.129,82,0,0,0,82,33,49,0,0.0,0.0
1005,2669,27-09-2019 04:36:00,0,2145.0,1467.0,0.684,10.075,100,0,0,0,100,45,55,0,0.0,0.0
1005,2670,27-09-2019 04:38:00,0,2158.0,1455.0,0.674,10.114,177,47,23,24,130,69,61,0,0.0,0.0
1005,2671,27-09-2019 04:40:00,0,2148.0,1501.0,0.699,10.126,401,259,201,58,142,101,41,44,0.0,0.0
1005,2672,27-09-2019 04:42:00,0,2224.0,1578.0,0.709,10.508,181,107,67,40,74,41,33,48,0.01,0.0
1005,2673,27-09-2019 04:44:00,0,2415.5,1741.5,0.72,11.445,406,265,206,59,141,108,33,42,0.0,0.0
1005,2674,27-09-2019 04:46:00,0,2607.0,1905.0,0.731,12.382,574,401,312,89,173,118,55,23,0.08,0.0
1005,2675,27-09-2019 04:48:00,0,2696.0,1992.0,0.739,12.83,522,425,327,98,97,64,33,25,0.0,0.0
1005,2676,27-09-2019 04:50:00,0,2706.0,1951.0,0.721,12.821,202,104,82,22,98,66,32,30,0.0,0.0
1005,2677,27-09-2019 04:52:00,0,3006.0,2187.0,0.728,14.266,181,105,65,40,76,47,29,50,0.0,0.0
1005,2678,27-09-2019 04:54:00,0,3012.0,2121.0,0.704,14.218,106,30,20,10,76,48,28,12,0.0,0.0
1005,2679,27-09-2019 04:56:00,0,3084.0,2254.0,0.731,14.649,437,289,210,79,148,108,40,20,0.0,0.0
1005,2680,27-09-2019 04:58:00,0,3001.0,2233.0,0.744,14.297,95,75,46,29,20,5,15,0,0.0,0.0
1005,2681,27-09-2019 05:00:00,0,3204.0,2311.0,0.721,15.183,294,149,118,31,145,102,43,16,0.0,0.0
1005,2682,27-09-2019 05:02:00,0,3183.0,2338.0,0.734,15.13,235,107,63,44,128,90,38,9,0.0,0.0
1005,2683,27-09-2019 05:04:00,0,2977.0,2229.0,0.749,14.199,275,136,108,28,139,86,53,52,0.0,0.0
1005,2684,27-09-2019 05:06:00,0,2988.0,2190.0,0.733,14.198,120,27,9,18,93,52,41,0,0.0,0.0
1005,2685,27-09-2019 05:08:00,0,2987.0,2221.0,0.744,14.227,109,45,32,13,64,35,29,9,0.0,0.0
1005,2686,27-09-2019 05:10:00,0,3003.0,2157.0,0.718,14.221,16,2,1,1,14,0,14,0,0.0,0.0
1005,2687,27-09-2019 05:12:00,0,3018.0,2098.0,0.695,14.215,144,51,28,23,93,52,41,1,0.0,0.0
1005,2688,27-09-2019 05:14:00,0,3018.0,2143.0,0.71,14.265,180,65,33,32,115,66,49,0,0.0,0.0
1005,2689,27-09-2019 05:16:00,0,2996.0,2194.0,0.732,14.236,130,18,7,11,112,58,54,0,0.0,0.0
1005,2690,27-09-2019 05:18:00,0,2902.5,2131.0,0.734,13.7965,144,14,6,8,130,81,49,0,0.0,0.0
1005,2691,27-09-2019 05:20:00,0,2809.0,2068.0,0.736,13.357,88,0,0,0,88,46,42,0,0.0,0.0
1005,2692,27-09-2019 05:22:00,0,2709.0,1980.0,0.731,12.866,78,0,0,0,78,41,37,0,0.0,0.0
1005,2693,27-09-2019 05:24:00,0,2510.0,1875.0,0.747,11.966,57,1,1,0,56,31,25,0,0.0,0.0
1005,2694,27-09-2019 05:26:00,0,2530.0,1780.0,0.704,11.94,74,0,0,0,74,48,26,0,0.0,0.0
1005,2695,27-09-2019 05:28:00,0,2307.0,1697.0,0.735,10.969,56,0,0,0,56,31,25,0,0.0,0.0
1005,2696,27-09-2019 05:30:00,0,2340.0,1657.0,0.708,11.053,28,0,0,0,28,2,26,0,0.0,0.0
1005,2697,27-09-2019 05:32:00,0,2355.0,1614.0,0.685,11.068,58,9,4,5,49,23,26,0,0.0,0.0
1005,2698,27-09-2019 05:34:00,0,2017.0,1514.0,0.75,9.624,55,0,0,0,55,27,28,0,0.0,0.0
1005,2699,27-09-2019 05:36:00,0,2044.0,1445.0,0.707,9.652,85,8,4,4,77,37,40,0,0.0,0.0
1005,2700,27-09-2019 05:38:00,0,2044.0,1425.0,0.697,9.633,103,3,1,2,100,46,54,0,0.0,0.0
1005,2701,27-09-2019 05:40:00,0,2052.0,1385.0,0.675,9.618,99,3,1,2,96,45,51,0,0.0,0.0
1005,2702,27-09-2019 05:42:00,0,1955.0,1366.0,0.699,9.217,130,22,8,14,108,49,59,0,0.0,0.0
1005,2703,27-09-2019 05:44:00,0,2045.0,1414.0,0.692,9.624,305,163,125,38,142,95,47,6,0.0,0.0
1005,2704,27-09-2019 05:46:00,0,2236.0,1598.0,0.715,10.579,143,2,0,2,141,88,53,0,0.0,0.0
1005,2705,27-09-2019 05:48:00,0,2234.0,1578.0,0.706,10.549,100,0,0,0,100,43,57,0,0.0,0.0
1005,2706,27-09-2019 05:50:00,0,2027.0,1524.0,0.752,9.672,164,0,0,0,164,93,71,0,0.0,0.0
1005,2707,27-09-2019 05:52:00,0,2033.5,1495.0,0.7355,9.666,99,0,0,0,99,43,56,0,0.0,0.0
1005,2708,27-09-2019 05:54:00,0,2040.0,1466.0,0.719,9.66,91,0,0,0,91,36,55,0,0.0,0.0
1005,2709,27-09-2019 05:56:00,0,2045.0,1433.0,0.701,9.645,95,0,0,0,95,36,59,0,0.0,0.0
1005,2710,27-09-2019 05:58:00,0,2055.0,1387.0,0.675,9.634,115,14,5,9,101,51,50,0,0.0,0.0
1005,2711,27-09-2019 06:00:00,1,2050.0,1404.0,0.685,9.631,569,203,153,50,366,279,87,24,0.0,0.0
1005,2712,27-09-2019 06:02:00,1,2313.0,1708.0,0.739,11.004,460,224,183,41,236,181,55,46,0.0,0.0
1005,2713,27-09-2019 06:04:00,1,2996.0,2150.0,0.718,14.183,283,129,85,44,154,97,57,75,0.0,0.01
1005,2714,27-09-2019 06:06:00,1,3191.0,2278.0,0.714,15.095,304,178,126,52,126,81,45,66,0.0,0.05
1005,2715,27-09-2019 06:08:00,1,3576.0,2632.0,0.736,17.006,148,67,34,33,81,32,49,67,0.0,0.0
1005,2716,27-09-2019 06:10:00,1,3668.0,2750.0,0.75,17.495,117,35,19,16,82,27,55,58,0.0,0.13
1005,2717,27-09-2019 06:12:00,1,3838.0,2880.0,0.75,18.311,119,31,12,19,88,44,44,70,0.0,0.08
1005,2718,27-09-2019 06:14:00,1,3906.0,3076.0,0.788,18.794,236,90,55,35,146,99,47,42,0.0,0.44
1005,2719,27-09-2019 06:16:00,1,3636.0,2857.0,0.786,17.488,28,4,0,4,24,3,21,0,0.0,0.01
1005,2720,27-09-2019 06:18:00,1,3451.0,2696.0,0.781,16.583,317,114,89,25,203,149,54,9,0.22,0.04
1005,2721,27-09-2019 06:20:00,1,4077.0,3364.0,0.825,19.786,446,194,159,35,252,194,58,65,0.17,0.0
1005,2722,27-09-2019 06:22:00,1,4075.0,3407.0,0.836,19.827,148,68,40,28,80,44,36,44,0.0,0.0
1005,2723,27-09-2019 06:24:00,1,4050.0,3423.0,0.845,19.746,117,53,30,23,64,40,24,23,0.06,0.07
1005,2724,27-09-2019 06:26:00,1,4043.0,3429.5,0.848,19.7255,91,44,26,18,47,19,28,56,0.0,0.0
1005,2725,27-09-2019 06:28:00,1,4036.0,3436.0,0.851,19.705,82,47,22,25,35,18,17,34,0.04,0.05
1005,2726,27-09-2019 06:30:00,1,3962.0,3364.0,0.849,19.336,213,112,83,29,101,69,32,14,0.14,0.0
1005,2727,27-09-2019 06:32:00,1,3104.0,2655.0,0.855,15.169,41,18,8,10,23,0,23,0,0.0,0.0
1005,2728,27-09-2019 06:34:00,1,3108.0,2654.0,0.854,15.183,81,35,21,14,46,27,19,2,0.04,0.0
1005,2729,27-09-2019 06:36:00,1,4213.0,3612.0,0.857,20.597,318,161,132,29,157,117,40,23,0.06,0.0
1005,2730,27-09-2019 06:38:00,1,4228.0,3719.0,0.88,20.775,245,120,91,29,125,97,28,60,0.08,0.02
1005,2731,27-09-2019 06:40:00,1,4208.0,3747.0,0.89,20.729,157,108,76,32,49,25,24,44,0.0,0.02
1005,2732,27-09-2019 06:42:00,1,4491.0,3930.0,0.875,22.046,174,108,76,32,66,39,27,16,0.0,0.04
1005,2733,27-09-2019 06:44:00,1,3547.0,3190.0,0.899,17.505,106,46,31,15,60,37,23,3,0.01,0.01
1005,2734,27-09-2019 06:46:00,1,3546.0,3135.0,0.884,17.444,120,63,42,21,57,31,26,27,0.11,0.0
1005,2735,27-09-2019 06:48:00,1,4507.0,3919.0,0.87,22.099,144,90,61,29,54,29,25,53,0.01,0.03
1005,2736,27-09-2019 06:50:00,1,4469.0,4052.0,0.907,22.093,178,108,77,31,70,44,26,35,0.09,0.05
1005,2737,27-09-2019 06:52:00,1,3811.0,3503.0,0.919,18.894,298,169,129,40,129,87,42,23,0.0,0.0
1005,2738,27-09-2019 06:54:00,1,4013.0,3586.0,0.893,19.781,386,196,136,60,190,133,57,1,0.09,0.01
1005,2739,27-09-2019 06:56:00,1,3801.0,3451.0,0.908,18.795,153,39,23,16,114,64,50,0,0.0,0.0
1005,2740,27-09-2019 06:58:00,1,3820.0,3422.0,0.896,18.838,112,37,18,19,75,30,45,0,0.0,0.0
1005,2741,27-09-2019 07:00:00,1,3534.0,3224.0,0.914,17.492,100,76,56,20,24,9,15,0,0.0,0.0
1005,2742,27-09-2019 07:02:00,1,3248.0,3026.0,0.932,16.146,208,170,143,27,38,8,30,0,0.0,0.0
1005,2743,27-09-2019 07:04:00,1,3226.0,3053.0,0.946,16.091,20,0,0,0,20,0,20,0,0.0,0.0
1005,2744,27-09-2019 07:06:00,1,3341.0,3120.0,0.934,16.619,37,5,1,4,32,9,23,0,0.0,0.0
1005,2745,27-09-2019 07:08:00,1,3454.0,3185.0,0.922,17.134,51,16,6,10,35,15,20,0,0.0,0.0
1005,2746,27-09-2019 07:10:00,1,3387.0,3250.0,0.959,16.942,72,28,0,28,44,20,24,0,0.01,0.01
1005,2747,27-09-2019 07:12:00,1,3424.0,3229.0,0.943,17.064,71,29,2,27,42,20,22,0,0.0,0.0
1005,2748,27-09-2019 07:14:00,1,3192.0,3135.0,0.982,16.046,96,55,29,26,41,21,20,0,0.0,0.0
1005,2749,27-09-2019 07:16:00,1,3208.0,3131.0,0.976,16.106,53,17,5,12,36,12,24,0,0.0,0.0
1005,2750,27-09-2019 07:18:00,1,3218.0,3112.0,0.967,16.124,34,3,0,3,31,10,21,0,0.0,0.0
1005,2751,27-09-2019 07:20:00,1,3227.0,3016.0,0.935,16.052,249,123,89,34,126,87,39,18,0.0,0.0
1005,2752,27-09-2019 07:22:00,1,3406.0,3294.0,0.967,17.066,247,93,56,37,154,102,52,31,0.01,0.0
1005,2753,27-09-2019 07:24:00,1,3181.0,3202.0,1.006,16.079,654,364,298,66,290,215,75,11,0.0,0.01
1005,2754,27-09-2019 07:26:00,1,3657.0,3542.0,0.969,18.33,370,182,142,40,188,141,47,40,0.0,0.0
1005,2755,27-09-2019 07:28:00,1,3660.0,3663.0,1.001,18.477,380,186,146,40,194,149,45,43,0.1,0.0
1005,2756,27-09-2019 07:30:00,1,3570.0,3484.0,0.976,17.922,124,28,16,12,96,58,38,30,0.01,0.0
1005,2757,27-09-2019 07:32:00,1,3687.0,3564.0,0.967,18.471,272,123,85,38,149,102,47,12,0.1,0.0
1005,2758,27-09-2019 07:34:00,1,3864.0,3781.0,0.978,19.4105,203,105,69,36,98,66,32,48,0.0,0.0
1005,2759,27-09-2019 07:36:00,1,4041.0,3998.0,0.989,20.35,117,41,19,22,76,41,35,46,0.01,0.06
1005,2760,27-09-2019 07:38:00,1,4209.0,4052.0,0.963,21.069,202,115,76,39,87,35,52,56,0.0,0.02
1005,2761,27-09-2019 07:40:00,1,4018.0,4026.0,1.002,20.289,307,159,116,43,148,115,33,47,0.11,0.06
1005,2762,27-09-2019 07:42:00,1,3675.0,3510.0,0.955,18.367,482,258,194,64,224,178,46,6,0.07,0.02
1005,2763,27-09-2019 07:44:00,1,3828.0,3790.0,0.99,19.28,248,130,100,30,118,87,31,20,0.0,0.0
1005,2764,27-09-2019 07:46:00,1,3832.0,3812.0,0.995,19.316,218,49,27,22,169,93,76,0,0.0,0.0
1005,2765,27-09-2019 07:48:00,1,3655.0,3646.0,0.998,18.436,157,42,2,40,115,56,59,0,0.0,0.0
1005,2766,27-09-2019 07:50:00,1,3683.0,3507.0,0.952,18.393,130,8,2,6,122,72,50,0,0.0,0.0
1005,2767,27-09-2019 07:52:00,1,3701.0,3459.0,0.935,18.409,66,3,2,1,63,31,32,0,0.0,0.0
1005,2768,27-09-2019 07:54:00,1,3697.0,3473.0,0.939,18.409,144,4,2,2,140,75,65,0,0.0,0.0
1005,2769,27-09-2019 07:56:00,1,3356.0,3378.0,1.006,16.963,99,0,0,0,99,41,58,0,0.0,0.0
1005,2770,27-09-2019 07:58:00,1,3383.0,3335.0,0.986,17.019,153,0,0,0,153,90,63,0,0.0,0.0
1005,2771,27-09-2019 08:00:00,1,3407.0,3311.0,0.972,17.089,93,31,19,12,62,31,31,0,0.0,0.0
1005,2772,27-09-2019 08:02:00,1,3296.0,3280.0,0.995,16.618,41,6,1,5,35,11,24,0,0.0,0.0
1005,2773,27-09-2019 08:04:00,1,3191.0,3204.0,1.004,16.121,67,15,3,12,52,24,28,0,0.0,0.0
1005,2774,27-09-2019 08:06:00,1,3215.0,3108.0,0.967,16.108,58,8,1,7,50,21,29,0,0.0,0.0
1005,2775,27-09-2019 08:08:00,1,3059.5,3032.5,0.9925,15.4115,64,2,1,1,62,29,33,0,0.0,0.0
1005,2776,27-09-2019 08:10:00,1,2904.0,2957.0,1.018,14.715,122,11,5,6,111,83,28,0,0.0,0.0
1005,2777,27-09-2019 08:12:00,1,3094.0,3089.0,0.998,15.61,30,0,0,0,30,11,19,0,0.0,0.0
1005,2778,27-09-2019 08:14:00,1,2881.0,3026.0,1.05,14.699,60,4,0,4,56,39,17,0,0.0,0.0
1005,2779,27-09-2019 08:16:00,1,2912.0,2944.0,1.011,14.732,76,0,0,0,76,34,42,0,0.0,0.0
1005,2780,27-09-2019 08:18:00,1,2936.0,2875.0,0.979,14.752,137,18,10,8,119,57,62,0,0.0,0.0
1005,2781,27-09-2019 08:20:00,1,2924.0,2878.0,0.984,14.707,82,9,0,9,73,27,46,0,0.0,0.0
1005,2782,27-09-2019 08:22:00,1,2828.0,2816.0,0.996,14.258,82,2,0,2,80,34,46,0,0.0,0.0
1005,2783,27-09-2019 08:24:00,1,2714.0,2802.0,1.032,13.793,88,5,0,5,83,33,50,0,0.0,0.0
1005,2784,27-09-2019 08:26:00,1,2733.0,2716.0,0.994,13.777,85,0,0,0,85,27,58,0,0.0,0.0
1005,2785,27-09-2019 08:28:00,1,2760.0,2626.0,0.951,13.782,93,18,1,17,75,31,44,0,0.0,0.0
1005,2786,27-09-2019 08:30:00,1,2743.0,2679.0,0.976,13.773,112,26,8,18,86,40,46,0,0.0,0.0
1005,2787,27-09-2019 08:32:00,1,2912.0,2903.0,0.997,14.687,365,180,129,51,185,119,66,6,0.0,0.0
1005,2788,27-09-2019 08:34:00,1,2882.0,3027.0,1.05,14.705,348,202,148,54,146,100,46,49,0.05,0.0
1005,2789,27-09-2019 08:36:00,1,3275.0,3352.0,1.024,16.613,115,74,46,28,41,22,19,53,0.01,0.0
1005,2790,27-09-2019 08:38:00,1,3350.0,3496.0,1.043,17.07,109,56,25,31,53,18,35,57,0.0,0.04
1005,2791,27-09-2019 08:40:00,1,3564.0,3545.0,0.995,17.967,172,108,61,47,64,24,40,51,0.0,0.0
1005,2792,27-09-2019 08:42:00,1,3357.5,3451.5,1.0305,17.0485,251,135,94,41,116,87,29,29,0.11,0.11
1005,2793,27-09-2019 08:44:00,1,3151.0,3358.0,1.066,16.13,190,117,79,38,73,40,33,42,0.01,0.0
1005,2794,27-09-2019 08:46:00,1,3721.0,3811.0,1.024,18.878,158,74,40,34,84,29,55,68,0.0,0.0
1005,2795,27-09-2019 08:48:00,1,3676.0,3971.0,1.08,18.881,127,32,22,10,95,52,43,66,0.0,0.08
1005,2796,27-09-2019 08:50:00,1,3888.0,4049.0,1.041,19.801,343,182,141,41,161,117,44,65,0.16,0.01
1005,2797,27-09-2019 08:52:00,1,3685.0,3931.0,1.067,18.871,220,83,56,27,137,95,42,37,0.01,0.02
1005,2798,27-09-2019 08:54:00,1,3981.0,4130.0,1.038,20.258,138,23,5,18,115,68,47,49,0.0,0.05
1005,2799,27-09-2019 08:56:00,1,3981.0,4165.0,1.046,20.294,138,31,8,23,107,48,59,38,0.0,0.15
1005,2800,27-09-2019 08:58:00,1,3552.0,3608.0,1.016,17.987,653,278,210,68,375,310,65,5,0.09,0.0
1005,2801,27-09-2019 09:00:00,1,3249.0,3365.0,1.036,16.525,1019,558,454,104,461,369,92,11,0.0,0.0
1005,2802,27-09-2019 09:02:00,1,3074.0,3243.0,1.055,15.7,337,161,132,29,176,126,50,11,0.0,0.0
1005,2803,27-09-2019 09:04:00,1,3738.0,3789.0,1.014,18.921,141,16,4,12,125,62,63,54,0.01,0.0
1005,2804,27-09-2019 09:06:00,1,4349.0,4554.0,1.047,22.176,230,37,14,23,193,126,67,28,0.06,0.04
1005,2805,27-09-2019 09:08:00,1,3738.0,3826.0,1.024,18.965,856,41,18,23,815,710,105,0,0.01,0.01
1005,2806,27-09-2019 09:10:00,1,3547.0,3553.0,1.002,17.906,892,40,13,27,852,756,96,0,0.0,0.02
1005,2807,27-09-2019 09:12:00,1,3708.0,3892.0,1.05,18.917,904,31,9,22,873,784,89,0,0.0,0.0
1005,2808,27-09-2019 09:14:00,1,3883.0,4072.0,1.049,19.806,724,49,13,36,675,572,103,0,0.0,0.0
1005,2809,27-09-2019 09:16:00,1,3755.0,3873.5,1.031,19.0825,256,6,0,6,250,187,63,0,0.0,0.0
1005,2810,27-09-2019 09:18:00,1,3627.0,3675.0,1.013,18.359,161,0,0,0,161,106,55,0,0.0,0.0
1005,2811,27-09-2019 09:20:00,1,3643.0,3721.0,1.021,18.472,386,5,1,4,381,308,73,0,0.01,0.0
1005,2812,27-09-2019 09:22:00,1,3840.0,3865.0,1.006,19.407,385,0,0,0,385,321,64,0,0.0,0.0
1005,2813,27-09-2019 09:24:00,1,3621.0,3722.0,1.028,18.388,401,0,0,0,401,318,83,0,0.0,0.0
1005,2814,27-09-2019 09:26:00,1,3670.0,3601.0,0.981,18.446,398,19,11,8,379,306,73,0,0.0,0.0
1005,2815,27-09-2019 09:28:00,1,3330.0,3500.0,1.051,16.994,328,7,4,3,321,235,86,0,0.0,0.0
1005,2816,27-09-2019 09:30:00,1,3384.0,3418.0,1.01,17.117,404,6,4,2,398,314,84,0,0.0,0.0
1005,2817,27-09-2019 09:32:00,1,3162.0,3278.0,1.037,16.084,447,3,0,3,444,330,114,0,0.01,0.0
1005,2818,27-09-2019 09:34:00,1,3188.0,3213.0,1.008,16.118,363,15,7,8,348,253,95,0,0.0,0.0
1005,2819,27-09-2019 09:36:00,1,3198.0,3158.0,0.987,16.097,411,0,0,0,411,313,98,0,0.0,0.0
1005,2820,27-09-2019 09:38:00,1,3006.0,3069.0,1.021,15.241,326,11,6,5,315,223,92,0,0.0,0.0
1005,2821,27-09-2019 09:40:00,1,3176.0,3237.0,1.019,16.099,241,1,0,1,240,165,75,0,0.0,0.0
1005,2822,27-09-2019 09:42:00,1,3147.0,3326.0,1.057,16.081,229,19,4,15,210,138,72,0,0.0,0.0
1005,2823,27-09-2019 09:44:00,1,3176.0,3330.0,1.048,16.2,300,6,3,3,294,210,84,0,0.0,0.0
1005,2824,27-09-2019 09:46:00,1,3163.0,3278.0,1.036,16.091,299,13,4,9,286,212,74,0,0.0,0.0
1005,2825,27-09-2019 09:48:00,1,3142.0,3369.0,1.072,16.11,420,4,2,2,416,305,111,0,0.0,0.0
1005,2826,27-09-2019 09:50:00,1,2873.0,3109.5,1.083,14.7625,393,0,0,0,393,302,91,0,0.0,0.0
1005,2827,27-09-2019 09:52:00,1,2604.0,2850.0,1.094,13.415,437,48,40,8,389,295,94,4,0.0,0.0
1005,2828,27-09-2019 09:54:00,1,2802.0,2985.0,1.066,14.344,266,33,21,12,233,198,35,3,0.0,0.0
1005,2829,27-09-2019 09:56:00,1,3035.0,3310.0,1.091,15.62,334,3,0,3,331,286,45,0,0.0,0.0
1005,2830,27-09-2019 09:58:00,1,3047.0,3276.0,1.075,15.63,384,28,13,15,356,301,55,27,0.0,0.0
1005,2831,27-09-2019 10:00:00,1,3237.0,3415.0,1.055,16.536,130,17,3,14,113,73,40,49,0.0,0.05
1005,2832,27-09-2019 10:02:00,1,3218.0,3569.0,1.109,16.629,242,8,0,8,234,167,67,31,0.0,0.06
1005,2833,27-09-2019 10:04:00,1,3315.0,3626.0,1.094,17.073,581,268,212,56,313,239,74,14,0.12,0.04
1005,2834,27-09-2019 10:06:00,1,3248.0,3432.0,1.057,16.595,774,389,316,73,385,306,79,11,0.05,0.0
1005,2835,27-09-2019 10:08:00,1,3222.0,3489.0,1.083,16.556,139,14,6,8,125,86,39,32,0.0,0.06
1005,2836,27-09-2019 10:10:00,1,3697.0,3960.0,1.071,18.949,158,22,14,8,136,64,72,49,0.0,0.07
1005,2837,27-09-2019 10:12:00,1,3695.0,3917.0,1.06,18.893,160,22,7,15,138,78,60,33,0.01,0.05
1005,2838,27-09-2019 10:14:00,1,3498.0,3746.0,1.071,17.927,649,393,316,77,256,183,73,1,0.09,0.02
1005,2839,27-09-2019 10:16:00,1,3211.0,3539.0,1.102,16.568,191,48,21,27,143,98,45,0,0.0,0.0
1005,2840,27-09-2019 10:18:00,1,3265.0,3373.0,1.033,16.597,205,36,17,19,169,106,63,0,0.02,0.01
1005,2841,27-09-2019 10:20:00,1,3426.0,3557.0,1.038,17.437,251,51,26,25,200,144,56,0,0.0,0.0
1005,2842,27-09-2019 10:22:00,1,3446.0,3585.0,1.04,17.546,133,12,7,5,121,77,44,0,0.0,0.0
1005,2843,27-09-2019 10:24:00,1,3390.5,3545.0,1.0455,17.2825,90,8,0,8,82,38,44,0,0.0,0.0
1005,2844,27-09-2019 10:26:00,1,3335.0,3505.0,1.051,17.019,127,10,0,10,117,68,49,0,0.0,0.0
1005,2845,27-09-2019 10:28:00,1,3344.0,3456.0,1.033,17.003,79,7,0,7,72,36,36,0,0.0,0.0
1005,2846,27-09-2019 10:30:00,1,3257.0,3382.0,1.038,16.579,276,103,69,34,173,121,52,0,0.0,0.0
1005,2847,27-09-2019 10:32:00,1,3379.0,3419.0,1.012,17.099,137,23,1,22,114,57,57,0,0.0,0.0
1005,2848,27-09-2019 10:34:00,1,3363.0,3413.0,1.015,17.028,90,6,0,6,84,36,48,0,0.0,0.0
1005,2849,27-09-2019 10:36:00,1,3154.0,3365.0,1.067,16.153,296,2,0,2,294,242,52,0,0.0,0.0
1005,2850,27-09-2019 10:38:00,1,3163.0,3335.0,1.054,16.153,233,3,1,2,230,203,27,0,0.0,0.0
1005,2851,27-09-2019 10:40:00,1,3176.0,3251.0,1.024,16.114,254,17,7,10,237,175,62,0,0.0,0.0
1005,2852,27-09-2019 10:42:00,1,2984.0,3167.0,1.061,15.261,182,0,0,0,182,155,27,0,0.0,0.0
1005,2853,27-09-2019 10:44:00,1,2895.0,2973.0,1.027,14.699,213,0,0,0,213,150,63,0,0.0,0.0
1005,2854,27-09-2019 10:46:00,1,2918.0,2908.0,0.996,14.717,120,9,1,8,111,68,43,0,0.0,0.0
1005,2855,27-09-2019 10:48:00,1,2818.0,2890.0,1.025,14.303,153,29,17,12,124,67,57,0,0.0,0.0
1005,2856,27-09-2019 10:50:00,1,2880.0,3065.0,1.064,14.742,107,3,2,1,104,52,52,0,0.0,0.0
1005,2857,27-09-2019 10:52:00,1,2883.0,3008.0,1.044,14.688,138,5,2,3,133,78,55,0,0.0,0.0
1005,2858,27-09-2019 10:54:00,1,2900.0,3008.0,1.037,14.757,172,43,34,9,129,79,50,0,0.0,0.0
1005,2859,27-09-2019 10:56:00,1,2880.0,3105.0,1.078,14.785,133,0,0,0,133,79,54,0,0.0,0.0
1005,2860,27-09-2019 10:58:00,1,2733.0,2975.5,1.0895,14.061,131,2,0,2,129,68,61,0,0.0,0.0
1005,2861,27-09-2019 11:00:00,1,2586.0,2846.0,1.101,13.337,123,4,0,4,119,65,54,0,0.0,0.0
1005,2862,27-09-2019 11:02:00,1,2610.0,2797.0,1.072,13.379,161,8,2,6,153,92,61,0,0.0,0.0
1005,2863,27-09-2019 11:04:00,1,2577.0,2908.0,1.128,13.373,226,3,2,1,223,150,73,0,0.0,0.0
1005,2864,27-09-2019 11:06:00,1,2794.0,2942.0,1.053,14.265,103,7,0,7,96,64,32,0,0.0,0.0
1005,2865,27-09-2019 11:08:00,1,2581.0,2857.0,1.107,13.33,60,2,1,1,58,31,27,0,0.0,0.0
1005,2866,27-09-2019 11:10:00,1,2592.0,2861.0,1.104,13.378,153,34,6,28,119,54,65,0,0.0,0.0
1005,2867,27-09-2019 11:12:00,1,2692.0,2940.0,1.092,13.862,268,76,44,32,192,123,69,0,0.0,0.0
1005,2868,27-09-2019 11:14:00,1,2959.0,3233.0,1.093,15.236,346,23,5,18,323,246,77,0,0.0,0.0
1005,2869,27-09-2019 11:16:00,1,3033.0,3359.0,1.107,15.667,132,10,1,9,122,88,34,0,0.0,0.0
1005,2870,27-09-2019 11:18:00,1,2963.0,3213.0,1.084,15.232,34,0,0,0,34,9,25,0,0.0,0.0
1005,2871,27-09-2019 11:20:00,1,2762.0,3084.0,1.117,14.297,53,0,0,0,53,20,33,0,0.0,0.0
1005,2872,27-09-2019 11:22:00,1,2778.0,3024.0,1.089,14.293,40,0,0,0,40,10,30,0,0.0,0.0
1005,2873,27-09-2019 11:24:00,1,2797.0,2958.0,1.058,14.295,55,0,0,0,55,27,28,0,0.0,0.0
1005,2874,27-09-2019 11:26:00,1,2687.0,2884.0,1.073,13.781,40,3,1,2,37,9,28,0,0.0,0.0
1005,2875,27-09-2019 11:28:00,1,2587.0,2894.0,1.118,13.397,182,87,56,31,95,57,38,16,0.03,0.0
1005,2876,27-09-2019 11:30:00,1,2959.0,3210.0,1.085,15.212,114,65,34,31,49,23,26,48,0.0,0.21
1005,2877,27-09-2019 11:32:00,1,2992.0,3301.5,1.1035,15.4425,53,0,0,0,53,19,34,0,0.0,0.0
1005,2878,27-09-2019 11:34:00,1,3025.0,3393.0,1.122,15.673,28,1,0,1,27,8,19,0,0.0,0.0
1005,2879,27-09-2019 11:36:00,1,3127.0,3405.0,1.089,16.087,172,51,24,27,121,90,31,6,0.07,0.04
1005,2880,27-09-2019 11:38:00,1,3129.0,3415.0,1.092,16.109,842,343,283,60,499,399,100,28,0.08,0.0
1005,2881,27-09-2019 11:40:00,1,3202.0,3548.0,1.108,16.543,558,150,110,40,408,344,64,0,0.0,0.0
1005,2882,27-09-2019 11:42:00,1,3036.0,3378.0,1.113,15.701,532,39,10,29,493,421,72,0,0.0,0.0
1005,2883,27-09-2019 11:44:00,1,3221.0,3511.0,1.09,16.578,331,8,0,8,323,237,86,0,0.0,0.0
1005,2884,27-09-2019 11:46:00,1,3205.0,3521.0,1.099,16.527,349,26,11,15,323,234,89,0,0.02,0.0
1005,2885,27-09-2019 11:48:00,1,3532.0,3684.0,1.043,17.993,62,24,8,16,38,8,30,0,0.0,0.0
1005,2886,27-09-2019 11:50:00,1,3337.0,3598.0,1.078,17.129,55,8,3,5,47,19,28,0,0.0,0.0
1005,2887,27-09-2019 11:52:00,1,3227.0,3446.0,1.068,16.529,58,4,2,2,54,30,24,0,0.0,0.0
1005,2888,27-09-2019 11:54:00,1,3250.0,3399.0,1.046,16.567,42,4,0,4,38,13,25,0,0.0,0.0
1005,2889,27-09-2019 11:56:00,1,3046.0,3289.0,1.08,15.642,19,0,0,0,19,0,19,0,0.0,0.0
1005,2890,27-09-2019 11:58:00,1,3070.0,3236.0,1.054,15.678,72,18,8,10,54,17,37,0,0.0,0.0
1005,2891,27-09-2019 12:00:00,1,3062.0,3282.0,1.072,15.698,48,6,2,4,42,2,40,0,0.0,0.0
1005,2892,27-09-2019 12:02:00,1,3054.0,3293.0,1.078,15.676,63,19,8,11,44,14,30,0,0.0,0.0
1005,2893,27-09-2019 12:04:00,1,3066.0,3183.0,1.038,15.605,40,9,2,7,31,2,29,0,0.0,0.0
1005,2894,27-09-2019 12:06:00,1,3057.5,3202.5,1.0475,15.5915,162,76,61,15,86,50,36,7,0.05,0.06
1005,2895,27-09-2019 12:08:00,1,3049.0,3222.0,1.057,15.578,138,0,0,0,138,97,41,0,0.0,0.0
1005,2896,27-09-2019 12:10:00,1,2763.0,3073.0,1.113,14.286,194,0,0,0,194,152,42,0,0.02,0.0
1005,2897,27-09-2019 12:12:00,1,2767.0,3058.0,1.105,14.287,172,0,0,0,172,133,39,0,0.0,0.0
1005,2898,27-09-2019 12:14:00,1,2739.0,3135.0,1.145,14.263,213,13,6,7,200,150,50,0,0.0,0.0
1005,2899,27-09-2019 12:16:00,1,2764.0,3024.0,1.094,14.239,183,13,7,6,170,104,66,0,0.0,0.0
1005,2900,27-09-2019 12:18:00,1,2685.0,2909.0,1.084,13.798,132,0,0,0,132,70,62,0,0.0,0.0
1005,2901,27-09-2019 12:20:00,1,2616.0,2775.0,1.061,13.378,139,0,0,0,139,85,54,0,0.0,0.0
1005,2902,27-09-2019 12:22:00,1,2641.0,2690.0,1.019,13.384,407,5,0,5,402,344,58,0,0.0,0.0
1005,2903,27-09-2019 12:24:00,1,2607.0,2766.0,1.061,13.334,234,46,31,15,188,131,57,1,0.0,0.0
1005,2904,27-09-2019 12:26:00,1,2791.0,2968.0,1.064,14.28,145,4,1,3,141,86,55,0,0.0,0.0
1005,2905,27-09-2019 12:28:00,1,2783.0,2990.0,1.075,14.273,189,1,0,1,188,136,52,0,0.0,0.0
1005,2906,27-09-2019 12:30:00,1,2795.0,2940.0,1.052,14.266,102,1,0,1,101,55,46,0,0.0,0.0
1005,2907,27-09-2019 12:32:00,1,2803.0,2930.0,1.045,14.286,126,5,0,5,121,64,57,0,0.0,0.0
1005,2908,27-09-2019 12:34:00,1,2779.0,2984.0,1.074,14.253,225,4,0,4,221,149,72,0,0.0,0.0
1005,2909,27-09-2019 12:36:00,1,2759.0,3048.0,1.104,14.246,318,7,0,7,311,236,75,0,0.0,0.0
1005,2910,27-09-2019 12:38:00,1,2582.0,2929.0,1.134,13.415,387,7,0,7,380,298,82,0,0.0,0.0
1005,2911,27-09-2019 12:40:00,1,2593.0,2860.5,1.103,13.3835,517,2,1,1,515,457,58,0,0.0,0.0
1005,2912,27-09-2019 12:42:00,1,2604.0,2792.0,1.072,13.352,487,1,0,1,486,396,90,0,0.0,0.0
1005,2913,27-09-2019 12:44:00,1,2629.0,2756.0,1.048,13.411,466,8,0,8,458,367,91,0,0.0,0.0
1005,2914,27-09-2019 12:46:00,1,2414.0,2693.0,1.115,12.492,492,0,0,0,492,386,106,0,0.0,0.0
1005,2915,27-09-2019 12:48:00,1,2614.0,2804.0,1.073,13.404,616,59,45,14,557,464,93,2,0.0,0.0
1005,2916,27-09-2019 12:50:00,1,2792.0,2967.0,1.063,14.285,288,54,14,40,234,153,81,0,0.0,0.0
1006,1,23-09-2019 11:40:00,1,3698.0,2775.0,0.751,17.642,0,0,0,0,0,0,0,0,0.0,0.02
1006,2,23-09-2019 11:42:00,1,3736.0,2707.0,0.724,17.717,1,0,0,0,1,0,1,0,0.01,0.0
1006,3,23-09-2019 11:44:00,1,3488.0,2580.0,0.74,16.602,15,6,0,6,9,0,9,0,0.0,0.0
1006,4,23-09-2019 11:46:00,1,3387.0,2467.0,0.728,16.078,5,4,0,4,1,0,1,0,0.03,0.0
1006,5,23-09-2019 11:48:00,1,3274.0,2392.5,0.7305,15.5495,19,3,1,2,16,2,14,0,0.0,0.0
1006,6,23-09-2019 11:50:00,1,3161.0,2318.0,0.733,15.021,189,123,87,36,66,40,26,7,0.0,0.0
1006,7,23-09-2019 11:52:00,1,3353.0,2585.0,0.771,16.075,332,170,128,42,162,117,45,34,0.0,0.03
1006,8,23-09-2019 11:54:00,1,4039.0,3066.0,0.759,19.309,502,279,222,57,223,167,56,33,0.0,0.0
1006,9,23-09-2019 11:56:00,1,4153.0,3120.0,0.751,19.816,426,265,218,47,161,113,48,30,0.01,0.0
1006,10,23-09-2019 11:58:00,1,3920.0,2975.0,0.759,18.74,150,76,54,22,74,41,33,4,0.0,0.0
1006,11,23-09-2019 12:00:00,1,3939.0,2912.0,0.739,18.745,11,10,6,4,1,0,1,0,0.01,0.0
1006,12,23-09-2019 12:02:00,1,3719.0,2770.0,0.745,17.719,0,0,0,0,0,0,0,0,0.0,0.0
1006,13,23-09-2019 12:04:00,1,3489.0,2601.0,0.745,16.625,6,1,0,1,5,2,3,0,0.0,0.0
1006,14,23-09-2019 12:06:00,1,3384.0,2466.0,0.729,16.065,3,0,0,0,3,2,1,0,0.0,0.0
1006,15,23-09-2019 12:08:00,1,3161.0,2348.0,0.743,15.055,3,0,0,0,3,0,3,0,0.0,0.0
1006,16,23-09-2019 12:10:00,1,2922.0,2221.0,0.76,13.972,5,0,0,0,5,2,3,0,0.03,0.0
1006,17,23-09-2019 12:12:00,1,2810.0,2118.0,0.754,13.417,2,0,0,0,2,0,2,0,0.0,0.0
1006,18,23-09-2019 12:14:00,1,2820.0,2058.0,0.73,13.39,19,0,0,0,19,5,14,0,0.0,0.0
1006,19,23-09-2019 12:16:00,1,2805.0,2130.0,0.759,13.41,159,90,62,28,69,43,26,32,0.0,0.0
1006,20,23-09-2019 12:18:00,1,3357.0,2605.0,0.776,16.113,188,100,57,43,88,54,34,22,0.0,0.0
1006,21,23-09-2019 12:20:00,1,3383.0,2512.0,0.742,16.111,239,128,93,35,111,70,41,8,0.0,0.0
1006,22,23-09-2019 12:22:00,1,3444.5,2517.5,0.731,16.359,95,46,18,28,49,23,26,5,0.0,0.0
1006,23,23-09-2019 12:24:00,1,3506.0,2523.0,0.72,16.607,110,32,11,21,78,50,28,2,0.0,0.0
1006,24,23-09-2019 12:26:00,1,3514.0,2536.0,0.722,16.652,86,35,14,21,51,28,23,0,0.0,0.0
1006,25,23-09-2019 12:28:00,1,3523.0,2522.0,0.716,16.674,106,28,9,19,78,57,21,0,0.0,0.0
1006,26,23-09-2019 12:30:00,1,3506.0,2527.0,0.721,16.611,82,24,5,19,58,32,26,0,0.0,0.0
1006,27,23-09-2019 12:32:00,1,3501.0,2565.0,0.732,16.635,47,21,10,11,26,11,15,0,0.0,0.0
1006,28,23-09-2019 12:34:00,1,3500.0,2540.0,0.726,16.602,102,33,8,25,69,44,25,0,0.0,0.0
1006,29,23-09-2019 12:36:00,1,3393.0,2446.0,0.721,16.077,75,2,0,2,73,56,17,0,0.0,0.0
1006,30,23-09-2019 12:38:00,1,3036.0,2261.0,0.745,14.466,24,0,0,0,24,4,20,0,0.0,0.0
1006,31,23-09-2019 12:40:00,1,2953.0,2085.0,0.706,13.942,6,0,0,0,6,0,6,0,0.0,0.0
1006,32,23-09-2019 12:42:00,1,2717.0,1938.0,0.713,12.851,17,9,5,4,8,3,5,0,0.0,0.0
1006,33,23-09-2019 12:44:00,1,2618.0,1842.0,0.704,12.356,29,8,1,7,21,3,18,1,0.0,0.0
1006,34,23-09-2019 12:46:00,1,2700.0,2010.0,0.744,12.865,0,0,0,0,0,0,0,0,0.0,0.0
1006,35,23-09-2019 12:48:00,1,2732.0,1896.0,0.694,12.863,0,0,0,0,0,0,0,0,0.0,0.0
1006,36,23-09-2019 12:50:00,1,2479.0,1807.0,0.729,11.766,0,0,0,0,0,0,0,0,0.0,0.0
1006,37,23-09-2019 12:52:00,1,2499.0,1779.0,0.712,11.814,0,0,0,0,0,0,0,0,0.0,0.0
1006,38,23-09-2019 12:54:00,1,2503.0,1715.0,0.685,11.76,0,0,0,0,0,0,0,0,0.0,0.0
1006,39,23-09-2019 12:56:00,1,2510.5,1693.5,0.6745,11.7665,0,0,0,0,0,0,0,0,0.0,0.0
1006,40,23-09-2019 12:58:00,1,2518.0,1672.0,0.664,11.773,25,10,6,4,15,6,9,0,0.0,0.0
1006,41,23-09-2019 13:00:00,1,2518.0,1712.0,0.68,11.815,16,7,0,7,9,0,9,0,0.0,0.0
1006,42,23-09-2019 13:02:00,1,2524.0,1671.0,0.662,11.794,34,1,0,1,33,0,33,0,0.0,0.0
1006,43,23-09-2019 13:04:00,1,2391.0,1638.0,0.685,11.234,125,39,17,22,86,47,39,3,0.0,0.0
1006,44,23-09-2019 13:06:00,1,2514.0,1695.0,0.674,11.782,161,78,41,37,83,49,34,15,0.0,0.0
1006,45,23-09-2019 13:08:00,1,3286.0,2368.0,0.721,15.57,116,92,58,34,24,2,22,52,0.0,0.0
1006,46,23-09-2019 13:10:00,1,3869.0,2716.0,0.702,18.252,179,103,77,26,76,48,28,23,0.0,0.0
1006,47,23-09-2019 13:12:00,1,2821.0,2061.0,0.73,13.397,44,24,8,16,20,8,12,3,0.0,0.0
1006,48,23-09-2019 13:14:00,1,2708.0,1981.0,0.732,12.862,114,59,40,19,55,30,25,10,0.0,0.0
1006,49,23-09-2019 13:16:00,1,3492.0,2621.0,0.75,16.662,155,86,60,26,69,48,21,11,0.0,0.0
1006,50,23-09-2019 13:18:00,1,3049.0,2223.0,0.729,14.477,69,42,24,18,27,16,11,2,0.0,0.0
1006,51,23-09-2019 13:20:00,1,3270.0,2401.0,0.734,15.542,193,103,77,26,90,67,23,19,0.0,0.0
1006,52,23-09-2019 13:22:00,1,3278.0,2358.0,0.719,15.529,209,125,91,34,84,62,22,4,0.0,0.0
1006,53,23-09-2019 13:24:00,1,2705.0,2016.0,0.745,12.891,85,59,42,17,26,14,12,0,0.0,0.0
1006,54,23-09-2019 13:26:00,1,3516.0,2495.0,0.709,16.616,2,1,0,1,1,0,1,0,0.0,0.0
1006,55,23-09-2019 13:28:00,1,3489.0,2572.0,0.737,16.594,189,92,64,28,97,64,33,13,0.0,0.01
1006,56,23-09-2019 13:30:00,1,3093.0,2300.0,0.7445,14.7335,38,7,4,3,31,11,20,0,0.0,0.0
1006,57,23-09-2019 13:32:00,1,2697.0,2028.0,0.752,12.873,57,28,13,15,29,5,24,0,0.0,0.0
1006,58,23-09-2019 13:34:00,1,2929.0,2171.0,0.741,13.943,204,120,89,31,84,57,27,5,0.0,0.0
1006,59,23-09-2019 13:36:00,1,3042.0,2248.0,0.739,14.474,18,3,1,2,15,2,13,0,0.0,0.0
1006,60,23-09-2019 13:38:00,1,2811.0,2097.0,0.746,13.398,9,4,1,3,5,1,4,0,0.0,0.0
1006,61,23-09-2019 13:40:00,1,2692.0,2040.0,0.758,12.865,10,10,0,10,0,0,0,0,0.0,0.0
1006,62,23-09-2019 13:42:00,1,2728.0,1940.0,0.711,12.898,0,0,0,0,0,0,0,0,0.0,0.0
1006,63,23-09-2019 13:44:00,1,2475.0,1854.0,0.749,11.804,6,6,0,6,0,0,0,0,0.0,0.0
1006,64,23-09-2019 13:46:00,1,2490.0,1779.0,0.715,11.78,134,65,50,15,69,51,18,0,0.0,0.0
1006,65,23-09-2019 13:48:00,1,2498.0,1772.0,0.709,11.802,5,0,0,0,5,0,5,0,0.0,0.0
1006,66,23-09-2019 13:50:00,1,2496.0,1754.0,0.703,11.776,12,2,1,1,10,0,10,0,0.0,0.0
1006,67,23-09-2019 13:52:00,1,2514.0,1708.0,0.679,11.799,30,0,0,0,30,0,30,0,0.0,0.0
1006,68,23-09-2019 13:54:00,1,2386.0,1689.0,0.708,11.271,0,0,0,0,0,0,0,0,0.0,0.0
1006,69,23-09-2019 13:56:00,1,2386.0,1669.0,0.7,11.25,0,0,0,0,0,0,0,0,0.0,0.0
1006,70,23-09-2019 13:58:00,1,2261.0,1647.0,0.728,10.731,36,4,0,4,32,0,32,0,0.0,0.0
1006,71,23-09-2019 14:00:00,1,2139.0,1604.0,0.75,10.203,34,3,0,3,31,0,31,0,0.0,0.0
1006,72,23-09-2019 14:02:00,1,2135.0,1585.0,0.742,10.168,5,0,0,0,5,0,5,0,0.0,0.0
1006,73,23-09-2019 14:04:00,1,2138.5,1574.0,0.736,10.1685,15,8,4,4,7,2,5,0,0.0,0.0
1006,74,23-09-2019 14:06:00,1,2142.0,1563.0,0.73,10.169,5,2,0,2,3,1,2,0,0.0,0.0
1006,75,23-09-2019 14:08:00,1,2158.0,1535.0,0.711,10.204,5,4,2,2,1,0,1,0,0.0,0.0
1006,76,23-09-2019 14:10:00,1,2035.0,1470.0,0.723,9.644,1,1,1,0,0,0,0,0,0.0,0.0
1006,77,23-09-2019 14:12:00,1,1915.0,1447.0,0.755,9.149,3,2,1,1,1,0,1,0,0.0,0.0
1006,78,23-09-2019 14:14:00,1,2036.0,1466.0,0.72,9.645,4,0,0,0,4,1,3,0,0.0,0.0
1006,79,23-09-2019 14:16:00,1,2155.0,1492.0,0.692,10.144,19,1,0,1,18,0,18,0,0.0,0.0
1006,80,23-09-2019 14:18:00,1,2166.0,1518.0,0.701,10.217,25,1,0,1,24,0,24,0,0.0,0.0
1006,81,23-09-2019 14:20:00,1,2160.0,1497.0,0.693,10.17,6,4,1,3,2,1,1,0,0.0,0.0
1006,82,23-09-2019 14:22:00,1,2152.0,1511.0,0.702,10.152,3,2,0,2,1,0,1,0,0.0,0.0
1006,83,23-09-2019 14:24:00,1,2147.0,1553.0,0.724,10.18,2,0,0,0,2,0,2,0,0.0,0.0
1006,84,23-09-2019 14:26:00,1,2145.0,1573.0,0.733,10.194,8,5,1,4,3,0,3,0,0.0,0.0
1006,85,23-09-2019 14:28:00,1,2139.0,1582.0,0.74,10.177,2,1,1,0,1,0,1,0,0.0,0.0
1006,86,23-09-2019 14:30:00,1,2134.0,1604.0,0.751,10.185,88,47,27,20,41,24,17,0,0.0,0.0
1006,87,23-09-2019 14:32:00,1,2401.0,1662.0,0.692,11.3,111,66,41,25,45,25,20,7,0.0,0.0
1006,88,23-09-2019 14:34:00,1,3154.0,2337.0,0.741,15.015,167,73,54,19,94,51,43,13,0.0,0.0
1006,89,23-09-2019 14:36:00,1,2712.0,1957.0,0.722,12.851,183,89,64,25,94,51,43,3,0.0,0.0
1006,90,23-09-2019 14:38:00,1,2710.5,1951.5,0.72,12.84,58,11,3,8,47,24,23,0,0.0,0.0
1006,91,23-09-2019 14:40:00,1,2709.0,1946.0,0.718,12.829,72,37,18,19,35,16,19,0,0.0,0.0
1006,92,23-09-2019 14:42:00,1,2945.0,2143.0,0.728,13.979,92,54,20,34,38,16,22,0,0.0,0.0
1006,93,23-09-2019 14:44:00,1,2915.0,2207.0,0.757,13.927,176,118,85,33,58,32,26,14,0.0,0.0
1006,94,23-09-2019 14:46:00,1,3263.0,2415.0,0.74,15.532,87,40,29,11,47,29,18,6,0.0,0.0
1006,95,23-09-2019 14:48:00,1,3023.0,2333.0,0.772,14.494,9,5,1,4,4,0,4,0,0.0,0.0
1006,96,23-09-2019 14:50:00,1,2919.0,2161.0,0.74,13.893,4,4,2,2,0,0,0,0,0.0,0.0
1006,97,23-09-2019 14:52:00,1,2700.0,2023.0,0.749,12.88,0,0,0,0,0,0,0,0,0.0,0.0
1006,98,23-09-2019 14:54:00,1,2599.0,1913.0,0.736,12.357,10,9,4,5,1,0,1,0,0.0,0.0
1006,99,23-09-2019 14:56:00,1,2481.0,1820.0,0.733,11.792,6,6,0,6,0,0,0,0,0.0,0.0
1006,100,23-09-2019 14:58:00,1,2494.0,1757.0,0.705,11.772,5,5,0,5,0,0,0,0,0.0,0.0
1006,101,23-09-2019 15:00:00,1,2371.0,1707.0,0.72,11.232,16,8,3,5,8,1,7,0,0.0,0.0
1006,102,23-09-2019 15:02:00,1,2257.0,1680.0,0.744,10.753,0,0,0,0,0,0,0,0,0.0,0.0
1006,103,23-09-2019 15:04:00,1,2251.0,1683.0,0.747,10.733,2,2,0,2,0,0,0,0,0.0,0.0
1006,104,23-09-2019 15:06:00,1,2119.0,1659.0,0.783,10.188,0,0,0,0,0,0,0,0,0.0,0.0
1006,105,23-09-2019 15:08:00,1,2125.0,1664.0,0.783,10.214,3,3,0,3,0,0,0,0,0.0,0.0
1006,106,23-09-2019 15:10:00,1,2256.0,1671.0,0.741,10.74,4,2,0,2,2,1,1,0,0.0,0.0
1006,107,23-09-2019 15:12:00,1,2255.5,1667.5,0.7395,10.733,21,17,7,10,4,1,3,0,0.0,0.0
1006,108,23-09-2019 15:14:00,1,2255.0,1664.0,0.738,10.726,0,0,0,0,0,0,0,0,0.0,0.0
1006,109,23-09-2019 15:16:00,1,2249.0,1669.0,0.742,10.711,10,8,4,4,2,2,0,0,0.0,0.0
1006,110,23-09-2019 15:18:00,1,2255.0,1663.0,0.737,10.726,1,1,0,1,0,0,0,0,0.0,0.0
1006,111,23-09-2019 15:20:00,1,2119.0,1643.0,0.775,10.167,0,0,0,0,0,0,0,0,0.0,0.0
1006,112,23-09-2019 15:22:00,1,2127.0,1630.0,0.766,10.186,4,3,0,3,1,0,1,0,0.0,0.0
1006,113,23-09-2019 15:24:00,1,2140.0,1594.0,0.745,10.198,0,0,0,0,0,0,0,0,0.0,0.0
1006,114,23-09-2019 15:26:00,1,2130.0,1588.0,0.745,10.152,0,0,0,0,0,0,0,0,0.0,0.0
1006,115,23-09-2019 15:28:00,1,2140.0,1587.0,0.741,10.19,1,1,0,1,0,0,0,0,0.0,0.0
1006,116,23-09-2019 15:30:00,1,2149.0,1586.0,0.738,10.224,57,12,6,6,45,8,37,0,0.0,0.0
1006,117,23-09-2019 15:32:00,1,2140.0,1569.0,0.733,10.169,33,17,3,14,16,6,10,0,0.0,0.0
1006,118,23-09-2019 15:34:00,1,2123.0,1652.0,0.778,10.194,8,2,0,2,6,2,4,0,0.0,0.0
1006,119,23-09-2019 15:36:00,1,2378.0,1713.0,0.72,11.267,5,3,2,1,2,0,2,0,0.0,0.0
1006,120,23-09-2019 15:38:00,1,2245.0,1706.0,0.76,10.735,15,4,0,4,11,0,11,0,0.0,0.0
1006,121,23-09-2019 15:40:00,1,2251.0,1710.0,0.76,10.764,1,1,0,1,0,0,0,0,0.0,0.0
1006,122,23-09-2019 15:42:00,1,2243.0,1699.0,0.757,10.721,1,0,0,0,1,1,0,0,0.0,0.0
1006,123,23-09-2019 15:44:00,1,2379.0,1724.0,0.725,11.283,0,0,0,0,0,0,0,0,0.0,0.0
1006,124,23-09-2019 15:46:00,1,2371.5,1716.0,0.7235,11.245,3,3,1,2,0,0,0,0,0.0,0.0
1006,125,23-09-2019 15:48:00,1,2364.0,1708.0,0.722,11.207,7,0,0,0,7,0,7,0,0.0,0.0
1006,126,23-09-2019 15:50:00,1,2244.0,1704.0,0.759,10.727,68,35,20,15,33,14,19,0,0.0,0.0
1006,127,23-09-2019 15:52:00,1,2242.0,1697.0,0.757,10.714,42,15,8,7,27,9,18,0,0.0,0.0
1006,128,23-09-2019 15:54:00,1,2492.0,1764.0,0.708,11.77,84,53,22,31,31,10,21,3,0.0,0.0
1006,129,23-09-2019 15:56:00,1,2472.0,1873.0,0.758,11.815,202,117,82,35,85,57,28,19,0.0,0.0
1006,130,23-09-2019 15:58:00,1,2918.0,2235.0,0.766,13.973,15,6,5,1,9,0,9,0,0.0,0.0
1006,131,23-09-2019 16:00:00,1,2699.0,2014.0,0.746,12.865,14,6,2,4,8,2,6,0,0.0,0.0
1006,132,23-09-2019 16:02:00,1,2584.0,1948.0,0.754,12.338,11,4,0,4,7,0,7,0,0.0,0.0
1006,133,23-09-2019 16:04:00,1,2471.0,1838.0,0.744,11.769,1,1,0,1,0,0,0,0,0.0,0.0
1006,134,23-09-2019 16:06:00,1,2374.0,1776.0,0.748,11.32,0,0,0,0,0,0,0,0,0.0,0.0
1006,135,23-09-2019 16:08:00,1,2232.0,1697.0,0.76,10.671,8,2,0,2,6,3,3,0,0.0,0.0
1006,136,23-09-2019 16:10:00,1,2120.0,1663.0,0.784,10.195,6,1,1,0,5,1,4,0,0.0,0.0
1006,137,23-09-2019 16:12:00,1,2129.0,1657.0,0.778,10.223,0,0,0,0,0,0,0,0,0.0,0.0
1006,138,23-09-2019 16:14:00,1,2114.0,1672.0,0.791,10.18,0,0,0,0,0,0,0,0,0.0,0.0
1006,139,23-09-2019 16:16:00,1,2119.0,1673.0,0.789,10.203,50,16,12,4,34,17,17,0,0.0,0.0
1006,140,23-09-2019 16:18:00,1,2121.0,1673.0,0.789,10.21,8,0,0,0,8,1,7,0,0.0,0.0
1006,141,23-09-2019 16:20:00,1,2122.0,1673.0,0.7885,10.214,4,0,0,0,4,2,2,0,0.0,0.0
1006,142,23-09-2019 16:22:00,1,2123.0,1673.0,0.788,10.218,30,12,5,7,18,6,12,0,0.0,0.0
1006,143,23-09-2019 16:24:00,1,2120.0,1665.0,0.785,10.196,21,3,1,2,18,2,16,0,0.0,0.0
1006,144,23-09-2019 16:26:00,1,2114.0,1682.0,0.796,10.19,23,3,2,1,20,0,20,0,0.0,0.0
1006,145,23-09-2019 16:28:00,1,2116.0,1675.0,0.792,10.191,28,2,1,1,26,0,26,0,0.0,0.0
1006,146,23-09-2019 16:30:00,1,2119.0,1671.0,0.789,10.197,66,19,13,6,47,7,40,0,0.0,0.0
1006,147,23-09-2019 16:32:00,1,2126.0,1643.0,0.773,10.195,3,0,0,0,3,1,2,0,0.0,0.0
1006,148,23-09-2019 16:34:00,1,2242.0,1710.0,0.763,10.727,5,0,0,0,5,2,3,0,0.0,0.0
1006,149,23-09-2019 16:36:00,1,2248.0,1731.0,0.77,10.775,6,0,0,0,6,3,3,0,0.0,0.0
1006,150,23-09-2019 16:38:00,1,2235.0,1726.0,0.772,10.715,63,38,23,15,25,9,16,0,0.0,0.0
1006,151,23-09-2019 16:40:00,1,2120.0,1658.0,0.782,10.187,146,73,45,28,73,34,39,1,0.0,0.0
1006,152,23-09-2019 16:42:00,1,2699.0,2023.0,0.75,12.875,109,75,46,29,34,22,12,31,0.0,0.0
1006,153,23-09-2019 16:44:00,1,3461.0,2760.0,0.798,16.692,123,92,54,38,31,0,31,31,0.0,0.0
1006,154,23-09-2019 16:46:00,1,3816.0,2869.0,0.752,18.212,150,96,66,30,54,35,19,18,0.0,0.0
1006,155,23-09-2019 16:48:00,1,2580.0,1982.0,0.768,12.361,94,28,19,9,66,37,29,4,0.0,0.0
1006,156,23-09-2019 16:50:00,1,2468.0,1858.0,0.753,11.783,86,17,1,16,69,37,32,0,0.0,0.0
1006,157,23-09-2019 16:52:00,1,2469.0,1865.0,0.755,11.794,65,36,9,27,29,12,17,0,0.0,0.0
1006,158,23-09-2019 16:54:00,1,2585.0,1936.5,0.749,12.3305,35,16,5,11,19,4,15,0,0.0,0.0
1006,159,23-09-2019 16:56:00,1,2701.0,2008.0,0.743,12.867,44,26,5,21,18,3,15,0,0.0,0.0
1006,160,23-09-2019 16:58:00,1,2687.0,2036.0,0.758,12.841,113,87,57,30,26,15,11,0,0.0,0.0
1006,161,23-09-2019 17:00:00,1,2802.0,2147.0,0.766,13.418,10,2,0,2,8,1,7,0,0.0,0.0
1006,162,23-09-2019 17:02:00,1,2799.0,2147.0,0.767,13.405,65,31,12,19,34,13,21,0,0.0,0.0
1006,163,23-09-2019 17:04:00,1,2919.0,2209.0,0.757,13.948,87,63,18,45,24,10,14,0,0.0,0.0
1006,164,23-09-2019 17:06:00,1,2785.0,2169.0,0.779,13.373,86,15,6,9,71,43,28,0,0.0,0.0
1006,165,23-09-2019 17:08:00,1,2923.0,2246.0,0.768,14.003,0,0,0,0,0,0,0,0,0.0,0.0
1006,166,23-09-2019 17:10:00,1,2663.0,2105.0,0.791,12.823,1,1,0,1,0,0,0,0,0.0,0.0
1006,167,23-09-2019 17:12:00,1,2713.0,1971.0,0.727,12.87,36,14,10,4,22,17,5,0,0.0,0.0
1006,168,23-09-2019 17:14:00,1,2460.0,1908.0,0.775,11.804,1,0,0,0,1,0,1,0,0.0,0.0
1006,169,23-09-2019 17:16:00,1,2450.0,1930.0,0.787,11.791,5,5,0,5,0,0,0,0,0.0,0.0
1006,170,23-09-2019 17:18:00,1,2465.0,1883.0,0.764,11.796,0,0,0,0,0,0,0,0,0.0,0.0
1006,171,23-09-2019 17:20:00,1,2492.0,1812.0,0.727,11.826,2,0,0,0,2,0,2,0,0.0,0.0
1006,172,23-09-2019 17:22:00,1,2231.0,1742.0,0.781,10.72,8,4,0,4,4,2,2,0,0.0,0.0
1006,173,23-09-2019 17:24:00,1,2108.0,1703.0,0.808,10.191,3,3,0,3,0,0,0,0,0.0,0.0
1006,174,23-09-2019 17:26:00,1,2246.0,1704.0,0.759,10.734,0,0,0,0,0,0,0,0,0.0,0.0
1006,175,23-09-2019 17:28:00,1,2306.0,1729.0,0.75,10.998,1,1,0,1,0,0,0,0,0.0,0.0
1006,176,23-09-2019 17:30:00,1,2366.0,1754.0,0.741,11.262,11,11,1,10,0,0,0,0,0.0,0.0
1006,177,23-09-2019 17:32:00,1,2368.0,1744.0,0.736,11.263,16,12,3,9,4,0,4,0,0.0,0.0
1006,178,23-09-2019 17:34:00,1,2489.0,1803.0,0.724,11.805,8,5,0,5,3,1,2,0,0.0,0.0
1006,179,23-09-2019 17:36:00,1,2471.0,1852.0,0.749,11.785,0,0,0,0,0,0,0,0,0.0,0.0
1006,180,23-09-2019 17:38:00,1,2468.0,1867.0,0.756,11.791,3,3,1,2,0,0,0,0,0.0,0.0
1006,181,23-09-2019 17:40:00,1,2481.0,1814.0,0.731,11.782,0,0,0,0,0,0,0,0,0.0,0.0
1006,182,23-09-2019 17:42:00,1,2240.0,1714.0,0.765,10.724,46,28,21,7,18,11,7,0,0.0,0.0
1006,183,23-09-2019 17:44:00,1,2378.0,1729.0,0.727,11.285,8,5,0,5,3,2,1,0,0.0,0.0
1006,184,23-09-2019 17:46:00,1,2238.0,1719.0,0.768,10.722,27,7,0,7,20,0,20,0,0.0,0.0
1006,185,23-09-2019 17:48:00,1,2372.0,1740.0,0.734,11.272,45,4,0,4,41,0,41,0,0.0,0.0
1006,186,23-09-2019 17:50:00,1,2238.0,1728.0,0.772,10.73,42,16,3,13,26,0,26,0,0.0,0.0
1006,187,23-09-2019 17:52:00,1,2239.0,1723.0,0.769,10.731,12,5,0,5,7,0,7,0,0.0,0.0
1006,188,23-09-2019 17:54:00,1,2114.0,1694.0,0.801,10.204,15,0,0,0,15,0,15,0,0.0,0.0
1006,189,23-09-2019 17:56:00,1,2115.0,1678.0,0.794,10.191,24,1,1,0,23,0,23,0,0.0,0.0
1006,190,23-09-2019 17:58:00,1,2242.0,1696.0,0.756,10.712,10,0,0,0,10,0,10,0,0.0,0.0
1006,191,23-09-2019 18:00:00,0,2245.0,1711.0,0.762,10.738,12,12,1,11,0,0,0,0,0.0,0.0
1006,192,23-09-2019 18:02:00,0,2313.5,1715.0,0.742,11.014,14,4,1,3,10,4,6,0,0.0,0.0
1006,193,23-09-2019 18:04:00,0,2382.0,1719.0,0.722,11.29,9,0,0,0,9,0,9,0,0.0,0.0
1006,194,23-09-2019 18:06:00,0,2507.0,1719.0,0.686,11.781,4,0,0,0,4,0,4,0,0.0,0.0
1006,195,23-09-2019 18:08:00,0,2364.0,1714.0,0.725,11.213,2,0,0,0,2,0,2,0,0.0,0.0
1006,196,23-09-2019 18:10:00,0,2635.0,1763.0,0.669,12.335,288,181,149,32,107,86,21,2,0.0,0.0
1006,197,23-09-2019 18:12:00,0,3341.0,2572.0,0.77,16.011,194,90,56,34,104,70,34,12,0.0,0.0
1006,198,23-09-2019 18:14:00,0,3035.0,2234.0,0.736,14.433,109,40,27,13,69,38,31,0,0.0,0.0
1006,199,23-09-2019 18:16:00,0,3835.0,2817.0,0.735,18.228,399,225,175,50,174,129,45,16,0.0,0.0
1006,200,23-09-2019 18:18:00,0,4135.0,3210.0,0.776,19.846,215,144,114,30,71,49,22,47,0.0,0.0
1006,201,23-09-2019 18:20:00,0,4366.0,3311.0,0.758,20.868,206,122,95,27,84,51,33,22,0.0,0.0
1006,202,23-09-2019 18:22:00,0,4180.0,3056.0,0.731,19.853,242,144,106,38,98,71,27,4,0.0,0.0
1006,203,23-09-2019 18:24:00,0,4145.0,3187.0,0.769,19.861,219,123,83,40,96,57,39,48,0.0,0.0
1006,204,23-09-2019 18:26:00,0,4161.0,3129.0,0.752,19.86,175,122,93,29,53,30,23,8,0.0,0.0
1006,205,23-09-2019 18:28:00,0,3608.0,2694.0,0.747,17.197,98,60,32,28,38,19,19,7,0.0,0.0
1006,206,23-09-2019 18:30:00,0,3039.0,2247.0,0.74,14.463,135,97,69,28,38,25,13,14,0.0,0.0
1006,207,23-09-2019 18:32:00,0,3051.0,2181.0,0.715,14.436,289,195,143,52,94,67,27,28,0.0,0.0
1006,208,23-09-2019 18:34:00,0,3625.0,2608.0,0.72,17.169,389,109,87,22,280,241,39,17,0.0,0.0
1006,209,23-09-2019 18:36:00,0,3994.5,2986.0,0.7455,19.0445,344,100,57,43,244,195,49,3,0.0,0.0
1006,210,23-09-2019 18:38:00,0,4364.0,3364.0,0.771,20.92,219,117,82,35,102,61,41,45,0.0,0.0
1006,211,23-09-2019 18:40:00,0,4155.0,3181.0,0.766,19.893,446,249,206,43,197,155,42,44,0.0,0.0
1006,212,23-09-2019 18:42:00,0,3712.0,2763.0,0.744,17.686,240,135,95,40,105,77,28,23,0.0,0.0
1006,213,23-09-2019 18:44:00,0,3053.0,2235.0,0.732,14.506,166,116,69,47,50,30,20,28,0.0,0.0
1006,214,23-09-2019 18:46:00,0,4157.0,3169.0,0.762,19.887,112,75,41,34,37,23,14,28,0.0,0.0
1006,215,23-09-2019 18:48:00,0,4123.0,3191.0,0.774,19.777,190,94,72,22,96,69,27,13,0.0,0.0
1006,216,23-09-2019 18:50:00,0,3039.0,2262.0,0.744,14.477,33,14,7,7,19,10,9,0,0.0,0.0
1006,217,23-09-2019 18:52:00,0,2840.0,1998.0,0.703,13.402,15,7,1,6,8,5,3,0,0.0,0.0
1006,218,23-09-2019 18:54:00,0,2595.0,1890.0,0.729,12.316,17,6,2,4,11,5,6,0,0.0,0.0
1006,219,23-09-2019 18:56:00,0,2618.0,1849.0,0.706,12.362,72,34,18,16,38,22,16,2,0.0,0.0
1006,220,23-09-2019 18:58:00,0,2855.0,1959.0,0.686,13.417,97,44,25,19,53,35,18,0,0.0,0.0
1006,221,23-09-2019 19:00:00,0,2855.0,1940.0,0.679,13.399,26,10,5,5,16,8,8,0,0.0,0.0
1006,222,23-09-2019 19:02:00,0,2824.0,2094.0,0.742,13.444,6,6,2,4,0,0,0,0,0.0,0.0
1006,223,23-09-2019 19:04:00,0,2830.0,2036.0,0.719,13.406,17,13,3,10,4,2,2,0,0.0,0.0
1006,224,23-09-2019 19:06:00,0,2841.0,1994.0,0.702,13.402,43,20,2,18,23,13,10,0,0.0,0.0
1006,225,23-09-2019 19:08:00,0,2813.0,2121.0,0.754,13.43,154,76,39,37,78,53,25,3,0.0,0.0
1006,226,23-09-2019 19:10:00,0,2867.0,2158.5,0.753,13.6845,10,4,1,3,6,3,3,0,0.0,0.0
1006,227,23-09-2019 19:12:00,0,2921.0,2196.0,0.752,13.939,0,0,0,0,0,0,0,0,0.0,0.0
1006,228,23-09-2019 19:14:00,0,2813.0,2115.0,0.752,13.427,3,2,1,1,1,0,1,0,0.0,0.0
1006,229,23-09-2019 19:16:00,0,2823.0,2071.0,0.734,13.416,123,55,35,20,68,45,23,2,0.0,0.0
1006,230,23-09-2019 19:18:00,0,3048.0,2231.0,0.732,14.479,142,96,54,42,46,19,27,1,0.0,0.0
1006,231,23-09-2019 19:20:00,0,3570.0,2804.0,0.786,17.171,118,69,31,38,49,18,31,0,0.0,0.0
1006,232,23-09-2019 19:22:00,0,4117.0,3308.0,0.804,19.884,85,38,16,22,47,14,33,1,0.0,0.0
1006,233,23-09-2019 19:24:00,0,4322.0,3521.0,0.815,20.925,176,79,46,33,97,66,31,5,0.0,0.0
1006,234,23-09-2019 19:26:00,0,4336.0,3502.0,0.808,20.962,35,16,9,7,19,16,3,0,0.0,0.0
1006,235,23-09-2019 19:28:00,0,3568.0,2795.0,0.783,17.152,173,42,18,24,131,97,34,7,0.0,0.0
1006,236,23-09-2019 19:30:00,0,4094.0,3322.0,0.811,19.807,106,56,28,28,50,17,33,5,0.0,0.0
1006,237,23-09-2019 19:32:00,0,4360.0,3364.0,0.772,20.902,90,35,22,13,55,39,16,7,0.0,0.0
1006,238,23-09-2019 19:34:00,0,4018.0,3139.0,0.781,19.305,44,18,10,8,26,14,12,5,0.0,0.0
1006,239,23-09-2019 19:36:00,0,4155.0,3130.0,0.753,19.836,136,50,24,26,86,52,34,0,0.0,0.0
1006,240,23-09-2019 19:38:00,0,4154.0,3153.0,0.759,19.859,64,22,8,14,42,18,24,0,0.0,0.0
1006,241,23-09-2019 19:40:00,0,4149.0,3159.0,0.761,19.847,21,11,4,7,10,5,5,0,0.0,0.0
1006,242,23-09-2019 19:42:00,0,3923.0,2943.0,0.75,18.714,70,34,19,15,36,20,16,8,0.0,0.0
1006,243,23-09-2019 19:44:00,0,3937.0,2911.0,0.7395,18.734,74,35,22,13,39,26,13,2,0.0,0.0
1006,244,23-09-2019 19:46:00,0,3951.0,2879.0,0.729,18.754,20,14,3,11,6,3,3,0,0.0,0.0
1006,245,23-09-2019 19:48:00,0,3710.0,2798.0,0.754,17.717,8,4,0,4,4,1,3,0,0.0,0.0
1006,246,23-09-2019 19:50:00,0,3619.0,2645.0,0.731,17.189,128,50,28,22,78,41,37,7,0.0,0.0
1006,247,23-09-2019 19:52:00,0,3616.0,2651.0,0.733,17.184,133,56,32,24,77,54,23,9,0.0,0.0
1006,248,23-09-2019 19:54:00,0,3585.0,2733.0,0.762,17.153,191,80,50,30,111,76,35,12,0.0,0.0
1006,249,23-09-2019 19:56:00,0,3956.0,2858.0,0.722,18.753,349,217,171,46,132,103,29,10,0.0,0.0
1006,250,23-09-2019 19:58:00,0,3923.0,2987.0,0.761,18.764,366,220,192,28,146,110,36,20,0.0,0.0
1006,251,23-09-2019 20:00:00,0,4053.0,2986.0,0.737,19.277,315,148,119,29,167,125,42,24,0.0,0.0
1006,252,23-09-2019 20:02:00,0,4047.0,2999.0,0.741,19.266,99,60,37,23,39,27,12,9,0.0,0.0
1006,253,23-09-2019 20:04:00,0,4063.0,2986.0,0.735,19.316,327,195,154,41,132,100,32,27,0.0,0.0
1006,254,23-09-2019 20:06:00,0,3927.0,2932.0,0.747,18.721,78,53,45,8,25,17,8,1,0.0,0.0
1006,255,23-09-2019 20:08:00,0,3716.0,2762.0,0.743,17.699,177,82,52,30,95,64,31,9,0.0,0.0
1006,256,23-09-2019 20:10:00,0,3966.0,2799.0,0.706,18.727,378,215,162,53,163,116,47,19,0.0,0.0
1006,257,23-09-2019 20:12:00,0,3947.0,2905.0,0.736,18.769,200,102,75,27,98,75,23,24,0.0,0.0
1006,258,23-09-2019 20:14:00,0,3949.0,2842.0,0.72,18.708,17,11,2,9,6,1,5,0,0.0,0.0
1006,259,23-09-2019 20:16:00,0,3721.0,2726.0,0.733,17.679,6,6,1,5,0,0,0,0,0.0,0.0
1006,260,23-09-2019 20:18:00,0,3608.0,2622.5,0.727,17.1185,58,29,11,18,29,13,16,3,0.0,0.0
1006,261,23-09-2019 20:20:00,0,3495.0,2519.0,0.721,16.558,209,136,94,42,73,49,24,7,0.0,0.0
1006,262,23-09-2019 20:22:00,0,3492.0,2600.0,0.745,16.639,215,98,73,25,117,89,28,8,0.0,0.0
1006,263,23-09-2019 20:24:00,0,3495.0,2609.0,0.747,16.661,7,4,1,3,3,1,2,0,0.0,0.0
1006,264,23-09-2019 20:26:00,0,3261.0,2494.0,0.765,15.611,142,96,65,31,46,41,5,11,0.0,0.0
1006,265,23-09-2019 20:28:00,0,3239.0,2501.0,0.772,15.532,223,125,100,25,98,72,26,15,0.0,0.0
1006,266,23-09-2019 20:30:00,0,3494.0,2563.0,0.734,16.605,264,159,128,31,105,78,27,10,0.0,0.0
1006,267,23-09-2019 20:32:00,0,3500.0,2577.0,0.736,16.646,282,137,110,27,145,114,31,14,0.0,0.0
1006,268,23-09-2019 20:34:00,0,3485.0,2603.0,0.747,16.613,17,8,4,4,9,6,3,0,0.0,0.0
1006,269,23-09-2019 20:36:00,0,3375.0,2522.0,0.747,16.092,11,8,5,3,3,1,2,0,0.0,0.0
1006,270,23-09-2019 20:38:00,0,3280.0,2391.0,0.729,15.57,245,141,105,36,104,71,33,11,0.0,0.0
1006,271,23-09-2019 20:40:00,0,3267.0,2420.0,0.741,15.55,436,252,204,48,184,145,39,20,0.0,0.0
1006,272,23-09-2019 20:42:00,0,3369.0,2508.0,0.744,16.049,199,87,61,26,112,84,28,18,0.0,0.0
1006,273,23-09-2019 20:44:00,0,3515.0,2536.0,0.722,16.659,143,81,61,20,62,50,12,6,0.0,0.0
1006,274,23-09-2019 20:46:00,0,3519.0,2497.0,0.709,16.63,469,249,195,54,220,168,52,33,0.0,0.0
1006,275,23-09-2019 20:48:00,0,3483.0,2602.0,0.747,16.604,463,294,236,58,169,122,47,30,0.0,0.0
1006,276,23-09-2019 20:50:00,0,3493.0,2642.0,0.756,16.689,202,116,96,20,86,64,22,9,0.0,0.0
1006,277,23-09-2019 20:52:00,0,3489.5,2621.0,0.751,16.652,323,168,133,35,155,123,32,39,0.0,0.0
1006,278,23-09-2019 20:54:00,0,3486.0,2600.0,0.746,16.615,306,158,124,34,148,103,45,18,0.0,0.0
1006,279,23-09-2019 20:56:00,0,3507.0,2576.0,0.734,16.671,77,35,17,18,42,25,17,0,0.0,0.0
1006,280,23-09-2019 20:58:00,0,3508.0,2475.0,0.705,16.564,272,134,100,34,138,94,44,19,0.0,0.0
1006,281,23-09-2019 21:00:00,0,3498.0,2556.0,0.731,16.612,208,82,59,23,126,97,29,9,0.0,0.0
1006,282,23-09-2019 21:02:00,0,3494.0,2582.0,0.739,16.626,467,255,222,33,212,162,50,21,0.0,0.0
1006,283,23-09-2019 21:04:00,0,3476.0,2609.0,0.751,16.583,276,153,116,37,123,97,26,41,0.0,0.0
1006,284,23-09-2019 21:06:00,0,3486.0,2593.0,0.744,16.604,366,231,189,42,135,102,33,102,0.0,0.0
1006,285,23-09-2019 21:08:00,0,3828.0,2816.0,0.736,18.203,512,259,211,48,253,188,65,89,0.0,0.0
1006,286,23-09-2019 21:10:00,0,3843.0,2822.0,0.734,18.266,405,230,194,36,175,134,41,102,0.0,0.0
1006,287,23-09-2019 21:12:00,0,3848.0,2699.0,0.701,18.152,343,197,156,41,146,110,36,32,0.0,0.0
1006,288,23-09-2019 21:14:00,0,3849.0,2769.0,0.719,18.231,216,103,82,21,113,85,28,32,0.0,0.0
1006,289,23-09-2019 21:16:00,0,3865.0,2738.0,0.708,18.261,402,230,179,51,172,132,40,15,0.0,0.0
1006,290,23-09-2019 21:18:00,0,3865.0,2705.0,0.7,18.222,385,204,166,38,181,144,37,96,0.0,0.0
1006,291,23-09-2019 21:20:00,0,3854.0,2734.0,0.709,18.213,490,260,196,64,230,190,40,28,0.0,0.0
1006,292,23-09-2019 21:22:00,0,3857.0,2727.0,0.707,18.216,184,131,85,46,53,27,26,21,0.0,0.0
1006,293,23-09-2019 21:24:00,0,3848.0,2738.0,0.712,18.194,428,221,176,45,207,157,50,30,0.0,0.0
1006,294,23-09-2019 21:26:00,0,3848.5,2748.0,0.7145,18.2065,544,321,268,53,223,179,44,51,0.0,0.0
1006,295,23-09-2019 21:28:00,0,3849.0,2758.0,0.717,18.219,237,123,94,29,114,91,23,16,0.0,0.0
1006,296,23-09-2019 21:30:00,0,3493.0,2567.0,0.735,16.605,38,26,11,15,12,7,5,8,0.0,0.0
1006,297,23-09-2019 21:32:00,0,3747.0,2630.0,0.702,17.677,292,160,126,34,132,98,34,92,0.0,0.0
1006,298,23-09-2019 21:34:00,0,3878.0,2692.0,0.694,18.259,355,199,144,55,156,116,40,36,0.0,0.0
1006,299,23-09-2019 21:36:00,0,3865.0,2727.0,0.706,18.247,395,221,173,48,174,131,43,29,0.0,0.0
1006,300,23-09-2019 21:38:00,0,3842.0,2780.0,0.724,18.218,451,265,212,53,186,132,54,38,0.0,0.0
1006,301,23-09-2019 21:40:00,0,3836.0,2834.0,0.739,18.253,321,193,139,54,128,83,45,42,0.0,0.0
1006,302,23-09-2019 21:42:00,0,3962.0,2860.0,0.722,18.778,321,215,158,57,106,73,33,38,0.0,0.01
1006,303,23-09-2019 21:44:00,0,4072.0,2900.0,0.712,19.253,355,228,170,58,127,78,49,33,0.0,0.03
1006,304,23-09-2019 21:46:00,0,4051.0,3005.0,0.742,19.291,273,164,116,48,109,75,34,81,0.0,0.05
1006,305,23-09-2019 21:48:00,0,4043.0,3043.0,0.753,19.299,547,331,268,63,216,167,49,149,0.0,0.02
1006,306,23-09-2019 21:50:00,0,3795.0,2926.0,0.771,18.194,390,225,180,45,165,129,36,134,0.0,0.0
1006,307,23-09-2019 21:52:00,0,4026.0,3089.0,0.767,19.281,111,79,49,30,32,12,20,23,0.0,0.0
1006,308,23-09-2019 21:54:00,0,4242.0,3345.0,0.789,20.419,156,129,86,43,27,12,15,29,0.0,0.01
1006,309,23-09-2019 21:56:00,0,4199.0,3459.0,0.824,20.375,488,278,228,50,210,158,52,57,0.0,0.07
1006,310,23-09-2019 21:58:00,0,4080.0,3424.0,0.839,19.866,311,197,154,43,114,82,32,37,0.0,0.0
1006,311,23-09-2019 22:00:00,0,4035.0,3332.0,0.8255,19.5865,185,101,69,32,84,57,27,49,0.0,0.0
1006,312,23-09-2019 22:02:00,0,3990.0,3240.0,0.812,19.307,157,92,71,21,65,48,17,2,0.0,0.0
1006,313,23-09-2019 22:04:00,0,3851.0,3223.0,0.837,18.743,387,190,141,49,197,150,47,13,0.12,0.0
1006,314,23-09-2019 22:06:00,0,4177.0,3538.0,0.847,20.377,182,143,96,47,39,21,18,21,0.0,0.0
1006,315,23-09-2019 22:08:00,0,4264.0,3720.0,0.873,20.918,288,190,134,56,98,62,36,32,0.01,0.0
1006,316,23-09-2019 22:10:00,0,4265.0,3767.0,0.883,20.975,264,152,110,42,112,75,37,29,0.0,0.01
1006,317,23-09-2019 22:12:00,0,3920.0,3457.0,0.882,19.274,334,191,145,46,143,106,37,76,0.02,0.03
1006,318,23-09-2019 22:14:00,0,3714.0,3285.0,0.884,18.268,356,238,182,56,118,74,44,69,0.0,0.0
1006,319,23-09-2019 22:16:00,0,4124.0,3775.0,0.915,20.43,136,100,63,37,36,22,14,21,0.0,0.0
1006,320,23-09-2019 22:18:00,0,4143.0,3749.0,0.905,20.473,76,49,25,24,27,14,13,13,0.0,0.0
1006,321,23-09-2019 22:20:00,0,4126.0,3725.0,0.903,20.381,147,87,62,25,60,37,23,9,0.19,0.0
1006,322,23-09-2019 22:22:00,0,3392.0,2954.0,0.871,16.637,335,178,145,33,157,119,38,93,0.05,0.0
1006,323,23-09-2019 22:24:00,0,3814.0,3410.0,0.894,18.803,244,159,118,41,85,59,26,75,0.02,0.01
1006,324,23-09-2019 22:26:00,0,4106.0,3813.0,0.928,20.4,133,65,38,27,68,36,32,22,0.0,0.0
1006,325,23-09-2019 22:28:00,0,4469.0,4008.0,0.897,22.045,228,139,92,47,89,61,28,33,0.0,0.03
1006,326,23-09-2019 22:30:00,0,3808.0,3433.0,0.901,18.806,154,87,56,31,67,42,25,58,0.0,0.01
1006,327,23-09-2019 22:32:00,0,3907.0,3526.0,0.902,19.296,172,97,66,31,75,50,25,15,0.0,0.02
1006,328,23-09-2019 22:34:00,0,4006.0,3669.5,0.9155,19.845,142,84,46,38,58,37,21,21,0.01,0.0
1006,329,23-09-2019 22:36:00,0,4105.0,3813.0,0.929,20.394,179,121,82,39,58,43,15,59,0.1,0.0
1006,330,23-09-2019 22:38:00,0,4471.0,4065.0,0.909,22.114,125,79,55,24,46,25,21,31,0.0,0.02
1006,331,23-09-2019 22:40:00,0,4133.0,3764.0,0.911,20.449,230,111,83,28,119,92,27,25,0.09,0.0
1006,332,23-09-2019 22:42:00,0,4075.0,3863.0,0.948,20.332,248,131,98,33,117,83,34,22,0.05,0.0
1006,333,23-09-2019 22:44:00,0,4088.0,3912.0,0.957,20.44,124,76,46,30,48,23,25,45,0.01,0.0
1006,334,23-09-2019 22:46:00,0,4428.0,4188.0,0.946,22.081,259,140,110,30,119,88,31,84,0.0,0.0
1006,335,23-09-2019 22:48:00,0,4431.0,4109.0,0.927,22.007,436,235,178,57,201,141,60,57,0.0,0.05
1006,336,23-09-2019 22:50:00,0,3792.0,3517.0,0.928,18.833,213,142,98,44,71,46,25,27,0.0,0.0
1006,337,23-09-2019 22:52:00,0,4638.0,4343.0,0.936,23.083,241,166,123,43,75,36,39,55,0.0,0.0
1006,338,23-09-2019 22:54:00,0,4618.0,4393.0,0.951,23.057,301,213,149,64,88,44,44,80,0.0,0.0
1006,339,23-09-2019 22:56:00,0,4624.0,4451.0,0.963,23.146,261,178,122,56,83,39,44,80,0.0,0.0
1006,340,23-09-2019 22:58:00,0,4610.0,4425.0,0.96,23.061,316,206,146,60,110,59,51,60,0.01,0.03
1006,341,23-09-2019 23:00:00,0,5191.0,4841.0,0.933,25.814,295,190,145,45,105,51,54,89,0.0,0.0
1006,342,23-09-2019 23:02:00,0,4948.0,4659.0,0.942,24.654,188,124,78,46,64,30,34,44,0.03,0.1
1006,343,23-09-2019 23:04:00,0,4633.0,4333.0,0.935,23.051,205,134,89,45,71,38,33,59,0.21,0.0
1006,344,23-09-2019 23:06:00,0,4999.0,4661.0,0.932,24.857,160,110,67,43,50,2,48,72,0.0,0.0
1006,345,23-09-2019 23:08:00,0,4796.0,4592.5,0.9585,23.9805,327,206,151,55,121,69,52,83,0.0,0.12
1006,346,23-09-2019 23:10:00,0,4593.0,4524.0,0.985,23.104,256,129,99,30,127,90,37,27,0.12,0.03
1006,347,23-09-2019 23:12:00,0,3874.0,3635.0,0.938,19.289,340,170,126,44,170,118,52,58,0.0,0.02
1006,348,23-09-2019 23:14:00,0,4425.0,4173.0,0.943,22.055,232,171,123,48,61,14,47,89,0.0,0.0
1006,349,23-09-2019 23:16:00,0,5073.0,4799.0,0.946,25.299,223,182,135,47,41,3,38,74,0.01,0.06
1006,350,23-09-2019 23:18:00,0,5161.0,4893.0,0.948,25.753,199,163,125,38,36,7,29,75,0.0,0.04
1006,351,23-09-2019 23:20:00,0,4970.0,4684.0,0.942,24.769,457,263,207,56,194,145,49,73,0.11,0.08
1006,352,23-09-2019 23:22:00,0,4441.0,4093.0,0.922,22.028,272,170,122,48,102,61,41,110,0.01,0.0
1006,353,23-09-2019 23:24:00,0,4728.0,4541.0,0.961,23.655,118,89,61,28,29,0,29,82,0.0,0.08
1006,354,23-09-2019 23:26:00,0,4624.0,4469.0,0.966,23.167,222,137,104,33,85,60,25,23,0.13,0.03
1006,355,23-09-2019 23:28:00,0,4395.0,4258.0,0.969,22.031,352,200,162,38,152,124,28,53,0.0,0.05
1006,356,23-09-2019 23:30:00,0,4423.0,4156.0,0.94,22.027,84,59,37,22,25,5,20,16,0.0,0.0
1006,357,23-09-2019 23:32:00,0,4427.0,4148.0,0.937,22.037,153,122,79,43,31,1,30,98,0.0,0.0
1006,358,23-09-2019 23:34:00,0,4825.0,4670.0,0.968,24.182,156,104,72,32,52,28,24,66,0.12,0.06
1006,359,23-09-2019 23:36:00,0,4439.0,4129.0,0.93,22.062,357,175,126,49,182,132,50,19,0.09,0.01
1006,360,23-09-2019 23:38:00,0,4101.0,3856.0,0.94,20.425,276,144,96,48,132,92,40,59,0.0,0.04
1006,361,23-09-2019 23:40:00,0,4517.0,4352.0,0.963,22.617,179,100,59,41,79,47,32,20,0.0,0.01
1006,362,23-09-2019 23:42:00,0,4554.5,4443.0,0.975,22.8635,156,111,82,29,45,20,25,24,0.0,0.0
1006,363,23-09-2019 23:44:00,0,4592.0,4534.0,0.987,23.11,268,171,135,36,97,75,22,50,0.0,0.0
1006,364,23-09-2019 23:46:00,0,4394.0,4200.0,0.956,21.961,137,106,71,35,31,2,29,69,0.07,0.0
1006,365,23-09-2019 23:48:00,0,4915.0,4889.0,0.995,24.777,168,128,92,36,40,22,18,42,0.0,0.05
1006,366,23-09-2019 23:50:00,0,4404.0,4239.0,0.962,22.046,288,182,139,43,106,75,31,8,0.0,0.03
1006,367,23-09-2019 23:52:00,0,3315.0,3249.0,0.98,16.656,57,50,18,32,7,2,5,1,0.0,0.0
1006,368,23-09-2019 23:54:00,0,3352.0,3101.0,0.925,16.641,31,30,1,29,1,0,1,0,0.01,0.0
1006,369,23-09-2019 23:56:00,0,3366.0,3065.0,0.911,16.656,32,11,5,6,21,6,15,0,0.0,0.0
1006,370,23-09-2019 23:58:00,0,3337.0,3186.0,0.955,16.677,153,113,74,39,40,18,22,14,0.0,0.0
1006,371,24-09-2019 00:00:00,0,4284.0,4171.0,0.974,21.496,73,51,36,15,22,7,15,0,0.0,0.0
1006,372,24-09-2019 00:02:00,0,3346.0,3159.0,0.944,16.678,0,0,0,0,0,0,0,0,0.0,0.0
1006,373,24-09-2019 00:04:00,0,3113.0,2973.0,0.955,15.558,1,1,0,1,0,0,0,0,0.0,0.0
1006,374,24-09-2019 00:06:00,0,3146.0,2905.0,0.923,15.609,0,0,0,0,0,0,0,0,0.0,0.0
1006,375,24-09-2019 00:08:00,0,3125.0,2901.0,0.928,15.526,3,2,0,2,1,0,1,0,0.0,0.0
1006,376,24-09-2019 00:10:00,0,3136.0,2911.0,0.928,15.577,1,1,1,0,0,0,0,0,0.0,0.0
1006,377,24-09-2019 00:12:00,0,3123.0,2997.0,0.96,15.623,0,0,0,0,0,0,0,0,0.0,0.0
1006,378,24-09-2019 00:14:00,0,3143.0,2882.0,0.917,15.575,0,0,0,0,0,0,0,0,0.0,0.0
1006,379,24-09-2019 00:16:00,0,2954.5,2805.5,0.9515,14.7475,1,1,1,0,0,0,0,0,0.0,0.0
1006,380,24-09-2019 00:18:00,0,2766.0,2729.0,0.986,13.92,2,2,0,2,0,0,0,0,0.0,0.0
1006,381,24-09-2019 00:20:00,0,2917.0,2744.0,0.941,14.532,3,3,0,3,0,0,0,0,0.01,0.0
1006,382,24-09-2019 00:22:00,0,2915.0,2699.0,0.926,14.473,0,0,0,0,0,0,0,0,0.0,0.0
1006,383,24-09-2019 00:24:00,0,2912.0,2727.0,0.936,14.493,70,41,14,27,29,7,22,2,0.0,0.0
1006,384,24-09-2019 00:26:00,0,3659.0,3525.0,0.963,18.319,390,234,188,46,156,111,45,29,0.0,0.0
1006,385,24-09-2019 00:28:00,0,4028.0,4110.0,1.02,20.419,430,239,186,53,191,151,40,70,0.0,0.0
1006,386,24-09-2019 00:30:00,0,3935.0,4003.0,1.017,19.935,155,109,71,38,46,29,17,39,0.0,0.0
1006,387,24-09-2019 00:32:00,0,3921.0,4021.0,1.026,19.898,94,77,51,26,17,1,16,76,0.0,0.0
1006,388,24-09-2019 00:34:00,0,4353.0,4458.0,1.024,22.088,259,132,96,36,127,95,32,58,0.11,0.02
1006,389,24-09-2019 00:36:00,0,4062.0,4029.0,0.992,20.465,63,44,19,25,19,3,16,47,0.0,0.06
1006,390,24-09-2019 00:38:00,0,4363.0,4329.0,0.992,21.984,60,42,25,17,18,1,17,65,0.01,0.02
1006,391,24-09-2019 00:40:00,0,4370.0,4426.0,1.013,22.117,246,120,95,25,126,88,38,13,0.1,0.06
1006,392,24-09-2019 00:42:00,0,3521.0,3458.0,0.982,17.701,277,167,140,27,110,87,23,96,0.0,0.0
1006,393,24-09-2019 00:44:00,0,3942.0,3937.0,0.999,19.891,55,34,17,17,21,0,21,47,0.0,0.31
1006,394,24-09-2019 00:46:00,0,4356.0,4423.0,1.015,22.061,62,29,11,18,33,10,23,3,0.08,0.0
1006,395,24-09-2019 00:48:00,0,4053.0,4075.0,1.005,20.478,264,155,124,31,109,77,32,23,0.01,0.0
1006,396,24-09-2019 00:50:00,0,3997.0,4017.0,1.0045,20.1945,416,248,196,52,168,131,37,43,0.0,0.0
1006,397,24-09-2019 00:52:00,0,3941.0,3959.0,1.004,19.911,44,22,12,10,22,11,11,29,0.0,0.0
1006,398,24-09-2019 00:54:00,0,4275.0,4271.0,0.999,21.571,157,94,62,32,63,28,35,4,0.0,0.05
1006,399,24-09-2019 00:56:00,0,3926.0,3988.0,1.016,19.883,368,197,151,46,171,125,46,20,0.1,0.0
1006,400,24-09-2019 00:58:00,0,3733.0,3691.0,0.989,18.795,249,116,83,33,133,92,41,4,0.01,0.0
1006,401,24-09-2019 01:00:00,0,3114.0,3011.0,0.967,15.603,282,218,168,50,64,41,23,19,0.0,0.0
1006,402,24-09-2019 01:02:00,0,4012.0,4159.0,1.037,20.41,0,0,0,0,0,0,0,0,0.0,0.0
1006,403,24-09-2019 01:04:00,0,4385.0,4314.0,0.984,22.053,9,0,0,0,9,1,8,0,0.0,0.0
1006,404,24-09-2019 01:06:00,0,4152.0,4235.0,1.02,21.046,223,151,111,40,72,38,34,14,0.1,0.0
1006,405,24-09-2019 01:08:00,0,4014.0,4094.0,1.02,20.349,118,69,38,31,49,27,22,0,0.01,0.0
1006,406,24-09-2019 01:10:00,0,3659.0,3479.0,0.951,18.27,25,13,3,10,12,0,12,0,0.0,0.0
1006,407,24-09-2019 01:12:00,0,3756.0,3679.0,0.979,18.872,36,30,7,23,6,1,5,0,0.0,0.0
1006,408,24-09-2019 01:14:00,0,3871.0,3718.0,0.961,19.368,109,83,41,42,26,9,17,5,0.0,0.0
1006,409,24-09-2019 01:16:00,0,4056.0,3978.0,0.981,20.384,41,30,0,30,11,0,11,0,0.0,0.0
1006,410,24-09-2019 01:18:00,0,3811.0,3894.0,1.022,19.327,2,2,1,1,0,0,0,0,0.01,0.0
1006,411,24-09-2019 01:20:00,0,3309.0,3249.0,0.982,16.636,5,5,1,4,0,0,0,0,0.0,0.0
1006,412,24-09-2019 01:22:00,0,3115.0,3046.0,0.978,15.645,17,15,4,11,2,1,1,0,0.0,0.0
1006,413,24-09-2019 01:24:00,0,3178.5,3051.5,0.9605,15.902,0,0,0,0,0,0,0,0,0.0,0.0
1006,414,24-09-2019 01:26:00,0,3242.0,3057.0,0.943,16.159,1,1,0,1,0,0,0,0,0.0,0.0
1006,415,24-09-2019 01:28:00,0,3218.0,3109.0,0.966,16.122,2,0,0,0,2,1,1,0,0.0,0.0
1006,416,24-09-2019 01:30:00,0,3344.0,3153.0,0.943,16.667,0,0,0,0,0,0,0,0,0.0,0.0
1006,417,24-09-2019 01:32:00,0,3451.0,3260.0,0.945,17.206,6,0,0,0,6,0,6,0,0.0,0.0
1006,418,24-09-2019 01:34:00,0,3409.0,3408.0,1.0,17.203,9,7,1,6,2,0,2,0,0.0,0.0
1006,419,24-09-2019 01:36:00,0,3425.0,3364.0,0.982,17.22,173,108,80,28,65,42,23,15,0.0,0.0
1006,420,24-09-2019 01:38:00,0,3764.0,3603.0,0.957,18.82,248,181,141,40,67,44,23,58,0.0,0.0
1006,421,24-09-2019 01:40:00,0,3396.0,3456.0,1.018,17.205,218,140,105,35,78,54,24,44,0.01,0.0
1006,422,24-09-2019 01:42:00,0,3431.0,3311.0,0.965,17.182,36,31,12,19,5,2,3,6,0.0,0.0
1006,423,24-09-2019 01:44:00,0,3409.0,3419.0,1.003,17.217,54,40,8,32,14,5,9,3,0.0,0.0
1006,424,24-09-2019 01:46:00,0,3536.0,3493.0,0.988,17.797,33,18,1,17,15,0,15,0,0.0,0.0
1006,425,24-09-2019 01:48:00,0,3531.0,3467.0,0.982,17.748,1,1,0,1,0,0,0,0,0.0,0.0
1006,426,24-09-2019 01:50:00,0,3420.0,3336.0,0.976,17.169,0,0,0,0,0,0,0,0,0.0,0.0
1006,427,24-09-2019 01:52:00,0,3445.0,3265.0,0.948,17.188,106,89,67,22,17,2,15,9,0.0,0.0
1006,428,24-09-2019 01:54:00,0,3317.0,3218.0,0.97,16.631,3,3,1,2,0,0,0,0,0.0,0.0
1006,429,24-09-2019 01:56:00,0,3335.0,3238.0,0.971,16.725,3,0,0,0,3,0,3,0,0.0,0.0
1006,430,24-09-2019 01:58:00,0,3109.5,3043.0,0.979,15.6195,1,0,0,0,1,0,1,0,0.0,0.0
1006,431,24-09-2019 02:00:00,0,2884.0,2848.0,0.987,14.514,0,0,0,0,0,0,0,0,0.0,0.0
1006,432,24-09-2019 02:02:00,0,2901.0,2767.0,0.954,14.493,1,1,1,0,0,0,0,0,0.0,0.0
1006,433,24-09-2019 02:04:00,0,2768.0,2750.0,0.993,13.949,8,4,2,2,4,0,4,0,0.0,0.0
1006,434,24-09-2019 02:06:00,0,2895.0,2812.0,0.971,14.52,242,151,114,37,91,66,25,6,0.0,0.0
1006,435,24-09-2019 02:08:00,0,3003.0,2886.0,0.961,15.026,29,17,11,6,12,5,7,0,0.0,0.0
1006,436,24-09-2019 02:10:00,0,3004.0,2926.0,0.974,15.076,0,0,0,0,0,0,0,0,0.0,0.0
1006,437,24-09-2019 02:12:00,0,2888.0,2860.0,0.99,14.543,0,0,0,0,0,0,0,0,0.0,0.0
1006,438,24-09-2019 02:14:00,0,2907.0,2778.0,0.956,14.529,0,0,0,0,0,0,0,0,0.0,0.0
1006,439,24-09-2019 02:16:00,0,2778.0,2774.0,0.998,14.015,3,3,0,3,0,0,0,0,0.0,0.0
1006,440,24-09-2019 02:18:00,0,2653.0,2700.0,1.018,13.441,5,5,0,5,0,0,0,0,0.0,0.0
1006,441,24-09-2019 02:20:00,0,2667.0,2669.0,1.0,13.464,14,12,0,12,2,0,2,0,0.0,0.0
1006,442,24-09-2019 02:22:00,0,2673.0,2611.0,0.977,13.42,5,1,0,1,4,0,4,0,0.0,0.0
1006,443,24-09-2019 02:24:00,0,2659.0,2670.0,1.004,13.43,5,1,0,1,4,0,4,0,0.0,0.0
1006,444,24-09-2019 02:26:00,0,2669.0,2647.0,0.992,13.446,0,0,0,0,0,0,0,0,0.0,0.0
1006,445,24-09-2019 02:28:00,0,2677.0,2605.0,0.973,13.433,88,70,38,32,18,4,14,17,0.0,0.0
1006,446,24-09-2019 02:30:00,0,3095.0,3068.0,0.991,15.589,105,59,24,35,46,27,19,0,0.0,0.0
1006,447,24-09-2019 02:32:00,0,3161.0,3079.0,0.9745,15.861,219,133,80,53,86,49,37,37,0.01,0.0
1006,448,24-09-2019 02:34:00,0,3227.0,3090.0,0.958,16.133,107,76,44,32,31,16,15,31,0.0,0.0
1006,449,24-09-2019 02:36:00,0,3552.0,3349.0,0.943,17.703,195,133,95,38,62,44,18,17,0.0,0.0
1006,450,24-09-2019 02:38:00,0,3449.0,3286.0,0.953,17.227,174,118,80,38,56,28,28,37,0.0,0.01
1006,451,24-09-2019 02:40:00,0,3548.0,3429.0,0.967,17.777,132,80,52,28,52,19,33,4,0.0,0.0
1006,452,24-09-2019 02:42:00,0,3523.0,3516.0,0.998,17.772,106,86,51,35,20,1,19,34,0.0,0.0
1006,453,24-09-2019 02:44:00,0,3885.0,3619.0,0.931,19.313,169,115,77,38,54,11,43,69,0.0,0.0
1006,454,24-09-2019 02:46:00,0,4081.0,3965.0,0.972,20.47,161,109,68,41,52,4,48,77,0.0,0.0
1006,455,24-09-2019 02:48:00,0,4188.0,4101.0,0.979,21.042,122,83,53,30,39,3,36,78,0.0,0.0
1006,456,24-09-2019 02:50:00,0,4269.0,4199.0,0.984,21.469,130,91,59,32,39,2,37,76,0.0,0.04
1006,457,24-09-2019 02:52:00,0,4393.0,4283.0,0.975,22.051,267,146,101,45,121,78,43,62,0.08,0.09
1006,458,24-09-2019 02:54:00,0,4115.0,3831.0,0.931,20.453,276,182,139,43,94,63,31,103,0.14,0.02
1006,459,24-09-2019 02:56:00,0,3454.0,3226.0,0.934,17.181,225,143,103,40,82,41,41,66,0.0,0.0
1006,460,24-09-2019 02:58:00,0,4504.0,4334.0,0.962,22.544,163,129,86,43,34,0,34,62,0.01,0.03
1006,461,24-09-2019 03:00:00,0,4605.0,4466.0,0.97,23.088,120,83,55,28,37,2,35,55,0.0,0.03
1006,462,24-09-2019 03:02:00,0,4621.0,4421.0,0.957,23.101,209,136,94,42,73,40,33,48,0.04,0.06
1006,463,24-09-2019 03:04:00,0,3658.0,3495.0,0.955,18.282,50,44,16,28,6,2,4,2,0.0,0.01
1006,464,24-09-2019 03:06:00,0,3722.0,3499.0,0.94,18.5395,270,156,127,29,114,79,35,40,0.08,0.02
1006,465,24-09-2019 03:08:00,0,3786.0,3503.0,0.925,18.797,167,124,93,31,43,13,30,59,0.0,0.0
1006,466,24-09-2019 03:10:00,0,4709.0,4570.0,0.971,23.611,114,84,48,36,30,0,30,52,0.0,0.04
1006,467,24-09-2019 03:12:00,0,4607.0,4487.0,0.974,23.118,93,73,40,33,20,7,13,5,0.0,0.03
1006,468,24-09-2019 03:14:00,0,3461.0,3230.0,0.933,17.213,54,32,16,16,22,5,17,0,0.0,0.0
1006,469,24-09-2019 03:16:00,0,3360.0,3051.0,0.908,16.617,44,37,7,30,7,1,6,0,0.0,0.0
1006,470,24-09-2019 03:18:00,0,3387.0,3019.0,0.892,16.686,178,125,88,37,53,37,16,12,0.09,0.0
1006,471,24-09-2019 03:20:00,0,4619.0,4457.0,0.965,23.135,95,46,25,21,49,26,23,22,0.0,0.03
1006,472,24-09-2019 03:22:00,0,4828.0,4671.0,0.967,24.195,269,161,125,36,108,80,28,87,0.0,0.07
1006,473,24-09-2019 03:24:00,0,3902.0,3590.0,0.92,19.347,144,122,81,41,22,0,22,66,0.0,0.0
1006,474,24-09-2019 03:26:00,0,4611.0,4489.0,0.973,23.137,138,100,66,34,38,0,38,67,0.01,0.0
1006,475,24-09-2019 03:28:00,0,5151.0,4995.0,0.97,25.822,124,86,60,26,38,8,30,47,0.0,0.0
1006,476,24-09-2019 03:30:00,0,3766.0,3539.0,0.94,18.754,10,1,0,1,9,1,8,0,0.0,0.0
1006,477,24-09-2019 03:32:00,0,3352.0,3081.0,0.919,16.617,0,0,0,0,0,0,0,0,0.0,0.0
1006,478,24-09-2019 03:34:00,0,3129.0,2888.0,0.923,15.525,8,6,2,4,2,0,2,0,0.0,0.0
1006,479,24-09-2019 03:36:00,0,3175.0,2772.0,0.873,15.577,2,1,0,1,1,0,1,0,0.0,0.0
1006,480,24-09-2019 03:38:00,0,3057.0,2692.0,0.881,15.023,10,10,0,10,0,0,0,0,0.0,0.0
1006,481,24-09-2019 03:40:00,0,2937.0,2642.5,0.9005,14.497,0,0,0,0,0,0,0,0,0.0,0.0
1006,482,24-09-2019 03:42:00,0,2817.0,2593.0,0.92,13.971,8,8,2,6,0,0,0,0,0.0,0.0
1006,483,24-09-2019 03:44:00,0,2827.0,2540.0,0.899,13.951,1,1,1,0,0,0,0,0,0.0,0.0
1006,484,24-09-2019 03:46:00,0,2807.0,2590.0,0.923,13.926,4,4,0,4,0,0,0,0,0.0,0.0
1006,485,24-09-2019 03:48:00,0,2829.0,2558.0,0.904,13.978,10,10,2,8,0,0,0,0,0.0,0.0
1006,486,24-09-2019 03:50:00,0,2816.0,2585.0,0.918,13.958,0,0,0,0,0,0,0,0,0.0,0.0
1006,487,24-09-2019 03:52:00,0,2828.0,2553.0,0.903,13.967,0,0,0,0,0,0,0,0,0.0,0.0
1006,488,24-09-2019 03:54:00,0,2829.0,2549.0,0.901,13.969,39,28,19,9,11,7,4,3,0.0,0.0
1006,489,24-09-2019 03:56:00,0,3051.0,2767.0,0.907,15.083,1,0,0,0,1,1,0,0,0.0,0.0
1006,490,24-09-2019 03:58:00,0,2813.0,2602.0,0.925,13.965,0,0,0,0,0,0,0,0,0.0,0.0
1006,491,24-09-2019 04:00:00,0,2809.0,2634.0,0.938,13.983,3,2,0,2,1,0,1,0,0.0,0.0
1006,492,24-09-2019 04:02:00,0,2834.0,2566.0,0.905,14.006,2,1,1,0,1,0,1,0,0.0,0.0
1006,493,24-09-2019 04:04:00,0,2831.0,2561.0,0.905,13.991,2,0,0,0,2,0,2,0,0.0,0.0
1006,494,24-09-2019 04:06:00,0,2806.0,2600.0,0.927,13.933,0,0,0,0,0,0,0,0,0.0,0.0
1006,495,24-09-2019 04:08:00,0,2788.0,2723.0,0.977,13.998,0,0,0,0,0,0,0,0,0.0,0.0
1006,496,24-09-2019 04:10:00,0,2998.0,2980.0,0.994,15.109,0,0,0,0,0,0,0,0,0.02,0.0
1006,497,24-09-2019 04:12:00,0,3097.0,3050.0,0.985,15.578,0,0,0,0,0,0,0,0,0.0,0.0
1006,498,24-09-2019 04:14:00,0,3316.0,3239.0,0.9775,16.6505,92,55,30,25,37,24,13,17,0.0,0.0
1006,499,24-09-2019 04:16:00,0,3535.0,3428.0,0.97,17.723,308,173,128,45,135,99,36,54,0.0,0.0
1006,500,24-09-2019 04:18:00,0,3620.0,3661.0,1.011,18.317,283,203,156,47,80,48,32,63,0.0,0.0
1006,501,24-09-2019 04:20:00,0,3843.0,3825.0,0.995,19.376,100,75,42,33,25,12,13,55,0.0,0.0
1006,502,24-09-2019 04:22:00,0,4052.0,4057.0,1.001,20.454,203,140,93,47,63,42,21,80,0.0,0.0
1006,503,24-09-2019 04:24:00,0,3521.0,3448.0,0.979,17.69,118,79,34,45,39,20,19,6,0.0,0.0
1006,504,24-09-2019 04:26:00,0,3954.0,3914.0,0.99,19.912,151,116,79,37,35,5,30,56,0.0,0.0
1006,505,24-09-2019 04:28:00,0,4271.0,4273.0,1.0,21.557,139,88,51,37,51,2,49,74,0.0,0.0
1006,506,24-09-2019 04:30:00,0,4357.0,4390.0,1.008,22.028,110,67,36,31,43,0,43,76,0.0,0.0
1006,507,24-09-2019 04:32:00,0,4591.0,4554.0,0.992,23.129,109,71,40,31,38,0,38,64,0.0,0.0
1006,508,24-09-2019 04:34:00,0,4576.0,4610.0,1.007,23.133,126,78,41,37,48,0,48,69,0.0,0.0
1006,509,24-09-2019 04:36:00,0,4364.0,4405.0,1.009,22.069,329,216,163,53,113,77,36,53,0.0,0.01
1006,510,24-09-2019 04:38:00,0,3543.0,3402.0,0.96,17.728,301,170,111,59,131,95,36,16,0.0,0.02
1006,511,24-09-2019 04:40:00,0,4054.0,4059.0,1.001,20.467,166,103,67,36,63,39,24,14,0.09,0.11
1006,512,24-09-2019 04:42:00,0,4061.0,3984.0,0.981,20.409,116,79,42,37,37,5,32,39,0.01,0.0
1006,513,24-09-2019 04:44:00,0,4247.0,4269.0,1.005,21.459,123,75,38,37,48,0,48,58,0.0,0.0
1006,514,24-09-2019 04:46:00,0,4612.0,4532.0,0.983,23.187,125,79,44,35,46,5,41,56,0.0,0.0
1006,515,24-09-2019 04:48:00,0,4491.0,4436.5,0.988,22.606,134,101,66,35,33,0,33,59,0.0,0.0
1006,516,24-09-2019 04:50:00,0,4370.0,4341.0,0.993,22.025,112,79,44,35,33,0,33,52,0.0,0.04
1006,517,24-09-2019 04:52:00,0,4058.0,4069.0,1.003,20.495,130,90,54,36,40,0,40,63,0.0,0.0
1006,518,24-09-2019 04:54:00,0,4254.0,4230.0,0.994,21.444,233,138,105,33,95,60,35,54,0.14,0.04
1006,519,24-09-2019 04:56:00,0,3976.0,3858.0,0.97,19.935,220,150,108,42,70,49,21,13,0.09,0.0
1006,520,24-09-2019 04:58:00,0,3536.0,3446.0,0.974,17.747,62,46,18,28,16,0,16,1,0.0,0.0
1006,521,24-09-2019 05:00:00,0,3323.0,3189.0,0.96,16.624,29,15,2,13,14,0,14,0,0.0,0.0
1006,522,24-09-2019 05:02:00,0,3358.0,3123.0,0.93,16.687,92,47,25,22,45,9,36,3,0.0,0.0
1006,523,24-09-2019 05:04:00,0,3141.0,2965.0,0.944,15.656,274,82,48,34,192,142,50,14,0.01,0.0
1006,524,24-09-2019 05:06:00,0,3349.0,3134.0,0.936,16.663,55,26,12,14,29,6,23,0,0.0,0.01
1006,525,24-09-2019 05:08:00,0,3592.0,3201.0,0.891,17.697,27,16,4,12,11,0,11,0,0.01,0.01
1006,526,24-09-2019 05:10:00,0,3577.0,3270.0,0.914,17.715,30,25,1,24,5,0,5,0,0.0,0.0
1006,527,24-09-2019 05:12:00,0,3563.0,3281.0,0.921,17.672,7,4,0,4,3,0,3,0,0.0,0.0
1006,528,24-09-2019 05:14:00,0,3446.0,3193.0,0.927,17.112,0,0,0,0,0,0,0,0,0.0,0.0
1006,529,24-09-2019 05:16:00,0,3375.0,3080.0,0.913,16.706,7,4,4,0,3,1,2,0,0.0,0.0
1006,530,24-09-2019 05:18:00,0,3239.0,2955.0,0.912,16.033,0,0,0,0,0,0,0,0,0.0,0.0
1006,531,24-09-2019 05:20:00,0,3136.0,2883.0,0.919,15.547,4,3,1,2,1,0,1,0,0.0,0.0
1006,532,24-09-2019 05:22:00,0,3092.0,2831.5,0.9155,15.3175,13,13,0,13,0,0,0,0,0.0,0.0
1006,533,24-09-2019 05:24:00,0,3048.0,2780.0,0.912,15.088,0,0,0,0,0,0,0,0,0.0,0.0
1006,534,24-09-2019 05:26:00,0,2912.0,2702.0,0.928,14.466,0,0,0,0,0,0,0,0,0.0,0.0
1006,535,24-09-2019 05:28:00,0,2800.0,2665.0,0.952,13.984,68,42,15,27,26,9,17,3,0.0,0.0
1006,536,24-09-2019 05:30:00,0,3240.0,3043.0,0.939,16.136,230,142,106,36,88,58,30,15,0.0,0.0
1006,537,24-09-2019 05:32:00,0,3518.0,3468.0,0.986,17.7,3,3,0,3,0,0,0,0,0.0,0.0
1006,538,24-09-2019 05:34:00,0,3025.0,2811.0,0.929,15.03,1,1,0,1,0,0,0,0,0.0,0.01
1006,539,24-09-2019 05:36:00,0,2920.0,2742.0,0.939,14.541,0,0,0,0,0,0,0,0,0.0,0.0
1006,540,24-09-2019 05:38:00,0,3021.0,2808.0,0.929,15.013,0,0,0,0,0,0,0,0,0.0,0.0
1006,541,24-09-2019 05:40:00,0,3108.0,2994.0,0.963,15.562,2,0,0,0,2,0,2,0,0.0,0.0
1006,542,24-09-2019 05:42:00,0,3356.0,3145.0,0.937,16.704,1,0,0,0,1,0,1,0,0.01,0.0
1006,543,24-09-2019 05:44:00,0,3420.0,3330.0,0.974,17.162,0,0,0,0,0,0,0,0,0.0,0.0
1006,544,24-09-2019 05:46:00,0,3286.0,3331.0,1.014,16.634,0,0,0,0,0,0,0,0,0.0,0.0
1006,545,24-09-2019 05:48:00,0,3214.0,3145.0,0.979,16.143,0,0,0,0,0,0,0,0,0.0,0.0
1006,546,24-09-2019 05:50:00,0,3079.0,3105.0,1.009,15.569,0,0,0,0,0,0,0,0,0.0,0.0
1006,547,24-09-2019 05:52:00,0,3079.0,3147.0,1.022,15.613,0,0,0,0,0,0,0,0,0.0,0.0
1006,548,24-09-2019 05:54:00,0,3089.0,3118.0,1.009,15.621,17,15,8,7,2,2,0,0,0.0,0.0
1006,549,24-09-2019 05:56:00,0,3290.5,3352.5,1.018,16.6745,152,98,64,34,54,29,25,15,0.0,0.0
1006,550,24-09-2019 05:58:00,0,3492.0,3587.0,1.027,17.728,174,125,85,40,49,26,23,26,0.0,0.0
1006,551,24-09-2019 06:00:00,1,3836.0,3826.0,0.998,19.349,520,275,225,50,245,194,51,101,0.0,0.0
1006,552,24-09-2019 06:02:00,1,3961.0,3909.0,0.987,19.933,416,264,213,51,152,113,39,93,0.0,0.0
1006,553,24-09-2019 06:04:00,1,4045.0,4109.0,1.016,20.485,242,131,96,35,111,69,42,109,0.0,0.0
1006,554,24-09-2019 06:06:00,1,4360.0,4337.0,0.995,21.978,90,55,30,25,35,0,35,76,0.0,0.05
1006,555,24-09-2019 06:08:00,1,4616.0,4491.0,0.973,23.16,138,89,48,41,49,0,49,75,0.0,0.0
1006,556,24-09-2019 06:10:00,1,4712.0,4617.0,0.98,23.677,120,76,38,38,44,0,44,60,0.0,0.0
1006,557,24-09-2019 06:12:00,1,4576.0,4578.0,1.001,23.096,135,76,53,23,59,34,25,28,0.0,0.03
1006,558,24-09-2019 06:14:00,1,3322.0,3259.0,0.981,16.698,233,159,116,43,74,51,23,14,0.0,0.05
1006,559,24-09-2019 06:16:00,1,3751.0,3616.0,0.964,18.78,131,50,28,22,81,55,26,4,0.0,0.0
1006,560,24-09-2019 06:18:00,1,3114.0,3020.0,0.97,15.614,70,37,16,21,33,6,27,0,0.0,0.0
1006,561,24-09-2019 06:20:00,1,3265.0,2999.0,0.919,16.184,58,25,6,19,33,1,32,0,0.0,0.0
1006,562,24-09-2019 06:22:00,1,3366.0,3038.0,0.903,16.625,23,23,1,22,0,0,0,0,0.0,0.0
1006,563,24-09-2019 06:24:00,1,3364.0,3065.0,0.911,16.647,19,10,2,8,9,1,8,0,0.0,0.0
1006,564,24-09-2019 06:26:00,1,3138.0,2893.0,0.922,15.568,0,0,0,0,0,0,0,0,0.0,0.0
1006,565,24-09-2019 06:28:00,1,3142.0,2859.0,0.91,15.546,0,0,0,0,0,0,0,0,0.0,0.0
1006,566,24-09-2019 06:30:00,1,3022.5,2827.5,0.9365,15.04,5,4,0,4,1,0,1,0,0.0,0.0
1006,567,24-09-2019 06:32:00,1,2903.0,2796.0,0.963,14.534,0,0,0,0,0,0,0,0,0.0,0.0
1006,568,24-09-2019 06:34:00,1,2880.0,2829.0,0.982,14.479,0,0,0,0,0,0,0,0,0.0,0.0
1006,569,24-09-2019 06:36:00,1,2981.0,2967.0,0.995,15.03,32,16,9,7,16,2,14,0,0.0,0.0
1006,570,24-09-2019 06:38:00,1,3450.0,3261.0,0.945,17.204,0,0,0,0,0,0,0,0,0.0,0.0
1006,571,24-09-2019 06:40:00,1,3435.0,3367.0,0.98,17.261,8,6,0,6,2,0,2,0,0.0,0.0
1006,572,24-09-2019 06:42:00,1,3754.0,3629.0,0.967,18.809,0,0,0,0,0,0,0,0,0.0,0.0
1006,573,24-09-2019 06:44:00,1,3630.0,3597.0,0.991,18.284,11,10,0,10,1,0,1,0,0.0,0.0
1006,574,24-09-2019 06:46:00,1,3417.0,3352.0,0.981,17.175,5,4,0,4,1,0,1,0,0.0,0.0
1006,575,24-09-2019 06:48:00,1,3224.0,3106.0,0.963,16.141,2,1,0,1,1,0,1,0,0.0,0.0
1006,576,24-09-2019 06:50:00,1,2960.0,3079.0,1.04,15.073,2,0,0,0,2,0,2,0,0.0,0.0
1006,577,24-09-2019 06:52:00,1,2980.0,3004.0,1.008,15.068,0,0,0,0,0,0,0,0,0.0,0.0
1006,578,24-09-2019 06:54:00,1,2975.0,3016.0,1.014,15.061,10,4,0,4,6,0,6,0,0.0,0.0
1006,579,24-09-2019 06:56:00,1,2996.0,2978.0,0.994,15.1,2,0,0,0,2,0,2,0,0.0,0.0
1006,580,24-09-2019 06:58:00,1,2981.0,2955.0,0.991,15.018,1,0,0,0,1,0,1,0,0.0,0.0
1006,581,24-09-2019 07:00:00,1,2867.0,2908.0,1.014,14.516,0,0,0,0,0,0,0,0,0.01,0.0
1006,582,24-09-2019 07:02:00,1,2879.0,2903.0,1.008,14.555,0,0,0,0,0,0,0,0,0.0,0.0
1006,583,24-09-2019 07:04:00,1,2820.0,2862.0,1.015,14.2775,3,2,0,2,1,0,1,0,0.0,0.0
1006,584,24-09-2019 07:06:00,1,2761.0,2821.0,1.022,14.0,1,1,0,1,0,0,0,0,0.0,0.0
1006,585,24-09-2019 07:08:00,1,2760.0,2830.0,1.026,14.006,2,2,0,2,0,0,0,0,0.0,0.0
1006,586,24-09-2019 07:10:00,1,2763.0,2811.0,1.017,13.996,5,0,0,0,5,0,5,0,0.0,0.0
1006,587,24-09-2019 07:12:00,1,2770.0,2735.0,0.987,13.942,3,2,0,2,1,0,1,0,0.0,0.0
1006,588,24-09-2019 07:14:00,1,2529.0,2676.0,1.058,12.926,207,127,92,35,80,45,35,1,0.0,0.0
1006,589,24-09-2019 07:16:00,1,2835.0,3013.0,1.063,14.504,169,94,59,35,75,45,30,20,0.0,0.0
1006,590,24-09-2019 07:18:00,1,3078.0,3100.0,1.007,15.558,245,129,98,31,116,79,37,32,0.0,0.0
1006,591,24-09-2019 07:20:00,1,3058.0,3204.0,1.048,15.596,56,26,16,10,30,18,12,2,0.0,0.0
1006,592,24-09-2019 07:22:00,1,3303.0,3314.0,1.003,16.683,36,10,0,10,26,0,26,0,0.0,0.0
1006,593,24-09-2019 07:24:00,1,3294.0,3361.0,1.021,16.697,57,23,2,21,34,0,34,0,0.0,0.0
1006,594,24-09-2019 07:26:00,1,3275.0,3380.0,1.032,16.645,18,8,2,6,10,4,6,0,0.0,0.0
1006,595,24-09-2019 07:28:00,1,3302.0,3308.0,1.002,16.672,14,13,0,13,1,0,1,0,0.0,0.0
1006,596,24-09-2019 07:30:00,1,3063.0,3206.0,1.047,15.617,4,4,0,4,0,0,0,0,0.0,0.0
1006,597,24-09-2019 07:32:00,1,2965.0,3055.0,1.03,15.065,2,1,1,0,1,1,0,0,0.0,0.0
1006,598,24-09-2019 07:34:00,1,2865.0,2936.0,1.025,14.538,0,0,0,0,0,0,0,0,0.0,0.0
1006,599,24-09-2019 07:36:00,1,2754.0,2844.0,1.033,13.999,81,70,51,19,11,2,9,5,0.0,0.0
1006,600,24-09-2019 07:38:00,1,2985.5,2994.5,1.0055,15.077,154,84,51,33,70,44,26,42,0.0,0.0
1006,601,24-09-2019 07:40:00,1,3217.0,3145.0,0.978,16.155,61,31,14,17,30,0,30,79,0.0,0.0
1006,602,24-09-2019 07:42:00,1,3759.0,3645.0,0.97,18.846,29,12,6,6,17,2,15,14,0.0,0.03
1006,603,24-09-2019 07:44:00,1,3737.0,3725.0,0.997,18.847,74,33,7,26,41,0,41,52,0.0,0.0
1006,604,24-09-2019 07:46:00,1,3856.0,3791.0,0.983,19.389,69,37,17,20,32,0,32,70,0.0,0.01
1006,605,24-09-2019 07:48:00,1,3969.0,3870.0,0.975,19.921,96,57,26,31,39,0,39,56,0.0,0.08
1006,606,24-09-2019 07:50:00,1,3957.0,3865.0,0.977,19.868,146,99,71,28,47,20,27,99,0.0,0.04
1006,607,24-09-2019 07:52:00,1,3520.0,3515.0,0.999,17.76,322,189,150,39,133,93,40,98,0.1,0.0
1006,608,24-09-2019 07:54:00,1,3318.0,3288.0,0.991,16.714,110,69,42,27,41,15,26,40,0.01,0.0
1006,609,24-09-2019 07:56:00,1,2663.0,2637.0,0.99,13.412,48,35,8,27,13,2,11,0,0.0,0.0
1006,610,24-09-2019 07:58:00,1,2721.0,2463.0,0.905,13.447,11,4,1,3,7,0,7,0,0.0,0.0
1006,611,24-09-2019 08:00:00,1,2906.0,2758.0,0.949,14.503,63,41,25,16,22,1,21,0,0.0,0.0
1006,612,24-09-2019 08:02:00,1,3412.0,3383.0,0.992,17.186,13,8,4,4,5,0,5,0,0.0,0.0
1006,613,24-09-2019 08:04:00,1,3208.0,3120.0,0.972,16.095,9,9,0,9,0,0,0,0,0.0,0.0
1006,614,24-09-2019 08:06:00,1,3223.0,3136.0,0.973,16.17,4,4,1,3,0,0,0,0,0.01,0.0
1006,615,24-09-2019 08:08:00,1,3103.0,3000.0,0.967,15.546,3,3,0,3,0,0,0,0,0.0,0.0
1006,616,24-09-2019 08:10:00,1,2672.0,2625.0,0.983,13.433,0,0,0,0,0,0,0,0,0.0,0.0
1006,617,24-09-2019 08:12:00,1,2756.5,2576.5,0.9365,13.7125,0,0,0,0,0,0,0,0,0.0,0.0
1006,618,24-09-2019 08:14:00,1,2841.0,2528.0,0.89,13.992,28,20,11,9,8,2,6,0,0.0,0.0
1006,619,24-09-2019 08:16:00,1,2783.0,2673.0,0.96,13.926,37,31,13,18,6,0,6,0,0.0,0.0
1006,620,24-09-2019 08:18:00,1,3358.0,3136.0,0.934,16.703,67,60,21,39,7,2,5,0,0.0,0.0
1006,621,24-09-2019 08:20:00,1,3874.0,3702.0,0.955,19.362,26,21,9,12,5,1,4,3,0.0,0.0
1006,622,24-09-2019 08:22:00,1,3811.0,3867.0,1.015,19.295,39,27,10,17,12,1,11,0,0.0,0.0
1006,623,24-09-2019 08:24:00,1,3626.0,3588.0,0.989,18.26,20,19,2,17,1,0,1,0,0.0,0.0
1006,624,24-09-2019 08:26:00,1,3750.0,3649.0,0.973,18.816,10,10,4,6,0,0,0,0,0.0,0.0
1006,625,24-09-2019 08:28:00,1,3508.0,3538.0,1.009,17.738,11,11,4,7,0,0,0,0,0.02,0.0
1006,626,24-09-2019 08:30:00,1,3329.0,3196.0,0.96,16.656,7,7,2,5,0,0,0,0,0.0,0.0
1006,627,24-09-2019 08:32:00,1,2760.0,2783.0,1.008,13.956,0,0,0,0,0,0,0,0,0.0,0.0
1006,628,24-09-2019 08:34:00,1,2785.0,2725.0,0.978,13.989,9,9,4,5,0,0,0,0,0.0,0.0
1006,629,24-09-2019 08:36:00,1,2784.0,2723.0,0.978,13.982,0,0,0,0,0,0,0,0,0.0,0.0
1006,630,24-09-2019 08:38:00,1,2776.0,2782.0,1.002,14.019,5,5,2,3,0,0,0,0,0.0,0.0
1006,631,24-09-2019 08:40:00,1,3009.0,2873.0,0.955,15.034,0,0,0,0,0,0,0,0,0.0,0.0
1006,632,24-09-2019 08:42:00,1,2998.0,2914.0,0.972,15.037,0,0,0,0,0,0,0,0,0.0,0.0
1006,633,24-09-2019 08:44:00,1,3019.0,2883.0,0.955,15.085,4,2,0,2,2,1,1,0,0.0,0.0
1006,634,24-09-2019 08:46:00,1,2956.0,2839.0,0.9605,14.7895,0,0,0,0,0,0,0,0,0.0,0.0
1006,635,24-09-2019 08:48:00,1,2893.0,2795.0,0.966,14.494,0,0,0,0,0,0,0,0,0.0,0.0
1006,636,24-09-2019 08:50:00,1,2774.0,2771.0,0.999,13.996,0,0,0,0,0,0,0,0,0.0,0.0
1006,637,24-09-2019 08:52:00,1,2787.0,2700.0,0.969,13.972,41,24,17,7,17,3,14,6,0.0,0.0
1006,638,24-09-2019 08:54:00,1,3021.0,2872.0,0.951,15.081,157,91,63,28,66,43,23,30,0.0,0.0
1006,639,24-09-2019 08:56:00,1,3221.0,3091.0,0.959,16.114,25,12,4,8,13,7,6,0,0.0,0.0
1006,640,24-09-2019 08:58:00,1,3115.0,3037.0,0.975,15.633,25,23,10,13,2,1,1,0,0.0,0.0
1006,641,24-09-2019 09:00:00,1,3123.0,2972.0,0.952,15.596,7,5,3,2,2,0,2,0,0.0,0.0
1006,642,24-09-2019 09:02:00,1,2780.0,2707.0,0.974,13.948,7,7,1,6,0,0,0,0,0.0,0.0
1006,643,24-09-2019 09:04:00,1,2818.0,2599.0,0.922,13.98,2,0,0,0,2,0,2,0,0.0,0.0
1006,644,24-09-2019 09:06:00,1,2812.0,2628.0,0.934,13.988,15,11,0,11,4,0,4,0,0.0,0.0
1006,645,24-09-2019 09:08:00,1,2788.0,2640.0,0.947,13.909,11,5,0,5,6,0,6,0,0.0,0.0
1006,646,24-09-2019 09:10:00,1,2806.0,2653.0,0.945,13.994,0,0,0,0,0,0,0,0,0.0,0.0
1006,647,24-09-2019 09:12:00,1,2816.0,2581.0,0.917,13.951,5,1,0,1,4,0,4,0,0.0,0.0
1006,648,24-09-2019 09:14:00,1,2703.0,2527.0,0.935,13.446,2,1,0,1,1,0,1,0,0.0,0.0
1006,649,24-09-2019 09:16:00,1,2567.0,2506.0,0.976,12.889,0,0,0,0,0,0,0,0,0.0,0.0
1006,650,24-09-2019 09:18:00,1,2582.0,2487.0,0.963,12.926,0,0,0,0,0,0,0,0,0.0,0.0
1006,651,24-09-2019 09:20:00,1,2694.5,2549.0,0.9465,13.4385,14,12,8,4,2,0,2,0,0.0,0.0
1006,652,24-09-2019 09:22:00,1,2807.0,2611.0,0.93,13.951,87,60,37,23,27,21,6,2,0.0,0.0
1006,653,24-09-2019 09:24:00,1,2874.0,2845.0,0.99,14.473,130,94,59,35,36,16,20,12,0.0,0.0
1006,654,24-09-2019 09:26:00,1,3431.0,3352.0,0.977,17.229,212,109,78,31,103,70,33,71,0.0,0.0
1006,655,24-09-2019 09:28:00,1,3544.0,3416.0,0.964,17.746,100,62,25,37,38,2,36,69,0.0,0.0
1006,656,24-09-2019 09:30:00,1,3884.0,3670.0,0.945,19.366,120,81,47,34,39,0,39,89,0.0,0.02
1006,657,24-09-2019 09:32:00,1,3976.0,3834.0,0.964,19.908,209,127,88,39,82,39,43,76,0.0,0.07
1006,658,24-09-2019 09:34:00,1,3768.0,3619.0,0.96,18.854,81,49,26,23,32,1,31,65,0.0,0.02
1006,659,24-09-2019 09:36:00,1,4049.0,4029.0,0.995,20.412,84,52,34,18,32,0,32,58,0.0,0.04
1006,660,24-09-2019 09:38:00,1,4150.0,4157.0,1.002,20.953,227,145,107,38,82,53,29,44,0.1,0.08
1006,661,24-09-2019 09:40:00,1,3517.0,3497.0,0.994,17.728,405,216,166,50,189,144,45,49,0.0,0.0
1006,662,24-09-2019 09:42:00,1,3336.0,3162.0,0.948,16.645,302,148,98,50,154,104,50,2,0.06,0.0
1006,663,24-09-2019 09:44:00,1,3130.0,2950.0,0.942,15.599,263,165,123,42,98,55,43,7,0.0,0.0
1006,664,24-09-2019 09:46:00,1,3556.0,3349.0,0.942,17.718,121,85,43,42,36,0,36,61,0.01,0.0
1006,665,24-09-2019 09:48:00,1,4378.0,4332.0,0.99,22.043,198,123,87,36,75,43,32,46,0.0,0.04
1006,666,24-09-2019 09:50:00,1,3643.0,3578.0,0.982,18.316,37,36,12,24,1,0,1,0,0.0,0.0
1006,667,24-09-2019 09:52:00,1,3021.0,2835.0,0.938,15.043,71,58,23,35,13,1,12,0,0.0,0.0
1006,668,24-09-2019 09:54:00,1,2928.0,2690.0,0.918,14.5155,54,17,6,11,37,13,24,0,0.0,0.0
1006,669,24-09-2019 09:56:00,1,2835.0,2545.0,0.898,13.988,34,0,0,0,34,11,23,0,0.0,0.0
1006,670,24-09-2019 09:58:00,1,2846.0,2502.0,0.879,13.983,20,0,0,0,20,0,20,0,0.0,0.0
1006,671,24-09-2019 10:00:00,1,2721.0,2435.0,0.895,13.418,12,4,0,4,8,0,8,0,0.0,0.0
1006,672,24-09-2019 10:02:00,1,2615.0,2348.0,0.898,12.902,3,1,0,1,2,0,2,0,0.0,0.0
1006,673,24-09-2019 10:04:00,1,2622.0,2322.0,0.885,12.901,3,0,0,0,3,0,3,0,0.0,0.0
1006,674,24-09-2019 10:06:00,1,2624.0,2315.0,0.882,12.902,3,0,0,0,3,0,3,0,0.0,0.0
1006,675,24-09-2019 10:08:00,1,2612.0,2382.0,0.912,12.93,20,3,0,3,17,0,17,0,0.0,0.0
1006,676,24-09-2019 10:10:00,1,2725.0,2437.0,0.894,13.436,27,19,6,13,8,3,5,0,0.0,0.0
1006,677,24-09-2019 10:12:00,1,2819.0,2570.0,0.912,13.953,2,2,0,2,0,0,0,0,0.0,0.0
1006,678,24-09-2019 10:14:00,1,3033.0,2809.0,0.926,15.059,0,0,0,0,0,0,0,0,0.01,0.0
1006,679,24-09-2019 10:16:00,1,3221.0,3089.0,0.959,16.109,1,1,1,0,0,0,0,0,0.0,0.0
1006,680,24-09-2019 10:18:00,1,3035.0,2821.0,0.93,15.079,0,0,0,0,0,0,0,0,0.0,0.0
1006,681,24-09-2019 10:20:00,1,2906.0,2801.0,0.964,14.552,2,0,0,0,2,0,2,0,0.0,0.0
1006,682,24-09-2019 10:22:00,1,3007.0,2916.0,0.97,15.077,13,9,4,5,4,2,2,0,0.0,0.0
1006,683,24-09-2019 10:24:00,1,3108.0,3054.0,0.983,15.627,11,8,2,6,3,2,1,0,0.0,0.0
1006,684,24-09-2019 10:26:00,1,3207.0,3169.0,0.988,16.145,3,2,0,2,1,0,1,0,0.0,0.0
1006,685,24-09-2019 10:28:00,1,3143.5,3156.5,1.0045,15.88,27,20,7,13,7,2,5,0,0.0,0.0
1006,686,24-09-2019 10:30:00,1,3080.0,3144.0,1.021,15.615,7,6,0,6,1,0,1,0,0.0,0.0
1006,687,24-09-2019 10:32:00,1,3313.0,3278.0,0.989,16.683,7,5,1,4,2,0,2,0,0.0,0.0
1006,688,24-09-2019 10:34:00,1,3296.0,3310.0,1.004,16.65,1,0,0,0,1,0,1,0,0.0,0.0
1006,689,24-09-2019 10:36:00,1,3319.0,3269.0,0.985,16.696,0,0,0,0,0,0,0,0,0.0,0.0
1006,690,24-09-2019 10:38:00,1,3069.0,3160.0,1.03,15.589,98,62,42,20,36,11,25,1,0.0,0.0
1006,691,24-09-2019 10:40:00,1,3329.0,3246.0,0.975,16.708,84,59,30,29,25,13,12,3,0.0,0.0
1006,692,24-09-2019 10:42:00,1,3422.0,3387.0,0.99,17.23,229,167,117,50,62,36,26,14,0.0,0.0
1006,693,24-09-2019 10:44:00,1,3300.0,3311.0,1.003,16.668,0,0,0,0,0,0,0,0,0.0,0.0
1006,694,24-09-2019 10:46:00,1,3316.0,3266.0,0.985,16.682,9,9,3,6,0,0,0,0,0.0,0.0
1006,695,24-09-2019 10:48:00,1,3079.0,3158.0,1.025,15.627,6,5,1,4,1,0,1,0,0.0,0.0
1006,696,24-09-2019 10:50:00,1,3106.0,3035.0,0.977,15.597,0,0,0,0,0,0,0,0,0.0,0.0
1006,697,24-09-2019 10:52:00,1,2882.0,2868.0,0.995,14.53,16,13,2,11,3,0,3,0,0.0,0.0
1006,698,24-09-2019 10:54:00,1,2770.0,2775.0,1.002,13.986,5,5,0,5,0,0,0,0,0.01,0.0
1006,699,24-09-2019 10:56:00,1,2762.0,2794.0,1.012,13.976,7,7,3,4,0,0,0,0,0.0,0.0
1006,700,24-09-2019 10:58:00,1,2778.0,2748.0,0.989,13.986,1,1,0,1,0,0,0,0,0.0,0.0
1006,701,24-09-2019 11:00:00,1,2785.0,2735.0,0.982,14.002,2,2,0,2,0,0,0,0,0.0,0.0
1006,702,24-09-2019 11:02:00,1,2790.0,2705.5,0.9695,13.989,0,0,0,0,0,0,0,0,0.0,0.0
1006,703,24-09-2019 11:04:00,1,2795.0,2676.0,0.957,13.976,10,10,2,8,0,0,0,0,0.0,0.0
1006,704,24-09-2019 11:06:00,1,2801.0,2658.0,0.949,13.98,4,4,0,4,0,0,0,0,0.0,0.0
1006,705,24-09-2019 11:08:00,1,2792.0,2685.0,0.962,13.972,0,0,0,0,0,0,0,0,0.0,0.0
1006,706,24-09-2019 11:10:00,1,2788.0,2672.0,0.958,13.944,0,0,0,0,0,0,0,0,0.0,0.0
1006,707,24-09-2019 11:12:00,1,2793.0,2684.0,0.961,13.977,51,46,26,20,5,0,5,0,0.0,0.0
1006,708,24-09-2019 11:14:00,1,2787.0,2684.0,0.963,13.951,2,2,0,2,0,0,0,0,0.0,0.0
1006,709,24-09-2019 11:16:00,1,2783.0,2709.0,0.973,13.964,9,6,3,3,3,0,3,0,0.0,0.0
1006,710,24-09-2019 11:18:00,1,2797.0,2690.0,0.962,13.997,5,2,1,1,3,0,3,0,0.0,0.0
1006,711,24-09-2019 11:20:00,1,2808.0,2631.0,0.937,13.976,11,11,7,4,0,0,0,0,0.0,0.0
1006,712,24-09-2019 11:22:00,1,2800.0,2654.0,0.948,13.972,34,23,13,10,11,4,7,0,0.0,0.0
1006,713,24-09-2019 11:24:00,1,2807.0,2701.0,0.962,14.05,0,0,0,0,0,0,0,0,0.0,0.0
1006,714,24-09-2019 11:26:00,1,2801.0,2637.0,0.941,13.957,0,0,0,0,0,0,0,0,0.0,0.0
1006,715,24-09-2019 11:28:00,1,2797.0,2638.0,0.943,13.939,0,0,0,0,0,0,0,0,0.0,0.0
1006,716,24-09-2019 11:30:00,1,2815.0,2604.0,0.925,13.973,97,68,40,28,29,5,24,5,0.0,0.0
1006,717,24-09-2019 11:32:00,1,2761.0,2798.0,1.013,13.975,99,70,48,22,29,6,23,27,0.0,0.0
1006,718,24-09-2019 11:34:00,1,3302.0,3267.0,0.989,16.628,115,70,38,32,45,4,41,62,0.0,0.0
1006,719,24-09-2019 11:36:00,1,3578.5,3523.5,0.985,18.0,110,65,31,34,45,0,45,64,0.0,0.01
1006,720,24-09-2019 11:38:00,1,3855.0,3780.0,0.981,19.372,99,56,31,25,43,0,43,69,0.0,0.0
1006,721,24-09-2019 11:40:00,1,4078.0,3957.0,0.97,20.447,110,77,44,33,33,0,33,73,0.0,0.09
1006,722,24-09-2019 11:42:00,1,4068.0,3957.0,0.973,20.407,226,124,91,33,102,59,43,65,0.0,0.08
1006,723,24-09-2019 11:44:00,1,3309.0,3291.0,0.995,16.681,335,191,146,45,144,103,41,70,0.0,0.03
1006,724,24-09-2019 11:46:00,1,3559.0,3374.0,0.948,17.757,375,206,161,45,169,120,49,13,0.1,0.0
1006,725,24-09-2019 11:48:00,1,3016.0,2874.0,0.953,15.065,448,285,208,77,163,110,53,9,0.0,0.0
1006,726,24-09-2019 11:50:00,1,2769.0,2781.0,1.004,13.99,256,129,98,31,127,95,32,5,0.0,0.0
1006,727,24-09-2019 11:52:00,1,2584.0,2474.0,0.957,12.921,206,148,106,42,58,28,30,8,0.0,0.0
1006,728,24-09-2019 11:54:00,1,3232.0,3085.0,0.955,16.15,131,46,26,20,85,56,29,7,0.0,0.0
1006,729,24-09-2019 11:56:00,1,3572.0,3317.0,0.929,17.748,379,228,182,46,151,102,49,7,0.0,0.0
1006,730,24-09-2019 11:58:00,1,3866.0,3737.0,0.967,19.371,489,352,273,79,137,103,34,5,0.01,0.0
1006,731,24-09-2019 12:00:00,1,4078.0,3944.0,0.967,20.433,7,7,0,7,0,0,0,0,0.01,0.0
1006,732,24-09-2019 12:02:00,1,4047.0,4080.0,1.008,20.462,268,156,115,41,112,76,36,1,0.01,0.0
1006,733,24-09-2019 12:04:00,1,4056.0,4000.0,0.986,20.41,220,143,100,43,77,46,31,6,0.12,0.0
1006,734,24-09-2019 12:06:00,1,3335.0,3204.0,0.961,16.688,732,465,369,96,267,188,79,8,0.03,0.08
1006,735,24-09-2019 12:08:00,1,3864.0,3722.0,0.963,19.345,240,151,114,37,89,63,26,33,0.0,0.15
1006,736,24-09-2019 12:10:00,1,3973.5,3837.0,0.9655,19.903,0,0,0,0,0,0,0,0,0.0,0.02
1006,737,24-09-2019 12:12:00,1,4083.0,3952.0,0.968,20.461,0,0,0,0,0,0,0,0,0.0,0.0
1006,738,24-09-2019 12:14:00,1,4080.0,3858.0,0.946,20.347,3,3,2,1,0,0,0,0,0.0,0.0
1006,739,24-09-2019 12:16:00,1,3855.0,3780.0,0.981,19.372,139,98,75,23,41,22,19,6,0.0,0.0
1006,740,24-09-2019 12:18:00,1,3302.0,3309.0,1.002,16.672,264,135,98,37,129,79,50,2,0.07,0.0
1006,741,24-09-2019 12:20:00,1,3221.0,3121.0,0.969,16.144,77,56,30,26,21,2,19,0,0.0,0.0
1006,742,24-09-2019 12:22:00,1,3326.0,3219.0,0.968,16.669,71,46,15,31,25,2,23,0,0.02,0.0
1006,743,24-09-2019 12:24:00,1,3639.0,3572.0,0.982,18.29,63,41,18,23,22,0,22,0,0.0,0.0
1006,744,24-09-2019 12:26:00,1,3967.0,3888.0,0.98,19.936,11,9,1,8,2,0,2,0,0.0,0.0
1006,745,24-09-2019 12:28:00,1,3553.0,3380.0,0.951,17.741,5,1,0,1,4,0,4,0,0.0,0.0
1006,746,24-09-2019 12:30:00,1,3339.0,3166.0,0.948,16.662,28,10,6,4,18,0,18,0,0.0,0.0
1006,747,24-09-2019 12:32:00,1,3224.0,3113.0,0.965,16.151,0,0,0,0,0,0,0,0,0.0,0.0
1006,748,24-09-2019 12:34:00,1,3106.0,2995.0,0.964,15.554,0,0,0,0,0,0,0,0,0.0,0.0
1006,749,24-09-2019 12:36:00,1,3114.0,3048.0,0.979,15.643,0,0,0,0,0,0,0,0,0.0,0.0
1006,750,24-09-2019 12:38:00,1,3089.0,3106.0,1.005,15.609,0,0,0,0,0,0,0,0,0.0,0.0
1006,751,24-09-2019 12:40:00,1,3081.0,3109.0,1.009,15.582,25,21,6,15,4,0,4,0,0.0,0.0
1006,752,24-09-2019 12:42:00,1,3105.0,3059.0,0.985,15.619,0,0,0,0,0,0,0,0,0.0,0.0
1006,753,24-09-2019 12:44:00,1,3037.5,3043.5,1.0025,15.337,0,0,0,0,0,0,0,0,0.0,0.0
1006,754,24-09-2019 12:46:00,1,2970.0,3028.0,1.02,15.055,3,2,1,1,1,0,1,0,0.0,0.0
1006,755,24-09-2019 12:48:00,1,2993.0,2953.0,0.987,15.061,0,0,0,0,0,0,0,0,0.0,0.0
1006,756,24-09-2019 12:50:00,1,3016.0,2886.0,0.957,15.077,0,0,0,0,0,0,0,0,0.0,0.0
1006,757,24-09-2019 12:52:00,1,3008.0,2890.0,0.961,15.05,16,12,8,4,4,0,4,0,0.0,0.0
1006,758,24-09-2019 12:54:00,1,3019.0,2886.0,0.956,15.092,3,2,1,1,1,0,1,0,0.0,0.0
1006,759,24-09-2019 12:56:00,1,2996.0,2939.0,0.981,15.06,1,0,0,0,1,0,1,0,0.0,0.0
1006,760,24-09-2019 12:58:00,1,2996.0,2934.0,0.979,15.053,0,0,0,0,0,0,0,0,0.0,0.0
1006,761,24-09-2019 13:00:00,1,3003.0,2942.0,0.98,15.089,0,0,0,0,0,0,0,0,0.0,0.0
1006,762,24-09-2019 13:02:00,1,2756.0,2839.0,1.03,13.999,5,0,0,0,5,0,5,0,0.0,0.0
1006,763,24-09-2019 13:04:00,1,2762.0,2809.0,1.017,13.991,0,0,0,0,0,0,0,0,0.0,0.0
1006,764,24-09-2019 13:06:00,1,2773.0,2796.0,1.008,14.021,2,0,0,0,2,0,2,0,0.0,0.0
1006,765,24-09-2019 13:08:00,1,2767.0,2818.0,1.018,14.023,0,0,0,0,0,0,0,0,0.0,0.0
1006,766,24-09-2019 13:10:00,1,2874.0,2823.0,0.982,14.451,0,0,0,0,0,0,0,0,0.0,0.0
1006,767,24-09-2019 13:12:00,1,2896.0,2826.0,0.976,14.539,2,2,1,1,0,0,0,0,0.0,0.0
1006,768,24-09-2019 13:14:00,1,2766.0,2804.0,1.014,14.002,38,25,13,12,13,0,13,0,0.0,0.0
1006,769,24-09-2019 13:16:00,1,2879.0,2807.0,0.975,14.452,2,2,1,1,0,0,0,0,0.0,0.0
1006,770,24-09-2019 13:18:00,1,2814.5,2813.5,1.0005,14.2035,6,4,1,3,2,0,2,0,0.0,0.0
1006,771,24-09-2019 13:20:00,1,2750.0,2820.0,1.026,13.955,0,0,0,0,0,0,0,0,0.0,0.0
1006,772,24-09-2019 13:22:00,1,2896.0,2865.0,0.989,14.58,0,0,0,0,0,0,0,0,0.0,0.0
1006,773,24-09-2019 13:24:00,1,2882.0,2858.0,0.992,14.52,12,9,3,6,3,0,3,0,0.0,0.0
1006,774,24-09-2019 13:26:00,1,3005.0,2871.0,0.955,15.017,6,4,2,2,2,1,1,0,0.0,0.0
1006,775,24-09-2019 13:28:00,1,3020.0,2892.0,0.958,15.1,1,1,0,1,0,0,0,0,0.0,0.0
1006,776,24-09-2019 13:30:00,1,3018.0,2896.0,0.96,15.095,1,1,0,1,0,0,0,0,0.0,0.0
1006,777,24-09-2019 13:32:00,1,2876.0,2844.0,0.989,14.48,0,0,0,0,0,0,0,0,0.0,0.0
1006,778,24-09-2019 13:34:00,1,2769.0,2816.0,1.017,14.027,27,13,4,9,14,1,13,0,0.0,0.0
1006,779,24-09-2019 13:36:00,1,2767.0,2783.0,1.006,13.982,109,85,47,38,24,5,19,0,0.0,0.0
1006,780,24-09-2019 13:38:00,1,2988.0,2956.0,0.989,15.043,43,33,9,24,10,0,10,0,0.0,0.0
1006,781,24-09-2019 13:40:00,1,2987.0,3032.0,1.015,15.124,49,44,23,21,5,1,4,0,0.0,0.0
1006,782,24-09-2019 13:42:00,1,3089.0,3097.0,1.003,15.599,41,40,0,40,1,0,1,0,0.0,0.0
1006,783,24-09-2019 13:44:00,1,3204.0,3142.0,0.981,16.103,129,97,57,40,32,11,21,0,0.0,0.0
1006,784,24-09-2019 13:46:00,1,3537.0,3365.0,0.952,17.66,257,147,110,37,110,71,39,34,0.0,0.03
1006,785,24-09-2019 13:48:00,1,3336.0,3224.0,0.967,16.712,207,156,110,46,51,27,24,30,0.0,0.0
1006,786,24-09-2019 13:50:00,1,3331.0,3209.0,0.963,16.677,76,41,15,26,35,0,35,0,0.0,0.0
1006,787,24-09-2019 13:52:00,1,3328.5,3230.0,0.97,16.691,54,31,12,19,23,0,23,0,0.0,0.0
1006,788,24-09-2019 13:54:00,1,3326.0,3251.0,0.977,16.705,5,0,0,0,5,2,3,0,0.0,0.0
1006,789,24-09-2019 13:56:00,1,3220.0,3152.0,0.979,16.175,10,7,4,3,3,0,3,0,0.0,0.0
1006,790,24-09-2019 13:58:00,1,3109.0,3015.0,0.97,15.589,0,0,0,0,0,0,0,0,0.01,0.0
1006,791,24-09-2019 14:00:00,1,3006.0,2899.0,0.964,15.054,0,0,0,0,0,0,0,0,0.0,0.0
1006,792,24-09-2019 14:02:00,1,2775.0,2781.0,1.002,14.011,18,13,8,5,5,0,5,0,0.0,0.0
1006,793,24-09-2019 14:04:00,1,2784.0,2730.0,0.981,13.99,1,0,0,0,1,0,1,0,0.0,0.0
1006,794,24-09-2019 14:06:00,1,2779.0,2720.0,0.979,13.962,0,0,0,0,0,0,0,0,0.0,0.0
1006,795,24-09-2019 14:08:00,1,2790.0,2717.0,0.974,14.002,2,0,0,0,2,0,2,0,0.0,0.0
1006,796,24-09-2019 14:10:00,1,2776.0,2741.0,0.987,13.972,0,0,0,0,0,0,0,0,0.0,0.0
1006,797,24-09-2019 14:12:00,1,2794.0,2701.0,0.967,13.998,4,2,1,1,2,0,2,0,0.0,0.0
1006,798,24-09-2019 14:14:00,1,2797.0,2658.0,0.95,13.962,16,8,7,1,8,0,8,0,0.0,0.0
1006,799,24-09-2019 14:16:00,1,2817.0,2574.0,0.914,13.949,1,0,0,0,1,0,1,0,0.0,0.0
1006,800,24-09-2019 14:18:00,1,2803.0,2645.0,0.944,13.97,3,0,0,0,3,0,3,0,0.0,0.0
1006,801,24-09-2019 14:20:00,1,2813.0,2630.0,0.935,13.994,2,0,0,0,2,0,2,0,0.0,0.0
1006,802,24-09-2019 14:22:00,1,2807.0,2618.0,0.932,13.958,1,0,0,0,1,0,1,0,0.0,0.0
1006,803,24-09-2019 14:24:00,1,2801.0,2612.0,0.932,13.928,9,2,1,1,7,0,7,0,0.0,0.0
1006,804,24-09-2019 14:26:00,1,2785.0,2673.0,0.9595,13.9325,13,6,1,5,7,0,7,0,0.0,0.0
1006,805,24-09-2019 14:28:00,1,2769.0,2734.0,0.987,13.937,63,41,23,18,22,4,18,0,0.0,0.0
1006,806,24-09-2019 14:30:00,1,2882.0,2867.0,0.995,14.528,29,8,2,6,21,0,21,0,0.0,0.0
1006,807,24-09-2019 14:32:00,1,2998.0,2972.0,0.991,15.101,50,21,8,13,29,6,23,0,0.0,0.0
1006,808,24-09-2019 14:34:00,1,3093.0,3077.0,0.995,15.594,185,112,76,36,73,50,23,20,0.0,0.0
1006,809,24-09-2019 14:36:00,1,3548.0,3411.0,0.961,17.755,256,159,113,46,97,56,41,68,0.0,0.0
1006,810,24-09-2019 14:38:00,1,3299.0,3299.0,1.0,16.649,196,110,89,21,86,48,38,40,0.0,0.0
1006,811,24-09-2019 14:40:00,1,3003.0,2915.0,0.971,15.057,91,75,35,40,16,0,16,0,0.0,0.0
1006,812,24-09-2019 14:42:00,1,3104.0,3073.0,0.99,15.632,26,26,0,26,0,0,0,0,0.01,0.0
1006,813,24-09-2019 14:44:00,1,3323.0,3201.0,0.963,16.638,33,28,7,21,5,0,5,0,0.0,0.0
1006,814,24-09-2019 14:46:00,1,3567.0,3335.0,0.935,17.746,18,4,1,3,14,0,14,0,0.0,0.0
1006,815,24-09-2019 14:48:00,1,3347.0,3142.0,0.939,16.664,0,0,0,0,0,0,0,0,0.0,0.0
1006,816,24-09-2019 14:50:00,1,3127.0,2964.0,0.948,15.603,0,0,0,0,0,0,0,0,0.0,0.0
1006,817,24-09-2019 14:52:00,1,3023.0,2845.0,0.941,15.061,8,4,2,2,4,0,4,0,0.0,0.0
1006,818,24-09-2019 14:54:00,1,2772.0,2743.0,0.989,13.959,10,0,0,0,10,0,10,0,0.0,0.0
1006,819,24-09-2019 14:56:00,1,2792.0,2674.0,0.958,13.962,3,0,0,0,3,0,3,0,0.0,0.0
1006,820,24-09-2019 14:58:00,1,2819.0,2582.0,0.916,13.964,1,0,0,0,1,0,1,0,0.0,0.0
1006,821,24-09-2019 15:00:00,1,2700.0,2525.5,0.9365,13.433,1,0,0,0,1,0,1,0,0.0,0.0
1006,822,24-09-2019 15:02:00,1,2581.0,2469.0,0.957,12.902,10,6,2,4,4,0,4,0,0.0,0.0
1006,823,24-09-2019 15:04:00,1,2699.0,2533.0,0.938,13.438,0,0,0,0,0,0,0,0,0.0,0.0
1006,824,24-09-2019 15:06:00,1,2819.0,2580.0,0.915,13.965,10,7,4,3,3,0,3,0,0.0,0.0
1006,825,24-09-2019 15:08:00,1,2825.0,2582.0,0.914,13.989,0,0,0,0,0,0,0,0,0.0,0.0
1006,826,24-09-2019 15:10:00,1,2822.0,2596.0,0.92,13.993,9,8,2,6,1,0,1,0,0.0,0.0
1006,827,24-09-2019 15:12:00,1,2812.0,2597.0,0.924,13.956,3,3,0,3,0,0,0,0,0.0,0.0
1006,828,24-09-2019 15:14:00,1,2821.0,2572.0,0.912,13.962,10,5,0,5,5,0,5,0,0.0,0.0
1006,829,24-09-2019 15:16:00,1,2834.0,2507.0,0.885,13.943,0,0,0,0,0,0,0,0,0.0,0.0
1006,830,24-09-2019 15:18:00,1,2593.0,2456.0,0.947,12.937,0,0,0,0,0,0,0,0,0.0,0.0
1006,831,24-09-2019 15:20:00,1,2598.0,2391.0,0.92,12.883,52,37,18,19,15,2,13,0,0.0,0.0
1006,832,24-09-2019 15:22:00,1,2702.0,2504.0,0.927,13.418,162,110,85,25,52,24,28,9,0.0,0.0
1006,833,24-09-2019 15:24:00,1,2808.0,2669.0,0.95,14.018,90,61,29,32,29,2,27,0,0.0,0.0
1006,834,24-09-2019 15:26:00,1,3024.0,2836.0,0.938,15.052,91,62,37,25,29,8,21,9,0.0,0.0
1006,835,24-09-2019 15:28:00,1,3375.0,3062.0,0.907,16.686,155,109,66,43,46,2,44,57,0.0,0.0
1006,836,24-09-2019 15:30:00,1,3545.0,3426.0,0.967,17.759,92,57,27,30,35,0,35,58,0.0,0.0
1006,837,24-09-2019 15:32:00,1,3783.0,3505.0,0.927,18.787,101,57,28,29,44,2,42,55,0.0,0.02
1006,838,24-09-2019 15:34:00,1,3730.5,3463.0,0.9285,18.532,221,124,91,33,97,46,51,72,0.0,0.0
1006,839,24-09-2019 15:36:00,1,3678.0,3421.0,0.93,18.277,128,77,36,41,51,1,50,67,0.0,0.0
1006,840,24-09-2019 15:38:00,1,3914.0,3557.0,0.909,19.357,131,72,45,27,59,27,32,20,0.01,0.01
1006,841,24-09-2019 15:40:00,1,2808.0,2637.0,0.939,13.985,203,154,109,45,49,21,28,26,0.01,0.0
1006,842,24-09-2019 15:42:00,1,3133.0,2920.0,0.932,15.577,231,119,80,39,112,65,47,37,0.0,0.0
1006,843,24-09-2019 15:44:00,1,3909.0,3562.0,0.911,19.343,178,112,79,33,66,11,55,62,0.0,0.0
1006,844,24-09-2019 15:46:00,1,3324.0,3188.0,0.959,16.624,34,20,2,18,14,1,13,3,0.0,0.0
1006,845,24-09-2019 15:48:00,1,2612.0,2342.0,0.896,12.884,17,16,3,13,1,0,1,0,0.0,0.0
1006,846,24-09-2019 15:50:00,1,2619.0,2320.0,0.886,12.886,19,19,0,19,0,0,0,0,0.01,0.0
1006,847,24-09-2019 15:52:00,1,2625.0,2318.0,0.883,12.91,8,8,0,8,0,0,0,0,0.0,0.0
1006,848,24-09-2019 15:54:00,1,2633.0,2275.0,0.864,12.894,4,0,0,0,4,0,4,0,0.0,0.0
1006,849,24-09-2019 15:56:00,1,2639.0,2243.0,0.85,12.88,9,0,0,0,9,0,9,0,0.0,0.0
1006,850,24-09-2019 15:58:00,1,2517.0,2247.0,0.893,12.406,4,0,0,0,4,0,4,0,0.0,0.0
1006,851,24-09-2019 16:00:00,1,2630.0,2271.0,0.864,12.875,1,0,0,0,1,0,1,0,0.0,0.0
1006,852,24-09-2019 16:02:00,1,2615.0,2376.0,0.909,12.932,1,0,0,0,1,0,1,0,0.0,0.0
1006,853,24-09-2019 16:04:00,1,2842.0,2503.0,0.881,13.968,4,1,0,1,3,0,3,0,0.0,0.0
1006,854,24-09-2019 16:06:00,1,2834.0,2522.0,0.89,13.957,0,0,0,0,0,0,0,0,0.0,0.0
1006,855,24-09-2019 16:08:00,1,2776.0,2490.5,0.8975,13.695,2,0,0,0,2,0,2,0,0.02,0.01
1006,856,24-09-2019 16:10:00,1,2718.0,2459.0,0.905,13.433,0,0,0,0,0,0,0,0,0.0,0.0
1006,857,24-09-2019 16:12:00,1,2847.0,2494.0,0.876,13.978,1,0,0,0,1,0,1,0,0.0,0.0
1006,858,24-09-2019 16:14:00,1,2840.0,2516.0,0.886,13.974,0,0,0,0,0,0,0,0,0.0,0.0
1006,859,24-09-2019 16:16:00,1,2706.0,2466.0,0.911,13.389,2,2,1,1,0,0,0,0,0.0,0.0
1006,860,24-09-2019 16:18:00,1,2846.0,2485.0,0.873,13.966,25,17,11,6,8,0,8,0,0.0,0.0
1006,861,24-09-2019 16:20:00,1,2801.0,2586.0,0.923,13.898,0,0,0,0,0,0,0,0,0.0,0.0
1006,862,24-09-2019 16:22:00,1,3040.0,2800.0,0.921,15.079,2,2,0,2,0,0,0,0,0.0,0.0
1006,863,24-09-2019 16:24:00,1,3125.0,2949.0,0.944,15.578,2,2,1,1,0,0,0,0,0.0,0.0
1006,864,24-09-2019 16:26:00,1,3372.0,2977.0,0.883,16.581,0,0,0,0,0,0,0,0,0.0,0.0
1006,865,24-09-2019 16:28:00,1,3148.0,2892.0,0.918,15.605,0,0,0,0,0,0,0,0,0.0,0.0
1006,866,24-09-2019 16:30:00,1,3062.0,2734.0,0.893,15.091,2,2,1,1,0,0,0,0,0.0,0.0
1006,867,24-09-2019 16:32:00,1,2926.0,2659.0,0.909,14.471,0,0,0,0,0,0,0,0,0.0,0.0
1006,868,24-09-2019 16:34:00,1,3059.0,2698.0,0.882,15.039,0,0,0,0,0,0,0,0,0.0,0.0
1006,869,24-09-2019 16:36:00,1,3062.0,2728.0,0.891,15.083,6,5,2,3,1,0,1,0,0.0,0.0
1006,870,24-09-2019 16:38:00,1,3059.0,2686.0,0.878,15.025,12,11,0,11,1,0,1,0,0.0,0.0
1006,871,24-09-2019 16:40:00,1,3074.0,2615.0,0.851,15.005,6,6,0,6,0,0,0,0,0.0,0.0
1006,872,24-09-2019 16:42:00,1,2965.5,2549.5,0.86,14.5065,8,8,0,8,0,0,0,0,0.0,0.0
1006,873,24-09-2019 16:44:00,1,2857.0,2484.0,0.869,14.008,0,0,0,0,0,0,0,0,0.0,0.0
1006,874,24-09-2019 16:46:00,1,2857.0,2468.0,0.864,13.988,0,0,0,0,0,0,0,0,0.0,0.0
1006,875,24-09-2019 16:48:00,1,2856.0,2424.0,0.849,13.936,0,0,0,0,0,0,0,0,0.0,0.0
1006,876,24-09-2019 16:50:00,1,2873.0,2384.0,0.83,13.96,0,0,0,0,0,0,0,0,0.0,0.0
1006,877,24-09-2019 16:52:00,1,2748.0,2341.0,0.852,13.42,0,0,0,0,0,0,0,0,0.0,0.0
1006,878,24-09-2019 16:54:00,1,2745.0,2332.0,0.85,13.398,0,0,0,0,0,0,0,0,0.0,0.0
1006,879,24-09-2019 16:56:00,1,2638.0,2306.0,0.874,12.947,0,0,0,0,0,0,0,0,0.0,0.0
1006,880,24-09-2019 16:58:00,1,2640.0,2228.0,0.844,12.871,102,47,27,20,55,21,34,7,0.0,0.0
1006,881,24-09-2019 17:00:00,1,2844.0,2487.0,0.874,13.957,250,186,130,56,64,29,35,47,0.0,0.0
1006,882,24-09-2019 17:02:00,1,3062.0,2668.0,0.871,15.018,235,125,76,49,110,74,36,40,0.0,0.0
1006,883,24-09-2019 17:04:00,1,3165.0,2825.0,0.893,15.597,104,60,33,27,44,4,40,49,0.0,0.25
1006,884,24-09-2019 17:06:00,1,3382.0,3020.0,0.893,16.668,105,64,45,19,41,20,21,3,0.0,0.0
1006,885,24-09-2019 17:08:00,1,3081.0,2639.0,0.857,15.062,25,17,7,10,8,1,7,0,0.0,0.0
1006,886,24-09-2019 17:10:00,1,3140.0,2855.0,0.909,15.531,122,111,75,36,11,0,11,0,0.0,0.0
1006,887,24-09-2019 17:12:00,1,3397.0,2970.0,0.874,16.671,42,35,17,18,7,0,7,0,0.0,0.0
1006,888,24-09-2019 17:14:00,1,3369.0,3057.0,0.907,16.658,41,19,5,14,22,0,22,0,0.0,0.0
1006,889,24-09-2019 17:16:00,1,3431.0,3081.0,0.898,16.9295,102,81,58,23,21,0,21,0,0.0,0.0
1006,890,24-09-2019 17:18:00,1,3493.0,3105.0,0.889,17.201,58,44,28,16,14,3,11,0,0.0,0.0
1006,891,24-09-2019 17:20:00,1,3367.0,3074.0,0.913,16.668,0,0,0,0,0,0,0,0,0.0,0.0
1006,892,24-09-2019 17:22:00,1,3141.0,2892.0,0.921,15.576,2,0,0,0,2,0,2,0,0.0,0.0
1006,893,24-09-2019 17:24:00,1,2930.0,2681.0,0.915,14.511,0,0,0,0,0,0,0,0,0.0,0.0
1006,894,24-09-2019 17:26:00,1,2829.0,2536.0,0.897,13.952,9,6,0,6,3,0,3,0,0.0,0.0
1006,895,24-09-2019 17:28:00,1,2836.0,2502.0,0.882,13.944,2,0,0,0,2,0,2,0,0.0,0.0
1006,896,24-09-2019 17:30:00,1,2834.0,2506.0,0.884,13.942,1,0,0,0,1,0,1,0,0.0,0.0
1006,897,24-09-2019 17:32:00,1,2846.0,2489.0,0.874,13.968,0,0,0,0,0,0,0,0,0.0,0.0
1006,898,24-09-2019 17:34:00,1,2862.0,2433.0,0.85,13.969,0,0,0,0,0,0,0,0,0.0,0.0
1006,899,24-09-2019 17:36:00,1,2866.0,2418.0,0.844,13.968,52,42,30,12,10,2,8,9,0.0,0.0
1006,900,24-09-2019 17:38:00,1,2833.0,2519.0,0.889,13.951,137,89,43,46,48,2,46,69,0.0,0.0
1006,901,24-09-2019 17:40:00,1,3636.0,3048.0,0.838,17.699,126,73,31,42,53,3,50,53,0.0,0.0
1006,902,24-09-2019 17:42:00,1,3594.0,3214.0,0.894,17.719,105,70,35,35,35,4,31,45,0.0,0.0
1006,903,24-09-2019 17:44:00,1,3592.0,3273.0,0.911,17.777,122,79,50,29,43,1,42,62,0.0,0.0
1006,904,24-09-2019 17:46:00,1,3567.0,3296.0,0.924,17.705,123,89,56,33,34,1,33,59,0.0,0.0
1006,905,24-09-2019 17:48:00,1,3612.0,3231.0,0.894,17.81,22,18,8,10,4,2,2,0,0.0,0.0
1006,906,24-09-2019 17:50:00,1,3498.0,3095.5,0.8845,17.2095,321,217,174,43,104,60,44,47,0.0,0.0
1006,907,24-09-2019 17:52:00,1,3384.0,2960.0,0.875,16.609,43,31,11,20,12,4,8,0,0.0,0.0
1006,908,24-09-2019 17:54:00,1,2610.0,2355.0,0.902,12.889,11,11,0,11,0,0,0,0,0.0,0.0
1006,909,24-09-2019 17:56:00,1,2622.0,2315.0,0.883,12.895,7,5,0,5,2,0,2,0,0.0,0.0
1006,910,24-09-2019 17:58:00,1,3047.0,2716.0,0.891,15.013,6,2,0,2,4,0,4,0,0.0,0.0
1006,911,24-09-2019 18:00:00,0,3057.0,2701.0,0.883,15.034,0,0,0,0,0,0,0,0,0.0,0.0
1006,912,24-09-2019 18:02:00,0,3035.0,2779.0,0.916,15.036,11,9,6,3,2,0,2,0,0.0,0.0
1006,913,24-09-2019 18:04:00,0,3149.0,2902.0,0.922,15.619,58,28,16,12,30,8,22,0,0.0,0.0
1006,914,24-09-2019 18:06:00,0,3370.0,3064.0,0.909,16.671,172,106,75,31,66,52,14,18,0.0,0.0
1006,915,24-09-2019 18:08:00,0,3460.0,3250.0,0.939,17.232,40,29,11,18,11,4,7,4,0.0,0.0
1006,916,24-09-2019 18:10:00,0,3356.0,3054.0,0.91,16.603,23,20,11,9,3,1,2,0,0.0,0.0
1006,917,24-09-2019 18:12:00,0,3251.0,3000.0,0.923,16.13,7,6,3,3,1,0,1,0,0.0,0.0
1006,918,24-09-2019 18:14:00,0,3139.0,2941.0,0.937,15.622,1,1,0,1,0,0,0,0,0.0,0.0
1006,919,24-09-2019 18:16:00,0,3242.0,3011.0,0.929,16.107,7,7,0,7,0,0,0,0,0.0,0.0
1006,920,24-09-2019 18:18:00,0,3332.0,3224.0,0.968,16.696,2,2,0,2,0,0,0,0,0.0,0.0
1006,921,24-09-2019 18:20:00,0,3574.0,3337.0,0.934,17.776,14,7,0,7,7,0,7,0,0.0,0.0
1006,922,24-09-2019 18:22:00,0,3425.0,3315.0,0.968,17.166,29,23,0,23,6,0,6,0,0.0,0.0
1006,923,24-09-2019 18:24:00,0,3478.5,3379.0,0.9715,17.4465,26,26,6,20,0,0,0,1,0.0,0.0
1006,924,24-09-2019 18:26:00,0,3532.0,3443.0,0.975,17.727,131,109,69,40,22,10,12,14,0.0,0.0
1006,925,24-09-2019 18:28:00,0,3773.0,3583.0,0.95,18.832,290,180,144,36,110,77,33,43,0.0,0.0
1006,926,24-09-2019 18:30:00,0,3524.0,3458.0,0.981,17.714,29,11,2,9,18,4,14,0,0.0,0.0
1006,927,24-09-2019 18:32:00,0,3537.0,3446.0,0.974,17.751,59,40,21,19,19,0,19,3,0.0,0.0
1006,928,24-09-2019 18:34:00,0,3774.0,3555.0,0.942,18.804,190,130,83,47,60,13,47,65,0.0,0.0
1006,929,24-09-2019 18:36:00,0,4092.0,3920.0,0.958,20.462,309,201,135,66,108,62,46,70,0.0,0.0
1006,930,24-09-2019 18:38:00,0,4090.0,3900.0,0.954,20.431,169,126,79,47,43,4,39,64,0.0,0.0
1006,931,24-09-2019 18:40:00,0,4313.0,4114.0,0.954,21.549,255,166,125,41,89,42,47,64,0.0,0.0
1006,932,24-09-2019 18:42:00,0,3873.0,3651.0,0.943,19.302,87,67,48,19,20,2,18,20,0.0,0.0
1006,933,24-09-2019 18:44:00,0,3883.0,3614.0,0.931,19.3,206,150,103,47,56,3,53,60,0.0,0.0
1006,934,24-09-2019 18:46:00,0,4078.0,3908.0,0.958,20.392,315,167,141,26,148,112,36,11,0.05,0.0
1006,935,24-09-2019 18:48:00,0,3101.0,3022.0,0.975,15.564,28,22,3,19,6,1,5,0,0.01,0.0
1006,936,24-09-2019 18:50:00,0,3027.0,2773.0,0.916,14.997,18,18,0,18,0,0,0,0,0.0,0.0
1006,937,24-09-2019 18:52:00,0,2803.0,2641.0,0.942,13.966,0,0,0,0,0,0,0,0,0.0,0.01
1006,938,24-09-2019 18:54:00,0,2813.0,2631.0,0.935,13.995,0,0,0,0,0,0,0,0,0.0,0.0
1006,939,24-09-2019 18:56:00,0,2801.0,2674.0,0.955,13.995,14,8,5,3,6,1,5,0,0.0,0.0
1006,940,24-09-2019 18:58:00,0,2929.0,2709.5,0.9265,14.539,8,0,0,0,8,0,8,0,0.0,0.0
1006,941,24-09-2019 19:00:00,0,3057.0,2745.0,0.898,15.083,6,2,0,2,4,0,4,0,0.01,0.0
1006,942,24-09-2019 19:02:00,0,3026.0,2813.0,0.93,15.037,0,0,0,0,0,0,0,0,0.0,0.0
1006,943,24-09-2019 19:04:00,0,3001.0,2919.0,0.973,15.054,224,178,130,48,46,8,38,46,0.0,0.0
1006,944,24-09-2019 19:06:00,0,4090.0,3910.0,0.956,20.444,317,264,190,74,53,3,50,71,0.0,0.0
1006,945,24-09-2019 19:08:00,0,4267.0,4266.0,1.0,21.537,299,247,178,69,52,1,51,56,0.0,0.0
1006,946,24-09-2019 19:10:00,0,4496.0,4366.0,0.971,22.547,283,213,160,53,70,24,46,50,0.0,0.02
1006,947,24-09-2019 19:12:00,0,3858.0,3696.0,0.958,19.293,291,195,143,52,96,49,47,40,0.0,0.06
1006,948,24-09-2019 19:14:00,0,4079.0,3965.0,0.972,20.46,200,158,118,40,42,4,38,58,0.0,0.0
1006,949,24-09-2019 19:16:00,0,4280.0,4255.0,0.994,21.573,207,158,110,48,49,8,41,67,0.0,0.05
1006,950,24-09-2019 19:18:00,0,4266.0,4249.0,0.996,21.513,160,130,91,39,30,0,30,45,0.0,0.13
1006,951,24-09-2019 19:20:00,0,4378.0,4335.0,0.99,22.05,216,163,116,47,53,17,36,35,0.06,0.02
1006,952,24-09-2019 19:22:00,0,3774.0,3552.0,0.941,18.8,187,121,87,34,66,42,24,15,0.03,0.03
1006,953,24-09-2019 19:24:00,0,3147.0,2913.0,0.926,15.626,50,26,3,23,24,2,22,0,0.0,0.0
1006,954,24-09-2019 19:26:00,0,3037.0,2775.0,0.914,15.037,59,22,8,14,37,4,33,0,0.0,0.0
1006,955,24-09-2019 19:28:00,0,3029.0,2825.0,0.933,15.06,6,3,0,3,3,0,3,0,0.0,0.0
1006,956,24-09-2019 19:30:00,0,3023.0,2799.0,0.926,15.01,8,3,3,0,5,0,5,0,0.0,0.0
1006,957,24-09-2019 19:32:00,0,2974.0,2742.0,0.922,14.7525,8,2,0,2,6,0,6,0,0.0,0.0
1006,958,24-09-2019 19:34:00,0,2925.0,2685.0,0.918,14.495,2,2,0,2,0,0,0,0,0.0,0.0
1006,959,24-09-2019 19:36:00,0,3049.0,2732.0,0.896,15.037,0,0,0,0,0,0,0,0,0.0,0.0
1006,960,24-09-2019 19:38:00,0,3041.0,2751.0,0.905,15.028,4,4,1,3,0,0,0,0,0.0,0.0
1006,961,24-09-2019 19:40:00,0,3029.0,2827.0,0.933,15.066,6,6,0,6,0,0,0,0,0.0,0.0
1006,962,24-09-2019 19:42:00,0,3020.0,2846.0,0.942,15.051,2,2,0,2,0,0,0,0,0.0,0.0
1006,963,24-09-2019 19:44:00,0,3112.0,3008.0,0.966,15.593,2,1,1,0,1,0,1,0,0.0,0.0
1006,964,24-09-2019 19:46:00,0,3570.0,3302.0,0.925,17.723,5,3,0,3,2,0,2,0,0.0,0.0
1006,965,24-09-2019 19:48:00,0,3508.0,3532.0,1.007,17.73,33,18,9,9,15,8,7,1,0.0,0.0
1006,966,24-09-2019 19:50:00,0,3836.0,3832.0,0.999,19.357,12,6,2,4,6,1,5,0,0.0,0.0
1006,967,24-09-2019 19:52:00,0,3866.0,3771.0,0.975,19.406,6,3,2,1,3,0,3,0,0.0,0.0
1006,968,24-09-2019 19:54:00,0,3352.0,3142.0,0.937,16.685,6,6,0,6,0,0,0,0,0.0,0.0
1006,969,24-09-2019 19:56:00,0,3086.0,3089.0,1.001,15.58,138,101,75,26,37,11,26,29,0.0,0.0
1006,970,24-09-2019 19:58:00,0,4244.0,4334.0,1.021,21.517,155,99,65,34,56,4,52,75,0.0,0.01
1006,971,24-09-2019 20:00:00,0,4548.0,4732.0,1.041,23.157,139,104,64,40,35,2,33,58,0.0,0.07
1006,972,24-09-2019 20:02:00,0,4796.0,4806.0,1.002,24.217,235,155,123,32,80,48,32,41,0.13,0.05
1006,973,24-09-2019 20:04:00,0,4152.0,4189.0,1.009,20.997,223,161,118,43,62,28,34,53,0.01,0.0
1006,974,24-09-2019 20:06:00,0,4414.5,4456.5,1.0095,22.327,123,86,57,29,37,6,31,65,0.0,0.0
1006,975,24-09-2019 20:08:00,0,4677.0,4724.0,1.01,23.657,148,87,60,27,61,34,27,48,0.1,0.02
1006,976,24-09-2019 20:10:00,0,3534.0,3430.0,0.97,17.72,74,49,17,32,25,0,25,0,0.01,0.01
1006,977,24-09-2019 20:12:00,0,3109.0,2990.0,0.962,15.56,21,15,2,13,6,0,6,0,0.0,0.0
1006,978,24-09-2019 20:14:00,0,3574.0,3301.0,0.924,17.737,32,15,0,15,17,0,17,0,0.01,0.0
1006,979,24-09-2019 20:16:00,0,4114.0,3863.0,0.939,20.486,56,27,0,27,29,0,29,0,0.0,0.0
1006,980,24-09-2019 20:18:00,0,4038.0,4099.0,1.015,20.446,30,23,2,21,7,0,7,0,0.0,0.0
1006,981,24-09-2019 20:20:00,0,4093.0,3917.0,0.957,20.462,3,3,1,2,0,0,0,0,0.0,0.0
1006,982,24-09-2019 20:22:00,0,3569.0,3333.0,0.934,17.751,1,1,0,1,0,0,0,0,0.0,0.0
1006,983,24-09-2019 20:24:00,0,3318.0,3235.0,0.975,16.655,170,123,85,38,47,10,37,61,0.0,0.01
1006,984,24-09-2019 20:26:00,0,4770.0,4875.0,1.022,24.19,119,84,54,30,35,7,28,55,0.0,0.05
1006,985,24-09-2019 20:28:00,0,4866.0,5007.0,1.029,24.715,120,89,48,41,31,4,27,47,0.0,0.06
1006,986,24-09-2019 20:30:00,0,4759.0,4966.0,1.044,24.248,148,98,69,29,50,23,27,23,0.02,0.04
1006,987,24-09-2019 20:32:00,0,3739.0,3681.0,0.985,18.806,4,4,1,3,0,0,0,0,0.0,0.01
1006,988,24-09-2019 20:34:00,0,3115.0,3000.0,0.963,15.594,4,3,2,1,1,1,0,0,0.0,0.0
1006,989,24-09-2019 20:36:00,0,3017.0,2834.0,0.939,15.025,7,2,0,2,5,3,2,0,0.0,0.0
1006,990,24-09-2019 20:38:00,0,2784.0,2717.0,0.976,13.977,15,11,6,5,4,3,1,0,0.0,0.01
1006,991,24-09-2019 20:40:00,0,2892.5,2829.0,0.978,14.529,8,5,2,3,3,1,2,0,0.0,0.0
1006,992,24-09-2019 20:42:00,0,3001.0,2941.0,0.98,15.081,6,5,1,4,1,0,1,0,0.0,0.0
1006,993,24-09-2019 20:44:00,0,3350.0,3129.0,0.934,16.663,13,7,2,5,6,3,3,0,0.0,0.0
1006,994,24-09-2019 20:46:00,0,3548.0,3362.0,0.948,17.701,0,0,0,0,0,0,0,0,0.0,0.0
1006,995,24-09-2019 20:48:00,0,3746.0,3609.0,0.963,18.754,97,64,24,40,33,6,27,0,0.0,0.0
1006,996,24-09-2019 20:50:00,0,4229.0,4390.0,1.038,21.521,53,40,18,22,13,1,12,0,0.01,0.0
1006,997,24-09-2019 20:52:00,0,4535.0,4752.0,1.048,23.127,29,22,9,13,7,0,7,0,0.0,0.0
1006,998,24-09-2019 20:54:00,0,4562.0,4700.0,1.03,23.179,229,138,101,37,91,69,22,25,0.0,0.0
1006,999,24-09-2019 20:56:00,0,4547.0,4740.0,1.042,23.163,343,248,191,57,95,67,28,48,0.1,0.0
1006,1000,24-09-2019 20:58:00,0,4569.0,4679.0,1.024,23.181,38,26,14,12,12,5,7,0,0.01,0.0
1006,1001,24-09-2019 21:00:00,0,4255.0,4281.0,1.006,21.504,17,17,0,17,0,0,0,0,0.0,0.01
1006,1002,24-09-2019 21:02:00,0,4032.0,4155.0,1.03,20.487,7,7,0,7,0,0,0,0,0.0,0.0
1006,1003,24-09-2019 21:04:00,0,4040.0,4076.0,1.009,20.429,15,12,4,8,3,2,1,0,0.0,0.0
1006,1004,24-09-2019 21:06:00,0,3814.0,3932.0,1.031,19.381,4,3,2,1,1,0,1,0,0.0,0.0
1006,1005,24-09-2019 21:08:00,0,3836.0,3835.0,1.0,19.361,9,9,0,9,0,0,0,0,0.0,0.0
1006,1006,24-09-2019 21:10:00,0,3857.0,3770.0,0.977,19.371,144,100,68,32,44,9,35,46,0.0,0.0
1006,1007,24-09-2019 21:12:00,0,4045.0,4112.0,1.017,20.487,157,114,72,42,43,3,40,66,0.0,0.02
1006,1008,24-09-2019 21:14:00,0,4322.5,4306.0,0.9975,21.796,116,80,51,29,36,5,31,57,0.0,0.07
1006,1009,24-09-2019 21:16:00,0,4600.0,4500.0,0.978,23.105,106,68,38,30,38,1,37,48,0.0,0.08
1006,1010,24-09-2019 21:18:00,0,4357.0,4463.0,1.024,22.108,204,133,98,35,71,38,33,42,0.06,0.05
1006,1011,24-09-2019 21:20:00,0,3848.0,3759.0,0.977,19.324,318,156,112,44,162,119,43,44,0.01,0.0
1006,1012,24-09-2019 21:22:00,0,3874.0,3733.0,0.964,19.397,259,150,108,42,109,73,36,18,0.06,0.0
1006,1013,24-09-2019 21:24:00,0,4039.0,4133.0,1.023,20.487,156,129,90,39,27,3,24,52,0.02,0.01
1006,1014,24-09-2019 21:26:00,0,4580.0,4595.0,1.003,23.132,28,24,15,9,4,0,4,18,0.0,0.12
1006,1015,24-09-2019 21:28:00,0,4484.0,4474.0,0.998,22.62,188,114,84,30,74,50,24,47,0.08,0.0
1006,1016,24-09-2019 21:30:00,0,4610.0,4520.0,0.98,23.169,160,107,76,31,53,34,19,26,0.0,0.04
1006,1017,24-09-2019 21:32:00,0,3296.0,3302.0,1.002,16.643,55,42,9,33,13,5,8,0,0.0,0.0
1006,1018,24-09-2019 21:34:00,0,3338.0,3180.0,0.952,16.674,18,5,0,5,13,3,10,0,0.01,0.0
1006,1019,24-09-2019 21:36:00,0,3546.0,3380.0,0.953,17.714,99,73,42,31,26,9,17,7,0.0,0.0
1006,1020,24-09-2019 21:38:00,0,4619.0,4463.0,0.966,23.14,113,65,48,17,48,36,12,7,0.02,0.0
1006,1021,24-09-2019 21:40:00,0,3898.0,3624.0,0.93,19.372,1,1,0,1,0,0,0,0,0.0,0.0
1006,1022,24-09-2019 21:42:00,0,3635.0,3485.0,0.959,18.181,0,0,0,0,0,0,0,0,0.0,0.0
1006,1023,24-09-2019 21:44:00,0,3877.0,3725.0,0.961,19.399,0,0,0,0,0,0,0,0,0.01,0.0
1006,1024,24-09-2019 21:46:00,0,3843.0,3824.0,0.995,19.376,3,3,2,1,0,0,0,0,0.0,0.0
1006,1025,24-09-2019 21:48:00,0,4008.0,3990.5,0.9955,20.2095,64,42,33,9,22,11,11,8,0.0,0.0
1006,1026,24-09-2019 21:50:00,0,4173.0,4157.0,0.996,21.043,40,38,19,19,2,1,1,20,0.0,0.03
1006,1027,24-09-2019 21:52:00,0,4763.0,4902.0,1.029,24.194,48,31,11,20,17,2,15,22,0.0,0.35
1006,1028,24-09-2019 21:54:00,0,4536.0,4679.0,1.031,23.05,7,0,0,0,7,0,7,0,0.0,0.01
1006,1029,24-09-2019 21:56:00,0,4613.0,4528.0,0.982,23.187,182,66,47,19,116,76,40,25,0.09,0.0
1006,1030,24-09-2019 21:58:00,0,4146.0,4172.0,1.006,20.952,160,96,65,31,64,48,16,23,0.0,0.0
1006,1031,24-09-2019 22:00:00,0,3858.0,3731.0,0.967,19.331,216,135,106,29,81,58,23,9,0.06,0.0
1006,1032,24-09-2019 22:02:00,0,4037.0,4056.0,1.005,20.394,94,72,52,20,22,11,11,6,0.01,0.0
1006,1033,24-09-2019 22:04:00,0,4239.0,4369.0,1.031,21.537,73,51,37,14,22,11,11,5,0.06,0.0
1006,1034,24-09-2019 22:06:00,0,4251.0,4294.0,1.01,21.503,43,14,5,9,29,10,19,1,0.0,0.0
1006,1035,24-09-2019 22:08:00,0,3852.0,3792.0,0.984,19.373,68,42,24,18,26,14,12,29,0.0,0.0
1006,1036,24-09-2019 22:10:00,0,4482.0,4441.0,0.991,22.577,16,9,2,7,7,3,4,0,0.0,0.0
1006,1037,24-09-2019 22:12:00,0,4784.0,4836.0,1.011,24.202,132,76,47,29,56,31,25,6,0.01,0.0
1006,1038,24-09-2019 22:14:00,0,4464.0,4510.0,1.01,22.58,278,134,101,33,144,105,39,39,0.0,0.0
1006,1039,24-09-2019 22:16:00,0,4358.0,4430.0,1.017,22.074,422,254,204,50,168,133,35,100,0.04,0.0
1006,1040,24-09-2019 22:18:00,0,4662.0,4725.0,1.014,23.598,115,78,49,29,37,15,22,20,0.0,0.0
1006,1041,24-09-2019 22:20:00,0,4276.0,4228.0,0.989,21.528,64,31,23,8,33,10,23,1,0.0,0.0
1006,1042,24-09-2019 22:22:00,0,4424.5,4411.0,0.997,22.316,40,29,6,23,11,1,10,1,0.0,0.0
1006,1043,24-09-2019 22:24:00,0,4573.0,4594.0,1.005,23.104,34,34,0,34,0,0,0,0,0.0,0.0
1006,1044,24-09-2019 22:26:00,0,4582.0,4606.0,1.005,23.152,39,26,4,22,13,4,9,0,0.0,0.0
1006,1045,24-09-2019 22:28:00,0,4583.0,4580.0,0.999,23.127,50,33,23,10,17,8,9,0,0.0,0.0
1006,1046,24-09-2019 22:30:00,0,4356.0,4448.0,1.021,22.087,1,1,0,1,0,0,0,0,0.0,0.0
1006,1047,24-09-2019 22:32:00,0,4255.0,4297.0,1.01,21.52,10,6,4,2,4,1,3,0,0.0,0.0
1006,1048,24-09-2019 22:34:00,0,4031.0,4121.0,1.022,20.445,3,2,0,2,1,0,1,0,0.0,0.0
1006,1049,24-09-2019 22:36:00,0,4071.0,3959.0,0.973,20.421,6,3,0,3,3,1,2,0,0.0,0.0
1006,1050,24-09-2019 22:38:00,0,3836.0,3842.0,1.002,19.364,3,2,1,1,1,0,1,0,0.0,0.0
1006,1051,24-09-2019 22:40:00,0,3870.0,3747.0,0.968,19.396,2,1,0,1,1,0,1,0,0.0,0.0
1006,1052,24-09-2019 22:42:00,0,3743.0,3672.0,0.981,18.811,0,0,0,0,0,0,0,0,0.0,0.0
1006,1053,24-09-2019 22:44:00,0,3628.0,3599.0,0.992,18.277,86,62,38,24,24,7,17,3,0.0,0.0
1006,1054,24-09-2019 22:46:00,0,3879.0,3687.0,0.95,19.366,139,86,43,43,53,16,37,14,0.0,0.0
1006,1055,24-09-2019 22:48:00,0,3958.0,3902.0,0.986,19.914,103,62,25,37,41,11,30,25,0.0,0.0
1006,1056,24-09-2019 22:50:00,0,4058.0,4024.0,0.992,20.441,313,166,128,38,147,92,55,42,0.0,0.53
1006,1057,24-09-2019 22:52:00,0,3834.0,3851.0,1.005,19.369,275,179,127,52,96,69,27,35,0.13,0.0
1006,1058,24-09-2019 22:54:00,0,4069.0,3988.0,0.98,20.448,161,112,66,46,49,5,44,74,0.01,0.0
1006,1059,24-09-2019 22:56:00,0,4154.0,4186.0,1.007,21.0005,147,106,60,46,41,0,41,59,0.0,0.0
1006,1060,24-09-2019 22:58:00,0,4239.0,4384.0,1.034,21.553,118,78,46,32,40,0,40,67,0.0,0.0
1006,1061,24-09-2019 23:00:00,0,4600.0,4542.0,0.987,23.153,215,144,108,36,71,35,36,65,0.07,0.0
1006,1062,24-09-2019 23:02:00,0,4465.0,4505.0,1.009,22.58,316,171,124,47,145,108,37,22,0.0,0.0
1006,1063,24-09-2019 23:04:00,0,4043.0,4054.0,1.003,20.419,233,151,110,41,82,53,29,76,0.0,0.0
1006,1064,24-09-2019 23:06:00,0,4042.0,4133.0,1.023,20.499,247,154,118,36,93,61,32,44,0.1,0.0
1006,1065,24-09-2019 23:08:00,0,3531.0,3420.0,0.968,17.7,213,129,88,41,84,41,43,61,0.02,0.0
1006,1066,24-09-2019 23:10:00,0,4798.0,4797.0,1.0,24.214,159,122,88,34,37,2,35,76,0.0,0.0
1006,1067,24-09-2019 23:12:00,0,4797.0,4854.0,1.012,24.273,156,98,69,29,58,34,24,17,0.0,0.0
1006,1068,24-09-2019 23:14:00,0,3530.0,3377.0,0.957,17.649,67,34,12,22,33,8,25,1,0.0,0.0
1006,1069,24-09-2019 23:16:00,0,3338.0,3165.0,0.948,16.655,32,19,15,4,13,4,9,0,0.0,0.0
1006,1070,24-09-2019 23:18:00,0,3135.0,2909.0,0.928,15.574,0,0,0,0,0,0,0,0,0.0,0.0
1006,1071,24-09-2019 23:20:00,0,3128.0,2893.0,0.925,15.527,3,3,1,2,0,0,0,0,0.0,0.0
1006,1072,24-09-2019 23:22:00,0,3141.0,2918.0,0.929,15.607,6,6,0,6,0,0,0,0,0.0,0.0
1006,1073,24-09-2019 23:24:00,0,3114.0,2987.0,0.959,15.574,83,78,68,10,5,3,2,0,0.0,0.0
1006,1074,24-09-2019 23:26:00,0,3333.0,3233.0,0.97,16.713,18,5,1,4,13,3,10,0,0.0,0.0
1006,1075,24-09-2019 23:28:00,0,3574.0,3303.0,0.924,17.739,4,1,0,1,3,0,3,0,0.0,0.0
1006,1076,24-09-2019 23:30:00,0,3544.5,3395.5,0.958,17.725,7,3,0,3,4,0,4,0,0.0,0.0
1006,1077,24-09-2019 23:32:00,0,3515.0,3488.0,0.992,17.711,8,4,0,4,4,0,4,0,0.0,0.0
1006,1078,24-09-2019 23:34:00,0,3765.0,3609.0,0.959,18.828,10,7,1,6,3,0,3,0,0.0,0.0
1006,1079,24-09-2019 23:36:00,0,3866.0,3702.0,0.958,19.33,0,0,0,0,0,0,0,0,0.0,0.0
1006,1080,24-09-2019 23:38:00,0,3855.0,3757.0,0.975,19.347,6,1,1,0,5,0,5,0,0.0,0.0
1006,1081,24-09-2019 23:40:00,0,3928.0,3953.0,1.006,19.853,39,31,13,18,8,4,4,0,0.0,0.0
1006,1082,24-09-2019 23:42:00,0,3986.0,4269.0,1.071,20.43,68,49,27,22,19,6,13,12,0.0,0.0
1006,1083,24-09-2019 23:44:00,0,4209.0,4465.0,1.061,21.526,331,168,131,37,163,124,39,60,0.0,0.0
1006,1084,24-09-2019 23:46:00,0,4211.0,4431.0,1.052,21.498,269,153,117,36,116,87,29,43,0.0,0.0
1006,1085,24-09-2019 23:48:00,0,4325.0,4538.0,1.049,22.065,103,66,38,28,37,0,37,44,0.0,0.07
1006,1086,24-09-2019 23:50:00,0,4795.0,4815.0,1.004,24.223,163,116,77,39,47,0,47,77,0.0,0.0
1006,1087,24-09-2019 23:52:00,0,4745.0,4976.0,1.049,24.203,153,104,68,36,49,9,40,69,0.05,0.0
1006,1088,24-09-2019 23:54:00,0,4558.0,4706.0,1.032,23.169,194,134,94,40,60,29,31,27,0.1,0.0
1006,1089,24-09-2019 23:56:00,0,4794.0,4802.0,1.002,24.204,317,198,144,54,119,65,54,70,0.01,0.0
1006,1090,24-09-2019 23:58:00,0,4800.0,4794.0,0.999,24.22,261,155,115,40,106,74,32,51,0.0,0.0
1006,1091,25-09-2019 00:00:00,0,4027.0,4135.0,1.027,20.444,236,157,122,35,79,55,24,37,0.0,0.0
1006,1092,25-09-2019 00:02:00,0,4234.0,4358.0,1.029,21.507,156,114,69,45,42,2,40,81,0.0,0.0
1006,1093,25-09-2019 00:04:00,0,4671.0,4753.0,1.0185,23.665,112,77,43,34,35,0,35,64,0.0,0.0
1006,1094,25-09-2019 00:06:00,0,5108.0,5148.0,1.008,25.823,94,65,41,24,29,0,29,77,0.0,0.0
1006,1095,25-09-2019 00:08:00,0,4756.0,4986.0,1.048,24.26,253,117,93,24,136,99,37,11,0.07,0.0
1006,1096,25-09-2019 00:10:00,0,3524.0,3500.0,0.993,17.76,82,64,21,43,18,11,7,2,0.0,0.0
1006,1097,25-09-2019 00:12:00,0,3447.0,3287.0,0.954,17.22,38,21,6,15,17,6,11,0,0.0,0.0
1006,1098,25-09-2019 00:14:00,0,3654.0,3497.0,0.957,18.269,187,86,59,27,101,65,36,32,0.01,0.0
1006,1099,25-09-2019 00:16:00,0,4771.0,4828.0,1.012,24.144,246,140,99,41,106,73,33,72,0.08,0.0
1006,1100,25-09-2019 00:18:00,0,4766.0,4912.0,1.031,24.215,200,121,84,37,79,47,32,52,0.0,0.0
1006,1101,25-09-2019 00:20:00,0,5205.0,5273.0,1.013,26.344,92,70,43,27,22,0,22,50,0.0,0.0
1006,1102,25-09-2019 00:22:00,0,5206.0,5291.0,1.016,26.367,46,31,17,14,15,1,14,31,0.0,0.07
1006,1103,25-09-2019 00:24:00,0,4772.0,4932.0,1.033,24.262,194,132,112,20,62,39,23,10,0.05,0.0
1006,1104,25-09-2019 00:26:00,0,3887.0,3629.0,0.934,19.334,208,163,123,40,45,16,29,5,0.0,0.0
1006,1105,25-09-2019 00:28:00,0,4686.0,4693.0,1.002,23.657,385,194,147,47,191,127,64,20,0.0,0.0
1006,1106,25-09-2019 00:30:00,0,3960.0,3883.0,0.981,19.901,78,42,23,19,36,21,15,3,0.01,0.01
1006,1107,25-09-2019 00:32:00,0,4072.0,3939.0,0.967,20.405,197,120,83,37,77,61,16,55,0.0,0.0
1006,1108,25-09-2019 00:34:00,0,4688.0,4703.0,1.003,23.675,244,113,77,36,131,103,28,10,0.0,0.0
1006,1109,25-09-2019 00:36:00,0,3982.0,3832.0,0.962,19.93,158,80,53,27,78,40,38,5,0.0,0.0
1006,1110,25-09-2019 00:38:00,0,4369.5,4380.0,0.999,22.0645,278,171,136,35,107,79,28,80,0.0,0.01
1006,1111,25-09-2019 00:40:00,0,4757.0,4928.0,1.036,24.199,243,108,73,35,135,93,42,3,0.08,0.01
1006,1112,25-09-2019 00:42:00,0,4245.0,4330.0,1.02,21.52,49,24,4,20,25,4,21,0,0.0,0.0
1006,1113,25-09-2019 00:44:00,0,4575.0,4585.0,1.002,23.102,28,7,0,7,21,2,19,0,0.0,0.0
1006,1114,25-09-2019 00:46:00,0,4586.0,4627.0,1.009,23.192,18,11,4,7,7,0,7,0,0.0,0.0
1006,1115,25-09-2019 00:48:00,0,4787.0,4758.0,0.994,24.126,35,30,6,24,5,2,3,0,0.0,0.0
1006,1116,25-09-2019 00:50:00,0,4563.0,4619.0,1.012,23.09,30,21,13,8,9,3,6,0,0.0,0.0
1006,1117,25-09-2019 00:52:00,0,4357.0,4449.0,1.021,22.09,6,5,2,3,1,1,0,0,0.0,0.0
1006,1118,25-09-2019 00:54:00,0,4244.0,4259.0,1.004,21.434,10,9,0,9,1,0,1,0,0.0,0.0
1006,1119,25-09-2019 00:56:00,0,4026.0,4102.0,1.019,20.405,11,11,0,11,0,0,0,0,0.0,0.0
1006,1120,25-09-2019 00:58:00,0,4071.0,3971.0,0.975,20.438,7,6,0,6,1,0,1,0,0.0,0.0
1006,1121,25-09-2019 01:00:00,0,3847.0,3792.0,0.986,19.354,1,1,0,1,0,0,0,0,0.0,0.0
1006,1122,25-09-2019 01:02:00,0,3733.0,3670.0,0.983,18.771,2,2,1,1,0,0,0,0,0.0,0.0
1006,1123,25-09-2019 01:04:00,0,3526.0,3493.0,0.991,17.761,30,20,7,13,10,6,4,0,0.0,0.0
1006,1124,25-09-2019 01:06:00,0,3410.0,3380.0,0.991,17.178,0,0,0,0,0,0,0,0,0.0,0.0
1006,1125,25-09-2019 01:08:00,0,3409.0,3394.0,0.996,17.188,0,0,0,0,0,0,0,0,0.0,0.0
1006,1126,25-09-2019 01:10:00,0,3311.0,3331.0,1.006,16.734,0,0,0,0,0,0,0,0,0.0,0.0
1006,1127,25-09-2019 01:12:00,0,3319.5,3262.5,0.983,16.691,0,0,0,0,0,0,0,0,0.0,0.0
1006,1128,25-09-2019 01:14:00,0,3328.0,3194.0,0.96,16.648,0,0,0,0,0,0,0,0,0.0,0.0
1006,1129,25-09-2019 01:16:00,0,3094.0,3119.0,1.008,15.642,2,2,1,1,0,0,0,0,0.0,0.0
1006,1130,25-09-2019 01:18:00,0,3086.0,3090.0,1.001,15.579,1,1,1,0,0,0,0,0,0.0,0.0
1006,1131,25-09-2019 01:20:00,0,3108.0,3046.0,0.98,15.618,0,0,0,0,0,0,0,0,0.0,0.0
1006,1132,25-09-2019 01:22:00,0,3111.0,3060.0,0.984,15.645,3,2,0,2,1,1,0,0,0.0,0.0
1006,1133,25-09-2019 01:24:00,0,3098.0,3064.0,0.989,15.598,0,0,0,0,0,0,0,0,0.0,0.0
1006,1134,25-09-2019 01:26:00,0,2978.0,3021.0,1.014,15.076,26,8,3,5,18,3,15,0,0.0,0.0
1006,1135,25-09-2019 01:28:00,0,2974.0,3021.0,1.016,15.063,4,2,1,1,2,1,1,0,0.0,0.0
1006,1136,25-09-2019 01:30:00,0,2983.0,2959.0,0.992,15.029,4,4,0,4,0,0,0,0,0.0,0.0
1006,1137,25-09-2019 01:32:00,0,2987.0,2982.0,0.998,15.07,5,3,0,3,2,0,2,0,0.0,0.0
1006,1138,25-09-2019 01:34:00,0,2978.0,3025.0,1.016,15.083,8,7,1,6,1,0,1,0,0.0,0.0
1006,1139,25-09-2019 01:36:00,0,2957.0,3076.0,1.04,15.057,5,5,2,3,0,0,0,0,0.0,0.0
1006,1140,25-09-2019 01:38:00,0,3089.0,3073.0,0.995,15.572,100,66,39,27,34,12,22,5,0.0,0.0
1006,1141,25-09-2019 01:40:00,0,3546.0,3451.0,0.973,17.794,467,242,186,56,225,177,48,76,0.0,0.0
1006,1142,25-09-2019 01:42:00,0,3524.0,3480.0,0.987,17.737,233,136,95,41,97,53,44,94,0.01,0.0
1006,1143,25-09-2019 01:44:00,0,4060.0,3939.0,0.97,20.357,146,100,66,34,46,0,46,73,0.0,0.0
1006,1144,25-09-2019 01:46:00,0,4216.0,4154.5,0.985,21.211,89,49,25,24,40,0,40,69,0.0,0.04
1006,1145,25-09-2019 01:48:00,0,4372.0,4370.0,1.0,22.065,92,63,37,26,29,2,27,41,0.0,0.06
1006,1146,25-09-2019 01:50:00,0,4346.0,4431.0,1.02,22.029,99,67,35,32,32,0,32,60,0.0,0.04
1006,1147,25-09-2019 01:52:00,0,4255.0,4374.0,1.028,21.606,196,118,92,26,78,35,43,67,0.0,0.03
1006,1148,25-09-2019 01:54:00,0,4059.0,4024.0,0.991,20.449,155,132,85,47,23,6,17,0,0.0,0.03
1006,1149,25-09-2019 01:56:00,0,3520.0,3519.0,1.0,17.764,296,170,128,42,126,90,36,23,0.0,0.0
1006,1150,25-09-2019 01:58:00,0,4068.0,4005.0,0.984,20.463,242,107,77,30,135,99,36,31,0.0,0.0
1006,1151,25-09-2019 02:00:00,0,3541.0,3410.0,0.963,17.728,248,92,67,25,156,113,43,22,0.07,0.0
1006,1152,25-09-2019 02:02:00,0,4213.0,4379.0,1.039,21.447,134,86,46,40,48,5,43,60,0.02,0.0
1006,1153,25-09-2019 02:04:00,0,4810.0,4773.0,0.992,24.236,90,57,30,27,33,0,33,50,0.0,0.03
1006,1154,25-09-2019 02:06:00,0,4683.0,4676.0,0.999,23.625,81,56,32,24,25,0,25,17,0.0,0.26
1006,1155,25-09-2019 02:08:00,0,4227.0,4412.0,1.044,21.54,0,0,0,0,0,0,0,0,0.0,0.0
1006,1156,25-09-2019 02:10:00,0,4260.0,4313.0,1.012,21.559,16,16,4,12,0,0,0,0,0.0,0.01
1006,1157,25-09-2019 02:12:00,0,4594.0,4453.0,0.969,23.032,135,83,58,25,52,38,14,17,0.09,0.0
1006,1158,25-09-2019 02:14:00,0,3525.0,3487.0,0.989,17.75,43,37,15,22,6,4,2,0,0.0,0.0
1006,1159,25-09-2019 02:16:00,0,3521.0,3524.0,1.001,17.772,157,93,70,23,64,36,28,11,0.08,0.0
1006,1160,25-09-2019 02:18:00,0,4286.0,4202.0,0.98,21.537,287,151,111,40,136,99,37,6,0.01,0.0
1006,1161,25-09-2019 02:20:00,0,4271.5,4264.0,0.998,21.5485,196,121,75,46,75,49,26,6,0.01,0.0
1006,1162,25-09-2019 02:22:00,0,4257.0,4326.0,1.016,21.56,73,59,29,30,14,7,7,33,0.0,0.0
1006,1163,25-09-2019 02:24:00,0,4994.0,5001.0,1.001,25.212,234,176,144,32,58,36,22,19,0.12,0.0
1006,1164,25-09-2019 02:26:00,0,4598.0,4525.0,0.984,23.127,67,46,27,19,21,5,16,0,0.02,0.01
1006,1165,25-09-2019 02:28:00,0,3869.0,3726.0,0.963,19.367,79,63,13,50,16,0,16,0,0.0,0.0
1006,1166,25-09-2019 02:30:00,0,4074.0,3930.0,0.965,20.403,57,42,19,23,15,1,14,0,0.0,0.0
1006,1167,25-09-2019 02:32:00,0,4298.0,4163.0,0.969,21.541,2,2,1,1,0,0,0,0,0.0,0.0
1006,1168,25-09-2019 02:34:00,0,4286.0,4228.0,0.986,21.568,0,0,0,0,0,0,0,0,0.0,0.0
1006,1169,25-09-2019 02:36:00,0,4156.0,4108.0,0.989,20.921,0,0,0,0,0,0,0,0,0.0,0.0
1006,1170,25-09-2019 02:38:00,0,4038.0,4124.0,1.021,20.474,6,6,3,3,0,0,0,0,0.0,0.0
1006,1171,25-09-2019 02:40:00,0,4050.0,4014.0,0.991,20.399,0,0,0,0,0,0,0,0,0.0,0.0
1006,1172,25-09-2019 02:42:00,0,4050.0,3963.0,0.978,20.343,0,0,0,0,0,0,0,0,0.0,0.0
1006,1173,25-09-2019 02:44:00,0,3955.0,3922.0,0.992,19.925,10,8,4,4,2,1,1,0,0.0,0.0
1006,1174,25-09-2019 02:46:00,0,3821.0,3897.0,1.02,19.37,2,2,1,1,0,0,0,0,0.0,0.0
1006,1175,25-09-2019 02:48:00,0,3823.0,3860.0,1.01,19.335,13,10,0,10,3,0,3,0,0.0,0.0
1006,1176,25-09-2019 02:50:00,0,3877.0,3746.0,0.966,19.424,3,1,0,1,2,0,2,0,0.0,0.0
1006,1177,25-09-2019 02:52:00,0,3608.0,3649.0,1.011,18.256,10,1,0,1,9,0,9,0,0.0,0.0
1006,1178,25-09-2019 02:54:00,0,3552.0,3625.5,1.0205,18.0085,55,33,15,18,22,2,20,0,0.0,0.0
1006,1179,25-09-2019 02:56:00,0,3496.0,3602.0,1.03,17.761,0,0,0,0,0,0,0,0,0.0,0.0
1006,1180,25-09-2019 02:58:00,0,3523.0,3486.0,0.989,17.739,6,0,0,0,6,0,6,0,0.0,0.0
1006,1181,25-09-2019 03:00:00,0,3423.0,3398.0,0.993,17.248,0,0,0,0,0,0,0,0,0.0,0.0
1006,1182,25-09-2019 03:02:00,0,3313.0,3279.0,0.99,16.682,0,0,0,0,0,0,0,0,0.0,0.0
1006,1183,25-09-2019 03:04:00,0,3328.0,3253.0,0.978,16.714,0,0,0,0,0,0,0,0,0.0,0.0
1006,1184,25-09-2019 03:06:00,0,3200.0,3165.0,0.989,16.111,0,0,0,0,0,0,0,0,0.0,0.0
1006,1185,25-09-2019 03:08:00,0,3090.0,3074.0,0.995,15.578,0,0,0,0,0,0,0,0,0.0,0.0
1006,1186,25-09-2019 03:10:00,0,3093.0,3076.0,0.994,15.593,14,8,5,3,6,2,4,0,0.0,0.0
1006,1187,25-09-2019 03:12:00,0,2968.0,3048.0,1.027,15.069,0,0,0,0,0,0,0,0,0.0,0.0
1006,1188,25-09-2019 03:14:00,0,2975.0,2970.0,0.998,15.008,0,0,0,0,0,0,0,0,0.0,0.0
1006,1189,25-09-2019 03:16:00,0,2999.0,2941.0,0.981,15.073,0,0,0,0,0,0,0,0,0.0,0.0
1006,1190,25-09-2019 03:18:00,0,3004.0,2919.0,0.972,15.066,0,0,0,0,0,0,0,0,0.0,0.0
1006,1191,25-09-2019 03:20:00,0,2872.0,2873.0,1.0,14.497,0,0,0,0,0,0,0,0,0.0,0.0
1006,1192,25-09-2019 03:22:00,0,2883.0,2892.0,1.003,14.561,2,0,0,0,2,0,2,0,0.0,0.0
1006,1193,25-09-2019 03:24:00,0,2754.0,2851.0,1.035,14.007,17,13,9,4,4,1,3,0,0.0,0.0
1006,1194,25-09-2019 03:26:00,0,2983.0,2987.0,1.001,15.06,289,196,152,44,93,69,24,43,0.0,0.0
1006,1195,25-09-2019 03:28:00,0,3256.5,3227.5,0.9915,16.404,257,185,146,39,72,46,26,54,0.0,0.02
1006,1196,25-09-2019 03:30:00,0,3530.0,3468.0,0.982,17.748,152,106,78,28,46,11,35,47,0.01,0.0
1006,1197,25-09-2019 03:32:00,0,3728.0,3729.0,1.0,18.818,42,32,19,13,10,1,9,13,0.0,0.0
1006,1198,25-09-2019 03:34:00,0,3491.0,3644.0,1.044,17.787,38,27,7,20,11,1,10,0,0.0,0.0
1006,1199,25-09-2019 03:36:00,0,3532.0,3444.0,0.975,17.728,288,179,137,42,109,66,43,29,0.0,0.0
1006,1200,25-09-2019 03:38:00,0,3846.0,3764.0,0.979,19.321,147,109,68,41,38,8,30,61,0.0,0.05
1006,1201,25-09-2019 03:40:00,0,4041.0,4049.0,1.002,20.401,147,101,64,37,46,2,44,72,0.0,0.0
1006,1202,25-09-2019 03:42:00,0,4137.0,4230.0,1.022,20.983,135,95,59,36,40,2,38,62,0.0,0.0
1006,1203,25-09-2019 03:44:00,0,4233.0,4355.0,1.029,21.498,141,103,61,42,38,5,33,54,0.0,0.04
1006,1204,25-09-2019 03:46:00,0,4470.0,4515.0,1.01,22.611,162,113,75,38,49,18,31,43,0.09,0.04
1006,1205,25-09-2019 03:48:00,0,3936.0,3945.0,1.002,19.874,305,151,107,44,154,105,49,41,0.0,0.0
1006,1206,25-09-2019 03:50:00,0,4247.0,4356.0,1.026,21.554,127,73,50,23,54,22,32,34,0.01,0.02
1006,1207,25-09-2019 03:52:00,0,4017.0,4172.0,1.038,20.447,308,155,119,36,153,107,46,92,0.0,0.0
1006,1208,25-09-2019 03:54:00,0,3933.0,3910.0,0.994,19.826,57,38,11,27,19,7,12,1,0.0,0.04
1006,1209,25-09-2019 03:56:00,0,3528.0,3530.0,1.001,17.809,9,3,0,3,6,1,5,0,0.0,0.0
1006,1210,25-09-2019 03:58:00,0,3881.0,3672.0,0.946,19.357,31,26,1,25,5,1,4,0,0.0,0.0
1006,1211,25-09-2019 04:00:00,0,4059.0,3981.0,0.981,20.4,33,27,8,19,6,3,3,0,0.02,0.0
1006,1212,25-09-2019 04:02:00,0,3690.0,3601.0,0.9755,18.525,18,15,3,12,3,0,3,0,0.0,0.0
1006,1213,25-09-2019 04:04:00,0,3321.0,3221.0,0.97,16.65,0,0,0,0,0,0,0,0,0.0,0.0
1006,1214,25-09-2019 04:06:00,0,3358.0,3105.0,0.925,16.666,0,0,0,0,0,0,0,0,0.0,0.0
1006,1215,25-09-2019 04:08:00,0,3346.0,3155.0,0.943,16.677,0,0,0,0,0,0,0,0,0.0,0.0
1006,1216,25-09-2019 04:10:00,0,3314.0,3288.0,0.992,16.697,25,24,13,11,1,1,0,0,0.0,0.0
1006,1217,25-09-2019 04:12:00,0,3527.0,3495.0,0.991,17.765,0,0,0,0,0,0,0,0,0.0,0.0
1006,1218,25-09-2019 04:14:00,0,3516.0,3567.0,1.014,17.803,3,3,0,3,0,0,0,0,0.0,0.0
1006,1219,25-09-2019 04:16:00,0,3744.0,3667.0,0.979,18.811,0,0,0,0,0,0,0,0,0.0,0.0
1006,1220,25-09-2019 04:18:00,0,3852.0,3780.0,0.981,19.36,6,0,0,0,6,0,6,0,0.0,0.0
1006,1221,25-09-2019 04:20:00,0,3724.0,3741.0,1.005,18.813,2,0,0,0,2,0,2,0,0.0,0.0
1006,1222,25-09-2019 04:22:00,0,3487.0,3644.0,1.045,17.772,1,0,0,0,1,0,1,0,0.0,0.0
1006,1223,25-09-2019 04:24:00,0,3523.0,3506.0,0.995,17.76,2,1,1,0,1,0,1,0,0.0,0.0
1006,1224,25-09-2019 04:26:00,0,3404.0,3427.0,1.007,17.205,0,0,0,0,0,0,0,0,0.0,0.0
1006,1225,25-09-2019 04:28:00,0,3291.0,3335.0,1.013,16.66,0,0,0,0,0,0,0,0,0.0,0.0
1006,1226,25-09-2019 04:30:00,0,3186.0,3242.0,1.018,16.142,19,10,3,7,9,2,7,0,0.0,0.0
1006,1227,25-09-2019 04:32:00,0,3193.0,3211.0,1.006,16.134,61,22,2,20,39,13,26,0,0.0,0.0
1006,1228,25-09-2019 04:34:00,0,3298.0,3304.0,1.002,16.653,331,205,154,51,126,93,33,22,0.0,0.0
1006,1229,25-09-2019 04:36:00,0,3298.5,3324.5,1.008,16.6765,21,5,0,5,16,2,14,0,0.0,0.0
1006,1230,25-09-2019 04:38:00,0,3299.0,3345.0,1.014,16.7,93,60,42,18,33,7,26,16,0.0,0.0
1006,1231,25-09-2019 04:40:00,0,3612.0,3644.0,1.009,18.266,130,100,68,32,30,0,30,57,0.0,0.0
1006,1232,25-09-2019 04:42:00,0,4056.0,4019.0,0.991,20.429,87,50,22,28,37,0,37,61,0.0,0.01
1006,1233,25-09-2019 04:44:00,0,4138.0,4203.0,1.016,20.956,122,80,46,34,42,2,40,66,0.0,0.08
1006,1234,25-09-2019 04:46:00,0,4015.0,4125.0,1.028,20.383,132,101,70,31,31,14,17,39,0.0,0.03
1006,1235,25-09-2019 04:48:00,0,3113.0,3008.0,0.966,15.596,0,0,0,0,0,0,0,0,0.0,0.0
1006,1236,25-09-2019 04:50:00,0,2890.0,2825.0,0.977,14.515,0,0,0,0,0,0,0,0,0.0,0.0
1006,1237,25-09-2019 04:52:00,0,3028.0,2839.0,0.937,15.074,0,0,0,0,0,0,0,0,0.0,0.0
1006,1238,25-09-2019 04:54:00,0,3229.0,3079.0,0.953,16.132,0,0,0,0,0,0,0,0,0.0,0.0
1006,1239,25-09-2019 04:56:00,0,3325.0,3245.0,0.976,16.693,2,2,0,2,0,0,0,0,0.0,0.0
1006,1240,25-09-2019 04:58:00,0,3433.0,3304.0,0.963,17.185,2,2,0,2,0,0,0,0,0.0,0.0
1006,1241,25-09-2019 05:00:00,0,3542.0,3401.0,0.96,17.718,0,0,0,0,0,0,0,0,0.0,0.0
1006,1242,25-09-2019 05:02:00,0,3510.0,3515.0,1.001,17.72,0,0,0,0,0,0,0,0,0.0,0.0
1006,1243,25-09-2019 05:04:00,0,3514.0,3540.0,1.007,17.765,0,0,0,0,0,0,0,0,0.0,0.0
1006,1244,25-09-2019 05:06:00,0,3522.0,3488.0,0.99,17.739,26,23,8,15,3,2,1,0,0.0,0.0
1006,1245,25-09-2019 05:08:00,0,3519.0,3490.0,0.992,17.727,226,138,96,42,88,55,33,21,0.0,0.0
1006,1246,25-09-2019 05:10:00,0,3562.0,3586.5,1.007,18.0035,312,240,179,61,72,47,25,24,0.0,0.0
1006,1247,25-09-2019 05:12:00,0,3605.0,3683.0,1.022,18.28,77,58,31,27,19,1,18,27,0.0,0.09
1006,1248,25-09-2019 05:14:00,0,4072.0,3962.0,0.973,20.431,206,120,90,30,86,51,35,69,0.0,0.0
1006,1249,25-09-2019 05:16:00,0,3723.0,3716.0,0.998,18.78,250,121,91,30,129,88,41,7,0.0,0.0
1006,1250,25-09-2019 05:18:00,0,3747.0,3724.0,0.994,18.885,66,27,14,13,39,7,32,0,0.0,0.0
1006,1251,25-09-2019 05:20:00,0,4038.0,4131.0,1.023,20.482,295,189,153,36,106,71,35,72,0.04,0.0
1006,1252,25-09-2019 05:22:00,0,3932.0,3962.0,1.008,19.879,220,148,107,41,72,49,23,51,0.0,0.0
1006,1253,25-09-2019 05:24:00,0,3826.0,3878.0,1.014,19.365,148,80,53,27,68,54,14,32,0.0,0.0
1006,1254,25-09-2019 05:26:00,0,3319.0,3220.0,0.97,16.64,285,235,181,54,50,18,32,15,0.0,0.0
1006,1255,25-09-2019 05:28:00,0,3833.0,3779.0,0.986,19.284,206,162,113,49,44,3,41,81,0.0,0.0
1006,1256,25-09-2019 05:30:00,0,4475.0,4438.0,0.992,22.546,159,126,79,47,33,0,33,55,0.0,0.0
1006,1257,25-09-2019 05:32:00,0,4573.0,4566.0,0.998,23.072,74,55,29,26,19,0,19,35,0.01,0.07
1006,1258,25-09-2019 05:34:00,0,4586.0,4544.0,0.991,23.101,80,60,39,21,20,0,20,47,0.01,0.06
1006,1259,25-09-2019 05:36:00,0,4587.0,4540.0,0.99,23.097,143,102,74,28,41,16,25,14,0.15,0.01
1006,1260,25-09-2019 05:38:00,0,3532.0,3429.0,0.971,17.711,76,58,21,37,18,2,16,0,0.0,0.0
1006,1261,25-09-2019 05:40:00,0,3101.0,3031.0,0.977,15.574,37,30,6,24,7,1,6,0,0.0,0.0
1006,1262,25-09-2019 05:42:00,0,3115.0,3040.0,0.976,15.639,86,73,40,33,13,1,12,0,0.01,0.0
1006,1263,25-09-2019 05:44:00,0,3232.5,3084.5,0.955,16.1505,11,11,3,8,0,0,0,0,0.0,0.0
1006,1264,25-09-2019 05:46:00,0,3350.0,3129.0,0.934,16.662,0,0,0,0,0,0,0,0,0.0,0.0
1006,1265,25-09-2019 05:48:00,0,3320.0,3212.0,0.968,16.635,3,3,2,1,0,0,0,0,0.0,0.0
1006,1266,25-09-2019 05:50:00,0,3447.0,3272.0,0.949,17.203,0,0,0,0,0,0,0,0,0.0,0.0
1006,1267,25-09-2019 05:52:00,0,3559.0,3317.0,0.932,17.693,25,20,10,10,5,0,5,0,0.0,0.0
1006,1268,25-09-2019 05:54:00,0,3450.0,3302.0,0.957,17.247,1,1,0,1,0,0,0,0,0.0,0.0
1006,1269,25-09-2019 05:56:00,0,3431.0,3305.0,0.963,17.177,9,6,4,2,3,0,3,0,0.0,0.0
1006,1270,25-09-2019 05:58:00,0,3548.0,3420.0,0.964,17.767,0,0,0,0,0,0,0,0,0.0,0.0
1006,1271,25-09-2019 06:00:00,1,3499.0,3613.0,1.032,17.786,3,2,0,2,1,0,1,0,0.01,0.0
1006,1272,25-09-2019 06:02:00,1,3615.0,3678.0,1.017,18.314,1,1,0,1,0,0,0,0,0.0,0.0
1006,1273,25-09-2019 06:04:00,1,3482.0,3619.0,1.039,17.725,1,1,0,1,0,0,0,0,0.0,0.0
1006,1274,25-09-2019 06:06:00,1,3523.0,3555.0,1.009,17.816,4,1,0,1,3,0,3,0,0.0,0.0
1006,1275,25-09-2019 06:08:00,1,3529.0,3451.0,0.978,17.725,2,0,0,0,2,0,2,0,0.0,0.0
1006,1276,25-09-2019 06:10:00,1,3303.0,3337.0,1.01,16.708,2,0,0,0,2,0,2,0,0.0,0.0
1006,1277,25-09-2019 06:12:00,1,3201.0,3240.0,1.012,16.199,2,2,1,1,0,0,0,0,0.0,0.0
1006,1278,25-09-2019 06:14:00,1,3053.0,3192.0,1.045,15.563,2,2,0,2,0,0,0,0,0.0,0.0
1006,1279,25-09-2019 06:16:00,1,3070.0,3102.0,1.01,15.53,0,0,0,0,0,0,0,0,0.0,0.0
1006,1280,25-09-2019 06:18:00,1,3026.5,3054.0,1.009,15.3055,1,1,0,1,0,0,0,0,0.0,0.0
1006,1281,25-09-2019 06:20:00,1,2983.0,3006.0,1.008,15.081,5,4,0,4,1,0,1,0,0.0,0.0
1006,1282,25-09-2019 06:22:00,1,2989.0,2931.0,0.981,15.021,5,0,0,0,5,0,5,0,0.0,0.0
1006,1283,25-09-2019 06:24:00,1,2758.0,2848.0,1.033,14.019,13,8,2,6,5,0,5,0,0.0,0.0
1006,1284,25-09-2019 06:26:00,1,2762.0,2815.0,1.019,13.998,1,1,0,1,0,0,0,0,0.0,0.0
1006,1285,25-09-2019 06:28:00,1,2760.0,2819.0,1.021,13.996,0,0,0,0,0,0,0,0,0.0,0.0
1006,1286,25-09-2019 06:30:00,1,2757.0,2848.0,1.033,14.017,22,17,10,7,5,1,4,0,0.0,0.0
1006,1287,25-09-2019 06:32:00,1,2735.0,2846.0,1.04,13.928,3,0,0,0,3,0,3,0,0.0,0.0
1006,1288,25-09-2019 06:34:00,1,2868.0,2912.0,1.015,14.524,1,0,0,0,1,0,1,0,0.01,0.01
1006,1289,25-09-2019 06:36:00,1,2885.0,2884.0,1.0,14.561,16,11,9,2,5,2,3,0,0.0,0.0
1006,1290,25-09-2019 06:38:00,1,2877.0,2893.0,1.005,14.539,0,0,0,0,0,0,0,0,0.0,0.0
1006,1291,25-09-2019 06:40:00,1,2744.0,2863.0,1.044,13.981,6,6,0,6,0,0,0,0,0.0,0.0
1006,1292,25-09-2019 06:42:00,1,2751.0,2838.0,1.032,13.981,4,4,0,4,0,0,0,0,0.0,0.0
1006,1293,25-09-2019 06:44:00,1,2889.0,2881.0,0.997,14.57,11,7,2,5,4,0,4,0,0.0,0.0
1006,1294,25-09-2019 06:46:00,1,2873.0,2869.0,0.999,14.497,18,14,7,7,4,0,4,0,0.0,0.0
1006,1295,25-09-2019 06:48:00,1,2760.0,2850.0,1.033,14.028,0,0,0,0,0,0,0,0,0.0,0.0
1006,1296,25-09-2019 06:50:00,1,2774.0,2780.0,1.002,14.008,3,3,0,3,0,0,0,0,0.0,0.0
1006,1297,25-09-2019 06:52:00,1,2834.0,2820.0,0.995,14.2885,5,3,0,3,2,0,2,0,0.0,0.0
1006,1298,25-09-2019 06:54:00,1,2894.0,2860.0,0.988,14.569,168,108,84,24,60,35,25,29,0.0,0.0
1006,1299,25-09-2019 06:56:00,1,3089.0,3079.0,0.997,15.579,34,8,1,7,26,2,24,0,0.0,0.0
1006,1300,25-09-2019 06:58:00,1,3319.0,3288.0,0.991,16.718,55,32,16,16,23,3,20,1,0.0,0.0
1006,1301,25-09-2019 07:00:00,1,3288.0,3336.0,1.015,16.647,46,26,2,24,20,0,20,0,0.0,0.0
1006,1302,25-09-2019 07:02:00,1,3546.0,3441.0,0.97,17.78,25,6,0,6,19,2,17,0,0.0,0.0
1006,1303,25-09-2019 07:04:00,1,3534.0,3496.0,0.989,17.796,41,14,3,11,27,0,27,0,0.0,0.0
1006,1304,25-09-2019 07:06:00,1,3511.0,3501.0,0.997,17.708,9,9,4,5,0,0,0,0,0.0,0.0
1006,1305,25-09-2019 07:08:00,1,3542.0,3347.0,0.945,17.661,9,9,1,8,0,0,0,0,0.0,0.0
1006,1306,25-09-2019 07:10:00,1,3321.0,3273.0,0.986,16.708,26,19,5,14,7,2,5,0,0.0,0.0
1006,1307,25-09-2019 07:12:00,1,3339.0,3160.0,0.946,16.655,1,1,0,1,0,0,0,0,0.0,0.0
1006,1308,25-09-2019 07:14:00,1,3205.0,3115.0,0.972,16.074,3,2,0,2,1,0,1,0,0.0,0.0
1006,1309,25-09-2019 07:16:00,1,3108.0,3036.0,0.977,15.608,2,2,0,2,0,0,0,0,0.0,0.0
1006,1310,25-09-2019 07:18:00,1,3119.0,2971.0,0.953,15.579,14,0,0,0,14,0,14,0,0.0,0.0
1006,1311,25-09-2019 07:20:00,1,3002.0,2904.0,0.967,15.041,4,2,0,2,2,0,2,0,0.0,0.0
1006,1312,25-09-2019 07:22:00,1,3009.0,2919.0,0.97,15.086,3,0,0,0,3,0,3,0,0.0,0.0
1006,1313,25-09-2019 07:24:00,1,3015.0,2912.0,0.966,15.104,14,10,3,7,4,1,3,0,0.0,0.0
1006,1314,25-09-2019 07:26:00,1,3047.5,3003.5,0.9855,15.3315,15,11,1,10,4,1,3,0,0.0,0.0
1006,1315,25-09-2019 07:28:00,1,3080.0,3095.0,1.005,15.559,39,31,15,16,8,2,6,0,0.0,0.0
1006,1316,25-09-2019 07:30:00,1,3332.0,3201.0,0.961,16.67,78,56,22,34,22,7,15,1,0.0,0.0
1006,1317,25-09-2019 07:32:00,1,3332.0,3215.0,0.965,16.687,128,82,63,19,46,20,26,12,0.0,0.0
1006,1318,25-09-2019 07:34:00,1,3525.0,3497.0,0.992,17.758,204,110,78,32,94,66,28,17,0.0,0.0
1006,1319,25-09-2019 07:36:00,1,3550.0,3411.0,0.961,17.765,108,70,45,25,38,20,18,33,0.0,0.0
1006,1320,25-09-2019 07:38:00,1,3649.0,3550.0,0.973,18.307,329,188,139,49,141,90,51,66,0.0,0.01
1006,1321,25-09-2019 07:40:00,1,3879.0,3691.0,0.951,19.37,107,42,19,23,65,34,31,2,0.0,0.01
1006,1322,25-09-2019 07:42:00,1,3550.0,3413.0,0.961,17.766,304,171,125,46,133,92,41,10,0.0,0.0
1006,1323,25-09-2019 07:44:00,1,3836.0,3803.0,0.991,19.324,278,141,99,42,137,92,45,1,0.0,0.0
1006,1324,25-09-2019 07:46:00,1,3876.0,3658.0,0.944,19.321,327,203,159,44,124,73,51,64,0.0,0.0
1006,1325,25-09-2019 07:48:00,1,4057.0,4020.0,0.991,20.436,301,178,130,48,123,81,42,6,0.0,0.0
1006,1326,25-09-2019 07:50:00,1,3863.0,3745.0,0.97,19.365,54,29,14,15,25,14,11,0,0.0,0.01
1006,1327,25-09-2019 07:52:00,1,3868.0,3714.0,0.96,19.35,36,32,15,17,4,1,3,0,0.0,0.0
1006,1328,25-09-2019 07:54:00,1,3760.0,3600.0,0.957,18.798,15,13,2,11,2,1,1,0,0.0,0.0
1006,1329,25-09-2019 07:56:00,1,3653.0,3553.0,0.973,18.328,76,28,12,16,48,15,33,0,0.0,0.0
1006,1330,25-09-2019 07:58:00,1,3545.0,3397.0,0.958,17.726,0,0,0,0,0,0,0,0,0.0,0.0
1006,1331,25-09-2019 08:00:00,1,3434.0,3320.0,0.967,17.205,1,1,0,1,0,0,0,0,0.0,0.0
1006,1332,25-09-2019 08:02:00,1,3323.0,3243.0,0.976,16.684,13,12,6,6,1,0,1,0,0.0,0.0
1006,1333,25-09-2019 08:04:00,1,3335.0,3180.0,0.954,16.659,7,7,0,7,0,0,0,0,0.0,0.0
1006,1334,25-09-2019 08:06:00,1,3364.0,3084.0,0.917,16.669,16,16,5,11,0,0,0,0,0.0,0.0
1006,1335,25-09-2019 08:08:00,1,3123.0,2989.0,0.957,15.612,1,1,0,1,0,0,0,0,0.0,0.0
1006,1336,25-09-2019 08:10:00,1,3128.0,2965.0,0.948,15.608,81,62,35,27,19,8,11,0,0.0,0.0
1006,1337,25-09-2019 08:12:00,1,3124.0,2944.0,0.942,15.569,215,131,93,38,84,44,40,7,0.0,0.0
1006,1338,25-09-2019 08:14:00,1,3228.0,3099.0,0.96,16.15,443,257,195,62,186,125,61,12,0.0,0.0
1006,1339,25-09-2019 08:16:00,1,3316.0,3220.0,0.971,16.629,552,348,266,82,204,146,58,5,0.0,0.0
1006,1340,25-09-2019 08:18:00,1,3558.0,3352.0,0.942,17.73,624,396,323,73,228,164,64,62,0.0,0.0
1006,1341,25-09-2019 08:20:00,1,3534.0,3441.0,0.974,17.733,239,150,109,41,89,55,34,41,0.0,0.0
1006,1342,25-09-2019 08:22:00,1,3544.0,3393.0,0.957,17.721,27,24,9,15,3,2,1,0,0.0,0.0
1006,1343,25-09-2019 08:24:00,1,3563.0,3373.0,0.946,17.773,47,26,13,13,21,1,20,0,0.0,0.0
1006,1344,25-09-2019 08:26:00,1,3575.0,3284.0,0.918,17.723,41,22,5,17,19,0,19,0,0.0,0.0
1006,1345,25-09-2019 08:28:00,1,3554.0,3345.0,0.941,17.707,40,24,6,18,16,0,16,0,0.0,0.0
1006,1346,25-09-2019 08:30:00,1,3571.0,3324.0,0.931,17.749,9,9,1,8,0,0,0,0,0.0,0.0
1006,1347,25-09-2019 08:32:00,1,3341.0,3155.0,0.945,16.656,18,15,0,15,3,0,3,0,0.01,0.0
1006,1348,25-09-2019 08:34:00,1,3237.0,3033.5,0.937,16.1115,1,0,0,0,1,0,1,0,0.0,0.0
1006,1349,25-09-2019 08:36:00,1,3133.0,2912.0,0.929,15.567,0,0,0,0,0,0,0,0,0.0,0.0
1006,1350,25-09-2019 08:38:00,1,2918.0,2746.0,0.941,14.536,13,3,1,2,10,2,8,0,0.0,0.0
1006,1351,25-09-2019 08:40:00,1,2805.0,2622.0,0.935,13.954,0,0,0,0,0,0,0,0,0.0,0.0
1006,1352,25-09-2019 08:42:00,1,2833.0,2555.0,0.902,13.99,0,0,0,0,0,0,0,0,0.0,0.0
1006,1353,25-09-2019 08:44:00,1,2840.0,2506.0,0.883,13.963,0,0,0,0,0,0,0,0,0.0,0.0
1006,1354,25-09-2019 08:46:00,1,2727.0,2451.0,0.899,13.459,2,0,0,0,2,0,2,0,0.0,0.0
1006,1355,25-09-2019 08:48:00,1,2587.0,2440.0,0.943,12.893,3,0,0,0,3,0,3,0,0.0,0.0
1006,1356,25-09-2019 08:50:00,1,2724.0,2464.0,0.905,13.461,0,0,0,0,0,0,0,0,0.0,0.0
1006,1357,25-09-2019 08:52:00,1,2727.0,2433.0,0.892,13.438,6,2,0,2,4,0,4,0,0.0,0.0
1006,1358,25-09-2019 08:54:00,1,2590.0,2425.0,0.936,12.889,0,0,0,0,0,0,0,0,0.0,0.0
1006,1359,25-09-2019 08:56:00,1,2594.0,2404.0,0.927,12.882,0,0,0,0,0,0,0,0,0.0,0.0
1006,1360,25-09-2019 08:58:00,1,2600.0,2377.0,0.914,12.874,1,0,0,0,1,0,1,0,0.0,0.0
1006,1361,25-09-2019 09:00:00,1,2607.0,2371.0,0.91,12.896,2,1,1,0,1,0,1,0,0.0,0.0
1006,1362,25-09-2019 09:02:00,1,2606.0,2391.0,0.918,12.915,103,85,39,46,18,0,18,0,0.0,0.0
1006,1363,25-09-2019 09:04:00,1,2821.0,2573.0,0.912,13.962,153,77,36,41,76,43,33,5,0.0,0.0
1006,1364,25-09-2019 09:06:00,1,3048.0,2779.0,0.912,15.086,142,75,47,28,67,19,48,66,0.0,0.0
1006,1365,25-09-2019 09:08:00,1,3489.0,3118.0,0.896,17.199,115,60,32,28,55,3,52,48,0.0,0.01
1006,1366,25-09-2019 09:10:00,1,3930.0,3457.0,0.88,19.312,94,64,36,28,30,0,30,50,0.0,0.04
1006,1367,25-09-2019 09:12:00,1,4013.0,3665.0,0.913,19.87,87,55,30,25,32,0,32,43,0.0,0.01
1006,1368,25-09-2019 09:14:00,1,4012.0,3666.0,0.914,19.867,86,57,33,24,29,0,29,51,0.0,0.08
1006,1369,25-09-2019 09:16:00,1,4115.0,3802.0,0.924,20.422,119,85,60,25,34,3,31,52,0.0,0.05
1006,1370,25-09-2019 09:18:00,1,3895.0,3654.0,0.938,19.391,247,140,97,43,107,72,35,14,0.0,0.02
1006,1371,25-09-2019 09:20:00,1,3140.0,2894.0,0.922,15.577,646,381,299,82,265,192,73,25,0.0,0.0
1006,1372,25-09-2019 09:22:00,1,3571.0,3356.0,0.94,17.786,85,64,46,18,21,13,8,17,0.0,0.0
1006,1373,25-09-2019 09:24:00,1,2798.0,2642.0,0.944,13.95,155,97,64,33,58,29,29,1,0.0,0.0
1006,1374,25-09-2019 09:26:00,1,3255.0,2989.0,0.918,16.132,140,71,55,16,69,55,14,0,0.06,0.0
1006,1375,25-09-2019 09:28:00,1,2926.0,2704.0,0.924,14.521,36,28,8,20,8,1,7,0,0.0,0.0
1006,1376,25-09-2019 09:30:00,1,3026.0,2814.0,0.93,15.037,86,64,23,41,22,1,21,0,0.0,0.0
1006,1377,25-09-2019 09:32:00,1,3349.0,3115.0,0.93,16.644,64,55,18,37,9,0,9,0,0.0,0.0
1006,1378,25-09-2019 09:34:00,1,3575.0,3300.0,0.923,17.737,0,0,0,0,0,0,0,0,0.0,0.0
1006,1379,25-09-2019 09:36:00,1,3464.0,3184.0,0.919,17.175,0,0,0,0,0,0,0,0,0.0,0.0
1006,1380,25-09-2019 09:38:00,1,3467.0,3208.0,0.925,17.211,0,0,0,0,0,0,0,0,0.0,0.0
1006,1381,25-09-2019 09:40:00,1,3569.0,3311.0,0.928,17.729,24,20,10,10,4,2,2,0,0.0,0.0
1006,1382,25-09-2019 09:42:00,1,3557.5,3350.5,0.942,17.7265,38,38,0,38,0,0,0,0,0.0,0.0
1006,1383,25-09-2019 09:44:00,1,3546.0,3390.0,0.956,17.724,7,7,0,7,0,0,0,0,0.0,0.0
1006,1384,25-09-2019 09:46:00,1,3444.0,3287.0,0.954,17.208,2,2,0,2,0,0,0,0,0.0,0.0
1006,1385,25-09-2019 09:48:00,1,3341.0,3164.0,0.947,16.668,8,8,0,8,0,0,0,0,0.0,0.0
1006,1386,25-09-2019 09:50:00,1,3228.0,3087.0,0.956,16.135,0,0,0,0,0,0,0,0,0.02,0.0
1006,1387,25-09-2019 09:52:00,1,3124.0,3006.0,0.962,15.635,0,0,0,0,0,0,0,0,0.0,0.0
1006,1388,25-09-2019 09:54:00,1,2893.0,2839.0,0.982,14.54,0,0,0,0,0,0,0,0,0.0,0.0
1006,1389,25-09-2019 09:56:00,1,2768.0,2764.0,0.998,13.968,0,0,0,0,0,0,0,0,0.0,0.0
1006,1390,25-09-2019 09:58:00,1,2765.0,2820.0,1.02,14.017,0,0,0,0,0,0,0,0,0.0,0.0
1006,1391,25-09-2019 10:00:00,1,3005.0,2845.0,0.947,14.99,21,13,7,6,8,2,6,0,0.0,0.0
1006,1392,25-09-2019 10:02:00,1,3010.0,2870.0,0.954,15.036,3,3,1,2,0,0,0,0,0.0,0.0
1006,1393,25-09-2019 10:04:00,1,2999.0,2937.0,0.98,15.067,2,2,0,2,0,0,0,0,0.0,0.0
1006,1394,25-09-2019 10:06:00,1,3007.0,2879.0,0.957,15.035,23,21,11,10,2,0,2,0,0.0,0.0
1006,1395,25-09-2019 10:08:00,1,3002.0,2927.0,0.975,15.067,1,0,0,0,1,0,1,0,0.0,0.0
1006,1396,25-09-2019 10:10:00,1,2988.0,2972.0,0.995,15.061,10,8,1,7,2,0,2,0,0.0,0.0
1006,1397,25-09-2019 10:12:00,1,3002.0,2861.0,0.953,14.994,3,3,0,3,0,0,0,0,0.0,0.0
1006,1398,25-09-2019 10:14:00,1,3026.0,2846.0,0.941,15.072,2,2,0,2,0,0,0,0,0.0,0.01
1006,1399,25-09-2019 10:16:00,1,2897.5,2788.5,0.9635,14.5015,1,1,0,1,0,0,0,0,0.0,0.0
1006,1400,25-09-2019 10:18:00,1,2769.0,2731.0,0.986,13.931,0,0,0,0,0,0,0,0,0.0,0.0
1006,1401,25-09-2019 10:20:00,1,2780.0,2763.0,0.994,14.011,83,49,22,27,34,11,23,0,0.0,0.0
1006,1402,25-09-2019 10:22:00,1,3007.0,2863.0,0.952,15.017,11,5,0,5,6,0,6,0,0.0,0.0
1006,1403,25-09-2019 10:24:00,1,3010.0,2834.0,0.942,14.996,11,4,0,4,7,0,7,0,0.0,0.0
1006,1404,25-09-2019 10:26:00,1,2904.0,2785.0,0.959,14.527,4,2,0,2,2,0,2,0,0.0,0.0
1006,1405,25-09-2019 10:28:00,1,2792.0,2728.0,0.977,14.019,1,0,0,0,1,0,1,0,0.0,0.0
1006,1406,25-09-2019 10:30:00,1,2791.0,2660.0,0.953,13.941,1,1,0,1,0,0,0,0,0.0,0.0
1006,1407,25-09-2019 10:32:00,1,2804.0,2644.0,0.943,13.977,0,0,0,0,0,0,0,0,0.0,0.0
1006,1408,25-09-2019 10:34:00,1,2816.0,2601.0,0.924,13.976,2,1,1,0,1,0,1,0,0.0,0.0
1006,1409,25-09-2019 10:36:00,1,2826.0,2597.0,0.919,14.01,17,13,5,8,4,2,2,0,0.0,0.0
1006,1410,25-09-2019 10:38:00,1,2791.0,2711.0,0.971,13.997,127,103,68,35,24,4,20,28,0.0,0.01
1006,1411,25-09-2019 10:40:00,1,3353.0,3126.0,0.933,16.67,118,87,52,35,31,0,31,49,0.0,0.0
1006,1412,25-09-2019 10:42:00,1,3781.0,3503.0,0.927,18.775,71,43,24,19,28,0,28,34,0.0,0.09
1006,1413,25-09-2019 10:44:00,1,3880.0,3689.0,0.951,19.372,84,57,35,22,27,0,27,49,0.0,0.05
1006,1414,25-09-2019 10:46:00,1,3867.0,3747.0,0.969,19.386,289,153,117,36,136,89,47,37,0.0,0.04
1006,1415,25-09-2019 10:48:00,1,3555.0,3330.0,0.937,17.694,391,255,203,52,136,92,44,47,0.06,0.01
1006,1416,25-09-2019 10:50:00,1,3452.0,3240.0,0.9385,17.1885,1030,622,512,110,408,316,92,5,0.0,0.0
1006,1417,25-09-2019 10:52:00,1,3349.0,3150.0,0.94,16.683,367,183,128,55,184,133,51,2,0.0,0.0
1006,1418,25-09-2019 10:54:00,1,3330.0,3219.0,0.967,16.683,575,355,293,62,220,164,56,12,0.0,0.06
1006,1419,25-09-2019 10:56:00,1,3557.0,3341.0,0.939,17.712,310,160,119,41,150,105,45,0,0.0,0.0
1006,1420,25-09-2019 10:58:00,1,3643.0,3485.0,0.957,18.21,240,162,119,43,78,46,32,12,0.02,0.0
1006,1421,25-09-2019 11:00:00,1,3548.0,3391.0,0.956,17.731,41,31,11,20,10,2,8,0,0.0,0.0
1006,1422,25-09-2019 11:02:00,1,3562.0,3410.0,0.957,17.807,23,22,2,20,1,0,1,0,0.0,0.0
1006,1423,25-09-2019 11:04:00,1,3609.0,3573.0,0.99,18.175,51,36,8,28,15,0,15,0,0.0,0.0
1006,1424,25-09-2019 11:06:00,1,3530.0,3521.0,0.997,17.805,95,68,34,34,27,5,22,0,0.0,0.0
1006,1425,25-09-2019 11:08:00,1,3735.0,3675.0,0.984,18.783,14,12,1,11,2,0,2,0,0.0,0.0
1006,1426,25-09-2019 11:10:00,1,3551.0,3369.0,0.949,17.72,0,0,0,0,0,0,0,0,0.0,0.0
1006,1427,25-09-2019 11:12:00,1,3305.0,3309.0,1.001,16.686,0,0,0,0,0,0,0,0,0.0,0.0
1006,1428,25-09-2019 11:14:00,1,3305.0,3311.0,1.002,16.685,10,7,2,5,3,0,3,0,0.0,0.0
1006,1429,25-09-2019 11:16:00,1,3300.0,3312.0,1.003,16.669,0,0,0,0,0,0,0,0,0.0,0.0
1006,1430,25-09-2019 11:18:00,1,3321.0,3257.0,0.981,16.689,0,0,0,0,0,0,0,0,0.0,0.0
1006,1431,25-09-2019 11:20:00,1,3095.0,3064.0,0.99,15.585,1,0,0,0,1,1,0,0,0.0,0.0
1006,1432,25-09-2019 11:22:00,1,2976.0,2959.0,0.994,15.003,13,7,3,4,6,1,5,0,0.0,0.0
1006,1433,25-09-2019 11:24:00,1,2983.5,2971.0,0.9955,15.0455,0,0,0,0,0,0,0,0,0.0,0.0
1006,1434,25-09-2019 11:26:00,1,2991.0,2983.0,0.997,15.088,0,0,0,0,0,0,0,0,0.0,0.0
1006,1435,25-09-2019 11:28:00,1,2958.0,3032.0,1.025,15.01,0,0,0,0,0,0,0,0,0.01,0.0
1006,1436,25-09-2019 11:30:00,1,2968.0,3068.0,1.034,15.089,1,0,0,0,1,1,0,0,0.0,0.0
1006,1437,25-09-2019 11:32:00,1,3120.0,2989.0,0.958,15.601,0,0,0,0,0,0,0,0,0.0,0.0
1006,1438,25-09-2019 11:34:00,1,3000.0,2950.0,0.983,15.087,6,5,1,4,1,0,1,0,0.0,0.0
1006,1439,25-09-2019 11:36:00,1,2986.0,2966.0,0.993,15.048,7,7,1,6,0,0,0,0,0.0,0.0
1006,1440,25-09-2019 11:38:00,1,2979.0,2978.0,1.0,15.032,10,9,0,9,1,0,1,0,0.0,0.0
1006,1441,25-09-2019 11:40:00,1,2989.0,2991.0,1.001,15.089,6,3,1,2,3,0,3,0,0.0,0.0
1006,1442,25-09-2019 11:42:00,1,2987.0,2918.0,0.977,15.001,65,40,12,28,25,12,13,0,0.0,0.0
1006,1443,25-09-2019 11:44:00,1,3222.0,3127.0,0.971,16.156,110,53,30,23,57,29,28,22,0.0,0.0
1006,1444,25-09-2019 11:46:00,1,3544.0,3435.0,0.969,17.768,271,166,122,44,105,69,36,71,0.0,0.0
1006,1445,25-09-2019 11:48:00,1,3526.0,3499.0,0.992,17.765,134,87,50,37,47,9,38,60,0.0,0.0
1006,1446,25-09-2019 11:50:00,1,3874.0,3665.0,0.946,19.319,173,116,81,35,57,31,26,35,0.0,0.0
1006,1447,25-09-2019 11:52:00,1,3107.0,3024.0,0.973,15.588,29,15,5,10,14,0,14,0,0.0,0.0
1006,1448,25-09-2019 11:54:00,1,3122.0,2971.0,0.952,15.591,31,25,5,20,6,0,6,0,0.0,0.0
1006,1449,25-09-2019 11:56:00,1,3336.0,3189.0,0.956,16.674,139,109,75,34,30,1,29,40,0.0,0.0
1006,1450,25-09-2019 11:58:00,1,3699.5,3619.0,0.976,18.583,122,94,59,35,28,0,28,57,0.0,0.01
1006,1451,25-09-2019 12:00:00,1,4063.0,4049.0,0.996,20.492,119,73,39,34,46,3,43,56,0.0,0.04
1006,1452,25-09-2019 12:02:00,1,4174.0,4115.0,0.986,21.0,74,39,23,16,35,2,33,42,0.0,0.07
1006,1453,25-09-2019 12:04:00,1,4054.0,3997.0,0.986,20.396,237,146,111,35,91,60,31,6,0.04,0.01
1006,1454,25-09-2019 12:06:00,1,3143.0,2882.0,0.917,15.575,190,130,82,48,60,33,27,1,0.0,0.01
1006,1455,25-09-2019 12:08:00,1,2831.0,2554.0,0.902,13.982,325,163,115,48,162,105,57,6,0.0,0.0
1006,1456,25-09-2019 12:10:00,1,2923.0,2736.0,0.936,14.544,282,170,115,55,112,78,34,14,0.0,0.0
1006,1457,25-09-2019 12:12:00,1,3863.0,3683.0,0.953,19.298,393,206,157,49,187,131,56,48,0.07,0.04
1006,1458,25-09-2019 12:14:00,1,4074.0,3937.0,0.966,20.411,453,318,261,57,135,100,35,3,0.0,0.0
1006,1459,25-09-2019 12:16:00,1,4043.0,4103.0,1.015,20.471,643,393,322,71,250,193,57,14,0.0,0.0
1006,1460,25-09-2019 12:18:00,1,4019.0,4082.0,1.016,20.354,311,245,181,64,66,22,44,37,0.01,0.0
1006,1461,25-09-2019 12:20:00,1,4366.0,4385.0,1.004,22.056,261,169,117,52,92,51,41,23,0.0,0.0
1006,1462,25-09-2019 12:22:00,1,3881.0,3684.0,0.949,19.368,71,39,13,26,32,14,18,0,0.0,0.01
1006,1463,25-09-2019 12:24:00,1,3294.0,3291.0,0.999,16.62,194,144,101,43,50,29,21,0,0.0,0.0
1006,1464,25-09-2019 12:26:00,1,3505.0,3515.0,1.003,17.7,30,15,1,14,15,3,12,0,0.0,0.02
1006,1465,25-09-2019 12:28:00,1,3881.0,3653.0,0.941,19.336,33,21,4,17,12,0,12,0,0.0,0.0
1006,1466,25-09-2019 12:30:00,1,3734.0,3623.0,0.97,18.723,4,4,0,4,0,0,0,0,0.0,0.0
1006,1467,25-09-2019 12:32:00,1,3624.0,3571.0,0.9855,18.2305,5,0,0,0,5,0,5,0,0.0,0.0
1006,1468,25-09-2019 12:34:00,1,3514.0,3519.0,1.001,17.738,1,0,0,0,1,0,1,0,0.0,0.0
1006,1469,25-09-2019 12:36:00,1,3523.0,3549.0,1.007,17.807,3,0,0,0,3,0,3,0,0.0,0.0
1006,1470,25-09-2019 12:38:00,1,3498.0,3576.0,1.022,17.741,0,0,0,0,0,0,0,0,0.0,0.0
1006,1471,25-09-2019 12:40:00,1,3534.0,3482.0,0.985,17.779,0,0,0,0,0,0,0,0,0.01,0.0
1006,1472,25-09-2019 12:42:00,1,3304.0,3310.0,1.002,16.684,0,0,0,0,0,0,0,0,0.0,0.0
1006,1473,25-09-2019 12:44:00,1,3074.0,3172.0,1.032,15.621,10,8,4,4,2,0,2,0,0.0,0.0
1006,1474,25-09-2019 12:46:00,1,3091.0,3118.0,1.009,15.629,0,0,0,0,0,0,0,0,0.0,0.0
1006,1475,25-09-2019 12:48:00,1,3084.0,3120.0,1.012,15.604,0,0,0,0,0,0,0,0,0.0,0.0
1006,1476,25-09-2019 12:50:00,1,3095.0,3061.0,0.989,15.582,0,0,0,0,0,0,0,0,0.0,0.0
1006,1477,25-09-2019 12:52:00,1,2975.0,3024.0,1.016,15.07,0,0,0,0,0,0,0,0,0.0,0.0
1006,1478,25-09-2019 12:54:00,1,2996.0,2934.0,0.98,15.051,0,0,0,0,0,0,0,0,0.0,0.0
1006,1479,25-09-2019 12:56:00,1,2871.0,2917.0,1.016,14.54,0,0,0,0,0,0,0,0,0.0,0.0
1006,1480,25-09-2019 12:58:00,1,2996.0,2929.0,0.978,15.046,2,2,1,1,0,0,0,0,0.0,0.0
1006,1481,25-09-2019 13:00:00,1,3000.0,2910.0,0.97,15.04,0,0,0,0,0,0,0,0,0.01,0.0
1006,1482,25-09-2019 13:02:00,1,3011.0,2910.0,0.967,15.083,6,4,0,4,2,0,2,0,0.0,0.0
1006,1483,25-09-2019 13:04:00,1,3011.0,2913.0,0.967,15.087,46,46,0,46,0,0,0,0,0.0,0.0
1006,1484,25-09-2019 13:06:00,1,2884.5,2861.5,0.993,14.5325,36,29,0,29,7,0,7,0,0.0,0.0
1006,1485,25-09-2019 13:08:00,1,2758.0,2810.0,1.019,13.978,12,10,1,9,2,0,2,0,0.0,0.0
1006,1486,25-09-2019 13:10:00,1,2767.0,2781.0,1.005,13.981,32,32,1,31,0,0,0,0,0.0,0.0
1006,1487,25-09-2019 13:12:00,1,2756.0,2785.0,1.011,13.942,8,8,0,8,0,0,0,0,0.0,0.0
1006,1488,25-09-2019 13:14:00,1,2768.0,2788.0,1.007,13.993,16,11,3,8,5,0,5,0,0.0,0.0
1006,1489,25-09-2019 13:16:00,1,2769.0,2787.0,1.007,13.996,0,0,0,0,0,0,0,0,0.0,0.0
1006,1490,25-09-2019 13:18:00,1,2891.0,2829.0,0.979,14.522,0,0,0,0,0,0,0,0,0.0,0.0
1006,1491,25-09-2019 13:20:00,1,3022.0,2837.0,0.939,15.049,0,0,0,0,0,0,0,0,0.0,0.0
1006,1492,25-09-2019 13:22:00,1,3025.0,2818.0,0.931,15.04,0,0,0,0,0,0,0,0,0.0,0.0
1006,1493,25-09-2019 13:24:00,1,2900.0,2802.0,0.966,14.529,0,0,0,0,0,0,0,0,0.0,0.0
1006,1494,25-09-2019 13:26:00,1,2783.0,2733.0,0.982,13.99,25,8,2,6,17,2,15,0,0.0,0.0
1006,1495,25-09-2019 13:28:00,1,2775.0,2742.0,0.988,13.971,1,0,0,0,1,0,1,0,0.0,0.0
1006,1496,25-09-2019 13:30:00,1,2787.0,2712.0,0.973,13.982,2,0,0,0,2,0,2,0,0.0,0.0
1006,1497,25-09-2019 13:32:00,1,2804.0,2651.0,0.945,13.982,3,0,0,0,3,0,3,0,0.0,0.0
1006,1498,25-09-2019 13:34:00,1,2819.0,2609.0,0.926,13.994,2,0,0,0,2,0,2,0,0.0,0.0
1006,1499,25-09-2019 13:36:00,1,2825.0,2593.0,0.918,14.003,1,0,0,0,1,0,1,0,0.0,0.0
1006,1500,25-09-2019 13:38:00,1,2813.0,2595.0,0.923,13.954,0,0,0,0,0,0,0,0,0.0,0.0
1006,1501,25-09-2019 13:40:00,1,2812.5,2606.0,0.9265,13.965,1,0,0,0,1,0,1,0,0.0,0.0
1006,1502,25-09-2019 13:42:00,1,2812.0,2617.0,0.93,13.976,0,0,0,0,0,0,0,0,0.0,0.0
1006,1503,25-09-2019 13:44:00,1,2813.0,2610.0,0.928,13.972,0,0,0,0,0,0,0,0,0.0,0.0
1006,1504,25-09-2019 13:46:00,1,2839.0,2517.0,0.887,13.973,51,17,6,11,34,4,30,0,0.0,0.0
1006,1505,25-09-2019 13:48:00,1,2817.0,2596.0,0.922,13.974,73,48,14,34,25,4,21,0,0.0,0.0
1006,1506,25-09-2019 13:50:00,1,3037.0,2781.0,0.916,15.046,26,11,1,10,15,2,13,0,0.0,0.0
1006,1507,25-09-2019 13:52:00,1,3146.0,2925.0,0.93,15.632,276,141,106,35,135,90,45,32,0.0,0.0
1006,1508,25-09-2019 13:54:00,1,3359.0,3080.0,0.917,16.646,150,102,69,33,48,23,25,76,0.0,0.0
1006,1509,25-09-2019 13:56:00,1,3566.0,3309.0,0.928,17.714,106,67,27,40,39,1,38,55,0.01,0.03
1006,1510,25-09-2019 13:58:00,1,3682.0,3444.0,0.935,18.322,142,87,42,45,55,2,53,63,0.0,0.0
1006,1511,25-09-2019 14:00:00,1,3905.0,3538.0,0.906,19.305,106,63,33,30,43,0,43,51,0.0,0.03
1006,1512,25-09-2019 14:02:00,1,3909.0,3541.0,0.906,19.322,12,8,6,2,4,0,4,4,0.0,0.24
1006,1513,25-09-2019 14:04:00,1,3465.0,3223.0,0.93,17.221,0,0,0,0,0,0,0,0,0.0,0.01
1006,1514,25-09-2019 14:06:00,1,3572.0,3318.0,0.929,17.746,76,54,37,17,22,5,17,12,0.0,0.0
1006,1515,25-09-2019 14:08:00,1,2917.0,2755.0,0.945,14.541,42,10,0,10,32,0,32,0,0.0,0.0
1006,1516,25-09-2019 14:10:00,1,2797.0,2656.0,0.95,13.96,43,19,0,19,24,0,24,0,0.0,0.01
1006,1517,25-09-2019 14:12:00,1,3130.0,2948.0,0.942,15.595,37,35,9,26,2,0,2,0,0.0,0.0
1006,1518,25-09-2019 14:14:00,1,3227.0,3083.0,0.955,16.127,7,3,0,3,4,1,3,0,0.0,0.0
1006,1519,25-09-2019 14:16:00,1,3324.0,3218.0,0.968,16.659,1,0,0,0,1,0,1,0,0.0,0.0
1006,1520,25-09-2019 14:18:00,1,3345.0,3139.0,0.938,16.656,0,0,0,0,0,0,0,0,0.0,0.0
1006,1521,25-09-2019 14:20:00,1,3354.0,3134.0,0.935,16.685,29,18,9,9,11,3,8,0,0.0,0.0
1006,1522,25-09-2019 14:22:00,1,3204.0,3123.0,0.975,16.081,2,2,1,1,0,0,0,0,0.0,0.0
1006,1523,25-09-2019 14:24:00,1,3318.0,3205.0,0.966,16.623,1,1,0,1,0,0,0,0,0.0,0.0
1006,1524,25-09-2019 14:26:00,1,3329.0,3222.0,0.968,16.682,0,0,0,0,0,0,0,0,0.0,0.0
1006,1525,25-09-2019 14:28:00,1,3081.0,3125.0,1.014,15.6,2,1,0,1,1,1,0,0,0.0,0.0
1006,1526,25-09-2019 14:30:00,1,3123.0,3046.0,0.975,15.674,19,19,1,18,0,0,0,0,0.0,0.0
1006,1527,25-09-2019 14:32:00,1,2974.0,2996.0,1.007,15.035,10,10,4,6,0,0,0,0,0.0,0.0
1006,1528,25-09-2019 14:34:00,1,2967.0,3000.0,1.011,15.013,20,10,5,5,10,3,7,0,0.0,0.0
1006,1529,25-09-2019 14:36:00,1,2989.0,3006.0,1.006,15.104,30,30,8,22,0,0,0,0,0.0,0.0
1006,1530,25-09-2019 14:38:00,1,2944.0,3108.0,1.056,15.04,10,5,1,4,5,1,4,0,0.0,0.0
1006,1531,25-09-2019 14:40:00,1,3086.0,3071.0,0.995,15.558,0,0,0,0,0,0,0,0,0.0,0.0
1006,1532,25-09-2019 14:42:00,1,2994.0,2969.0,0.992,15.081,3,0,0,0,3,0,3,0,0.0,0.0
1006,1533,25-09-2019 14:44:00,1,2865.0,2928.0,1.022,14.528,0,0,0,0,0,0,0,0,0.0,0.0
1006,1534,25-09-2019 14:46:00,1,2743.0,2859.0,1.042,13.973,0,0,0,0,0,0,0,0,0.0,0.0
1006,1535,25-09-2019 14:48:00,1,2741.0,2882.0,1.0515,13.9895,8,6,3,3,2,0,2,0,0.0,0.0
1006,1536,25-09-2019 14:50:00,1,2739.0,2905.0,1.061,14.006,10,6,4,2,4,1,3,0,0.0,0.0
1006,1537,25-09-2019 14:52:00,1,2863.0,2933.0,1.025,14.527,2,2,0,2,0,0,0,0,0.0,0.0
1006,1538,25-09-2019 14:54:00,1,2860.0,2944.0,1.029,14.529,8,8,0,8,0,0,0,0,0.0,0.0
1006,1539,25-09-2019 14:56:00,1,2728.0,2904.0,1.064,13.965,0,0,0,0,0,0,0,0,0.0,0.0
1006,1540,25-09-2019 14:58:00,1,2860.0,2919.0,1.021,14.497,3,2,1,1,1,0,1,0,0.0,0.0
1006,1541,25-09-2019 15:00:00,1,2984.0,2957.0,0.991,15.032,0,0,0,0,0,0,0,0,0.0,0.0
1006,1542,25-09-2019 15:02:00,1,2993.0,2960.0,0.989,15.07,5,5,1,4,0,0,0,0,0.0,0.0
1006,1543,25-09-2019 15:04:00,1,2860.0,2904.0,1.015,14.484,52,42,25,17,10,0,10,0,0.0,0.0
1006,1544,25-09-2019 15:06:00,1,2983.0,2944.0,0.987,15.011,54,47,25,22,7,1,6,0,0.0,0.0
1006,1545,25-09-2019 15:08:00,1,2973.0,3054.0,1.027,15.095,24,22,7,15,2,2,0,0,0.0,0.0
1006,1546,25-09-2019 15:10:00,1,3082.0,3162.0,1.026,15.645,67,54,20,34,13,1,12,0,0.0,0.0
1006,1547,25-09-2019 15:12:00,1,3318.0,3220.0,0.97,16.636,44,18,3,15,26,3,23,0,0.0,0.0
1006,1548,25-09-2019 15:14:00,1,3301.0,3338.0,1.011,16.701,16,13,0,13,3,1,2,0,0.0,0.0
1006,1549,25-09-2019 15:16:00,1,3304.0,3305.0,1.0,16.675,12,0,0,0,12,0,12,0,0.0,0.0
1006,1550,25-09-2019 15:18:00,1,3313.0,3291.0,0.993,16.698,32,13,5,8,19,1,18,0,0.0,0.0
1006,1551,25-09-2019 15:20:00,1,3420.0,3373.0,0.986,17.209,26,9,2,7,17,2,15,0,0.0,0.0
1006,1552,25-09-2019 15:22:00,1,3469.5,3394.0,0.978,17.426,40,28,2,26,12,1,11,0,0.0,0.0
1006,1553,25-09-2019 15:24:00,1,3519.0,3415.0,0.97,17.643,36,11,5,6,25,0,25,0,0.0,0.0
1006,1554,25-09-2019 15:26:00,1,3429.0,3380.0,0.986,17.253,7,5,0,5,2,1,1,0,0.0,0.0
1006,1555,25-09-2019 15:28:00,1,3326.0,3190.0,0.959,16.637,35,27,19,8,8,3,5,0,0.0,0.0
1006,1556,25-09-2019 15:30:00,1,3211.0,3148.0,0.98,16.136,0,0,0,0,0,0,0,0,0.0,0.0
1006,1557,25-09-2019 15:32:00,1,2980.0,3041.0,1.021,15.106,1,1,0,1,0,0,0,0,0.0,0.0
1006,1558,25-09-2019 15:34:00,1,3000.0,2932.0,0.977,15.067,2,2,1,1,0,0,0,0,0.0,0.0
1006,1559,25-09-2019 15:36:00,1,2750.0,2844.0,1.034,13.984,4,3,1,2,1,0,1,0,0.0,0.0
1006,1560,25-09-2019 15:38:00,1,2761.0,2844.0,1.03,14.027,0,0,0,0,0,0,0,0,0.0,0.0
1006,1561,25-09-2019 15:40:00,1,2774.0,2766.0,0.997,13.993,44,34,19,15,10,2,8,0,0.0,0.0
1006,1562,25-09-2019 15:42:00,1,2757.0,2807.0,1.018,13.971,3,1,0,1,2,0,2,0,0.0,0.0
1006,1563,25-09-2019 15:44:00,1,2887.0,2841.0,0.984,14.522,2,1,0,1,1,0,1,0,0.0,0.0
1006,1564,25-09-2019 15:46:00,1,2765.0,2780.0,1.006,13.97,0,0,0,0,0,0,0,0,0.0,0.0
1006,1565,25-09-2019 15:48:00,1,2798.0,2688.0,0.961,14.0,0,0,0,0,0,0,0,0,0.0,0.0
1006,1566,25-09-2019 15:50:00,1,2817.0,2598.0,0.922,13.976,0,0,0,0,0,0,0,0,0.0,0.0
1006,1567,25-09-2019 15:52:00,1,2830.0,2571.0,0.908,13.997,5,5,1,4,0,0,0,0,0.0,0.0
1006,1568,25-09-2019 15:54:00,1,2818.0,2585.0,0.917,13.964,1,0,0,0,1,0,1,0,0.0,0.0
1006,1569,25-09-2019 15:56:00,1,2818.5,2575.5,0.9135,13.955,0,0,0,0,0,0,0,0,0.0,0.0
1006,1570,25-09-2019 15:58:00,1,2819.0,2566.0,0.91,13.946,1,0,0,0,1,0,1,0,0.0,0.0
1006,1571,25-09-2019 16:00:00,1,2845.0,2543.0,0.894,14.026,9,9,1,8,0,0,0,0,0.0,0.0
1006,1572,25-09-2019 16:02:00,1,2826.0,2543.0,0.9,13.95,1,1,0,1,0,0,0,0,0.0,0.0
1006,1573,25-09-2019 16:04:00,1,2822.0,2555.0,0.905,13.947,5,5,0,5,0,0,0,0,0.0,0.0
1006,1574,25-09-2019 16:06:00,1,2843.0,2514.0,0.884,13.985,54,38,15,23,16,4,12,0,0.0,0.0
1006,1575,25-09-2019 16:08:00,1,2821.0,2579.0,0.914,13.969,3,0,0,0,3,0,3,0,0.0,0.0
1006,1576,25-09-2019 16:10:00,1,2831.0,2536.0,0.896,13.961,0,0,0,0,0,0,0,0,0.0,0.0
1006,1577,25-09-2019 16:12:00,1,2849.0,2488.0,0.874,13.979,28,25,19,6,3,1,2,3,0.0,0.0
1006,1578,25-09-2019 16:14:00,1,2804.0,2628.0,0.937,13.958,201,132,92,40,69,54,15,8,0.0,0.0
1006,1579,25-09-2019 16:16:00,1,3117.0,2945.0,0.945,15.54,143,78,53,25,65,46,19,27,0.0,0.0
1006,1580,25-09-2019 16:18:00,1,3013.0,2873.0,0.954,15.051,59,40,15,25,19,1,18,0,0.0,0.01
1006,1581,25-09-2019 16:20:00,1,3124.0,2957.0,0.946,15.583,35,35,0,35,0,0,0,0,0.0,0.01
1006,1582,25-09-2019 16:22:00,1,3355.0,3041.0,0.907,16.585,46,37,10,27,9,0,9,0,0.0,0.0
1006,1583,25-09-2019 16:24:00,1,3367.0,3087.0,0.917,16.683,176,131,88,43,45,19,26,14,0.0,0.0
1006,1584,25-09-2019 16:26:00,1,3330.0,3163.0,0.95,16.62,108,87,58,29,21,7,14,0,0.0,0.0
1006,1585,25-09-2019 16:28:00,1,3349.0,3127.0,0.934,16.658,33,23,7,16,10,1,9,0,0.0,0.0
1006,1586,25-09-2019 16:30:00,1,3340.0,3159.5,0.946,16.6575,53,32,7,25,21,0,21,0,0.0,0.0
1006,1587,25-09-2019 16:32:00,1,3331.0,3192.0,0.958,16.657,0,0,0,0,0,0,0,0,0.0,0.0
1006,1588,25-09-2019 16:34:00,1,3360.0,3089.0,0.919,16.658,0,0,0,0,0,0,0,0,0.0,0.0
1006,1589,25-09-2019 16:36:00,1,3118.0,2969.0,0.952,15.572,0,0,0,0,0,0,0,0,0.0,0.0
1006,1590,25-09-2019 16:38:00,1,3019.0,2852.0,0.945,15.052,4,3,1,2,1,0,1,0,0.0,0.0
1006,1591,25-09-2019 16:40:00,1,2784.0,2739.0,0.984,14.001,13,9,4,5,4,3,1,0,0.0,0.0
1006,1592,25-09-2019 16:42:00,1,2770.0,2729.0,0.985,13.933,1,1,0,1,0,0,0,0,0.0,0.0
1006,1593,25-09-2019 16:44:00,1,2806.0,2650.0,0.944,13.989,0,0,0,0,0,0,0,0,0.0,0.0
1006,1594,25-09-2019 16:46:00,1,2820.0,2626.0,0.931,14.02,0,0,0,0,0,0,0,0,0.0,0.0
1006,1595,25-09-2019 16:48:00,1,2808.0,2632.0,0.937,13.976,77,64,54,10,13,4,9,8,0.0,0.0
1006,1596,25-09-2019 16:50:00,1,2801.0,2649.0,0.946,13.97,2,2,1,1,0,0,0,0,0.0,0.0
1006,1597,25-09-2019 16:52:00,1,2797.0,2661.0,0.951,13.967,0,0,0,0,0,0,0,0,0.0,0.0
1006,1598,25-09-2019 16:54:00,1,2804.0,2653.0,0.946,13.985,1,1,0,1,0,0,0,0,0.0,0.0
1006,1599,25-09-2019 16:56:00,1,2794.0,2633.0,0.942,13.925,7,7,0,7,0,0,0,0,0.0,0.0
1006,1600,25-09-2019 16:58:00,1,2794.0,2642.0,0.946,13.932,2,2,0,2,0,0,0,0,0.0,0.0
1006,1601,25-09-2019 17:00:00,1,2802.0,2652.0,0.946,13.975,3,3,0,3,0,0,0,0,0.0,0.0
1006,1602,25-09-2019 17:02:00,1,2801.0,2634.0,0.94,13.951,4,4,0,4,0,0,0,0,0.0,0.0
1006,1603,25-09-2019 17:04:00,1,2805.0,2621.0,0.9345,13.9525,3,3,0,3,0,0,0,0,0.0,0.0
1006,1604,25-09-2019 17:06:00,1,2809.0,2608.0,0.929,13.954,0,0,0,0,0,0,0,0,0.0,0.0
1006,1605,25-09-2019 17:08:00,1,2816.0,2605.0,0.925,13.98,0,0,0,0,0,0,0,0,0.0,0.0
1006,1606,25-09-2019 17:10:00,1,2818.0,2556.0,0.907,13.934,54,40,24,16,14,6,8,6,0.0,0.0
1006,1607,25-09-2019 17:12:00,1,2939.0,2617.0,0.89,14.478,160,108,67,41,52,15,37,70,0.0,0.0
1006,1608,25-09-2019 17:14:00,1,3609.0,3149.0,0.873,17.707,144,98,57,41,46,0,46,57,0.0,0.0
1006,1609,25-09-2019 17:16:00,1,3823.0,3387.0,0.886,18.813,95,60,33,27,35,0,35,52,0.0,0.07
1006,1610,25-09-2019 17:18:00,1,3914.0,3519.0,0.899,19.318,181,96,65,31,85,53,32,40,0.02,0.05
1006,1611,25-09-2019 17:20:00,1,3604.0,3213.0,0.892,17.755,110,76,54,22,34,16,18,41,0.02,0.01
1006,1612,25-09-2019 17:22:00,1,2809.0,2646.0,0.942,13.997,51,29,15,14,22,8,14,0,0.0,0.0
1006,1613,25-09-2019 17:24:00,1,3041.0,2753.0,0.905,15.031,34,34,8,26,0,0,0,0,0.0,0.0
1006,1614,25-09-2019 17:26:00,1,3152.0,2895.0,0.918,15.626,88,42,13,29,46,0,46,0,0.0,0.0
1006,1615,25-09-2019 17:28:00,1,3138.0,2893.0,0.922,15.567,19,12,3,9,7,0,7,0,0.0,0.0
1006,1616,25-09-2019 17:30:00,1,3390.0,2986.0,0.881,16.663,3,2,1,1,1,0,1,0,0.0,0.0
1006,1617,25-09-2019 17:32:00,1,3133.0,2924.0,0.933,15.581,1,0,0,0,1,0,1,0,0.0,0.0
1006,1618,25-09-2019 17:34:00,1,3358.0,3111.0,0.926,16.674,0,0,0,0,0,0,0,0,0.0,0.0
1006,1619,25-09-2019 17:36:00,1,3446.0,3254.0,0.944,17.18,8,7,4,3,1,0,1,0,0.0,0.0
1006,1620,25-09-2019 17:38:00,1,3399.5,3175.5,0.934,16.909,1,0,0,0,1,1,0,0,0.0,0.0
1006,1621,25-09-2019 17:40:00,1,3353.0,3097.0,0.924,16.638,0,0,0,0,0,0,0,0,0.0,0.0
1006,1622,25-09-2019 17:42:00,1,3116.0,2967.0,0.952,15.562,11,6,2,4,5,0,5,0,0.0,0.0
1006,1623,25-09-2019 17:44:00,1,3109.0,2999.0,0.965,15.572,0,0,0,0,0,0,0,0,0.0,0.0
1006,1624,25-09-2019 17:46:00,1,3100.0,3035.0,0.979,15.576,12,7,4,3,5,2,3,0,0.0,0.0
1006,1625,25-09-2019 17:48:00,1,3350.0,3142.0,0.938,16.677,5,0,0,0,5,0,5,0,0.01,0.01
1006,1626,25-09-2019 17:50:00,1,3349.0,3140.0,0.937,16.672,0,0,0,0,0,0,0,0,0.0,0.0
1006,1627,25-09-2019 17:52:00,1,3345.0,3129.0,0.935,16.641,1,1,1,0,0,0,0,0,0.0,0.0
1006,1628,25-09-2019 17:54:00,1,3348.0,3134.0,0.936,16.662,3,3,0,3,0,0,0,0,0.0,0.0
1006,1629,25-09-2019 17:56:00,1,3346.0,3123.0,0.933,16.642,123,99,56,43,24,6,18,15,0.0,0.0
1006,1630,25-09-2019 17:58:00,1,3333.0,3242.0,0.973,16.722,73,56,32,24,17,4,13,0,0.0,0.0
1006,1631,25-09-2019 18:00:00,0,3318.0,3244.0,0.978,16.663,0,0,0,0,0,0,0,0,0.0,0.0
1006,1632,25-09-2019 18:02:00,0,3347.0,3154.0,0.942,16.678,12,11,5,6,1,0,1,0,0.0,0.0
1006,1633,25-09-2019 18:04:00,0,3106.0,3057.0,0.984,15.621,63,39,14,25,24,17,7,0,0.0,0.0
1006,1634,25-09-2019 18:06:00,0,3224.0,3102.0,0.962,16.135,508,285,228,57,223,176,47,123,0.0,0.0
1006,1635,25-09-2019 18:08:00,0,3550.0,3404.0,0.959,17.755,297,198,151,47,99,61,38,87,0.0,0.01
1006,1636,25-09-2019 18:10:00,0,3868.0,3671.0,0.949,19.305,315,191,134,57,124,70,54,103,0.0,0.0
1006,1637,25-09-2019 18:12:00,0,4026.0,3863.5,0.959,20.141,140,99,64,35,41,0,41,75,0.0,0.09
1006,1638,25-09-2019 18:14:00,0,4184.0,4056.0,0.969,20.977,411,252,194,58,159,109,50,50,0.05,0.01
1006,1639,25-09-2019 18:16:00,0,3528.0,3442.0,0.976,17.711,169,94,64,30,75,46,29,45,0.01,0.02
1006,1640,25-09-2019 18:18:00,0,3114.0,3025.0,0.971,15.617,48,20,7,13,28,0,28,3,0.0,0.0
1006,1641,25-09-2019 18:20:00,0,3352.0,3142.0,0.937,16.685,15,6,1,5,9,0,9,0,0.0,0.0
1006,1642,25-09-2019 18:22:00,0,3777.0,3530.0,0.935,18.791,69,50,25,25,19,2,17,0,0.0,0.0
1006,1643,25-09-2019 18:24:00,0,3990.0,3771.0,0.945,19.893,221,152,126,26,69,46,23,22,0.0,0.03
1006,1644,25-09-2019 18:26:00,0,4264.0,4286.0,1.005,21.545,146,104,66,38,42,9,33,61,0.0,0.0
1006,1645,25-09-2019 18:28:00,0,4763.0,4848.0,1.018,24.134,96,54,22,32,42,10,32,37,0.06,0.06
1006,1646,25-09-2019 18:30:00,0,4828.0,4717.0,0.977,24.245,281,163,122,41,118,84,34,73,0.01,0.01
1006,1647,25-09-2019 18:32:00,0,4079.0,3899.0,0.956,20.388,38,21,4,17,17,8,9,0,0.01,0.01
1006,1648,25-09-2019 18:34:00,0,3991.0,3828.0,0.959,19.962,103,49,20,29,54,17,37,0,0.0,0.0
1006,1649,25-09-2019 18:36:00,0,4077.0,3957.0,0.971,20.444,34,19,4,15,15,0,15,0,0.0,0.0
1006,1650,25-09-2019 18:38:00,0,4066.0,3990.0,0.981,20.436,3,2,1,1,1,0,1,0,0.0,0.0
1006,1651,25-09-2019 18:40:00,0,4111.0,3854.0,0.938,20.462,24,13,0,13,11,0,11,0,0.0,0.0
1006,1652,25-09-2019 18:42:00,0,4255.0,4212.0,0.99,21.43,59,40,19,21,19,1,18,0,0.0,0.0
1006,1653,25-09-2019 18:44:00,0,4360.0,4403.0,1.01,22.051,92,81,53,28,11,4,7,0,0.0,0.0
1006,1654,25-09-2019 18:46:00,0,4482.5,4444.5,0.992,22.58,134,94,55,39,40,21,19,6,0.0,0.0
1006,1655,25-09-2019 18:48:00,0,4605.0,4486.0,0.974,23.109,120,82,53,29,38,7,31,51,0.02,0.0
1006,1656,25-09-2019 18:50:00,0,4775.0,4848.0,1.015,24.18,133,86,46,40,47,7,40,45,0.03,0.06
1006,1657,25-09-2019 18:52:00,0,4780.0,4906.0,1.026,24.264,91,46,36,10,45,30,15,3,0.06,0.03
1006,1658,25-09-2019 18:54:00,0,3512.0,3514.0,1.001,17.727,3,3,2,1,0,0,0,0,0.0,0.0
1006,1659,25-09-2019 18:56:00,0,3330.0,3219.0,0.967,16.681,1,1,0,1,0,0,0,0,0.0,0.01
1006,1660,25-09-2019 18:58:00,0,3342.0,3183.0,0.952,16.693,4,4,0,4,0,0,0,0,0.0,0.0
1006,1661,25-09-2019 19:00:00,0,3535.0,3429.0,0.97,17.722,13,6,1,5,7,3,4,0,0.0,0.0
1006,1662,25-09-2019 19:02:00,0,3635.0,3571.0,0.983,18.274,3,0,0,0,3,0,3,0,0.0,0.0
1006,1663,25-09-2019 19:04:00,0,3768.0,3634.0,0.964,18.869,108,77,48,29,31,7,24,15,0.01,0.0
1006,1664,25-09-2019 19:06:00,0,4247.0,4279.0,1.008,21.47,143,107,69,38,36,2,34,53,0.0,0.01
1006,1665,25-09-2019 19:08:00,0,4808.0,4761.0,0.99,24.214,129,95,57,38,34,0,34,59,0.0,0.09
1006,1666,25-09-2019 19:10:00,0,4874.0,5026.0,1.031,24.766,158,76,54,22,82,53,29,22,0.12,0.03
1006,1667,25-09-2019 19:12:00,0,3846.0,3813.0,0.991,19.374,0,0,0,0,0,0,0,0,0.0,0.01
1006,1668,25-09-2019 19:14:00,0,3284.0,3321.0,1.011,16.617,4,2,1,1,2,1,1,0,0.0,0.0
1006,1669,25-09-2019 19:16:00,0,3119.0,3003.0,0.963,15.613,4,4,0,4,0,0,0,0,0.0,0.0
1006,1670,25-09-2019 19:18:00,0,3117.0,2976.0,0.955,15.573,12,6,1,5,6,1,5,0,0.0,0.0
1006,1671,25-09-2019 19:20:00,0,3214.0,3148.0,0.979,16.1475,8,7,0,7,1,0,1,0,0.0,0.0
1006,1672,25-09-2019 19:22:00,0,3311.0,3320.0,1.003,16.722,1,1,0,1,0,0,0,0,0.0,0.0
1006,1673,25-09-2019 19:24:00,0,3536.0,3412.0,0.965,17.709,17,7,2,5,10,5,5,0,0.0,0.0
1006,1674,25-09-2019 19:26:00,0,3628.0,3611.0,0.995,18.29,144,112,76,36,32,5,27,32,0.0,0.0
1006,1675,25-09-2019 19:28:00,0,4542.0,4727.0,1.041,23.127,121,88,56,32,33,0,33,50,0.0,0.06
1006,1676,25-09-2019 19:30:00,0,4726.0,5061.0,1.071,24.223,97,67,38,29,30,0,30,58,0.0,0.08
1006,1677,25-09-2019 19:32:00,0,4853.0,5107.0,1.052,24.775,405,213,161,52,192,148,44,60,0.11,0.03
1006,1678,25-09-2019 19:34:00,0,3907.0,3994.0,1.022,19.814,52,24,7,17,28,13,15,5,0.0,0.01
1006,1679,25-09-2019 19:36:00,0,3292.0,3352.0,1.018,16.682,41,27,8,19,14,2,12,1,0.0,0.0
1006,1680,25-09-2019 19:38:00,0,3855.0,3769.0,0.977,19.362,64,45,7,38,19,2,17,0,0.0,0.0
1006,1681,25-09-2019 19:40:00,0,4060.0,4016.0,0.989,20.444,22,16,5,11,6,0,6,0,0.0,0.0
1006,1682,25-09-2019 19:42:00,0,3949.0,3929.0,0.995,19.91,6,5,4,1,1,0,1,0,0.0,0.0
1006,1683,25-09-2019 19:44:00,0,4044.0,4047.0,1.001,20.412,3,0,0,0,3,1,2,0,0.0,0.01
1006,1684,25-09-2019 19:46:00,0,4036.0,4143.0,1.026,20.488,119,79,59,20,40,6,34,26,0.0,0.0
1006,1685,25-09-2019 19:48:00,0,4732.0,4976.0,1.051,24.153,95,64,34,30,31,0,31,61,0.0,0.02
1006,1686,25-09-2019 19:50:00,0,5075.0,5282.0,1.041,25.844,79,57,27,30,22,0,22,57,0.0,0.07
1006,1687,25-09-2019 19:52:00,0,5077.0,5325.0,1.049,25.899,113,64,31,33,49,7,42,75,0.01,0.04
1006,1688,25-09-2019 19:54:00,0,4914.5,5114.5,1.0405,25.0245,262,181,129,52,81,47,34,30,0.1,0.03
1006,1689,25-09-2019 19:56:00,0,4752.0,4904.0,1.032,24.15,244,119,79,40,125,94,31,31,0.1,0.01
1006,1690,25-09-2019 19:58:00,0,3840.0,3846.0,1.002,19.385,56,41,29,12,15,10,5,10,0.01,0.01
1006,1691,25-09-2019 20:00:00,0,3285.0,3312.0,1.008,16.61,0,0,0,0,0,0,0,0,0.0,0.0
1006,1692,25-09-2019 20:02:00,0,3336.0,3164.0,0.949,16.645,4,3,0,3,1,1,0,0,0.0,0.0
1006,1693,25-09-2019 20:04:00,0,3231.0,3107.0,0.962,16.168,2,2,0,2,0,0,0,0,0.0,0.0
1006,1694,25-09-2019 20:06:00,0,3327.0,3183.0,0.957,16.634,0,0,0,0,0,0,0,0,0.0,0.0
1006,1695,25-09-2019 20:08:00,0,3546.0,3416.0,0.963,17.754,7,6,0,6,1,0,1,0,0.0,0.0
1006,1696,25-09-2019 20:10:00,0,3517.0,3525.0,1.002,17.76,0,0,0,0,0,0,0,0,0.0,0.0
1006,1697,25-09-2019 20:12:00,0,3852.0,3742.0,0.971,19.321,36,14,8,6,22,12,10,0,0.0,0.0
1006,1698,25-09-2019 20:14:00,0,3830.0,3895.0,1.017,19.403,0,0,0,0,0,0,0,0,0.0,0.0
1006,1699,25-09-2019 20:16:00,0,4054.0,4055.0,1.0,20.463,11,9,0,9,2,0,2,0,0.0,0.0
1006,1700,25-09-2019 20:18:00,0,4027.0,4143.0,1.029,20.452,7,5,0,5,2,1,1,0,0.0,0.0
1006,1701,25-09-2019 20:20:00,0,4238.0,4385.0,1.035,21.551,132,83,52,31,49,22,27,21,0.01,0.02
1006,1702,25-09-2019 20:22:00,0,4301.0,4645.0,1.08,22.089,160,123,74,49,37,4,33,78,0.0,0.0
1006,1703,25-09-2019 20:24:00,0,4723.0,5093.0,1.078,24.245,133,95,48,47,38,2,36,58,0.0,0.05
1006,1704,25-09-2019 20:26:00,0,5091.0,5250.0,1.031,25.871,69,47,23,24,22,1,21,45,0.0,0.33
1006,1705,25-09-2019 20:28:00,0,4653.0,4824.0,1.037,23.6735,83,41,33,8,42,32,10,3,0.05,0.02
1006,1706,25-09-2019 20:30:00,0,4215.0,4398.0,1.043,21.476,241,138,98,40,103,73,30,47,0.01,0.0
1006,1707,25-09-2019 20:32:00,0,4010.0,4226.0,1.054,20.476,267,197,150,47,70,51,19,74,0.0,0.0
1006,1708,25-09-2019 20:34:00,0,4525.0,4793.0,1.059,23.133,383,222,173,49,161,114,47,36,0.06,0.0
1006,1709,25-09-2019 20:36:00,0,3990.0,4255.0,1.066,20.431,52,23,7,16,29,12,17,3,0.0,0.0
1006,1710,25-09-2019 20:38:00,0,4061.0,4030.0,0.992,20.463,171,104,81,23,67,47,20,75,0.0,0.0
1006,1711,25-09-2019 20:40:00,0,4517.0,4798.0,1.062,23.109,116,68,47,21,48,30,18,1,0.0,0.0
1006,1712,25-09-2019 20:42:00,0,4741.0,4949.0,1.044,24.157,311,190,151,39,121,86,35,12,0.03,0.0
1006,1713,25-09-2019 20:44:00,0,4546.0,4750.0,1.045,23.168,67,34,19,15,33,15,18,0,0.0,0.0
1006,1714,25-09-2019 20:46:00,0,4039.0,4106.0,1.017,20.458,30,11,3,8,19,1,18,0,0.0,0.0
1006,1715,25-09-2019 20:48:00,0,4549.0,4607.0,1.013,23.021,50,22,4,18,28,9,19,4,0.0,0.0
1006,1716,25-09-2019 20:50:00,0,4776.0,4899.0,1.026,24.239,36,25,10,15,11,7,4,4,0.0,0.0
1006,1717,25-09-2019 20:52:00,0,4677.0,4814.0,1.029,23.754,49,31,6,25,18,2,16,0,0.0,0.0
1006,1718,25-09-2019 20:54:00,0,4761.0,4984.0,1.047,24.276,317,136,99,37,181,133,48,35,0.14,0.0
1006,1719,25-09-2019 20:56:00,0,4644.0,4841.0,1.042,23.656,17,6,5,1,11,5,6,0,0.01,0.0
1006,1720,25-09-2019 20:58:00,0,4338.0,4555.0,1.05,22.136,1,0,0,0,1,0,1,0,0.0,0.0
1006,1721,25-09-2019 21:00:00,0,4235.0,4324.0,1.021,21.471,0,0,0,0,0,0,0,0,0.0,0.0
1006,1722,25-09-2019 21:02:00,0,4233.5,4361.0,1.03,21.507,24,22,21,1,2,1,1,0,0.0,0.0
1006,1723,25-09-2019 21:04:00,0,4232.0,4398.0,1.039,21.543,25,22,8,14,3,0,3,0,0.0,0.0
1006,1724,25-09-2019 21:06:00,0,4553.0,4716.0,1.036,23.157,138,107,66,41,31,7,24,17,0.01,0.13
1006,1725,25-09-2019 21:08:00,0,4639.0,4812.0,1.037,23.604,31,21,7,14,10,2,8,1,0.0,0.0
1006,1726,25-09-2019 21:10:00,0,4537.0,4732.0,1.043,23.113,184,116,78,38,68,39,29,11,0.0,0.0
1006,1727,25-09-2019 21:12:00,0,4232.0,4421.0,1.045,21.568,170,88,55,33,82,51,31,55,0.0,0.0
1006,1728,25-09-2019 21:14:00,0,4001.0,4282.0,1.07,20.503,167,105,73,32,62,40,22,0,0.0,0.0
1006,1729,25-09-2019 21:16:00,0,4190.0,4543.0,1.084,21.538,175,97,76,21,78,51,27,21,0.0,0.02
1006,1730,25-09-2019 21:18:00,0,4011.0,4221.0,1.052,20.476,81,52,37,15,29,14,15,41,0.0,0.0
1006,1731,25-09-2019 21:20:00,0,4123.0,4295.0,1.042,20.998,182,113,75,38,69,45,24,44,0.0,0.0
1006,1732,25-09-2019 21:22:00,0,4319.0,4533.0,1.05,22.035,93,40,23,17,53,19,34,6,0.0,0.0
1006,1733,25-09-2019 21:24:00,0,4562.0,4599.0,1.008,23.066,146,87,59,28,59,30,29,45,0.03,0.0
1006,1734,25-09-2019 21:26:00,0,4011.0,4172.0,1.04,20.422,233,164,122,42,69,18,51,92,0.0,0.0
1006,1735,25-09-2019 21:28:00,0,4557.0,4642.0,1.019,23.092,184,146,93,53,38,2,36,71,0.03,0.0
1006,1736,25-09-2019 21:30:00,0,4521.0,4789.0,1.059,23.112,97,67,43,24,30,4,26,75,0.0,0.05
1006,1737,25-09-2019 21:32:00,0,4788.0,4842.0,1.011,24.226,105,65,38,27,40,4,36,57,0.0,0.0
1006,1738,25-09-2019 21:34:00,0,4546.0,4728.0,1.04,23.144,187,131,90,41,56,33,23,1,0.0,0.0
1006,1739,25-09-2019 21:36:00,0,3926.0,3997.5,1.014,19.893,91,74,38,36,17,6,11,0,0.0,0.0
1006,1740,25-09-2019 21:38:00,0,3306.0,3267.0,0.988,16.642,22,19,8,11,3,0,3,0,0.0,0.0
1006,1741,25-09-2019 21:40:00,0,3085.0,3092.0,1.002,15.578,4,4,0,4,0,0,0,0,0.0,0.0
1006,1742,25-09-2019 21:42:00,0,3098.0,3063.0,0.989,15.596,0,0,0,0,0,0,0,0,0.0,0.0
1006,1743,25-09-2019 21:44:00,0,3225.0,3092.0,0.959,16.131,32,28,20,8,4,0,4,0,0.0,0.0
1006,1744,25-09-2019 21:46:00,0,3314.0,3288.0,0.992,16.697,11,10,1,9,1,0,1,0,0.0,0.0
1006,1745,25-09-2019 21:48:00,0,3340.0,3186.0,0.954,16.688,1,1,0,1,0,0,0,0,0.0,0.0
1006,1746,25-09-2019 21:50:00,0,3219.0,3120.0,0.969,16.136,1,1,0,1,0,0,0,0,0.0,0.0
1006,1747,25-09-2019 21:52:00,0,3013.0,2902.0,0.963,15.084,10,10,4,6,0,0,0,0,0.0,0.0
1006,1748,25-09-2019 21:54:00,0,3098.0,3043.0,0.982,15.576,4,4,1,3,0,0,0,0,0.0,0.0
1006,1749,25-09-2019 21:56:00,0,3297.0,3316.0,1.006,16.663,12,12,1,11,0,0,0,0,0.0,0.0
1006,1750,25-09-2019 21:58:00,0,3495.0,3587.0,1.026,17.742,1,1,0,1,0,0,0,0,0.0,0.0
1006,1751,25-09-2019 22:00:00,0,3733.0,3731.0,0.999,18.839,1,1,0,1,0,0,0,0,0.0,0.0
1006,1752,25-09-2019 22:02:00,0,3722.0,3798.0,1.02,18.869,99,70,43,27,29,16,13,0,0.0,0.0
1006,1753,25-09-2019 22:04:00,0,4158.0,4611.0,1.109,21.486,235,136,98,38,99,58,41,42,0.0,0.0
1006,1754,25-09-2019 22:06:00,0,4536.0,4792.0,1.056,23.175,340,209,171,38,131,98,33,93,0.0,0.0
1006,1755,25-09-2019 22:08:00,0,4403.0,4682.0,1.063,22.53,66,35,14,21,31,7,24,0,0.0,0.0
1006,1756,25-09-2019 22:10:00,0,4464.0,4736.0,1.061,22.8295,128,69,40,29,59,25,34,5,0.0,0.0
1006,1757,25-09-2019 22:12:00,0,4525.0,4790.0,1.059,23.129,252,166,119,47,86,53,33,42,0.0,0.0
1006,1758,25-09-2019 22:14:00,0,4637.0,4888.0,1.054,23.682,173,121,84,37,52,21,31,98,0.0,0.03
1006,1759,25-09-2019 22:16:00,0,4516.0,4852.0,1.074,23.163,409,263,207,56,146,100,46,50,0.11,0.02
1006,1760,25-09-2019 22:18:00,0,4486.0,4836.0,1.078,23.028,456,271,212,59,185,132,53,57,0.03,0.01
1006,1761,25-09-2019 22:20:00,0,4112.0,4303.0,1.046,20.966,338,229,183,46,109,74,35,34,0.0,0.0
1006,1762,25-09-2019 22:22:00,0,4540.0,4774.0,1.051,23.174,186,127,86,41,59,16,43,54,0.0,0.01
1006,1763,25-09-2019 22:24:00,0,4835.0,5148.0,1.065,24.748,215,140,97,43,75,37,38,39,0.0,0.01
1006,1764,25-09-2019 22:26:00,0,3986.0,4304.0,1.08,20.471,42,19,5,14,23,7,16,0,0.0,0.01
1006,1765,25-09-2019 22:28:00,0,4022.0,4126.0,1.026,20.416,55,35,11,24,20,1,19,1,0.0,0.01
1006,1766,25-09-2019 22:30:00,0,4239.0,4377.0,1.033,21.548,41,16,5,11,25,1,24,0,0.0,0.0
1006,1767,25-09-2019 22:32:00,0,4328.0,4491.0,1.038,22.022,37,18,5,13,19,1,18,0,0.0,0.01
1006,1768,25-09-2019 22:34:00,0,4540.0,4785.0,1.054,23.183,7,0,0,0,7,0,7,0,0.0,0.0
1006,1769,25-09-2019 22:36:00,0,4321.0,4534.0,1.049,22.043,11,0,0,0,11,0,11,0,0.0,0.0
1006,1770,25-09-2019 22:38:00,0,4205.0,4472.0,1.064,21.517,1,0,0,0,1,0,1,0,0.0,0.0
1006,1771,25-09-2019 22:40:00,0,4235.0,4400.0,1.039,21.556,2,2,1,1,0,0,0,0,0.0,0.0
1006,1772,25-09-2019 22:42:00,0,4104.0,4333.0,1.056,20.964,5,4,0,4,1,0,1,0,0.0,0.0
1006,1773,25-09-2019 22:44:00,0,3959.0,4165.0,1.052,20.208,3,2,0,2,1,0,1,0,0.01,0.0
1006,1774,25-09-2019 22:46:00,0,3814.0,3997.0,1.048,19.452,25,19,11,8,6,0,6,0,0.0,0.0
1006,1775,25-09-2019 22:48:00,0,3807.0,3928.0,1.032,19.345,5,4,1,3,1,0,1,0,0.0,0.0
1006,1776,25-09-2019 22:50:00,0,3818.0,3884.0,1.017,19.341,3,1,0,1,2,0,2,0,0.0,0.0
1006,1777,25-09-2019 22:52:00,0,3589.0,3790.0,1.056,18.337,94,62,44,18,32,1,31,36,0.0,0.0
1006,1778,25-09-2019 22:54:00,0,3912.0,4014.0,1.026,19.857,188,130,87,43,58,4,54,90,0.0,0.0
1006,1779,25-09-2019 22:56:00,0,4242.0,4369.0,1.03,21.549,151,97,57,40,54,0,54,91,0.0,0.0
1006,1780,25-09-2019 22:58:00,0,4440.0,4621.0,1.041,22.608,212,143,99,44,69,19,50,91,0.0,0.07
1006,1781,25-09-2019 23:00:00,0,4238.0,4360.0,1.029,21.524,348,190,149,41,158,112,46,101,0.0,0.09
1006,1782,25-09-2019 23:02:00,0,4010.0,4227.0,1.054,20.478,206,133,98,35,73,46,27,9,0.0,0.0
1006,1783,25-09-2019 23:04:00,0,4035.0,4156.0,1.03,20.499,448,250,211,39,198,156,42,150,0.0,0.0
1006,1784,25-09-2019 23:06:00,0,3990.0,4276.0,1.071,20.455,363,257,209,48,106,74,32,212,0.0,0.0
1006,1785,25-09-2019 23:08:00,0,4312.0,4523.0,1.049,21.996,392,248,189,59,144,111,33,112,0.07,0.0
1006,1786,25-09-2019 23:10:00,0,4233.0,4374.0,1.033,21.522,117,72,58,14,45,26,19,33,0.0,0.0
1006,1787,25-09-2019 23:12:00,0,4221.0,4400.0,1.042,21.502,98,64,36,28,34,16,18,6,0.0,0.0
1006,1788,25-09-2019 23:14:00,0,4014.0,4199.0,1.046,20.464,225,148,97,51,77,31,46,69,0.01,0.0
1006,1789,25-09-2019 23:16:00,0,4793.0,4807.0,1.003,24.204,196,129,76,53,67,19,48,92,0.0,0.0
1006,1790,25-09-2019 23:18:00,0,4786.5,4803.0,1.0035,24.1755,149,89,57,32,60,20,40,44,0.07,0.06
1006,1791,25-09-2019 23:20:00,0,4780.0,4799.0,1.004,24.147,160,110,73,37,50,2,48,68,0.0,0.0
1006,1792,25-09-2019 23:22:00,0,4757.0,4941.0,1.039,24.213,177,132,97,35,45,8,37,51,0.0,0.03
1006,1793,25-09-2019 23:24:00,0,4058.0,4049.0,0.998,20.471,64,38,9,29,26,2,24,0,0.01,0.0
1006,1794,25-09-2019 23:26:00,0,3410.0,3359.0,0.985,17.153,58,17,1,16,41,2,39,0,0.0,0.0
1006,1795,25-09-2019 23:28:00,0,3317.0,3204.0,0.966,16.616,56,23,6,17,33,0,33,0,0.0,0.0
1006,1796,25-09-2019 23:30:00,0,3553.0,3415.0,0.961,17.778,31,18,8,10,13,5,8,0,0.0,0.0
1006,1797,25-09-2019 23:32:00,0,3529.0,3448.0,0.977,17.722,53,38,8,30,15,0,15,0,0.0,0.0
1006,1798,25-09-2019 23:34:00,0,3333.0,3236.0,0.971,16.714,40,37,4,33,3,0,3,0,0.0,0.0
1006,1799,25-09-2019 23:36:00,0,3318.0,3255.0,0.981,16.675,49,47,0,47,2,0,2,0,0.01,0.0
1006,1800,25-09-2019 23:38:00,0,3554.0,3373.0,0.949,17.738,65,64,21,43,1,0,1,0,0.0,0.0
1006,1801,25-09-2019 23:40:00,0,3551.0,3418.0,0.963,17.776,27,27,3,24,0,0,0,0,0.0,0.0
1006,1802,25-09-2019 23:42:00,0,3411.0,3346.0,0.981,17.142,24,24,3,21,0,0,0,0,0.0,0.0
1006,1803,25-09-2019 23:44:00,0,3548.0,3421.0,0.964,17.765,19,19,5,14,0,0,0,0,0.0,0.0
1006,1804,25-09-2019 23:46:00,0,3530.0,3469.0,0.983,17.748,22,22,0,22,0,0,0,0,0.0,0.0
1006,1805,25-09-2019 23:48:00,0,3502.0,3565.0,1.018,17.746,50,23,7,16,27,0,27,0,0.0,0.0
1006,1806,25-09-2019 23:50:00,0,3486.0,3612.0,1.036,17.735,50,41,27,14,9,5,4,0,0.0,0.0
1006,1807,25-09-2019 23:52:00,0,3612.5,3682.5,1.02,18.3095,29,26,7,19,3,0,3,0,0.0,0.0
1006,1808,25-09-2019 23:54:00,0,3739.0,3753.0,1.004,18.884,22,21,16,5,1,0,1,0,0.0,0.0
1006,1809,25-09-2019 23:56:00,0,3709.0,3788.0,1.021,18.807,11,11,7,4,0,0,0,0,0.0,0.0
1006,1810,25-09-2019 23:58:00,0,3819.0,3885.0,1.017,19.346,28,26,15,11,2,0,2,0,0.0,0.0
1006,1811,26-09-2019 00:00:00,0,3468.0,3744.0,1.08,17.81,8,8,5,3,0,0,0,0,0.0,0.0
1006,1812,26-09-2019 00:02:00,0,3486.0,3599.0,1.032,17.72,63,47,21,26,16,2,14,0,0.0,0.0
1006,1813,26-09-2019 00:04:00,0,4035.0,4116.0,1.02,20.454,281,186,138,48,95,62,33,60,0.0,0.0
1006,1814,26-09-2019 00:06:00,0,3999.0,4268.0,1.067,20.481,104,71,32,39,33,7,26,30,0.0,0.16
1006,1815,26-09-2019 00:08:00,0,4430.0,4643.0,1.048,22.594,166,109,71,38,57,1,56,86,0.0,0.0
1006,1816,26-09-2019 00:10:00,0,4552.0,4725.0,1.038,23.165,265,174,123,51,91,43,48,100,0.0,0.0
1006,1817,26-09-2019 00:12:00,0,4448.0,4597.0,1.033,22.613,173,114,69,45,59,4,55,62,0.0,0.0
1006,1818,26-09-2019 00:14:00,0,4533.0,4801.0,1.059,23.175,153,104,74,30,49,10,39,64,0.08,0.0
1006,1819,26-09-2019 00:16:00,0,4328.0,4550.0,1.051,22.089,341,246,184,62,95,60,35,27,0.01,0.0
1006,1820,26-09-2019 00:18:00,0,4337.0,4463.0,1.029,22.03,105,69,48,21,36,1,35,48,0.01,0.0
1006,1821,26-09-2019 00:20:00,0,4197.0,4461.0,1.063,21.472,334,161,125,36,173,121,52,76,0.0,0.0
1006,1822,26-09-2019 00:22:00,0,4052.0,4041.0,0.997,20.439,151,61,35,26,90,65,25,10,0.0,0.0
1006,1823,26-09-2019 00:24:00,0,3301.0,3260.0,0.988,16.614,11,2,1,1,9,2,7,0,0.0,0.0
1006,1824,26-09-2019 00:26:00,0,3202.0,3165.5,0.9885,16.1205,4,0,0,0,4,0,4,0,0.0,0.0
1006,1825,26-09-2019 00:28:00,0,3103.0,3071.0,0.989,15.627,10,1,1,0,9,3,6,0,0.0,0.0
1006,1826,26-09-2019 00:30:00,0,3217.0,3093.0,0.962,16.098,5,1,1,0,4,1,3,0,0.0,0.0
1006,1827,26-09-2019 00:32:00,0,3318.0,3257.0,0.982,16.678,4,0,0,0,4,0,4,0,0.0,0.0
1006,1828,26-09-2019 00:34:00,0,3424.0,3368.0,0.984,17.217,9,2,1,1,7,2,5,0,0.0,0.0
1006,1829,26-09-2019 00:36:00,0,3520.0,3469.0,0.985,17.708,0,0,0,0,0,0,0,0,0.0,0.0
1006,1830,26-09-2019 00:38:00,0,3498.0,3611.0,1.032,17.779,1,1,0,1,0,0,0,0,0.0,0.0
1006,1831,26-09-2019 00:40:00,0,3843.0,3767.0,0.98,19.31,50,31,6,25,19,7,12,0,0.0,0.0
1006,1832,26-09-2019 00:42:00,0,4234.0,4417.0,1.043,21.571,71,34,11,23,37,10,27,9,0.0,0.0
1006,1833,26-09-2019 00:44:00,0,4309.0,4625.0,1.073,22.097,27,13,4,9,14,1,13,0,0.01,0.0
1006,1834,26-09-2019 00:46:00,0,4179.0,4514.0,1.08,21.463,388,209,154,55,179,130,49,50,0.0,0.0
1006,1835,26-09-2019 00:48:00,0,4189.0,4548.0,1.086,21.54,274,206,156,50,68,38,30,105,0.0,0.0
1006,1836,26-09-2019 00:50:00,0,4446.0,4602.0,1.035,22.612,158,102,65,37,56,14,42,76,0.0,0.0
1006,1837,26-09-2019 00:52:00,0,4778.0,4920.0,1.03,24.272,155,112,72,40,43,2,41,80,0.0,0.04
1006,1838,26-09-2019 00:54:00,0,4745.0,4971.0,1.047,24.199,130,97,54,43,33,2,31,45,0.0,0.11
1006,1839,26-09-2019 00:56:00,0,4733.0,5010.0,1.059,24.194,180,110,67,43,70,41,29,55,0.06,0.04
1006,1840,26-09-2019 00:58:00,0,4004.0,4203.0,1.05,20.427,50,41,17,24,9,0,9,2,0.01,0.01
1006,1841,26-09-2019 01:00:00,0,3783.5,3776.5,0.995,19.087,156,120,74,46,36,6,30,1,0.0,0.0
1006,1842,26-09-2019 01:02:00,0,3563.0,3350.0,0.94,17.747,41,21,5,16,20,0,20,0,0.0,0.0
1006,1843,26-09-2019 01:04:00,0,3546.0,3421.0,0.965,17.757,36,33,16,17,3,0,3,0,0.0,0.02
1006,1844,26-09-2019 01:06:00,0,3879.0,3688.0,0.951,19.367,0,0,0,0,0,0,0,0,0.0,0.0
1006,1845,26-09-2019 01:08:00,0,3858.0,3700.0,0.959,19.295,0,0,0,0,0,0,0,0,0.0,0.0
1006,1846,26-09-2019 01:10:00,0,3845.0,3817.0,0.993,19.373,0,0,0,0,0,0,0,0,0.0,0.0
1006,1847,26-09-2019 01:12:00,0,3835.0,3830.0,0.999,19.351,7,5,3,2,2,0,2,0,0.0,0.0
1006,1848,26-09-2019 01:14:00,0,3833.0,3830.0,0.999,19.34,308,194,134,60,114,72,42,3,0.0,0.0
1006,1849,26-09-2019 01:16:00,0,4325.0,4548.0,1.052,22.076,567,328,242,86,239,173,66,13,0.03,0.0
1006,1850,26-09-2019 01:18:00,0,4563.0,4715.0,1.033,23.197,219,144,106,38,75,54,21,57,0.07,0.0
1006,1851,26-09-2019 01:20:00,0,4647.0,4866.0,1.047,23.697,189,125,82,43,64,35,29,68,0.01,0.02
1006,1852,26-09-2019 01:22:00,0,4786.0,4848.0,1.013,24.223,154,119,86,33,35,2,33,65,0.0,0.0
1006,1853,26-09-2019 01:24:00,0,4783.0,4903.0,1.025,24.271,269,157,112,45,112,72,40,42,0.1,0.07
1006,1854,26-09-2019 01:26:00,0,3928.0,4028.0,1.025,19.936,170,104,60,44,66,36,30,25,0.0,0.01
1006,1855,26-09-2019 01:28:00,0,3309.0,3213.0,0.971,16.596,67,43,26,17,24,6,18,0,0.0,0.0
1006,1856,26-09-2019 01:30:00,0,3089.0,3087.0,0.999,15.587,76,51,22,29,25,0,25,0,0.0,0.0
1006,1857,26-09-2019 01:32:00,0,3639.0,3588.0,0.986,18.311,7,3,0,3,4,0,4,0,0.0,0.0
1006,1858,26-09-2019 01:34:00,0,3531.5,3462.0,0.98,17.7475,0,0,0,0,0,0,0,0,0.0,0.0
1006,1859,26-09-2019 01:36:00,0,3424.0,3336.0,0.974,17.184,0,0,0,0,0,0,0,0,0.0,0.0
1006,1860,26-09-2019 01:38:00,0,3515.0,3531.0,1.005,17.757,0,0,0,0,0,0,0,0,0.0,0.0
1006,1861,26-09-2019 01:40:00,0,3749.0,3682.0,0.982,18.847,1,1,0,1,0,0,0,0,0.0,0.0
1006,1862,26-09-2019 01:42:00,0,3857.0,3784.0,0.981,19.384,0,0,0,0,0,0,0,0,0.0,0.0
1006,1863,26-09-2019 01:44:00,0,3840.0,3786.0,0.986,19.32,14,8,5,3,6,1,5,0,0.0,0.0
1006,1864,26-09-2019 01:46:00,0,3803.0,3964.0,1.042,19.371,0,0,0,0,0,0,0,0,0.0,0.0
1006,1865,26-09-2019 01:48:00,0,3914.0,4030.0,1.03,19.882,2,0,0,0,2,1,1,0,0.0,0.0
1006,1866,26-09-2019 01:50:00,0,3974.0,4358.0,1.097,20.481,5,5,1,4,0,0,0,0,0.0,0.0
1006,1867,26-09-2019 01:52:00,0,4027.0,4139.0,1.028,20.446,16,15,1,14,1,0,1,0,0.0,0.0
1006,1868,26-09-2019 01:54:00,0,3799.0,3971.0,1.045,19.364,7,4,1,3,3,0,3,0,0.0,0.0
1006,1869,26-09-2019 01:56:00,0,3828.0,3869.0,1.011,19.366,7,4,0,4,3,0,3,0,0.02,0.0
1006,1870,26-09-2019 01:58:00,0,3837.0,3836.0,1.0,19.363,21,12,5,7,9,2,7,0,0.0,0.0
1006,1871,26-09-2019 02:00:00,0,3721.0,3791.0,1.019,18.859,61,43,24,19,18,8,10,0,0.0,0.0
1006,1872,26-09-2019 02:02:00,0,3830.0,3877.0,1.012,19.383,114,70,57,13,44,8,36,36,0.0,0.0
1006,1873,26-09-2019 02:04:00,0,4054.0,4048.0,0.999,20.455,123,80,49,31,43,4,39,67,0.0,0.03
1006,1874,26-09-2019 02:06:00,0,4231.0,4393.0,1.038,21.531,123,88,50,38,35,0,35,59,0.0,0.08
1006,1875,26-09-2019 02:08:00,0,4169.0,4352.0,1.044,21.242,96,65,26,39,31,5,26,40,0.0,0.05
1006,1876,26-09-2019 02:10:00,0,4107.0,4311.0,1.05,20.953,265,160,123,37,105,73,32,97,0.0,0.05
1006,1877,26-09-2019 02:12:00,0,3809.0,3941.0,1.035,19.37,268,137,105,32,131,105,26,86,0.0,0.0
1006,1878,26-09-2019 02:14:00,0,3847.0,3796.0,0.987,19.36,101,58,36,22,43,23,20,0,0.09,0.01
1006,1879,26-09-2019 02:16:00,0,4216.0,4420.0,1.048,21.502,155,83,59,24,72,37,35,89,0.0,0.02
1006,1880,26-09-2019 02:18:00,0,4447.0,4529.0,1.019,22.535,109,75,48,27,34,0,34,62,0.0,0.02
1006,1881,26-09-2019 02:20:00,0,4595.0,4592.0,0.999,23.187,158,116,88,28,42,13,29,53,0.14,0.03
1006,1882,26-09-2019 02:22:00,0,4000.0,4233.0,1.058,20.446,32,27,4,23,5,2,3,0,0.01,0.03
1006,1883,26-09-2019 02:24:00,0,3587.0,3664.0,1.021,18.191,150,102,65,37,48,24,24,1,0.0,0.0
1006,1884,26-09-2019 02:26:00,0,3864.0,3719.0,0.963,19.34,95,65,37,28,30,9,21,1,0.0,0.0
1006,1885,26-09-2019 02:28:00,0,3758.0,3634.0,0.967,18.828,245,187,139,48,58,28,30,9,0.0,0.03
1006,1886,26-09-2019 02:30:00,0,4334.0,4453.0,1.027,22.006,184,130,84,46,54,20,34,0,0.0,0.0
1006,1887,26-09-2019 02:32:00,0,4009.0,4207.0,1.049,20.452,47,34,24,10,13,5,8,0,0.0,0.0
1006,1888,26-09-2019 02:34:00,0,4067.0,3967.0,0.975,20.414,52,34,18,16,18,2,16,0,0.0,0.0
1006,1889,26-09-2019 02:36:00,0,4249.0,4318.0,1.016,21.519,25,16,2,14,9,0,9,0,0.0,0.0
1006,1890,26-09-2019 02:38:00,0,4201.0,4471.0,1.064,21.5,1,1,0,1,0,0,0,0,0.0,0.0
1006,1891,26-09-2019 02:40:00,0,4247.0,4324.0,1.018,21.521,7,4,2,2,3,0,3,0,0.0,0.0
1006,1892,26-09-2019 02:42:00,0,4024.5,4134.5,1.028,20.434,2,1,0,1,1,0,1,0,0.0,0.0
1006,1893,26-09-2019 02:44:00,0,3802.0,3945.0,1.038,19.347,0,0,0,0,0,0,0,0,0.0,0.0
1006,1894,26-09-2019 02:46:00,0,3848.0,3800.0,0.988,19.366,35,28,20,8,7,0,7,0,0.0,0.0
1006,1895,26-09-2019 02:48:00,0,3739.0,3675.0,0.983,18.801,206,137,93,44,69,35,34,0,0.0,0.0
1006,1896,26-09-2019 02:50:00,0,3843.0,3797.0,0.988,19.342,472,239,185,54,233,168,65,20,0.0,0.0
1006,1897,26-09-2019 02:52:00,0,3819.0,3885.0,1.017,19.347,311,151,113,38,160,117,43,25,0.0,0.0
1006,1898,26-09-2019 02:54:00,0,4066.0,4028.0,0.991,20.478,456,335,289,46,121,84,37,24,0.0,0.0
1006,1899,26-09-2019 02:56:00,0,4075.0,3984.0,0.978,20.465,513,369,304,65,144,107,37,16,0.0,0.0
1006,1900,26-09-2019 02:58:00,0,4031.0,4163.0,1.033,20.489,332,187,146,41,145,104,41,12,0.0,0.0
1006,1901,26-09-2019 03:00:00,0,3820.0,3916.0,1.025,19.384,49,27,12,15,22,3,19,1,0.0,0.0
1006,1902,26-09-2019 03:02:00,0,4058.0,3996.0,0.985,20.412,72,51,24,27,21,4,17,1,0.0,0.0
1006,1903,26-09-2019 03:04:00,0,4065.0,4012.0,0.987,20.456,79,64,35,29,15,1,14,0,0.0,0.0
1006,1904,26-09-2019 03:06:00,0,4070.0,3998.0,0.982,20.461,12,12,7,5,0,0,0,0,0.0,0.0
1006,1905,26-09-2019 03:08:00,0,3939.0,3937.0,0.999,19.878,0,0,0,0,0,0,0,0,0.0,0.0
1006,1906,26-09-2019 03:10:00,0,3859.0,3777.0,0.979,19.385,0,0,0,0,0,0,0,0,0.0,0.0
1006,1907,26-09-2019 03:12:00,0,3635.0,3624.0,0.997,18.335,0,0,0,0,0,0,0,0,0.0,0.0
1006,1908,26-09-2019 03:14:00,0,3527.0,3480.0,0.987,17.748,2,2,1,1,0,0,0,0,0.0,0.0
1006,1909,26-09-2019 03:16:00,0,3421.5,3360.5,0.9825,17.2,0,0,0,0,0,0,0,0,0.0,0.0
1006,1910,26-09-2019 03:18:00,0,3316.0,3241.0,0.978,16.652,3,3,0,3,0,0,0,0,0.0,0.0
1006,1911,26-09-2019 03:20:00,0,3337.0,3202.0,0.96,16.69,0,0,0,0,0,0,0,0,0.0,0.0
1006,1912,26-09-2019 03:22:00,0,3211.0,3136.0,0.977,16.122,2,1,0,1,1,1,0,0,0.0,0.0
1006,1913,26-09-2019 03:24:00,0,3223.0,3151.0,0.978,16.185,0,0,0,0,0,0,0,0,0.0,0.0
1006,1914,26-09-2019 03:26:00,0,3206.0,3128.0,0.976,16.093,34,16,9,7,18,4,14,0,0.0,0.0
1006,1915,26-09-2019 03:28:00,0,3206.0,3184.0,0.993,16.156,3,1,0,1,2,0,2,0,0.0,0.0
1006,1916,26-09-2019 03:30:00,0,3074.0,3134.0,1.02,15.583,2,0,0,0,2,0,2,0,0.0,0.0
1006,1917,26-09-2019 03:32:00,0,3083.0,3105.0,1.007,15.583,3,0,0,0,3,0,3,0,0.0,0.0
1006,1918,26-09-2019 03:34:00,0,3082.0,3126.0,1.014,15.602,3,1,1,0,2,0,2,0,0.0,0.0
1006,1919,26-09-2019 03:36:00,0,3085.0,3112.0,1.009,15.599,4,4,1,3,0,0,0,0,0.0,0.0
1006,1920,26-09-2019 03:38:00,0,3090.0,3073.0,0.994,15.576,14,14,5,9,0,0,0,0,0.0,0.0
1006,1921,26-09-2019 03:40:00,0,3100.0,3062.0,0.988,15.605,8,7,3,4,1,0,1,0,0.0,0.0
1006,1922,26-09-2019 03:42:00,0,3102.0,3059.0,0.986,15.607,51,46,16,30,5,2,3,0,0.0,0.0
1006,1923,26-09-2019 03:44:00,0,3203.0,3149.0,0.983,16.104,143,115,83,32,28,13,15,14,0.0,0.0
1006,1924,26-09-2019 03:46:00,0,3418.0,3364.0,0.984,17.19,262,170,123,47,92,58,34,48,0.0,0.0
1006,1925,26-09-2019 03:48:00,0,3546.0,3407.0,0.961,17.744,191,130,95,35,61,34,27,94,0.0,0.0
1006,1926,26-09-2019 03:50:00,0,3809.5,3696.5,0.9695,19.102,142,110,71,39,32,0,32,61,0.0,0.0
1006,1927,26-09-2019 03:52:00,0,4073.0,3986.0,0.978,20.46,75,41,27,14,34,18,16,24,0.0,0.05
1006,1928,26-09-2019 03:54:00,0,4072.0,3929.0,0.965,20.395,157,100,69,31,57,36,21,8,0.0,0.0
1006,1929,26-09-2019 03:56:00,0,3845.0,3751.0,0.976,19.3,298,170,125,45,128,83,45,95,0.0,0.02
1006,1930,26-09-2019 03:58:00,0,3852.0,3817.0,0.991,19.401,182,104,71,33,78,46,32,58,0.0,0.0
1006,1931,26-09-2019 04:00:00,0,3557.0,3373.0,0.948,17.75,57,28,12,16,29,3,26,0,0.0,0.0
1006,1932,26-09-2019 04:02:00,0,3518.0,3488.0,0.991,17.722,27,13,4,9,14,2,12,0,0.0,0.0
1006,1933,26-09-2019 04:04:00,0,3531.0,3504.0,0.992,17.791,1,1,0,1,0,0,0,0,0.0,0.02
1006,1934,26-09-2019 04:06:00,0,3650.0,3519.0,0.964,18.274,0,0,0,0,0,0,0,0,0.0,0.0
1006,1935,26-09-2019 04:08:00,0,3649.0,3535.0,0.969,18.291,1,1,0,1,0,0,0,0,0.0,0.0
1006,1936,26-09-2019 04:10:00,0,3506.0,3487.0,0.995,17.674,15,9,0,9,6,0,6,0,0.0,0.0
1006,1937,26-09-2019 04:12:00,0,3537.0,3449.0,0.975,17.754,46,30,9,21,16,2,14,0,0.0,0.0
1006,1938,26-09-2019 04:14:00,0,3523.0,3464.0,0.983,17.715,8,7,2,5,1,0,1,0,0.0,0.0
1006,1939,26-09-2019 04:16:00,0,3425.0,3344.0,0.976,17.198,5,3,0,3,2,0,2,0,0.0,0.0
1006,1940,26-09-2019 04:18:00,0,3330.0,3245.0,0.975,16.711,3,2,0,2,1,0,1,0,0.0,0.0
1006,1941,26-09-2019 04:20:00,0,3340.0,3161.0,0.947,16.657,3,2,0,2,1,0,1,0,0.0,0.01
1006,1942,26-09-2019 04:22:00,0,3090.0,3085.0,0.998,15.588,5,4,2,2,1,0,1,0,0.0,0.0
1006,1943,26-09-2019 04:24:00,0,3094.0,3073.5,0.9935,15.592,7,3,1,2,4,0,4,0,0.0,0.0
1006,1944,26-09-2019 04:26:00,0,3098.0,3062.0,0.989,15.596,6,5,3,2,1,0,1,0,0.0,0.0
1006,1945,26-09-2019 04:28:00,0,3096.0,3035.0,0.98,15.557,4,1,0,1,3,0,3,0,0.0,0.0
1006,1946,26-09-2019 04:30:00,0,3102.0,3044.0,0.981,15.593,2,0,0,0,2,0,2,0,0.0,0.0
1006,1947,26-09-2019 04:32:00,0,3097.0,3060.0,0.988,15.589,26,15,10,5,11,3,8,0,0.0,0.0
1006,1948,26-09-2019 04:34:00,0,3225.0,3112.0,0.965,16.153,2,1,1,0,1,0,1,0,0.0,0.0
1006,1949,26-09-2019 04:36:00,0,3219.0,3108.0,0.965,16.122,6,2,2,0,4,0,4,0,0.0,0.0
1006,1950,26-09-2019 04:38:00,0,3091.0,3062.0,0.991,15.569,22,17,9,8,5,1,4,0,0.0,0.0
1006,1951,26-09-2019 04:40:00,0,3099.0,3051.0,0.984,15.588,8,8,3,5,0,0,0,0,0.0,0.0
1006,1952,26-09-2019 04:42:00,0,3141.0,2954.0,0.941,15.647,3,3,0,3,0,0,0,0,0.0,0.0
1006,1953,26-09-2019 04:44:00,0,3121.0,2939.0,0.941,15.551,9,8,2,6,1,1,0,0,0.0,0.0
1006,1954,26-09-2019 04:46:00,0,3007.0,2847.0,0.947,15.001,16,15,0,15,1,0,1,0,0.0,0.0
1006,1955,26-09-2019 04:48:00,0,3020.0,2855.0,0.945,15.06,114,93,55,38,21,3,18,30,0.0,0.0
1006,1956,26-09-2019 04:50:00,0,3673.0,3436.0,0.936,18.274,117,71,44,27,46,6,40,72,0.0,0.0
1006,1957,26-09-2019 04:52:00,0,4118.0,3745.0,0.909,20.372,120,73,52,21,47,0,47,84,0.0,0.08
1006,1958,26-09-2019 04:54:00,0,4090.0,3933.0,0.962,20.469,86,58,32,26,28,0,28,63,0.0,0.1
1006,1959,26-09-2019 04:56:00,0,4289.0,4138.0,0.965,21.481,144,86,61,25,58,28,30,60,0.0,0.04
1006,1960,26-09-2019 04:58:00,0,4143.0,3937.0,0.95,20.6825,520,279,226,53,241,186,55,122,0.02,0.01
1006,1961,26-09-2019 05:00:00,0,3997.0,3736.0,0.935,19.884,312,152,116,36,160,111,49,5,0.07,0.08
1006,1962,26-09-2019 05:02:00,0,3554.0,3286.0,0.925,17.64,297,174,122,52,123,86,37,10,0.0,0.0
1006,1963,26-09-2019 05:04:00,0,4120.0,3773.0,0.916,20.41,267,198,147,51,69,47,22,15,0.06,0.0
1006,1964,26-09-2019 05:06:00,0,4104.0,3857.0,0.94,20.439,138,42,32,10,96,52,44,3,0.01,0.0
1006,1965,26-09-2019 05:08:00,0,4078.0,3869.0,0.949,20.351,305,160,128,32,145,101,44,25,0.0,0.0
1006,1966,26-09-2019 05:10:00,0,4060.0,4032.0,0.993,20.46,56,44,18,26,12,9,3,1,0.0,0.0
1006,1967,26-09-2019 05:12:00,0,4070.0,3946.0,0.97,20.405,38,38,22,16,0,0,0,0,0.0,0.0
1006,1968,26-09-2019 05:14:00,0,4051.0,4010.0,0.99,20.4,95,68,41,27,27,14,13,5,0.0,0.0
1006,1969,26-09-2019 05:16:00,0,4072.0,4008.0,0.984,20.479,101,64,43,21,37,16,21,0,0.01,0.0
1006,1970,26-09-2019 05:18:00,0,4054.0,4041.0,0.997,20.444,67,47,18,29,20,0,20,0,0.0,0.0
1006,1971,26-09-2019 05:20:00,0,4048.0,4041.0,0.998,20.424,23,21,8,13,2,1,1,0,0.0,0.0
1006,1972,26-09-2019 05:22:00,0,4059.0,4000.0,0.985,20.421,61,42,20,22,19,3,16,0,0.0,0.0
1006,1973,26-09-2019 05:24:00,0,4070.0,3983.0,0.978,20.446,2,1,0,1,1,0,1,0,0.0,0.0
1006,1974,26-09-2019 05:26:00,0,3980.0,3802.0,0.955,19.891,0,0,0,0,0,0,0,0,0.0,0.0
1006,1975,26-09-2019 05:28:00,0,3900.0,3657.0,0.938,19.416,2,2,1,1,0,0,0,0,0.0,0.0
1006,1976,26-09-2019 05:30:00,0,3657.0,3499.0,0.957,18.281,0,0,0,0,0,0,0,0,0.0,0.0
1006,1977,26-09-2019 05:32:00,0,3494.0,3368.0,0.9645,17.495,2,2,1,1,0,0,0,0,0.0,0.0
1006,1978,26-09-2019 05:34:00,0,3331.0,3237.0,0.972,16.709,3,2,1,1,1,0,1,0,0.0,0.0
1006,1979,26-09-2019 05:36:00,0,3336.0,3141.0,0.942,16.622,28,22,11,11,6,3,3,0,0.0,0.0
1006,1980,26-09-2019 05:38:00,0,3347.0,3150.0,0.941,16.674,0,0,0,0,0,0,0,0,0.0,0.0
1006,1981,26-09-2019 05:40:00,0,3230.0,3092.0,0.957,16.152,0,0,0,0,0,0,0,0,0.0,0.0
1006,1982,26-09-2019 05:42:00,0,3103.0,3043.0,0.98,15.596,2,2,1,1,0,0,0,0,0.0,0.0
1006,1983,26-09-2019 05:44:00,0,3107.0,3019.0,0.972,15.583,0,0,0,0,0,0,0,0,0.0,0.0
1006,1984,26-09-2019 05:46:00,0,3113.0,3014.0,0.968,15.603,10,7,3,4,3,1,2,0,0.0,0.0
1006,1985,26-09-2019 05:48:00,0,3134.0,2948.0,0.941,15.611,3,2,0,2,1,0,1,0,0.0,0.0
1006,1986,26-09-2019 05:50:00,0,3132.0,2961.0,0.945,15.617,8,6,1,5,2,0,2,0,0.0,0.0
1006,1987,26-09-2019 05:52:00,0,3118.0,2967.0,0.952,15.568,11,5,1,4,6,0,6,0,0.0,0.0
1006,1988,26-09-2019 05:54:00,0,3012.0,2902.0,0.963,15.081,14,13,6,7,1,1,0,0,0.0,0.0
1006,1989,26-09-2019 05:56:00,0,3109.0,2960.0,0.952,15.527,0,0,0,0,0,0,0,0,0.0,0.0
1006,1990,26-09-2019 05:58:00,0,3136.0,2922.0,0.932,15.592,51,37,12,25,14,3,11,0,0.0,0.0
1006,1991,26-09-2019 06:00:00,1,3254.0,2993.0,0.92,16.134,18,17,3,14,1,0,1,0,0.0,0.0
1006,1992,26-09-2019 06:02:00,1,3130.0,2920.0,0.933,15.565,158,158,121,37,0,0,0,0,0.0,0.0
1006,1993,26-09-2019 06:04:00,1,3150.0,2850.0,0.905,15.566,289,289,243,46,0,0,0,0,0.0,0.0
1006,1994,26-09-2019 06:06:00,1,3091.0,2826.0,0.9145,15.308,29,20,5,15,9,2,7,0,0.0,0.0
1006,1995,26-09-2019 06:08:00,1,3032.0,2802.0,0.924,15.05,14,14,0,14,0,0,0,0,0.0,0.0
1006,1996,26-09-2019 06:10:00,1,3053.0,2722.0,0.892,15.044,4,4,0,4,0,0,0,0,0.0,0.0
1006,1997,26-09-2019 06:12:00,1,2922.0,2672.0,0.914,14.472,9,9,0,9,0,0,0,0,0.0,0.0
1006,1998,26-09-2019 06:14:00,1,2806.0,2662.0,0.949,14.002,2,0,0,0,2,1,1,0,0.0,0.0
1006,1999,26-09-2019 06:16:00,1,2934.0,2663.0,0.908,14.508,5,2,0,2,3,0,3,0,0.0,0.0
1006,2000,26-09-2019 06:18:00,1,3058.0,2696.0,0.882,15.031,0,0,0,0,0,0,0,0,0.0,0.0
1006,2001,26-09-2019 06:20:00,1,3066.0,2703.0,0.882,15.073,70,47,29,18,23,13,10,0,0.0,0.0
1006,2002,26-09-2019 06:22:00,1,3149.0,2864.0,0.91,15.578,89,65,45,20,24,10,14,9,0.0,0.0
1006,2003,26-09-2019 06:24:00,1,3593.0,3200.0,0.891,17.698,69,51,28,23,18,0,18,39,0.0,0.0
1006,2004,26-09-2019 06:26:00,1,3909.0,3587.0,0.918,19.375,119,64,50,14,55,28,27,40,0.0,0.3
1006,2005,26-09-2019 06:28:00,1,3804.0,3445.0,0.905,18.803,330,192,140,52,138,97,41,103,0.0,0.0
1006,2006,26-09-2019 06:30:00,1,3554.0,3390.0,0.954,17.755,82,42,31,11,40,24,16,7,0.0,0.0
1006,2007,26-09-2019 06:32:00,1,3907.0,3542.0,0.907,19.314,101,47,41,6,54,34,20,5,0.06,0.0
1006,2008,26-09-2019 06:34:00,1,3785.0,3460.0,0.914,18.741,80,68,36,32,12,3,9,0,0.01,0.0
1006,2009,26-09-2019 06:36:00,1,3682.0,3421.0,0.929,18.293,30,18,7,11,12,2,10,0,0.0,0.0
1006,2010,26-09-2019 06:38:00,1,3881.0,3657.0,0.942,19.34,5,5,0,5,0,0,0,0,0.0,0.0
1006,2011,26-09-2019 06:40:00,1,3938.5,3702.0,0.94,19.6165,0,0,0,0,0,0,0,0,0.0,0.0
1006,2012,26-09-2019 06:42:00,1,3996.0,3747.0,0.938,19.893,14,10,1,9,4,0,4,0,0.0,0.0
1006,2013,26-09-2019 06:44:00,1,4115.0,3804.0,0.924,20.423,6,6,0,6,0,0,0,0,0.0,0.0
1006,2014,26-09-2019 06:46:00,1,3865.0,3715.0,0.961,19.34,1,1,1,0,0,0,0,0,0.0,0.0
1006,2015,26-09-2019 06:48:00,1,3896.0,3573.0,0.917,19.306,0,0,0,0,0,0,0,0,0.0,0.0
1006,2016,26-09-2019 06:50:00,1,3533.0,3444.0,0.975,17.735,16,10,5,5,6,0,6,0,0.0,0.0
1006,2017,26-09-2019 06:52:00,1,3545.0,3410.0,0.962,17.742,0,0,0,0,0,0,0,0,0.0,0.0
1006,2018,26-09-2019 06:54:00,1,3438.0,3285.0,0.956,17.182,0,0,0,0,0,0,0,0,0.02,0.0
1006,2019,26-09-2019 06:56:00,1,3336.0,3215.0,0.964,16.702,5,5,1,4,0,0,0,0,0.0,0.0
1006,2020,26-09-2019 06:58:00,1,3350.0,3151.0,0.941,16.686,0,0,0,0,0,0,0,0,0.0,0.0
1006,2021,26-09-2019 07:00:00,1,3225.0,3101.0,0.962,16.138,8,7,4,3,1,0,1,0,0.0,0.01
1006,2022,26-09-2019 07:02:00,1,3089.0,3087.0,0.999,15.587,0,0,0,0,0,0,0,0,0.0,0.0
1006,2023,26-09-2019 07:04:00,1,3094.0,3066.0,0.991,15.584,0,0,0,0,0,0,0,0,0.0,0.0
1006,2024,26-09-2019 07:06:00,1,3095.0,3036.0,0.981,15.555,24,17,11,6,7,2,5,0,0.0,0.0
1006,2025,26-09-2019 07:08:00,1,3100.0,3069.0,0.99,15.613,0,0,0,0,0,0,0,0,0.0,0.0
1006,2026,26-09-2019 07:10:00,1,3104.0,3003.0,0.967,15.554,1,1,1,0,0,0,0,0,0.0,0.0
1006,2027,26-09-2019 07:12:00,1,3113.0,2979.0,0.957,15.563,4,4,0,4,0,0,0,0,0.0,0.0
1006,2028,26-09-2019 07:14:00,1,3056.5,2949.0,0.965,15.3065,0,0,0,0,0,0,0,0,0.0,0.0
1006,2029,26-09-2019 07:16:00,1,3000.0,2919.0,0.973,15.05,0,0,0,0,0,0,0,0,0.0,0.0
1006,2030,26-09-2019 07:18:00,1,3005.0,2921.0,0.972,15.073,0,0,0,0,0,0,0,0,0.0,0.0
1006,2031,26-09-2019 07:20:00,1,2998.0,2881.0,0.961,15.003,1,0,0,0,1,1,0,0,0.0,0.0
1006,2032,26-09-2019 07:22:00,1,3016.0,2863.0,0.949,15.052,1,1,0,1,0,0,0,0,0.0,0.0
1006,2033,26-09-2019 07:24:00,1,2890.0,2834.0,0.981,14.525,0,0,0,0,0,0,0,0,0.0,0.0
1006,2034,26-09-2019 07:26:00,1,2774.0,2764.0,0.996,13.991,0,0,0,0,0,0,0,0,0.0,0.0
1006,2035,26-09-2019 07:28:00,1,2774.0,2735.0,0.986,13.957,1,1,1,0,0,0,0,0,0.0,0.0
1006,2036,26-09-2019 07:30:00,1,2776.0,2737.0,0.986,13.967,14,14,0,14,0,0,0,0,0.0,0.0
1006,2037,26-09-2019 07:32:00,1,2782.0,2771.0,0.996,14.029,21,14,6,8,7,2,5,0,0.0,0.0
1006,2038,26-09-2019 07:34:00,1,3012.0,2861.0,0.95,15.037,115,99,74,25,16,5,11,3,0.0,0.0
1006,2039,26-09-2019 07:36:00,1,3005.0,2942.0,0.979,15.096,8,0,0,0,8,0,8,0,0.0,0.0
1006,2040,26-09-2019 07:38:00,1,3343.0,3123.0,0.934,16.628,300,180,134,46,120,83,37,103,0.0,0.01
1006,2041,26-09-2019 07:40:00,1,3529.0,3475.0,0.985,17.749,293,167,133,34,126,86,40,86,0.0,0.0
1006,2042,26-09-2019 07:42:00,1,3536.0,3476.0,0.983,17.781,61,24,21,3,37,22,15,0,0.0,0.0
1006,2043,26-09-2019 07:44:00,1,3541.0,3436.0,0.97,17.754,145,63,44,19,82,58,24,3,0.0,0.0
1006,2044,26-09-2019 07:46:00,1,3772.0,3527.0,0.935,18.767,211,94,61,33,117,87,30,0,0.0,0.0
1006,2045,26-09-2019 07:48:00,1,3780.5,3528.0,0.933,18.801,81,53,19,34,28,9,19,2,0.0,0.0
1006,2046,26-09-2019 07:50:00,1,3789.0,3529.0,0.931,18.835,28,20,7,13,8,4,4,0,0.0,0.0
1006,2047,26-09-2019 07:52:00,1,3891.0,3568.0,0.917,19.282,29,18,10,8,11,3,8,0,0.0,0.0
1006,2048,26-09-2019 07:54:00,1,3785.0,3570.0,0.943,18.866,12,9,4,5,3,0,3,0,0.0,0.0
1006,2049,26-09-2019 07:56:00,1,3531.0,3455.0,0.978,17.738,10,9,2,7,1,1,0,0,0.0,0.0
1006,2050,26-09-2019 07:58:00,1,3550.0,3392.0,0.955,17.741,4,3,1,2,1,0,1,0,0.0,0.0
1006,2051,26-09-2019 08:00:00,1,3446.0,3293.0,0.956,17.223,13,13,2,11,0,0,0,0,0.0,0.0
1006,2052,26-09-2019 08:02:00,1,3339.0,3179.0,0.952,16.676,5,5,0,5,0,0,0,0,0.0,0.0
1006,2053,26-09-2019 08:04:00,1,3224.0,3079.0,0.955,16.111,11,5,2,3,6,0,6,0,0.0,0.0
1006,2054,26-09-2019 08:06:00,1,3103.0,3064.0,0.988,15.617,0,0,0,0,0,0,0,0,0.0,0.0
1006,2055,26-09-2019 08:08:00,1,3111.0,2997.0,0.963,15.576,0,0,0,0,0,0,0,0,0.0,0.0
1006,2056,26-09-2019 08:10:00,1,3127.0,2964.0,0.948,15.602,0,0,0,0,0,0,0,0,0.0,0.0
1006,2057,26-09-2019 08:12:00,1,3005.0,2932.0,0.976,15.086,3,3,0,3,0,0,0,0,0.0,0.0
1006,2058,26-09-2019 08:14:00,1,2995.0,2895.0,0.967,15.007,0,0,0,0,0,0,0,0,0.0,0.0
1006,2059,26-09-2019 08:16:00,1,3015.0,2877.0,0.954,15.063,53,40,28,12,13,6,7,0,0.0,0.0
1006,2060,26-09-2019 08:18:00,1,2997.0,2879.0,0.96,14.995,206,120,84,36,86,54,32,28,0.0,0.0
1006,2061,26-09-2019 08:20:00,1,2967.0,3006.0,1.013,15.018,3,3,1,2,0,0,0,0,0.0,0.0
1006,2062,26-09-2019 08:22:00,1,2977.5,2959.5,0.994,15.007,2,2,0,2,0,0,0,0,0.0,0.0
1006,2063,26-09-2019 08:24:00,1,2988.0,2913.0,0.975,14.996,4,4,0,4,0,0,0,0,0.0,0.0
1006,2064,26-09-2019 08:26:00,1,3011.0,2884.0,0.958,15.055,2,2,1,1,0,0,0,0,0.0,0.0
1006,2065,26-09-2019 08:28:00,1,2896.0,2790.0,0.963,14.5,5,5,1,4,0,0,0,0,0.0,0.0
1006,2066,26-09-2019 08:30:00,1,2771.0,2757.0,0.995,13.969,8,0,0,0,8,0,8,0,0.0,0.0
1006,2067,26-09-2019 08:32:00,1,2765.0,2751.0,0.995,13.941,2,0,0,0,2,0,2,0,0.0,0.0
1006,2068,26-09-2019 08:34:00,1,2806.0,2698.0,0.962,14.041,0,0,0,0,0,0,0,0,0.0,0.0
1006,2069,26-09-2019 08:36:00,1,2805.0,2606.0,0.929,13.937,10,4,2,2,6,2,4,0,0.0,0.0
1006,2070,26-09-2019 08:38:00,1,2806.0,2620.0,0.933,13.957,3,2,1,1,1,1,0,0,0.0,0.0
1006,2071,26-09-2019 08:40:00,1,2909.0,2729.0,0.938,14.481,2,2,1,1,0,0,0,0,0.0,0.0
1006,2072,26-09-2019 08:42:00,1,2914.0,2738.0,0.94,14.512,9,6,2,4,3,1,2,0,0.0,0.0
1006,2073,26-09-2019 08:44:00,1,3046.0,2730.0,0.896,15.022,0,0,0,0,0,0,0,0,0.0,0.0
1006,2074,26-09-2019 08:46:00,1,3056.0,2741.0,0.897,15.076,0,0,0,0,0,0,0,0,0.0,0.0
1006,2075,26-09-2019 08:48:00,1,3050.0,2707.0,0.887,15.013,0,0,0,0,0,0,0,0,0.0,0.0
1006,2076,26-09-2019 08:50:00,1,3055.0,2703.0,0.885,15.031,1,1,0,1,0,0,0,0,0.0,0.0
1006,2077,26-09-2019 08:52:00,1,3054.0,2718.0,0.89,15.043,2,2,0,2,0,0,0,0,0.0,0.0
1006,2078,26-09-2019 08:54:00,1,3056.0,2721.0,0.89,15.053,22,11,4,7,11,2,9,0,0.0,0.0
1006,2079,26-09-2019 08:56:00,1,3162.5,2818.5,0.891,15.581,26,17,6,11,9,0,9,0,0.01,0.0
1006,2080,26-09-2019 08:58:00,1,3269.0,2916.0,0.892,16.109,52,24,3,21,28,0,28,0,0.0,0.0
1006,2081,26-09-2019 09:00:00,1,3367.0,3076.0,0.914,16.672,102,75,46,29,27,8,19,11,0.0,0.0
1006,2082,26-09-2019 09:02:00,1,3594.0,3225.0,0.897,17.729,167,108,66,42,59,32,27,24,0.0,0.01
1006,2083,26-09-2019 09:04:00,1,3561.0,3347.0,0.94,17.738,207,152,104,48,55,36,19,28,0.0,0.0
1006,2084,26-09-2019 09:06:00,1,3934.0,3430.0,0.872,19.296,1010,544,440,104,466,354,112,12,0.0,0.06
1006,2085,26-09-2019 09:08:00,1,3582.0,3333.0,0.931,17.805,368,206,167,39,162,120,42,111,0.0,0.0
1006,2086,26-09-2019 09:10:00,1,3912.0,3476.0,0.888,19.263,277,138,103,35,139,100,39,26,0.0,0.0
1006,2087,26-09-2019 09:12:00,1,3558.0,3330.0,0.936,17.704,521,343,273,70,178,124,54,14,0.0,0.0
1006,2088,26-09-2019 09:14:00,1,3808.0,3441.0,0.904,18.812,100,67,40,27,33,9,24,3,0.0,0.0
1006,2089,26-09-2019 09:16:00,1,3689.0,3377.0,0.915,18.273,159,105,79,26,54,33,21,0,0.0,0.0
1006,2090,26-09-2019 09:18:00,1,3816.0,3394.0,0.89,18.792,533,312,248,64,221,148,73,6,0.0,0.0
1006,2091,26-09-2019 09:20:00,1,3813.0,3402.0,0.892,18.791,316,218,162,56,98,59,39,14,0.0,0.0
1006,2092,26-09-2019 09:22:00,1,3699.0,3347.0,0.905,18.281,141,104,58,46,37,20,17,0,0.0,0.0
1006,2093,26-09-2019 09:24:00,1,3588.0,3278.0,0.913,17.765,32,32,2,30,0,0,0,0,0.0,0.0
1006,2094,26-09-2019 09:26:00,1,3583.0,3223.0,0.9,17.684,64,46,17,29,18,0,18,0,0.0,0.0
1006,2095,26-09-2019 09:28:00,1,3575.0,3249.0,0.909,17.683,41,25,4,21,16,0,16,0,0.0,0.0
1006,2096,26-09-2019 09:30:00,1,3591.0,3197.5,0.8905,17.689,15,10,2,8,5,2,3,0,0.0,0.0
1006,2097,26-09-2019 09:32:00,1,3607.0,3146.0,0.872,17.695,31,26,7,19,5,0,5,0,0.0,0.0
1006,2098,26-09-2019 09:34:00,1,3617.0,3126.0,0.864,17.713,6,3,2,1,3,0,3,0,0.0,0.0
1006,2099,26-09-2019 09:36:00,1,3380.0,3027.0,0.896,16.667,0,0,0,0,0,0,0,0,0.0,0.0
1006,2100,26-09-2019 09:38:00,1,3286.0,2909.0,0.885,16.168,13,13,8,5,0,0,0,0,0.0,0.0
1006,2101,26-09-2019 09:40:00,1,3169.0,2781.0,0.878,15.566,2,0,0,0,2,0,2,0,0.0,0.0
1006,2102,26-09-2019 09:42:00,1,3064.0,2685.0,0.876,15.044,11,8,1,7,3,0,3,0,0.0,0.0
1006,2103,26-09-2019 09:44:00,1,3047.0,2715.0,0.891,15.011,0,0,0,0,0,0,0,0,0.0,0.0
1006,2104,26-09-2019 09:46:00,1,3072.0,2686.0,0.874,15.078,0,0,0,0,0,0,0,0,0.0,0.0
1006,2105,26-09-2019 09:48:00,1,3078.0,2587.0,0.84,14.993,0,0,0,0,0,0,0,0,0.0,0.0
1006,2106,26-09-2019 09:50:00,1,2855.0,2512.0,0.88,14.03,2,2,0,2,0,0,0,0,0.0,0.0
1006,2107,26-09-2019 09:52:00,1,2841.0,2472.0,0.87,13.931,3,3,0,3,0,0,0,0,0.0,0.0
1006,2108,26-09-2019 09:54:00,1,2849.0,2467.0,0.866,13.956,2,2,0,2,0,0,0,0,0.0,0.0
1006,2109,26-09-2019 09:56:00,1,3114.0,2479.0,0.796,15.016,4,4,1,3,0,0,0,0,0.0,0.0
1006,2110,26-09-2019 09:58:00,1,3122.0,2458.0,0.787,15.022,0,0,0,0,0,0,0,0,0.0,0.0
1006,2111,26-09-2019 10:00:00,1,2988.0,2431.0,0.814,14.466,44,34,19,15,10,2,8,0,0.0,0.0
1006,2112,26-09-2019 10:02:00,1,2996.0,2438.0,0.814,14.502,0,0,0,0,0,0,0,0,0.0,0.0
1006,2113,26-09-2019 10:04:00,1,2926.5,2414.5,0.8255,14.204,0,0,0,0,0,0,0,0,0.0,0.0
1006,2114,26-09-2019 10:06:00,1,2857.0,2391.0,0.837,13.906,13,12,7,5,1,0,1,0,0.0,0.0
1006,2115,26-09-2019 10:08:00,1,2860.0,2422.0,0.847,13.95,73,52,30,22,21,11,10,0,0.0,0.0
1006,2116,26-09-2019 10:10:00,1,3123.0,2473.0,0.792,15.044,10,10,6,4,0,0,0,0,0.0,0.0
1006,2117,26-09-2019 10:12:00,1,2986.0,2416.0,0.809,14.439,0,0,0,0,0,0,0,0,0.0,0.0
1006,2118,26-09-2019 10:14:00,1,2876.0,2392.0,0.832,13.982,1,0,0,0,1,0,1,0,0.0,0.0
1006,2119,26-09-2019 10:16:00,1,2881.0,2354.0,0.817,13.957,0,0,0,0,0,0,0,0,0.0,0.0
1006,2120,26-09-2019 10:18:00,1,2888.0,2327.0,0.806,13.956,5,3,1,2,2,0,2,0,0.0,0.0
1006,2121,26-09-2019 10:20:00,1,2896.0,2309.0,0.797,13.967,18,16,13,3,2,0,2,0,0.0,0.0
1006,2122,26-09-2019 10:22:00,1,2891.0,2298.0,0.795,13.935,0,0,0,0,0,0,0,0,0.0,0.0
1006,2123,26-09-2019 10:24:00,1,2880.0,2316.0,0.804,13.911,5,4,3,1,1,1,0,0,0.01,0.0
1006,2124,26-09-2019 10:26:00,1,2885.0,2329.0,0.807,13.947,0,0,0,0,0,0,0,0,0.0,0.0
1006,2125,26-09-2019 10:28:00,1,2905.0,2271.0,0.782,13.961,0,0,0,0,0,0,0,0,0.0,0.0
1006,2126,26-09-2019 10:30:00,1,2922.0,2191.0,0.75,13.939,14,13,5,8,1,0,1,0,0.0,0.0
1006,2127,26-09-2019 10:32:00,1,2911.0,2271.0,0.78,13.986,3,3,1,2,0,0,0,0,0.0,0.0
1006,2128,26-09-2019 10:34:00,1,2910.0,2242.0,0.771,13.947,4,2,1,1,2,1,1,0,0.0,0.0
1006,2129,26-09-2019 10:36:00,1,2919.0,2229.0,0.764,13.968,0,0,0,0,0,0,0,0,0.0,0.0
1006,2130,26-09-2019 10:38:00,1,2917.5,2220.5,0.7615,13.954,0,0,0,0,0,0,0,0,0.0,0.0
1006,2131,26-09-2019 10:40:00,1,2916.0,2212.0,0.759,13.94,44,35,24,11,9,2,7,0,0.0,0.0
1006,2132,26-09-2019 10:42:00,1,2907.0,2268.0,0.78,13.963,145,87,68,19,58,42,16,22,0.0,0.0
1006,2133,26-09-2019 10:44:00,1,3124.0,2454.0,0.786,15.025,160,99,63,36,61,36,25,30,0.0,0.0
1006,2134,26-09-2019 10:46:00,1,3215.0,2629.0,0.818,15.579,201,134,104,30,67,42,25,96,0.0,0.0
1006,2135,26-09-2019 10:48:00,1,3699.0,2861.0,0.774,17.741,188,106,74,32,82,70,12,80,0.0,0.0
1006,2136,26-09-2019 10:50:00,1,3458.0,2721.0,0.787,16.638,354,187,141,46,167,131,36,11,0.0,0.0
1006,2137,26-09-2019 10:52:00,1,3696.0,2863.0,0.775,17.73,35,28,10,18,7,1,6,0,0.0,0.0
1006,2138,26-09-2019 10:54:00,1,3667.0,2971.0,0.81,17.736,142,92,74,18,50,32,18,7,0.0,0.0
1006,2139,26-09-2019 10:56:00,1,3690.0,2852.0,0.773,17.695,128,99,67,32,29,12,17,27,0.0,0.0
1006,2140,26-09-2019 10:58:00,1,3441.0,2810.0,0.817,16.67,76,44,27,17,32,5,27,1,0.0,0.0
1006,2141,26-09-2019 11:00:00,1,3452.0,2741.0,0.794,16.638,3,0,0,0,3,0,3,0,0.0,0.0
1006,2142,26-09-2019 11:02:00,1,3421.0,2821.0,0.825,16.603,35,32,14,18,3,1,2,0,0.0,0.0
1006,2143,26-09-2019 11:04:00,1,3687.0,2886.0,0.783,17.721,43,36,13,23,7,2,5,0,0.0,0.0
1006,2144,26-09-2019 11:06:00,1,3431.0,2833.0,0.826,16.655,76,58,28,30,18,6,12,0,0.0,0.0
1006,2145,26-09-2019 11:08:00,1,3447.0,2781.0,0.807,16.661,81,51,26,25,30,9,21,1,0.0,0.0
1006,2146,26-09-2019 11:10:00,1,3443.0,2774.0,0.806,16.636,638,381,307,74,257,196,61,21,0.0,0.0
1006,2147,26-09-2019 11:12:00,1,3557.5,2839.5,0.7985,17.161,673,411,342,69,262,207,55,55,0.0,0.0
1006,2148,26-09-2019 11:14:00,1,3672.0,2905.0,0.791,17.686,683,489,416,73,194,140,54,38,0.0,0.0
1006,2149,26-09-2019 11:16:00,1,3427.0,2857.0,0.834,16.663,397,254,202,52,143,95,48,45,0.0,0.0
1006,2150,26-09-2019 11:18:00,1,3650.0,2967.0,0.813,17.666,313,164,124,40,149,104,45,21,0.0,0.0
1006,2151,26-09-2019 11:20:00,1,3235.0,2571.0,0.795,15.592,124,74,45,29,50,20,30,0,0.0,0.0
1006,2152,26-09-2019 11:22:00,1,3225.0,2579.0,0.8,15.562,93,74,39,35,19,11,8,0,0.0,0.0
1006,2153,26-09-2019 11:24:00,1,3464.0,2719.0,0.785,16.658,60,41,28,13,19,5,14,0,0.0,0.0
1006,2154,26-09-2019 11:26:00,1,3461.0,2678.0,0.774,16.604,33,21,1,20,12,0,12,0,0.0,0.0
1006,2155,26-09-2019 11:28:00,1,3464.0,2730.0,0.788,16.67,18,7,1,6,11,0,11,0,0.0,0.0
1006,2156,26-09-2019 11:30:00,1,3468.0,2680.0,0.773,16.631,2,1,0,1,1,0,1,0,0.0,0.0
1006,2157,26-09-2019 11:32:00,1,3239.0,2522.0,0.779,15.553,0,0,0,0,0,0,0,0,0.0,0.0
1006,2158,26-09-2019 11:34:00,1,2873.0,2375.0,0.827,13.949,8,3,3,0,5,0,5,0,0.0,0.0
1006,2159,26-09-2019 11:36:00,1,2901.0,2270.0,0.782,13.942,2,0,0,0,2,0,2,0,0.0,0.0
1006,2160,26-09-2019 11:38:00,1,2795.0,2159.0,0.773,13.402,4,0,0,0,4,0,4,0,0.0,0.0
1006,2161,26-09-2019 11:40:00,1,2686.0,2083.0,0.775,12.887,9,4,2,2,5,0,5,0,0.0,0.0
1006,2162,26-09-2019 11:42:00,1,2688.0,2082.0,0.774,12.897,12,6,0,6,6,0,6,0,0.0,0.0
1006,2163,26-09-2019 11:44:00,1,2700.0,2044.0,0.757,12.903,1,1,0,1,0,0,0,0,0.0,0.0
1006,2164,26-09-2019 11:46:00,1,2701.5,2021.5,0.7485,12.8825,2,2,0,2,0,0,0,0,0.0,0.0
1006,2165,26-09-2019 11:48:00,1,2703.0,1999.0,0.74,12.862,4,4,0,4,0,0,0,0,0.0,0.0
1006,2166,26-09-2019 11:50:00,1,2703.0,2012.0,0.744,12.879,2,2,0,2,0,0,0,0,0.0,0.0
1006,2167,26-09-2019 11:52:00,1,2699.0,2010.0,0.745,12.862,16,16,0,16,0,0,0,0,0.0,0.0
1006,2168,26-09-2019 11:54:00,1,2703.0,1985.0,0.734,12.848,0,0,0,0,0,0,0,0,0.0,0.0
1006,2169,26-09-2019 11:56:00,1,2696.0,1988.0,0.737,12.821,0,0,0,0,0,0,0,0,0.0,0.0
1006,2170,26-09-2019 11:58:00,1,2708.0,1982.0,0.732,12.864,0,0,0,0,0,0,0,0,0.0,0.0
1006,2171,26-09-2019 12:00:00,1,2707.0,1983.0,0.732,12.86,21,13,7,6,8,0,8,0,0.0,0.0
1006,2172,26-09-2019 12:02:00,1,2696.0,1983.0,0.735,12.82,45,22,14,8,23,2,21,3,0.0,0.0
1006,2173,26-09-2019 12:04:00,1,2951.0,2119.0,0.718,13.972,90,47,14,33,43,8,35,2,0.0,0.0
1006,2174,26-09-2019 12:06:00,1,3145.0,2334.0,0.742,14.976,232,143,102,41,89,58,31,62,0.0,0.0
1006,2175,26-09-2019 12:08:00,1,3135.0,2403.0,0.767,15.012,141,90,61,29,51,11,40,44,0.0,0.0
1006,2176,26-09-2019 12:10:00,1,3452.0,2724.0,0.789,16.615,85,72,40,32,13,3,10,18,0.0,0.0
1006,2177,26-09-2019 12:12:00,1,3455.0,2679.0,0.775,16.58,75,53,30,23,22,12,10,0,0.0,0.0
1006,2178,26-09-2019 12:14:00,1,2884.0,2300.0,0.797,13.909,45,24,8,16,21,0,21,0,0.0,0.0
1006,2179,26-09-2019 12:16:00,1,3230.0,2556.0,0.791,15.556,30,12,4,8,18,0,18,0,0.0,0.0
1006,2180,26-09-2019 12:18:00,1,3242.0,2509.0,0.774,15.55,26,16,7,9,10,0,10,0,0.0,0.0
1006,2181,26-09-2019 12:20:00,1,3123.5,2428.0,0.7775,14.9945,5,5,0,5,0,0,0,0,0.0,0.0
1006,2182,26-09-2019 12:22:00,1,3005.0,2347.0,0.781,14.439,5,5,3,2,0,0,0,0,0.0,0.0
1006,2183,26-09-2019 12:24:00,1,2920.0,2257.0,0.773,14.005,0,0,0,0,0,0,0,0,0.0,0.0
1006,2184,26-09-2019 12:26:00,1,2932.0,2172.0,0.741,13.957,0,0,0,0,0,0,0,0,0.0,0.0
1006,2185,26-09-2019 12:28:00,1,2675.0,2105.0,0.787,12.871,0,0,0,0,0,0,0,0,0.0,0.0
1006,2186,26-09-2019 12:30:00,1,2684.0,2049.0,0.764,12.843,0,0,0,0,0,0,0,0,0.0,0.0
1006,2187,26-09-2019 12:32:00,1,2704.0,2002.0,0.74,12.87,3,2,1,1,1,0,1,0,0.0,0.0
1006,2188,26-09-2019 12:34:00,1,2719.0,1945.0,0.715,12.868,25,21,9,12,4,0,4,0,0.0,0.0
1006,2189,26-09-2019 12:36:00,1,2692.0,2059.0,0.765,12.886,0,0,0,0,0,0,0,0,0.0,0.0
1006,2190,26-09-2019 12:38:00,1,2939.0,2130.0,0.725,13.94,11,0,0,0,11,0,11,0,0.0,0.0
1006,2191,26-09-2019 12:40:00,1,2929.0,2182.0,0.745,13.955,0,0,0,0,0,0,0,0,0.0,0.0
1006,2192,26-09-2019 12:42:00,1,2937.0,2182.0,0.743,13.986,6,4,2,2,2,0,2,0,0.0,0.0
1006,2193,26-09-2019 12:44:00,1,2945.0,2143.0,0.728,13.974,5,1,1,0,4,0,4,0,0.0,0.0
1006,2194,26-09-2019 12:46:00,1,2926.0,2133.0,0.729,13.891,0,0,0,0,0,0,0,0,0.0,0.0
1006,2195,26-09-2019 12:48:00,1,2939.0,2151.0,0.732,13.963,0,0,0,0,0,0,0,0,0.0,0.0
1006,2196,26-09-2019 12:50:00,1,2934.0,2142.0,0.73,13.932,85,56,36,20,29,0,29,0,0.0,0.0
1006,2197,26-09-2019 12:52:00,1,2903.0,2281.0,0.786,13.962,115,86,39,47,29,0,29,0,0.0,0.0
1006,2198,26-09-2019 12:54:00,1,3017.0,2367.5,0.785,14.509,108,88,56,32,20,0,20,0,0.0,0.0
1006,2199,26-09-2019 12:56:00,1,3131.0,2454.0,0.784,15.056,49,21,7,14,28,0,28,0,0.0,0.0
1006,2200,26-09-2019 12:58:00,1,3097.0,2498.0,0.807,14.968,65,47,20,27,18,0,18,1,0.0,0.0
1006,2201,26-09-2019 13:00:00,1,3118.0,2504.0,0.803,15.058,79,50,33,17,29,0,29,0,0.0,0.0
1006,2202,26-09-2019 13:02:00,1,3098.0,2544.0,0.821,15.022,7,5,3,2,2,0,2,0,0.0,0.0
1006,2203,26-09-2019 13:04:00,1,3115.0,2442.0,0.784,14.978,2,2,0,2,0,0,0,0,0.0,0.0
1006,2204,26-09-2019 13:06:00,1,2891.0,2344.0,0.811,13.985,0,0,0,0,0,0,0,0,0.0,0.0
1006,2205,26-09-2019 13:08:00,1,2911.0,2225.0,0.765,13.931,0,0,0,0,0,0,0,0,0.0,0.0
1006,2206,26-09-2019 13:10:00,1,2798.0,2143.0,0.766,13.396,39,30,19,11,9,0,9,0,0.0,0.0
1006,2207,26-09-2019 13:12:00,1,2815.0,2133.0,0.758,13.453,12,10,2,8,2,0,2,0,0.0,0.0
1006,2208,26-09-2019 13:14:00,1,2924.0,2181.0,0.746,13.937,6,5,3,2,1,0,1,0,0.0,0.0
1006,2209,26-09-2019 13:16:00,1,2924.0,2156.0,0.737,13.909,2,2,0,2,0,0,0,0,0.0,0.0
1006,2210,26-09-2019 13:18:00,1,2939.0,2165.0,0.737,13.976,8,8,5,3,0,0,0,0,0.0,0.0
1006,2211,26-09-2019 13:20:00,1,2937.0,2146.0,0.731,13.947,0,0,0,0,0,0,0,0,0.0,0.0
1006,2212,26-09-2019 13:22:00,1,2932.0,2133.0,0.728,13.913,34,28,18,10,6,2,4,0,0.0,0.0
1006,2213,26-09-2019 13:24:00,1,2942.0,2125.0,0.722,13.943,9,9,6,3,0,0,0,0,0.0,0.0
1006,2214,26-09-2019 13:26:00,1,2937.0,2149.0,0.732,13.952,0,0,0,0,0,0,0,0,0.0,0.0
1006,2215,26-09-2019 13:28:00,1,2941.5,2147.0,0.73,13.9675,0,0,0,0,0,0,0,0,0.0,0.0
1006,2216,26-09-2019 13:30:00,1,2946.0,2145.0,0.728,13.983,0,0,0,0,0,0,0,0,0.0,0.0
1006,2217,26-09-2019 13:32:00,1,2936.0,2143.0,0.73,13.942,0,0,0,0,0,0,0,0,0.0,0.0
1006,2218,26-09-2019 13:34:00,1,2927.0,2162.0,0.739,13.926,1,0,0,0,1,0,1,0,0.0,0.0
1006,2219,26-09-2019 13:36:00,1,2940.0,2147.0,0.73,13.96,1,0,0,0,1,0,1,0,0.0,0.0
1006,2220,26-09-2019 13:38:00,1,2947.0,2110.0,0.716,13.946,109,87,70,17,22,6,16,4,0.01,0.0
1006,2221,26-09-2019 13:40:00,1,2924.0,2146.0,0.734,13.899,0,0,0,0,0,0,0,0,0.0,0.0
1006,2222,26-09-2019 13:42:00,1,2809.0,2125.0,0.756,13.421,0,0,0,0,0,0,0,0,0.0,0.0
1006,2223,26-09-2019 13:44:00,1,2686.0,2096.0,0.78,12.903,0,0,0,0,0,0,0,0,0.0,0.0
1006,2224,26-09-2019 13:46:00,1,2679.0,2083.0,0.777,12.864,0,0,0,0,0,0,0,0,0.0,0.0
1006,2225,26-09-2019 13:48:00,1,2690.0,2073.0,0.771,12.893,0,0,0,0,0,0,0,0,0.0,0.0
1006,2226,26-09-2019 13:50:00,1,2689.0,2070.0,0.77,12.885,21,15,7,8,6,2,4,0,0.0,0.0
1006,2227,26-09-2019 13:52:00,1,2801.0,2114.0,0.755,13.377,0,0,0,0,0,0,0,0,0.0,0.0
1006,2228,26-09-2019 13:54:00,1,2679.0,2076.0,0.775,12.853,23,22,2,20,1,0,1,0,0.0,0.0
1006,2229,26-09-2019 13:56:00,1,2705.0,2041.0,0.755,12.917,0,0,0,0,0,0,0,0,0.0,0.0
1006,2230,26-09-2019 13:58:00,1,2668.0,2077.0,0.778,12.81,0,0,0,0,0,0,0,0,0.0,0.0
1006,2231,26-09-2019 14:00:00,1,2685.0,2100.0,0.782,12.905,19,19,0,19,0,0,0,0,0.0,0.0
1006,2232,26-09-2019 14:02:00,1,2744.5,2093.0,0.763,13.1315,12,12,3,9,0,0,0,0,0.0,0.0
1006,2233,26-09-2019 14:04:00,1,2804.0,2086.0,0.744,13.358,1,1,0,1,0,0,0,0,0.0,0.0
1006,2234,26-09-2019 14:06:00,1,2823.0,2118.0,0.75,13.468,2,2,0,2,0,0,0,0,0.0,0.0
1006,2235,26-09-2019 14:08:00,1,2930.0,2161.0,0.738,13.938,44,31,21,10,13,0,13,0,0.0,0.0
1006,2236,26-09-2019 14:10:00,1,2920.0,2154.0,0.738,13.89,96,73,46,27,23,4,19,4,0.0,0.0
1006,2237,26-09-2019 14:12:00,1,3039.0,2301.0,0.757,14.524,50,41,9,32,9,0,9,23,0.0,0.0
1006,2238,26-09-2019 14:14:00,1,3493.0,2607.0,0.747,16.649,91,91,50,41,0,0,0,0,0.0,0.0
1006,2239,26-09-2019 14:16:00,1,3468.0,2650.0,0.764,16.6,112,101,50,51,11,1,10,0,0.0,0.0
1006,2240,26-09-2019 14:18:00,1,3449.0,2763.0,0.801,16.648,98,49,16,33,49,9,40,60,0.0,0.0
1006,2241,26-09-2019 14:20:00,1,3710.0,2797.0,0.754,17.714,192,107,67,40,85,34,51,93,0.0,0.0
1006,2242,26-09-2019 14:22:00,1,3463.0,2682.0,0.775,16.613,209,138,101,37,71,34,37,94,0.0,0.0
1006,2243,26-09-2019 14:24:00,1,3708.0,2812.0,0.758,17.726,118,71,46,25,47,0,47,58,0.0,0.0
1006,2244,26-09-2019 14:26:00,1,3669.0,2920.0,0.796,17.689,151,100,61,39,51,7,44,67,0.0,0.0
1006,2245,26-09-2019 14:28:00,1,3787.0,2992.0,0.79,18.235,129,82,55,27,47,6,41,66,0.0,0.0
1006,2246,26-09-2019 14:30:00,1,3911.0,3063.0,0.783,18.802,183,127,76,51,56,13,43,68,0.0,0.05
1006,2247,26-09-2019 14:32:00,1,3686.0,2895.0,0.786,17.727,342,183,139,44,159,114,45,5,0.01,0.03
1006,2248,26-09-2019 14:34:00,1,3208.0,2629.0,0.819,15.549,317,151,105,46,166,117,49,4,0.01,0.0
1006,2249,26-09-2019 14:36:00,1,3441.0,2762.5,0.8035,16.6155,651,324,257,67,327,255,72,2,0.08,0.0
1006,2250,26-09-2019 14:38:00,1,3674.0,2896.0,0.788,17.682,525,397,330,67,128,82,46,1,0.02,0.0
1006,2251,26-09-2019 14:40:00,1,3531.0,2926.0,0.829,17.15,43,38,9,29,5,0,5,0,0.0,0.01
1006,2252,26-09-2019 14:42:00,1,3447.0,2786.0,0.808,16.665,33,13,7,6,20,0,20,0,0.0,0.0
1006,2253,26-09-2019 14:44:00,1,3222.0,2620.0,0.813,15.598,39,21,0,21,18,1,17,0,0.0,0.0
1006,2254,26-09-2019 14:46:00,1,3407.0,2901.0,0.852,16.635,21,11,1,10,10,1,9,0,0.0,0.0
1006,2255,26-09-2019 14:48:00,1,3662.0,3014.0,0.823,17.765,2,2,1,1,0,0,0,0,0.0,0.0
1006,2256,26-09-2019 14:50:00,1,3412.0,2900.0,0.85,16.654,0,0,0,0,0,0,0,0,0.0,0.0
1006,2257,26-09-2019 14:52:00,1,3288.0,2835.0,0.862,16.094,0,0,0,0,0,0,0,0,0.0,0.0
1006,2258,26-09-2019 14:54:00,1,3290.0,2846.0,0.865,16.113,5,4,0,4,1,0,1,0,0.01,0.01
1006,2259,26-09-2019 14:56:00,1,3149.0,2832.0,0.899,15.544,1,1,0,1,0,0,0,0,0.0,0.0
1006,2260,26-09-2019 14:58:00,1,3190.0,2766.0,0.867,15.63,18,13,8,5,5,0,5,0,0.0,0.0
1006,2261,26-09-2019 15:00:00,1,3054.0,2749.0,0.9,15.076,3,3,0,3,0,0,0,0,0.0,0.0
1006,2262,26-09-2019 15:02:00,1,3031.0,2785.0,0.919,15.025,0,0,0,0,0,0,0,0,0.0,0.0
1006,2263,26-09-2019 15:04:00,1,3038.0,2779.0,0.915,15.047,4,2,0,2,2,0,2,0,0.0,0.0
1006,2264,26-09-2019 15:06:00,1,3025.0,2810.0,0.929,15.03,1,1,0,1,0,0,0,0,0.0,0.0
1006,2265,26-09-2019 15:08:00,1,3043.0,2809.0,0.923,15.098,0,0,0,0,0,0,0,0,0.0,0.0
1006,2266,26-09-2019 15:10:00,1,3050.0,2762.5,0.9055,15.0755,0,0,0,0,0,0,0,0,0.0,0.0
1006,2267,26-09-2019 15:12:00,1,3057.0,2716.0,0.888,15.053,1,1,0,1,0,0,0,0,0.0,0.0
1006,2268,26-09-2019 15:14:00,1,3055.0,2726.0,0.892,15.055,2,2,0,2,0,0,0,0,0.0,0.0
1006,2269,26-09-2019 15:16:00,1,3057.0,2703.0,0.884,15.035,5,5,0,5,0,0,0,0,0.0,0.0
1006,2270,26-09-2019 15:18:00,1,3066.0,2685.0,0.876,15.052,5,5,0,5,0,0,0,0,0.0,0.0
1006,2271,26-09-2019 15:20:00,1,3073.0,2679.0,0.872,15.074,0,0,0,0,0,0,0,0,0.0,0.0
1006,2272,26-09-2019 15:22:00,1,3071.0,2633.0,0.858,15.015,1,1,0,1,0,0,0,0,0.0,0.0
1006,2273,26-09-2019 15:24:00,1,3067.0,2663.0,0.868,15.032,3,3,0,3,0,0,0,0,0.0,0.0
1006,2274,26-09-2019 15:26:00,1,3087.0,2612.0,0.846,15.056,0,0,0,0,0,0,0,0,0.0,0.0
1006,2275,26-09-2019 15:28:00,1,3078.0,2611.0,0.848,15.019,8,7,2,5,1,0,1,0,0.0,0.0
1006,2276,26-09-2019 15:30:00,1,3088.0,2610.0,0.845,15.056,2,2,0,2,0,0,0,0,0.0,0.0
1006,2277,26-09-2019 15:32:00,1,2962.0,2552.0,0.862,14.495,1,1,0,1,0,0,0,0,0.0,0.0
1006,2278,26-09-2019 15:34:00,1,2845.0,2502.0,0.879,13.98,11,4,1,3,7,0,7,0,0.0,0.0
1006,2279,26-09-2019 15:36:00,1,2848.0,2492.0,0.875,13.98,23,14,9,5,9,0,9,0,0.0,0.0
1006,2280,26-09-2019 15:38:00,1,2840.0,2527.0,0.89,13.987,1,0,0,0,1,0,1,0,0.0,0.0
1006,2281,26-09-2019 15:40:00,1,2839.0,2506.0,0.883,13.96,3,3,0,3,0,0,0,0,0.0,0.0
1006,2282,26-09-2019 15:42:00,1,2848.0,2481.0,0.871,13.969,1,1,0,1,0,0,0,0,0.0,0.0
1006,2283,26-09-2019 15:44:00,1,2845.5,2490.5,0.875,13.9695,13,8,4,4,5,0,5,0,0.0,0.0
1006,2284,26-09-2019 15:46:00,1,2843.0,2500.0,0.879,13.97,0,0,0,0,0,0,0,0,0.0,0.0
1006,2285,26-09-2019 15:48:00,1,2854.0,2476.0,0.868,13.985,1,1,0,1,0,0,0,0,0.0,0.0
1006,2286,26-09-2019 15:50:00,1,2872.0,2410.0,0.839,13.986,1,1,0,1,0,0,0,0,0.0,0.0
1006,2287,26-09-2019 15:52:00,1,2866.0,2406.0,0.84,13.955,2,1,0,1,1,0,1,0,0.0,0.0
1006,2288,26-09-2019 15:54:00,1,2866.0,2453.0,0.856,14.007,8,7,0,7,1,0,1,0,0.0,0.0
1006,2289,26-09-2019 15:56:00,1,2855.0,2461.0,0.862,13.972,43,39,0,39,4,0,4,0,0.0,0.0
1006,2290,26-09-2019 15:58:00,1,3100.0,2552.0,0.823,15.041,31,23,4,19,8,0,8,2,0.0,0.0
1006,2291,26-09-2019 16:00:00,1,3076.0,2620.0,0.852,15.021,77,59,28,31,18,0,18,0,0.0,0.0
1006,2292,26-09-2019 16:02:00,1,3069.0,2681.0,0.874,15.06,79,36,16,20,43,3,40,9,0.0,0.0
1006,2293,26-09-2019 16:04:00,1,3175.0,2732.0,0.86,15.535,72,34,9,25,38,7,31,2,0.0,0.0
1006,2294,26-09-2019 16:06:00,1,3188.0,2742.0,0.86,15.595,18,11,2,9,7,0,7,0,0.0,0.0
1006,2295,26-09-2019 16:08:00,1,3188.0,2743.0,0.86,15.599,19,9,0,9,10,0,10,0,0.0,0.0
1006,2296,26-09-2019 16:10:00,1,3202.0,2636.0,0.823,15.535,0,0,0,0,0,0,0,0,0.0,0.0
1006,2297,26-09-2019 16:12:00,1,2833.0,2516.0,0.888,13.948,11,5,1,4,6,0,6,0,0.0,0.0
1006,2298,26-09-2019 16:14:00,1,2856.0,2422.0,0.848,13.935,10,9,1,8,1,0,1,0,0.0,0.0
1006,2299,26-09-2019 16:16:00,1,2853.0,2451.0,0.859,13.954,4,4,0,4,0,0,0,0,0.0,0.0
1006,2300,26-09-2019 16:18:00,1,2869.0,2404.0,0.838,13.9645,1,1,0,1,0,0,0,0,0.0,0.0
1006,2301,26-09-2019 16:20:00,1,2885.0,2357.0,0.817,13.975,1,0,0,0,1,0,1,0,0.0,0.0
1006,2302,26-09-2019 16:22:00,1,2882.0,2334.0,0.81,13.938,3,2,0,2,1,0,1,0,0.0,0.0
1006,2303,26-09-2019 16:24:00,1,2884.0,2328.0,0.807,13.942,1,0,0,0,1,0,1,0,0.0,0.0
1006,2304,26-09-2019 16:26:00,1,2889.0,2331.0,0.807,13.965,0,0,0,0,0,0,0,0,0.0,0.0
1006,2305,26-09-2019 16:28:00,1,2915.0,2250.0,0.772,13.978,0,0,0,0,0,0,0,0,0.0,0.0
1006,2306,26-09-2019 16:30:00,1,2900.0,2283.0,0.787,13.953,0,0,0,0,0,0,0,0,0.0,0.0
1006,2307,26-09-2019 16:32:00,1,2894.0,2277.0,0.787,13.923,0,0,0,0,0,0,0,0,0.0,0.0
1006,2308,26-09-2019 16:34:00,1,2909.0,2269.0,0.78,13.972,0,0,0,0,0,0,0,0,0.0,0.0
1006,2309,26-09-2019 16:36:00,1,2914.0,2222.0,0.763,13.942,0,0,0,0,0,0,0,0,0.0,0.0
1006,2310,26-09-2019 16:38:00,1,2912.0,2225.0,0.764,13.939,18,18,1,17,0,0,0,0,0.0,0.0
1006,2311,26-09-2019 16:40:00,1,2913.0,2227.0,0.765,13.941,148,108,64,44,40,10,30,41,0.0,0.0
1006,2312,26-09-2019 16:42:00,1,3480.0,2647.0,0.761,16.644,138,90,51,39,48,13,35,56,0.0,0.0
1006,2313,26-09-2019 16:44:00,1,3664.0,2948.0,0.805,17.701,214,133,85,48,81,38,43,48,0.0,0.07
1006,2314,26-09-2019 16:46:00,1,3218.0,2633.0,0.818,15.595,12,6,1,5,6,1,5,0,0.0,0.02
1006,2315,26-09-2019 16:48:00,1,3124.0,2446.0,0.783,15.017,15,15,1,14,0,0,0,0,0.0,0.0
1006,2316,26-09-2019 16:50:00,1,3212.0,2612.0,0.813,15.549,3,1,0,1,2,0,2,0,0.0,0.0
1006,2317,26-09-2019 16:52:00,1,3155.0,2591.5,0.8215,15.302,1,0,0,0,1,0,1,0,0.0,0.0
1006,2318,26-09-2019 16:54:00,1,3098.0,2571.0,0.83,15.055,0,0,0,0,0,0,0,0,0.0,0.0
1006,2319,26-09-2019 16:56:00,1,3097.0,2524.0,0.815,14.996,0,0,0,0,0,0,0,0,0.0,0.0
1006,2320,26-09-2019 16:58:00,1,2977.0,2520.0,0.846,14.521,3,0,0,0,3,0,3,0,0.0,0.0
1006,2321,26-09-2019 17:00:00,1,2855.0,2468.0,0.864,13.982,8,1,0,1,7,0,7,0,0.0,0.0
1006,2322,26-09-2019 17:02:00,1,2853.0,2466.0,0.864,13.97,5,1,0,1,4,0,4,0,0.0,0.0
1006,2323,26-09-2019 17:04:00,1,2856.0,2473.0,0.866,13.992,3,2,0,2,1,0,1,0,0.0,0.0
1006,2324,26-09-2019 17:06:00,1,2850.0,2496.0,0.876,13.992,20,14,6,8,6,2,4,0,0.0,0.0
1006,2325,26-09-2019 17:08:00,1,2827.0,2523.0,0.892,13.933,0,0,0,0,0,0,0,0,0.0,0.0
1006,2326,26-09-2019 17:10:00,1,2842.0,2524.0,0.888,13.993,5,5,3,2,0,0,0,0,0.0,0.0
1006,2327,26-09-2019 17:12:00,1,2841.0,2529.0,0.89,13.994,3,3,1,2,0,0,0,0,0.0,0.0
1006,2328,26-09-2019 17:14:00,1,2825.0,2524.0,0.893,13.924,11,4,1,3,7,3,4,0,0.0,0.0
1006,2329,26-09-2019 17:16:00,1,2964.0,2555.0,0.862,14.507,19,10,0,10,9,1,8,0,0.0,0.0
1006,2330,26-09-2019 17:18:00,1,3092.0,2586.0,0.836,15.044,0,0,0,0,0,0,0,0,0.0,0.0
1006,2331,26-09-2019 17:20:00,1,2837.0,2504.0,0.883,13.951,0,0,0,0,0,0,0,0,0.0,0.0
1006,2332,26-09-2019 17:22:00,1,2860.0,2457.0,0.859,13.989,120,78,59,19,42,15,27,40,0.0,0.0
1006,2333,26-09-2019 17:24:00,1,3421.0,2917.0,0.853,16.708,168,111,72,39,57,17,40,72,0.0,0.0
1006,2334,26-09-2019 17:26:00,1,3697.0,3141.0,0.85,18.0435,146,102,60,42,44,10,34,65,0.0,0.02
1006,2335,26-09-2019 17:28:00,1,3973.0,3365.0,0.847,19.379,191,113,80,33,78,34,44,75,0.0,0.12
1006,2336,26-09-2019 17:30:00,1,3635.0,3089.0,0.85,17.742,280,149,112,37,131,90,41,62,0.06,0.0
1006,2337,26-09-2019 17:32:00,1,3158.0,2794.0,0.885,15.534,14,9,3,6,5,2,3,0,0.0,0.0
1006,2338,26-09-2019 17:34:00,1,3068.0,2658.0,0.866,15.03,27,20,7,13,7,1,6,0,0.02,0.0
1006,2339,26-09-2019 17:36:00,1,3390.0,2965.0,0.875,16.638,33,23,11,12,10,0,10,2,0.0,0.0
1006,2340,26-09-2019 17:38:00,1,3608.0,3185.0,0.883,17.74,35,11,2,9,24,1,23,0,0.0,0.0
1006,2341,26-09-2019 17:40:00,1,3948.0,3452.0,0.874,19.378,36,20,8,12,16,2,14,0,0.0,0.0
1006,2342,26-09-2019 17:42:00,1,3567.0,3315.0,0.929,17.725,55,39,19,20,16,0,16,0,0.0,0.0
1006,2343,26-09-2019 17:44:00,1,3570.0,3303.0,0.925,17.724,5,5,0,5,0,0,0,0,0.0,0.0
1006,2344,26-09-2019 17:46:00,1,3576.0,3311.0,0.926,17.757,1,0,0,0,1,0,1,0,0.0,0.0
1006,2345,26-09-2019 17:48:00,1,3479.0,3174.0,0.912,17.22,1,1,1,0,0,0,0,0,0.0,0.0
1006,2346,26-09-2019 17:50:00,1,3359.0,3086.0,0.918,16.652,0,0,0,0,0,0,0,0,0.0,0.0
1006,2347,26-09-2019 17:52:00,1,3368.0,3072.0,0.912,16.671,0,0,0,0,0,0,0,0,0.0,0.0
1006,2348,26-09-2019 17:54:00,1,3237.0,3053.0,0.943,16.134,0,0,0,0,0,0,0,0,0.0,0.0
1006,2349,26-09-2019 17:56:00,1,3225.0,3044.0,0.944,16.077,8,4,0,4,4,2,2,0,0.0,0.0
1006,2350,26-09-2019 17:58:00,1,3345.0,3093.0,0.925,16.604,8,3,0,3,5,0,5,0,0.0,0.0
1006,2351,26-09-2019 18:00:00,0,3337.5,3119.0,0.935,16.602,62,31,20,11,31,22,9,5,0.0,0.0
1006,2352,26-09-2019 18:02:00,0,3330.0,3145.0,0.945,16.6,322,231,177,54,91,64,27,18,0.0,0.0
1006,2353,26-09-2019 18:04:00,0,3923.0,3536.0,0.901,19.372,459,381,293,88,78,57,21,57,0.0,0.0
1006,2354,26-09-2019 18:06:00,0,4133.0,3759.0,0.91,20.445,420,286,223,63,134,104,30,61,0.0,0.0
1006,2355,26-09-2019 18:08:00,0,3866.0,3640.0,0.941,19.262,249,182,140,42,67,38,29,30,0.0,0.0
1006,2356,26-09-2019 18:10:00,0,3876.0,3627.0,0.936,19.287,72,61,26,35,11,7,4,5,0.0,0.0
1006,2357,26-09-2019 18:12:00,0,4021.0,3668.0,0.912,19.903,48,47,17,30,1,0,1,0,0.0,0.0
1006,2358,26-09-2019 18:14:00,0,4139.0,3682.0,0.89,20.383,157,114,89,25,43,17,26,3,0.0,0.0
1006,2359,26-09-2019 18:16:00,0,4149.0,3685.0,0.888,20.428,30,29,19,10,1,0,1,0,0.0,0.0
1006,2360,26-09-2019 18:18:00,0,3908.0,3589.0,0.918,19.371,272,211,154,57,61,39,22,8,0.0,0.0
1006,2361,26-09-2019 18:20:00,0,4014.0,3662.0,0.912,19.87,9,7,1,6,2,0,2,0,0.0,0.0
1006,2362,26-09-2019 18:22:00,0,4033.0,3604.0,0.893,19.881,40,37,14,23,3,2,1,0,0.0,0.0
1006,2363,26-09-2019 18:24:00,0,4042.0,3609.0,0.893,19.92,39,35,6,29,4,1,3,0,0.0,0.0
1006,2364,26-09-2019 18:26:00,0,3890.0,3576.0,0.919,19.284,118,113,81,32,5,2,3,3,0.0,0.0
1006,2365,26-09-2019 18:28:00,0,4150.0,3631.0,0.875,20.372,13,12,4,8,1,0,1,0,0.0,0.0
1006,2366,26-09-2019 18:30:00,0,3924.0,3543.0,0.903,19.384,141,118,94,24,23,16,7,13,0.0,0.0
1006,2367,26-09-2019 18:32:00,0,3932.0,3464.0,0.881,19.327,417,289,226,63,128,89,39,31,0.0,0.0
1006,2368,26-09-2019 18:34:00,0,3882.5,3406.0,0.877,19.0685,198,127,92,35,71,48,23,6,0.0,0.0
1006,2369,26-09-2019 18:36:00,0,3833.0,3348.0,0.873,18.81,71,58,20,38,13,0,13,1,0.0,0.0
1006,2370,26-09-2019 18:38:00,0,3820.0,3299.0,0.864,18.702,163,149,126,23,14,6,8,0,0.0,0.0
1006,2371,26-09-2019 18:40:00,0,3725.0,3270.0,0.878,18.296,0,0,0,0,0,0,0,0,0.0,0.0
1006,2372,26-09-2019 18:42:00,0,3620.0,3116.0,0.861,17.711,2,2,1,1,0,0,0,0,0.0,0.0
1006,2373,26-09-2019 18:44:00,0,3385.0,2938.0,0.868,16.588,0,0,0,0,0,0,0,0,0.0,0.0
1006,2374,26-09-2019 18:46:00,0,3307.0,2823.0,0.854,16.155,0,0,0,0,0,0,0,0,0.0,0.0
1006,2375,26-09-2019 18:48:00,0,3192.0,2689.0,0.842,15.554,1,1,1,0,0,0,0,0,0.0,0.0
1006,2376,26-09-2019 18:50:00,0,3083.0,2571.0,0.834,14.992,0,0,0,0,0,0,0,0,0.0,0.0
1006,2377,26-09-2019 18:52:00,0,2855.0,2459.0,0.861,13.973,188,131,98,33,57,40,17,13,0.0,0.0
1006,2378,26-09-2019 18:54:00,0,3079.0,2594.0,0.843,15.005,306,210,167,43,96,73,23,20,0.0,0.0
1006,2379,26-09-2019 18:56:00,0,3196.0,2660.0,0.832,15.538,0,0,0,0,0,0,0,0,0.0,0.0
1006,2380,26-09-2019 18:58:00,0,3220.0,2610.0,0.811,15.577,1,0,0,0,1,0,1,0,0.0,0.0
1006,2381,26-09-2019 19:00:00,0,3106.0,2497.0,0.804,15.001,2,0,0,0,2,1,1,0,0.0,0.0
1006,2382,26-09-2019 19:02:00,0,2868.0,2400.0,0.837,13.958,7,2,1,1,5,3,2,0,0.0,0.0
1006,2383,26-09-2019 19:04:00,0,2879.0,2335.0,0.811,13.93,280,202,157,45,78,57,21,9,0.0,0.0
1006,2384,26-09-2019 19:06:00,0,3114.0,2502.0,0.804,15.039,272,121,81,40,151,116,35,4,0.0,0.0
1006,2385,26-09-2019 19:08:00,0,3278.0,2629.5,0.8025,15.826,280,181,133,48,99,86,13,51,0.0,0.0
1006,2386,26-09-2019 19:10:00,0,3442.0,2757.0,0.801,16.613,149,60,50,10,89,71,18,0,0.0,0.0
1006,2387,26-09-2019 19:12:00,0,3480.0,2647.0,0.761,16.644,1,0,0,0,1,0,1,0,0.0,0.0
1006,2388,26-09-2019 19:14:00,0,3240.0,2540.0,0.784,15.58,0,0,0,0,0,0,0,0,0.0,0.0
1006,2389,26-09-2019 19:16:00,0,3133.0,2421.0,0.773,15.024,9,0,0,0,9,7,2,0,0.0,0.0
1006,2390,26-09-2019 19:18:00,0,2886.0,2316.0,0.802,13.937,45,15,6,9,30,4,26,0,0.0,0.0
1006,2391,26-09-2019 19:20:00,0,2911.0,2265.0,0.778,13.978,24,5,2,3,19,1,18,0,0.0,0.0
1006,2392,26-09-2019 19:22:00,0,2931.0,2171.0,0.741,13.953,80,63,40,23,17,8,9,0,0.0,0.0
1006,2393,26-09-2019 19:24:00,0,2924.0,2184.0,0.747,13.938,106,57,21,36,49,0,49,0,0.0,0.0
1006,2394,26-09-2019 19:26:00,0,3151.0,2337.0,0.742,15.005,213,129,95,34,84,45,39,1,0.0,0.0
1006,2395,26-09-2019 19:28:00,0,3128.0,2425.0,0.775,15.011,32,0,0,0,32,0,32,0,0.0,0.0
1006,2396,26-09-2019 19:30:00,0,3141.0,2408.0,0.767,15.042,23,0,0,0,23,0,23,0,0.01,0.0
1006,2397,26-09-2019 19:32:00,0,3153.0,2314.0,0.734,14.985,41,6,1,5,35,0,35,0,0.0,0.0
1006,2398,26-09-2019 19:34:00,0,2915.0,2241.0,0.769,13.968,37,15,1,14,22,0,22,0,0.0,0.0
1006,2399,26-09-2019 19:36:00,0,2934.0,2147.0,0.732,13.936,112,88,53,35,24,2,22,0,0.0,0.0
1006,2400,26-09-2019 19:38:00,0,2914.0,2237.0,0.768,13.956,198,142,105,37,56,32,24,8,0.0,0.0
1006,2401,26-09-2019 19:40:00,0,3163.0,2341.0,0.74,15.056,167,125,87,38,42,14,28,2,0.0,0.0
1006,2402,26-09-2019 19:42:00,0,3270.5,2435.0,0.7445,15.5835,244,132,83,49,112,72,40,57,0.0,0.0
1006,2403,26-09-2019 19:44:00,0,3378.0,2529.0,0.749,16.111,15,13,8,5,2,1,1,0,0.0,0.0
1006,2404,26-09-2019 19:46:00,0,3254.0,2492.0,0.766,15.58,141,125,97,28,16,14,2,0,0.0,0.0
1006,2405,26-09-2019 19:48:00,0,3130.0,2405.0,0.768,14.995,13,13,0,13,0,0,0,0,0.0,0.0
1006,2406,26-09-2019 19:50:00,0,3158.0,2320.0,0.734,15.012,10,7,1,6,3,1,2,0,0.0,0.0
1006,2407,26-09-2019 19:52:00,0,2910.0,2216.0,0.761,13.919,1,0,0,0,1,0,1,0,0.0,0.0
1006,2408,26-09-2019 19:54:00,0,2933.0,2145.0,0.731,13.932,1,1,1,0,0,0,0,0,0.0,0.0
1006,2409,26-09-2019 19:56:00,0,2820.0,2065.0,0.732,13.398,1,1,0,1,0,0,0,0,0.0,0.0
1006,2410,26-09-2019 19:58:00,0,2698.0,2053.0,0.761,12.903,0,0,0,0,0,0,0,0,0.0,0.0
1006,2411,26-09-2019 20:00:00,0,2709.0,1998.0,0.737,12.887,3,3,2,1,0,0,0,0,0.0,0.0
1006,2412,26-09-2019 20:02:00,0,2713.0,1961.0,0.723,12.86,11,11,0,11,0,0,0,0,0.0,0.0
1006,2413,26-09-2019 20:04:00,0,2724.0,1945.0,0.714,12.886,257,179,136,43,78,64,14,30,0.0,0.0
1006,2414,26-09-2019 20:06:00,0,2951.0,2099.0,0.711,13.951,198,142,105,37,56,36,20,12,0.0,0.0
1006,2415,26-09-2019 20:08:00,0,3045.0,2241.0,0.736,14.478,92,57,38,19,35,20,15,1,0.0,0.0
1006,2416,26-09-2019 20:10:00,0,3140.0,2359.0,0.751,14.982,312,202,151,51,110,79,31,14,0.0,0.0
1006,2417,26-09-2019 20:12:00,0,3528.0,2482.0,0.703,16.649,367,195,142,53,172,128,44,10,0.0,0.0
1006,2418,26-09-2019 20:14:00,0,3488.0,2599.0,0.745,16.621,525,251,202,49,274,240,34,121,0.0,0.0
1006,2419,26-09-2019 20:16:00,0,3486.0,2598.5,0.7455,16.612,348,216,166,50,132,105,27,44,0.0,0.0
1006,2420,26-09-2019 20:18:00,0,3484.0,2598.0,0.746,16.603,171,117,83,34,54,34,20,1,0.0,0.0
1006,2421,26-09-2019 20:20:00,0,3727.0,2674.0,0.718,17.644,217,132,94,38,85,56,29,40,0.0,0.0
1006,2422,26-09-2019 20:22:00,0,3710.0,2750.0,0.741,17.662,177,122,90,32,55,34,21,19,0.0,0.0
1006,2423,26-09-2019 20:24:00,0,3728.0,2725.0,0.731,17.708,280,136,107,29,144,109,35,52,0.0,0.0
1006,2424,26-09-2019 20:26:00,0,3712.0,2781.0,0.749,17.703,427,230,164,66,197,144,53,13,0.0,0.0
1006,2425,26-09-2019 20:28:00,0,3731.0,2749.0,0.737,17.745,255,175,126,49,80,62,18,35,0.0,0.0
1006,2426,26-09-2019 20:30:00,0,3718.0,2740.0,0.737,17.685,218,118,79,39,100,57,43,9,0.0,0.0
1006,2427,26-09-2019 20:32:00,0,3964.0,2847.0,0.718,18.769,108,64,41,23,44,23,21,1,0.0,0.0
1006,2428,26-09-2019 20:34:00,0,3727.0,2702.0,0.725,17.675,78,52,31,21,26,20,6,1,0.0,0.0
1006,2429,26-09-2019 20:36:00,0,3703.0,2788.0,0.753,17.676,272,182,147,35,90,67,23,52,0.0,0.0
1006,2430,26-09-2019 20:38:00,0,3721.0,2713.0,0.729,17.664,53,44,23,21,9,2,7,0,0.0,0.0
1006,2431,26-09-2019 20:40:00,0,3726.0,2735.0,0.734,17.71,97,73,54,19,24,17,7,0,0.0,0.0
1006,2432,26-09-2019 20:42:00,0,3725.0,2705.0,0.726,17.672,100,64,35,29,36,26,10,4,0.0,0.0
1006,2433,26-09-2019 20:44:00,0,3737.0,2678.0,0.717,17.687,5,3,2,1,2,0,2,0,0.0,0.0
1006,2434,26-09-2019 20:46:00,0,3496.0,2567.0,0.734,16.616,6,2,1,1,4,3,1,0,0.0,0.0
1006,2435,26-09-2019 20:48:00,0,3266.0,2458.0,0.753,15.591,141,109,76,33,32,24,8,3,0.0,0.0
1006,2436,26-09-2019 20:50:00,0,3259.5,2458.0,0.7545,15.564,40,37,28,9,3,1,2,0,0.0,0.0
1006,2437,26-09-2019 20:52:00,0,3253.0,2458.0,0.756,15.537,2,2,1,1,0,0,0,0,0.0,0.0
1006,2438,26-09-2019 20:54:00,0,3286.0,2374.0,0.723,15.574,3,3,1,2,0,0,0,0,0.0,0.0
1006,2439,26-09-2019 20:56:00,0,2907.0,2244.0,0.772,13.939,3,3,1,2,0,0,0,0,0.0,0.0
1006,2440,26-09-2019 20:58:00,0,2930.0,2161.0,0.738,13.937,4,4,2,2,0,0,0,0,0.0,0.0
1006,2441,26-09-2019 21:00:00,0,2954.0,2096.0,0.71,13.959,3,3,0,3,0,0,0,0,0.0,0.0
1006,2442,26-09-2019 21:02:00,0,2704.0,2019.0,0.747,12.89,0,0,0,0,0,0,0,0,0.0,0.0
1006,2443,26-09-2019 21:04:00,0,2719.0,1954.0,0.719,12.877,1,1,1,0,0,0,0,0,0.0,0.0
1006,2444,26-09-2019 21:06:00,0,2726.0,1896.0,0.696,12.839,37,34,25,9,3,2,1,1,0.0,0.0
1006,2445,26-09-2019 21:08:00,0,2607.0,1857.0,0.712,12.33,289,198,153,45,91,74,17,14,0.0,0.0
1006,2446,26-09-2019 21:10:00,0,2703.0,2000.0,0.74,12.864,249,151,111,40,98,63,35,24,0.0,0.0
1006,2447,26-09-2019 21:12:00,0,2913.0,2232.0,0.766,13.949,261,159,119,40,102,71,31,41,0.0,0.0
1006,2448,26-09-2019 21:14:00,0,3131.0,2415.0,0.771,15.012,173,82,55,27,91,60,31,5,0.0,0.0
1006,2449,26-09-2019 21:16:00,0,3381.0,2489.0,0.736,16.079,142,87,42,45,55,36,19,0,0.0,0.0
1006,2450,26-09-2019 21:18:00,0,3479.0,2610.0,0.75,16.598,309,214,172,42,95,71,24,61,0.0,0.0
1006,2451,26-09-2019 21:20:00,0,3499.0,2585.0,0.739,16.649,385,230,175,55,155,116,39,85,0.0,0.0
1006,2452,26-09-2019 21:22:00,0,3705.0,2770.0,0.748,17.667,303,176,139,37,127,88,39,67,0.0,0.0
1006,2453,26-09-2019 21:24:00,0,3599.0,2690.5,0.748,17.16,102,45,24,21,57,26,31,8,0.0,0.0
1006,2454,26-09-2019 21:26:00,0,3493.0,2611.0,0.748,16.653,165,100,69,31,65,41,24,49,0.0,0.0
1006,2455,26-09-2019 21:28:00,0,3740.0,2662.0,0.712,17.683,294,198,148,50,96,70,26,0,0.0,0.0
1006,2456,26-09-2019 21:30:00,0,3723.0,2738.0,0.735,17.7,185,112,75,37,73,47,26,40,0.0,0.0
1006,2457,26-09-2019 21:32:00,0,3726.0,2737.0,0.735,17.71,246,163,123,40,83,62,21,30,0.0,0.0
1006,2458,26-09-2019 21:34:00,0,3600.0,2647.0,0.735,17.116,134,83,50,33,51,25,26,3,0.0,0.0
1006,2459,26-09-2019 21:36:00,0,3609.0,2623.0,0.727,17.126,268,171,132,39,97,67,30,21,0.0,0.0
1006,2460,26-09-2019 21:38:00,0,3488.0,2625.0,0.753,16.65,184,121,84,37,63,33,30,15,0.0,0.0
1006,2461,26-09-2019 21:40:00,0,3485.0,2567.0,0.737,16.576,132,62,35,27,70,44,26,0,0.0,0.0
1006,2462,26-09-2019 21:42:00,0,3749.0,2657.0,0.709,17.712,264,183,139,44,81,48,33,11,0.0,0.0
1006,2463,26-09-2019 21:44:00,0,3484.0,2619.0,0.751,16.628,187,155,117,38,32,16,16,11,0.0,0.0
1006,2464,26-09-2019 21:46:00,0,3743.0,2661.0,0.711,17.694,60,53,34,19,7,3,4,0,0.0,0.0
1006,2465,26-09-2019 21:48:00,0,3517.0,2527.0,0.718,16.655,89,77,41,36,12,0,12,1,0.0,0.0
1006,2466,26-09-2019 21:50:00,0,3493.0,2587.0,0.74,16.629,155,105,74,31,50,25,25,36,0.0,0.0
1006,2467,26-09-2019 21:52:00,0,3479.0,2631.0,0.756,16.622,3,3,1,2,0,0,0,0,0.0,0.0
1006,2468,26-09-2019 21:54:00,0,3384.0,2515.0,0.743,16.119,0,0,0,0,0,0,0,0,0.0,0.0
1006,2469,26-09-2019 21:56:00,0,3271.0,2397.0,0.733,15.544,0,0,0,0,0,0,0,0,0.0,0.0
1006,2470,26-09-2019 21:58:00,0,3100.0,2289.5,0.739,14.75,0,0,0,0,0,0,0,0,0.0,0.0
1006,2471,26-09-2019 22:00:00,0,2929.0,2182.0,0.745,13.956,1,0,0,0,1,1,0,0,0.0,0.0
1006,2472,26-09-2019 22:02:00,0,2949.0,2091.0,0.709,13.934,0,0,0,0,0,0,0,0,0.0,0.0
1006,2473,26-09-2019 22:04:00,0,2704.0,2012.0,0.744,12.881,20,16,3,13,4,2,2,0,0.0,0.0
1006,2474,26-09-2019 22:06:00,0,2701.0,2033.0,0.753,12.894,199,121,74,47,78,55,23,36,0.0,0.0
1006,2475,26-09-2019 22:08:00,0,2927.0,2204.0,0.753,13.971,350,216,165,51,134,95,39,25,0.0,0.0
1006,2476,26-09-2019 22:10:00,0,2912.0,2240.0,0.769,13.956,304,173,120,53,131,80,51,5,0.0,0.0
1006,2477,26-09-2019 22:12:00,0,3269.0,2424.0,0.742,15.564,234,158,121,37,76,51,25,22,0.0,0.0
1006,2478,26-09-2019 22:14:00,0,3255.0,2438.0,0.749,15.524,105,70,44,26,35,12,23,22,0.0,0.0
1006,2479,26-09-2019 22:16:00,0,3147.0,2367.0,0.752,15.019,137,106,75,31,31,11,20,3,0.0,0.0
1006,2480,26-09-2019 22:18:00,0,3266.0,2445.0,0.749,15.574,96,54,24,30,42,18,24,0,0.0,0.0
1006,2481,26-09-2019 22:20:00,0,3612.0,2620.0,0.725,17.135,208,155,113,42,53,36,17,11,0.0,0.0
1006,2482,26-09-2019 22:22:00,0,3523.0,2526.0,0.717,16.676,199,107,77,30,92,61,31,2,0.0,0.0
1006,2483,26-09-2019 22:24:00,0,3498.0,2610.0,0.746,16.67,83,34,12,22,49,27,22,2,0.04,0.0
1006,2484,26-09-2019 22:26:00,0,3712.0,2720.0,0.733,17.638,122,44,25,19,78,45,33,1,0.02,0.0
1006,2485,26-09-2019 22:28:00,0,3282.0,2354.0,0.717,15.54,185,119,80,39,66,38,28,9,0.01,0.0
1006,2486,26-09-2019 22:30:00,0,3394.0,2488.0,0.733,16.128,226,152,112,40,74,51,23,63,0.0,0.0
1006,2487,26-09-2019 22:32:00,0,3553.0,2629.0,0.7395,16.9095,88,31,16,15,57,26,31,0,0.0,0.0
1006,2488,26-09-2019 22:34:00,0,3712.0,2770.0,0.746,17.691,158,65,39,26,93,63,30,2,0.0,0.0
1006,2489,26-09-2019 22:36:00,0,3611.0,2639.0,0.731,17.149,271,186,137,49,85,54,31,16,0.03,0.0
1006,2490,26-09-2019 22:38:00,0,3495.0,2600.0,0.744,16.651,254,161,121,40,93,65,28,58,0.0,0.0
1006,2491,26-09-2019 22:40:00,0,3732.0,2704.0,0.724,17.698,188,108,71,37,80,53,27,9,0.02,0.0
1006,2492,26-09-2019 22:42:00,0,3506.0,2571.0,0.733,16.66,185,96,71,25,89,52,37,13,0.0,0.0
1006,2493,26-09-2019 22:44:00,0,3724.0,2673.0,0.718,17.633,156,84,55,29,72,43,29,2,0.01,0.0
1006,2494,26-09-2019 22:46:00,0,3728.0,2743.0,0.736,17.725,234,101,77,24,133,98,35,38,0.02,0.0
1006,2495,26-09-2019 22:48:00,0,3469.0,2660.0,0.767,16.614,324,192,140,52,132,103,29,80,0.0,0.0
1006,2496,26-09-2019 22:50:00,0,3486.0,2591.0,0.743,16.605,86,46,25,21,40,18,22,0,0.0,0.0
1006,2497,26-09-2019 22:52:00,0,3734.0,2692.0,0.721,17.692,110,85,54,31,25,6,19,2,0.0,0.0
1006,2498,26-09-2019 22:54:00,0,3733.0,2750.0,0.737,17.753,131,102,71,31,29,8,21,14,0.0,0.0
1006,2499,26-09-2019 22:56:00,0,3246.0,2455.0,0.756,15.51,122,118,80,38,4,2,2,3,0.0,0.0
1006,2500,26-09-2019 22:58:00,0,3522.0,2553.0,0.725,16.706,126,100,60,40,26,4,22,2,0.0,0.0
1006,2501,26-09-2019 23:00:00,0,3720.0,2694.0,0.724,17.639,86,59,25,34,27,5,22,0,0.0,0.0
1006,2502,26-09-2019 23:02:00,0,3729.0,2700.0,0.724,17.682,128,56,30,26,72,39,33,15,0.0,0.0
1006,2503,26-09-2019 23:04:00,0,3722.0,2755.0,0.74,17.716,273,178,128,50,95,64,31,74,0.0,0.0
1006,2504,26-09-2019 23:06:00,0,3611.5,2655.5,0.735,17.1695,185,133,100,33,52,39,13,12,0.0,0.0
1006,2505,26-09-2019 23:08:00,0,3501.0,2556.0,0.73,16.623,5,5,0,5,0,0,0,0,0.0,0.0
1006,2506,26-09-2019 23:10:00,0,3251.0,2489.0,0.765,15.566,19,19,0,19,0,0,0,0,0.0,0.0
1006,2507,26-09-2019 23:12:00,0,3265.0,2392.0,0.733,15.514,0,0,0,0,0,0,0,0,0.0,0.0
1006,2508,26-09-2019 23:14:00,0,3033.0,2291.0,0.755,14.486,3,3,0,3,0,0,0,0,0.0,0.0
1006,2509,26-09-2019 23:16:00,0,2925.0,2220.0,0.759,13.985,0,0,0,0,0,0,0,0,0.0,0.0
1006,2510,26-09-2019 23:18:00,0,2936.0,2089.0,0.711,13.883,22,20,8,12,2,1,1,0,0.0,0.0
1006,2511,26-09-2019 23:20:00,0,2693.0,2047.0,0.76,12.875,2,2,2,0,0,0,0,0,0.0,0.0
1006,2512,26-09-2019 23:22:00,0,2721.0,1965.0,0.722,12.895,3,3,1,2,0,0,0,0,0.01,0.0
1006,2513,26-09-2019 23:24:00,0,2597.0,1884.0,0.725,12.317,2,2,0,2,0,0,0,0,0.0,0.0
1006,2514,26-09-2019 23:26:00,0,2352.0,1825.0,0.776,11.289,2,2,0,2,0,0,0,0,0.0,0.0
1006,2515,26-09-2019 23:28:00,0,2363.0,1760.0,0.745,11.261,21,21,9,12,0,0,0,0,0.0,0.0
1006,2516,26-09-2019 23:30:00,0,2365.0,1743.0,0.737,11.25,3,3,0,3,0,0,0,0,0.0,0.0
1006,2517,26-09-2019 23:32:00,0,2245.0,1697.0,0.756,10.723,0,0,0,0,0,0,0,0,0.0,0.0
1006,2518,26-09-2019 23:34:00,0,2134.0,1644.0,0.77,10.228,0,0,0,0,0,0,0,0,0.0,0.0
1006,2519,26-09-2019 23:36:00,0,2121.0,1612.0,0.76,10.141,0,0,0,0,0,0,0,0,0.0,0.0
1006,2520,26-09-2019 23:38:00,0,2140.0,1610.0,0.753,10.214,8,8,4,4,0,0,0,0,0.0,0.0
1006,2521,26-09-2019 23:40:00,0,2238.5,1714.0,0.7655,10.717,375,210,170,40,165,127,38,72,0.0,0.0
1006,2522,26-09-2019 23:42:00,0,2337.0,1818.0,0.778,11.22,307,217,175,42,90,67,23,99,0.0,0.0
1006,2523,26-09-2019 23:44:00,0,2952.0,2139.0,0.725,13.998,210,133,94,39,77,51,26,15,0.0,0.0
1006,2524,26-09-2019 23:46:00,0,2917.0,2182.0,0.748,13.911,128,59,26,33,69,26,43,0,0.0,0.0
1006,2525,26-09-2019 23:48:00,0,3147.0,2339.0,0.743,14.99,186,120,83,37,66,34,32,9,0.0,0.0
1006,2526,26-09-2019 23:50:00,0,3500.0,2580.0,0.737,16.647,291,176,136,40,115,88,27,23,0.0,0.0
1006,2527,26-09-2019 23:52:00,0,3488.0,2605.0,0.747,16.629,186,99,76,23,87,62,25,52,0.0,0.0
1006,2528,26-09-2019 23:54:00,0,3287.0,2366.0,0.72,15.571,141,92,69,23,49,33,16,57,0.0,0.0
1006,2529,26-09-2019 23:56:00,0,3261.0,2465.0,0.756,15.579,247,161,110,51,86,57,29,12,0.0,0.0
1006,2530,26-09-2019 23:58:00,0,3513.0,2515.0,0.716,16.626,156,119,92,27,37,19,18,22,0.01,0.0
1006,2531,27-09-2019 00:00:00,0,3392.0,2479.0,0.731,16.11,129,63,36,27,66,39,27,52,0.0,0.0
1006,2532,27-09-2019 00:02:00,0,3473.0,2655.0,0.765,16.623,179,74,45,29,105,62,43,30,0.0,0.0
1006,2533,27-09-2019 00:04:00,0,3381.0,2500.0,0.739,16.091,256,164,120,44,92,58,34,7,0.0,0.0
1006,2534,27-09-2019 00:06:00,0,3503.0,2548.0,0.728,16.624,89,52,22,30,37,18,19,3,0.0,0.0
1006,2535,27-09-2019 00:08:00,0,3746.0,2655.0,0.709,17.698,174,106,69,37,68,47,21,25,0.0,0.0
1006,2536,27-09-2019 00:10:00,0,3617.0,2673.0,0.739,17.209,74,57,35,22,17,6,11,2,0.0,0.0
1006,2537,27-09-2019 00:12:00,0,3729.0,2678.0,0.718,17.659,86,36,13,23,50,28,22,5,0.0,0.0
1006,2538,27-09-2019 00:14:00,0,3491.0,2582.0,0.741,16.614,307,154,113,41,153,119,34,40,0.05,0.0
1006,2539,27-09-2019 00:16:00,0,3253.0,2486.0,0.764,15.569,89,52,27,25,37,14,23,0,0.0,0.0
1006,2540,27-09-2019 00:18:00,0,3509.0,2552.0,0.727,16.653,216,162,126,36,54,35,19,10,0.0,0.0
1006,2541,27-09-2019 00:20:00,0,3492.0,2583.0,0.74,16.618,350,234,176,58,116,85,31,50,0.0,0.0
1006,2542,27-09-2019 00:22:00,0,3736.0,2697.0,0.722,17.707,277,183,142,41,94,71,23,38,0.0,0.0
1006,2543,27-09-2019 00:24:00,0,3257.0,2450.0,0.752,15.545,146,128,83,45,18,10,8,0,0.0,0.0
1006,2544,27-09-2019 00:26:00,0,3391.0,2496.0,0.736,16.125,46,46,9,37,0,0,0,0,0.0,0.0
1006,2545,27-09-2019 00:28:00,0,3522.0,2509.0,0.712,16.656,21,20,1,19,1,0,1,0,0.0,0.0
1006,2546,27-09-2019 00:30:00,0,3509.0,2533.0,0.722,16.631,33,31,4,27,2,2,0,0,0.0,0.0
1006,2547,27-09-2019 00:32:00,0,3504.0,2513.0,0.717,16.589,5,2,0,2,3,1,2,0,0.0,0.0
1006,2548,27-09-2019 00:34:00,0,3267.0,2412.0,0.738,15.542,4,1,0,1,3,0,3,0,0.0,0.0
1006,2549,27-09-2019 00:36:00,0,3168.0,2303.0,0.727,15.031,9,0,0,0,9,0,9,0,0.02,0.0
1006,2550,27-09-2019 00:38:00,0,2917.0,2201.0,0.754,13.929,8,0,0,0,8,0,8,0,0.0,0.0
1006,2551,27-09-2019 00:40:00,0,2937.0,2104.0,0.716,13.903,10,0,0,0,10,0,10,0,0.0,0.0
1006,2552,27-09-2019 00:42:00,0,2705.0,2004.0,0.741,12.878,9,6,3,3,3,0,3,0,0.0,0.0
1006,2553,27-09-2019 00:44:00,0,2725.0,1911.0,0.701,12.853,8,0,0,0,8,0,8,0,0.0,0.0
1006,2554,27-09-2019 00:46:00,0,2745.0,1867.0,0.68,12.881,10,0,0,0,10,0,10,0,0.0,0.0
1006,2555,27-09-2019 00:48:00,0,2556.5,1797.5,0.705,12.063,10,0,0,0,10,0,10,0,0.0,0.0
1006,2556,27-09-2019 00:50:00,0,2368.0,1728.0,0.73,11.245,6,0,0,0,6,0,6,0,0.0,0.0
1006,2557,27-09-2019 00:52:00,0,2391.0,1678.0,0.702,11.28,23,0,0,0,23,0,23,0,0.0,0.0
1006,2558,27-09-2019 00:54:00,0,2131.0,1614.0,0.758,10.184,12,0,0,0,12,0,12,0,0.0,0.0
1006,2559,27-09-2019 00:56:00,0,2143.0,1569.0,0.732,10.181,17,0,0,0,17,0,17,0,0.0,0.0
1006,2560,27-09-2019 00:58:00,0,2145.0,1551.0,0.723,10.169,24,0,0,0,24,0,24,0,0.0,0.0
1006,2561,27-09-2019 01:00:00,0,2156.0,1524.0,0.707,10.182,46,20,7,13,26,0,26,2,0.0,0.0
1006,2562,27-09-2019 01:02:00,0,2148.0,1530.0,0.712,10.159,349,146,111,35,203,157,46,43,0.0,0.0
1006,2563,27-09-2019 01:04:00,0,2357.0,1785.0,0.757,11.263,297,134,100,34,163,108,55,42,0.0,0.0
1006,2564,27-09-2019 01:06:00,0,2478.0,1846.0,0.745,11.807,261,139,95,44,122,83,39,15,0.0,0.0
1006,2565,27-09-2019 01:08:00,0,2701.0,2024.0,0.749,12.883,337,210,160,50,127,86,41,72,0.0,0.0
1006,2566,27-09-2019 01:10:00,0,3160.0,2309.0,0.731,15.006,249,172,134,38,77,53,24,12,0.0,0.0
1006,2567,27-09-2019 01:12:00,0,3268.0,2407.0,0.737,15.541,357,206,164,42,151,114,37,84,0.0,0.0
1006,2568,27-09-2019 01:14:00,0,3477.0,2573.0,0.74,16.547,319,211,163,48,108,81,27,37,0.0,0.0
1006,2569,27-09-2019 01:16:00,0,3389.0,2431.0,0.717,16.045,173,95,59,36,78,43,35,2,0.0,0.0
1006,2570,27-09-2019 01:18:00,0,3278.0,2360.0,0.72,15.528,97,49,26,23,48,29,19,7,0.0,0.0
1006,2571,27-09-2019 01:20:00,0,3494.0,2550.0,0.73,16.589,140,89,64,25,51,29,22,33,0.0,0.0
1006,2572,27-09-2019 01:22:00,0,3329.0,2440.5,0.7335,15.819,84,52,37,15,32,24,8,8,0.0,0.0
1006,2573,27-09-2019 01:24:00,0,3164.0,2331.0,0.737,15.049,168,124,92,32,44,29,15,24,0.0,0.0
1006,2574,27-09-2019 01:26:00,0,3489.0,2601.0,0.745,16.628,179,120,79,41,59,44,15,53,0.0,0.0
1006,2575,27-09-2019 01:28:00,0,3617.0,2601.0,0.719,17.133,116,94,51,43,22,7,15,0,0.01,0.0
1006,2576,27-09-2019 01:30:00,0,3707.0,2751.0,0.742,17.652,316,167,132,35,149,118,31,127,0.0,0.0
1006,2577,27-09-2019 01:32:00,0,3484.0,2589.0,0.743,16.592,445,336,272,64,109,76,33,152,0.0,0.0
1006,2578,27-09-2019 01:34:00,0,3751.0,2672.0,0.712,17.74,348,234,189,45,114,81,33,101,0.0,0.0
1006,2579,27-09-2019 01:36:00,0,3719.0,2759.0,0.742,17.709,373,227,168,59,146,116,30,222,0.01,0.0
1006,2580,27-09-2019 01:38:00,0,4078.0,2873.0,0.705,19.248,341,216,156,60,125,95,30,166,0.0,0.0
1006,2581,27-09-2019 01:40:00,0,4082.0,2940.0,0.72,19.339,448,308,248,60,140,100,40,156,0.0,0.0
1006,2582,27-09-2019 01:42:00,0,4068.0,2982.0,0.733,19.33,445,271,216,55,174,134,40,105,0.0,0.0
1006,2583,27-09-2019 01:44:00,0,4074.0,2875.0,0.706,19.237,227,147,95,52,80,55,25,88,0.05,0.0
1006,2584,27-09-2019 01:46:00,0,4094.0,2846.0,0.695,19.281,106,80,53,27,26,15,11,8,0.0,0.0
1006,2585,27-09-2019 01:48:00,0,3837.0,2780.0,0.725,18.194,253,165,117,48,88,61,27,45,0.0,0.0
1006,2586,27-09-2019 01:50:00,0,3722.0,2737.0,0.735,17.695,213,165,126,39,48,23,25,41,0.0,0.0
1006,2587,27-09-2019 01:52:00,0,3746.0,2662.0,0.711,17.709,28,17,9,8,11,2,9,0,0.0,0.0
1006,2588,27-09-2019 01:54:00,0,3630.0,2588.0,0.713,17.166,27,21,6,15,6,0,6,0,0.0,0.0
1006,2589,27-09-2019 01:56:00,0,3622.0,2580.5,0.7125,17.128,101,68,41,27,33,11,22,0,0.0,0.0
1006,2590,27-09-2019 01:58:00,0,3614.0,2573.0,0.712,17.09,67,46,28,18,21,4,17,0,0.01,0.0
1006,2591,27-09-2019 02:00:00,0,3520.0,2532.0,0.719,16.673,7,7,2,5,0,0,0,0,0.0,0.0
1006,2592,27-09-2019 02:02:00,0,3412.0,2427.0,0.711,16.13,3,2,0,2,1,0,1,0,0.0,0.0
1006,2593,27-09-2019 02:04:00,0,3296.0,2282.0,0.692,15.514,4,4,1,3,0,0,0,0,0.0,0.0
1006,2594,27-09-2019 02:06:00,0,2927.0,2160.0,0.738,13.924,6,6,4,2,0,0,0,0,0.0,0.0
1006,2595,27-09-2019 02:08:00,0,2954.0,2071.0,0.701,13.932,11,10,5,5,1,0,1,0,0.0,0.0
1006,2596,27-09-2019 02:10:00,0,2715.0,1987.0,0.732,12.897,0,0,0,0,0,0,0,0,0.0,0.0
1006,2597,27-09-2019 02:12:00,0,2733.0,1887.0,0.691,12.857,0,0,0,0,0,0,0,0,0.02,0.0
1006,2598,27-09-2019 02:14:00,0,2623.0,1805.0,0.688,12.335,7,7,0,7,0,0,0,0,0.0,0.0
1006,2599,27-09-2019 02:16:00,0,2372.0,1738.0,0.733,11.271,5,5,0,5,0,0,0,0,0.0,0.0
1006,2600,27-09-2019 02:18:00,0,2388.0,1683.0,0.705,11.273,3,3,0,3,0,0,0,0,0.0,0.0
1006,2601,27-09-2019 02:20:00,0,2264.0,1615.0,0.713,10.708,1,0,0,0,1,0,1,0,0.0,0.0
1006,2602,27-09-2019 02:22:00,0,2147.0,1573.0,0.733,10.2,0,0,0,0,0,0,0,0,0.0,0.0
1006,2603,27-09-2019 02:24:00,0,2150.0,1529.0,0.711,10.166,0,0,0,0,0,0,0,0,0.0,0.0
1006,2604,27-09-2019 02:26:00,0,2161.0,1492.0,0.69,10.167,0,0,0,0,0,0,0,0,0.0,0.0
1006,2605,27-09-2019 02:28:00,0,2178.0,1451.0,0.666,10.189,225,132,111,21,93,64,29,32,0.0,0.0
1006,2606,27-09-2019 02:30:00,0,2281.5,1557.0,0.6815,10.713,199,109,70,39,90,68,22,37,0.0,0.0
1006,2607,27-09-2019 02:32:00,0,2385.0,1663.0,0.697,11.237,82,41,21,20,41,28,13,8,0.0,0.0
1006,2608,27-09-2019 02:34:00,0,2494.0,1801.0,0.722,11.82,89,70,40,30,19,7,12,6,0.0,0.0
1006,2609,27-09-2019 02:36:00,0,2710.0,1989.0,0.734,12.881,219,189,126,63,30,10,20,15,0.0,0.0
1006,2610,27-09-2019 02:38:00,0,2936.0,2150.0,0.732,13.951,302,266,192,74,36,23,13,8,0.0,0.0
1006,2611,27-09-2019 02:40:00,0,3160.0,2292.0,0.725,14.988,192,162,110,52,30,15,15,0,0.0,0.0
1006,2612,27-09-2019 02:42:00,0,3282.0,2396.0,0.73,15.585,207,122,95,27,85,60,25,31,0.0,0.0
1006,2613,27-09-2019 02:44:00,0,3176.0,2285.0,0.719,15.043,146,85,60,25,61,25,36,26,0.0,0.0
1006,2614,27-09-2019 02:46:00,0,3155.0,2281.0,0.723,14.956,253,130,92,38,123,83,40,68,0.0,0.0
1006,2615,27-09-2019 02:48:00,0,3295.0,2345.0,0.712,15.578,189,167,112,55,22,16,6,9,0.0,0.0
1006,2616,27-09-2019 02:50:00,0,3270.0,2417.0,0.739,15.563,272,204,156,48,68,51,17,59,0.0,0.0
1006,2617,27-09-2019 02:52:00,0,3047.0,2216.0,0.727,14.46,92,74,43,31,18,11,7,1,0.0,0.0
1006,2618,27-09-2019 02:54:00,0,3170.0,2307.0,0.728,15.045,165,133,100,33,32,16,16,27,0.0,0.0
1006,2619,27-09-2019 02:56:00,0,3144.0,2366.0,0.753,15.008,174,124,97,27,50,35,15,45,0.0,0.0
1006,2620,27-09-2019 02:58:00,0,3151.0,2331.0,0.74,14.998,124,80,44,36,44,22,22,0,0.0,0.0
1006,2621,27-09-2019 03:00:00,0,3512.0,2530.0,0.72,16.64,114,85,60,25,29,15,14,9,0.01,0.0
1006,2622,27-09-2019 03:02:00,0,3287.0,2325.0,0.707,15.525,53,47,19,28,6,0,6,0,0.0,0.0
1006,2623,27-09-2019 03:04:00,0,3229.0,2322.5,0.7195,15.295,41,29,6,23,12,0,12,0,0.0,0.0
1006,2624,27-09-2019 03:06:00,0,3171.0,2320.0,0.732,15.065,48,23,12,11,25,2,23,1,0.0,0.0
1006,2625,27-09-2019 03:08:00,0,3281.0,2350.0,0.716,15.531,15,11,4,7,4,0,4,0,0.0,0.0
1006,2626,27-09-2019 03:10:00,0,3309.0,2278.0,0.688,15.559,0,0,0,0,0,0,0,0,0.0,0.0
1006,2627,27-09-2019 03:12:00,0,3068.0,2182.0,0.711,14.503,0,0,0,0,0,0,0,0,0.0,0.0
1006,2628,27-09-2019 03:14:00,0,2954.0,2063.0,0.699,13.923,1,0,0,0,1,0,1,0,0.0,0.0
1006,2629,27-09-2019 03:16:00,0,2851.0,1965.0,0.689,13.41,3,2,0,2,1,0,1,0,0.01,0.0
1006,2630,27-09-2019 03:18:00,0,2726.0,1900.0,0.697,12.847,1,1,0,1,0,0,0,0,0.0,0.0
1006,2631,27-09-2019 03:20:00,0,2757.0,1808.0,0.656,12.865,11,11,2,9,0,0,0,0,0.0,0.0
1006,2632,27-09-2019 03:22:00,0,2371.0,1735.0,0.732,11.263,0,0,0,0,0,0,0,0,0.0,0.0
1006,2633,27-09-2019 03:24:00,0,2372.0,1717.0,0.724,11.248,0,0,0,0,0,0,0,0,0.0,0.0
1006,2634,27-09-2019 03:26:00,0,2391.0,1664.0,0.696,11.264,0,0,0,0,0,0,0,0,0.0,0.0
1006,2635,27-09-2019 03:28:00,0,2270.0,1612.0,0.71,10.728,0,0,0,0,0,0,0,0,0.0,0.0
1006,2636,27-09-2019 03:30:00,0,2152.0,1563.0,0.727,10.209,0,0,0,0,0,0,0,0,0.0,0.0
1006,2637,27-09-2019 03:32:00,0,2151.0,1506.0,0.7,10.143,0,0,0,0,0,0,0,0,0.0,0.0
1006,2638,27-09-2019 03:34:00,0,2176.0,1473.0,0.677,10.204,4,4,1,3,0,0,0,0,0.0,0.0
1006,2639,27-09-2019 03:36:00,0,2180.0,1430.0,0.656,10.175,4,4,1,3,0,0,0,0,0.0,0.0
1006,2640,27-09-2019 03:38:00,0,2160.0,1496.0,0.693,10.169,44,40,19,21,4,1,3,5,0.0,0.0
1006,2641,27-09-2019 03:40:00,0,2140.0,1562.0,0.73,10.163,205,129,109,20,76,57,19,8,0.0,0.0
1006,2642,27-09-2019 03:42:00,0,2394.0,1649.0,0.689,11.258,181,106,73,33,75,60,15,53,0.0,0.0
1006,2643,27-09-2019 03:44:00,0,2378.0,1708.0,0.718,11.259,33,33,10,23,0,0,0,0,0.0,0.0
1006,2644,27-09-2019 03:46:00,0,2622.0,1811.0,0.691,12.336,187,109,83,26,78,47,31,0,0.0,0.0
1006,2645,27-09-2019 03:48:00,0,2750.0,1843.0,0.67,12.877,51,32,7,25,19,5,14,0,0.0,0.0
1006,2646,27-09-2019 03:50:00,0,2844.0,1969.0,0.692,13.386,123,73,30,43,50,20,30,1,0.0,0.0
1006,2647,27-09-2019 03:52:00,0,3057.0,2183.0,0.714,14.463,126,93,59,34,33,18,15,87,0.0,0.0
1006,2648,27-09-2019 03:54:00,0,3175.0,2271.0,0.715,15.023,218,145,101,44,73,39,34,9,0.02,0.0
1006,2649,27-09-2019 03:56:00,0,2935.0,2144.0,0.73,13.938,101,46,27,19,55,34,21,5,0.0,0.0
1006,2650,27-09-2019 03:58:00,0,2960.0,2077.0,0.702,13.965,69,42,20,22,27,1,26,0,0.0,0.0
1006,2651,27-09-2019 04:00:00,0,2944.0,2121.0,0.72,13.948,99,82,44,38,17,2,15,1,0.0,0.0
1006,2652,27-09-2019 04:02:00,0,2935.0,2126.0,0.725,13.916,212,122,88,34,90,61,29,4,0.0,0.0
1006,2653,27-09-2019 04:04:00,0,3174.0,2272.0,0.716,15.023,243,136,98,38,107,76,31,55,0.0,0.0
1006,2654,27-09-2019 04:06:00,0,3155.0,2345.0,0.743,15.026,302,221,170,51,81,61,20,150,0.0,0.0
1006,2655,27-09-2019 04:08:00,0,3298.0,2314.0,0.702,15.558,29,26,0,26,3,1,2,0,0.0,0.0
1006,2656,27-09-2019 04:10:00,0,3174.0,2245.0,0.707,14.994,42,37,17,20,5,3,2,4,0.0,0.0
1006,2657,27-09-2019 04:12:00,0,3179.5,2243.5,0.7055,15.013,14,14,6,8,0,0,0,0,0.0,0.0
1006,2658,27-09-2019 04:14:00,0,3185.0,2242.0,0.704,15.032,0,0,0,0,0,0,0,0,0.0,0.0
1006,2659,27-09-2019 04:16:00,0,2929.0,2162.0,0.738,13.936,4,4,0,4,0,0,0,0,0.0,0.0
1006,2660,27-09-2019 04:18:00,0,2955.0,2075.0,0.702,13.941,0,0,0,0,0,0,0,0,0.0,0.0
1006,2661,27-09-2019 04:20:00,0,2852.0,1982.0,0.695,13.43,0,0,0,0,0,0,0,0,0.0,0.0
1006,2662,27-09-2019 04:22:00,0,2736.0,1887.0,0.69,12.872,0,0,0,0,0,0,0,0,0.0,0.0
1006,2663,27-09-2019 04:24:00,0,2617.0,1811.0,0.692,12.318,0,0,0,0,0,0,0,0,0.0,0.0
1006,2664,27-09-2019 04:26:00,0,2373.0,1734.0,0.731,11.27,0,0,0,0,0,0,0,0,0.0,0.0
1006,2665,27-09-2019 04:28:00,0,2385.0,1667.0,0.699,11.241,4,4,3,1,0,0,0,0,0.0,0.0
1006,2666,27-09-2019 04:30:00,0,2268.0,1607.0,0.709,10.714,14,14,0,14,0,0,0,0,0.0,0.0
1006,2667,27-09-2019 04:32:00,0,2139.0,1566.0,0.732,10.163,0,0,0,0,0,0,0,0,0.0,0.0
1006,2668,27-09-2019 04:34:00,0,2156.0,1521.0,0.706,10.177,0,0,0,0,0,0,0,0,0.0,0.0
1006,2669,27-09-2019 04:36:00,0,2175.0,1469.0,0.675,10.197,14,13,2,11,1,0,1,0,0.0,0.0
1006,2670,27-09-2019 04:38:00,0,2166.0,1479.0,0.683,10.171,8,8,2,6,0,0,0,0,0.0,0.0
1006,2671,27-09-2019 04:40:00,0,2161.0,1474.0,0.682,10.146,7,7,4,3,0,0,0,0,0.0,0.0
1006,2672,27-09-2019 04:42:00,0,2179.0,1458.0,0.669,10.202,24,24,15,9,0,0,0,0,0.0,0.0
1006,2673,27-09-2019 04:44:00,0,2187.0,1423.0,0.651,10.192,5,5,4,1,0,0,0,0,0.0,0.0
1006,2674,27-09-2019 04:46:00,0,2058.5,1392.5,0.6785,9.6535,0,0,0,0,0,0,0,0,0.0,0.0
1006,2675,27-09-2019 04:48:00,0,1930.0,1362.0,0.706,9.115,0,0,0,0,0,0,0,0,0.0,0.0
1006,2676,27-09-2019 04:50:00,0,1940.0,1341.0,0.691,9.13,0,0,0,0,0,0,0,0,0.0,0.0
1006,2677,27-09-2019 04:52:00,0,1940.0,1307.0,0.674,9.092,0,0,0,0,0,0,0,0,0.0,0.0
1006,2678,27-09-2019 04:54:00,0,1950.0,1289.0,0.661,9.108,0,0,0,0,0,0,0,0,0.0,0.0
1006,2679,27-09-2019 04:56:00,0,1952.0,1269.0,0.65,9.096,0,0,0,0,0,0,0,0,0.0,0.0
1006,2680,27-09-2019 04:58:00,0,1960.0,1243.0,0.634,9.1,16,7,4,3,9,0,9,0,0.0,0.0
1006,2681,27-09-2019 05:00:00,0,1927.0,1383.0,0.718,9.123,72,55,33,22,17,10,7,37,0.0,0.0
1006,2682,27-09-2019 05:02:00,0,2380.0,1685.0,0.708,11.244,188,137,105,32,51,33,18,54,0.0,0.0
1006,2683,27-09-2019 05:04:00,0,2492.0,1787.0,0.717,11.799,224,157,121,36,67,41,26,6,0.0,0.0
1006,2684,27-09-2019 05:06:00,0,2708.0,1993.0,0.736,12.878,195,110,75,35,85,47,38,17,0.0,0.0
1006,2685,27-09-2019 05:08:00,0,2710.0,1965.0,0.725,12.855,151,89,66,23,62,46,16,53,0.0,0.0
1006,2686,27-09-2019 05:10:00,0,2923.0,2164.0,0.74,13.915,240,175,134,41,65,33,32,8,0.0,0.0
1006,2687,27-09-2019 05:12:00,0,2957.0,2058.0,0.696,13.931,180,112,78,34,68,49,19,66,0.0,0.0
1006,2688,27-09-2019 05:14:00,0,3178.0,2268.0,0.714,15.032,156,74,47,27,82,55,27,42,0.0,0.0
1006,2689,27-09-2019 05:16:00,0,3277.0,2358.0,0.72,15.521,163,68,44,24,95,61,34,39,0.0,0.0
1006,2690,27-09-2019 05:18:00,0,2928.0,2134.0,0.729,13.899,100,47,20,27,53,26,27,0,0.0,0.0
1006,2691,27-09-2019 05:20:00,0,3038.5,2238.0,0.7365,14.4485,170,63,34,29,107,68,39,31,0.0,0.0
1006,2692,27-09-2019 05:22:00,0,3149.0,2342.0,0.744,14.998,235,139,101,38,96,58,38,64,0.0,0.0
1006,2693,27-09-2019 05:24:00,0,3168.0,2279.0,0.719,15.008,171,79,46,33,92,55,37,9,0.0,0.0
1006,2694,27-09-2019 05:26:00,0,3523.0,2482.0,0.705,16.63,254,127,97,30,127,89,38,59,0.0,0.0
1006,2695,27-09-2019 05:28:00,0,3179.0,2263.0,0.712,15.033,43,27,9,18,16,4,12,1,0.0,0.0
1006,2696,27-09-2019 05:30:00,0,3168.0,2258.0,0.713,14.982,67,63,30,33,4,4,0,2,0.0,0.0
1006,2697,27-09-2019 05:32:00,0,3185.0,2236.0,0.702,15.024,535,444,352,92,91,62,29,56,0.0,0.0
1006,2698,27-09-2019 05:34:00,0,3284.0,2366.0,0.721,15.559,121,89,60,29,32,22,10,64,0.0,0.0
1006,2699,27-09-2019 05:36:00,0,3183.0,2227.0,0.7,15.006,24,24,11,13,0,0,0,0,0.0,0.0
1006,2700,27-09-2019 05:38:00,0,3175.0,2243.0,0.706,14.993,30,30,16,14,0,0,0,0,0.0,0.0
1006,2701,27-09-2019 05:40:00,0,3184.0,2233.0,0.701,15.019,2,2,1,1,0,0,0,0,0.0,0.0
1006,2702,27-09-2019 05:42:00,0,2942.0,2112.0,0.718,13.93,3,3,0,3,0,0,0,0,0.0,0.0
1006,2703,27-09-2019 05:44:00,0,2970.0,2004.0,0.675,13.923,3,3,0,3,0,0,0,0,0.0,0.0
1006,2704,27-09-2019 05:46:00,0,2730.0,1892.0,0.693,12.854,6,6,0,6,0,0,0,0,0.0,0.0
1006,2705,27-09-2019 05:48:00,0,2756.0,1811.0,0.657,12.865,0,0,0,0,0,0,0,0,0.0,0.0
1006,2706,27-09-2019 05:50:00,0,2378.0,1723.0,0.725,11.279,1,1,0,1,0,0,0,0,0.01,0.0
1006,2707,27-09-2019 05:52:00,0,2400.0,1659.0,0.691,11.292,7,7,2,5,0,0,0,0,0.0,0.0
1006,2708,27-09-2019 05:54:00,0,2278.0,1592.0,0.699,10.737,0,0,0,0,0,0,0,0,0.0,0.0
1006,2709,27-09-2019 05:56:00,0,2156.0,1525.0,0.707,10.182,0,0,0,0,0,0,0,0,0.0,0.0
1006,2710,27-09-2019 05:58:00,0,2174.0,1474.0,0.678,10.197,0,0,0,0,0,0,0,0,0.0,0.0
1006,2711,27-09-2019 06:00:00,1,2187.0,1419.0,0.649,10.187,16,9,7,2,7,1,6,0,0.0,0.0
1006,2712,27-09-2019 06:02:00,1,2051.0,1379.0,0.672,9.607,26,21,0,21,5,0,5,0,0.0,0.0
1006,2713,27-09-2019 06:04:00,1,1933.0,1379.0,0.713,9.145,13,12,0,12,1,0,1,0,0.0,0.0
1006,2714,27-09-2019 06:06:00,1,1935.0,1330.0,0.687,9.099,1,1,0,1,0,0,0,0,0.0,0.0
1006,2715,27-09-2019 06:08:00,1,1946.0,1295.0,0.666,9.1,0,0,0,0,0,0,0,0,0.0,0.0
1006,2716,27-09-2019 06:10:00,1,1963.0,1266.0,0.645,9.135,0,0,0,0,0,0,0,0,0.0,0.0
1006,2717,27-09-2019 06:12:00,1,1831.0,1222.0,0.667,8.569,2,0,0,0,2,0,2,0,0.0,0.0
1006,2718,27-09-2019 06:14:00,1,1837.0,1216.0,0.662,8.584,9,9,0,9,0,0,0,0,0.0,0.0
1006,2719,27-09-2019 06:16:00,1,1710.0,1199.0,0.701,8.064,4,4,0,4,0,0,0,0,0.0,0.0
1006,2720,27-09-2019 06:18:00,1,1584.0,1155.0,0.729,7.52,95,56,42,14,39,22,17,1,0.0,0.0
1006,2721,27-09-2019 06:20:00,1,1939.0,1301.0,0.671,9.079,181,142,113,29,39,19,20,18,0.0,0.0
1006,2722,27-09-2019 06:22:00,1,2161.0,1497.0,0.693,10.172,233,161,123,38,72,54,18,33,0.0,0.0
1006,2723,27-09-2019 06:24:00,1,2919.0,2195.0,0.752,13.933,148,97,69,28,51,15,36,78,0.0,0.0
1006,2724,27-09-2019 06:26:00,1,3731.0,2641.0,0.708,17.626,126,90,52,38,36,11,25,63,0.0,0.03
1006,2725,27-09-2019 06:28:00,1,3903.5,2771.0,0.71,18.4495,344,216,164,52,128,74,54,100,0.01,0.05
1006,2726,27-09-2019 06:30:00,1,4076.0,2901.0,0.712,19.273,136,93,52,41,43,8,35,88,0.0,0.04
1006,2727,27-09-2019 06:32:00,1,4026.0,3073.0,0.763,19.266,85,58,30,28,27,4,23,57,0.0,0.12
1006,2728,27-09-2019 06:34:00,1,4014.0,3186.0,0.794,19.343,121,81,47,34,40,3,37,74,0.0,0.01
1006,2729,27-09-2019 06:36:00,1,4230.0,3280.0,0.776,20.297,206,127,84,43,79,45,34,59,0.18,0.11
1006,2730,27-09-2019 06:38:00,1,4048.0,3088.0,0.763,19.369,294,169,129,40,125,89,36,79,0.07,0.0
1006,2731,27-09-2019 06:40:00,1,4214.0,3404.0,0.808,20.373,160,98,68,30,62,38,24,46,0.12,0.05
1006,2732,27-09-2019 06:42:00,1,3647.0,2975.0,0.816,17.663,94,72,50,22,22,9,13,48,0.0,0.04
1006,2733,27-09-2019 06:44:00,1,4173.0,3583.0,0.859,20.407,85,53,35,18,32,12,20,46,0.03,0.05
1006,2734,27-09-2019 06:46:00,1,4164.0,3602.0,0.865,20.396,237,138,104,34,99,62,37,71,0.19,0.01
1006,2735,27-09-2019 06:48:00,1,4377.0,3747.0,0.856,21.395,100,66,37,29,34,4,30,69,0.0,0.09
1006,2736,27-09-2019 06:50:00,1,4501.0,3926.0,0.872,22.08,167,118,90,28,49,38,11,31,0.1,0.04
1006,2737,27-09-2019 06:52:00,1,4371.0,3852.0,0.881,21.486,255,162,126,36,93,57,36,29,0.08,0.0
1006,2738,27-09-2019 06:54:00,1,4120.0,3678.0,0.893,20.304,45,22,10,12,23,13,10,37,0.0,0.04
1006,2739,27-09-2019 06:56:00,1,4707.0,4108.0,0.873,23.094,36,26,8,18,10,6,4,16,0.0,0.28
1006,2740,27-09-2019 06:58:00,1,4160.0,3632.0,0.873,20.41,42,23,15,8,19,12,7,13,0.08,0.01
1006,2741,27-09-2019 07:00:00,1,4242.0,3817.0,0.9,20.939,204,114,89,25,90,68,22,47,0.07,0.0
1006,2742,27-09-2019 07:02:00,1,4185.5,3791.0,0.906,20.6885,72,56,37,19,16,4,12,1,0.0,0.0
1006,2743,27-09-2019 07:04:00,1,4129.0,3765.0,0.912,20.438,211,118,87,31,93,61,32,62,0.09,0.0
1006,2744,27-09-2019 07:06:00,1,3394.0,2942.0,0.867,16.631,49,28,20,8,21,2,19,0,0.01,0.02
1006,2745,27-09-2019 07:08:00,1,3064.0,2702.0,0.882,15.065,80,65,43,22,15,2,13,0,0.0,0.01
1006,2746,27-09-2019 07:10:00,1,4037.0,3555.0,0.881,19.84,0,0,0,0,0,0,0,0,0.01,0.0
1006,2747,27-09-2019 07:12:00,1,3620.0,3172.0,0.876,17.774,53,40,24,16,13,5,8,0,0.01,0.0
1006,2748,27-09-2019 07:14:00,1,3590.0,3246.0,0.904,17.737,0,0,0,0,0,0,0,0,0.0,0.0
1006,2749,27-09-2019 07:16:00,1,3630.0,3088.0,0.851,17.723,0,0,0,0,0,0,0,0,0.0,0.0
1006,2750,27-09-2019 07:18:00,1,3509.0,3037.0,0.866,17.187,10,8,6,2,2,2,0,0,0.0,0.0
1006,2751,27-09-2019 07:20:00,1,3401.0,2973.0,0.874,16.69,0,0,0,0,0,0,0,0,0.0,0.0
1006,2752,27-09-2019 07:22:00,1,3381.0,2998.0,0.887,16.641,25,14,5,9,11,2,9,0,0.0,0.0
1006,2753,27-09-2019 07:24:00,1,3613.0,3154.0,0.873,17.726,0,0,0,0,0,0,0,0,0.0,0.0
1006,2754,27-09-2019 07:26:00,1,3493.0,3131.0,0.896,17.229,1,0,0,0,1,0,1,0,0.0,0.0
1006,2755,27-09-2019 07:28:00,1,3472.0,3136.0,0.903,17.153,1,1,0,1,0,0,0,0,0.0,0.0
1006,2756,27-09-2019 07:30:00,1,3474.0,3178.0,0.915,17.207,9,9,1,8,0,0,0,0,0.0,0.0
1006,2757,27-09-2019 07:32:00,1,3351.0,3157.0,0.942,16.7,36,15,5,10,21,2,19,0,0.0,0.0
1006,2758,27-09-2019 07:34:00,1,3915.0,3518.0,0.899,19.322,208,133,95,38,75,50,25,12,0.06,0.0
1006,2759,27-09-2019 07:36:00,1,4011.0,3650.5,0.91,19.846,144,99,57,42,45,15,30,4,0.0,0.0
1006,2760,27-09-2019 07:38:00,1,4107.0,3783.0,0.921,20.37,177,120,86,34,57,33,24,30,0.0,0.0
1006,2761,27-09-2019 07:40:00,1,4079.0,3950.0,0.969,20.442,234,136,87,49,98,65,33,71,0.07,0.0
1006,2762,27-09-2019 07:42:00,1,4085.0,3912.0,0.958,20.428,122,79,42,37,43,9,34,88,0.01,0.0
1006,2763,27-09-2019 07:44:00,1,4264.0,4183.0,0.981,21.431,196,109,66,43,87,46,41,81,0.03,0.01
1006,2764,27-09-2019 07:46:00,1,4303.0,4135.0,0.961,21.533,158,104,71,33,54,23,31,47,0.01,0.02
1006,2765,27-09-2019 07:48:00,1,4053.0,3977.0,0.981,20.37,156,106,78,28,50,25,25,35,0.0,0.0
1006,2766,27-09-2019 07:50:00,1,4195.0,3997.0,0.953,20.954,146,103,62,41,43,0,43,67,0.0,0.03
1006,2767,27-09-2019 07:52:00,1,4639.0,4386.0,0.945,23.135,140,78,60,18,62,38,24,36,0.11,0.05
1006,2768,27-09-2019 07:54:00,1,3466.0,3209.0,0.926,17.207,13,13,5,8,0,0,0,0,0.01,0.01
1006,2769,27-09-2019 07:56:00,1,3063.0,2704.0,0.883,15.06,1,1,1,0,0,0,0,0,0.0,0.0
1006,2770,27-09-2019 07:58:00,1,2925.0,2681.0,0.917,14.492,0,0,0,0,0,0,0,0,0.0,0.0
1006,2771,27-09-2019 08:00:00,1,2829.0,2604.0,0.921,14.029,0,0,0,0,0,0,0,0,0.0,0.0
1006,2772,27-09-2019 08:02:00,1,2810.0,2589.0,0.921,13.939,11,9,4,5,2,1,1,0,0.0,0.0
1006,2773,27-09-2019 08:04:00,1,2814.0,2615.0,0.929,13.983,0,0,0,0,0,0,0,0,0.0,0.0
1006,2774,27-09-2019 08:06:00,1,3050.0,2715.0,0.89,15.025,0,0,0,0,0,0,0,0,0.0,0.0
1006,2775,27-09-2019 08:08:00,1,3029.0,2824.0,0.932,15.062,0,0,0,0,0,0,0,0,0.0,0.0
1006,2776,27-09-2019 08:10:00,1,3200.0,2911.5,0.911,15.8315,0,0,0,0,0,0,0,0,0.0,0.0
1006,2777,27-09-2019 08:12:00,1,3371.0,2999.0,0.89,16.601,3,3,0,3,0,0,0,0,0.0,0.0
1006,2778,27-09-2019 08:14:00,1,3337.0,3167.0,0.949,16.655,0,0,0,0,0,0,0,0,0.0,0.0
1006,2779,27-09-2019 08:16:00,1,3340.0,3159.0,0.946,16.655,19,19,3,16,0,0,0,0,0.0,0.0
1006,2780,27-09-2019 08:18:00,1,3351.0,3129.0,0.934,16.665,4,4,1,3,0,0,0,0,0.0,0.0
1006,2781,27-09-2019 08:20:00,1,3350.0,3171.0,0.947,16.71,2,2,0,2,0,0,0,0,0.0,0.0
1006,2782,27-09-2019 08:22:00,1,3220.0,3122.0,0.97,16.141,7,7,1,6,0,0,0,0,0.0,0.0
1006,2783,27-09-2019 08:24:00,1,3352.0,3141.0,0.937,16.682,27,17,9,8,10,2,8,0,0.0,0.0
1006,2784,27-09-2019 08:26:00,1,3308.0,3265.0,0.987,16.648,1,0,0,0,1,0,1,0,0.0,0.0
1006,2785,27-09-2019 08:28:00,1,3329.0,3220.0,0.967,16.681,0,0,0,0,0,0,0,0,0.0,0.0
1006,2786,27-09-2019 08:30:00,1,3217.0,3154.0,0.981,16.165,4,3,1,2,1,0,1,0,0.0,0.0
1006,2787,27-09-2019 08:32:00,1,2766.0,2763.0,0.999,13.958,14,7,1,6,7,0,7,0,0.0,0.0
1006,2788,27-09-2019 08:34:00,1,2889.0,2851.0,0.987,14.538,78,38,13,25,40,4,36,5,0.0,0.0
1006,2789,27-09-2019 08:36:00,1,3328.0,3212.0,0.965,16.67,33,22,2,20,11,1,10,4,0.0,0.0
1006,2790,27-09-2019 08:38:00,1,3308.0,3301.0,0.998,16.686,31,18,3,15,13,0,13,0,0.0,0.0
1006,2791,27-09-2019 08:40:00,1,3556.0,3367.0,0.947,17.738,26,5,0,5,21,2,19,0,0.0,0.0
1006,2792,27-09-2019 08:42:00,1,3571.0,3345.0,0.937,17.771,11,5,3,2,6,0,6,0,0.0,0.0
1006,2793,27-09-2019 08:44:00,1,3450.5,3260.0,0.945,17.2035,6,3,2,1,3,0,3,0,0.0,0.0
1006,2794,27-09-2019 08:46:00,1,3330.0,3175.0,0.953,16.636,8,6,3,3,2,0,2,0,0.0,0.0
1006,2795,27-09-2019 08:48:00,1,3352.0,3134.0,0.935,16.678,157,92,52,40,65,30,35,2,0.0,0.0
1006,2796,27-09-2019 08:50:00,1,3357.0,3134.0,0.934,16.696,10,10,0,10,0,0,0,0,0.0,0.0
1006,2797,27-09-2019 08:52:00,1,3094.0,3068.0,0.992,15.587,21,21,0,21,0,0,0,0,0.0,0.0
1006,2798,27-09-2019 08:54:00,1,3014.0,2903.0,0.963,15.087,6,6,0,6,0,0,0,0,0.0,0.0
1006,2799,27-09-2019 08:56:00,1,3022.0,2843.0,0.941,15.054,1,1,0,1,0,0,0,0,0.0,0.0
1006,2800,27-09-2019 08:58:00,1,3034.0,2839.0,0.936,15.097,0,0,0,0,0,0,0,0,0.0,0.0
1006,2801,27-09-2019 09:00:00,1,2900.0,2781.0,0.959,14.507,0,0,0,0,0,0,0,0,0.0,0.0
1006,2802,27-09-2019 09:02:00,1,2781.0,2735.0,0.983,13.985,15,15,2,13,0,0,0,0,0.0,0.0
1006,2803,27-09-2019 09:04:00,1,2784.0,2700.0,0.97,13.958,26,22,6,16,4,0,4,0,0.0,0.0
1006,2804,27-09-2019 09:06:00,1,2781.0,2743.0,0.986,13.994,11,1,0,1,10,0,10,0,0.0,0.0
1006,2805,27-09-2019 09:08:00,1,2787.0,2707.0,0.971,13.98,0,0,0,0,0,0,0,0,0.0,0.0
1006,2806,27-09-2019 09:10:00,1,2799.0,2666.0,0.953,13.978,5,2,1,1,3,0,3,0,0.0,0.0
1006,2807,27-09-2019 09:12:00,1,2810.0,2659.0,0.946,14.016,0,0,0,0,0,0,0,0,0.0,0.0
1006,2808,27-09-2019 09:14:00,1,2799.0,2631.0,0.94,13.941,1,0,0,0,1,0,1,0,0.0,0.0
1006,2809,27-09-2019 09:16:00,1,2813.0,2601.0,0.925,13.962,36,16,11,5,20,4,16,0,0.0,0.0
1006,2810,27-09-2019 09:18:00,1,2908.5,2764.0,0.9495,14.52,42,24,10,14,18,2,16,8,0.0,0.0
1006,2811,27-09-2019 09:20:00,1,3004.0,2927.0,0.974,15.078,244,132,101,31,112,87,25,40,0.0,0.0
1006,2812,27-09-2019 09:22:00,1,3110.0,3028.0,0.974,15.605,292,145,118,27,147,95,52,87,0.0,0.0
1006,2813,27-09-2019 09:24:00,1,3310.0,3270.0,0.988,16.661,149,79,42,37,70,16,54,80,0.0,0.0
1006,2814,27-09-2019 09:26:00,1,3871.0,3732.0,0.964,19.385,179,122,77,45,57,14,43,93,0.0,0.0
1006,2815,27-09-2019 09:28:00,1,4089.0,3910.0,0.956,20.441,181,133,88,45,48,4,44,78,0.0,0.03
1006,2816,27-09-2019 09:30:00,1,4171.0,4066.0,0.975,20.935,244,168,125,43,76,42,34,51,0.08,0.04
1006,2817,27-09-2019 09:32:00,1,3553.0,3369.0,0.948,17.73,1,0,0,0,1,1,0,0,0.01,0.01
1006,2818,27-09-2019 09:34:00,1,3045.0,2790.0,0.916,15.088,44,35,22,13,9,6,3,0,0.0,0.0
1006,2819,27-09-2019 09:36:00,1,2826.0,2552.0,0.903,13.96,64,56,17,39,8,0,8,1,0.0,0.0
1006,2820,27-09-2019 09:38:00,1,2924.0,2691.0,0.92,14.502,41,32,10,22,9,0,9,0,0.0,0.0
1006,2821,27-09-2019 09:40:00,1,2924.0,2691.0,0.92,14.501,3,3,0,3,0,0,0,0,0.0,0.0
1006,2822,27-09-2019 09:42:00,1,3041.0,2801.0,0.921,15.081,2,1,0,1,1,0,1,0,0.01,0.01
1006,2823,27-09-2019 09:44:00,1,3132.0,2921.0,0.933,15.576,3,2,1,1,1,0,1,0,0.0,0.0
1006,2824,27-09-2019 09:46:00,1,3247.0,2967.0,0.914,16.079,6,6,1,5,0,0,0,0,0.0,0.0
1006,2825,27-09-2019 09:48:00,1,3368.0,3091.0,0.918,16.693,8,7,1,6,1,0,1,0,0.0,0.01
1006,2826,27-09-2019 09:50:00,1,3460.0,3241.0,0.937,17.222,0,0,0,0,0,0,0,0,0.0,0.0
1006,2827,27-09-2019 09:52:00,1,3394.0,3237.0,0.9545,16.956,38,30,19,11,8,2,6,0,0.0,0.0
1006,2828,27-09-2019 09:54:00,1,3328.0,3233.0,0.972,16.69,6,6,2,4,0,0,0,0,0.0,0.0
1006,2829,27-09-2019 09:56:00,1,3360.0,3080.0,0.917,16.648,1,1,0,1,0,0,0,0,0.0,0.0
1006,2830,27-09-2019 09:58:00,1,3118.0,2987.0,0.958,15.593,0,0,0,0,0,0,0,0,0.0,0.0
1006,2831,27-09-2019 10:00:00,1,3138.0,2946.0,0.939,15.624,7,6,2,4,1,0,1,0,0.0,0.0
1006,2832,27-09-2019 10:02:00,1,3024.0,2840.0,0.939,15.059,0,0,0,0,0,0,0,0,0.0,0.0
1006,2833,27-09-2019 10:04:00,1,2784.0,2725.0,0.979,13.985,25,17,11,6,8,0,8,0,0.0,0.0
1006,2834,27-09-2019 10:06:00,1,3014.0,2849.0,0.945,15.03,114,89,54,35,25,6,19,2,0.0,0.0
1006,2835,27-09-2019 10:08:00,1,2994.0,2955.0,0.987,15.068,109,76,50,26,33,13,20,14,0.0,0.0
1006,2836,27-09-2019 10:10:00,1,3330.0,3224.0,0.968,16.688,103,63,23,40,40,10,30,56,0.0,0.0
1006,2837,27-09-2019 10:12:00,1,3655.0,3465.0,0.948,18.235,143,91,51,40,52,2,50,73,0.0,0.0
1006,2838,27-09-2019 10:14:00,1,3869.0,3733.0,0.965,19.375,124,76,45,31,48,12,36,68,0.0,0.03
1006,2839,27-09-2019 10:16:00,1,4102.0,3867.0,0.943,20.443,167,105,76,29,62,19,43,74,0.0,0.1
1006,2840,27-09-2019 10:18:00,1,4053.0,3970.0,0.98,20.365,170,97,56,41,73,32,41,78,0.09,0.01
1006,2841,27-09-2019 10:20:00,1,3851.0,3748.0,0.973,19.322,519,295,236,59,224,169,55,53,0.01,0.04
1006,2842,27-09-2019 10:22:00,1,3904.0,3563.0,0.913,19.325,159,109,75,34,50,17,33,69,0.01,0.0
1006,2843,27-09-2019 10:24:00,1,4308.0,4064.0,0.943,21.475,169,101,66,35,68,23,45,79,0.0,0.01
1006,2844,27-09-2019 10:26:00,1,4106.5,3816.5,0.9285,20.4055,159,102,68,34,57,20,37,69,0.0,0.07
1006,2845,27-09-2019 10:28:00,1,3905.0,3569.0,0.914,19.336,66,49,30,19,17,10,7,8,0.1,0.01
1006,2846,27-09-2019 10:30:00,1,3043.0,2771.0,0.911,15.057,0,0,0,0,0,0,0,0,0.01,0.01
1006,2847,27-09-2019 10:32:00,1,2923.0,2665.0,0.912,14.466,2,2,0,2,0,0,0,0,0.01,0.0
1006,2848,27-09-2019 10:34:00,1,2823.0,2584.0,0.915,13.984,0,0,0,0,0,0,0,0,0.0,0.0
1006,2849,27-09-2019 10:36:00,1,2824.0,2562.0,0.907,13.962,19,18,12,6,1,1,0,0,0.0,0.0
1006,2850,27-09-2019 10:38:00,1,2822.0,2554.0,0.905,13.944,0,0,0,0,0,0,0,0,0.0,0.0
1006,2851,27-09-2019 10:40:00,1,2942.0,2667.0,0.907,14.544,0,0,0,0,0,0,0,0,0.0,0.0
1006,2852,27-09-2019 10:42:00,1,2935.0,2670.0,0.91,14.519,11,11,5,6,0,0,0,0,0.0,0.0
1006,2853,27-09-2019 10:44:00,1,2818.0,2584.0,0.917,13.962,3,3,2,1,0,0,0,0,0.0,0.0
1006,2854,27-09-2019 10:46:00,1,2924.0,2647.0,0.905,14.45,8,6,5,1,2,1,1,0,0.0,0.0
1006,2855,27-09-2019 10:48:00,1,3018.0,2878.0,0.954,15.078,2,0,0,0,2,0,2,0,0.0,0.0
1006,2856,27-09-2019 10:50:00,1,3233.0,3003.0,0.929,16.064,4,3,0,3,1,1,0,0,0.0,0.0
1006,2857,27-09-2019 10:52:00,1,3365.0,3126.0,0.929,16.718,29,26,15,11,3,1,2,0,0.0,0.0
1006,2858,27-09-2019 10:54:00,1,3329.0,3189.0,0.958,16.645,12,11,3,8,1,0,1,0,0.0,0.0
1006,2859,27-09-2019 10:56:00,1,3309.0,3235.0,0.978,16.618,17,12,6,6,5,0,5,0,0.01,0.0
1006,2860,27-09-2019 10:58:00,1,3323.0,3232.0,0.973,16.672,9,4,1,3,5,0,5,0,0.0,0.0
1006,2861,27-09-2019 11:00:00,1,3314.0,3266.5,0.986,16.6745,28,19,16,3,9,4,5,0,0.0,0.0
1006,2862,27-09-2019 11:02:00,1,3305.0,3301.0,0.999,16.677,1,1,1,0,0,0,0,0,0.0,0.0
1006,2863,27-09-2019 11:04:00,1,3314.0,3284.0,0.991,16.693,3,3,0,3,0,0,0,0,0.0,0.0
1006,2864,27-09-2019 11:06:00,1,3338.0,3207.0,0.961,16.702,2,2,0,2,0,0,0,0,0.0,0.0
1006,2865,27-09-2019 11:08:00,1,3084.0,3122.0,1.012,15.608,54,32,17,15,22,14,8,0,0.0,0.0
1006,2866,27-09-2019 11:10:00,1,3091.0,3079.0,0.996,15.585,1,1,0,1,0,0,0,0,0.0,0.0
1006,2867,27-09-2019 11:12:00,1,3088.0,3082.0,0.998,15.577,7,3,1,2,4,0,4,0,0.0,0.0
1006,2868,27-09-2019 11:14:00,1,3123.0,2991.0,0.958,15.616,0,0,0,0,0,0,0,0,0.0,0.01
1006,2869,27-09-2019 11:16:00,1,3003.0,2912.0,0.97,15.054,2,1,0,1,1,0,1,0,0.0,0.0
1006,2870,27-09-2019 11:18:00,1,3031.0,2827.0,0.933,15.072,20,10,4,6,10,0,10,0,0.0,0.0
1006,2871,27-09-2019 11:20:00,1,2991.0,2978.0,0.996,15.08,20,1,1,0,19,0,19,0,0.0,0.0
1006,2872,27-09-2019 11:22:00,1,3008.0,2876.0,0.956,15.037,1,0,0,0,1,0,1,0,0.0,0.0
1006,2873,27-09-2019 11:24:00,1,3017.0,2868.0,0.951,15.062,0,0,0,0,0,0,0,0,0.0,0.0
1006,2874,27-09-2019 11:26:00,1,2761.0,2833.0,1.026,14.015,0,0,0,0,0,0,0,0,0.0,0.0
1006,2875,27-09-2019 11:28:00,1,2776.0,2690.0,0.969,13.917,155,108,89,19,47,33,14,6,0.0,0.0
1006,2876,27-09-2019 11:30:00,1,2888.0,2874.0,0.995,14.56,161,52,36,16,109,69,40,35,0.0,0.0
1006,2877,27-09-2019 11:32:00,1,3343.0,3126.0,0.935,16.634,84,62,31,31,22,5,17,8,0.0,0.0
1006,2878,27-09-2019 11:34:00,1,3544.5,3413.0,0.9615,17.7445,258,162,121,41,96,51,45,81,0.0,0.0
1006,2879,27-09-2019 11:36:00,1,3746.0,3700.0,0.988,18.855,154,94,57,37,60,28,32,64,0.0,0.0
1006,2880,27-09-2019 11:38:00,1,3943.0,3884.0,0.985,19.835,199,129,89,40,70,40,30,44,0.08,0.08
1006,2881,27-09-2019 11:40:00,1,3736.0,3670.0,0.982,18.784,94,52,31,21,42,21,21,0,0.01,0.0
1006,2882,27-09-2019 11:42:00,1,2992.0,2955.0,0.988,15.059,538,306,235,71,232,170,62,28,0.0,0.0
1006,2883,27-09-2019 11:44:00,1,3935.0,3967.0,1.008,19.895,143,87,57,30,56,12,44,53,0.01,0.04
1006,2884,27-09-2019 11:46:00,1,4148.0,4206.0,1.014,20.998,116,74,43,31,42,9,33,39,0.0,0.06
1006,2885,27-09-2019 11:48:00,1,4118.0,4273.0,1.038,20.954,228,133,97,36,95,58,37,24,0.08,0.06
1006,2886,27-09-2019 11:50:00,1,3430.0,3303.0,0.963,17.171,605,345,274,71,260,192,68,17,0.02,0.0
1006,2887,27-09-2019 11:52:00,1,3121.0,3005.0,0.963,15.625,286,219,165,54,67,48,19,15,0.0,0.0
1006,2888,27-09-2019 11:54:00,1,3739.0,3636.0,0.973,18.756,1493,1045,881,164,448,360,88,43,0.0,0.0
1006,2889,27-09-2019 11:56:00,1,4044.0,4107.0,1.016,20.479,1398,1089,927,162,309,229,80,28,0.0,0.0
1006,2890,27-09-2019 11:58:00,1,4033.0,4126.0,1.023,20.457,272,218,154,64,54,41,13,36,0.0,0.01
1006,2891,27-09-2019 12:00:00,1,3419.0,3313.0,0.969,17.14,198,104,62,42,94,46,48,0,0.0,0.0
1006,2892,27-09-2019 12:02:00,1,3412.0,3420.0,1.002,17.23,248,160,112,48,88,47,41,24,0.0,0.0
1006,2893,27-09-2019 12:04:00,1,4464.0,4476.0,1.003,22.544,136,83,56,27,53,16,37,35,0.0,0.07
1006,2894,27-09-2019 12:06:00,1,4690.0,4669.0,0.996,23.648,109,72,44,28,37,19,18,9,0.11,0.04
1006,2895,27-09-2019 12:08:00,1,4228.0,4085.0,0.963,21.1805,29,17,2,15,12,0,12,0,0.01,0.01
1006,2896,27-09-2019 12:10:00,1,3766.0,3501.0,0.93,18.713,42,23,4,19,19,0,19,0,0.01,0.0
1006,2897,27-09-2019 12:12:00,1,3867.0,3703.0,0.958,19.338,7,3,0,3,4,0,4,0,0.0,0.0
1006,2898,27-09-2019 12:14:00,1,3577.0,3295.0,0.921,17.739,0,0,0,0,0,0,0,0,0.0,0.0
1006,2899,27-09-2019 12:16:00,1,3604.0,3240.0,0.899,17.788,0,0,0,0,0,0,0,0,0.0,0.0
1006,2900,27-09-2019 12:18:00,1,3580.0,3281.0,0.917,17.736,10,10,1,9,0,0,0,0,0.0,0.0
1006,2901,27-09-2019 12:20:00,1,3548.0,3367.0,0.949,17.708,6,5,0,5,1,0,1,0,0.0,0.0
1006,2902,27-09-2019 12:22:00,1,3662.0,3501.0,0.956,18.303,4,0,0,0,4,0,4,0,0.0,0.0
1006,2903,27-09-2019 12:24:00,1,3547.0,3441.0,0.97,17.787,2,0,0,0,2,0,2,0,0.0,0.0
1006,2904,27-09-2019 12:26:00,1,3515.0,3490.0,0.993,17.714,1,1,1,0,0,0,0,0,0.0,0.01
1006,2905,27-09-2019 12:28:00,1,3535.0,3426.0,0.969,17.722,0,0,0,0,0,0,0,0,0.01,0.0
1006,2906,27-09-2019 12:30:00,1,3309.0,3284.0,0.992,16.673,139,105,60,45,34,6,28,12,0.0,0.0
1006,2907,27-09-2019 12:32:00,1,3531.0,3470.0,0.983,17.751,149,130,87,43,19,10,9,9,0.0,0.0
1006,2908,27-09-2019 12:34:00,1,3534.0,3463.0,0.98,17.756,79,55,20,35,24,4,20,3,0.0,0.0
1006,2909,27-09-2019 12:36:00,1,3519.0,3515.0,0.999,17.754,72,56,17,39,16,0,16,1,0.0,0.0
1006,2910,27-09-2019 12:38:00,1,3523.0,3550.0,1.008,17.81,90,89,37,52,1,0,1,0,0.0,0.0
1006,2911,27-09-2019 12:40:00,1,3512.0,3480.0,0.991,17.69,7,7,2,5,0,0,0,0,0.0,0.0
1006,2912,27-09-2019 12:42:00,1,3413.0,3373.0,0.9885,17.1815,0,0,0,0,0,0,0,0,0.0,0.0
1006,2913,27-09-2019 12:44:00,1,3314.0,3266.0,0.986,16.673,12,7,5,2,5,0,5,0,0.0,0.0
1006,2914,27-09-2019 12:46:00,1,3327.0,3205.0,0.963,16.657,3,0,0,0,3,0,3,0,0.0,0.0
1006,2915,27-09-2019 12:48:00,1,3355.0,3126.0,0.932,16.681,11,0,0,0,11,0,11,0,0.0,0.0
1006,2916,27-09-2019 12:50:00,1,3100.0,3042.0,0.981,15.584,8,3,1,2,5,0,5,0,0.0,0.0
1007,1,23-09-2019 11:40:00,1,4200.0,3165.0,0.754,20.053,87,53,30,23,34,4,30,4,0.02,0.04
1007,2,23-09-2019 11:42:00,1,3984.0,3003.0,0.754,19.023,16,0,0,0,16,0,16,0,0.0,0.0
1007,3,23-09-2019 11:44:00,1,4022.0,2837.0,0.705,18.99,6,2,0,2,4,0,4,0,0.0,0.0
1007,4,23-09-2019 11:46:00,1,3692.0,2660.0,0.72,17.491,4,0,0,0,4,0,4,0,0.0,0.0
1007,5,23-09-2019 11:48:00,1,3482.0,2527.0,0.726,16.519,7,5,0,5,2,0,2,0,0.0,0.0
1007,6,23-09-2019 11:50:00,1,3524.5,2599.0,0.7375,16.765,110,60,32,28,50,11,39,10,0.0,0.0
1007,7,23-09-2019 11:52:00,1,3567.0,2671.0,0.749,17.011,309,138,90,48,171,95,76,31,0.02,0.0
1007,8,23-09-2019 11:54:00,1,3672.0,2773.0,0.755,17.538,335,162,116,46,173,103,70,21,0.0,0.0
1007,9,23-09-2019 11:56:00,1,3689.0,2750.0,0.745,17.581,151,74,45,29,77,40,37,16,0.0,0.0
1007,10,23-09-2019 11:58:00,1,3671.0,2739.0,0.746,17.497,209,99,62,37,110,71,39,43,0.0,0.0
1007,11,23-09-2019 12:00:00,1,3446.0,2671.0,0.775,16.535,351,204,168,36,147,112,35,116,0.0,0.0
1007,12,23-09-2019 12:02:00,1,3656.0,2843.0,0.778,17.554,331,209,159,50,122,77,45,90,0.0,0.0
1007,13,23-09-2019 12:04:00,1,4007.0,2932.0,0.732,19.033,286,107,75,32,179,131,48,92,0.0,0.0
1007,14,23-09-2019 12:06:00,1,3982.0,2982.0,0.749,18.991,297,133,95,38,164,119,45,45,0.0,0.0
1007,15,23-09-2019 12:08:00,1,3654.0,2797.0,0.765,17.492,121,24,8,16,97,51,46,0,0.0,0.0
1007,16,23-09-2019 12:10:00,1,3773.0,2855.0,0.757,18.027,123,57,31,26,66,28,38,3,0.0,0.0
1007,17,23-09-2019 12:12:00,1,3652.0,2863.0,0.784,17.558,181,74,37,37,107,46,61,4,0.0,0.0
1007,18,23-09-2019 12:14:00,1,3450.0,2662.0,0.772,16.541,223,82,42,40,141,79,62,13,0.0,0.0
1007,19,23-09-2019 12:16:00,1,3668.0,2789.0,0.76,17.539,165,67,36,31,98,37,61,12,0.0,0.0
1007,20,23-09-2019 12:18:00,1,3460.0,2642.0,0.764,16.558,213,70,41,29,143,94,49,7,0.0,0.0
1007,21,23-09-2019 12:20:00,1,3437.0,2703.0,0.787,16.535,244,80,56,24,164,114,50,7,0.0,0.0
1007,22,23-09-2019 12:22:00,1,3338.0,2579.0,0.773,16.008,191,74,31,43,117,57,60,7,0.0,0.0
1007,23,23-09-2019 12:24:00,1,3186.0,2457.5,0.7715,15.2745,159,54,30,24,105,55,50,4,0.0,0.0
1007,24,23-09-2019 12:26:00,1,3034.0,2336.0,0.77,14.541,59,5,0,5,54,12,42,0,0.0,0.0
1007,25,23-09-2019 12:28:00,1,2969.0,2125.0,0.716,14.05,43,0,0,0,43,0,43,0,0.0,0.0
1007,26,23-09-2019 12:30:00,1,2955.0,2128.0,0.72,13.999,68,14,6,8,54,10,44,0,0.0,0.0
1007,27,23-09-2019 12:32:00,1,2968.0,2116.0,0.713,14.036,35,2,1,1,33,0,33,0,0.0,0.0
1007,28,23-09-2019 12:34:00,1,2849.0,2096.0,0.736,13.545,38,1,0,1,37,0,37,0,0.0,0.0
1007,29,23-09-2019 12:36:00,1,2723.0,2065.0,0.758,13.016,40,2,0,2,38,0,38,0,0.0,0.0
1007,30,23-09-2019 12:38:00,1,2639.0,1943.0,0.736,12.548,36,2,0,2,34,0,34,0,0.0,0.0
1007,31,23-09-2019 12:40:00,1,2633.0,1919.0,0.729,12.501,36,3,0,3,33,0,33,0,0.0,0.0
1007,32,23-09-2019 12:42:00,1,2662.0,1838.0,0.69,12.526,134,4,2,2,130,88,42,0,0.0,0.0
1007,33,23-09-2019 12:44:00,1,2732.0,2023.0,0.74,13.005,44,5,0,5,39,0,39,0,0.0,0.0
1007,34,23-09-2019 12:46:00,1,2949.0,2151.0,0.729,13.999,70,13,3,10,57,13,44,0,0.0,0.0
1007,35,23-09-2019 12:48:00,1,2948.0,2163.0,0.734,14.008,240,68,37,31,172,104,68,26,0.0,0.73
1007,36,23-09-2019 12:50:00,1,3116.0,2449.0,0.786,14.991,176,64,38,26,112,62,50,19,0.0,0.0
1007,37,23-09-2019 12:52:00,1,3229.0,2546.0,0.789,15.542,171,87,51,36,84,42,42,26,0.0,0.0
1007,38,23-09-2019 12:54:00,1,3461.0,2618.0,0.756,16.534,426,172,127,45,254,196,58,51,0.0,0.0
1007,39,23-09-2019 12:56:00,1,3134.0,2409.0,0.768,15.016,130,33,18,15,97,48,49,3,0.01,0.0
1007,40,23-09-2019 12:58:00,1,2880.5,2188.5,0.7585,13.772,34,0,0,0,34,0,34,0,0.0,0.0
1007,41,23-09-2019 13:00:00,1,2627.0,1968.0,0.749,12.528,44,0,0,0,44,0,44,0,0.0,0.0
1007,42,23-09-2019 13:02:00,1,2638.0,1914.0,0.725,12.514,50,1,1,0,49,2,47,0,0.0,0.0
1007,43,23-09-2019 13:04:00,1,2412.0,1805.0,0.748,11.503,52,9,4,5,43,2,41,0,0.0,0.0
1007,44,23-09-2019 13:06:00,1,2085.0,1635.0,0.784,10.025,56,4,1,3,52,0,52,0,0.0,0.0
1007,45,23-09-2019 13:08:00,1,2105.0,1567.0,0.744,10.027,84,22,10,12,62,18,44,1,0.0,0.0
1007,46,23-09-2019 13:10:00,1,2613.0,2035.0,0.779,12.547,272,55,24,31,217,145,72,10,0.0,0.0
1007,47,23-09-2019 13:12:00,1,2901.0,2343.0,0.808,14.024,230,38,17,21,192,126,66,28,0.0,0.0
1007,48,23-09-2019 13:14:00,1,3017.0,2368.0,0.785,14.509,239,45,17,28,194,133,61,49,0.0,0.0
1007,49,23-09-2019 13:16:00,1,3349.0,2553.0,0.762,16.021,279,71,34,37,208,139,69,40,0.0,0.0
1007,50,23-09-2019 13:18:00,1,3138.0,2402.0,0.765,15.024,264,107,78,29,157,106,51,45,0.0,0.0
1007,51,23-09-2019 13:20:00,1,2934.0,2205.0,0.751,14.003,119,40,18,22,79,24,55,6,0.0,0.0
1007,52,23-09-2019 13:22:00,1,3137.0,2444.0,0.779,15.067,117,26,16,10,91,48,43,6,0.0,0.0
1007,53,23-09-2019 13:24:00,1,2843.0,2124.0,0.747,13.552,42,2,2,0,40,0,40,0,0.0,0.0
1007,54,23-09-2019 13:26:00,1,2608.0,2007.0,0.77,12.497,42,0,0,0,42,0,42,0,0.0,0.0
1007,55,23-09-2019 13:28:00,1,2624.0,1952.0,0.744,12.498,36,0,0,0,36,0,36,0,0.0,0.0
1007,56,23-09-2019 13:30:00,1,2403.0,1896.0,0.789,11.567,58,6,3,3,52,14,38,0,0.0,0.0
1007,57,23-09-2019 13:32:00,1,2291.0,1816.5,0.793,11.037,49,2,1,1,47,4,43,0,0.0,0.0
1007,58,23-09-2019 13:34:00,1,2179.0,1737.0,0.797,10.507,56,7,4,3,49,9,40,0,0.0,0.0
1007,59,23-09-2019 13:36:00,1,2062.0,1725.0,0.837,10.033,82,0,0,0,82,37,45,0,0.0,0.0
1007,60,23-09-2019 13:38:00,1,2074.0,1678.0,0.809,10.029,116,11,4,7,105,51,54,0,0.0,0.0
1007,61,23-09-2019 13:40:00,1,2181.0,1728.0,0.792,10.505,120,2,0,2,118,63,55,0,0.0,0.0
1007,62,23-09-2019 13:42:00,1,2304.0,1747.0,0.759,11.011,149,0,0,0,149,88,61,0,0.0,0.0
1007,63,23-09-2019 13:44:00,1,2297.0,1769.0,0.77,11.01,61,0,0,0,61,23,38,0,0.0,0.0
1007,64,23-09-2019 13:46:00,1,2417.0,1792.0,0.741,11.51,78,13,1,12,65,24,41,0,0.0,0.0
1007,65,23-09-2019 13:48:00,1,2420.0,1796.0,0.742,11.522,86,6,0,6,80,38,42,0,0.0,0.0
1007,66,23-09-2019 13:50:00,1,2403.0,1828.0,0.761,11.494,48,0,0,0,48,8,40,0,0.0,0.0
1007,67,23-09-2019 13:52:00,1,2578.0,2159.0,0.837,12.548,234,55,29,26,179,106,73,4,0.0,0.0
1007,68,23-09-2019 13:54:00,1,2576.0,2136.0,0.829,12.516,175,0,0,0,175,123,52,0,0.0,0.0
1007,69,23-09-2019 13:56:00,1,2594.0,2056.0,0.793,12.499,56,1,0,1,55,14,41,0,0.0,0.0
1007,70,23-09-2019 13:58:00,1,2589.0,2106.0,0.813,12.534,41,0,0,0,41,2,39,0,0.0,0.0
1007,71,23-09-2019 14:00:00,1,2579.0,2100.0,0.814,12.488,56,3,0,3,53,14,39,0,0.0,0.0
1007,72,23-09-2019 14:02:00,1,2592.0,2076.0,0.801,12.511,40,4,2,2,36,0,36,0,0.0,0.0
1007,73,23-09-2019 14:04:00,1,2604.0,2039.0,0.783,12.519,39,4,1,3,35,0,35,0,0.0,0.0
1007,74,23-09-2019 14:06:00,1,2597.5,2072.5,0.798,12.529,55,7,1,6,48,2,46,0,0.0,0.0
1007,75,23-09-2019 14:08:00,1,2591.0,2106.0,0.813,12.539,42,0,0,0,42,0,42,0,0.0,0.0
1007,76,23-09-2019 14:10:00,1,2586.0,2119.0,0.819,12.536,37,2,1,1,35,0,35,0,0.0,0.0
1007,77,23-09-2019 14:12:00,1,2581.0,2122.0,0.822,12.519,71,24,15,9,47,4,43,0,0.0,0.0
1007,78,23-09-2019 14:14:00,1,2933.0,2220.0,0.757,14.015,43,6,2,4,37,0,37,0,0.0,0.0
1007,79,23-09-2019 14:16:00,1,2816.0,2195.0,0.779,13.524,46,0,0,0,46,0,46,0,0.0,0.0
1007,80,23-09-2019 14:18:00,1,2934.0,2204.0,0.751,13.999,45,8,4,4,37,0,37,0,0.0,0.0
1007,81,23-09-2019 14:20:00,1,2702.0,2151.0,0.796,13.025,78,0,0,0,78,31,47,0,0.0,0.0
1007,82,23-09-2019 14:22:00,1,2591.0,2104.0,0.812,12.536,56,0,0,0,56,11,45,0,0.0,0.0
1007,83,23-09-2019 14:24:00,1,2605.0,2025.0,0.777,12.507,65,10,2,8,55,17,38,0,0.0,0.0
1007,84,23-09-2019 14:26:00,1,2590.0,2063.0,0.796,12.489,55,12,5,7,43,0,43,0,0.0,0.0
1007,85,23-09-2019 14:28:00,1,2611.0,2016.0,0.772,12.518,49,6,2,4,43,0,43,0,0.0,0.0
1007,86,23-09-2019 14:30:00,1,2623.0,1971.0,0.752,12.518,61,10,2,8,51,0,51,0,0.0,0.0
1007,87,23-09-2019 14:32:00,1,2603.0,2051.0,0.788,12.528,48,2,0,2,46,0,46,0,0.0,0.0
1007,88,23-09-2019 14:34:00,1,2615.0,1996.0,0.763,12.514,91,28,14,14,63,13,50,0,0.0,0.0
1007,89,23-09-2019 14:36:00,1,2595.0,2095.0,0.807,12.546,97,1,0,1,96,28,68,0,0.0,0.0
1007,90,23-09-2019 14:38:00,1,2615.0,2018.0,0.772,12.536,44,0,0,0,44,0,44,0,0.0,0.0
1007,91,23-09-2019 14:40:00,1,2654.0,2100.5,0.7915,12.7825,51,0,0,0,51,7,44,0,0.0,0.0
1007,92,23-09-2019 14:42:00,1,2693.0,2183.0,0.811,13.029,157,11,7,4,146,97,49,0,0.0,0.0
1007,93,23-09-2019 14:44:00,1,2594.0,2076.0,0.8,12.519,69,3,1,2,66,16,50,0,0.0,0.0
1007,94,23-09-2019 14:46:00,1,2927.0,2269.0,0.775,14.045,91,16,9,7,75,26,49,0,0.0,0.0
1007,95,23-09-2019 14:48:00,1,2927.0,2240.0,0.765,14.012,57,13,3,10,44,4,40,0,0.0,0.0
1007,96,23-09-2019 14:50:00,1,2574.0,2147.0,0.834,12.521,43,0,0,0,43,0,43,0,0.0,0.0
1007,97,23-09-2019 14:52:00,1,2579.0,2142.0,0.831,12.531,45,2,1,1,43,0,43,0,0.0,0.0
1007,98,23-09-2019 14:54:00,1,2580.0,2125.0,0.823,12.52,45,0,0,0,45,0,45,0,0.0,0.0
1007,99,23-09-2019 14:56:00,1,2576.0,2120.0,0.823,12.498,49,3,1,2,46,0,46,0,0.0,0.0
1007,100,23-09-2019 14:58:00,1,2575.0,2149.0,0.835,12.523,42,3,0,3,39,0,39,0,0.0,0.0
1007,101,23-09-2019 15:00:00,1,2579.0,2162.0,0.838,12.557,93,35,23,12,58,12,46,6,0.0,0.0
1007,102,23-09-2019 15:02:00,1,2877.0,2429.0,0.844,14.024,168,69,42,27,99,53,46,27,0.0,0.37
1007,103,23-09-2019 15:04:00,1,3422.0,2762.0,0.807,16.542,222,97,70,27,125,86,39,78,0.0,0.0
1007,104,23-09-2019 15:06:00,1,2684.0,2212.0,0.824,13.022,281,100,64,36,181,124,57,49,0.0,0.0
1007,105,23-09-2019 15:08:00,1,3615.0,2991.0,0.827,17.554,363,125,87,38,238,181,57,71,0.0,0.0
1007,106,23-09-2019 15:10:00,1,3730.0,3020.0,0.81,18.039,317,92,58,34,225,152,73,45,0.0,0.0
1007,107,23-09-2019 15:12:00,1,3626.0,2928.0,0.808,17.531,258,75,40,35,183,112,71,63,0.0,0.0
1007,108,23-09-2019 15:14:00,1,3622.0,2916.0,0.8055,17.5005,334,81,40,41,253,185,68,57,0.0,0.0
1007,109,23-09-2019 15:16:00,1,3618.0,2904.0,0.803,17.47,189,61,34,27,128,77,51,12,0.0,0.0
1007,110,23-09-2019 15:18:00,1,3005.0,2429.0,0.809,14.528,188,45,22,23,143,78,65,0,0.0,0.0
1007,111,23-09-2019 15:20:00,1,3314.0,2706.0,0.817,16.053,167,79,48,31,88,55,33,60,0.0,0.0
1007,112,23-09-2019 15:22:00,1,3189.0,2688.0,0.843,15.542,163,47,27,20,116,61,55,8,0.0,0.0
1007,113,23-09-2019 15:24:00,1,3402.0,2822.0,0.83,16.529,163,32,15,17,131,73,58,0,0.0,0.0
1007,114,23-09-2019 15:26:00,1,3089.0,2591.0,0.839,15.04,135,45,11,34,90,47,43,0,0.0,0.0
1007,115,23-09-2019 15:28:00,1,3069.0,2652.0,0.864,15.029,80,31,0,31,49,2,47,0,0.0,0.0
1007,116,23-09-2019 15:30:00,1,3387.0,2868.0,0.847,16.521,140,69,29,40,71,20,51,8,0.0,0.0
1007,117,23-09-2019 15:32:00,1,3183.0,2721.0,0.855,15.554,42,1,0,1,41,0,41,0,0.0,0.0
1007,118,23-09-2019 15:34:00,1,2890.0,2364.0,0.818,14.002,38,0,0,0,38,0,38,0,0.0,0.0
1007,119,23-09-2019 15:36:00,1,2926.0,2262.0,0.773,14.035,46,0,0,0,46,0,46,0,0.0,0.0
1007,120,23-09-2019 15:38:00,1,2557.0,2190.0,0.857,12.498,44,0,0,0,44,0,44,0,0.0,0.0
1007,121,23-09-2019 15:40:00,1,2576.0,2135.0,0.829,12.513,53,2,2,0,51,5,46,0,0.0,0.0
1007,122,23-09-2019 15:42:00,1,2582.0,2111.0,0.818,12.511,43,0,0,0,43,0,43,0,0.0,0.0
1007,123,23-09-2019 15:44:00,1,2595.0,2054.0,0.791,12.499,53,5,2,3,48,0,48,0,0.0,0.0
1007,124,23-09-2019 15:46:00,1,2601.0,2060.0,0.792,12.527,53,5,1,4,48,0,48,0,0.0,0.0
1007,125,23-09-2019 15:48:00,1,2604.0,2038.5,0.783,12.516,40,0,0,0,40,0,40,0,0.0,0.0
1007,126,23-09-2019 15:50:00,1,2607.0,2017.0,0.774,12.505,54,7,0,7,47,6,41,0,0.0,0.0
1007,127,23-09-2019 15:52:00,1,2605.0,2011.0,0.772,12.492,43,1,0,1,42,0,42,0,0.0,0.0
1007,128,23-09-2019 15:54:00,1,2490.0,1987.0,0.798,12.012,51,0,0,0,51,0,51,0,0.0,0.0
1007,129,23-09-2019 15:56:00,1,2619.0,2015.0,0.769,12.552,43,6,0,6,37,0,37,0,0.0,0.0
1007,130,23-09-2019 15:58:00,1,2600.0,2051.0,0.789,12.515,38,1,0,1,37,0,37,0,0.0,0.0
1007,131,23-09-2019 16:00:00,1,2599.0,2073.0,0.798,12.534,53,0,0,0,53,4,49,0,0.0,0.0
1007,132,23-09-2019 16:02:00,1,2594.0,2084.0,0.804,12.527,52,0,0,0,52,12,40,0,0.0,0.0
1007,133,23-09-2019 16:04:00,1,2615.0,2011.0,0.769,12.53,44,2,1,1,42,0,42,0,0.0,0.0
1007,134,23-09-2019 16:06:00,1,2491.0,1962.0,0.788,11.989,241,3,1,2,238,181,57,0,0.0,0.0
1007,135,23-09-2019 16:08:00,1,2378.0,1955.0,0.822,11.535,230,14,9,5,216,180,36,0,0.0,0.0
1007,136,23-09-2019 16:10:00,1,2604.0,2054.0,0.789,12.533,79,25,2,23,54,7,47,0,0.0,0.0
1007,137,23-09-2019 16:12:00,1,2684.0,2207.0,0.822,13.019,101,48,26,22,53,11,42,1,0.0,0.0
1007,138,23-09-2019 16:14:00,1,3095.0,2529.0,0.817,14.994,213,68,43,25,145,80,65,32,0.0,0.0
1007,139,23-09-2019 16:16:00,1,3174.0,2715.0,0.856,15.511,331,97,70,27,234,166,68,70,0.0,0.0
1007,140,23-09-2019 16:18:00,1,3101.0,2535.0,0.817,15.026,269,87,55,32,182,129,53,12,0.0,0.0
1007,141,23-09-2019 16:20:00,1,3421.0,2739.0,0.8,16.513,119,46,25,21,73,26,47,0,0.0,0.0
1007,142,23-09-2019 16:22:00,1,3300.5,2725.5,0.8265,16.022,82,14,6,8,68,17,51,0,0.0,0.0
1007,143,23-09-2019 16:24:00,1,3180.0,2712.0,0.853,15.531,111,52,24,28,59,12,47,1,0.0,0.0
1007,144,23-09-2019 16:26:00,1,3421.0,2771.0,0.81,16.547,282,103,58,45,179,108,71,20,0.0,0.0
1007,145,23-09-2019 16:28:00,1,3309.0,2738.0,0.828,16.069,311,60,37,23,251,186,65,8,0.0,0.0
1007,146,23-09-2019 16:30:00,1,2919.0,2237.0,0.766,13.976,299,5,2,3,294,256,38,0,0.0,0.0
1007,147,23-09-2019 16:32:00,1,2595.0,2056.0,0.792,12.5,317,39,26,13,278,237,41,0,0.0,0.0
1007,148,23-09-2019 16:34:00,1,2495.0,1975.0,0.792,12.015,37,0,0,0,37,0,37,0,0.0,0.0
1007,149,23-09-2019 16:36:00,1,2376.0,1949.0,0.82,11.519,41,0,0,0,41,0,41,0,0.0,0.0
1007,150,23-09-2019 16:38:00,1,2391.0,1919.0,0.803,11.546,45,2,0,2,43,0,43,0,0.0,0.0
1007,151,23-09-2019 16:40:00,1,2615.0,1994.0,0.763,12.51,54,7,3,4,47,2,45,0,0.0,0.0
1007,152,23-09-2019 16:42:00,1,2494.0,1962.0,0.786,12.0,48,8,4,4,40,0,40,0,0.0,0.0
1007,153,23-09-2019 16:44:00,1,2380.0,1919.0,0.806,11.503,43,0,0,0,43,0,43,0,0.0,0.0
1007,154,23-09-2019 16:46:00,1,2389.0,1906.0,0.798,11.522,48,0,0,0,48,0,48,0,0.0,0.0
1007,155,23-09-2019 16:48:00,1,2403.0,1852.0,0.771,11.518,52,9,3,6,43,2,41,0,0.0,0.0
1007,156,23-09-2019 16:50:00,1,2295.0,1791.0,0.78,11.027,41,3,0,3,38,0,38,0,0.0,0.0
1007,157,23-09-2019 16:52:00,1,2402.0,1854.0,0.772,11.518,59,19,6,13,40,0,40,0,0.0,0.0
1007,158,23-09-2019 16:54:00,1,2390.0,1923.0,0.805,11.546,46,11,4,7,35,0,35,0,0.0,0.0
1007,159,23-09-2019 16:56:00,1,2385.0,1921.0,0.8055,11.5245,55,13,4,9,42,0,42,0,0.0,0.0
1007,160,23-09-2019 16:58:00,1,2380.0,1919.0,0.806,11.503,53,6,3,3,47,0,47,0,0.0,0.0
1007,161,23-09-2019 17:00:00,1,2393.0,1899.0,0.794,11.53,45,1,1,0,44,0,44,0,0.0,0.0
1007,162,23-09-2019 17:02:00,1,2406.0,1851.0,0.769,11.53,46,4,1,3,42,0,42,0,0.0,0.0
1007,163,23-09-2019 17:04:00,1,2399.0,1871.0,0.78,11.524,42,0,0,0,42,0,42,0,0.0,0.0
1007,164,23-09-2019 17:06:00,1,2398.0,1858.0,0.775,11.505,46,0,0,0,46,0,46,0,0.0,0.0
1007,165,23-09-2019 17:08:00,1,2414.0,1833.0,0.759,11.54,118,0,0,0,118,73,45,0,0.0,0.0
1007,166,23-09-2019 17:10:00,1,2407.0,1852.0,0.769,11.535,42,0,0,0,42,2,40,0,0.0,0.0
1007,167,23-09-2019 17:12:00,1,2395.0,1841.0,0.769,11.475,41,1,0,1,40,0,40,0,0.0,0.0
1007,168,23-09-2019 17:14:00,1,2391.0,1904.0,0.796,11.529,48,5,0,5,43,4,39,0,0.0,0.0
1007,169,23-09-2019 17:16:00,1,2508.0,1924.0,0.767,12.012,57,9,4,5,48,12,36,0,0.0,0.0
1007,170,23-09-2019 17:18:00,1,2516.0,1901.0,0.755,12.019,44,2,0,2,42,2,40,0,0.0,0.0
1007,171,23-09-2019 17:20:00,1,2393.0,1903.0,0.795,11.535,41,0,0,0,41,0,41,0,0.0,0.0
1007,172,23-09-2019 17:22:00,1,2388.0,1902.0,0.796,11.514,245,15,7,8,230,147,83,0,0.0,0.0
1007,173,23-09-2019 17:24:00,1,2623.0,1978.0,0.754,12.527,257,66,22,44,191,123,68,15,0.0,0.0
1007,174,23-09-2019 17:26:00,1,3107.0,2503.0,0.806,15.011,258,78,53,25,180,119,61,41,0.0,0.0
1007,175,23-09-2019 17:28:00,1,3417.0,2734.0,0.8,16.488,289,130,88,42,159,104,55,38,0.0,0.0
1007,176,23-09-2019 17:30:00,1,3531.0,2815.5,0.7975,17.028,190,60,35,25,130,73,57,32,0.0,0.0
1007,177,23-09-2019 17:32:00,1,3645.0,2897.0,0.795,17.568,208,49,19,30,159,110,49,20,0.0,0.0
1007,178,23-09-2019 17:34:00,1,3534.0,2804.0,0.794,17.029,110,34,20,14,76,37,39,18,0.0,0.0
1007,179,23-09-2019 17:36:00,1,3085.0,2589.0,0.839,15.019,224,37,16,21,187,126,61,45,0.0,0.0
1007,180,23-09-2019 17:38:00,1,3412.0,2769.0,0.812,16.51,333,128,96,32,205,148,57,23,0.0,0.0
1007,181,23-09-2019 17:40:00,1,3313.0,2676.0,0.808,16.017,138,17,9,8,121,67,54,0,0.0,0.0
1007,182,23-09-2019 17:42:00,1,3407.0,2782.0,0.816,16.503,134,48,21,27,86,33,53,0,0.0,0.0
1007,183,23-09-2019 17:44:00,1,3405.0,2803.0,0.823,16.517,169,32,11,21,137,83,54,0,0.0,0.0
1007,184,23-09-2019 17:46:00,1,3397.0,2838.0,0.835,16.524,101,33,14,19,68,17,51,0,0.0,0.0
1007,185,23-09-2019 17:48:00,1,3423.0,2752.0,0.804,16.533,131,31,9,22,100,51,49,6,0.0,0.0
1007,186,23-09-2019 17:50:00,1,3307.0,2711.0,0.82,16.033,47,5,2,3,42,0,42,0,0.0,0.0
1007,187,23-09-2019 17:52:00,1,3095.0,2538.0,0.82,15.003,47,2,1,1,45,0,45,0,0.0,0.0
1007,188,23-09-2019 17:54:00,1,2880.0,2419.0,0.84,14.025,56,20,3,17,36,0,36,0,0.0,0.0
1007,189,23-09-2019 17:56:00,1,2574.0,2164.0,0.84,12.539,53,15,2,13,38,0,38,0,0.0,0.0
1007,190,23-09-2019 17:58:00,1,2604.0,2031.0,0.78,12.507,37,2,0,2,35,0,35,0,0.0,0.0
1007,191,23-09-2019 18:00:00,0,2624.0,2009.0,0.766,12.562,38,1,0,1,37,0,37,0,0.0,0.0
1007,192,23-09-2019 18:02:00,0,2619.0,2002.0,0.764,12.536,45,1,1,0,44,0,44,0,0.0,0.0
1007,193,23-09-2019 18:04:00,0,2770.5,2144.0,0.773,13.2905,244,70,57,13,174,121,53,7,0.0,0.0
1007,194,23-09-2019 18:06:00,0,2922.0,2286.0,0.782,14.045,411,140,96,44,271,205,66,52,0.0,0.0
1007,195,23-09-2019 18:08:00,0,3629.0,2930.0,0.807,17.543,583,250,189,61,333,265,68,65,0.0,0.0
1007,196,23-09-2019 18:10:00,0,3425.0,2740.0,0.8,16.528,327,128,101,27,199,142,57,139,0.0,0.0
1007,197,23-09-2019 18:12:00,0,3657.0,2807.0,0.768,17.517,351,107,83,24,244,180,64,54,0.0,0.0
1007,198,23-09-2019 18:14:00,0,3607.0,2988.0,0.828,17.52,300,73,41,32,227,158,69,35,0.0,0.0
1007,199,23-09-2019 18:16:00,0,3980.0,3049.0,0.766,19.056,234,50,39,11,184,111,73,54,0.0,0.0
1007,200,23-09-2019 18:18:00,0,3736.0,2988.0,0.8,18.03,297,49,30,19,248,174,74,49,0.0,0.0
1007,201,23-09-2019 18:20:00,0,3937.0,3169.0,0.805,19.02,305,67,42,25,238,152,86,65,0.0,0.0
1007,202,23-09-2019 18:22:00,0,3931.0,3184.0,0.81,19.015,499,162,125,37,337,250,87,27,0.0,0.0
1007,203,23-09-2019 18:24:00,0,3086.0,2602.0,0.843,15.038,474,209,158,51,265,210,55,64,0.0,0.0
1007,204,23-09-2019 18:26:00,0,3709.0,3078.0,0.83,18.023,494,145,112,33,349,275,74,67,0.0,0.0
1007,205,23-09-2019 18:28:00,0,3080.0,2603.0,0.845,15.017,188,90,57,33,98,55,43,7,0.0,0.0
1007,206,23-09-2019 18:30:00,0,4072.0,3608.0,0.886,20.036,153,34,5,29,119,57,62,2,0.0,0.0
1007,207,23-09-2019 18:32:00,0,4067.0,3631.0,0.893,20.045,130,43,24,19,87,38,49,3,0.0,0.0
1007,208,23-09-2019 18:34:00,0,4083.0,3562.0,0.872,20.029,168,35,11,24,133,76,57,1,0.0,0.0
1007,209,23-09-2019 18:36:00,0,4050.0,3702.0,0.914,20.055,580,177,138,39,403,329,74,63,0.0,0.0
1007,210,23-09-2019 18:38:00,0,3960.5,3574.5,0.902,19.561,403,114,85,29,289,253,36,89,0.0,0.0
1007,211,23-09-2019 18:40:00,0,3871.0,3447.0,0.89,19.067,6,0,0,0,6,2,4,2,0.0,0.0
1007,212,23-09-2019 18:42:00,0,3902.0,3307.0,0.848,19.035,11,0,0,0,11,0,11,0,0.0,0.0
1007,213,23-09-2019 18:44:00,0,3569.0,3173.0,0.889,17.577,10,3,1,2,7,0,7,0,0.0,0.0
1007,214,23-09-2019 18:46:00,0,3366.0,2942.0,0.874,16.518,96,1,0,1,95,79,16,0,0.0,0.0
1007,215,23-09-2019 18:48:00,0,3046.0,2744.0,0.901,15.039,88,2,0,2,86,69,17,0,0.0,0.0
1007,216,23-09-2019 18:50:00,0,3033.0,2781.0,0.917,15.029,9,5,0,5,4,0,4,0,0.0,0.0
1007,217,23-09-2019 18:52:00,0,3075.0,2698.0,0.877,15.104,112,8,2,6,104,82,22,8,0.0,0.0
1007,218,23-09-2019 18:54:00,0,3145.0,2860.0,0.91,15.557,404,122,78,44,282,229,53,32,0.0,0.0
1007,219,23-09-2019 18:56:00,0,3354.0,3015.0,0.899,16.552,468,192,153,39,276,233,43,80,0.0,0.0
1007,220,23-09-2019 18:58:00,0,3371.0,2971.0,0.881,16.572,353,113,79,34,240,217,23,155,0.03,0.0
1007,221,23-09-2019 19:00:00,0,3043.0,2772.0,0.911,15.059,503,169,131,38,334,291,43,66,0.0,0.0
1007,222,23-09-2019 19:02:00,0,3899.0,3294.0,0.845,19.01,510,120,88,32,390,306,84,49,0.0,0.0
1007,223,23-09-2019 19:04:00,0,3590.0,3033.0,0.845,17.501,293,73,44,29,220,154,66,81,0.0,0.0
1007,224,23-09-2019 19:06:00,0,3906.0,3277.0,0.839,19.017,387,74,41,33,313,228,85,47,0.0,0.0
1007,225,23-09-2019 19:08:00,0,3900.0,3315.0,0.85,19.034,917,96,71,25,821,744,77,76,0.0,0.0
1007,226,23-09-2019 19:10:00,0,3275.0,2837.0,0.866,16.045,305,78,44,34,227,177,50,11,0.0,0.0
1007,227,23-09-2019 19:12:00,0,3118.0,2712.5,0.87,15.289,473,121,91,30,352,295,57,105,0.0,0.0
1007,228,23-09-2019 19:14:00,0,2961.0,2588.0,0.874,14.533,475,154,121,33,321,270,51,43,0.0,0.0
1007,229,23-09-2019 19:16:00,0,3812.0,3185.0,0.835,18.547,133,48,22,26,85,49,36,13,0.0,0.0
1007,230,23-09-2019 19:18:00,0,3497.0,2974.0,0.851,17.07,350,114,88,26,236,191,45,70,0.0,0.0
1007,231,23-09-2019 19:20:00,0,3891.0,3372.0,0.867,19.064,481,139,88,51,342,267,75,58,0.0,0.0
1007,232,23-09-2019 19:22:00,0,4122.0,3413.0,0.828,20.022,347,77,54,23,270,194,76,44,0.0,0.0
1007,233,23-09-2019 19:24:00,0,3364.0,2954.0,0.878,16.525,433,86,58,28,347,266,81,36,0.0,0.0
1007,234,23-09-2019 19:26:00,0,4023.0,3389.0,0.842,19.602,336,91,50,41,245,171,74,3,0.0,0.0
1007,235,23-09-2019 19:28:00,0,2593.0,2070.0,0.798,12.509,246,75,38,37,171,116,55,15,0.0,0.0
1007,236,23-09-2019 19:30:00,0,2806.0,2266.0,0.807,13.564,322,101,79,22,221,158,63,17,0.0,0.0
1007,237,23-09-2019 19:32:00,0,2884.0,2394.0,0.83,14.015,51,8,0,8,43,6,37,0,0.0,0.0
1007,238,23-09-2019 19:34:00,0,2081.0,1682.0,0.808,10.061,53,10,4,6,43,11,32,0,0.0,0.0
1007,239,23-09-2019 19:36:00,0,2074.0,1664.0,0.802,10.015,49,6,3,3,43,7,36,0,0.0,0.0
1007,240,23-09-2019 19:38:00,0,2088.0,1617.0,0.774,10.017,107,1,0,1,106,51,55,0,0.01,0.0
1007,241,23-09-2019 19:40:00,0,2094.0,1587.0,0.758,10.009,63,0,0,0,63,17,46,0,0.0,0.0
1007,242,23-09-2019 19:42:00,0,2099.0,1594.0,0.759,10.035,51,0,0,0,51,2,49,0,0.0,0.0
1007,243,23-09-2019 19:44:00,0,1863.0,1523.0,0.817,9.027,101,27,15,12,74,25,49,0,0.0,0.0
1007,244,23-09-2019 19:46:00,0,2039.5,1575.5,0.776,9.7815,63,8,0,8,55,14,41,0,0.0,0.0
1007,245,23-09-2019 19:48:00,0,2216.0,1628.0,0.735,10.536,141,15,3,12,126,68,58,0,0.0,0.0
1007,246,23-09-2019 19:50:00,0,2218.0,1612.0,0.726,10.525,68,6,1,5,62,20,42,0,0.0,0.0
1007,247,23-09-2019 19:52:00,0,2217.0,1594.0,0.719,10.499,407,141,99,42,266,198,68,9,0.0,0.0
1007,248,23-09-2019 19:54:00,0,4272.0,3371.0,0.789,20.562,424,165,120,45,259,196,63,71,0.0,0.0
1007,249,23-09-2019 19:56:00,0,4224.0,3541.0,0.838,20.564,361,137,101,36,224,163,61,77,0.0,0.0
1007,250,23-09-2019 19:58:00,0,4253.0,3453.0,0.812,20.58,217,82,48,34,135,76,59,10,0.0,0.0
1007,251,23-09-2019 20:00:00,0,4076.0,3103.0,0.761,19.495,220,68,39,29,152,93,59,6,0.0,0.0
1007,252,23-09-2019 20:02:00,0,4260.0,3356.0,0.788,20.499,599,159,111,48,440,363,77,16,0.01,0.0
1007,253,23-09-2019 20:04:00,0,4045.0,3211.0,0.794,19.493,594,72,58,14,522,463,59,78,0.03,0.0
1007,254,23-09-2019 20:06:00,0,4266.0,3433.0,0.805,20.61,412,150,105,45,262,203,59,15,0.0,0.0
1007,255,23-09-2019 20:08:00,0,3745.0,2912.0,0.778,17.982,474,186,145,41,288,212,76,24,0.0,0.0
1007,256,23-09-2019 20:10:00,0,3738.0,2960.0,0.792,18.004,254,81,59,22,173,112,61,67,0.0,0.0
1007,257,23-09-2019 20:12:00,0,4088.0,3149.0,0.77,19.592,373,107,77,30,266,199,67,19,0.0,0.0
1007,258,23-09-2019 20:14:00,0,4283.0,3293.0,0.769,20.521,717,82,44,38,635,529,106,16,0.0,0.0
1007,259,23-09-2019 20:16:00,0,4069.0,3150.0,0.774,19.52,463,183,139,44,280,204,76,18,0.0,0.0
1007,260,23-09-2019 20:18:00,0,4282.0,3280.0,0.766,20.505,345,100,71,29,245,183,62,19,0.0,0.0
1007,261,23-09-2019 20:20:00,0,4138.0,3133.5,0.757,19.774,295,143,102,41,152,101,51,39,0.0,0.0
1007,262,23-09-2019 20:22:00,0,3994.0,2987.0,0.748,19.043,224,93,61,32,131,86,45,85,0.0,0.0
1007,263,23-09-2019 20:24:00,0,3549.0,2763.0,0.779,17.042,528,117,79,38,411,348,63,45,0.01,0.0
1007,264,23-09-2019 20:26:00,0,3747.0,2944.0,0.786,18.024,391,67,36,31,324,264,60,10,0.0,0.0
1007,265,23-09-2019 20:28:00,0,3881.0,2959.0,0.762,18.565,541,44,18,26,497,395,102,0,0.0,0.0
1007,266,23-09-2019 20:30:00,0,3646.0,2810.0,0.771,17.475,240,46,26,20,194,137,57,0,0.0,0.0
1007,267,23-09-2019 20:32:00,0,3224.0,2580.0,0.8,15.558,134,1,1,0,133,82,51,0,0.0,0.0
1007,268,23-09-2019 20:34:00,0,3134.0,2431.0,0.776,15.038,492,0,0,0,492,402,90,0,0.0,0.0
1007,269,23-09-2019 20:36:00,0,2913.0,2311.0,0.793,14.036,98,21,4,17,77,27,50,0,0.0,0.0
1007,270,23-09-2019 20:38:00,0,2606.0,2038.0,0.782,12.524,69,10,6,4,59,22,37,0,0.0,0.0
1007,271,23-09-2019 20:40:00,0,2621.0,1943.0,0.741,12.481,53,10,5,5,43,4,39,0,0.0,0.0
1007,272,23-09-2019 20:42:00,0,2620.0,1977.0,0.754,12.511,90,2,0,2,88,41,47,0,0.0,0.0
1007,273,23-09-2019 20:44:00,0,2629.0,1927.0,0.733,12.493,69,4,1,3,65,20,45,0,0.0,0.0
1007,274,23-09-2019 20:46:00,0,2643.0,1905.0,0.721,12.522,63,8,2,6,55,24,31,0,0.0,0.0
1007,275,23-09-2019 20:48:00,0,2636.0,1907.0,0.723,12.498,61,3,0,3,58,7,51,0,0.0,0.0
1007,276,23-09-2019 20:50:00,0,2660.0,1848.0,0.695,12.529,185,0,0,0,185,120,65,0,0.0,0.0
1007,277,23-09-2019 20:52:00,0,2414.0,1803.0,0.747,11.508,189,0,0,0,189,134,55,0,0.0,0.0
1007,278,23-09-2019 20:54:00,0,2682.5,1984.5,0.7405,12.767,389,118,87,31,271,201,70,13,0.0,0.0
1007,279,23-09-2019 20:56:00,0,2951.0,2166.0,0.734,14.026,311,111,82,29,200,154,46,112,0.0,0.0
1007,280,23-09-2019 20:58:00,0,3109.0,2506.0,0.806,15.023,790,293,231,62,497,405,92,87,0.0,0.0
1007,281,23-09-2019 21:00:00,0,3462.0,2619.0,0.757,16.539,586,286,231,55,300,226,74,80,0.0,0.0
1007,282,23-09-2019 21:02:00,0,3660.0,2799.0,0.765,17.519,544,206,152,54,338,273,65,55,0.0,0.0
1007,283,23-09-2019 21:04:00,0,3682.0,2727.0,0.741,17.525,348,142,101,41,206,146,60,29,0.0,0.0
1007,284,23-09-2019 21:06:00,0,3656.0,2814.0,0.77,17.519,416,155,116,39,261,192,69,67,0.0,0.0
1007,285,23-09-2019 21:08:00,0,3677.0,2777.0,0.755,17.562,334,123,77,46,211,145,66,11,0.0,0.0
1007,286,23-09-2019 21:10:00,0,3685.0,2702.0,0.733,17.512,124,50,28,22,74,28,46,13,0.0,0.0
1007,287,23-09-2019 21:12:00,0,4015.0,2896.0,0.721,19.024,285,111,74,37,174,122,52,43,0.0,0.0
1007,288,23-09-2019 21:14:00,0,3656.0,2824.0,0.773,17.53,582,233,172,61,349,265,84,40,0.0,0.0
1007,289,23-09-2019 21:16:00,0,3775.0,2838.0,0.752,18.014,386,189,143,46,197,132,65,42,0.0,0.0
1007,290,23-09-2019 21:18:00,0,3656.0,2787.0,0.762,17.492,514,161,109,52,353,268,85,51,0.0,0.0
1007,291,23-09-2019 21:20:00,0,3687.0,2736.0,0.742,17.557,371,158,115,43,213,152,61,27,0.0,0.0
1007,292,23-09-2019 21:22:00,0,3700.0,2626.0,0.71,17.484,336,108,70,38,228,169,59,17,0.0,0.0
1007,293,23-09-2019 21:24:00,0,3705.0,2675.0,0.722,17.561,149,58,31,27,91,76,15,6,0.0,0.0
1007,294,23-09-2019 21:26:00,0,3263.0,2402.0,0.736,15.514,255,69,45,24,186,162,24,31,0.0,0.0
1007,295,23-09-2019 21:28:00,0,3367.0,2477.0,0.7355,16.0075,388,97,67,30,291,235,56,48,0.0,0.0
1007,296,23-09-2019 21:30:00,0,3471.0,2552.0,0.735,16.501,432,140,95,45,292,213,79,20,0.0,0.0
1007,297,23-09-2019 21:32:00,0,3467.0,2620.0,0.756,16.563,481,76,53,23,405,313,92,30,0.0,0.0
1007,298,23-09-2019 21:34:00,0,3477.0,2556.0,0.735,16.529,289,52,35,17,237,177,60,11,0.0,0.0
1007,299,23-09-2019 21:36:00,0,3480.0,2527.0,0.726,16.508,430,101,63,38,329,260,69,13,0.0,0.0
1007,300,23-09-2019 21:38:00,0,3364.0,2500.0,0.743,16.025,261,121,84,37,140,96,44,18,0.0,0.0
1007,301,23-09-2019 21:40:00,0,3577.0,2587.0,0.723,16.96,529,179,137,42,350,275,75,79,0.0,0.0
1007,302,23-09-2019 21:42:00,0,3364.0,2483.0,0.738,16.005,282,58,26,32,224,159,65,21,0.0,0.0
1007,303,23-09-2019 21:44:00,0,3056.0,2228.0,0.729,14.508,462,57,35,22,405,341,64,16,0.0,0.0
1007,304,23-09-2019 21:46:00,0,3252.0,2446.0,0.752,15.522,390,125,92,33,265,192,73,29,0.0,0.0
1007,305,23-09-2019 21:48:00,0,3165.0,2297.0,0.726,15.013,49,5,4,1,44,9,35,0,0.0,0.0
1007,306,23-09-2019 21:50:00,0,2958.0,2099.0,0.71,13.977,42,0,0,0,42,3,39,0,0.0,0.0
1007,307,23-09-2019 21:52:00,0,2991.0,2018.0,0.675,14.021,98,0,0,0,98,62,36,0,0.0,0.0
1007,308,23-09-2019 21:54:00,0,2625.0,1927.0,0.734,12.475,41,2,2,0,39,9,30,0,0.0,0.0
1007,309,23-09-2019 21:56:00,0,2645.0,1869.0,0.706,12.491,30,0,0,0,30,0,30,0,0.0,0.0
1007,310,23-09-2019 21:58:00,0,2658.0,1839.0,0.692,12.508,35,0,0,0,35,0,35,0,0.0,0.0
1007,311,23-09-2019 22:00:00,0,2653.0,1875.0,0.707,12.527,122,24,13,11,98,50,48,0,0.0,0.0
1007,312,23-09-2019 22:02:00,0,2915.0,2074.0,0.7115,13.78,506,181,124,57,325,255,70,34,0.0,0.0
1007,313,23-09-2019 22:04:00,0,3177.0,2273.0,0.716,15.033,586,205,158,47,381,307,74,86,0.0,0.0
1007,314,23-09-2019 22:06:00,0,3147.0,2362.0,0.751,15.013,394,167,122,45,227,175,52,76,0.0,0.0
1007,315,23-09-2019 22:08:00,0,3249.0,2475.0,0.762,15.54,526,160,106,54,366,290,76,38,0.0,0.0
1007,316,23-09-2019 22:10:00,0,3249.0,2456.0,0.756,15.52,477,130,85,45,347,292,55,47,0.04,0.0
1007,317,23-09-2019 22:12:00,0,3482.0,2478.0,0.712,16.462,639,136,97,39,503,413,90,21,0.0,0.0
1007,318,23-09-2019 22:14:00,0,3257.0,2420.0,0.743,15.511,418,111,76,35,307,239,68,32,0.0,0.0
1007,319,23-09-2019 22:16:00,0,3579.0,2605.0,0.728,16.987,174,44,32,12,130,80,50,10,0.0,0.0
1007,320,23-09-2019 22:18:00,0,3486.0,2514.0,0.721,16.517,322,74,53,21,248,168,80,46,0.0,0.0
1007,321,23-09-2019 22:20:00,0,3484.0,2513.0,0.721,16.51,203,59,31,28,144,92,52,7,0.0,0.0
1007,322,23-09-2019 22:22:00,0,2945.0,2176.0,0.739,14.011,226,61,27,34,165,106,59,9,0.0,0.0
1007,323,23-09-2019 22:24:00,0,3164.0,2310.0,0.73,15.027,254,98,70,28,156,88,68,15,0.0,0.0
1007,324,23-09-2019 22:26:00,0,3128.0,2397.0,0.766,14.978,460,103,70,33,357,283,74,26,0.03,0.0
1007,325,23-09-2019 22:28:00,0,3056.0,2253.0,0.737,14.535,276,94,72,22,182,128,54,29,0.0,0.0
1007,326,23-09-2019 22:30:00,0,3137.0,2368.0,0.755,14.983,288,123,97,26,165,121,44,41,0.0,0.0
1007,327,23-09-2019 22:32:00,0,3490.0,2498.0,0.716,16.517,283,113,80,33,170,110,60,13,0.0,0.0
1007,328,23-09-2019 22:34:00,0,3594.0,2597.0,0.723,17.035,395,151,110,41,244,191,53,62,0.0,0.0
1007,329,23-09-2019 22:36:00,0,3598.0,2584.5,0.7185,17.0375,391,122,95,27,269,209,60,12,0.0,0.0
1007,330,23-09-2019 22:38:00,0,3602.0,2572.0,0.714,17.04,372,167,130,37,205,148,57,55,0.0,0.0
1007,331,23-09-2019 22:40:00,0,3479.0,2543.0,0.731,16.524,223,88,58,30,135,89,46,58,0.0,0.0
1007,332,23-09-2019 22:42:00,0,3481.0,2522.0,0.724,16.509,452,140,100,40,312,239,73,8,0.0,0.0
1007,333,23-09-2019 22:44:00,0,3065.0,2221.0,0.725,14.537,358,105,69,36,253,194,59,14,0.04,0.0
1007,334,23-09-2019 22:46:00,0,3480.0,2505.0,0.72,16.484,349,51,32,19,298,259,39,43,0.0,0.0
1007,335,23-09-2019 22:48:00,0,3370.0,2426.0,0.72,15.963,317,126,91,35,191,140,51,18,0.0,0.0
1007,336,23-09-2019 22:50:00,0,3486.0,2479.0,0.711,16.481,490,56,40,16,434,340,94,16,0.0,0.0
1007,337,23-09-2019 22:52:00,0,3258.0,2410.0,0.74,15.507,326,5,1,4,321,301,20,0,0.0,0.0
1007,338,23-09-2019 22:54:00,0,2952.0,2193.0,0.743,14.058,303,0,0,0,303,280,23,0,0.0,0.0
1007,339,23-09-2019 22:56:00,0,2979.0,2010.0,0.675,13.962,332,1,0,1,331,263,68,0,0.0,0.0
1007,340,23-09-2019 22:58:00,0,2877.0,1970.0,0.685,13.516,354,8,2,6,346,259,87,0,0.0,0.0
1007,341,23-09-2019 23:00:00,0,2634.0,1929.0,0.732,12.516,222,5,0,5,217,146,71,0,0.0,0.0
1007,342,23-09-2019 23:02:00,0,2642.0,1909.0,0.723,12.525,472,119,83,36,353,275,78,18,0.06,0.0
1007,343,23-09-2019 23:04:00,0,2938.0,2209.0,0.752,14.021,564,193,147,46,371,288,83,87,0.0,0.0
1007,344,23-09-2019 23:06:00,0,3051.0,2260.0,0.741,14.523,414,169,122,47,245,169,76,63,0.0,0.0
1007,345,23-09-2019 23:08:00,0,3149.0,2352.0,0.747,15.011,314,43,26,17,271,206,65,84,0.0,0.0
1007,346,23-09-2019 23:10:00,0,3144.5,2351.5,0.748,14.993,513,168,125,43,345,271,74,46,0.0,0.0
1007,347,23-09-2019 23:12:00,0,3140.0,2351.0,0.749,14.975,352,161,121,40,191,135,56,43,0.0,0.0
1007,348,23-09-2019 23:14:00,0,3163.0,2311.0,0.731,15.02,404,108,71,37,296,228,68,26,0.0,0.0
1007,349,23-09-2019 23:16:00,0,3164.0,2361.0,0.746,15.08,304,105,71,34,199,145,54,45,0.0,0.0
1007,350,23-09-2019 23:18:00,0,3151.0,2355.0,0.747,15.022,317,71,45,26,246,180,66,56,0.01,0.0
1007,351,23-09-2019 23:20:00,0,3374.0,2441.0,0.723,15.995,336,45,32,13,291,219,72,5,0.0,0.0
1007,352,23-09-2019 23:22:00,0,2946.0,2182.0,0.741,14.024,211,64,40,24,147,90,57,0,0.02,0.0
1007,353,23-09-2019 23:24:00,0,2941.0,2206.0,0.75,14.031,192,67,37,30,125,72,53,21,0.0,0.0
1007,354,23-09-2019 23:26:00,0,3054.0,2235.0,0.732,14.508,427,139,101,38,288,219,69,37,0.0,0.0
1007,355,23-09-2019 23:28:00,0,3141.0,2384.0,0.759,15.016,438,139,108,31,299,231,68,10,0.0,0.0
1007,356,23-09-2019 23:30:00,0,3174.0,2276.0,0.717,15.025,431,100,63,37,331,253,78,49,0.0,0.0
1007,357,23-09-2019 23:32:00,0,3256.0,2410.0,0.74,15.498,289,80,49,31,209,143,66,44,0.0,0.0
1007,358,23-09-2019 23:34:00,0,3495.0,2494.0,0.714,16.531,351,92,62,30,259,183,76,72,0.0,0.0
1007,359,23-09-2019 23:36:00,0,3479.0,2533.0,0.728,16.511,311,98,70,28,213,151,62,69,0.0,0.0
1007,360,23-09-2019 23:38:00,0,3700.0,2667.0,0.721,17.53,405,100,72,28,305,229,76,68,0.0,0.0
1007,361,23-09-2019 23:40:00,0,3684.0,2725.0,0.74,17.534,478,167,123,44,311,228,83,86,0.0,0.0
1007,362,23-09-2019 23:42:00,0,3794.0,2755.0,0.726,17.999,321,91,56,35,230,166,64,63,0.0,0.0
1007,363,23-09-2019 23:44:00,0,3890.5,2877.0,0.739,18.5145,293,97,63,34,196,134,62,49,0.0,0.0
1007,364,23-09-2019 23:46:00,0,3987.0,2999.0,0.752,19.03,325,120,83,37,205,134,71,69,0.0,0.0
1007,365,23-09-2019 23:48:00,0,4205.0,3162.0,0.752,20.07,336,129,88,41,207,136,71,76,0.0,0.0
1007,366,23-09-2019 23:50:00,0,4166.0,3273.0,0.786,20.038,300,87,69,18,213,140,73,58,0.0,0.0
1007,367,23-09-2019 23:52:00,0,4268.0,3424.0,0.802,20.607,596,207,161,46,389,300,89,54,0.0,0.0
1007,368,23-09-2019 23:54:00,0,3964.0,3119.0,0.787,19.07,696,305,242,63,391,310,81,130,0.1,0.0
1007,369,23-09-2019 23:56:00,0,3422.0,2748.0,0.803,16.523,555,162,115,47,393,309,84,90,0.13,0.0
1007,370,23-09-2019 23:58:00,0,3981.0,3046.0,0.765,19.058,309,96,58,38,213,139,74,40,0.0,0.0
1007,371,24-09-2019 00:00:00,0,4162.0,3307.0,0.794,20.061,341,163,120,43,178,119,59,76,0.0,0.0
1007,372,24-09-2019 00:02:00,0,4442.0,3613.0,0.813,21.503,362,117,79,38,245,184,61,49,0.0,0.0
1007,373,24-09-2019 00:04:00,0,4448.0,3616.0,0.813,21.531,341,139,105,34,202,137,65,59,0.0,0.0
1007,374,24-09-2019 00:06:00,0,4422.0,3745.0,0.847,21.569,472,226,174,52,246,170,76,72,0.0,0.0
1007,375,24-09-2019 00:08:00,0,4373.0,3816.0,0.873,21.455,465,168,129,39,297,222,75,64,0.1,0.0
1007,376,24-09-2019 00:10:00,0,4632.0,3924.0,0.847,22.593,437,151,106,45,286,207,79,63,0.0,0.0
1007,377,24-09-2019 00:12:00,0,4503.0,3941.0,0.875,22.105,505,191,148,43,314,242,72,44,0.13,0.0
1007,378,24-09-2019 00:14:00,0,4599.0,4014.0,0.873,22.563,317,107,66,41,210,151,59,62,0.0,0.0
1007,379,24-09-2019 00:16:00,0,4926.0,4170.0,0.847,24.027,489,170,117,53,319,252,67,75,0.0,0.0
1007,380,24-09-2019 00:18:00,0,4554.5,3945.0,0.868,22.314,577,182,138,44,395,330,65,47,0.03,0.0
1007,381,24-09-2019 00:20:00,0,4183.0,3720.0,0.889,20.601,442,108,78,30,334,265,69,24,0.0,0.0
1007,382,24-09-2019 00:22:00,0,3888.0,3346.0,0.861,19.022,490,148,114,34,342,279,63,66,0.09,0.0
1007,383,24-09-2019 00:24:00,0,4351.0,3944.0,0.906,21.511,425,148,111,37,277,227,50,64,0.0,0.0
1007,384,24-09-2019 00:26:00,0,4892.0,4332.0,0.885,24.071,584,223,172,51,361,294,67,81,0.0,0.0
1007,385,24-09-2019 00:28:00,0,4068.0,3618.0,0.889,20.035,588,195,156,39,393,348,45,84,0.06,0.0
1007,386,24-09-2019 00:30:00,0,3966.0,3517.0,0.887,19.521,414,152,106,46,262,224,38,61,0.02,0.0
1007,387,24-09-2019 00:32:00,0,4179.0,3723.0,0.891,20.587,333,107,70,37,226,197,29,69,0.0,0.0
1007,388,24-09-2019 00:34:00,0,4043.0,3735.0,0.924,20.065,531,153,113,40,378,339,39,50,0.0,0.0
1007,389,24-09-2019 00:36:00,0,4579.0,4062.0,0.887,22.538,439,145,104,41,294,277,17,65,0.0,0.0
1007,390,24-09-2019 00:38:00,0,5071.0,4559.0,0.899,25.028,474,113,79,34,361,324,37,58,0.0,0.0
1007,391,24-09-2019 00:40:00,0,4823.0,4574.0,0.948,24.066,452,124,92,32,328,287,41,68,0.0,0.0
1007,392,24-09-2019 00:42:00,0,4858.0,4461.0,0.918,24.08,558,150,108,42,408,392,16,76,0.0,0.0
1007,393,24-09-2019 00:44:00,0,5059.0,4631.0,0.915,25.057,452,141,102,39,311,278,33,52,0.08,0.0
1007,394,24-09-2019 00:46:00,0,3859.0,3446.0,0.893,19.02,602,152,109,43,450,405,45,13,0.0,0.0
1007,395,24-09-2019 00:48:00,0,4356.0,3986.0,0.915,21.574,403,126,91,35,277,219,58,59,0.05,0.0
1007,396,24-09-2019 00:50:00,0,4868.0,4422.0,0.908,24.077,366,88,58,30,278,222,56,66,0.0,0.0
1007,397,24-09-2019 00:52:00,0,4224.0,3757.0,0.886,20.803,419,91,67,24,328,263,65,43,0.0,0.0
1007,398,24-09-2019 00:54:00,0,3580.0,3092.0,0.864,17.529,351,120,73,47,231,167,64,6,0.0,0.0
1007,399,24-09-2019 00:56:00,0,3668.0,3238.0,0.883,18.039,347,124,74,50,223,148,75,63,0.0,0.0
1007,400,24-09-2019 00:58:00,0,4856.0,4466.0,0.92,24.076,504,148,106,42,356,273,83,63,0.0,0.0
1007,401,24-09-2019 01:00:00,0,3883.0,3376.0,0.87,19.035,672,254,196,58,418,341,77,47,0.0,0.0
1007,402,24-09-2019 01:02:00,0,4333.0,4013.0,0.926,21.516,355,91,63,28,264,199,65,64,0.0,0.0
1007,403,24-09-2019 01:04:00,0,4847.0,4494.0,0.927,24.071,361,159,108,51,202,135,67,73,0.0,0.0
1007,404,24-09-2019 01:06:00,0,4887.0,4397.0,0.9,24.121,294,79,51,28,215,142,73,53,0.0,0.0
1007,405,24-09-2019 01:08:00,0,4761.0,4309.0,0.905,23.53,338,116,72,44,222,146,76,45,0.0,0.0
1007,406,24-09-2019 01:10:00,0,4554.0,4185.0,0.919,22.577,679,246,192,54,433,351,82,13,0.0,0.0
1007,407,24-09-2019 01:12:00,0,3766.0,3344.0,0.888,18.54,510,159,117,42,351,267,84,56,0.0,0.0
1007,408,24-09-2019 01:14:00,0,4264.0,3843.0,0.901,21.055,327,120,78,42,207,141,66,51,0.0,0.0
1007,409,24-09-2019 01:16:00,0,4890.0,4359.0,0.891,24.095,396,119,83,36,277,205,72,66,0.0,0.0
1007,410,24-09-2019 01:18:00,0,4755.0,4317.0,0.908,23.516,357,164,117,47,193,127,66,61,0.0,0.0
1007,411,24-09-2019 01:20:00,0,3746.0,3435.0,0.917,18.563,411,128,97,31,283,214,69,37,0.0,0.0
1007,412,24-09-2019 01:22:00,0,3763.0,3380.0,0.898,18.569,590,164,121,43,426,342,84,42,0.03,0.0
1007,413,24-09-2019 01:24:00,0,4445.0,4113.0,0.925,22.066,297,86,52,34,211,146,65,66,0.0,0.0
1007,414,24-09-2019 01:26:00,0,4482.5,4167.0,0.9295,22.275,379,143,95,48,236,159,77,58,0.0,0.0
1007,415,24-09-2019 01:28:00,0,4520.0,4221.0,0.934,22.484,361,113,86,27,248,180,68,25,0.0,0.0
1007,416,24-09-2019 01:30:00,0,4331.0,4095.0,0.946,21.596,461,145,103,42,316,241,75,4,0.0,0.0
1007,417,24-09-2019 01:32:00,0,3353.0,2987.0,0.891,16.518,495,119,82,37,376,276,100,9,0.09,0.0
1007,418,24-09-2019 01:34:00,0,3852.0,3524.0,0.915,19.078,464,174,128,46,290,226,64,64,0.0,0.0
1007,419,24-09-2019 01:36:00,0,3543.0,3230.0,0.912,17.535,383,116,87,29,267,192,75,38,0.0,0.0
1007,420,24-09-2019 01:38:00,0,4356.0,4008.0,0.92,21.601,343,136,99,37,207,137,70,83,0.0,0.0
1007,421,24-09-2019 01:40:00,0,4655.0,4298.0,0.923,23.097,440,244,191,53,196,139,57,67,0.0,0.0
1007,422,24-09-2019 01:42:00,0,4535.0,4259.0,0.939,22.583,303,112,78,34,191,135,56,68,0.0,0.0
1007,423,24-09-2019 01:44:00,0,4878.0,4374.0,0.897,24.061,381,181,135,46,200,137,63,73,0.0,0.0
1007,424,24-09-2019 01:46:00,0,4537.0,4240.0,0.935,22.568,303,110,81,29,193,138,55,26,0.07,0.0
1007,425,24-09-2019 01:48:00,0,3551.0,3215.0,0.906,17.55,610,190,140,50,420,331,89,34,0.0,0.0
1007,426,24-09-2019 01:50:00,0,4347.0,3998.0,0.92,21.555,372,199,151,48,173,110,63,69,0.0,0.0
1007,427,24-09-2019 01:52:00,0,4851.0,4461.0,0.92,24.051,454,152,100,52,302,215,87,35,0.09,0.0
1007,428,24-09-2019 01:54:00,0,3341.0,3092.0,0.925,16.588,625,155,116,39,470,392,78,26,0.03,0.0
1007,429,24-09-2019 01:56:00,0,4351.0,4042.0,0.929,21.617,425,126,88,38,299,228,71,90,0.04,0.0
1007,430,24-09-2019 01:58:00,0,4761.0,4352.0,0.914,23.577,316,131,93,38,185,121,64,77,0.0,0.0
1007,431,24-09-2019 02:00:00,0,4259.0,3879.0,0.9105,21.075,511,162,127,35,349,268,81,36,0.04,0.0
1007,432,24-09-2019 02:02:00,0,3757.0,3406.0,0.907,18.573,453,145,104,41,308,242,66,65,0.0,0.0
1007,433,24-09-2019 02:04:00,0,4630.0,4307.0,0.93,23.011,467,232,172,60,235,168,67,58,0.0,0.0
1007,434,24-09-2019 02:06:00,0,4543.0,4206.0,0.926,22.558,436,175,129,46,261,191,70,20,0.0,0.0
1007,435,24-09-2019 02:08:00,0,4309.0,4105.0,0.953,21.523,351,124,85,39,227,171,56,53,0.05,0.0
1007,436,24-09-2019 02:10:00,0,4353.0,4052.0,0.931,21.639,331,110,73,37,221,162,59,70,0.0,0.0
1007,437,24-09-2019 02:12:00,0,4544.0,4226.0,0.93,22.581,591,162,121,41,429,340,89,25,0.0,0.0
1007,438,24-09-2019 02:14:00,0,3866.0,3455.0,0.894,19.059,788,251,194,57,537,441,96,50,0.0,0.0
1007,439,24-09-2019 02:16:00,0,4054.0,3682.0,0.908,20.05,665,232,177,55,433,338,95,30,0.0,0.0
1007,440,24-09-2019 02:18:00,0,2818.0,2663.0,0.945,14.051,640,243,184,59,397,317,80,37,0.05,0.0
1007,441,24-09-2019 02:20:00,0,3134.0,2912.0,0.929,15.571,484,178,127,51,306,228,78,50,0.0,0.0
1007,442,24-09-2019 02:22:00,0,4346.0,4002.0,0.921,21.556,535,193,146,47,342,258,84,43,0.0,0.0
1007,443,24-09-2019 02:24:00,0,3736.0,3475.0,0.93,18.565,645,239,188,51,406,326,80,14,0.0,0.0
1007,444,24-09-2019 02:26:00,0,3533.0,3269.0,0.925,17.541,495,183,127,56,312,233,79,0,0.0,0.0
1007,445,24-09-2019 02:28:00,0,3537.0,3259.0,0.921,17.544,673,287,225,62,386,316,70,6,0.0,0.0
1007,446,24-09-2019 02:30:00,0,3757.0,3403.0,0.906,18.572,276,59,27,32,217,158,59,0,0.0,0.0
1007,447,24-09-2019 02:32:00,0,3368.0,2994.0,0.889,16.583,253,45,13,32,208,140,68,0,0.0,0.0
1007,448,24-09-2019 02:34:00,0,3462.5,3084.5,0.891,17.0565,192,89,48,41,103,61,42,0,0.0,0.0
1007,449,24-09-2019 02:36:00,0,3557.0,3175.0,0.893,17.53,250,63,25,38,187,119,68,0,0.0,0.0
1007,450,24-09-2019 02:38:00,0,3574.0,3169.0,0.887,17.589,105,5,0,5,100,49,51,0,0.0,0.0
1007,451,24-09-2019 02:40:00,0,3022.0,2831.0,0.937,15.043,48,0,0,0,48,0,48,0,0.0,0.0
1007,452,24-09-2019 02:42:00,0,2929.0,2691.0,0.919,14.52,36,0,0,0,36,0,36,0,0.0,0.0
1007,453,24-09-2019 02:44:00,0,3061.0,2692.0,0.879,15.041,77,0,0,0,77,30,47,0,0.0,0.0
1007,454,24-09-2019 02:46:00,0,3043.0,2752.0,0.905,15.035,286,85,63,22,201,137,64,17,0.0,0.0
1007,455,24-09-2019 02:48:00,0,3334.0,3098.0,0.929,16.564,543,166,135,31,377,307,70,111,0.0,0.0
1007,456,24-09-2019 02:50:00,0,3347.0,3033.0,0.906,16.544,474,168,120,48,306,237,69,96,0.0,0.0
1007,457,24-09-2019 02:52:00,0,3110.0,2962.0,0.953,15.531,383,121,87,34,262,193,69,32,0.0,0.0
1007,458,24-09-2019 02:54:00,0,3344.0,3094.0,0.925,16.6,498,182,142,40,316,240,76,53,0.0,0.0
1007,459,24-09-2019 02:56:00,0,3015.0,2882.0,0.956,15.071,281,46,35,11,235,164,71,3,0.0,0.0
1007,460,24-09-2019 02:58:00,0,2853.0,2541.0,0.891,14.053,168,0,0,0,168,102,66,0,0.0,0.0
1007,461,24-09-2019 03:00:00,0,2756.0,2394.0,0.869,13.51,152,0,0,0,152,96,56,0,0.0,0.0
1007,462,24-09-2019 03:02:00,0,2533.0,2299.0,0.908,12.527,137,2,0,2,135,73,62,0,0.0,0.0
1007,463,24-09-2019 03:04:00,0,2551.0,2225.0,0.872,12.513,182,0,0,0,182,118,64,0,0.0,0.0
1007,464,24-09-2019 03:06:00,0,2567.0,2162.0,0.842,12.51,107,5,0,5,102,56,46,0,0.0,0.0
1007,465,24-09-2019 03:08:00,0,2463.0,2085.0,0.8465,12.013,101,0,0,0,101,53,48,0,0.0,0.0
1007,466,24-09-2019 03:10:00,0,2359.0,2008.0,0.851,11.516,127,3,2,1,124,69,55,0,0.0,0.0
1007,467,24-09-2019 03:12:00,0,2136.0,1905.0,0.892,10.526,104,12,8,4,92,46,46,0,0.0,0.0
1007,468,24-09-2019 03:14:00,0,2017.0,1888.0,0.936,10.036,99,0,0,0,99,48,51,0,0.0,0.0
1007,469,24-09-2019 03:16:00,0,2031.0,1859.0,0.916,10.059,70,1,0,1,69,27,42,0,0.0,0.0
1007,470,24-09-2019 03:18:00,0,2026.0,1824.0,0.9,10.004,110,8,0,8,102,51,51,0,0.0,0.0
1007,471,24-09-2019 03:20:00,0,2033.0,1825.0,0.897,10.031,91,1,0,1,90,39,51,0,0.0,0.0
1007,472,24-09-2019 03:22:00,0,2039.0,1791.0,0.878,10.016,110,0,0,0,110,55,55,0,0.0,0.0
1007,473,24-09-2019 03:24:00,0,2044.0,1783.0,0.872,10.029,112,4,0,4,108,52,56,0,0.0,0.0
1007,474,24-09-2019 03:26:00,0,2049.0,1765.0,0.862,10.027,85,1,0,1,84,41,43,0,0.0,0.0
1007,475,24-09-2019 03:28:00,0,2051.0,1739.0,0.848,10.006,63,0,0,0,63,23,40,0,0.0,0.0
1007,476,24-09-2019 03:30:00,0,2064.0,1727.0,0.836,10.045,109,5,1,4,104,54,50,0,0.0,0.0
1007,477,24-09-2019 03:32:00,0,2062.0,1702.0,0.825,10.009,91,3,0,3,88,35,53,0,0.0,0.0
1007,478,24-09-2019 03:34:00,0,2066.0,1706.0,0.826,10.028,93,3,0,3,90,44,46,0,0.0,0.0
1007,479,24-09-2019 03:36:00,0,2067.0,1666.0,0.806,9.989,74,1,0,1,73,35,38,0,0.0,0.0
1007,480,24-09-2019 03:38:00,0,2073.0,1674.0,0.807,10.022,47,1,1,0,46,5,41,0,0.0,0.0
1007,481,24-09-2019 03:40:00,0,2069.0,1702.0,0.823,10.036,79,14,0,14,65,19,46,0,0.0,0.0
1007,482,24-09-2019 03:42:00,0,2061.0,1722.5,0.836,10.028,73,3,0,3,70,24,46,0,0.0,0.0
1007,483,24-09-2019 03:44:00,0,2053.0,1743.0,0.849,10.02,103,10,5,5,93,42,51,0,0.0,0.0
1007,484,24-09-2019 03:46:00,0,2023.0,1840.0,0.91,10.005,137,5,0,5,132,67,65,0,0.0,0.0
1007,485,24-09-2019 03:48:00,0,2032.0,1842.0,0.906,10.047,132,6,0,6,126,67,59,0,0.0,0.0
1007,486,24-09-2019 03:50:00,0,2032.0,1830.0,0.901,10.03,166,2,0,2,164,101,63,0,0.0,0.0
1007,487,24-09-2019 03:52:00,0,2034.0,1814.0,0.892,10.023,150,0,0,0,150,88,62,0,0.0,0.0
1007,488,24-09-2019 03:54:00,0,2026.0,1832.0,0.904,10.011,91,4,0,4,87,38,49,0,0.0,0.0
1007,489,24-09-2019 03:56:00,0,2037.0,1815.0,0.891,10.036,162,0,0,0,162,101,61,0,0.0,0.0
1007,490,24-09-2019 03:58:00,0,2042.0,1817.0,0.89,10.058,152,11,5,6,141,87,54,0,0.0,0.0
1007,491,24-09-2019 04:00:00,0,2042.0,1777.0,0.87,10.015,444,126,94,32,318,227,91,20,0.0,0.0
1007,492,24-09-2019 04:02:00,0,2367.0,1998.0,0.844,11.537,418,141,104,37,277,212,65,66,0.0,0.0
1007,493,24-09-2019 04:04:00,0,2584.0,2113.0,0.818,12.521,532,157,117,40,375,290,85,19,0.0,0.0
1007,494,24-09-2019 04:06:00,0,2895.0,2352.0,0.812,14.012,278,72,51,21,206,154,52,44,0.0,0.0
1007,495,24-09-2019 04:08:00,0,2902.0,2377.0,0.819,14.065,305,68,33,35,237,162,75,38,0.0,0.0
1007,496,24-09-2019 04:10:00,0,2976.0,2496.0,0.839,14.49,340,109,76,33,231,164,67,73,0.0,0.0
1007,497,24-09-2019 04:12:00,0,3095.0,2614.0,0.845,15.087,316,48,19,29,268,189,79,67,0.0,0.0
1007,498,24-09-2019 04:14:00,0,3198.0,2666.0,0.833,15.553,280,92,51,41,188,121,67,63,0.0,0.0
1007,499,24-09-2019 04:16:00,0,3303.5,2737.5,0.8285,16.0465,307,109,66,43,198,139,59,63,0.0,0.0
1007,500,24-09-2019 04:18:00,0,3409.0,2809.0,0.824,16.54,317,65,25,40,252,179,73,55,0.0,0.0
1007,501,24-09-2019 04:20:00,0,3425.0,2786.0,0.814,16.578,247,63,21,42,184,121,63,48,0.0,0.0
1007,502,24-09-2019 04:22:00,0,3419.0,2779.0,0.813,16.546,279,50,18,32,229,142,87,61,0.0,0.0
1007,503,24-09-2019 04:24:00,0,3405.0,2828.0,0.831,16.547,289,61,25,36,228,151,77,50,0.0,0.0
1007,504,24-09-2019 04:26:00,0,3617.0,2937.0,0.812,17.501,306,66,30,36,240,166,74,50,0.0,0.0
1007,505,24-09-2019 04:28:00,0,3608.0,3029.0,0.84,17.569,282,53,18,35,229,153,76,49,0.0,0.0
1007,506,24-09-2019 04:30:00,0,3570.0,3118.0,0.873,17.519,282,124,71,53,158,96,62,53,0.0,0.0
1007,507,24-09-2019 04:32:00,0,3800.0,3209.0,0.844,18.526,299,65,26,39,234,159,75,44,0.0,0.0
1007,508,24-09-2019 04:34:00,0,3886.0,3339.0,0.859,19.007,383,122,91,31,261,186,75,14,0.0,0.0
1007,509,24-09-2019 04:36:00,0,3596.0,3073.0,0.855,17.568,274,72,43,29,202,137,65,49,0.0,0.0
1007,510,24-09-2019 04:38:00,0,3664.0,3244.0,0.885,18.028,313,74,39,35,239,172,67,59,0.0,0.0
1007,511,24-09-2019 04:40:00,0,3875.0,3384.0,0.873,19.013,320,72,46,26,248,183,65,56,0.07,0.0
1007,512,24-09-2019 04:42:00,0,3361.0,2997.0,0.892,16.559,404,121,79,42,283,206,77,55,0.0,0.0
1007,513,24-09-2019 04:44:00,0,3874.0,3438.0,0.888,19.07,310,83,52,31,227,151,76,66,0.0,0.0
1007,514,24-09-2019 04:46:00,0,3971.0,3574.0,0.9,19.604,309,56,30,26,253,179,74,58,0.0,0.0
1007,515,24-09-2019 04:48:00,0,4050.0,3704.0,0.915,20.058,387,70,33,37,317,229,88,36,0.1,0.0
1007,516,24-09-2019 04:50:00,0,3902.5,3567.5,0.9145,19.326,336,94,65,29,242,183,59,13,0.0,0.0
1007,517,24-09-2019 04:52:00,0,3755.0,3431.0,0.914,18.594,540,206,161,45,334,272,62,65,0.05,0.0
1007,518,24-09-2019 04:54:00,0,3840.0,3493.0,0.91,18.996,288,69,46,23,219,144,75,73,0.0,0.0
1007,519,24-09-2019 04:56:00,0,4052.0,3741.0,0.923,20.107,303,94,52,42,209,135,74,53,0.0,0.0
1007,520,24-09-2019 04:58:00,0,4045.0,3718.0,0.919,20.053,420,143,107,36,277,207,70,25,0.07,0.0
1007,521,24-09-2019 05:00:00,0,3506.0,3373.0,0.962,17.546,348,97,57,40,251,175,76,74,0.0,0.0
1007,522,24-09-2019 05:02:00,0,4022.0,3806.0,0.946,20.06,286,55,32,23,231,151,80,59,0.0,0.0
1007,523,24-09-2019 05:04:00,0,4335.0,4094.0,0.945,21.611,281,51,30,21,230,168,62,55,0.0,0.0
1007,524,24-09-2019 05:06:00,0,4351.0,4014.0,0.923,21.586,266,56,33,23,210,142,68,69,0.0,0.0
1007,525,24-09-2019 05:08:00,0,4328.0,4170.0,0.964,21.669,246,48,25,23,198,129,69,57,0.0,0.02
1007,526,24-09-2019 05:10:00,0,4523.0,4261.0,0.942,22.537,323,92,59,33,231,162,69,61,0.0,0.0
1007,527,24-09-2019 05:12:00,0,4540.0,4252.0,0.937,22.595,328,96,70,26,232,153,79,60,0.0,0.12
1007,528,24-09-2019 05:14:00,0,4526.0,4315.0,0.953,22.611,371,129,83,46,242,164,78,50,0.0,0.01
1007,529,24-09-2019 05:16:00,0,4507.0,4391.0,0.974,22.618,571,133,100,33,438,354,84,18,0.24,0.05
1007,530,24-09-2019 05:18:00,0,3966.0,4028.0,1.016,20.087,726,186,138,48,540,437,103,47,0.07,0.01
1007,531,24-09-2019 05:20:00,0,3415.0,3258.0,0.954,17.063,385,112,83,29,273,196,77,119,0.0,0.0
1007,532,24-09-2019 05:22:00,0,4310.0,4148.0,0.963,21.574,284,67,38,29,217,143,74,60,0.0,0.0
1007,533,24-09-2019 05:24:00,0,4350.0,4217.0,0.9695,21.8075,304,102,67,35,202,130,72,63,0.0,0.14
1007,534,24-09-2019 05:26:00,0,4390.0,4286.0,0.976,22.041,364,76,46,30,288,211,77,32,0.11,0.03
1007,535,24-09-2019 05:28:00,0,4604.0,4470.0,0.971,23.09,442,109,76,33,333,266,67,31,0.0,0.0
1007,536,24-09-2019 05:30:00,0,4220.0,4070.0,0.964,21.13,582,183,153,30,399,309,90,15,0.07,0.1
1007,537,24-09-2019 05:32:00,0,3790.0,3699.0,0.976,19.027,504,142,105,37,362,276,86,46,0.08,0.0
1007,538,24-09-2019 05:34:00,0,4305.0,4189.0,0.973,21.597,310,73,41,32,237,167,70,48,0.0,0.0
1007,539,24-09-2019 05:36:00,0,4019.0,3829.0,0.953,20.072,605,167,127,40,438,354,84,35,0.05,0.0
1007,540,24-09-2019 05:38:00,0,3811.0,3621.0,0.95,19.023,78,42,20,22,36,0,36,1,0.0,0.0
1007,541,24-09-2019 05:40:00,0,4460.0,4485.0,1.006,22.539,185,69,38,31,116,69,47,0,0.04,0.0
1007,542,24-09-2019 05:42:00,0,4281.0,4236.0,0.989,21.558,744,248,185,63,496,410,86,23,0.0,0.0
1007,543,24-09-2019 05:44:00,0,2994.0,2955.0,0.987,15.067,543,189,142,47,354,266,88,51,0.0,0.0
1007,544,24-09-2019 05:46:00,0,4287.0,4201.0,0.98,21.541,291,53,22,31,238,151,87,73,0.0,0.0
1007,545,24-09-2019 05:48:00,0,4486.0,4440.0,0.99,22.59,260,49,16,33,211,140,71,45,0.0,0.0
1007,546,24-09-2019 05:50:00,0,4384.0,4324.0,0.986,22.059,257,51,25,26,206,134,72,57,0.0,0.04
1007,547,24-09-2019 05:52:00,0,4323.0,4105.0,0.949,21.579,362,112,85,27,250,177,73,59,0.0,0.03
1007,548,24-09-2019 05:54:00,0,4014.0,3822.0,0.952,20.048,767,297,238,59,470,375,95,8,0.1,0.05
1007,549,24-09-2019 05:56:00,0,3989.0,3971.0,0.996,20.114,279,35,16,19,244,167,77,0,0.0,0.0
1007,550,24-09-2019 05:58:00,0,3394.5,3337.5,0.981,17.0695,179,29,13,16,150,90,60,0,0.0,0.0
1007,551,24-09-2019 06:00:00,1,2800.0,2704.0,0.966,14.025,329,99,65,34,230,166,64,8,0.0,0.0
1007,552,24-09-2019 06:02:00,1,4384.0,4378.0,0.999,22.119,541,217,169,48,324,264,60,105,0.0,0.0
1007,553,24-09-2019 06:04:00,1,4303.0,4145.0,0.963,21.544,267,88,61,27,179,122,57,105,0.0,0.0
1007,554,24-09-2019 06:06:00,1,4590.0,4541.0,0.989,23.11,300,55,32,23,245,176,69,83,0.0,0.0
1007,555,24-09-2019 06:08:00,1,4815.0,4603.0,0.956,24.066,267,56,34,22,211,137,74,65,0.0,0.0
1007,556,24-09-2019 06:10:00,1,4693.0,4581.0,0.976,23.562,295,58,31,27,237,158,79,71,0.0,0.09
1007,557,24-09-2019 06:12:00,1,4495.0,4380.0,0.974,22.557,165,35,15,20,130,73,57,20,0.0,0.05
1007,558,24-09-2019 06:14:00,1,4293.0,4169.0,0.971,21.531,299,112,91,21,187,121,66,54,0.0,0.0
1007,559,24-09-2019 06:16:00,1,4283.0,4270.0,0.997,21.601,536,174,132,42,362,274,88,25,0.11,0.01
1007,560,24-09-2019 06:18:00,1,3008.0,2869.0,0.954,15.028,551,134,105,29,417,319,98,38,0.02,0.0
1007,561,24-09-2019 06:20:00,1,3095.0,3073.0,0.993,15.596,428,136,111,25,292,223,69,61,0.0,0.03
1007,562,24-09-2019 06:22:00,1,3425.0,3265.0,0.953,17.109,272,16,14,2,256,195,61,0,0.0,0.0
1007,563,24-09-2019 06:24:00,1,3729.0,3489.0,0.936,18.556,185,0,0,0,185,127,58,0,0.0,0.0
1007,564,24-09-2019 06:26:00,1,3498.0,3422.0,0.978,17.571,235,53,29,24,182,124,58,0,0.0,0.0
1007,565,24-09-2019 06:28:00,1,3036.0,2817.0,0.928,15.082,181,1,0,1,180,114,66,0,0.0,0.0
1007,566,24-09-2019 06:30:00,1,2875.0,2500.0,0.87,14.095,218,4,0,4,214,142,72,0,0.0,0.0
1007,567,24-09-2019 06:32:00,1,3094.5,2847.0,0.917,15.345,292,5,2,3,287,215,72,0,0.0,0.0
1007,568,24-09-2019 06:34:00,1,3314.0,3194.0,0.964,16.595,191,8,4,4,183,120,63,0,0.0,0.0
1007,569,24-09-2019 06:36:00,1,3524.0,3335.0,0.946,17.574,238,11,4,7,227,155,72,0,0.0,0.0
1007,570,24-09-2019 06:38:00,1,3828.0,3566.0,0.932,19.031,197,0,0,0,197,124,73,0,0.0,0.0
1007,571,24-09-2019 06:40:00,1,3604.0,3481.0,0.966,18.055,187,6,0,6,181,116,65,0,0.0,0.0
1007,572,24-09-2019 06:42:00,1,3506.0,3380.0,0.964,17.555,302,1,0,1,301,225,76,0,0.01,0.0
1007,573,24-09-2019 06:44:00,1,3411.0,3252.0,0.953,17.04,251,3,0,3,248,169,79,0,0.0,0.0
1007,574,24-09-2019 06:46:00,1,3302.0,3235.0,0.98,16.591,267,3,1,2,264,192,72,0,0.0,0.0
1007,575,24-09-2019 06:48:00,1,3416.0,3255.0,0.953,17.063,291,15,1,14,276,194,82,0,0.0,0.0
1007,576,24-09-2019 06:50:00,1,3312.0,3153.0,0.952,16.541,286,28,2,26,258,186,72,0,0.0,0.0
1007,577,24-09-2019 06:52:00,1,3083.0,3080.0,0.999,15.557,274,31,15,16,243,171,72,0,0.0,0.0
1007,578,24-09-2019 06:54:00,1,3299.0,3244.0,0.983,16.588,386,141,104,37,245,175,70,56,0.0,0.0
1007,579,24-09-2019 06:56:00,1,3496.0,3420.0,0.978,17.561,548,164,130,34,384,300,84,46,0.0,0.0
1007,580,24-09-2019 06:58:00,1,3592.0,3540.0,0.986,18.072,268,73,55,18,195,138,57,72,0.0,0.0
1007,581,24-09-2019 07:00:00,1,3793.0,3707.0,0.977,19.046,261,20,5,15,241,163,78,46,0.01,0.0
1007,582,24-09-2019 07:02:00,1,3795.0,3740.0,0.985,19.093,224,21,4,17,203,133,70,69,0.0,0.0
1007,583,24-09-2019 07:04:00,1,3896.0,3806.0,0.977,19.565,259,44,21,23,215,140,75,56,0.0,0.09
1007,584,24-09-2019 07:06:00,1,3940.5,3888.5,0.987,19.8305,243,36,15,21,207,142,65,56,0.0,0.01
1007,585,24-09-2019 07:08:00,1,3985.0,3971.0,0.997,20.096,292,55,23,32,237,160,77,69,0.0,0.0
1007,586,24-09-2019 07:10:00,1,4074.0,4056.0,0.996,20.541,406,92,67,25,314,222,92,25,0.0,0.11
1007,587,24-09-2019 07:12:00,1,2622.0,2460.0,0.938,13.053,452,159,114,45,293,214,79,23,0.08,0.02
1007,588,24-09-2019 07:14:00,1,3535.0,3322.0,0.94,17.606,714,241,195,46,473,377,96,27,0.03,0.02
1007,589,24-09-2019 07:16:00,1,3817.0,3588.0,0.94,19.011,764,266,209,57,498,404,94,41,0.07,0.0
1007,590,24-09-2019 07:18:00,1,3917.0,3749.0,0.957,19.583,554,215,168,47,339,265,74,35,0.0,0.05
1007,591,24-09-2019 07:20:00,1,3008.0,2900.0,0.964,15.061,255,79,56,23,176,137,39,101,0.0,0.0
1007,592,24-09-2019 07:22:00,1,3807.0,3667.0,0.963,19.059,247,72,50,22,175,132,43,97,0.0,0.0
1007,593,24-09-2019 07:24:00,1,4080.0,4053.0,0.993,20.561,298,67,38,29,231,171,60,13,0.0,0.0
1007,594,24-09-2019 07:26:00,1,3788.0,3742.0,0.988,19.066,60,14,4,10,46,10,36,0,0.0,0.0
1007,595,24-09-2019 07:28:00,1,4019.0,3804.0,0.946,20.048,295,62,30,32,233,165,68,0,0.0,0.0
1007,596,24-09-2019 07:30:00,1,4015.0,3883.0,0.967,20.118,203,31,2,29,172,122,50,0,0.0,0.0
1007,597,24-09-2019 07:32:00,1,3804.0,3704.0,0.974,19.086,174,12,4,8,162,103,59,0,0.0,0.0
1007,598,24-09-2019 07:34:00,1,3813.0,3655.0,0.959,19.07,140,0,0,0,140,86,54,0,0.0,0.0
1007,599,24-09-2019 07:36:00,1,3484.0,3479.0,0.999,17.577,174,1,0,1,173,120,53,0,0.0,0.0
1007,600,24-09-2019 07:38:00,1,3525.0,3318.0,0.941,17.563,146,0,0,0,146,87,59,0,0.0,0.0
1007,601,24-09-2019 07:40:00,1,3256.0,3148.5,0.969,16.3145,166,0,0,0,166,105,61,0,0.0,0.0
1007,602,24-09-2019 07:42:00,1,2987.0,2979.0,0.997,15.066,149,2,1,1,147,95,52,0,0.0,0.0
1007,603,24-09-2019 07:44:00,1,3022.0,2871.0,0.95,15.083,251,9,1,8,242,171,71,0,0.0,0.0
1007,604,24-09-2019 07:46:00,1,2798.0,2727.0,0.975,14.044,418,24,10,14,394,305,89,0,0.0,0.0
1007,605,24-09-2019 07:48:00,1,2891.0,2881.0,0.997,14.582,238,0,0,0,238,172,66,0,0.0,0.0
1007,606,24-09-2019 07:50:00,1,2786.0,2767.0,0.993,14.041,286,0,0,0,286,219,67,0,0.0,0.0
1007,607,24-09-2019 07:52:00,1,2801.0,2708.0,0.967,14.036,513,0,0,0,513,414,99,0,0.0,0.0
1007,608,24-09-2019 07:54:00,1,2832.0,2607.0,0.92,14.046,755,0,0,0,755,660,95,0,0.0,0.0
1007,609,24-09-2019 07:56:00,1,2597.0,2523.0,0.971,13.026,258,5,0,5,253,186,67,0,0.0,0.0
1007,610,24-09-2019 07:58:00,1,2478.0,2530.0,1.021,12.563,255,1,0,1,254,177,77,0,0.0,0.0
1007,611,24-09-2019 08:00:00,1,2490.0,2452.0,0.985,12.527,222,1,0,1,221,159,62,0,0.0,0.0
1007,612,24-09-2019 08:02:00,1,2504.0,2407.0,0.961,12.531,507,0,0,0,507,414,93,0,0.0,0.0
1007,613,24-09-2019 08:04:00,1,2485.0,2491.0,1.002,12.547,329,16,8,8,313,242,71,0,0.0,0.0
1007,614,24-09-2019 08:06:00,1,2478.0,2538.0,1.024,12.573,291,1,0,1,290,201,89,0,0.0,0.0
1007,615,24-09-2019 08:08:00,1,2461.0,2556.0,1.038,12.527,345,3,0,3,342,263,79,0,0.0,0.0
1007,616,24-09-2019 08:10:00,1,2480.0,2496.0,1.006,12.536,289,2,0,2,287,203,84,0,0.0,0.0
1007,617,24-09-2019 08:12:00,1,2402.0,2334.0,0.971,12.048,304,43,30,13,261,188,73,0,0.0,0.0
1007,618,24-09-2019 08:14:00,1,2444.5,2404.5,0.983,12.293,267,8,0,8,259,175,84,0,0.0,0.0
1007,619,24-09-2019 08:16:00,1,2487.0,2475.0,0.995,12.538,219,4,0,4,215,133,82,0,0.0,0.0
1007,620,24-09-2019 08:18:00,1,2496.0,2472.0,0.99,12.569,260,0,0,0,260,174,86,0,0.0,0.0
1007,621,24-09-2019 08:20:00,1,2515.0,2387.0,0.949,12.551,245,1,0,1,244,165,79,0,0.0,0.0
1007,622,24-09-2019 08:22:00,1,2521.0,2399.0,0.952,12.588,242,0,0,0,242,175,67,0,0.0,0.0
1007,623,24-09-2019 08:24:00,1,2501.0,2442.0,0.976,12.558,291,1,0,1,290,202,88,0,0.0,0.0
1007,624,24-09-2019 08:26:00,1,2496.0,2443.0,0.979,12.539,291,1,0,1,290,209,81,0,0.0,0.0
1007,625,24-09-2019 08:28:00,1,2484.0,2481.0,0.999,12.534,305,2,0,2,303,223,80,0,0.0,0.0
1007,626,24-09-2019 08:30:00,1,2501.0,2423.0,0.969,12.535,333,50,36,14,283,199,84,0,0.0,0.0
1007,627,24-09-2019 08:32:00,1,2682.0,2703.0,1.008,13.558,325,97,70,27,228,165,63,33,0.0,0.0
1007,628,24-09-2019 08:34:00,1,2739.0,2955.0,1.079,14.063,305,126,86,40,179,135,44,3,0.0,0.0
1007,629,24-09-2019 08:36:00,1,2855.0,3006.0,1.053,14.577,415,147,111,36,268,205,63,23,0.0,0.0
1007,630,24-09-2019 08:38:00,1,2949.0,3082.0,1.045,15.03,57,15,11,4,42,3,39,0,0.0,0.0
1007,631,24-09-2019 08:40:00,1,2790.0,2777.0,0.995,14.065,37,4,1,3,33,0,33,0,0.0,0.0
1007,632,24-09-2019 08:42:00,1,2692.0,2644.0,0.982,13.534,38,3,2,1,35,0,35,0,0.0,0.0
1007,633,24-09-2019 08:44:00,1,2476.0,2570.0,1.038,12.599,105,3,0,3,102,53,49,0,0.0,0.0
1007,634,24-09-2019 08:46:00,1,2820.0,2635.0,0.934,14.03,186,3,0,3,183,136,47,0,0.0,0.0
1007,635,24-09-2019 08:48:00,1,2758.0,2635.0,0.9555,13.7845,227,5,0,5,222,208,14,0,0.0,0.0
1007,636,24-09-2019 08:50:00,1,2696.0,2635.0,0.977,13.539,61,2,0,2,59,17,42,0,0.0,0.0
1007,637,24-09-2019 08:52:00,1,2703.0,2631.0,0.973,13.563,34,3,0,3,31,13,18,0,0.0,0.0
1007,638,24-09-2019 08:54:00,1,2460.0,2564.0,1.042,12.532,7,4,0,4,3,2,1,0,0.0,0.0
1007,639,24-09-2019 08:56:00,1,2479.0,2517.0,1.015,12.556,61,6,1,5,55,40,15,0,0.0,0.0
1007,640,24-09-2019 08:58:00,1,2487.0,2511.0,1.01,12.578,239,2,1,1,237,157,80,0,0.0,0.0
1007,641,24-09-2019 09:00:00,1,2484.0,2491.0,1.003,12.546,170,1,1,0,169,107,62,0,0.0,0.0
1007,642,24-09-2019 09:02:00,1,2506.0,2392.0,0.954,12.522,108,1,0,1,107,53,54,0,0.0,0.0
1007,643,24-09-2019 09:04:00,1,2309.0,2224.0,0.963,11.559,215,38,15,23,177,126,51,0,0.0,0.0
1007,644,24-09-2019 09:06:00,1,2492.0,2481.0,0.996,12.565,48,3,2,1,45,2,43,0,0.0,0.0
1007,645,24-09-2019 09:08:00,1,2391.0,2381.0,0.996,12.056,44,0,0,0,44,0,44,0,0.0,0.0
1007,646,24-09-2019 09:10:00,1,2281.0,2288.0,1.003,11.518,93,7,2,5,86,41,45,0,0.0,0.0
1007,647,24-09-2019 09:12:00,1,2506.0,2407.0,0.961,12.537,89,0,0,0,89,39,50,0,0.0,0.0
1007,648,24-09-2019 09:14:00,1,2487.0,2455.0,0.987,12.518,122,1,0,1,121,63,58,0,0.0,0.0
1007,649,24-09-2019 09:16:00,1,2490.0,2446.0,0.982,12.518,101,0,0,0,101,58,43,0,0.0,0.0
1007,650,24-09-2019 09:18:00,1,2517.0,2400.0,0.953,12.573,93,3,0,3,90,42,48,0,0.0,0.0
1007,651,24-09-2019 09:20:00,1,2271.0,2358.0,1.038,11.558,62,1,1,0,61,19,42,0,0.0,0.0
1007,652,24-09-2019 09:22:00,1,2370.5,2450.0,1.0335,12.053,69,2,0,2,67,25,42,0,0.0,0.0
1007,653,24-09-2019 09:24:00,1,2470.0,2542.0,1.029,12.548,44,0,0,0,44,0,44,0,0.0,0.0
1007,654,24-09-2019 09:26:00,1,2485.0,2502.0,1.007,12.56,72,7,5,2,65,24,41,0,0.0,0.0
1007,655,24-09-2019 09:28:00,1,2464.0,2548.0,1.034,12.53,47,0,0,0,47,7,40,0,0.0,0.0
1007,656,24-09-2019 09:30:00,1,2475.0,2518.0,1.018,12.54,77,8,6,2,69,28,41,0,0.0,0.0
1007,657,24-09-2019 09:32:00,1,2279.0,2325.0,1.021,11.552,40,0,0,0,40,0,40,0,0.0,0.0
1007,658,24-09-2019 09:34:00,1,2302.0,2228.0,0.968,11.537,51,3,1,2,48,12,36,0,0.0,0.0
1007,659,24-09-2019 09:36:00,1,2279.0,2327.0,1.021,11.553,54,1,0,1,53,8,45,0,0.0,0.0
1007,660,24-09-2019 09:38:00,1,2265.0,2358.0,1.041,11.532,210,90,47,43,120,61,59,0,0.0,0.0
1007,661,24-09-2019 09:40:00,1,2800.0,2732.0,0.975,14.057,235,47,24,23,188,131,57,52,0.0,0.0
1007,662,24-09-2019 09:42:00,1,2978.0,3038.0,1.02,15.099,282,40,12,28,242,157,85,52,0.0,0.0
1007,663,24-09-2019 09:44:00,1,2939.0,3176.0,1.081,15.094,273,37,14,23,236,172,64,54,0.0,0.0
1007,664,24-09-2019 09:46:00,1,3259.0,3351.0,1.028,16.552,251,20,4,16,231,157,74,29,0.0,0.02
1007,665,24-09-2019 09:48:00,1,3491.0,3460.0,0.991,17.585,173,21,7,14,152,92,60,25,0.0,0.29
1007,666,24-09-2019 09:50:00,1,3492.0,3450.0,0.988,17.577,67,16,0,16,51,12,39,0,0.0,0.01
1007,667,24-09-2019 09:52:00,1,3479.0,3495.0,1.005,17.577,61,14,0,14,47,2,45,0,0.0,0.0
1007,668,24-09-2019 09:54:00,1,3478.0,3466.0,0.996,17.541,267,72,53,19,195,141,54,11,0.08,0.01
1007,669,24-09-2019 09:56:00,1,3369.5,3415.5,1.014,17.058,469,176,129,47,293,230,63,70,0.06,0.01
1007,670,24-09-2019 09:58:00,1,3261.0,3365.0,1.032,16.575,494,224,174,50,270,194,76,41,0.01,0.0
1007,671,24-09-2019 10:00:00,1,2970.0,2996.0,1.009,15.017,499,168,121,47,331,262,69,19,0.11,0.0
1007,672,24-09-2019 10:02:00,1,3389.0,3378.0,0.997,17.092,545,221,178,43,324,237,87,33,0.07,0.0
1007,673,24-09-2019 10:04:00,1,3477.0,3476.0,1.0,17.549,549,185,134,51,364,286,78,12,0.0,0.0
1007,674,24-09-2019 10:06:00,1,3468.0,3505.0,1.01,17.545,414,147,109,38,267,204,63,7,0.0,0.0
1007,675,24-09-2019 10:08:00,1,3386.0,3371.0,0.995,17.072,141,45,24,21,96,45,51,0,0.0,0.0
1007,676,24-09-2019 10:10:00,1,3488.0,3463.0,0.993,17.575,146,44,13,31,102,61,41,0,0.0,0.0
1007,677,24-09-2019 10:12:00,1,3482.0,3495.0,1.004,17.586,178,55,24,31,123,69,54,0,0.0,0.0
1007,678,24-09-2019 10:14:00,1,3481.0,3476.0,0.999,17.563,733,250,202,48,483,392,91,5,0.0,0.0
1007,679,24-09-2019 10:16:00,1,3679.0,3655.0,0.994,18.54,991,290,220,70,701,606,95,5,0.0,0.0
1007,680,24-09-2019 10:18:00,1,3455.0,3588.0,1.039,17.585,746,284,229,55,462,377,85,25,0.03,0.0
1007,681,24-09-2019 10:20:00,1,3805.0,3677.0,0.966,19.063,820,256,197,59,564,457,107,5,0.0,0.0
1007,682,24-09-2019 10:22:00,1,3460.0,3556.0,1.028,17.568,720,200,149,51,520,435,85,3,0.0,0.0
1007,683,24-09-2019 10:24:00,1,3488.0,3513.0,1.007,17.633,549,67,37,30,482,401,81,3,0.01,0.0
1007,684,24-09-2019 10:26:00,1,3498.0,3433.0,0.981,17.582,216,29,12,17,187,134,53,0,0.0,0.0
1007,685,24-09-2019 10:28:00,1,3510.0,3358.0,0.957,17.545,326,0,0,0,326,263,63,0,0.0,0.0
1007,686,24-09-2019 10:30:00,1,3245.5,3154.5,0.9735,16.2785,336,120,109,11,216,175,41,0,0.0,0.0
1007,687,24-09-2019 10:32:00,1,2981.0,2951.0,0.99,15.012,627,10,4,6,617,561,56,0,0.0,0.0
1007,688,24-09-2019 10:34:00,1,3013.0,2865.0,0.951,15.044,941,23,1,22,918,842,76,0,0.01,0.0
1007,689,24-09-2019 10:36:00,1,2791.0,2765.0,0.991,14.056,547,19,1,18,528,440,88,0,0.0,0.0
1007,690,24-09-2019 10:38:00,1,2805.0,2675.0,0.954,14.011,336,1,0,1,335,252,83,0,0.0,0.0
1007,691,24-09-2019 10:40:00,1,2837.0,2607.0,0.919,14.064,771,5,0,5,766,670,96,0,0.0,0.0
1007,692,24-09-2019 10:42:00,1,2594.0,2539.0,0.979,13.032,493,10,0,10,483,423,60,0,0.0,0.0
1007,693,24-09-2019 10:44:00,1,2488.0,2490.0,1.001,12.56,317,21,0,21,296,254,42,0,0.0,0.0
1007,694,24-09-2019 10:46:00,1,2500.0,2416.0,0.966,12.524,686,0,0,0,686,612,74,0,0.0,0.0
1007,695,24-09-2019 10:48:00,1,2522.0,2388.0,0.947,12.582,629,9,0,9,620,541,79,0,0.0,0.0
1007,696,24-09-2019 10:50:00,1,2515.0,2389.0,0.95,12.553,340,16,7,9,324,246,78,0,0.0,0.0
1007,697,24-09-2019 10:52:00,1,2283.0,2313.0,1.013,11.557,306,6,1,5,300,213,87,0,0.0,0.0
1007,698,24-09-2019 10:54:00,1,2294.0,2257.0,0.984,11.536,411,16,2,14,395,297,98,0,0.0,0.0
1007,699,24-09-2019 10:56:00,1,2290.0,2240.0,0.978,11.502,452,12,3,9,440,345,95,0,0.0,0.0
1007,700,24-09-2019 10:58:00,1,2294.0,2254.0,0.983,11.532,445,10,1,9,435,366,69,0,0.01,0.0
1007,701,24-09-2019 11:00:00,1,2409.0,2335.0,0.969,12.077,503,12,5,7,491,415,76,0,0.0,0.0
1007,702,24-09-2019 11:02:00,1,2278.0,2320.0,1.019,11.543,378,3,0,3,375,288,87,0,0.0,0.0
1007,703,24-09-2019 11:04:00,1,2393.5,2366.0,0.99,12.05,483,19,6,13,464,370,94,0,0.0,0.0
1007,704,24-09-2019 11:06:00,1,2509.0,2412.0,0.961,12.557,300,6,2,4,294,201,93,0,0.0,0.0
1007,705,24-09-2019 11:08:00,1,2518.0,2394.0,0.951,12.572,231,1,0,1,230,142,88,0,0.0,0.0
1007,706,24-09-2019 11:10:00,1,2497.0,2428.0,0.972,12.526,241,7,2,5,234,158,76,0,0.0,0.0
1007,707,24-09-2019 11:12:00,1,2492.0,2444.0,0.98,12.525,276,10,3,7,266,186,80,0,0.0,0.0
1007,708,24-09-2019 11:14:00,1,2482.0,2482.0,1.0,12.528,695,337,308,29,358,300,58,0,0.0,0.0
1007,709,24-09-2019 11:16:00,1,2485.0,2458.0,0.989,12.511,174,0,0,0,174,129,45,0,0.0,0.0
1007,710,24-09-2019 11:18:00,1,2484.0,2462.0,0.991,12.513,350,0,0,0,350,294,56,0,0.0,0.0
1007,711,24-09-2019 11:20:00,1,2493.0,2492.0,1.0,12.579,848,0,0,0,848,780,68,0,0.0,0.0
1007,712,24-09-2019 11:22:00,1,2484.0,2478.0,0.997,12.53,276,10,2,8,266,208,58,0,0.0,0.0
1007,713,24-09-2019 11:24:00,1,2506.0,2446.0,0.976,12.58,220,1,0,1,219,195,24,0,0.0,0.0
1007,714,24-09-2019 11:26:00,1,2507.0,2392.0,0.954,12.526,719,10,4,6,709,651,58,0,0.0,0.0
1007,715,24-09-2019 11:28:00,1,2496.0,2441.0,0.978,12.536,326,15,10,5,311,227,84,0,0.0,0.0
1007,716,24-09-2019 11:30:00,1,2275.0,2348.0,1.032,11.563,463,7,3,4,456,357,99,0,0.0,0.0
1007,717,24-09-2019 11:32:00,1,2281.0,2321.0,1.018,11.558,280,6,4,2,274,193,81,0,0.0,0.0
1007,718,24-09-2019 11:34:00,1,2284.0,2310.0,1.012,11.557,301,15,8,7,286,206,80,0,0.0,0.0
1007,719,24-09-2019 11:36:00,1,2403.0,2343.0,0.975,12.062,486,18,5,13,468,389,79,0,0.0,0.0
1007,720,24-09-2019 11:38:00,1,2448.0,2418.0,0.9875,12.321,378,72,50,22,306,219,87,4,0.0,0.0
1007,721,24-09-2019 11:40:00,1,2493.0,2493.0,1.0,12.58,505,117,75,42,388,297,91,8,0.0,0.0
1007,722,24-09-2019 11:42:00,1,2771.0,2830.0,1.021,14.051,574,144,94,50,430,323,107,1,0.0,0.0
1007,723,24-09-2019 11:44:00,1,2758.0,2887.0,1.046,14.064,720,247,206,41,473,389,84,36,0.0,0.01
1007,724,24-09-2019 11:46:00,1,2868.0,2961.0,1.033,14.576,739,261,203,58,478,386,92,14,0.0,0.01
1007,725,24-09-2019 11:48:00,1,2960.0,3088.0,1.043,15.082,553,172,132,40,381,304,77,53,0.0,0.01
1007,726,24-09-2019 11:50:00,1,3058.0,3165.0,1.035,15.553,643,267,207,60,376,291,85,29,0.0,0.0
1007,727,24-09-2019 11:52:00,1,3066.0,3155.0,1.029,15.572,1016,306,237,69,710,600,110,0,0.0,0.02
1007,728,24-09-2019 11:54:00,1,2957.0,3107.0,1.051,15.091,1063,426,355,71,637,530,107,19,0.0,0.0
1007,729,24-09-2019 11:56:00,1,2951.0,3109.0,1.054,15.067,652,226,176,50,426,341,85,10,0.0,0.0
1007,730,24-09-2019 11:58:00,1,3058.0,3168.0,1.036,15.553,195,12,5,7,183,123,60,0,0.0,0.0
1007,731,24-09-2019 12:00:00,1,2967.0,3048.0,1.027,15.063,194,13,3,10,181,119,62,0,0.0,0.0
1007,732,24-09-2019 12:02:00,1,2966.0,3043.0,1.026,15.053,184,26,2,24,158,97,61,0,0.0,0.0
1007,733,24-09-2019 12:04:00,1,2988.0,2961.0,0.991,15.051,258,12,0,12,246,184,62,0,0.0,0.0
1007,734,24-09-2019 12:06:00,1,2995.0,2935.0,0.98,15.051,230,27,0,27,203,130,73,0,0.0,0.0
1007,735,24-09-2019 12:08:00,1,2970.0,3014.0,1.015,15.038,257,41,17,24,216,158,58,0,0.0,0.0
1007,736,24-09-2019 12:10:00,1,3312.0,3195.0,0.965,16.587,649,270,207,63,379,292,87,2,0.0,0.0
1007,737,24-09-2019 12:12:00,1,3140.5,3120.5,0.9955,15.829,500,188,152,36,312,237,75,11,0.0,0.0
1007,738,24-09-2019 12:14:00,1,2969.0,3046.0,1.026,15.071,48,0,0,0,48,4,44,0,0.0,0.0
1007,739,24-09-2019 12:16:00,1,3016.0,2848.0,0.944,15.035,143,32,15,17,111,65,46,0,0.0,0.0
1007,740,24-09-2019 12:18:00,1,2796.0,2772.0,0.991,14.084,164,36,3,33,128,77,51,0,0.0,0.0
1007,741,24-09-2019 12:20:00,1,2813.0,2685.0,0.955,14.054,376,7,2,5,369,330,39,0,0.0,0.0
1007,742,24-09-2019 12:22:00,1,2840.0,2580.0,0.909,14.045,302,12,2,10,290,242,48,0,0.0,0.0
1007,743,24-09-2019 12:24:00,1,2494.0,2455.0,0.985,12.543,367,44,24,20,323,251,72,0,0.0,0.0
1007,744,24-09-2019 12:26:00,1,2517.0,2364.0,0.939,12.536,373,22,9,13,351,268,83,0,0.0,0.0
1007,745,24-09-2019 12:28:00,1,2545.0,2282.0,0.897,12.556,361,23,11,12,338,280,58,0,0.0,0.0
1007,746,24-09-2019 12:30:00,1,2310.0,2197.0,0.951,11.534,460,0,0,0,460,418,42,0,0.0,0.0
1007,747,24-09-2019 12:32:00,1,2221.0,2068.0,0.931,11.039,513,1,0,1,512,467,45,0,0.0,0.0
1007,748,24-09-2019 12:34:00,1,2218.0,2059.0,0.928,11.018,799,14,0,14,785,741,44,0,0.0,0.0
1007,749,24-09-2019 12:36:00,1,2340.0,2093.0,0.895,11.536,748,4,0,4,744,696,48,0,0.0,0.0
1007,750,24-09-2019 12:38:00,1,2427.0,2232.0,0.92,12.035,520,0,0,0,520,474,46,0,0.0,0.0
1007,751,24-09-2019 12:40:00,1,2420.0,2265.0,0.936,12.042,434,2,0,2,432,395,37,0,0.0,0.0
1007,752,24-09-2019 12:42:00,1,2422.0,2289.0,0.945,12.076,562,2,0,2,560,518,42,0,0.01,0.0
1007,753,24-09-2019 12:44:00,1,2536.0,2296.0,0.905,12.532,394,0,0,0,394,333,61,0,0.0,0.0
1007,754,24-09-2019 12:46:00,1,2417.5,2276.0,0.943,12.044,721,4,2,2,717,643,74,0,0.0,0.0
1007,755,24-09-2019 12:48:00,1,2299.0,2256.0,0.981,11.556,531,0,0,0,531,454,77,0,0.0,0.0
1007,756,24-09-2019 12:50:00,1,2315.0,2224.0,0.961,11.582,440,0,0,0,440,361,79,0,0.0,0.0
1007,757,24-09-2019 12:52:00,1,2312.0,2185.0,0.945,11.526,354,0,0,0,354,281,73,0,0.0,0.0
1007,758,24-09-2019 12:54:00,1,2316.0,2182.0,0.942,11.543,623,1,1,0,622,585,37,0,0.0,0.0
1007,759,24-09-2019 12:56:00,1,2300.0,2241.0,0.974,11.544,511,0,0,0,511,417,94,0,0.0,0.0
1007,760,24-09-2019 12:58:00,1,2424.0,2262.0,0.933,12.056,808,16,8,8,792,737,55,0,0.0,0.0
1007,761,24-09-2019 13:00:00,1,2311.0,2208.0,0.955,11.551,522,18,11,7,504,466,38,0,0.0,0.0
1007,762,24-09-2019 13:02:00,1,2419.0,2261.0,0.935,12.033,208,3,1,2,205,182,23,0,0.0,0.0
1007,763,24-09-2019 13:04:00,1,2310.0,2226.0,0.964,11.566,383,17,7,10,366,314,52,0,0.0,0.0
1007,764,24-09-2019 13:06:00,1,2541.0,2282.0,0.898,12.539,639,55,29,26,584,520,64,0,0.0,0.0
1007,765,24-09-2019 13:08:00,1,2620.0,2476.0,0.945,13.065,158,47,22,25,111,61,50,0,0.0,0.0
1007,766,24-09-2019 13:10:00,1,2729.0,2531.0,0.927,13.554,175,32,6,26,143,103,40,0,0.0,0.0
1007,767,24-09-2019 13:12:00,1,2816.0,2706.0,0.961,14.091,495,71,34,37,424,354,70,0,0.0,0.0
1007,768,24-09-2019 13:14:00,1,2799.0,2776.0,0.992,14.102,660,188,143,45,472,383,89,11,0.0,0.0
1007,769,24-09-2019 13:16:00,1,2782.0,2792.0,1.004,14.051,402,26,11,15,376,320,56,0,0.0,0.0
1007,770,24-09-2019 13:18:00,1,3016.0,2838.0,0.941,15.024,222,30,12,18,192,136,56,0,0.0,0.0
1007,771,24-09-2019 13:20:00,1,2816.0,2649.5,0.941,14.027,117,1,0,1,116,63,53,0,0.0,0.0
1007,772,24-09-2019 13:22:00,1,2616.0,2461.0,0.941,13.03,114,2,1,1,112,66,46,0,0.0,0.0
1007,773,24-09-2019 13:24:00,1,2516.0,2346.0,0.932,12.512,90,1,0,1,89,46,43,0,0.0,0.0
1007,774,24-09-2019 13:26:00,1,2544.0,2274.0,0.894,12.541,180,8,5,3,172,135,37,0,0.0,0.0
1007,775,24-09-2019 13:28:00,1,2541.0,2283.0,0.898,12.538,507,0,0,0,507,449,58,0,0.0,0.0
1007,776,24-09-2019 13:30:00,1,2534.0,2300.0,0.908,12.532,494,6,1,5,488,445,43,0,0.0,0.0
1007,777,24-09-2019 13:32:00,1,2549.0,2237.0,0.878,12.52,208,3,1,2,205,157,48,0,0.0,0.0
1007,778,24-09-2019 13:34:00,1,2316.0,2172.0,0.938,11.531,40,0,0,0,40,2,38,0,0.0,0.0
1007,779,24-09-2019 13:36:00,1,2341.0,2056.0,0.878,11.501,688,3,2,1,685,637,48,0,0.0,0.0
1007,780,24-09-2019 13:38:00,1,2343.0,2073.0,0.885,11.525,531,1,0,1,530,491,39,0,0.0,0.0
1007,781,24-09-2019 13:40:00,1,2338.0,2093.0,0.896,11.527,117,0,0,0,117,101,16,0,0.0,0.0
1007,782,24-09-2019 13:42:00,1,2332.0,2130.0,0.914,11.545,1093,3,2,1,1090,1047,43,0,0.0,0.0
1007,783,24-09-2019 13:44:00,1,2325.0,2131.0,0.917,11.522,707,2,0,2,705,664,41,0,0.0,0.0
1007,784,24-09-2019 13:46:00,1,2323.0,2148.0,0.925,11.532,92,0,0,0,92,74,18,0,0.0,0.0
1007,785,24-09-2019 13:48:00,1,2333.0,2125.0,0.911,11.547,94,1,0,1,93,79,14,0,0.0,0.0
1007,786,24-09-2019 13:50:00,1,2344.0,2091.0,0.892,11.549,102,11,2,9,91,66,25,0,0.0,0.0
1007,787,24-09-2019 13:52:00,1,2325.0,2133.0,0.917,11.523,102,4,2,2,98,44,54,0,0.0,0.0
1007,788,24-09-2019 13:54:00,1,2167.5,2018.0,0.932,10.7745,63,0,0,0,63,21,42,0,0.0,0.0
1007,789,24-09-2019 13:56:00,1,2010.0,1903.0,0.947,10.026,66,0,0,0,66,26,40,0,0.0,0.0
1007,790,24-09-2019 13:58:00,1,2016.0,1869.0,0.927,10.013,116,13,0,13,103,50,53,0,0.0,0.0
1007,791,24-09-2019 14:00:00,1,2118.0,1967.0,0.929,10.522,68,2,0,2,66,26,40,0,0.0,0.0
1007,792,24-09-2019 14:02:00,1,2347.0,2060.0,0.878,11.528,57,0,0,0,57,22,35,0,0.0,0.0
1007,793,24-09-2019 14:04:00,1,2580.0,2125.0,0.824,12.517,174,6,0,6,168,108,60,0,0.0,0.0
1007,794,24-09-2019 14:06:00,1,2587.0,2120.0,0.82,12.54,227,13,0,13,214,142,72,0,0.0,0.0
1007,795,24-09-2019 14:08:00,1,2581.0,2131.0,0.826,12.529,132,0,0,0,132,74,58,0,0.0,0.0
1007,796,24-09-2019 14:10:00,1,2577.0,2137.0,0.829,12.519,69,1,0,1,68,26,42,0,0.0,0.0
1007,797,24-09-2019 14:12:00,1,2576.0,2156.0,0.837,12.537,145,7,4,3,138,89,49,0,0.0,0.0
1007,798,24-09-2019 14:14:00,1,2355.0,2049.0,0.87,11.547,169,0,0,0,169,102,67,0,0.0,0.0
1007,799,24-09-2019 14:16:00,1,2349.0,2052.0,0.873,11.527,240,0,0,0,240,166,74,0,0.0,0.0
1007,800,24-09-2019 14:18:00,1,2592.0,2091.0,0.807,12.529,316,0,0,0,316,274,42,0,0.0,0.0
1007,801,24-09-2019 14:20:00,1,2468.0,2066.0,0.837,12.013,333,0,0,0,333,296,37,0,0.0,0.0
1007,802,24-09-2019 14:22:00,1,2369.0,1986.0,0.838,11.535,429,13,1,12,416,379,37,0,0.0,0.0
1007,803,24-09-2019 14:24:00,1,2352.0,2052.0,0.872,11.538,459,8,3,5,451,397,54,0,0.0,0.0
1007,804,24-09-2019 14:26:00,1,2344.0,2053.0,0.876,11.509,451,2,1,1,449,386,63,0,0.0,0.0
1007,805,24-09-2019 14:28:00,1,2357.0,2019.5,0.857,11.523,310,1,0,1,309,225,84,0,0.0,0.0
1007,806,24-09-2019 14:30:00,1,2370.0,1986.0,0.838,11.537,288,4,0,4,284,217,67,0,0.0,0.0
1007,807,24-09-2019 14:32:00,1,2355.0,2035.0,0.864,11.53,216,22,12,10,194,136,58,0,0.0,0.0
1007,808,24-09-2019 14:34:00,1,2569.0,2175.0,0.847,12.53,97,1,0,1,96,47,49,0,0.0,0.0
1007,809,24-09-2019 14:36:00,1,2573.0,2132.0,0.829,12.497,139,1,0,1,138,86,52,0,0.0,0.0
1007,810,24-09-2019 14:38:00,1,2568.0,2173.0,0.846,12.523,265,0,0,0,265,210,55,0,0.0,0.0
1007,811,24-09-2019 14:40:00,1,2559.0,2192.0,0.857,12.508,370,2,1,1,368,277,91,0,0.0,0.0
1007,812,24-09-2019 14:42:00,1,2589.0,2120.0,0.819,12.549,180,2,0,2,178,118,60,0,0.0,0.0
1007,813,24-09-2019 14:44:00,1,2579.0,2138.0,0.829,12.528,131,7,2,5,124,67,57,0,0.0,0.0
1007,814,24-09-2019 14:46:00,1,2576.0,2150.0,0.835,12.53,106,0,0,0,106,49,57,0,0.0,0.0
1007,815,24-09-2019 14:48:00,1,2570.0,2150.0,0.837,12.506,54,7,3,4,47,13,34,0,0.0,0.0
1007,816,24-09-2019 14:50:00,1,2581.0,2099.0,0.813,12.495,93,4,2,2,89,35,54,0,0.0,0.0
1007,817,24-09-2019 14:52:00,1,2598.0,2075.0,0.799,12.535,72,3,0,3,69,22,47,0,0.0,0.0
1007,818,24-09-2019 14:54:00,1,2590.0,2067.0,0.798,12.492,122,5,2,3,117,63,54,0,0.0,0.0
1007,819,24-09-2019 14:56:00,1,2591.0,2104.0,0.812,12.537,195,0,0,0,195,125,70,0,0.0,0.0
1007,820,24-09-2019 14:58:00,1,2598.0,2072.0,0.797,12.531,256,51,20,31,205,144,61,0,0.0,0.0
1007,821,24-09-2019 15:00:00,1,2862.0,2480.0,0.866,14.022,332,60,29,31,272,183,89,1,0.0,0.0
1007,822,24-09-2019 15:02:00,1,2955.5,2609.0,0.882,14.5335,411,75,43,32,336,264,72,0,0.0,0.0
1007,823,24-09-2019 15:04:00,1,3049.0,2738.0,0.898,15.045,338,82,54,28,256,193,63,27,0.0,0.0
1007,824,24-09-2019 15:06:00,1,3374.0,2927.0,0.867,16.535,214,25,7,18,189,119,70,59,0.0,0.0
1007,825,24-09-2019 15:08:00,1,3464.0,3044.0,0.879,17.019,239,35,7,28,204,122,82,34,0.0,0.0
1007,826,24-09-2019 15:10:00,1,3579.0,3116.0,0.871,17.55,347,103,79,24,244,180,64,48,0.0,0.0
1007,827,24-09-2019 15:12:00,1,3594.0,3089.0,0.86,17.58,351,120,87,33,231,153,78,41,0.01,0.0
1007,828,24-09-2019 15:14:00,1,3561.0,3170.0,0.89,17.541,292,54,30,24,238,165,73,44,0.0,0.0
1007,829,24-09-2019 15:16:00,1,3566.0,3119.0,0.875,17.504,1032,353,286,67,679,558,121,43,0.0,0.0
1007,830,24-09-2019 15:18:00,1,3375.0,2932.0,0.869,16.544,462,119,87,32,343,268,75,10,0.05,0.0
1007,831,24-09-2019 15:20:00,1,3348.0,3038.0,0.907,16.555,715,276,206,70,439,348,91,8,0.0,0.0
1007,832,24-09-2019 15:22:00,1,3032.0,2795.0,0.922,15.042,963,320,257,63,643,520,123,8,0.0,0.01
1007,833,24-09-2019 15:24:00,1,3356.0,2974.0,0.886,16.515,486,131,89,42,355,282,73,26,0.0,0.0
1007,834,24-09-2019 15:26:00,1,3031.0,2838.0,0.936,15.085,61,5,0,5,56,16,40,0,0.0,0.0
1007,835,24-09-2019 15:28:00,1,3051.0,2724.0,0.893,15.035,50,8,0,8,42,8,34,0,0.0,0.0
1007,836,24-09-2019 15:30:00,1,3030.0,2799.0,0.924,15.039,133,24,8,16,109,55,54,0,0.0,0.0
1007,837,24-09-2019 15:32:00,1,3142.0,2886.0,0.918,15.574,223,41,11,30,182,135,47,0,0.0,0.0
1007,838,24-09-2019 15:34:00,1,3264.0,2889.0,0.885,16.059,72,12,3,9,60,13,47,0,0.0,0.0
1007,839,24-09-2019 15:36:00,1,3048.5,2742.5,0.9005,15.048,177,6,0,6,171,123,48,0,0.01,0.0
1007,840,24-09-2019 15:38:00,1,2833.0,2596.0,0.916,14.037,142,0,0,0,142,91,51,0,0.0,0.0
1007,841,24-09-2019 15:40:00,1,2862.0,2470.0,0.863,14.013,56,2,0,2,54,8,46,0,0.0,0.0
1007,842,24-09-2019 15:42:00,1,2885.0,2395.0,0.83,14.016,118,5,0,5,113,62,51,0,0.0,0.0
1007,843,24-09-2019 15:44:00,1,2647.0,2323.0,0.877,13.002,108,17,0,17,91,47,44,0,0.0,0.0
1007,844,24-09-2019 15:46:00,1,2548.0,2246.0,0.881,12.524,59,2,0,2,57,10,47,0,0.0,0.0
1007,845,24-09-2019 15:48:00,1,2653.0,2317.0,0.873,13.019,50,1,0,1,49,13,36,0,0.0,0.0
1007,846,24-09-2019 15:50:00,1,2670.0,2334.0,0.874,13.105,67,0,0,0,67,18,49,0,0.0,0.0
1007,847,24-09-2019 15:52:00,1,2537.0,2289.0,0.902,12.53,62,2,0,2,60,19,41,0,0.0,0.0
1007,848,24-09-2019 15:54:00,1,2547.0,2249.0,0.883,12.526,70,0,0,0,70,19,51,0,0.0,0.0
1007,849,24-09-2019 15:56:00,1,2551.0,2235.0,0.876,12.525,44,0,0,0,44,3,41,0,0.0,0.0
1007,850,24-09-2019 15:58:00,1,2563.0,2230.0,0.87,12.567,39,0,0,0,39,0,39,0,0.0,0.0
1007,851,24-09-2019 16:00:00,1,2566.0,2180.0,0.85,12.522,123,32,14,18,91,54,37,0,0.0,0.0
1007,852,24-09-2019 16:02:00,1,2548.0,2233.0,0.876,12.512,43,0,0,0,43,4,39,0,0.0,0.0
1007,853,24-09-2019 16:04:00,1,2570.0,2172.0,0.845,12.532,38,0,0,0,38,5,33,0,0.0,0.0
1007,854,24-09-2019 16:06:00,1,2570.0,2196.0,0.855,12.556,67,3,2,1,64,16,48,0,0.0,0.0
1007,855,24-09-2019 16:08:00,1,2559.0,2185.0,0.854,12.5,51,0,0,0,51,7,44,0,0.0,0.0
1007,856,24-09-2019 16:10:00,1,2575.5,2141.5,0.8315,12.5185,46,1,1,0,45,4,41,0,0.0,0.0
1007,857,24-09-2019 16:12:00,1,2592.0,2098.0,0.809,12.537,58,0,0,0,58,21,37,0,0.0,0.0
1007,858,24-09-2019 16:14:00,1,2585.0,2108.0,0.815,12.52,44,0,0,0,44,3,41,0,0.0,0.0
1007,859,24-09-2019 16:16:00,1,2596.0,2090.0,0.805,12.541,48,0,0,0,48,0,48,0,0.0,0.0
1007,860,24-09-2019 16:18:00,1,2486.0,2021.0,0.813,12.034,75,10,8,2,65,19,46,0,0.0,0.0
1007,861,24-09-2019 16:20:00,1,2574.0,2156.0,0.837,12.528,46,0,0,0,46,2,44,0,0.0,0.0
1007,862,24-09-2019 16:22:00,1,2576.0,2140.0,0.831,12.519,43,3,1,2,40,0,40,0,0.0,0.0
1007,863,24-09-2019 16:24:00,1,2566.0,2163.0,0.843,12.506,68,3,0,3,65,15,50,0,0.0,0.0
1007,864,24-09-2019 16:26:00,1,2593.0,2100.0,0.81,12.542,102,8,3,5,94,44,50,0,0.0,0.0
1007,865,24-09-2019 16:28:00,1,2588.0,2110.0,0.815,12.535,50,7,0,7,43,2,41,0,0.0,0.0
1007,866,24-09-2019 16:30:00,1,2600.0,2045.0,0.787,12.508,48,2,0,2,46,6,40,0,0.0,0.0
1007,867,24-09-2019 16:32:00,1,2606.0,2033.0,0.78,12.521,68,0,0,0,68,21,47,0,0.0,0.0
1007,868,24-09-2019 16:34:00,1,2359.0,1987.0,0.842,11.492,112,20,6,14,92,48,44,0,0.0,0.0
1007,869,24-09-2019 16:36:00,1,2582.0,2135.0,0.827,12.537,78,13,7,6,65,24,41,0,0.0,0.0
1007,870,24-09-2019 16:38:00,1,2574.0,2129.0,0.827,12.497,40,0,0,0,40,2,38,0,0.0,0.0
1007,871,24-09-2019 16:40:00,1,2601.0,2080.0,0.799,12.552,47,0,0,0,47,4,43,0,0.0,0.0
1007,872,24-09-2019 16:42:00,1,2590.0,2091.0,0.807,12.519,52,0,0,0,52,12,40,0,0.0,0.0
1007,873,24-09-2019 16:44:00,1,2582.0,2120.0,0.821,12.52,58,0,0,0,58,17,41,0,0.0,0.0
1007,874,24-09-2019 16:46:00,1,2574.0,2149.0,0.835,12.521,37,0,0,0,37,2,35,0,0.0,0.0
1007,875,24-09-2019 16:48:00,1,2588.0,2093.0,0.809,12.513,58,0,0,0,58,19,39,0,0.0,0.0
1007,876,24-09-2019 16:50:00,1,2591.0,2084.0,0.804,12.515,127,36,22,14,91,50,41,0,0.0,0.0
1007,877,24-09-2019 16:52:00,1,2889.0,2375.0,0.822,14.014,198,68,31,37,130,81,49,13,0.01,0.0
1007,878,24-09-2019 16:54:00,1,3054.0,2727.0,0.893,15.054,275,38,22,16,237,163,74,10,0.0,0.0
1007,879,24-09-2019 16:56:00,1,3069.0,2656.0,0.865,15.033,146,6,0,6,140,80,60,0,0.0,0.0
1007,880,24-09-2019 16:58:00,1,2876.0,2442.0,0.849,14.035,55,9,4,5,46,4,42,0,0.0,0.0
1007,881,24-09-2019 17:00:00,1,2900.0,2339.0,0.807,14.017,46,6,1,5,40,2,38,0,0.0,0.0
1007,882,24-09-2019 17:02:00,1,2673.0,2243.0,0.839,13.015,56,4,0,4,52,11,41,0,0.0,0.0
1007,883,24-09-2019 17:04:00,1,2571.0,2171.0,0.845,12.532,60,8,1,7,52,11,41,0,0.0,0.0
1007,884,24-09-2019 17:06:00,1,2576.0,2144.0,0.832,12.522,107,6,1,5,101,54,47,0,0.0,0.0
1007,885,24-09-2019 17:08:00,1,2577.0,2169.0,0.842,12.556,159,20,3,17,139,81,58,0,0.0,0.0
1007,886,24-09-2019 17:10:00,1,2784.0,2276.0,0.818,13.489,103,12,0,12,91,37,54,0,0.0,0.0
1007,887,24-09-2019 17:12:00,1,2912.0,2295.0,0.788,14.016,136,30,14,16,106,51,55,0,0.0,0.0
1007,888,24-09-2019 17:14:00,1,2853.0,2530.0,0.887,14.042,114,26,9,17,88,40,48,0,0.0,0.0
1007,889,24-09-2019 17:16:00,1,2845.0,2525.0,0.887,14.005,52,2,1,1,50,13,37,0,0.0,0.0
1007,890,24-09-2019 17:18:00,1,2877.0,2413.5,0.839,14.0065,68,1,0,1,67,31,36,0,0.0,0.0
1007,891,24-09-2019 17:20:00,1,2909.0,2302.0,0.791,14.008,100,10,5,5,90,42,48,0,0.0,0.0
1007,892,24-09-2019 17:22:00,1,2912.0,2299.0,0.789,14.02,94,0,0,0,94,47,47,0,0.0,0.0
1007,893,24-09-2019 17:24:00,1,2565.0,2221.0,0.866,12.566,88,2,1,1,86,36,50,0,0.0,0.0
1007,894,24-09-2019 17:26:00,1,2683.0,2227.0,0.83,13.037,93,31,5,26,62,18,44,0,0.0,0.0
1007,895,24-09-2019 17:28:00,1,2899.0,2345.0,0.809,14.021,116,37,10,27,79,47,32,0,0.0,0.0
1007,896,24-09-2019 17:30:00,1,2870.0,2423.0,0.844,13.99,260,68,37,31,192,134,58,25,0.0,0.0
1007,897,24-09-2019 17:32:00,1,3417.0,2823.0,0.826,16.591,250,82,51,31,168,109,59,63,0.0,0.0
1007,898,24-09-2019 17:34:00,1,3612.0,2990.0,0.828,17.543,292,46,19,27,246,171,75,73,0.0,0.0
1007,899,24-09-2019 17:36:00,1,3816.0,3155.0,0.827,18.53,248,49,23,26,199,126,73,60,0.0,0.0
1007,900,24-09-2019 17:38:00,1,3914.0,3284.0,0.839,19.058,234,31,14,17,203,124,79,63,0.0,0.04
1007,901,24-09-2019 17:40:00,1,3906.0,3328.0,0.852,19.072,382,136,109,27,246,184,62,52,0.0,0.04
1007,902,24-09-2019 17:42:00,1,3499.0,2941.0,0.841,17.042,297,95,58,37,202,141,61,41,0.01,0.0
1007,903,24-09-2019 17:44:00,1,3922.0,3206.0,0.818,19.002,269,35,20,15,234,154,80,60,0.0,0.05
1007,904,24-09-2019 17:46:00,1,3811.0,3211.0,0.843,18.57,247,28,10,18,219,148,71,52,0.0,0.01
1007,905,24-09-2019 17:48:00,1,3895.0,3374.0,0.866,19.083,261,33,7,26,228,147,81,46,0.0,0.17
1007,906,24-09-2019 17:50:00,1,3894.0,3318.0,0.852,19.017,306,58,30,28,248,175,73,27,0.1,0.06
1007,907,24-09-2019 17:52:00,1,3401.5,2827.5,0.8275,16.5335,190,19,5,14,171,102,69,0,0.0,0.0
1007,908,24-09-2019 17:54:00,1,2909.0,2337.0,0.803,14.05,279,34,14,20,245,178,67,0,0.0,0.0
1007,909,24-09-2019 17:56:00,1,3091.0,2590.0,0.838,15.045,131,40,17,23,91,48,43,0,0.0,0.0
1007,910,24-09-2019 17:58:00,1,2970.0,2531.0,0.852,14.503,41,0,0,0,41,6,35,0,0.0,0.0
1007,911,24-09-2019 18:00:00,0,3401.0,2845.0,0.837,16.548,45,1,1,0,44,6,38,0,0.0,0.0
1007,912,24-09-2019 18:02:00,0,3677.0,3214.0,0.874,18.047,360,127,103,24,233,163,70,17,0.0,0.0
1007,913,24-09-2019 18:04:00,0,4068.0,3649.0,0.897,20.068,358,128,91,37,230,168,62,46,0.0,0.0
1007,914,24-09-2019 18:06:00,0,4133.0,3827.0,0.926,20.521,505,201,154,47,304,239,65,102,0.01,0.0
1007,915,24-09-2019 18:08:00,0,4046.0,3746.0,0.926,20.089,549,168,120,48,381,297,84,22,0.09,0.0
1007,916,24-09-2019 18:10:00,0,4239.0,3924.0,0.926,21.047,416,184,145,39,232,173,59,86,0.0,0.0
1007,917,24-09-2019 18:12:00,0,4039.0,3698.0,0.916,20.006,354,125,90,35,229,175,54,64,0.0,0.0
1007,918,24-09-2019 18:14:00,0,4040.0,3727.0,0.923,20.046,224,86,51,35,138,85,53,4,0.0,0.0
1007,919,24-09-2019 18:16:00,0,4032.0,3778.0,0.937,20.067,277,43,16,27,234,166,68,0,0.0,0.0
1007,920,24-09-2019 18:18:00,0,4027.0,3798.0,0.943,20.072,72,15,1,14,57,20,37,0,0.0,0.0
1007,921,24-09-2019 18:20:00,0,4044.0,3746.0,0.926,20.08,31,1,0,1,30,0,30,0,0.0,0.0
1007,922,24-09-2019 18:22:00,0,3843.0,3554.0,0.925,19.078,119,0,0,0,119,65,54,0,0.0,0.0
1007,923,24-09-2019 18:24:00,0,3637.0,3386.0,0.931,18.076,51,1,0,1,50,15,35,0,0.0,0.0
1007,924,24-09-2019 18:26:00,0,3485.5,3236.5,0.9285,17.3155,162,3,0,3,159,101,58,0,0.0,0.0
1007,925,24-09-2019 18:28:00,0,3334.0,3087.0,0.926,16.555,153,11,2,9,142,83,59,0,0.0,0.0
1007,926,24-09-2019 18:30:00,0,3356.0,3016.0,0.899,16.563,100,3,1,2,97,43,54,0,0.0,0.0
1007,927,24-09-2019 18:32:00,0,3341.0,3040.0,0.91,16.528,50,6,2,4,44,3,41,0,0.0,0.0
1007,928,24-09-2019 18:34:00,0,3230.0,3022.0,0.936,16.07,72,4,1,3,68,21,47,0,0.0,0.0
1007,929,24-09-2019 18:36:00,0,3001.0,2934.0,0.978,15.071,108,5,0,5,103,54,49,0,0.0,0.0
1007,930,24-09-2019 18:38:00,0,3000.0,2895.0,0.965,15.026,229,3,0,3,226,153,73,0,0.0,0.0
1007,931,24-09-2019 18:40:00,0,3020.0,2841.0,0.941,15.042,140,0,0,0,140,76,64,0,0.0,0.0
1007,932,24-09-2019 18:42:00,0,3049.0,2787.0,0.914,15.097,325,95,72,23,230,160,70,38,0.0,0.0
1007,933,24-09-2019 18:44:00,0,3316.0,3109.0,0.938,16.506,415,128,98,30,287,209,78,63,0.0,0.0
1007,934,24-09-2019 18:46:00,0,3517.0,3403.0,0.968,17.627,262,34,10,24,228,157,71,46,0.0,0.0
1007,935,24-09-2019 18:48:00,0,3815.0,3666.0,0.961,19.089,263,34,11,23,229,155,74,58,0.0,0.08
1007,936,24-09-2019 18:50:00,0,3994.0,3851.0,0.964,20.0,239,22,12,10,217,140,77,76,0.0,0.04
1007,937,24-09-2019 18:52:00,0,3954.0,4013.0,1.015,20.023,430,129,93,36,301,223,78,73,0.08,0.09
1007,938,24-09-2019 18:54:00,0,3902.0,3776.0,0.968,19.553,764,264,221,43,500,398,102,59,0.04,0.0
1007,939,24-09-2019 18:56:00,0,3511.0,3375.0,0.961,17.569,461,130,92,38,331,256,75,39,0.0,0.0
1007,940,24-09-2019 18:58:00,0,3612.0,3466.0,0.96,18.071,252,93,68,25,159,102,57,1,0.01,0.0
1007,941,24-09-2019 19:00:00,0,3613.5,3465.0,0.959,18.074,300,105,75,30,195,129,66,5,0.01,0.0
1007,942,24-09-2019 19:02:00,0,3615.0,3464.0,0.958,18.077,349,115,80,35,234,159,75,62,0.0,0.0
1007,943,24-09-2019 19:04:00,0,4293.0,4198.0,0.978,21.562,318,75,46,29,243,160,83,90,0.0,0.0
1007,944,24-09-2019 19:06:00,0,4291.0,4247.0,0.99,21.606,156,22,8,14,134,69,65,21,0.0,0.17
1007,945,24-09-2019 19:08:00,0,3979.0,4019.0,1.01,20.125,204,24,15,9,180,115,65,10,0.0,0.14
1007,946,24-09-2019 19:10:00,0,3993.0,3941.0,0.987,20.097,163,0,0,0,163,99,64,0,0.0,0.01
1007,947,24-09-2019 19:12:00,0,3995.0,3898.0,0.976,20.057,292,68,35,33,224,153,71,6,0.2,0.0
1007,948,24-09-2019 19:14:00,0,4284.0,4259.0,0.994,21.594,425,126,104,22,299,225,74,15,0.0,0.0
1007,949,24-09-2019 19:16:00,0,3844.0,3509.0,0.913,19.029,503,195,141,54,308,225,83,22,0.15,0.0
1007,950,24-09-2019 19:18:00,0,4001.0,3870.0,0.967,20.049,607,208,166,42,399,307,92,28,0.0,0.04
1007,951,24-09-2019 19:20:00,0,4500.0,4331.0,0.962,22.525,660,248,198,50,412,319,93,12,0.07,0.0
1007,952,24-09-2019 19:22:00,0,4041.0,3791.0,0.938,20.12,553,218,151,67,335,253,82,5,0.0,0.0
1007,953,24-09-2019 19:24:00,0,4012.0,3893.0,0.97,20.118,527,204,169,35,323,248,75,13,0.0,0.04
1007,954,24-09-2019 19:26:00,0,4304.0,4169.0,0.969,21.572,436,120,94,26,316,226,90,74,0.0,0.0
1007,955,24-09-2019 19:28:00,0,4507.0,4392.0,0.974,22.619,318,57,29,28,261,181,80,73,0.0,0.0
1007,956,24-09-2019 19:30:00,0,4601.0,4451.0,0.968,23.055,305,78,43,35,227,150,77,72,0.0,0.06
1007,957,24-09-2019 19:32:00,0,4608.0,4469.0,0.97,23.103,294,51,25,26,243,175,68,62,0.0,0.06
1007,958,24-09-2019 19:34:00,0,4513.5,4372.0,0.9685,22.624,287,120,91,29,167,112,55,21,0.09,0.0
1007,959,24-09-2019 19:36:00,0,4419.0,4275.0,0.967,22.145,602,287,227,60,315,239,76,4,0.0,0.0
1007,960,24-09-2019 19:38:00,0,4226.0,4027.0,0.953,21.108,591,185,135,50,406,323,83,5,0.06,0.08
1007,961,24-09-2019 19:40:00,0,4394.0,4258.0,0.969,22.026,256,99,51,48,157,101,56,0,0.0,0.0
1007,962,24-09-2019 19:42:00,0,4307.0,4180.0,0.971,21.597,181,48,17,31,133,84,49,0,0.0,0.0
1007,963,24-09-2019 19:44:00,0,4341.0,4034.0,0.929,21.571,221,63,23,40,158,96,62,0,0.0,0.0
1007,964,24-09-2019 19:46:00,0,4033.0,3801.0,0.943,20.098,237,31,10,21,206,145,61,0,0.0,0.0
1007,965,24-09-2019 19:48:00,0,4097.0,3958.0,0.966,20.525,458,94,62,32,364,281,83,0,0.0,0.0
1007,966,24-09-2019 19:50:00,0,4525.0,4320.0,0.955,22.613,757,260,205,55,497,402,95,18,0.0,0.0
1007,967,24-09-2019 19:52:00,0,4002.0,3940.0,0.984,20.131,562,153,104,49,409,328,81,0,0.08,0.0
1007,968,24-09-2019 19:54:00,0,4097.0,4040.0,0.986,20.615,268,45,27,18,223,150,73,0,0.0,0.0
1007,969,24-09-2019 19:56:00,0,4034.0,3751.0,0.93,20.046,135,0,0,0,135,79,56,0,0.0,0.0
1007,970,24-09-2019 19:58:00,0,3825.0,3613.0,0.945,19.07,298,0,0,0,298,229,69,0,0.0,0.0
1007,971,24-09-2019 20:00:00,0,3857.0,3486.0,0.904,19.057,467,0,0,0,467,401,66,0,0.0,0.0
1007,972,24-09-2019 20:02:00,0,3500.0,3382.0,0.966,17.535,273,5,3,2,268,221,47,0,0.0,0.0
1007,973,24-09-2019 20:04:00,0,3548.0,3236.0,0.912,17.56,386,12,0,12,374,335,39,0,0.0,0.0
1007,974,24-09-2019 20:06:00,0,3311.0,3161.0,0.955,16.542,246,3,3,0,243,211,32,0,0.0,0.0
1007,975,24-09-2019 20:08:00,0,3304.5,3179.0,0.962,16.537,337,1,0,1,336,300,36,0,0.0,0.0
1007,976,24-09-2019 20:10:00,0,3298.0,3197.0,0.969,16.532,416,15,1,14,401,365,36,0,0.0,0.0
1007,977,24-09-2019 20:12:00,0,3216.0,3068.0,0.954,16.068,232,14,4,10,218,177,41,0,0.0,0.0
1007,978,24-09-2019 20:14:00,0,3322.0,3134.0,0.944,16.558,298,1,0,1,297,239,58,0,0.0,0.0
1007,979,24-09-2019 20:16:00,0,2977.0,3000.0,1.008,15.048,98,0,0,0,98,49,49,0,0.0,0.0
1007,980,24-09-2019 20:18:00,0,3001.0,2950.0,0.983,15.089,174,6,3,3,168,104,64,0,0.0,0.0
1007,981,24-09-2019 20:20:00,0,3005.0,2906.0,0.967,15.058,299,11,0,11,288,220,68,0,0.0,0.0
1007,982,24-09-2019 20:22:00,0,2793.0,2776.0,0.994,14.076,240,1,0,1,239,212,27,0,0.0,0.0
1007,983,24-09-2019 20:24:00,0,2797.0,2735.0,0.978,14.046,348,2,1,1,346,303,43,0,0.0,0.0
1007,984,24-09-2019 20:26:00,0,2796.0,2744.0,0.982,14.053,261,0,0,0,261,228,33,0,0.0,0.0
1007,985,24-09-2019 20:28:00,0,2810.0,2742.0,0.976,14.108,327,5,1,4,322,286,36,0,0.0,0.0
1007,986,24-09-2019 20:30:00,0,2789.0,2755.0,0.988,14.04,301,13,3,10,288,253,35,0,0.0,0.0
1007,987,24-09-2019 20:32:00,0,3022.0,2826.0,0.935,15.035,429,77,45,32,352,285,67,1,0.0,0.0
1007,988,24-09-2019 20:34:00,0,3279.0,3281.0,1.001,16.551,324,123,84,39,201,142,59,63,0.0,0.0
1007,989,24-09-2019 20:36:00,0,3455.0,3521.0,1.019,17.51,56,14,4,10,42,8,34,0,0.0,0.0
1007,990,24-09-2019 20:38:00,0,3314.0,3172.0,0.957,16.571,37,0,0,0,37,2,35,0,0.0,0.0
1007,991,24-09-2019 20:40:00,0,2974.0,2990.0,1.006,15.026,52,4,1,3,48,8,40,0,0.0,0.0
1007,992,24-09-2019 20:42:00,0,2974.0,3003.5,1.01,15.041,65,11,0,11,54,11,43,0,0.0,0.0
1007,993,24-09-2019 20:44:00,0,2974.0,3017.0,1.014,15.056,320,38,21,17,282,221,61,0,0.0,0.0
1007,994,24-09-2019 20:46:00,0,3200.0,3120.0,0.975,16.063,178,13,8,5,165,96,69,0,0.0,0.0
1007,995,24-09-2019 20:48:00,0,2970.0,3038.0,1.023,15.064,115,4,2,2,111,60,51,0,0.0,0.0
1007,996,24-09-2019 20:50:00,0,2978.0,3027.0,1.016,15.084,117,22,15,7,95,47,48,0,0.0,0.0
1007,997,24-09-2019 20:52:00,0,2980.0,3001.0,1.007,15.063,40,1,0,1,39,0,39,0,0.0,0.0
1007,998,24-09-2019 20:54:00,0,3012.0,2867.0,0.952,15.039,101,16,4,12,85,45,40,0,0.0,0.0
1007,999,24-09-2019 20:56:00,0,3013.0,2889.0,0.959,15.068,67,2,0,2,65,26,39,0,0.0,0.0
1007,1000,24-09-2019 20:58:00,0,3002.0,2924.0,0.974,15.066,73,9,5,4,64,17,47,0,0.0,0.0
1007,1001,24-09-2019 21:00:00,0,2972.0,2994.0,1.007,15.025,139,5,3,2,134,74,60,0,0.0,0.0
1007,1002,24-09-2019 21:02:00,0,2790.0,2789.0,0.999,14.08,162,17,10,7,145,78,67,0,0.0,0.0
1007,1003,24-09-2019 21:04:00,0,2777.0,2802.0,1.009,14.043,125,2,0,2,123,65,58,0,0.0,0.0
1007,1004,24-09-2019 21:06:00,0,2824.0,2612.0,0.925,14.017,181,34,25,9,147,89,58,0,0.0,0.0
1007,1005,24-09-2019 21:08:00,0,2788.0,2758.0,0.989,14.036,363,91,60,31,272,204,68,68,0.01,0.0
1007,1006,24-09-2019 21:10:00,0,3087.0,3066.0,0.993,15.557,290,61,29,32,229,154,75,4,0.0,0.0
1007,1007,24-09-2019 21:12:00,0,3324.0,3170.0,0.954,16.607,279,52,18,34,227,161,66,0,0.0,0.0
1007,1008,24-09-2019 21:14:00,0,3200.0,3118.0,0.974,16.059,230,28,8,20,202,134,68,0,0.0,0.0
1007,1009,24-09-2019 21:16:00,0,3355.5,3258.0,0.971,16.8265,179,32,12,20,147,90,57,0,0.0,0.0
1007,1010,24-09-2019 21:18:00,0,3511.0,3398.0,0.968,17.594,355,131,99,32,224,147,77,58,0.0,0.0
1007,1011,24-09-2019 21:20:00,0,4021.0,3833.0,0.953,20.086,221,45,24,21,176,116,60,47,0.0,0.0
1007,1012,24-09-2019 21:22:00,0,3959.0,4024.0,1.016,20.052,235,41,21,20,194,128,66,46,0.0,0.09
1007,1013,24-09-2019 21:24:00,0,4072.0,4095.0,1.006,20.578,479,184,145,39,295,220,75,181,0.05,0.03
1007,1014,24-09-2019 21:26:00,0,4022.0,3814.0,0.948,20.07,342,82,50,32,260,195,65,58,0.05,0.0
1007,1015,24-09-2019 21:28:00,0,4310.0,4200.0,0.975,21.629,325,61,37,24,264,188,76,17,0.02,0.05
1007,1016,24-09-2019 21:30:00,0,3909.0,3746.0,0.958,19.549,198,38,14,24,160,100,60,0,0.0,0.0
1007,1017,24-09-2019 21:32:00,0,4033.0,3774.0,0.936,20.067,432,158,121,37,274,212,62,3,0.0,0.05
1007,1018,24-09-2019 21:34:00,0,4008.0,3852.0,0.961,20.057,261,66,33,33,195,128,67,50,0.0,0.06
1007,1019,24-09-2019 21:36:00,0,4307.0,4140.0,0.961,21.553,253,7,5,2,246,164,82,0,0.0,0.0
1007,1020,24-09-2019 21:38:00,0,3909.0,3720.0,0.952,19.52,137,0,0,0,137,88,49,0,0.0,0.0
1007,1021,24-09-2019 21:40:00,0,3499.0,3406.0,0.973,17.558,151,0,0,0,151,86,65,0,0.0,0.0
1007,1022,24-09-2019 21:42:00,0,3547.0,3249.0,0.916,17.572,112,0,0,0,112,67,45,0,0.0,0.0
1007,1023,24-09-2019 21:44:00,0,3324.0,3144.0,0.946,16.576,198,7,2,5,191,113,78,0,0.0,0.0
1007,1024,24-09-2019 21:46:00,0,3316.0,3140.0,0.947,16.541,192,0,0,0,192,119,73,0,0.0,0.0
1007,1025,24-09-2019 21:48:00,0,3350.0,3048.0,0.91,16.575,203,12,6,6,191,113,78,0,0.0,0.0
1007,1026,24-09-2019 21:50:00,0,3326.5,3112.0,0.936,16.5535,108,1,0,1,107,53,54,0,0.0,0.0
1007,1027,24-09-2019 21:52:00,0,3303.0,3176.0,0.962,16.532,90,8,4,4,82,35,47,0,0.0,0.0
1007,1028,24-09-2019 21:54:00,0,3299.0,3214.0,0.975,16.555,161,21,2,19,140,82,58,0,0.0,0.0
1007,1029,24-09-2019 21:56:00,0,3416.0,3257.0,0.954,17.064,278,7,0,7,271,188,83,0,0.0,0.0
1007,1030,24-09-2019 21:58:00,0,3303.0,3210.0,0.972,16.568,190,3,0,3,187,119,68,0,0.0,0.0
1007,1031,24-09-2019 22:00:00,0,3327.0,3134.0,0.942,16.579,251,2,0,2,249,179,70,0,0.0,0.0
1007,1032,24-09-2019 22:02:00,0,3091.0,3049.0,0.986,15.552,353,14,10,4,339,255,84,0,0.0,0.0
1007,1033,24-09-2019 22:04:00,0,3017.0,2812.0,0.932,15.002,372,21,13,8,351,278,73,0,0.0,0.0
1007,1034,24-09-2019 22:06:00,0,2821.0,2615.0,0.927,14.01,359,20,5,15,339,271,68,0,0.0,0.0
1007,1035,24-09-2019 22:08:00,0,2832.0,2600.0,0.918,14.037,335,8,2,6,327,260,67,0,0.0,0.0
1007,1036,24-09-2019 22:10:00,0,2842.0,2572.0,0.905,14.045,252,10,4,6,242,192,50,0,0.0,0.0
1007,1037,24-09-2019 22:12:00,0,2788.0,2783.0,0.998,14.065,230,11,3,8,219,176,43,0,0.0,0.0
1007,1038,24-09-2019 22:14:00,0,3016.0,2845.0,0.943,15.033,362,10,0,10,352,298,54,0,0.0,0.0
1007,1039,24-09-2019 22:16:00,0,3013.0,2883.0,0.957,15.064,543,3,0,3,540,466,74,0,0.0,0.0
1007,1040,24-09-2019 22:18:00,0,2788.0,2793.0,1.002,14.077,428,10,4,6,418,359,59,0,0.0,0.0
1007,1041,24-09-2019 22:20:00,0,2799.0,2769.0,0.989,14.093,293,7,2,5,286,214,72,0,0.0,0.0
1007,1042,24-09-2019 22:22:00,0,3005.0,2907.0,0.967,15.059,487,38,19,19,449,368,81,0,0.0,0.0
1007,1043,24-09-2019 22:24:00,0,2994.5,2938.5,0.981,15.052,396,28,9,19,368,263,105,0,0.0,0.0
1007,1044,24-09-2019 22:26:00,0,2984.0,2970.0,0.995,15.045,549,120,85,35,429,326,103,0,0.0,0.0
1007,1045,24-09-2019 22:28:00,0,3407.0,3290.0,0.966,17.064,297,38,17,21,259,178,81,1,0.0,0.0
1007,1046,24-09-2019 22:30:00,0,3506.0,3392.0,0.968,17.568,354,112,77,35,242,172,70,47,0.0,0.0
1007,1047,24-09-2019 22:32:00,0,3723.0,3523.0,0.946,18.567,293,46,25,21,247,172,75,68,0.0,0.0
1007,1048,24-09-2019 22:34:00,0,3802.0,3660.0,0.963,19.033,241,27,7,20,214,143,71,58,0.0,0.0
1007,1049,24-09-2019 22:36:00,0,4030.0,3773.0,0.936,20.055,328,67,43,24,261,188,73,56,0.0,0.01
1007,1050,24-09-2019 22:38:00,0,3798.0,3701.0,0.974,19.062,303,107,73,34,196,141,55,70,0.12,0.01
1007,1051,24-09-2019 22:40:00,0,3833.0,3613.0,0.943,19.102,332,103,69,34,229,161,68,79,0.0,0.05
1007,1052,24-09-2019 22:42:00,0,3992.0,3895.0,0.976,20.042,317,71,41,30,246,179,67,58,0.0,0.0
1007,1053,24-09-2019 22:44:00,0,4320.0,4122.0,0.954,21.586,265,47,22,25,218,141,77,54,0.0,0.02
1007,1054,24-09-2019 22:46:00,0,4304.0,4140.0,0.962,21.54,364,68,41,27,296,214,82,49,0.08,0.05
1007,1055,24-09-2019 22:48:00,0,3831.0,3632.0,0.948,19.116,481,148,118,30,333,253,80,24,0.0,0.01
1007,1056,24-09-2019 22:50:00,0,3986.0,3919.0,0.983,20.042,402,118,89,29,284,212,72,27,0.09,0.0
1007,1057,24-09-2019 22:52:00,0,3836.0,3583.0,0.934,19.081,269,85,50,35,184,126,58,26,0.0,0.09
1007,1058,24-09-2019 22:54:00,0,4033.0,3756.0,0.931,20.048,304,107,78,29,197,133,64,121,0.0,0.0
1007,1059,24-09-2019 22:56:00,0,4542.0,4301.0,0.947,22.658,268,65,28,37,203,135,68,55,0.0,0.0
1007,1060,24-09-2019 22:58:00,0,4514.0,4378.0,0.97,22.6325,274,69,40,29,205,129,76,47,0.0,0.0
1007,1061,24-09-2019 23:00:00,0,4486.0,4455.0,0.993,22.607,311,118,79,39,193,126,67,23,0.0,0.17
1007,1062,24-09-2019 23:02:00,0,4016.0,3857.0,0.96,20.092,445,170,112,58,275,203,72,4,0.0,0.0
1007,1063,24-09-2019 23:04:00,0,4030.0,3847.0,0.955,20.139,498,246,180,66,252,177,75,23,0.18,0.0
1007,1064,24-09-2019 23:06:00,0,3845.0,3501.0,0.91,19.025,796,364,292,72,432,352,80,23,0.0,0.16
1007,1065,24-09-2019 23:08:00,0,4339.0,4065.0,0.937,21.596,269,80,49,31,189,134,55,5,0.0,0.0
1007,1066,24-09-2019 23:10:00,0,4313.0,4176.0,0.968,21.618,750,294,232,62,456,372,84,42,0.0,0.0
1007,1067,24-09-2019 23:12:00,0,4408.0,4211.0,0.955,22.028,204,43,16,27,161,98,63,41,0.0,0.0
1007,1068,24-09-2019 23:14:00,0,4512.0,4317.0,0.957,22.555,272,42,17,25,230,160,70,57,0.0,0.0
1007,1069,24-09-2019 23:16:00,0,4616.0,4409.0,0.955,23.07,251,74,42,32,177,122,55,65,0.0,0.0
1007,1070,24-09-2019 23:18:00,0,4710.0,4500.0,0.955,23.537,291,64,28,36,227,150,77,53,0.0,0.0
1007,1071,24-09-2019 23:20:00,0,4303.0,4188.0,0.973,21.589,223,37,15,22,186,118,68,71,0.0,0.0
1007,1072,24-09-2019 23:22:00,0,4613.0,4457.0,0.966,23.108,275,34,20,14,241,170,71,43,0.0,0.0
1007,1073,24-09-2019 23:24:00,0,3905.0,3799.0,0.973,19.59,232,80,44,36,152,104,48,0,0.16,0.0
1007,1074,24-09-2019 23:26:00,0,3341.0,3081.0,0.922,16.573,172,78,32,46,94,50,44,0,0.0,0.0
1007,1075,24-09-2019 23:28:00,0,3540.0,3215.0,0.908,17.505,391,174,125,49,217,158,59,3,0.0,0.0
1007,1076,24-09-2019 23:30:00,0,3355.0,3030.0,0.903,16.573,486,205,155,50,281,221,60,13,0.04,0.0
1007,1077,24-09-2019 23:32:00,0,3556.5,3228.0,0.9075,17.5855,94,26,8,18,68,33,35,0,0.0,0.0
1007,1078,24-09-2019 23:34:00,0,3758.0,3426.0,0.912,18.598,87,17,4,13,70,21,49,0,0.0,0.0
1007,1079,24-09-2019 23:36:00,0,4046.0,3740.0,0.924,20.08,150,26,8,18,124,84,40,0,0.0,0.0
1007,1080,24-09-2019 23:38:00,0,4313.0,4160.0,0.965,21.597,153,45,17,28,108,61,47,0,0.0,0.0
1007,1081,24-09-2019 23:40:00,0,4318.0,4154.0,0.962,21.61,150,57,31,26,93,51,42,0,0.0,0.0
1007,1082,24-09-2019 23:42:00,0,4324.0,4087.0,0.945,21.563,38,0,0,0,38,0,38,0,0.0,0.0
1007,1083,24-09-2019 23:44:00,0,4001.0,3866.0,0.966,20.043,39,0,0,0,39,0,39,0,0.0,0.0
1007,1084,24-09-2019 23:46:00,0,4045.0,3736.0,0.924,20.074,40,0,0,0,40,0,40,0,0.0,0.0
1007,1085,24-09-2019 23:48:00,0,3942.0,3655.0,0.927,19.576,103,0,0,0,103,48,55,0,0.0,0.0
1007,1086,24-09-2019 23:50:00,0,3824.0,3593.0,0.94,19.043,196,1,1,0,195,148,47,0,0.0,0.0
1007,1087,24-09-2019 23:52:00,0,3849.0,3517.0,0.914,19.059,301,2,0,2,299,269,30,0,0.0,0.0
1007,1088,24-09-2019 23:54:00,0,3850.0,3494.0,0.907,19.038,367,32,16,16,335,282,53,0,0.0,0.0
1007,1089,24-09-2019 23:56:00,0,3609.0,3469.0,0.961,18.06,333,0,0,0,333,295,38,0,0.0,0.0
1007,1090,24-09-2019 23:58:00,0,3504.0,3364.0,0.96,17.531,346,6,2,4,340,282,58,0,0.0,0.0
1007,1091,25-09-2019 00:00:00,0,3521.0,3343.0,0.95,17.574,431,0,0,0,431,350,81,0,0.0,0.0
1007,1092,25-09-2019 00:02:00,0,3313.0,3226.0,0.974,16.623,243,1,0,1,242,189,53,0,0.0,0.0
1007,1093,25-09-2019 00:04:00,0,3328.0,3106.0,0.933,16.552,324,37,19,18,287,213,74,0,0.0,0.0
1007,1094,25-09-2019 00:06:00,0,3403.0,3290.5,0.966,17.0515,718,237,179,58,481,384,97,63,0.0,0.0
1007,1095,25-09-2019 00:08:00,0,3478.0,3475.0,0.999,17.551,683,232,186,46,451,365,86,83,0.0,0.0
1007,1096,25-09-2019 00:10:00,0,3718.0,3586.0,0.964,18.62,708,248,201,47,460,360,100,117,0.0,0.0
1007,1097,25-09-2019 00:12:00,0,3700.0,3587.0,0.969,18.55,722,288,236,52,434,348,86,126,0.0,0.0
1007,1098,25-09-2019 00:14:00,0,3785.0,3763.0,0.994,19.079,435,131,84,47,304,226,78,92,0.0,0.0
1007,1099,25-09-2019 00:16:00,0,3971.0,3997.0,1.006,20.07,385,140,96,44,245,176,69,76,0.0,0.0
1007,1100,25-09-2019 00:18:00,0,4217.0,4111.0,0.975,21.165,345,88,41,47,257,181,76,58,0.0,0.0
1007,1101,25-09-2019 00:20:00,0,4302.0,4160.0,0.967,21.553,298,59,24,35,239,164,75,60,0.0,0.0
1007,1102,25-09-2019 00:22:00,0,4288.0,4284.0,0.999,21.636,305,58,28,30,247,177,70,67,0.0,0.0
1007,1103,25-09-2019 00:24:00,0,4500.0,4361.0,0.969,22.558,252,58,29,29,194,117,77,47,0.0,0.11
1007,1104,25-09-2019 00:26:00,0,4512.0,4323.0,0.958,22.564,383,120,84,36,263,190,73,35,0.06,0.05
1007,1105,25-09-2019 00:28:00,0,4080.0,4086.0,1.002,20.598,439,161,122,39,278,221,57,27,0.05,0.0
1007,1106,25-09-2019 00:30:00,0,4327.0,4095.0,0.946,21.583,416,166,131,35,250,183,67,33,0.0,0.04
1007,1107,25-09-2019 00:32:00,0,4023.0,3817.0,0.949,20.076,303,71,30,41,232,166,66,51,0.0,0.0
1007,1108,25-09-2019 00:34:00,0,4831.0,4610.0,0.954,24.139,275,52,27,25,223,150,73,68,0.0,0.02
1007,1109,25-09-2019 00:36:00,0,4798.0,4642.0,0.967,24.045,338,54,28,26,284,205,79,28,0.11,0.17
1007,1110,25-09-2019 00:38:00,0,4501.0,4414.0,0.981,22.621,437,199,148,51,238,174,64,27,0.08,0.0
1007,1111,25-09-2019 00:40:00,0,4303.0,4203.5,0.977,21.607,733,226,175,51,507,417,90,29,0.0,0.0
1007,1112,25-09-2019 00:42:00,0,4105.0,3993.0,0.973,20.593,727,179,144,35,548,473,75,14,0.0,0.0
1007,1113,25-09-2019 00:44:00,0,4294.0,4214.0,0.981,21.585,679,203,157,46,476,386,90,6,0.0,0.0
1007,1114,25-09-2019 00:46:00,0,4394.0,4284.0,0.975,22.055,551,161,121,40,390,302,88,23,0.08,0.0
1007,1115,25-09-2019 00:48:00,0,4802.0,4618.0,0.962,24.03,413,187,148,39,226,163,63,23,0.0,0.0
1007,1116,25-09-2019 00:50:00,0,3948.0,3634.0,0.92,19.579,534,122,76,46,412,338,74,47,0.03,0.0
1007,1117,25-09-2019 00:52:00,0,4277.0,4276.0,1.0,21.585,265,23,15,8,242,209,33,0,0.0,0.0
1007,1118,25-09-2019 00:54:00,0,4092.0,3972.0,0.971,20.522,721,218,168,50,503,419,84,0,0.0,0.0
1007,1119,25-09-2019 00:56:00,0,4509.0,4316.0,0.957,22.545,821,346,279,67,475,385,90,13,0.0,0.0
1007,1120,25-09-2019 00:58:00,0,4503.0,4339.0,0.964,22.544,449,166,137,29,283,228,55,117,0.0,0.0
1007,1121,25-09-2019 01:00:00,0,4281.0,4226.0,0.987,21.545,404,34,21,13,370,284,86,22,0.0,0.0
1007,1122,25-09-2019 01:02:00,0,4308.0,4137.0,0.96,21.553,352,38,14,24,314,236,78,0,0.0,0.0
1007,1123,25-09-2019 01:04:00,0,4217.0,4020.0,0.953,21.065,515,103,63,40,412,332,80,1,0.0,0.0
1007,1124,25-09-2019 01:06:00,0,4330.0,4105.0,0.948,21.603,492,184,137,47,308,240,68,43,0.0,0.0
1007,1125,25-09-2019 01:08:00,0,4309.0,4130.0,0.958,21.551,318,96,68,28,222,158,64,1,0.0,0.0
1007,1126,25-09-2019 01:10:00,0,3972.0,3982.0,1.003,20.057,346,35,18,17,311,253,58,0,0.0,0.0
1007,1127,25-09-2019 01:12:00,0,4107.0,4000.0,0.974,20.609,159,35,7,28,124,77,47,2,0.0,0.0
1007,1128,25-09-2019 01:14:00,0,4103.0,4016.0,0.979,20.6105,511,171,134,37,340,263,77,4,0.0,0.0
1007,1129,25-09-2019 01:16:00,0,4099.0,4032.0,0.984,20.612,234,13,3,10,221,173,48,0,0.0,0.0
1007,1130,25-09-2019 01:18:00,0,4117.0,4000.0,0.972,20.648,350,18,0,18,332,258,74,0,0.0,0.0
1007,1131,25-09-2019 01:20:00,0,4039.0,3793.0,0.939,20.112,388,79,39,40,309,241,68,0,0.0,0.0
1007,1132,25-09-2019 01:22:00,0,3991.0,3961.0,0.992,20.109,188,5,0,5,183,132,51,0,0.0,0.0
1007,1133,25-09-2019 01:24:00,0,4014.0,3853.0,0.96,20.082,43,0,0,0,43,4,39,0,0.0,0.0
1007,1134,25-09-2019 01:26:00,0,4040.0,3765.0,0.932,20.086,46,0,0,0,46,2,44,0,0.0,0.0
1007,1135,25-09-2019 01:28:00,0,3836.0,3553.0,0.926,19.049,38,0,0,0,38,0,38,0,0.0,0.0
1007,1136,25-09-2019 01:30:00,0,3621.0,3406.0,0.941,18.037,30,0,0,0,30,0,30,0,0.0,0.0
1007,1137,25-09-2019 01:32:00,0,3535.0,3251.0,0.92,17.525,66,1,1,0,65,11,54,0,0.0,0.0
1007,1138,25-09-2019 01:34:00,0,3310.0,3188.0,0.963,16.572,40,1,0,1,39,0,39,0,0.0,0.0
1007,1139,25-09-2019 01:36:00,0,3339.0,3091.0,0.926,16.578,50,2,0,2,48,10,38,0,0.0,0.0
1007,1140,25-09-2019 01:38:00,0,2987.0,2954.0,0.989,15.038,58,1,0,1,57,11,46,0,0.0,0.0
1007,1141,25-09-2019 01:40:00,0,3007.0,2874.0,0.956,15.028,122,13,6,7,109,61,48,0,0.0,0.0
1007,1142,25-09-2019 01:42:00,0,3018.0,2866.0,0.95,15.063,235,0,0,0,235,161,74,0,0.0,0.0
1007,1143,25-09-2019 01:44:00,0,2800.0,2722.0,0.972,14.045,199,0,0,0,199,127,72,0,0.0,0.0
1007,1144,25-09-2019 01:46:00,0,2827.0,2601.0,0.92,14.02,176,0,0,0,176,110,66,0,0.0,0.0
1007,1145,25-09-2019 01:48:00,0,2834.0,2584.0,0.9115,14.028,77,0,0,0,77,26,51,0,0.0,0.0
1007,1146,25-09-2019 01:50:00,0,2841.0,2567.0,0.903,14.036,87,0,0,0,87,42,45,0,0.0,0.0
1007,1147,25-09-2019 01:52:00,0,2841.0,2570.0,0.905,14.037,76,4,3,1,72,22,50,0,0.0,0.0
1007,1148,25-09-2019 01:54:00,0,2801.0,2708.0,0.967,14.036,57,9,1,8,48,8,40,0,0.0,0.0
1007,1149,25-09-2019 01:56:00,0,2824.0,2667.0,0.945,14.078,54,0,0,0,54,10,44,0,0.0,0.0
1007,1150,25-09-2019 01:58:00,0,2811.0,2672.0,0.951,14.035,44,0,0,0,44,0,44,0,0.0,0.0
1007,1151,25-09-2019 02:00:00,0,2841.0,2550.0,0.898,14.015,43,0,0,0,43,0,43,0,0.0,0.0
1007,1152,25-09-2019 02:02:00,0,2829.0,2628.0,0.929,14.057,51,0,0,0,51,8,43,0,0.0,0.0
1007,1153,25-09-2019 02:04:00,0,2802.0,2692.0,0.961,14.02,53,0,0,0,53,10,43,0,0.0,0.0
1007,1154,25-09-2019 02:06:00,0,2836.0,2642.0,0.931,14.099,194,22,11,11,172,111,61,2,0.0,0.0
1007,1155,25-09-2019 02:08:00,0,2995.0,2925.0,0.976,15.04,409,162,115,47,247,182,65,49,0.0,0.0
1007,1156,25-09-2019 02:10:00,0,3292.0,3241.0,0.984,16.558,529,192,142,50,337,266,71,119,0.0,0.0
1007,1157,25-09-2019 02:12:00,0,3516.0,3384.0,0.962,17.599,466,186,144,42,280,218,62,102,0.0,0.0
1007,1158,25-09-2019 02:14:00,0,3489.0,3434.0,0.984,17.548,578,202,162,40,376,295,81,96,0.0,0.0
1007,1159,25-09-2019 02:16:00,0,3599.0,3505.0,0.974,18.058,405,155,118,37,250,185,65,79,0.0,0.0
1007,1160,25-09-2019 02:18:00,0,3588.0,3512.0,0.979,18.025,322,81,60,21,241,174,67,43,0.0,0.21
1007,1161,25-09-2019 02:20:00,0,3794.0,3733.0,0.984,19.081,164,0,0,0,164,98,66,0,0.0,0.01
1007,1162,25-09-2019 02:22:00,0,3850.5,3741.0,0.972,19.3115,191,0,0,0,191,125,66,0,0.0,0.0
1007,1163,25-09-2019 02:24:00,0,3907.0,3749.0,0.96,19.542,338,111,89,22,227,164,63,10,0.06,0.01
1007,1164,25-09-2019 02:26:00,0,3909.0,3759.0,0.962,19.564,686,292,227,65,394,320,74,5,0.05,0.07
1007,1165,25-09-2019 02:28:00,0,4029.0,3795.0,0.942,20.075,652,293,236,57,359,273,86,15,0.0,0.0
1007,1166,25-09-2019 02:30:00,0,3820.0,3628.0,0.95,19.067,420,188,144,44,232,177,55,53,0.03,0.0
1007,1167,25-09-2019 02:32:00,0,4012.0,3848.0,0.959,20.066,436,127,93,34,309,237,72,77,0.0,0.0
1007,1168,25-09-2019 02:34:00,0,3976.0,3967.0,0.998,20.056,559,233,182,51,326,256,70,7,0.07,0.0
1007,1169,25-09-2019 02:36:00,0,3999.0,3902.0,0.976,20.074,404,127,84,43,277,207,70,43,0.0,0.0
1007,1170,25-09-2019 02:38:00,0,4019.0,3903.0,0.971,20.156,509,135,92,43,374,291,83,3,0.0,0.0
1007,1171,25-09-2019 02:40:00,0,4102.0,3992.0,0.973,20.58,210,27,6,21,183,129,54,0,0.0,0.0
1007,1172,25-09-2019 02:42:00,0,4027.0,3762.0,0.934,20.032,155,27,6,21,128,81,47,0,0.0,0.0
1007,1173,25-09-2019 02:44:00,0,4041.0,3728.0,0.923,20.05,264,21,1,20,243,173,70,0,0.0,0.0
1007,1174,25-09-2019 02:46:00,0,4047.0,3737.0,0.923,20.083,121,18,3,15,103,66,37,0,0.0,0.0
1007,1175,25-09-2019 02:48:00,0,3936.0,3680.0,0.935,19.583,272,82,52,30,190,126,64,0,0.0,0.0
1007,1176,25-09-2019 02:50:00,0,3991.0,3908.0,0.979,20.049,686,159,117,42,527,444,83,19,0.0,0.0
1007,1177,25-09-2019 02:52:00,0,4016.0,3857.0,0.96,20.094,323,117,95,22,206,145,61,7,0.0,0.0
1007,1178,25-09-2019 02:54:00,0,3928.0,3750.0,0.955,19.628,282,64,40,24,218,174,44,3,0.0,0.0
1007,1179,25-09-2019 02:56:00,0,3884.5,3620.0,0.932,19.3135,63,11,1,10,52,10,42,0,0.0,0.0
1007,1180,25-09-2019 02:58:00,0,3841.0,3490.0,0.909,18.999,48,0,0,0,48,0,48,0,0.0,0.0
1007,1181,25-09-2019 03:00:00,0,3514.0,3319.0,0.944,17.518,41,0,0,0,41,0,41,0,0.0,0.0
1007,1182,25-09-2019 03:02:00,0,3554.0,3232.0,0.909,17.58,35,0,0,0,35,0,35,0,0.0,0.0
1007,1183,25-09-2019 03:04:00,0,3320.0,3111.0,0.937,16.524,48,0,0,0,48,0,48,0,0.0,0.0
1007,1184,25-09-2019 03:06:00,0,3342.0,3048.0,0.912,16.543,41,4,0,4,37,0,37,0,0.0,0.0
1007,1185,25-09-2019 03:08:00,0,3223.0,3016.0,0.936,16.037,62,0,0,0,62,20,42,0,0.0,0.0
1007,1186,25-09-2019 03:10:00,0,3000.0,2935.0,0.979,15.068,45,0,0,0,45,0,45,0,0.0,0.0
1007,1187,25-09-2019 03:12:00,0,3033.0,2814.0,0.928,15.063,43,2,0,2,41,6,35,0,0.0,0.0
1007,1188,25-09-2019 03:14:00,0,3042.0,2748.0,0.904,15.027,59,6,0,6,53,12,41,0,0.0,0.0
1007,1189,25-09-2019 03:16:00,0,2806.0,2690.0,0.959,14.032,47,6,2,4,41,4,37,0,0.0,0.0
1007,1190,25-09-2019 03:18:00,0,2807.0,2710.0,0.965,14.058,65,12,0,12,53,0,53,0,0.0,0.0
1007,1191,25-09-2019 03:20:00,0,2802.0,2689.0,0.96,14.016,85,15,6,9,70,19,51,0,0.0,0.0
1007,1192,25-09-2019 03:22:00,0,2813.0,2673.0,0.95,14.043,118,37,18,19,81,43,38,0,0.0,0.0
1007,1193,25-09-2019 03:24:00,0,2803.0,2703.0,0.964,14.036,43,8,0,8,35,0,35,0,0.0,0.0
1007,1194,25-09-2019 03:26:00,0,2823.0,2662.0,0.943,14.071,57,2,1,1,55,10,45,0,0.0,0.0
1007,1195,25-09-2019 03:28:00,0,2811.0,2656.0,0.945,14.014,94,7,2,5,87,39,48,0,0.0,0.0
1007,1196,25-09-2019 03:30:00,0,2803.0,2706.5,0.9655,14.0395,67,14,3,11,53,8,45,0,0.0,0.0
1007,1197,25-09-2019 03:32:00,0,2795.0,2757.0,0.986,14.065,120,14,1,13,106,53,53,0,0.0,0.0
1007,1198,25-09-2019 03:34:00,0,2844.0,2545.0,0.895,14.021,249,32,17,15,217,147,70,0,0.0,0.0
1007,1199,25-09-2019 03:36:00,0,2821.0,2632.0,0.933,14.031,50,3,1,2,47,2,45,0,0.0,0.0
1007,1200,25-09-2019 03:38:00,0,2825.0,2658.0,0.941,14.075,42,10,5,5,32,0,32,0,0.0,0.0
1007,1201,25-09-2019 03:40:00,0,2804.0,2700.0,0.963,14.036,115,10,3,7,105,52,53,0,0.0,0.0
1007,1202,25-09-2019 03:42:00,0,2810.0,2661.0,0.947,14.018,157,0,0,0,157,90,67,0,0.0,0.0
1007,1203,25-09-2019 03:44:00,0,2816.0,2677.0,0.951,14.06,69,0,0,0,69,30,39,0,0.0,0.0
1007,1204,25-09-2019 03:46:00,0,2811.0,2696.0,0.959,14.059,278,81,59,22,197,138,59,2,0.0,0.0
1007,1205,25-09-2019 03:48:00,0,2991.0,2952.0,0.987,15.052,268,77,32,45,191,134,57,22,0.0,0.0
1007,1206,25-09-2019 03:50:00,0,3338.0,3162.0,0.947,16.651,144,37,11,26,107,48,59,76,0.0,0.0
1007,1207,25-09-2019 03:52:00,0,3298.0,3231.0,0.98,16.572,375,102,62,40,273,197,76,19,0.0,0.0
1007,1208,25-09-2019 03:54:00,0,3292.0,3229.0,0.981,16.545,479,160,131,29,319,252,67,75,0.0,0.0
1007,1209,25-09-2019 03:56:00,0,3294.0,3221.0,0.978,16.545,191,4,0,4,187,123,64,0,0.0,0.0
1007,1210,25-09-2019 03:58:00,0,3333.0,3107.0,0.932,16.574,39,0,0,0,39,2,37,0,0.0,0.0
1007,1211,25-09-2019 04:00:00,0,2981.0,2998.0,1.006,15.064,57,4,2,2,53,6,47,0,0.0,0.0
1007,1212,25-09-2019 04:02:00,0,3018.0,2858.0,0.947,15.056,57,1,1,0,56,6,50,0,0.0,0.0
1007,1213,25-09-2019 04:04:00,0,2910.5,2789.0,0.9585,14.5555,67,0,0,0,67,13,54,0,0.0,0.0
1007,1214,25-09-2019 04:06:00,0,2803.0,2720.0,0.97,14.055,55,7,1,6,48,2,46,0,0.0,0.0
1007,1215,25-09-2019 04:08:00,0,2812.0,2695.0,0.959,14.061,127,31,9,22,96,49,47,0,0.0,0.0
1007,1216,25-09-2019 04:10:00,0,2812.0,2656.0,0.945,14.018,43,2,0,2,41,2,39,0,0.0,0.0
1007,1217,25-09-2019 04:12:00,0,2829.0,2639.0,0.933,14.068,56,10,0,10,46,6,40,0,0.0,0.0
1007,1218,25-09-2019 04:14:00,0,2843.0,2603.0,0.916,14.085,134,39,19,20,95,57,38,0,0.0,0.0
1007,1219,25-09-2019 04:16:00,0,3007.0,2897.0,0.963,15.056,123,33,8,25,90,50,40,4,0.0,0.0
1007,1220,25-09-2019 04:18:00,0,3324.0,3150.0,0.948,16.585,510,180,134,46,330,249,81,66,0.0,0.0
1007,1221,25-09-2019 04:20:00,0,3541.0,3236.0,0.914,17.536,252,21,11,10,231,152,79,64,0.0,0.0
1007,1222,25-09-2019 04:22:00,0,3732.0,3466.0,0.929,18.539,259,34,15,19,225,150,75,66,0.0,0.0
1007,1223,25-09-2019 04:24:00,0,3830.0,3533.0,0.923,19.001,203,28,16,12,175,105,70,50,0.0,0.0
1007,1224,25-09-2019 04:26:00,0,3810.0,3681.0,0.966,19.088,241,62,30,32,179,121,58,72,0.0,0.01
1007,1225,25-09-2019 04:28:00,0,3801.0,3676.0,0.967,19.047,353,92,57,35,261,184,77,47,0.11,0.05
1007,1226,25-09-2019 04:30:00,0,4047.0,3724.0,0.92,20.068,350,121,87,34,229,158,71,67,0.0,0.0
1007,1227,25-09-2019 04:32:00,0,3824.0,3576.0,0.935,19.027,515,95,60,35,420,327,93,48,0.07,0.0
1007,1228,25-09-2019 04:34:00,0,4039.0,3715.0,0.92,20.027,329,89,60,29,240,171,69,1,0.0,0.01
1007,1229,25-09-2019 04:36:00,0,3920.0,3725.0,0.95,19.569,365,114,82,32,251,176,75,68,0.0,0.0
1007,1230,25-09-2019 04:38:00,0,3834.5,3580.0,0.933,19.072,430,94,67,27,336,251,85,52,0.08,0.0
1007,1231,25-09-2019 04:40:00,0,3749.0,3435.0,0.916,18.575,302,53,29,24,249,171,78,74,0.0,0.0
1007,1232,25-09-2019 04:42:00,0,4332.0,4021.0,0.928,21.518,255,64,37,27,191,130,61,73,0.0,0.0
1007,1233,25-09-2019 04:44:00,0,4024.0,3857.0,0.958,20.126,205,72,46,26,133,91,42,9,0.0,0.04
1007,1234,25-09-2019 04:46:00,0,3454.0,3112.0,0.901,17.052,256,68,50,18,188,125,63,30,0.0,0.0
1007,1235,25-09-2019 04:48:00,0,4010.0,3801.0,0.948,20.007,671,180,144,36,491,397,94,36,0.06,0.01
1007,1236,25-09-2019 04:50:00,0,4017.0,3847.0,0.958,20.087,417,62,41,21,355,280,75,1,0.09,0.0
1007,1237,25-09-2019 04:52:00,0,3809.0,3602.0,0.946,18.996,396,11,1,10,385,325,60,0,0.0,0.0
1007,1238,25-09-2019 04:54:00,0,4130.0,3945.0,0.955,20.641,311,16,10,6,295,264,31,0,0.0,0.0
1007,1239,25-09-2019 04:56:00,0,3991.0,3892.0,0.975,20.034,642,18,4,14,624,564,60,0,0.0,0.0
1007,1240,25-09-2019 04:58:00,0,4049.0,3689.0,0.911,20.039,561,1,0,1,560,522,38,0,0.0,0.0
1007,1241,25-09-2019 05:00:00,0,3860.0,3479.0,0.901,19.061,392,0,0,0,392,358,34,0,0.0,0.0
1007,1242,25-09-2019 05:02:00,0,3763.0,3349.0,0.89,18.534,524,5,1,4,519,477,42,0,0.0,0.0
1007,1243,25-09-2019 05:04:00,0,3556.0,3207.0,0.902,17.56,435,6,2,4,429,390,39,0,0.0,0.0
1007,1244,25-09-2019 05:06:00,0,3460.0,3090.0,0.893,17.053,377,2,0,2,375,347,28,0,0.0,0.0
1007,1245,25-09-2019 05:08:00,0,3356.0,3016.0,0.899,16.561,380,1,0,1,379,351,28,0,0.0,0.0
1007,1246,25-09-2019 05:10:00,0,3362.0,3025.0,0.9,16.594,577,0,0,0,577,525,52,0,0.0,0.0
1007,1247,25-09-2019 05:12:00,0,3399.0,3106.0,0.9135,16.8305,434,8,7,1,426,386,40,0,0.0,0.0
1007,1248,25-09-2019 05:14:00,0,3436.0,3187.0,0.927,17.067,474,0,0,0,474,419,55,0,0.0,0.01
1007,1249,25-09-2019 05:16:00,0,3551.0,3221.0,0.907,17.559,479,7,4,3,472,412,60,0,0.0,0.0
1007,1250,25-09-2019 05:18:00,0,3295.0,3177.0,0.964,16.497,124,20,2,18,104,49,55,0,0.0,0.0
1007,1251,25-09-2019 05:20:00,0,3536.0,3269.0,0.924,17.551,398,158,114,44,240,180,60,82,0.0,0.0
1007,1252,25-09-2019 05:22:00,0,3842.0,3522.0,0.916,19.038,430,114,77,37,316,238,78,78,0.0,0.0
1007,1253,25-09-2019 05:24:00,0,3825.0,3585.0,0.937,19.039,319,104,66,38,215,144,71,74,0.0,0.02
1007,1254,25-09-2019 05:26:00,0,3821.0,3638.0,0.952,19.083,264,72,38,34,192,125,67,48,0.0,0.0
1007,1255,25-09-2019 05:28:00,0,4017.0,3799.0,0.946,20.031,213,38,21,17,175,108,67,56,0.0,0.0
1007,1256,25-09-2019 05:30:00,0,3994.0,3911.0,0.979,20.066,430,77,47,30,353,283,70,27,0.0,0.0
1007,1257,25-09-2019 05:32:00,0,3847.0,3542.0,0.921,19.08,337,100,69,31,237,151,86,75,0.0,0.0
1007,1258,25-09-2019 05:34:00,0,4243.0,3960.0,0.933,21.104,318,99,70,29,219,141,78,71,0.0,0.01
1007,1259,25-09-2019 05:36:00,0,4312.0,4152.0,0.963,21.585,261,83,53,30,178,108,70,41,0.0,0.03
1007,1260,25-09-2019 05:38:00,0,4337.0,4011.0,0.925,21.53,410,135,93,42,275,203,72,59,0.0,0.01
1007,1261,25-09-2019 05:40:00,0,4341.0,4042.0,0.931,21.579,503,58,34,24,445,353,92,51,0.0,0.0
1007,1262,25-09-2019 05:42:00,0,4354.0,3963.0,0.91,21.543,262,70,42,28,192,129,63,59,0.0,0.0
1007,1263,25-09-2019 05:44:00,0,4341.0,4026.0,0.927,21.56,303,92,58,34,211,136,75,54,0.0,0.0
1007,1264,25-09-2019 05:46:00,0,4236.0,3947.0,0.9315,21.059,324,100,75,25,224,161,63,40,0.0,0.0
1007,1265,25-09-2019 05:48:00,0,4131.0,3868.0,0.936,20.558,378,102,76,26,276,198,78,51,0.0,0.01
1007,1266,25-09-2019 05:50:00,0,4038.0,3768.0,0.933,20.082,540,99,75,24,441,376,65,41,0.0,0.0
1007,1267,25-09-2019 05:52:00,0,3971.0,3556.0,0.895,19.584,271,72,31,41,199,120,79,1,0.0,0.0
1007,1268,25-09-2019 05:54:00,0,3376.0,2912.0,0.863,16.526,313,71,46,25,242,171,71,0,0.0,0.02
1007,1269,25-09-2019 05:56:00,0,4046.0,3677.0,0.909,20.011,483,157,119,38,326,244,82,31,0.0,0.0
1007,1270,25-09-2019 05:58:00,0,3973.0,3551.0,0.894,19.583,536,148,113,35,388,296,92,63,0.07,0.0
1007,1271,25-09-2019 06:00:00,1,4300.0,4128.0,0.96,21.512,351,101,69,32,250,181,69,85,0.0,0.0
1007,1272,25-09-2019 06:02:00,1,4876.0,4394.0,0.901,24.077,322,71,41,30,251,183,68,89,0.0,0.0
1007,1273,25-09-2019 06:04:00,1,4864.0,4457.0,0.916,24.099,251,44,20,24,207,144,63,59,0.0,0.08
1007,1274,25-09-2019 06:06:00,1,4883.0,4408.0,0.903,24.118,633,211,172,39,422,333,89,47,0.09,0.02
1007,1275,25-09-2019 06:08:00,1,4349.0,3956.0,0.91,21.515,356,148,111,37,208,149,59,21,0.0,0.02
1007,1276,25-09-2019 06:10:00,1,3868.0,3418.0,0.884,19.024,353,140,104,36,213,161,52,103,0.0,0.0
1007,1277,25-09-2019 06:12:00,1,4569.0,4139.0,0.906,22.584,339,100,63,37,239,155,84,68,0.0,0.0
1007,1278,25-09-2019 06:14:00,1,4844.0,4393.0,0.907,23.948,264,76,51,25,188,120,68,76,0.0,0.03
1007,1279,25-09-2019 06:16:00,1,4863.0,4414.0,0.908,24.047,364,51,32,19,313,240,73,53,0.0,0.04
1007,1280,25-09-2019 06:18:00,1,4554.0,4191.0,0.92,22.58,571,143,104,39,428,328,100,1,0.12,0.04
1007,1281,25-09-2019 06:20:00,1,4710.5,4289.0,0.9105,23.3065,262,62,44,18,200,132,68,64,0.0,0.0
1007,1282,25-09-2019 06:22:00,1,4867.0,4387.0,0.901,24.033,499,68,44,24,431,340,91,11,0.0,0.05
1007,1283,25-09-2019 06:24:00,1,3965.0,3546.0,0.894,19.549,506,65,33,32,441,374,67,3,0.0,0.0
1007,1284,25-09-2019 06:26:00,1,4032.0,3754.0,0.931,20.043,310,27,2,25,283,215,68,0,0.0,0.0
1007,1285,25-09-2019 06:28:00,1,4535.0,4280.0,0.944,22.605,339,17,2,15,322,263,59,0,0.0,0.0
1007,1286,25-09-2019 06:30:00,1,4323.0,4084.0,0.945,21.555,309,10,4,6,299,224,75,0,0.0,0.0
1007,1287,25-09-2019 06:32:00,1,4344.0,3999.0,0.92,21.544,261,3,0,3,258,184,74,0,0.0,0.0
1007,1288,25-09-2019 06:34:00,1,4027.0,3811.0,0.946,20.085,305,1,0,1,304,214,90,0,0.0,0.0
1007,1289,25-09-2019 06:36:00,1,3970.0,3575.0,0.9,19.6,277,3,1,2,274,219,55,0,0.0,0.0
1007,1290,25-09-2019 06:38:00,1,3882.0,3366.0,0.867,19.02,417,0,0,0,417,371,46,0,0.0,0.0
1007,1291,25-09-2019 06:40:00,1,3540.0,3252.0,0.918,17.549,317,0,0,0,317,282,35,0,0.0,0.0
1007,1292,25-09-2019 06:42:00,1,3572.0,3138.0,0.879,17.546,331,1,0,1,330,292,38,0,0.0,0.0
1007,1293,25-09-2019 06:44:00,1,3351.0,3076.0,0.918,16.61,266,0,0,0,266,230,36,0,0.0,0.0
1007,1294,25-09-2019 06:46:00,1,3358.0,2959.0,0.881,16.505,287,3,0,3,284,243,41,0,0.0,0.0
1007,1295,25-09-2019 06:48:00,1,3250.0,2944.0,0.906,16.066,247,1,0,1,246,215,31,0,0.0,0.0
1007,1296,25-09-2019 06:50:00,1,3017.0,2894.0,0.959,15.09,319,7,0,7,312,277,35,0,0.0,0.0
1007,1297,25-09-2019 06:52:00,1,3023.0,2819.0,0.933,15.033,455,10,0,10,445,387,58,0,0.0,0.0
1007,1298,25-09-2019 06:54:00,1,3039.5,2757.0,0.9075,15.029,760,0,0,0,760,666,94,0,0.0,0.0
1007,1299,25-09-2019 06:56:00,1,3056.0,2695.0,0.882,15.025,502,12,1,11,490,426,64,0,0.0,0.0
1007,1300,25-09-2019 06:58:00,1,2809.0,2679.0,0.954,14.034,470,24,2,22,446,389,57,0,0.0,0.0
1007,1301,25-09-2019 07:00:00,1,3056.0,2733.0,0.894,15.068,530,6,2,4,524,460,64,0,0.0,0.0
1007,1302,25-09-2019 07:02:00,1,2839.0,2582.0,0.909,14.045,433,0,0,0,433,382,51,0,0.0,0.0
1007,1303,25-09-2019 07:04:00,1,2846.0,2585.0,0.908,14.075,462,1,0,1,461,400,61,0,0.0,0.0
1007,1304,25-09-2019 07:06:00,1,2838.0,2572.0,0.906,14.031,188,4,0,4,184,161,23,0,0.0,0.0
1007,1305,25-09-2019 07:08:00,1,2843.0,2592.0,0.912,14.072,411,11,1,10,400,353,47,0,0.0,0.0
1007,1306,25-09-2019 07:10:00,1,2929.0,2702.0,0.922,14.532,629,145,107,38,484,425,59,17,0.0,0.0
1007,1307,25-09-2019 07:12:00,1,3438.0,3172.0,0.922,17.059,375,64,28,36,311,256,55,29,0.0,0.0
1007,1308,25-09-2019 07:14:00,1,3525.0,3303.0,0.937,17.546,480,204,156,48,276,199,77,52,0.0,0.0
1007,1309,25-09-2019 07:16:00,1,3440.0,3191.0,0.928,17.084,388,164,119,45,224,167,57,56,0.0,0.0
1007,1310,25-09-2019 07:18:00,1,3639.0,3397.0,0.933,18.097,213,66,41,25,147,82,65,47,0.0,0.0
1007,1311,25-09-2019 07:20:00,1,3830.0,3561.0,0.93,19.031,383,138,105,33,245,196,49,70,0.05,0.0
1007,1312,25-09-2019 07:22:00,1,3869.0,3445.0,0.89,19.056,659,243,193,50,416,328,88,7,0.0,0.02
1007,1313,25-09-2019 07:24:00,1,3831.0,3550.0,0.927,19.024,489,175,132,43,314,248,66,15,0.0,0.01
1007,1314,25-09-2019 07:26:00,1,3542.0,3245.0,0.916,17.547,324,56,18,38,268,199,69,1,0.0,0.0
1007,1315,25-09-2019 07:28:00,1,3545.0,3256.0,0.9185,17.5715,491,151,110,41,340,260,80,1,0.0,0.0
1007,1316,25-09-2019 07:30:00,1,3548.0,3267.0,0.921,17.596,302,110,86,24,192,139,53,103,0.0,0.0
1007,1317,25-09-2019 07:32:00,1,3638.0,3354.0,0.922,18.048,347,83,47,36,264,208,56,16,0.0,0.0
1007,1318,25-09-2019 07:34:00,1,3756.0,3371.0,0.897,18.532,231,48,29,19,183,131,52,0,0.0,0.0
1007,1319,25-09-2019 07:36:00,1,3875.0,3436.0,0.887,19.072,203,61,27,34,142,91,51,0,0.0,0.0
1007,1320,25-09-2019 07:38:00,1,3654.0,3298.0,0.903,18.047,142,73,40,33,69,22,47,0,0.0,0.0
1007,1321,25-09-2019 07:40:00,1,3559.0,3167.0,0.89,17.53,41,5,1,4,36,0,36,0,0.0,0.0
1007,1322,25-09-2019 07:42:00,1,3361.0,2978.0,0.886,16.539,39,0,0,0,39,0,39,0,0.0,0.0
1007,1323,25-09-2019 07:44:00,1,3263.0,2866.0,0.878,16.028,39,3,3,0,36,0,36,0,0.0,0.0
1007,1324,25-09-2019 07:46:00,1,3032.0,2781.0,0.917,15.026,43,1,0,1,42,0,42,0,0.0,0.0
1007,1325,25-09-2019 07:48:00,1,3035.0,2802.0,0.923,15.059,130,46,23,23,84,41,43,0,0.0,0.0
1007,1326,25-09-2019 07:50:00,1,3023.0,2845.0,0.941,15.062,252,69,41,28,183,128,55,1,0.0,0.0
1007,1327,25-09-2019 07:52:00,1,3376.0,2968.0,0.879,16.588,325,104,66,38,221,149,72,16,0.0,0.0
1007,1328,25-09-2019 07:54:00,1,3348.0,3028.0,0.904,16.543,277,118,73,45,159,103,56,28,0.0,0.0
1007,1329,25-09-2019 07:56:00,1,3366.0,2999.0,0.891,16.581,205,66,32,34,139,85,54,75,0.0,0.0
1007,1330,25-09-2019 07:58:00,1,3352.0,3022.0,0.902,16.55,391,107,80,27,284,217,67,3,0.0,0.0
1007,1331,25-09-2019 08:00:00,1,3383.0,2900.0,0.857,16.541,190,80,52,28,110,63,47,1,0.0,0.0
1007,1332,25-09-2019 08:02:00,1,3326.5,2877.5,0.865,16.2935,411,84,53,31,327,269,58,7,0.0,0.0
1007,1333,25-09-2019 08:04:00,1,3270.0,2855.0,0.873,16.046,97,7,2,5,90,44,46,0,0.0,0.0
1007,1334,25-09-2019 08:06:00,1,3074.0,2629.0,0.855,15.023,237,8,4,4,229,160,69,0,0.0,0.0
1007,1335,25-09-2019 08:08:00,1,2865.0,2475.0,0.864,14.027,187,0,0,0,187,125,62,0,0.0,0.0
1007,1336,25-09-2019 08:10:00,1,2886.0,2392.0,0.829,14.02,155,12,7,5,143,95,48,0,0.0,0.0
1007,1337,25-09-2019 08:12:00,1,2880.0,2428.0,0.843,14.035,188,10,6,4,178,111,67,0,0.0,0.0
1007,1338,25-09-2019 08:14:00,1,2877.0,2430.0,0.845,14.024,135,1,0,1,134,78,56,0,0.0,0.0
1007,1339,25-09-2019 08:16:00,1,2883.0,2432.0,0.843,14.053,188,3,1,2,185,122,63,0,0.0,0.0
1007,1340,25-09-2019 08:18:00,1,2901.0,2348.0,0.809,14.029,166,7,1,6,159,95,64,0,0.0,0.0
1007,1341,25-09-2019 08:20:00,1,2921.0,2278.0,0.78,14.033,113,12,2,10,101,44,57,0,0.0,0.0
1007,1342,25-09-2019 08:22:00,1,2692.0,2208.0,0.82,13.053,65,0,0,0,65,13,52,0,0.0,0.0
1007,1343,25-09-2019 08:24:00,1,2573.0,2133.0,0.829,12.5,109,0,0,0,109,54,55,0,0.0,0.0
1007,1344,25-09-2019 08:26:00,1,2601.0,2082.0,0.801,12.552,59,6,1,5,53,16,37,0,0.0,0.0
1007,1345,25-09-2019 08:28:00,1,2607.0,2022.0,0.776,12.513,81,12,0,12,69,29,40,0,0.0,0.0
1007,1346,25-09-2019 08:30:00,1,2592.0,2095.0,0.808,12.53,77,12,6,6,65,24,41,0,0.0,0.0
1007,1347,25-09-2019 08:32:00,1,2580.0,2117.0,0.82,12.509,60,0,0,0,60,24,36,0,0.0,0.0
1007,1348,25-09-2019 08:34:00,1,2597.0,2037.0,0.784,12.49,150,8,2,6,142,84,58,0,0.0,0.0
1007,1349,25-09-2019 08:36:00,1,2771.0,2119.0,0.7655,13.2645,97,12,7,5,85,42,43,0,0.0,0.0
1007,1350,25-09-2019 08:38:00,1,2945.0,2201.0,0.747,14.039,45,4,1,3,41,0,41,0,0.0,0.0
1007,1351,25-09-2019 08:40:00,1,2598.0,2064.0,0.794,12.523,40,5,2,3,35,0,35,0,0.0,0.0
1007,1352,25-09-2019 08:42:00,1,2597.0,2072.0,0.798,12.525,62,16,11,5,46,7,39,0,0.0,0.0
1007,1353,25-09-2019 08:44:00,1,2946.0,2178.0,0.739,14.018,40,0,0,0,40,0,40,0,0.0,0.0
1007,1354,25-09-2019 08:46:00,1,2926.0,2259.0,0.772,14.03,52,3,1,2,49,9,40,0,0.0,0.0
1007,1355,25-09-2019 08:48:00,1,2943.0,2188.0,0.744,14.018,36,0,0,0,36,2,34,0,0.0,0.0
1007,1356,25-09-2019 08:50:00,1,2823.0,2142.0,0.759,13.493,155,63,29,34,92,42,50,0,0.0,0.0
1007,1357,25-09-2019 08:52:00,1,3113.0,2501.0,0.803,15.036,175,58,33,25,117,76,41,3,0.0,0.0
1007,1358,25-09-2019 08:54:00,1,3099.0,2541.0,0.82,15.024,390,131,104,27,259,187,72,45,0.0,0.0
1007,1359,25-09-2019 08:56:00,1,3317.0,2650.0,0.799,16.005,319,122,86,36,197,131,66,15,0.0,0.06
1007,1360,25-09-2019 08:58:00,1,3087.0,2590.0,0.839,15.031,57,6,2,4,51,10,41,0,0.0,0.0
1007,1361,25-09-2019 09:00:00,1,3125.0,2462.0,0.788,15.04,76,8,4,4,68,32,36,0,0.0,0.0
1007,1362,25-09-2019 09:02:00,1,3140.0,2431.0,0.774,15.064,116,6,2,4,110,62,48,0,0.0,0.0
1007,1363,25-09-2019 09:04:00,1,3012.0,2360.0,0.784,14.479,126,0,0,0,126,77,49,0,0.0,0.0
1007,1364,25-09-2019 09:06:00,1,2920.0,2271.0,0.778,14.02,121,0,0,0,121,60,61,0,0.0,0.0
1007,1365,25-09-2019 09:08:00,1,2938.0,2191.0,0.746,14.003,400,112,79,33,288,226,62,9,0.0,0.0
1007,1366,25-09-2019 09:10:00,1,3028.0,2339.0,0.772,14.521,300,49,27,22,251,177,74,4,0.0,0.0
1007,1367,25-09-2019 09:12:00,1,3118.0,2487.0,0.798,15.039,337,123,85,38,214,150,64,69,0.0,0.0
1007,1368,25-09-2019 09:14:00,1,3323.0,2613.0,0.786,15.986,244,71,32,39,173,111,62,54,0.0,0.0
1007,1369,25-09-2019 09:16:00,1,3657.0,2816.0,0.77,17.529,289,92,50,42,197,130,67,69,0.0,0.0
1007,1370,25-09-2019 09:18:00,1,3644.0,2898.0,0.795,17.567,232,89,54,35,143,80,63,59,0.0,0.0
1007,1371,25-09-2019 09:20:00,1,3749.0,2958.0,0.789,18.047,534,172,128,44,362,288,74,27,0.0,0.0
1007,1372,25-09-2019 09:22:00,1,3614.0,2959.0,0.819,17.516,100,38,15,23,62,21,41,0,0.07,0.0
1007,1373,25-09-2019 09:24:00,1,3429.0,2740.0,0.799,16.544,147,58,26,32,89,39,50,0,0.0,0.0
1007,1374,25-09-2019 09:26:00,1,3443.0,2653.0,0.771,16.502,39,0,0,0,39,0,39,0,0.0,0.0
1007,1375,25-09-2019 09:28:00,1,3097.0,2589.0,0.836,15.067,35,0,0,0,35,0,35,0,0.0,0.0
1007,1376,25-09-2019 09:30:00,1,3111.0,2508.0,0.806,15.033,31,2,1,1,29,0,29,0,0.0,0.0
1007,1377,25-09-2019 09:32:00,1,3125.0,2433.0,0.778,15.008,42,0,0,0,42,0,42,0,0.0,0.0
1007,1378,25-09-2019 09:34:00,1,2893.0,2379.0,0.822,14.033,37,1,0,1,36,0,36,0,0.0,0.0
1007,1379,25-09-2019 09:36:00,1,2922.0,2332.0,0.798,14.095,45,2,2,0,43,0,43,0,0.0,0.0
1007,1380,25-09-2019 09:38:00,1,2923.0,2253.0,0.771,14.013,43,0,0,0,43,0,43,0,0.0,0.0
1007,1381,25-09-2019 09:40:00,1,2920.0,2259.0,0.773,14.006,43,2,1,1,41,0,41,0,0.0,0.0
1007,1382,25-09-2019 09:42:00,1,2925.0,2269.0,0.776,14.037,42,1,0,1,41,0,41,0,0.0,0.0
1007,1383,25-09-2019 09:44:00,1,2921.5,2274.0,0.7785,14.028,49,2,0,2,47,0,47,0,0.0,0.0
1007,1384,25-09-2019 09:46:00,1,2918.0,2279.0,0.781,14.019,46,0,0,0,46,0,46,0,0.0,0.0
1007,1385,25-09-2019 09:48:00,1,2804.0,2233.0,0.797,13.519,33,2,0,2,31,0,31,0,0.0,0.0
1007,1386,25-09-2019 09:50:00,1,2809.0,2220.0,0.79,13.526,46,0,0,0,46,14,32,0,0.0,0.0
1007,1387,25-09-2019 09:52:00,1,2571.0,2174.0,0.846,12.538,50,1,0,1,49,2,47,0,0.0,0.0
1007,1388,25-09-2019 09:54:00,1,2592.0,2092.0,0.807,12.528,47,5,1,4,42,0,42,0,0.0,0.0
1007,1389,25-09-2019 09:56:00,1,2623.0,1991.0,0.759,12.537,65,20,3,17,45,0,45,0,0.0,0.0
1007,1390,25-09-2019 09:58:00,1,2625.0,1986.0,0.757,12.543,51,8,4,4,43,0,43,0,0.0,0.0
1007,1391,25-09-2019 10:00:00,1,2603.0,1997.0,0.767,12.465,56,11,0,11,45,0,45,0,0.0,0.0
1007,1392,25-09-2019 10:02:00,1,2613.0,2011.0,0.77,12.522,60,7,4,3,53,10,43,0,0.0,0.0
1007,1393,25-09-2019 10:04:00,1,2596.0,2067.0,0.796,12.517,57,1,0,1,56,9,47,0,0.0,0.0
1007,1394,25-09-2019 10:06:00,1,2591.0,2095.0,0.809,12.529,49,5,2,3,44,0,44,0,0.0,0.0
1007,1395,25-09-2019 10:08:00,1,2710.0,2134.0,0.788,13.04,43,0,0,0,43,0,43,0,0.0,0.0
1007,1396,25-09-2019 10:10:00,1,2703.0,2127.0,0.787,13.007,60,14,6,8,46,2,44,0,0.0,0.0
1007,1397,25-09-2019 10:12:00,1,2703.0,2120.0,0.784,12.998,58,0,0,0,58,13,45,0,0.0,0.0
1007,1398,25-09-2019 10:14:00,1,2610.0,2053.0,0.786,12.557,80,7,2,5,73,27,46,0,0.0,0.0
1007,1399,25-09-2019 10:16:00,1,2611.0,2000.0,0.766,12.504,46,3,0,3,43,2,41,0,0.0,0.0
1007,1400,25-09-2019 10:18:00,1,2602.5,2027.5,0.779,12.501,78,32,11,21,46,6,40,0,0.0,0.0
1007,1401,25-09-2019 10:20:00,1,2594.0,2055.0,0.792,12.498,100,2,0,2,98,56,42,0,0.0,0.0
1007,1402,25-09-2019 10:22:00,1,2706.0,2119.0,0.783,13.007,48,3,0,3,45,0,45,0,0.0,0.0
1007,1403,25-09-2019 10:24:00,1,2823.0,2135.0,0.756,13.488,60,0,0,0,60,12,48,0,0.0,0.0
1007,1404,25-09-2019 10:26:00,1,2820.0,2169.0,0.769,13.515,89,0,0,0,89,41,48,0,0.0,0.0
1007,1405,25-09-2019 10:28:00,1,2943.0,2172.0,0.738,13.999,124,0,0,0,124,79,45,0,0.0,0.0
1007,1406,25-09-2019 10:30:00,1,2705.0,2145.0,0.793,13.033,255,114,84,30,141,84,57,5,0.0,0.0
1007,1407,25-09-2019 10:32:00,1,2922.0,2314.0,0.792,14.074,79,38,17,21,41,0,41,0,0.0,0.0
1007,1408,25-09-2019 10:34:00,1,2921.0,2252.0,0.771,14.002,180,81,50,31,99,45,54,2,0.0,0.0
1007,1409,25-09-2019 10:36:00,1,2998.0,2432.0,0.811,14.504,257,74,40,34,183,121,62,60,0.0,0.0
1007,1410,25-09-2019 10:38:00,1,3209.0,2630.0,0.819,15.556,224,68,33,35,156,88,68,40,0.0,0.0
1007,1411,25-09-2019 10:40:00,1,3404.0,2805.0,0.824,16.516,249,80,42,38,169,116,53,64,0.0,0.0
1007,1412,25-09-2019 10:42:00,1,3635.0,2900.0,0.798,17.533,273,92,67,25,181,119,62,54,0.0,0.09
1007,1413,25-09-2019 10:44:00,1,3605.0,3019.0,0.837,17.548,215,6,0,6,209,141,68,56,0.0,0.0
1007,1414,25-09-2019 10:46:00,1,3596.0,3052.0,0.849,17.547,230,6,4,2,224,154,70,59,0.0,0.08
1007,1415,25-09-2019 10:48:00,1,3598.0,3032.0,0.843,17.534,402,145,108,37,257,172,85,35,0.11,0.06
1007,1416,25-09-2019 10:50:00,1,3589.0,3072.0,0.856,17.542,696,242,184,58,454,354,100,11,0.05,0.08
1007,1417,25-09-2019 10:52:00,1,3587.5,3076.5,0.8575,17.541,868,278,220,58,590,491,99,3,0.05,0.0
1007,1418,25-09-2019 10:54:00,1,3586.0,3081.0,0.859,17.54,379,132,96,36,247,172,75,0,0.0,0.0
1007,1419,25-09-2019 10:56:00,1,3605.0,3016.0,0.837,17.542,242,112,76,36,130,72,58,0,0.0,0.0
1007,1420,25-09-2019 10:58:00,1,3388.0,2907.0,0.858,16.568,577,271,207,64,306,227,79,0,0.07,0.0
1007,1421,25-09-2019 11:00:00,1,3790.0,3232.0,0.853,18.512,195,34,18,16,161,94,67,0,0.0,0.0
1007,1422,25-09-2019 11:02:00,1,3606.0,3030.0,0.84,17.563,304,25,8,17,279,190,89,0,0.0,0.0
1007,1423,25-09-2019 11:04:00,1,3569.0,3120.0,0.874,17.516,348,6,2,4,342,260,82,0,0.0,0.0
1007,1424,25-09-2019 11:06:00,1,3485.0,3001.0,0.861,17.052,248,0,0,0,248,166,82,0,0.0,0.0
1007,1425,25-09-2019 11:08:00,1,3387.0,2878.0,0.85,16.529,255,0,0,0,255,174,81,0,0.0,0.0
1007,1426,25-09-2019 11:10:00,1,3036.0,2773.0,0.913,15.032,246,5,1,4,241,156,85,0,0.0,0.0
1007,1427,25-09-2019 11:12:00,1,3041.0,2780.0,0.914,15.061,249,0,0,0,249,156,93,0,0.0,0.0
1007,1428,25-09-2019 11:14:00,1,3063.0,2675.0,0.873,15.031,248,6,2,4,242,159,83,0,0.0,0.0
1007,1429,25-09-2019 11:16:00,1,3080.0,2630.0,0.854,15.046,63,0,0,0,63,21,42,0,0.0,0.0
1007,1430,25-09-2019 11:18:00,1,2963.0,2602.0,0.878,14.555,79,9,0,9,70,21,49,0,0.0,0.0
1007,1431,25-09-2019 11:20:00,1,2853.0,2546.0,0.892,14.059,47,4,2,2,43,2,41,0,0.0,0.0
1007,1432,25-09-2019 11:22:00,1,2865.0,2471.0,0.863,14.023,89,8,2,6,81,36,45,0,0.0,0.0
1007,1433,25-09-2019 11:24:00,1,2869.0,2478.0,0.864,14.049,72,1,0,1,71,27,44,0,0.0,0.0
1007,1434,25-09-2019 11:26:00,1,2877.0,2435.5,0.847,14.032,276,1,1,0,275,202,73,0,0.0,0.0
1007,1435,25-09-2019 11:28:00,1,2885.0,2393.0,0.83,14.015,332,6,1,5,326,262,64,0,0.0,0.0
1007,1436,25-09-2019 11:30:00,1,2872.0,2416.0,0.841,13.989,452,11,0,11,441,384,57,0,0.0,0.0
1007,1437,25-09-2019 11:32:00,1,2763.0,2381.0,0.862,13.523,288,1,0,1,287,253,34,0,0.0,0.0
1007,1438,25-09-2019 11:34:00,1,2657.0,2325.0,0.875,13.043,206,3,0,3,203,173,30,0,0.0,0.0
1007,1439,25-09-2019 11:36:00,1,2540.0,2265.0,0.892,12.515,258,17,9,8,241,202,39,0,0.0,0.0
1007,1440,25-09-2019 11:38:00,1,2869.0,2452.0,0.855,14.018,546,192,146,46,354,295,59,54,0.0,0.0
1007,1441,25-09-2019 11:40:00,1,3051.0,2722.0,0.892,15.034,437,75,47,28,362,270,92,26,0.0,0.0
1007,1442,25-09-2019 11:42:00,1,3013.0,2845.0,0.944,15.022,528,182,133,49,346,256,90,0,0.0,0.0
1007,1443,25-09-2019 11:44:00,1,3027.0,2805.0,0.927,15.032,443,23,3,20,420,324,96,0,0.0,0.0
1007,1444,25-09-2019 11:46:00,1,3352.0,3002.0,0.896,16.53,449,19,2,17,430,373,57,1,0.0,0.0
1007,1445,25-09-2019 11:48:00,1,3010.0,2890.0,0.96,15.059,637,41,16,25,596,543,53,1,0.0,0.0
1007,1446,25-09-2019 11:50:00,1,3020.0,2860.0,0.947,15.066,483,29,11,18,454,406,48,0,0.0,0.0
1007,1447,25-09-2019 11:52:00,1,3020.0,2823.0,0.935,15.023,415,59,30,29,356,269,87,0,0.0,0.0
1007,1448,25-09-2019 11:54:00,1,3367.0,2964.0,0.88,16.549,353,1,0,1,352,267,85,0,0.0,0.0
1007,1449,25-09-2019 11:56:00,1,3041.0,2767.0,0.91,15.046,235,1,0,1,234,162,72,0,0.0,0.0
1007,1450,25-09-2019 11:58:00,1,3074.0,2651.0,0.863,15.045,292,2,1,1,290,211,79,0,0.0,0.0
1007,1451,25-09-2019 12:00:00,1,2971.5,2562.5,0.8625,14.5445,499,4,2,2,495,421,74,0,0.0,0.0
1007,1452,25-09-2019 12:02:00,1,2869.0,2474.0,0.862,14.044,431,14,9,5,417,352,65,0,0.0,0.0
1007,1453,25-09-2019 12:04:00,1,2880.0,2426.0,0.842,14.032,141,0,0,0,141,85,56,0,0.0,0.0
1007,1454,25-09-2019 12:06:00,1,2546.0,2260.0,0.888,12.535,253,0,0,0,253,192,61,0,0.0,0.0
1007,1455,25-09-2019 12:08:00,1,2576.0,2128.0,0.826,12.506,467,0,0,0,467,433,34,0,0.0,0.0
1007,1456,25-09-2019 12:10:00,1,2604.0,2059.0,0.791,12.539,264,0,0,0,264,245,19,0,0.0,0.0
1007,1457,25-09-2019 12:12:00,1,2607.0,2033.0,0.78,12.522,324,0,0,0,324,294,30,0,0.0,0.0
1007,1458,25-09-2019 12:14:00,1,2599.0,2031.0,0.781,12.49,263,0,0,0,263,237,26,0,0.0,0.0
1007,1459,25-09-2019 12:16:00,1,2602.0,2065.0,0.794,12.539,343,0,0,0,343,311,32,0,0.0,0.0
1007,1460,25-09-2019 12:18:00,1,2589.0,2081.0,0.804,12.503,275,0,0,0,275,238,37,0,0.0,0.0
1007,1461,25-09-2019 12:20:00,1,2576.0,2133.0,0.828,12.511,294,0,0,0,294,265,29,0,0.0,0.0
1007,1462,25-09-2019 12:22:00,1,2569.0,2160.0,0.841,12.512,216,0,0,0,216,188,28,0,0.0,0.0
1007,1463,25-09-2019 12:24:00,1,2566.0,2178.0,0.849,12.521,423,0,0,0,423,373,50,0,0.0,0.0
1007,1464,25-09-2019 12:26:00,1,2575.0,2151.0,0.835,12.526,407,1,0,1,406,341,65,0,0.0,0.0
1007,1465,25-09-2019 12:28:00,1,2578.0,2125.0,0.824,12.512,254,1,1,0,253,207,46,0,0.0,0.0
1007,1466,25-09-2019 12:30:00,1,2592.0,2080.0,0.802,12.516,244,0,0,0,244,230,14,0,0.0,0.0
1007,1467,25-09-2019 12:32:00,1,2619.0,1985.0,0.758,12.517,320,1,0,1,319,283,36,0,0.0,0.0
1007,1468,25-09-2019 12:34:00,1,2558.5,1980.5,0.7745,12.274,355,3,0,3,352,315,37,0,0.0,0.0
1007,1469,25-09-2019 12:36:00,1,2498.0,1976.0,0.791,12.031,473,0,0,0,473,425,48,0,0.0,0.0
1007,1470,25-09-2019 12:38:00,1,2612.0,1997.0,0.765,12.501,289,1,0,1,288,244,44,0,0.0,0.0
1007,1471,25-09-2019 12:40:00,1,2616.0,2006.0,0.767,12.529,312,0,0,0,312,262,50,0,0.0,0.0
1007,1472,25-09-2019 12:42:00,1,2613.0,1988.0,0.761,12.496,293,0,0,0,293,266,27,0,0.0,0.0
1007,1473,25-09-2019 12:44:00,1,2618.0,1983.0,0.757,12.513,265,1,0,1,264,242,22,0,0.0,0.0
1007,1474,25-09-2019 12:46:00,1,2625.0,1953.0,0.744,12.505,489,0,0,0,489,444,45,0,0.0,0.0
1007,1475,25-09-2019 12:48:00,1,2630.0,1954.0,0.743,12.527,503,0,0,0,503,452,51,0,0.0,0.0
1007,1476,25-09-2019 12:50:00,1,2645.0,1908.0,0.721,12.534,601,6,4,2,595,522,73,0,0.0,0.0
1007,1477,25-09-2019 12:52:00,1,2623.0,1971.0,0.751,12.519,535,11,5,6,524,466,58,0,0.0,0.0
1007,1478,25-09-2019 12:54:00,1,2698.0,2148.0,0.796,13.007,332,0,0,0,332,308,24,0,0.0,0.0
1007,1479,25-09-2019 12:56:00,1,2936.0,2216.0,0.755,14.02,267,0,0,0,267,239,28,0,0.0,0.0
1007,1480,25-09-2019 12:58:00,1,2933.0,2214.0,0.755,14.009,301,28,20,8,273,241,32,0,0.0,0.0
1007,1481,25-09-2019 13:00:00,1,2936.0,2217.0,0.755,14.022,353,39,32,7,314,255,59,2,0.0,0.0
1007,1482,25-09-2019 13:02:00,1,2813.0,2171.0,0.772,13.487,283,3,2,1,280,240,40,0,0.0,0.0
1007,1483,25-09-2019 13:04:00,1,2577.0,2133.0,0.828,12.515,472,9,4,5,463,411,52,0,0.0,0.0
1007,1484,25-09-2019 13:06:00,1,2595.0,2079.0,0.801,12.528,293,7,5,2,286,255,31,0,0.0,0.0
1007,1485,25-09-2019 13:08:00,1,2598.5,2057.5,0.792,12.517,277,4,2,2,273,243,30,0,0.0,0.0
1007,1486,25-09-2019 13:10:00,1,2602.0,2036.0,0.783,12.506,332,0,0,0,332,277,55,0,0.0,0.0
1007,1487,25-09-2019 13:12:00,1,2612.0,2013.0,0.771,12.521,308,3,1,2,305,237,68,0,0.0,0.0
1007,1488,25-09-2019 13:14:00,1,2611.0,2033.0,0.778,12.539,373,0,0,0,373,305,68,0,0.0,0.0
1007,1489,25-09-2019 13:16:00,1,2619.0,2029.0,0.775,12.567,337,0,0,0,337,264,73,0,0.0,0.0
1007,1490,25-09-2019 13:18:00,1,2601.0,2046.0,0.786,12.514,405,0,0,0,405,336,69,0,0.0,0.0
1007,1491,25-09-2019 13:20:00,1,2601.0,2046.0,0.786,12.514,274,2,1,1,272,223,49,0,0.0,0.0
1007,1492,25-09-2019 13:22:00,1,2600.0,2067.0,0.795,12.533,66,17,0,17,49,38,11,0,0.0,0.0
1007,1493,25-09-2019 13:24:00,1,2596.0,2055.0,0.791,12.505,204,28,7,21,176,157,19,0,0.0,0.0
1007,1494,25-09-2019 13:26:00,1,2718.0,2120.0,0.78,13.058,327,34,16,18,293,257,36,0,0.0,0.0
1007,1495,25-09-2019 13:28:00,1,2887.0,2399.0,0.831,14.029,422,21,4,17,401,361,40,0,0.0,0.0
1007,1496,25-09-2019 13:30:00,1,3112.0,2501.0,0.804,15.03,349,42,19,23,307,271,36,31,0.0,0.0
1007,1497,25-09-2019 13:32:00,1,3080.0,2609.0,0.847,15.022,206,27,9,18,179,121,58,67,0.0,0.0
1007,1498,25-09-2019 13:34:00,1,3524.0,2878.0,0.816,17.072,228,38,18,20,190,120,70,73,0.0,0.0
1007,1499,25-09-2019 13:36:00,1,3595.0,3042.0,0.846,17.532,304,41,28,13,263,193,70,68,0.0,0.05
1007,1500,25-09-2019 13:38:00,1,3715.0,3089.0,0.831,18.057,236,31,20,11,205,139,66,65,0.0,0.04
1007,1501,25-09-2019 13:40:00,1,3907.0,3278.0,0.839,19.021,670,175,136,39,495,391,104,37,0.0,0.05
1007,1502,25-09-2019 13:42:00,1,3904.5,3288.5,0.8425,19.0225,557,182,133,49,375,301,74,24,0.06,0.02
1007,1503,25-09-2019 13:44:00,1,3902.0,3299.0,0.846,19.024,423,83,63,20,340,255,85,5,0.0,0.0
1007,1504,25-09-2019 13:46:00,1,3612.0,2976.0,0.824,17.525,547,187,143,44,360,284,76,6,0.0,0.0
1007,1505,25-09-2019 13:48:00,1,3584.0,3120.0,0.87,17.577,235,71,50,21,164,122,42,4,0.0,0.0
1007,1506,25-09-2019 13:50:00,1,3497.0,2949.0,0.843,17.043,505,17,3,14,488,385,103,0,0.0,0.0
1007,1507,25-09-2019 13:52:00,1,3378.0,2920.0,0.864,16.544,723,165,128,37,558,440,118,3,0.06,0.07
1007,1508,25-09-2019 13:54:00,1,3575.0,3108.0,0.869,17.528,1027,192,147,45,835,706,129,6,0.0,0.0
1007,1509,25-09-2019 13:56:00,1,3552.0,3202.0,0.901,17.541,867,135,95,40,732,618,114,0,0.03,0.0
1007,1510,25-09-2019 13:58:00,1,3557.0,3152.0,0.886,17.506,776,41,10,31,735,633,102,0,0.0,0.0
1007,1511,25-09-2019 14:00:00,1,3606.0,3016.0,0.836,17.546,756,25,7,18,731,633,98,0,0.0,0.0
1007,1512,25-09-2019 14:02:00,1,3550.0,3187.0,0.898,17.517,499,33,1,32,466,379,87,0,0.0,0.0
1007,1513,25-09-2019 14:04:00,1,3568.0,3135.0,0.879,17.528,362,0,0,0,362,329,33,0,0.0,0.0
1007,1514,25-09-2019 14:06:00,1,3382.0,2897.0,0.857,16.532,368,0,0,0,368,328,40,0,0.0,0.0
1007,1515,25-09-2019 14:08:00,1,3041.0,2771.0,0.911,15.051,269,2,1,1,267,234,33,0,0.0,0.0
1007,1516,25-09-2019 14:10:00,1,3042.0,2765.0,0.909,15.048,217,0,0,0,217,187,30,0,0.0,0.0
1007,1517,25-09-2019 14:12:00,1,3057.0,2711.0,0.887,15.045,474,0,0,0,474,429,45,0,0.0,0.0
1007,1518,25-09-2019 14:14:00,1,3080.0,2638.0,0.856,15.057,421,0,0,0,421,338,83,0,0.0,0.0
1007,1519,25-09-2019 14:16:00,1,2978.0,2539.5,0.8525,14.5455,174,6,1,5,168,145,23,0,0.0,0.0
1007,1520,25-09-2019 14:18:00,1,2876.0,2441.0,0.849,14.034,73,0,0,0,73,63,10,0,0.0,0.0
1007,1521,25-09-2019 14:20:00,1,2888.0,2389.0,0.827,14.024,83,0,0,0,83,65,18,0,0.0,0.0
1007,1522,25-09-2019 14:22:00,1,2773.0,2374.0,0.856,13.554,1371,10,5,5,1361,1332,29,0,0.0,0.0
1007,1523,25-09-2019 14:24:00,1,2872.0,2478.0,0.863,14.058,954,0,0,0,954,913,41,0,0.0,0.0
1007,1524,25-09-2019 14:26:00,1,2765.0,2379.0,0.86,13.53,810,0,0,0,810,740,70,0,0.0,0.0
1007,1525,25-09-2019 14:28:00,1,2879.0,2425.0,0.842,14.026,1106,0,0,0,1106,1045,61,0,0.0,0.0
1007,1526,25-09-2019 14:30:00,1,2882.0,2428.0,0.843,14.042,963,31,16,15,932,870,62,0,0.0,0.0
1007,1527,25-09-2019 14:32:00,1,2875.0,2436.0,0.847,14.027,864,0,0,0,864,771,93,0,0.0,0.0
1007,1528,25-09-2019 14:34:00,1,2552.0,2239.0,0.878,12.533,970,36,25,11,934,845,89,0,0.0,0.0
1007,1529,25-09-2019 14:36:00,1,2781.0,2343.0,0.842,13.55,879,8,4,4,871,772,99,0,0.0,0.0
1007,1530,25-09-2019 14:38:00,1,2772.0,2354.0,0.849,13.528,775,21,12,9,754,667,87,0,0.0,0.0
1007,1531,25-09-2019 14:40:00,1,2889.0,2392.0,0.828,14.031,1309,10,1,9,1299,1220,79,0,0.0,0.0
1007,1532,25-09-2019 14:42:00,1,2664.0,2319.0,0.871,13.062,1264,9,3,6,1255,1175,80,0,0.0,0.0
1007,1533,25-09-2019 14:44:00,1,2548.0,2252.0,0.884,12.532,920,3,2,1,917,843,74,0,0.0,0.0
1007,1534,25-09-2019 14:46:00,1,2547.0,2237.0,0.878,12.511,903,2,1,1,901,820,81,0,0.0,0.0
1007,1535,25-09-2019 14:48:00,1,2560.0,2247.0,0.878,12.576,997,2,1,1,995,904,91,0,0.0,0.0
1007,1536,25-09-2019 14:50:00,1,2557.0,2255.5,0.8825,12.573,896,6,3,3,890,807,83,0,0.0,0.0
1007,1537,25-09-2019 14:52:00,1,2554.0,2264.0,0.887,12.57,994,4,1,3,990,901,89,0,0.0,0.0
1007,1538,25-09-2019 14:54:00,1,2661.0,2273.0,0.854,13.002,1853,12,0,12,1841,1794,47,0,0.0,0.0
1007,1539,25-09-2019 14:56:00,1,2555.0,2214.0,0.867,12.518,1284,20,12,8,1264,1203,61,0,0.0,0.0
1007,1540,25-09-2019 14:58:00,1,2670.0,2256.0,0.845,13.016,532,2,1,1,530,480,50,0,0.0,0.0
1007,1541,25-09-2019 15:00:00,1,2671.0,2260.0,0.846,13.028,645,15,0,15,630,552,78,0,0.0,0.0
1007,1542,25-09-2019 15:02:00,1,2895.0,2346.0,0.81,14.005,677,11,6,5,666,594,72,0,0.0,0.0
1007,1543,25-09-2019 15:04:00,1,2893.0,2381.0,0.823,14.036,595,9,1,8,586,532,54,0,0.0,0.0
1007,1544,25-09-2019 15:06:00,1,2892.0,2381.0,0.823,14.031,902,23,8,15,879,777,102,0,0.0,0.0
1007,1545,25-09-2019 15:08:00,1,2889.0,2385.0,0.826,14.023,1502,0,0,0,1502,1409,93,0,0.0,0.0
1007,1546,25-09-2019 15:10:00,1,2798.0,2278.0,0.814,13.545,1173,3,1,2,1170,1091,79,0,0.0,0.0
1007,1547,25-09-2019 15:12:00,1,2794.0,2272.0,0.813,13.525,942,0,0,0,942,876,66,0,0.0,0.0
1007,1548,25-09-2019 15:14:00,1,2798.0,2270.0,0.811,13.537,1083,0,0,0,1083,1007,76,0,0.0,0.0
1007,1549,25-09-2019 15:16:00,1,2921.0,2275.0,0.779,14.027,979,3,2,1,976,910,66,0,0.0,0.0
1007,1550,25-09-2019 15:18:00,1,2677.0,2211.0,0.826,12.996,472,0,0,0,472,411,61,0,0.0,0.0
1007,1551,25-09-2019 15:20:00,1,2574.0,2158.0,0.838,12.53,406,0,0,0,406,369,37,0,0.0,0.0
1007,1552,25-09-2019 15:22:00,1,2584.0,2087.0,0.808,12.492,813,49,20,29,764,694,70,0,0.0,0.0
1007,1553,25-09-2019 15:24:00,1,2838.5,2320.5,0.817,13.7535,1222,55,14,41,1167,1069,98,0,0.0,0.0
1007,1554,25-09-2019 15:26:00,1,3093.0,2554.0,0.826,15.015,1244,31,4,27,1213,1100,113,0,0.0,0.0
1007,1555,25-09-2019 15:28:00,1,3170.0,2796.0,0.882,15.584,211,22,4,18,189,158,31,0,0.0,0.0
1007,1556,25-09-2019 15:30:00,1,3377.0,2860.0,0.847,16.471,1035,8,2,6,1027,932,95,0,0.0,0.0
1007,1557,25-09-2019 15:32:00,1,3278.0,2845.0,0.868,16.064,790,7,4,3,783,697,86,0,0.0,0.0
1007,1558,25-09-2019 15:34:00,1,3085.0,2632.0,0.853,15.069,368,4,2,2,364,316,48,0,0.0,0.0
1007,1559,25-09-2019 15:36:00,1,2867.0,2497.0,0.871,14.059,366,0,0,0,366,316,50,0,0.0,0.0
1007,1560,25-09-2019 15:38:00,1,2874.0,2441.0,0.849,14.026,456,0,0,0,456,384,72,0,0.0,0.0
1007,1561,25-09-2019 15:40:00,1,2894.0,2357.0,0.814,14.013,311,2,0,2,309,238,71,0,0.0,0.0
1007,1562,25-09-2019 15:42:00,1,2911.0,2324.0,0.798,14.045,376,0,0,0,376,290,86,0,0.0,0.0
1007,1563,25-09-2019 15:44:00,1,2915.0,2291.0,0.786,14.022,269,7,4,3,262,178,84,0,0.0,0.0
1007,1564,25-09-2019 15:46:00,1,2922.0,2250.0,0.77,14.002,186,3,0,3,183,115,68,0,0.0,0.0
1007,1565,25-09-2019 15:48:00,1,2935.0,2238.0,0.762,14.042,275,12,8,4,263,188,75,0,0.0,0.0
1007,1566,25-09-2019 15:50:00,1,2806.0,2221.0,0.791,13.514,301,0,0,0,301,210,91,0,0.0,0.0
1007,1567,25-09-2019 15:52:00,1,2696.0,2165.0,0.803,13.018,184,2,0,2,182,118,64,0,0.0,0.0
1007,1568,25-09-2019 15:54:00,1,2697.0,2161.0,0.801,13.019,217,0,0,0,217,148,69,0,0.0,0.0
1007,1569,25-09-2019 15:56:00,1,2944.0,2223.0,0.755,14.061,435,2,0,2,433,335,98,0,0.0,0.0
1007,1570,25-09-2019 15:58:00,1,2942.0,2220.0,0.7545,14.049,452,0,0,0,452,338,114,0,0.0,0.0
1007,1571,25-09-2019 16:00:00,1,2940.0,2217.0,0.754,14.037,419,19,7,12,400,324,76,0,0.0,0.0
1007,1572,25-09-2019 16:02:00,1,2825.0,2141.0,0.758,13.502,332,14,0,14,318,273,45,0,0.0,0.0
1007,1573,25-09-2019 16:04:00,1,2821.0,2157.0,0.765,13.504,334,20,6,14,314,275,39,0,0.0,0.0
1007,1574,25-09-2019 16:06:00,1,2938.0,2180.0,0.742,13.99,384,67,51,16,317,246,71,7,0.0,0.0
1007,1575,25-09-2019 16:08:00,1,2915.0,2309.0,0.792,14.04,260,13,1,12,247,179,68,0,0.0,0.0
1007,1576,25-09-2019 16:10:00,1,2989.0,2456.0,0.822,14.495,244,46,19,27,198,149,49,0,0.0,0.0
1007,1577,25-09-2019 16:12:00,1,3406.0,2790.0,0.819,16.507,280,13,5,8,267,196,71,1,0.0,0.0
1007,1578,25-09-2019 16:14:00,1,3096.0,2610.0,0.843,15.089,393,31,16,15,362,283,79,17,0.0,0.0
1007,1579,25-09-2019 16:16:00,1,3179.0,2681.0,0.843,15.493,202,33,18,15,169,105,64,46,0.0,0.0
1007,1580,25-09-2019 16:18:00,1,3629.0,2937.0,0.809,17.549,264,89,47,42,175,112,63,56,0.0,0.0
1007,1581,25-09-2019 16:20:00,1,3600.0,3022.0,0.839,17.531,217,45,25,20,172,102,70,64,0.0,0.0
1007,1582,25-09-2019 16:22:00,1,3583.0,3049.0,0.851,17.493,242,45,34,11,197,118,79,60,0.0,0.08
1007,1583,25-09-2019 16:24:00,1,3936.0,3174.0,0.806,19.025,434,167,131,36,267,190,77,77,0.0,0.05
1007,1584,25-09-2019 16:26:00,1,3939.0,3164.0,0.803,19.024,482,192,136,56,290,216,74,12,0.03,0.0
1007,1585,25-09-2019 16:28:00,1,3678.0,3137.0,0.853,17.965,667,290,238,52,377,290,87,13,0.0,0.0
1007,1586,25-09-2019 16:30:00,1,3179.0,2718.0,0.855,15.533,193,69,49,20,124,71,53,20,0.0,0.0
1007,1587,25-09-2019 16:32:00,1,3552.5,2997.5,0.845,17.3145,430,160,115,45,270,198,72,3,0.0,0.0
1007,1588,25-09-2019 16:34:00,1,3926.0,3277.0,0.835,19.096,434,152,117,35,282,199,83,0,0.11,0.0
1007,1589,25-09-2019 16:36:00,1,3682.0,3183.0,0.865,18.03,293,161,112,49,132,71,61,0,0.0,0.0
1007,1590,25-09-2019 16:38:00,1,3617.0,2989.0,0.827,17.559,81,1,0,1,80,25,55,0,0.0,0.0
1007,1591,25-09-2019 16:40:00,1,3607.0,2987.0,0.828,17.518,246,71,41,30,175,117,58,0,0.0,0.0
1007,1592,25-09-2019 16:42:00,1,3693.0,3180.0,0.861,18.072,66,0,0,0,66,20,46,0,0.0,0.0
1007,1593,25-09-2019 16:44:00,1,3594.0,3071.0,0.854,17.56,42,5,0,5,37,0,37,0,0.0,0.0
1007,1594,25-09-2019 16:46:00,1,3369.0,2945.0,0.874,16.533,79,20,0,20,59,17,42,0,0.0,0.0
1007,1595,25-09-2019 16:48:00,1,3392.0,2871.0,0.846,16.541,41,0,0,0,41,4,37,0,0.0,0.0
1007,1596,25-09-2019 16:50:00,1,3162.0,2786.0,0.881,15.544,48,0,0,0,48,7,41,0,0.0,0.0
1007,1597,25-09-2019 16:52:00,1,3032.0,2786.0,0.919,15.03,43,1,0,1,42,0,42,0,0.0,0.0
1007,1598,25-09-2019 16:54:00,1,3051.0,2705.0,0.886,15.017,46,0,0,0,46,3,43,0,0.0,0.0
1007,1599,25-09-2019 16:56:00,1,3052.0,2723.0,0.892,15.037,46,0,0,0,46,2,44,0,0.0,0.0
1007,1600,25-09-2019 16:58:00,1,2946.0,2652.0,0.9,14.543,38,0,0,0,38,0,38,0,0.0,0.0
1007,1601,25-09-2019 17:00:00,1,2825.0,2610.0,0.924,14.019,71,0,0,0,71,31,40,0,0.0,0.0
1007,1602,25-09-2019 17:02:00,1,2843.0,2577.0,0.907,14.054,174,0,0,0,174,117,57,0,0.0,0.0
1007,1603,25-09-2019 17:04:00,1,2831.0,2592.0,0.916,14.021,86,1,1,0,85,37,48,0,0.0,0.0
1007,1604,25-09-2019 17:06:00,1,2919.0,2750.5,0.9415,14.544,101,15,8,7,86,38,48,0,0.0,0.0
1007,1605,25-09-2019 17:08:00,1,3007.0,2909.0,0.967,15.067,72,1,0,1,71,34,37,0,0.0,0.0
1007,1606,25-09-2019 17:10:00,1,3004.0,2928.0,0.975,15.075,48,6,2,4,42,0,42,0,0.0,0.0
1007,1607,25-09-2019 17:12:00,1,3011.0,2853.0,0.947,15.022,83,6,2,4,77,41,36,0,0.0,0.0
1007,1608,25-09-2019 17:14:00,1,2929.0,2717.0,0.927,14.55,101,5,3,2,96,46,50,0,0.0,0.0
1007,1609,25-09-2019 17:16:00,1,2638.0,2376.0,0.901,13.024,212,23,16,7,189,119,70,0,0.0,0.0
1007,1610,25-09-2019 17:18:00,1,2872.0,2456.0,0.855,14.035,187,44,22,22,143,93,50,0,0.0,0.0
1007,1611,25-09-2019 17:20:00,1,3050.0,2740.0,0.898,15.049,185,26,5,21,159,105,54,0,0.0,0.0
1007,1612,25-09-2019 17:22:00,1,3119.0,2913.0,0.934,15.515,235,45,18,27,190,138,52,8,0.0,0.0
1007,1613,25-09-2019 17:24:00,1,3344.0,3053.0,0.913,16.555,169,35,10,25,134,85,49,55,0.0,0.0
1007,1614,25-09-2019 17:26:00,1,3548.0,3254.0,0.917,17.583,255,39,22,17,216,150,66,57,0.0,0.0
1007,1615,25-09-2019 17:28:00,1,3767.0,3357.0,0.891,18.559,198,7,3,4,191,132,59,64,0.0,0.06
1007,1616,25-09-2019 17:30:00,1,3878.0,3360.0,0.866,19.001,292,55,41,14,237,178,59,64,0.0,0.11
1007,1617,25-09-2019 17:32:00,1,3884.0,3403.0,0.876,19.069,642,200,159,41,442,355,87,43,0.06,0.0
1007,1618,25-09-2019 17:34:00,1,3877.0,3387.0,0.874,19.027,192,33,9,24,159,94,65,0,0.0,0.0
1007,1619,25-09-2019 17:36:00,1,3840.0,3529.0,0.919,19.036,184,29,4,25,155,101,54,0,0.0,0.01
1007,1620,25-09-2019 17:38:00,1,3769.0,3328.0,0.883,18.533,225,6,3,3,219,162,57,0,0.0,0.0
1007,1621,25-09-2019 17:40:00,1,3676.0,3235.0,0.88,18.065,116,5,2,3,111,62,49,0,0.0,0.0
1007,1622,25-09-2019 17:42:00,1,3583.0,3142.0,0.877,17.597,98,1,1,0,97,52,45,0,0.0,0.0
1007,1623,25-09-2019 17:44:00,1,3573.0,3128.0,0.876,17.539,78,1,0,1,77,40,37,0,0.0,0.0
1007,1624,25-09-2019 17:46:00,1,3340.0,3039.0,0.91,16.524,141,8,6,2,133,79,54,0,0.0,0.0
1007,1625,25-09-2019 17:48:00,1,3367.0,2960.0,0.879,16.545,127,0,0,0,127,78,49,0,0.0,0.0
1007,1626,25-09-2019 17:50:00,1,3031.0,2841.0,0.937,15.089,127,0,0,0,127,79,48,0,0.0,0.0
1007,1627,25-09-2019 17:52:00,1,3025.0,2810.0,0.929,15.03,109,0,0,0,109,62,47,0,0.0,0.0
1007,1628,25-09-2019 17:54:00,1,3031.0,2787.0,0.919,15.028,82,0,0,0,82,36,46,0,0.0,0.0
1007,1629,25-09-2019 17:56:00,1,3027.0,2826.0,0.934,15.055,73,0,0,0,73,28,45,0,0.0,0.0
1007,1630,25-09-2019 17:58:00,1,3020.0,2874.0,0.952,15.082,131,15,8,7,116,62,54,0,0.0,0.01
1007,1631,25-09-2019 18:00:00,0,3337.0,3041.0,0.911,16.513,524,211,166,45,313,241,72,41,0.0,0.0
1007,1632,25-09-2019 18:02:00,0,3834.0,3578.0,0.933,19.066,660,289,242,47,371,301,70,179,0.0,0.0
1007,1633,25-09-2019 18:04:00,0,3924.0,3760.0,0.958,19.623,466,171,140,31,295,229,66,172,0.0,0.0
1007,1634,25-09-2019 18:06:00,0,3815.0,3652.0,0.957,19.074,257,66,41,25,191,126,65,74,0.0,0.0
1007,1635,25-09-2019 18:08:00,0,4094.0,3968.0,0.969,20.523,243,46,26,20,197,122,75,87,0.0,0.0
1007,1636,25-09-2019 18:10:00,0,4221.0,4016.0,0.951,21.077,155,24,15,9,131,77,54,47,0.0,0.42
1007,1637,25-09-2019 18:12:00,0,4011.0,3852.0,0.96,20.068,247,109,89,20,138,84,54,25,0.09,0.0
1007,1638,25-09-2019 18:14:00,0,4024.5,3836.5,0.953,20.1045,509,215,166,49,294,219,75,94,0.0,0.01
1007,1639,25-09-2019 18:16:00,0,4038.0,3821.0,0.946,20.141,65,13,9,4,52,17,35,1,0.0,0.0
1007,1640,25-09-2019 18:18:00,0,4218.0,3977.0,0.943,21.021,321,160,129,31,161,113,48,14,0.08,0.0
1007,1641,25-09-2019 18:20:00,0,4316.0,4098.0,0.949,21.541,360,107,81,26,253,185,68,39,0.07,0.0
1007,1642,25-09-2019 18:22:00,0,4040.0,3737.0,0.925,20.054,472,199,166,33,273,203,70,34,0.0,0.07
1007,1643,25-09-2019 18:24:00,0,4294.0,4223.0,0.984,21.592,342,84,49,35,258,185,73,11,0.0,0.0
1007,1644,25-09-2019 18:26:00,0,3988.0,3935.0,0.987,20.067,259,134,100,34,125,78,47,74,0.06,0.0
1007,1645,25-09-2019 18:28:00,0,4407.0,4266.0,0.968,22.085,88,30,18,12,58,15,43,0,0.0,0.0
1007,1646,25-09-2019 18:30:00,0,3994.0,3876.0,0.971,20.027,204,76,47,29,128,73,55,0,0.0,0.0
1007,1647,25-09-2019 18:32:00,0,3995.0,3883.0,0.972,20.038,263,27,12,15,236,159,77,0,0.0,0.0
1007,1648,25-09-2019 18:34:00,0,4337.0,4124.0,0.951,21.653,429,83,54,29,346,271,75,19,0.0,0.0
1007,1649,25-09-2019 18:36:00,0,4494.0,4428.0,0.985,22.61,402,83,52,31,319,235,84,4,0.0,0.0
1007,1650,25-09-2019 18:38:00,0,4307.0,4184.0,0.971,21.604,186,85,36,49,101,49,52,10,0.0,0.0
1007,1651,25-09-2019 18:40:00,0,4515.0,4333.0,0.96,22.585,302,99,72,27,203,125,78,81,0.0,0.0
1007,1652,25-09-2019 18:42:00,0,4732.0,4475.0,0.946,23.599,284,69,32,37,215,142,73,66,0.0,0.0
1007,1653,25-09-2019 18:44:00,0,4828.0,4541.0,0.941,24.051,368,132,95,37,236,178,58,34,0.09,0.0
1007,1654,25-09-2019 18:46:00,0,4530.0,4261.0,0.941,22.566,426,145,106,39,281,211,70,64,0.0,0.0
1007,1655,25-09-2019 18:48:00,0,4522.5,4300.0,0.951,22.579,346,84,61,23,262,189,73,57,0.07,0.0
1007,1656,25-09-2019 18:50:00,0,4515.0,4339.0,0.961,22.592,271,77,46,31,194,124,70,56,0.0,0.0
1007,1657,25-09-2019 18:52:00,0,4519.0,4361.0,0.965,22.631,401,111,84,27,290,231,59,75,0.0,0.02
1007,1658,25-09-2019 18:54:00,0,4542.0,4246.0,0.935,22.596,283,66,44,22,217,155,62,76,0.0,0.0
1007,1659,25-09-2019 18:56:00,0,4637.0,4404.0,0.95,23.144,284,68,48,20,216,147,69,89,0.0,0.14
1007,1660,25-09-2019 18:58:00,0,4840.0,4514.0,0.933,24.065,183,47,30,17,136,85,51,72,0.0,0.07
1007,1661,25-09-2019 19:00:00,0,4836.0,4525.0,0.936,24.062,376,97,74,23,279,206,73,42,0.1,0.03
1007,1662,25-09-2019 19:02:00,0,4526.0,4263.0,0.942,22.551,353,139,99,40,214,155,59,26,0.07,0.02
1007,1663,25-09-2019 19:04:00,0,4304.0,4181.0,0.971,21.587,74,12,1,11,62,27,35,0,0.0,0.0
1007,1664,25-09-2019 19:06:00,0,4341.0,4062.0,0.936,21.599,320,159,121,38,161,103,58,3,0.0,0.0
1007,1665,25-09-2019 19:08:00,0,4410.0,4241.0,0.962,22.07,461,171,130,41,290,216,74,12,0.0,0.08
1007,1666,25-09-2019 19:10:00,0,4293.0,4193.0,0.977,21.555,423,111,80,31,312,228,84,22,0.0,0.0
1007,1667,25-09-2019 19:12:00,0,4009.0,3866.0,0.964,20.076,307,81,41,40,226,154,72,0,0.0,0.0
1007,1668,25-09-2019 19:14:00,0,4113.0,3912.0,0.951,20.535,214,58,36,22,156,94,62,0,0.0,0.0
1007,1669,25-09-2019 19:16:00,0,3999.0,3906.0,0.977,20.081,108,34,19,15,74,38,36,0,0.0,0.0
1007,1670,25-09-2019 19:18:00,0,4223.0,4021.0,0.952,21.089,142,47,17,30,95,51,44,0,0.0,0.0
1007,1671,25-09-2019 19:20:00,0,4273.0,4210.0,0.985,21.496,82,36,4,32,46,14,32,0,0.0,0.0
1007,1672,25-09-2019 19:22:00,0,4143.0,4026.0,0.971,20.7795,95,19,2,17,76,36,40,0,0.0,0.0
1007,1673,25-09-2019 19:24:00,0,4013.0,3842.0,0.957,20.063,266,2,1,1,264,216,48,0,0.0,0.0
1007,1674,25-09-2019 19:26:00,0,3941.0,3686.0,0.935,19.61,175,5,0,5,170,134,36,0,0.0,0.0
1007,1675,25-09-2019 19:28:00,0,3937.0,3663.0,0.93,19.566,66,3,1,2,63,14,49,0,0.0,0.0
1007,1676,25-09-2019 19:30:00,0,3738.0,3420.0,0.915,18.513,74,4,0,4,70,32,38,0,0.0,0.0
1007,1677,25-09-2019 19:32:00,0,3749.0,3414.0,0.911,18.553,58,2,0,2,56,9,47,0,0.0,0.0
1007,1678,25-09-2019 19:34:00,0,3630.0,3427.0,0.944,18.098,43,2,0,2,41,0,41,0,0.0,0.0
1007,1679,25-09-2019 19:36:00,0,3500.0,3370.0,0.963,17.521,224,5,2,3,219,170,49,0,0.0,0.0
1007,1680,25-09-2019 19:38:00,0,3614.0,3457.0,0.956,18.067,59,1,0,1,58,21,37,0,0.0,0.0
1007,1681,25-09-2019 19:40:00,0,3535.0,3269.0,0.925,17.547,164,26,10,16,138,96,42,0,0.0,0.0
1007,1682,25-09-2019 19:42:00,0,3542.0,3280.0,0.926,17.585,38,1,0,1,37,0,37,0,0.0,0.0
1007,1683,25-09-2019 19:44:00,0,3325.0,3163.0,0.951,16.604,54,8,5,3,46,3,43,0,0.0,0.0
1007,1684,25-09-2019 19:46:00,0,3311.0,3221.0,0.973,16.609,44,6,3,3,38,0,38,0,0.0,0.0
1007,1685,25-09-2019 19:48:00,0,3306.0,3177.0,0.961,16.541,45,3,1,2,42,6,36,0,0.0,0.0
1007,1686,25-09-2019 19:50:00,0,3318.0,3213.0,0.968,16.632,51,16,8,8,35,0,35,0,0.0,0.0
1007,1687,25-09-2019 19:52:00,0,3318.0,3135.0,0.945,16.542,213,66,31,35,147,92,55,0,0.0,0.0
1007,1688,25-09-2019 19:54:00,0,3506.0,3368.0,0.96,17.542,450,167,126,41,283,212,71,92,0.0,0.0
1007,1689,25-09-2019 19:56:00,0,3672.0,3481.5,0.9485,18.321,471,205,163,42,266,198,68,89,0.0,0.0
1007,1690,25-09-2019 19:58:00,0,3838.0,3595.0,0.937,19.1,384,157,119,38,227,168,59,131,0.0,0.0
1007,1691,25-09-2019 20:00:00,0,4022.0,3806.0,0.946,20.062,271,37,20,17,234,159,75,62,0.0,0.0
1007,1692,25-09-2019 20:02:00,0,3990.0,3926.0,0.984,20.067,263,51,27,24,212,138,74,66,0.0,0.0
1007,1693,25-09-2019 20:04:00,0,4204.0,4064.0,0.967,21.063,278,77,46,31,201,148,53,46,0.01,0.1
1007,1694,25-09-2019 20:06:00,0,3972.0,3984.0,1.003,20.062,556,246,198,48,310,233,77,38,0.09,0.0
1007,1695,25-09-2019 20:08:00,0,3976.0,3981.0,1.001,20.072,501,155,119,36,346,272,74,71,0.02,0.0
1007,1696,25-09-2019 20:10:00,0,3912.0,3719.0,0.951,19.533,238,39,21,18,199,125,74,69,0.01,0.0
1007,1697,25-09-2019 20:12:00,0,4281.0,4218.0,0.985,21.536,274,41,19,22,233,171,62,53,0.01,0.03
1007,1698,25-09-2019 20:14:00,0,4299.0,4242.0,0.987,21.634,472,57,38,19,415,324,91,0,0.12,0.01
1007,1699,25-09-2019 20:16:00,0,4280.0,4224.0,0.987,21.538,569,24,9,15,545,510,35,0,0.0,0.0
1007,1700,25-09-2019 20:18:00,0,4331.0,4070.0,0.94,21.57,435,52,24,28,383,344,39,0,0.0,0.0
1007,1701,25-09-2019 20:20:00,0,4219.0,4027.0,0.955,21.081,484,16,2,14,468,408,60,0,0.0,0.0
1007,1702,25-09-2019 20:22:00,0,4039.0,3784.0,0.937,20.101,510,1,0,1,509,470,39,0,0.0,0.0
1007,1703,25-09-2019 20:24:00,0,3932.0,3673.0,0.934,19.558,383,0,0,0,383,342,41,0,0.0,0.0
1007,1704,25-09-2019 20:26:00,0,3841.0,3555.0,0.926,19.068,494,0,0,0,494,433,61,0,0.0,0.0
1007,1705,25-09-2019 20:28:00,0,3856.0,3491.0,0.905,19.059,401,0,0,0,401,351,50,0,0.0,0.0
1007,1706,25-09-2019 20:30:00,0,3834.0,3567.0,0.9305,19.055,586,73,39,34,513,419,94,9,0.0,0.01
1007,1707,25-09-2019 20:32:00,0,3812.0,3643.0,0.956,19.051,297,93,62,31,204,141,63,30,0.01,0.0
1007,1708,25-09-2019 20:34:00,0,4010.0,3877.0,0.967,20.092,377,194,145,49,183,122,61,66,0.0,0.0
1007,1709,25-09-2019 20:36:00,0,3992.0,3947.0,0.989,20.099,169,52,24,28,117,70,47,50,0.0,0.0
1007,1710,25-09-2019 20:38:00,0,4099.0,4009.0,0.978,20.586,212,37,19,18,175,104,71,56,0.0,0.04
1007,1711,25-09-2019 20:40:00,0,4310.0,4140.0,0.96,21.565,407,77,44,33,330,247,83,40,0.08,0.04
1007,1712,25-09-2019 20:42:00,0,3818.0,3581.0,0.938,19.006,724,215,158,57,509,407,102,9,0.0,0.05
1007,1713,25-09-2019 20:44:00,0,4323.0,4091.0,0.946,21.562,1554,519,413,106,1035,879,156,29,0.0,0.0
1007,1714,25-09-2019 20:46:00,0,4102.0,4006.0,0.977,20.597,1113,359,282,77,754,640,114,0,0.0,0.0
1007,1715,25-09-2019 20:48:00,0,4032.0,3794.0,0.941,20.087,745,269,205,64,476,388,88,17,0.0,0.04
1007,1716,25-09-2019 20:50:00,0,4222.0,4053.0,0.96,21.121,669,277,222,55,392,307,85,57,0.0,0.0
1007,1717,25-09-2019 20:52:00,0,4003.0,3914.0,0.978,20.104,509,190,143,47,319,235,84,55,0.07,0.0
1007,1718,25-09-2019 20:54:00,0,4399.0,4279.0,0.973,22.071,233,44,21,23,189,116,73,68,0.0,0.0
1007,1719,25-09-2019 20:56:00,0,4493.0,4411.0,0.982,22.587,235,43,26,17,192,113,79,71,0.0,0.0
1007,1720,25-09-2019 20:58:00,0,4825.0,4530.0,0.939,24.026,198,31,17,14,167,98,69,64,0.0,0.08
1007,1721,25-09-2019 21:00:00,0,4829.0,4566.0,0.946,24.08,195,33,17,16,162,97,65,68,0.0,0.08
1007,1722,25-09-2019 21:02:00,0,4840.0,4556.0,0.941,24.115,256,34,12,22,222,149,73,56,0.0,0.03
1007,1723,25-09-2019 21:04:00,0,4338.5,4080.0,0.94,21.611,394,127,95,32,267,195,72,34,0.09,0.06
1007,1724,25-09-2019 21:06:00,0,3837.0,3604.0,0.939,19.107,358,143,102,41,215,148,67,14,0.07,0.0
1007,1725,25-09-2019 21:08:00,0,4508.0,4403.0,0.977,22.634,433,159,129,30,274,207,67,9,0.0,0.0
1007,1726,25-09-2019 21:10:00,0,4011.0,3816.0,0.951,20.026,523,220,174,46,303,222,81,25,0.07,0.08
1007,1727,25-09-2019 21:12:00,0,4525.0,4291.0,0.948,22.579,553,222,179,43,331,252,79,7,0.0,0.0
1007,1728,25-09-2019 21:14:00,0,4307.0,4112.0,0.955,21.524,690,310,246,64,380,287,93,4,0.0,0.0
1007,1729,25-09-2019 21:16:00,0,4501.0,4381.0,0.973,22.585,407,127,87,40,280,195,85,20,0.0,0.0
1007,1730,25-09-2019 21:18:00,0,4320.0,4135.0,0.957,21.597,329,70,43,27,259,189,70,8,0.0,0.0
1007,1731,25-09-2019 21:20:00,0,4320.0,4130.0,0.956,21.593,305,53,14,39,252,172,80,0,0.0,0.0
1007,1732,25-09-2019 21:22:00,0,4323.0,4096.0,0.947,21.567,140,27,6,21,113,58,55,0,0.0,0.0
1007,1733,25-09-2019 21:24:00,0,4299.0,4167.0,0.969,21.55,93,28,11,17,65,30,35,0,0.0,0.0
1007,1734,25-09-2019 21:26:00,0,4417.0,4233.0,0.958,22.088,51,13,5,8,38,2,36,0,0.0,0.0
1007,1735,25-09-2019 21:28:00,0,4112.0,3954.0,0.962,20.578,54,0,0,0,54,6,48,0,0.0,0.0
1007,1736,25-09-2019 21:30:00,0,4038.0,3749.0,0.928,20.059,54,1,1,0,53,6,47,0,0.0,0.0
1007,1737,25-09-2019 21:32:00,0,3937.0,3632.0,0.923,19.531,113,1,0,1,112,70,42,0,0.0,0.0
1007,1738,25-09-2019 21:34:00,0,3840.0,3561.0,0.927,19.072,63,11,5,6,52,7,45,0,0.0,0.0
1007,1739,25-09-2019 21:36:00,0,3837.0,3543.0,0.923,19.041,48,0,0,0,48,0,48,0,0.0,0.0
1007,1740,25-09-2019 21:38:00,0,3672.5,3457.5,0.942,18.2975,52,6,3,3,46,0,46,0,0.0,0.0
1007,1741,25-09-2019 21:40:00,0,3508.0,3372.0,0.961,17.554,60,14,1,13,46,0,46,0,0.0,0.0
1007,1742,25-09-2019 21:42:00,0,3511.0,3398.0,0.968,17.593,50,0,0,0,50,2,48,0,0.0,0.0
1007,1743,25-09-2019 21:44:00,0,3376.0,3427.0,1.015,17.094,37,0,0,0,37,0,37,0,0.0,0.0
1007,1744,25-09-2019 21:46:00,0,3376.0,3409.0,1.01,17.073,63,5,3,2,58,9,49,0,0.0,0.0
1007,1745,25-09-2019 21:48:00,0,3377.0,3407.0,1.009,17.078,141,14,12,2,127,76,51,0,0.0,0.0
1007,1746,25-09-2019 21:50:00,0,3406.0,3318.0,0.974,17.092,94,16,10,6,78,30,48,0,0.0,0.0
1007,1747,25-09-2019 21:52:00,0,3197.0,3122.0,0.976,16.053,44,2,1,1,42,0,42,0,0.0,0.0
1007,1748,25-09-2019 21:54:00,0,3103.0,3039.0,0.979,15.591,58,7,3,4,51,4,47,0,0.0,0.0
1007,1749,25-09-2019 21:56:00,0,3207.0,3099.0,0.967,16.065,308,100,59,41,208,137,71,23,0.0,0.0
1007,1750,25-09-2019 21:58:00,0,3591.0,3533.0,0.984,18.061,410,155,119,36,255,193,62,89,0.0,0.0
1007,1751,25-09-2019 22:00:00,0,3712.0,3577.0,0.964,18.585,173,19,4,15,154,92,62,62,0.0,0.0
1007,1752,25-09-2019 22:02:00,0,3672.0,3714.0,1.011,18.579,151,36,20,16,115,59,56,46,0.01,0.02
1007,1753,25-09-2019 22:04:00,0,3879.0,3849.0,0.992,19.545,243,37,17,20,206,124,82,73,0.0,0.06
1007,1754,25-09-2019 22:06:00,0,3851.0,4015.0,1.043,19.619,226,28,12,16,198,124,74,63,0.0,0.14
1007,1755,25-09-2019 22:08:00,0,4068.0,4111.0,1.011,20.579,399,141,100,41,258,194,64,32,0.07,0.0
1007,1756,25-09-2019 22:10:00,0,3873.0,3872.0,1.0,19.546,377,138,97,41,239,172,67,30,0.06,0.0
1007,1757,25-09-2019 22:12:00,0,4012.5,4067.5,1.0135,20.312,364,147,111,36,217,156,61,26,0.0,0.07
1007,1758,25-09-2019 22:14:00,0,4152.0,4263.0,1.027,21.078,232,26,18,8,206,133,73,76,0.0,0.19
1007,1759,25-09-2019 22:16:00,0,4165.0,4245.0,1.019,21.107,45,0,0,0,45,2,43,0,0.0,0.01
1007,1760,25-09-2019 22:18:00,0,4184.0,4113.0,0.983,21.038,165,41,28,13,124,65,59,0,0.09,0.0
1007,1761,25-09-2019 22:20:00,0,4162.0,4216.0,1.013,21.064,527,246,199,47,281,212,69,4,0.05,0.0
1007,1762,25-09-2019 22:22:00,0,3858.0,3952.0,1.024,19.577,547,245,185,60,302,237,65,35,0.0,0.0
1007,1763,25-09-2019 22:24:00,0,4186.0,4080.0,0.975,21.012,631,287,218,69,344,265,79,50,0.01,0.03
1007,1764,25-09-2019 22:26:00,0,4391.0,4354.0,0.992,22.121,518,230,176,54,288,218,70,35,0.11,0.0
1007,1765,25-09-2019 22:28:00,0,4182.0,4123.0,0.986,21.04,1148,460,357,103,688,573,115,18,0.0,0.0
1007,1766,25-09-2019 22:30:00,0,4579.0,4523.0,0.988,23.05,1330,621,486,135,709,585,124,28,0.0,0.0
1007,1767,25-09-2019 22:32:00,0,4474.0,4481.0,1.002,22.586,1006,376,292,84,630,505,125,7,0.0,0.0
1007,1768,25-09-2019 22:34:00,0,4589.0,4531.0,0.987,23.095,599,249,190,59,350,277,73,2,0.0,0.0
1007,1769,25-09-2019 22:36:00,0,4386.0,4389.0,1.001,22.14,169,56,35,21,113,59,54,0,0.0,0.0
1007,1770,25-09-2019 22:38:00,0,4697.0,4573.0,0.974,23.567,436,128,98,30,308,237,71,70,0.1,0.0
1007,1771,25-09-2019 22:40:00,0,4715.0,4558.0,0.967,23.625,541,202,157,45,339,265,74,9,0.0,0.0
1007,1772,25-09-2019 22:42:00,0,4370.0,4370.0,1.0,22.057,483,155,114,41,328,243,85,7,0.0,0.0
1007,1773,25-09-2019 22:44:00,0,4277.0,4294.0,1.004,21.605,371,165,120,45,206,141,65,0,0.0,0.0
1007,1774,25-09-2019 22:46:00,0,4335.0,4300.5,0.992,21.8405,519,226,166,60,293,209,84,6,0.0,0.0
1007,1775,25-09-2019 22:48:00,0,4393.0,4307.0,0.98,22.076,154,41,7,34,113,47,66,1,0.0,0.0
1007,1776,25-09-2019 22:50:00,0,4286.0,4258.0,0.993,21.6,462,207,160,47,255,190,65,0,0.0,0.0
1007,1777,25-09-2019 22:52:00,0,4381.0,4376.0,0.999,22.107,242,54,19,35,188,121,67,0,0.0,0.0
1007,1778,25-09-2019 22:54:00,0,4385.0,4324.0,0.986,22.062,194,34,16,18,160,100,60,0,0.0,0.0
1007,1779,25-09-2019 22:56:00,0,4277.0,4281.0,1.001,21.589,83,16,9,7,67,12,55,0,0.0,0.0
1007,1780,25-09-2019 22:58:00,0,4383.0,4315.0,0.985,22.047,141,45,19,26,96,38,58,0,0.0,0.0
1007,1781,25-09-2019 23:00:00,0,4277.0,4269.0,0.998,21.578,347,127,88,39,220,150,70,4,0.0,0.0
1007,1782,25-09-2019 23:02:00,0,4405.0,4290.0,0.974,22.105,638,253,206,47,385,296,89,34,0.0,0.0
1007,1783,25-09-2019 23:04:00,0,4393.0,4293.0,0.977,22.062,477,210,167,43,267,190,77,11,0.0,0.0
1007,1784,25-09-2019 23:06:00,0,4397.0,4304.0,0.979,22.088,351,48,33,15,303,241,62,9,0.0,0.01
1007,1785,25-09-2019 23:08:00,0,3979.0,3999.0,1.005,20.104,129,0,0,0,129,75,54,0,0.0,0.0
1007,1786,25-09-2019 23:10:00,0,3904.0,3756.0,0.962,19.538,97,2,2,0,95,33,62,0,0.0,0.0
1007,1787,25-09-2019 23:12:00,0,3701.0,3582.0,0.968,18.549,119,0,0,0,119,57,62,0,0.0,0.0
1007,1788,25-09-2019 23:14:00,0,3620.0,3455.0,0.955,18.086,74,0,0,0,74,23,51,0,0.0,0.0
1007,1789,25-09-2019 23:16:00,0,3384.0,3356.0,0.992,17.048,70,0,0,0,70,26,44,0,0.0,0.0
1007,1790,25-09-2019 23:18:00,0,3398.0,3314.0,0.975,17.057,75,0,0,0,75,26,49,0,0.0,0.0
1007,1791,25-09-2019 23:20:00,0,3287.5,3238.0,0.985,16.5385,187,2,0,2,185,126,59,0,0.0,0.0
1007,1792,25-09-2019 23:22:00,0,3177.0,3162.0,0.995,16.02,136,0,0,0,136,84,52,0,0.0,0.0
1007,1793,25-09-2019 23:24:00,0,3299.0,3191.0,0.967,16.532,131,21,9,12,110,59,51,0,0.0,0.0
1007,1794,25-09-2019 23:26:00,0,3413.0,3270.0,0.958,17.066,69,14,7,7,55,13,42,0,0.0,0.0
1007,1795,25-09-2019 23:28:00,0,3414.0,3274.0,0.959,17.077,361,318,277,41,43,2,41,0,0.0,0.0
1007,1796,25-09-2019 23:30:00,0,3168.0,3190.0,1.007,16.014,109,37,11,26,72,24,48,0,0.0,0.0
1007,1797,25-09-2019 23:32:00,0,3194.0,3134.0,0.981,16.054,85,46,7,39,39,1,38,0,0.0,0.0
1007,1798,25-09-2019 23:34:00,0,3102.0,3064.0,0.988,15.615,74,34,0,34,40,0,40,0,0.0,0.0
1007,1799,25-09-2019 23:36:00,0,2862.0,2984.0,1.043,14.58,131,56,27,29,75,24,51,0,0.0,0.0
1007,1800,25-09-2019 23:38:00,0,2856.0,2963.0,1.037,14.531,83,17,0,17,66,17,49,0,0.0,0.0
1007,1801,25-09-2019 23:40:00,0,2908.0,2819.0,0.969,14.576,91,14,0,14,77,20,57,0,0.0,0.0
1007,1802,25-09-2019 23:42:00,0,2894.0,2842.0,0.982,14.548,94,21,5,16,73,29,44,0,0.0,0.0
1007,1803,25-09-2019 23:44:00,0,2903.0,2811.0,0.968,14.549,144,55,42,13,89,45,44,3,0.0,0.0
1007,1804,25-09-2019 23:46:00,0,2845.0,3025.0,1.064,14.556,60,1,0,1,59,14,45,0,0.0,0.0
1007,1805,25-09-2019 23:48:00,0,3087.0,3084.0,0.999,15.577,48,3,1,2,45,8,37,0,0.0,0.0
1007,1806,25-09-2019 23:50:00,0,3189.0,3189.0,1.0,16.094,61,3,0,3,58,2,56,0,0.0,0.0
1007,1807,25-09-2019 23:52:00,0,3181.0,3189.0,1.003,16.062,51,5,3,2,46,7,39,0,0.0,0.0
1007,1808,25-09-2019 23:54:00,0,3133.0,3140.5,1.0025,15.821,159,60,44,16,99,49,50,4,0.0,0.0
1007,1809,25-09-2019 23:56:00,0,3085.0,3092.0,1.002,15.58,67,4,3,1,63,22,41,0,0.0,0.0
1007,1810,25-09-2019 23:58:00,0,2874.0,2895.0,1.008,14.528,37,0,0,0,37,0,37,0,0.0,0.0
1007,1811,26-09-2019 00:00:00,0,2890.0,2893.0,1.001,14.589,43,0,0,0,43,0,43,0,0.0,0.0
1007,1812,26-09-2019 00:02:00,0,2879.0,2896.0,1.006,14.55,72,12,6,6,60,13,47,0,0.0,0.0
1007,1813,26-09-2019 00:04:00,0,2868.0,2971.0,1.036,14.589,290,82,50,32,208,139,69,15,0.0,0.0
1007,1814,26-09-2019 00:06:00,0,3178.0,3182.0,1.001,16.044,244,37,13,24,207,130,77,0,0.0,0.0
1007,1815,26-09-2019 00:08:00,0,3401.0,3326.0,0.978,17.081,216,67,30,37,149,92,57,0,0.0,0.0
1007,1816,26-09-2019 00:10:00,0,3693.0,3616.0,0.979,18.555,138,58,35,23,80,41,39,0,0.0,0.0
1007,1817,26-09-2019 00:12:00,0,3669.0,3747.0,1.021,18.605,334,112,72,40,222,163,59,68,0.0,0.0
1007,1818,26-09-2019 00:14:00,0,3845.0,3970.0,1.032,19.542,476,138,112,26,338,255,83,77,0.0,0.0
1007,1819,26-09-2019 00:16:00,0,3848.0,3989.0,1.037,19.576,310,74,56,18,236,165,71,88,0.0,0.0
1007,1820,26-09-2019 00:18:00,0,3966.0,4054.0,1.022,20.112,421,149,99,50,272,205,67,24,0.03,0.0
1007,1821,26-09-2019 00:20:00,0,3852.0,3985.0,1.035,19.586,274,65,39,26,209,137,72,72,0.0,0.0
1007,1822,26-09-2019 00:22:00,0,4171.0,4167.0,0.999,21.046,270,33,17,16,237,160,77,74,0.0,0.02
1007,1823,26-09-2019 00:24:00,0,4399.0,4335.0,0.986,22.13,239,55,28,27,184,118,66,71,0.0,0.1
1007,1824,26-09-2019 00:26:00,0,4381.0,4365.0,0.996,22.095,269,66,47,19,203,142,61,58,0.08,0.07
1007,1825,26-09-2019 00:28:00,0,4283.5,4269.5,0.9965,21.604,637,246,196,50,391,302,89,96,0.0,0.01
1007,1826,26-09-2019 00:30:00,0,4186.0,4174.0,0.997,21.113,675,262,206,56,413,320,93,72,0.1,0.05
1007,1827,26-09-2019 00:32:00,0,4586.0,4528.0,0.987,23.08,583,251,211,40,332,251,81,70,0.0,0.0
1007,1828,26-09-2019 00:34:00,0,3904.0,3771.0,0.966,19.557,449,157,113,44,292,223,69,37,0.0,0.0
1007,1829,26-09-2019 00:36:00,0,4401.0,4255.0,0.967,22.049,476,172,135,37,304,237,67,66,0.09,0.0
1007,1830,26-09-2019 00:38:00,0,4591.0,4501.0,0.98,23.072,302,128,77,51,174,120,54,9,0.0,0.0
1007,1831,26-09-2019 00:40:00,0,4298.0,4228.0,0.984,21.616,295,116,55,61,179,106,73,0,0.0,0.0
1007,1832,26-09-2019 00:42:00,0,4201.0,4108.0,0.978,21.101,165,21,6,15,144,95,49,0,0.0,0.0
1007,1833,26-09-2019 00:44:00,0,4111.0,3944.0,0.959,20.565,407,150,111,39,257,193,64,8,0.0,0.0
1007,1834,26-09-2019 00:46:00,0,4372.0,4406.0,1.008,22.104,384,95,69,26,289,221,68,60,0.0,0.0
1007,1835,26-09-2019 00:48:00,0,4680.0,4628.0,0.989,23.564,239,60,36,24,179,120,59,92,0.0,0.0
1007,1836,26-09-2019 00:50:00,0,4669.0,4689.0,1.004,23.587,298,64,33,31,234,184,50,74,0.0,0.0
1007,1837,26-09-2019 00:52:00,0,4668.0,4646.0,0.995,23.535,283,64,39,25,219,150,69,44,0.07,0.1
1007,1838,26-09-2019 00:54:00,0,4388.0,4336.0,0.988,22.09,219,79,55,24,140,96,44,0,0.0,0.0
1007,1839,26-09-2019 00:56:00,0,4210.0,4086.0,0.971,21.109,391,174,137,37,217,160,57,35,0.0,0.12
1007,1840,26-09-2019 00:58:00,0,4183.0,4134.0,0.988,21.058,603,194,149,45,409,316,93,7,0.0,0.0
1007,1841,26-09-2019 01:00:00,0,4490.0,4426.0,0.986,22.59,414,170,124,46,244,173,71,24,0.07,0.0
1007,1842,26-09-2019 01:02:00,0,4342.0,4273.5,0.984,21.838,297,88,55,33,209,146,63,24,0.0,0.0
1007,1843,26-09-2019 01:04:00,0,4194.0,4121.0,0.982,21.086,518,175,121,54,343,271,72,19,0.0,0.0
1007,1844,26-09-2019 01:06:00,0,4729.0,4498.0,0.951,23.613,573,181,133,48,392,314,78,49,0.0,0.0
1007,1845,26-09-2019 01:08:00,0,4599.0,4434.0,0.964,23.03,422,69,35,34,353,284,69,42,0.0,0.0
1007,1846,26-09-2019 01:10:00,0,4383.0,4318.0,0.985,22.049,119,41,13,28,78,35,43,0,0.0,0.0
1007,1847,26-09-2019 01:12:00,0,3984.0,3943.0,0.99,20.062,152,5,3,2,147,98,49,0,0.0,0.0
1007,1848,26-09-2019 01:14:00,0,3922.0,3738.0,0.953,19.59,427,20,4,16,407,340,67,0,0.0,0.0
1007,1849,26-09-2019 01:16:00,0,3834.0,3606.0,0.94,19.098,43,0,0,0,43,15,28,0,0.0,0.0
1007,1850,26-09-2019 01:18:00,0,3741.0,3443.0,0.92,18.552,345,0,0,0,345,286,59,0,0.0,0.0
1007,1851,26-09-2019 01:20:00,0,3722.0,3495.0,0.939,18.532,263,0,0,0,263,206,57,0,0.0,0.0
1007,1852,26-09-2019 01:22:00,0,3720.0,3486.0,0.937,18.517,62,0,0,0,62,22,40,0,0.0,0.0
1007,1853,26-09-2019 01:24:00,0,3414.0,3259.0,0.955,17.061,194,29,17,12,165,115,50,0,0.0,0.0
1007,1854,26-09-2019 01:26:00,0,3514.0,3385.0,0.963,17.593,311,76,37,39,235,189,46,5,0.0,0.0
1007,1855,26-09-2019 01:28:00,0,3685.0,3666.0,0.995,18.578,342,94,59,35,248,195,53,47,0.0,0.0
1007,1856,26-09-2019 01:30:00,0,3889.0,3836.0,0.987,19.569,391,126,85,41,265,216,49,42,0.0,0.0
1007,1857,26-09-2019 01:32:00,0,3851.0,4014.0,1.042,19.616,635,207,162,45,428,355,73,71,0.0,0.0
1007,1858,26-09-2019 01:34:00,0,3891.0,3801.0,0.977,19.538,501,178,132,46,323,276,47,55,0.0,0.0
1007,1859,26-09-2019 01:36:00,0,3892.0,3814.5,0.98,19.556,510,171,126,45,339,269,70,50,0.0,0.0
1007,1860,26-09-2019 01:38:00,0,3893.0,3828.0,0.983,19.574,379,73,44,29,306,247,59,35,0.0,0.0
1007,1861,26-09-2019 01:40:00,0,3905.0,3738.0,0.957,19.525,264,56,27,29,208,158,50,0,0.0,0.0
1007,1862,26-09-2019 01:42:00,0,3902.0,3824.0,0.98,19.608,209,65,37,28,144,108,36,0,0.0,0.0
1007,1863,26-09-2019 01:44:00,0,3907.0,3775.0,0.966,19.575,21,0,0,0,21,0,21,0,0.0,0.0
1007,1864,26-09-2019 01:46:00,0,3709.0,3610.0,0.973,18.609,16,1,0,1,15,2,13,0,0.0,0.0
1007,1865,26-09-2019 01:48:00,0,3491.0,3390.0,0.971,17.508,62,5,3,2,57,26,31,0,0.0,0.0
1007,1866,26-09-2019 01:50:00,0,3393.0,3312.0,0.976,17.035,14,1,1,0,13,0,13,0,0.0,0.0
1007,1867,26-09-2019 01:52:00,0,3432.0,3185.0,0.928,17.046,17,0,0,0,17,2,15,0,0.0,0.0
1007,1868,26-09-2019 01:54:00,0,3213.0,3088.0,0.961,16.079,32,1,0,1,31,0,31,0,0.0,0.0
1007,1869,26-09-2019 01:56:00,0,3220.0,3036.0,0.943,16.049,42,3,0,3,39,12,27,0,0.0,0.0
1007,1870,26-09-2019 01:58:00,0,2979.0,2978.0,0.999,15.035,58,2,0,2,56,20,36,0,0.0,0.0
1007,1871,26-09-2019 02:00:00,0,2866.0,2948.0,1.029,14.557,42,10,7,3,32,6,26,0,0.0,0.0
1007,1872,26-09-2019 02:02:00,0,2919.0,2772.0,0.95,14.571,187,16,9,7,171,119,52,0,0.0,0.0
1007,1873,26-09-2019 02:04:00,0,2924.0,2734.0,0.935,14.545,146,0,0,0,146,119,27,0,0.0,0.0
1007,1874,26-09-2019 02:06:00,0,2924.0,2718.0,0.93,14.529,229,0,0,0,229,174,55,0,0.0,0.0
1007,1875,26-09-2019 02:08:00,0,2806.0,2716.0,0.968,14.062,260,18,10,8,242,184,58,0,0.0,0.0
1007,1876,26-09-2019 02:10:00,0,2865.0,2733.0,0.954,14.3125,45,1,0,1,44,21,23,0,0.0,0.0
1007,1877,26-09-2019 02:12:00,0,2924.0,2750.0,0.94,14.563,16,2,0,2,14,0,14,0,0.0,0.0
1007,1878,26-09-2019 02:14:00,0,2913.0,2782.0,0.955,14.557,16,0,0,0,16,4,12,0,0.0,0.0
1007,1879,26-09-2019 02:16:00,0,2915.0,2763.0,0.948,14.545,245,2,1,1,243,208,35,0,0.0,0.0
1007,1880,26-09-2019 02:18:00,0,2897.0,2825.0,0.975,14.542,282,37,17,20,245,188,57,0,0.0,0.0
1007,1881,26-09-2019 02:20:00,0,3404.0,3265.0,0.959,17.028,222,68,26,42,154,120,34,0,0.0,0.0
1007,1882,26-09-2019 02:22:00,0,3741.0,3484.0,0.931,18.598,436,141,109,32,295,251,44,47,0.0,0.0
1007,1883,26-09-2019 02:24:00,0,3607.0,3458.0,0.959,18.04,299,62,49,13,237,186,51,25,0.0,0.0
1007,1884,26-09-2019 02:26:00,0,3399.0,3314.0,0.975,17.06,58,0,0,0,58,39,19,0,0.0,0.0
1007,1885,26-09-2019 02:28:00,0,3430.0,3180.0,0.927,17.036,53,6,2,4,47,27,20,0,0.0,0.0
1007,1886,26-09-2019 02:30:00,0,3213.0,3114.0,0.969,16.107,26,0,0,0,26,23,3,0,0.0,0.0
1007,1887,26-09-2019 02:32:00,0,3223.0,3044.0,0.944,16.067,6,1,0,1,5,2,3,0,0.0,0.0
1007,1888,26-09-2019 02:34:00,0,2886.0,2907.0,1.007,14.59,103,10,3,7,93,81,12,0,0.0,0.0
1007,1889,26-09-2019 02:36:00,0,2885.0,2878.0,0.998,14.552,306,56,28,28,250,219,31,63,0.0,0.0
1007,1890,26-09-2019 02:38:00,0,3434.0,3174.0,0.924,17.044,269,50,20,30,219,204,15,67,0.0,0.0
1007,1891,26-09-2019 02:40:00,0,3724.0,3464.0,0.93,18.507,354,66,28,38,288,271,17,77,0.0,0.0
1007,1892,26-09-2019 02:42:00,0,3936.0,3656.0,0.929,19.556,328,53,21,32,275,251,24,66,0.0,0.0
1007,1893,26-09-2019 02:44:00,0,3928.5,3677.0,0.936,19.549,548,166,124,42,382,337,45,57,0.0,0.03
1007,1894,26-09-2019 02:46:00,0,3921.0,3698.0,0.943,19.542,414,152,111,41,262,207,55,62,0.01,0.0
1007,1895,26-09-2019 02:48:00,0,3937.0,3666.0,0.931,19.572,231,52,28,24,179,145,34,51,0.18,0.0
1007,1896,26-09-2019 02:50:00,0,3884.0,3868.0,0.996,19.584,262,46,18,28,216,172,44,41,0.0,0.01
1007,1897,26-09-2019 02:52:00,0,3923.0,3755.0,0.957,19.612,392,134,104,30,258,198,60,23,0.0,0.0
1007,1898,26-09-2019 02:54:00,0,3646.0,3359.0,0.921,18.084,517,214,160,54,303,245,58,15,0.0,0.08
1007,1899,26-09-2019 02:56:00,0,3923.0,3702.0,0.944,19.554,533,189,142,47,344,285,59,26,0.04,0.0
1007,1900,26-09-2019 02:58:00,0,3936.0,3680.0,0.935,19.583,467,146,105,41,321,255,66,8,0.0,0.0
1007,1901,26-09-2019 03:00:00,0,3822.0,3619.0,0.947,19.068,612,198,160,38,414,355,59,42,0.0,0.0
1007,1902,26-09-2019 03:02:00,0,4193.0,4083.0,0.974,21.041,323,55,26,29,268,200,68,1,0.0,0.0
1007,1903,26-09-2019 03:04:00,0,3883.0,3846.0,0.99,19.556,480,18,4,14,462,381,81,0,0.0,0.0
1007,1904,26-09-2019 03:06:00,0,3737.0,3490.0,0.934,18.589,241,12,2,10,229,164,65,0,0.0,0.0
1007,1905,26-09-2019 03:08:00,0,3736.0,3476.0,0.931,18.567,332,33,8,25,299,235,64,1,0.0,0.0
1007,1906,26-09-2019 03:10:00,0,3732.0,3497.0,0.937,18.576,243,7,5,2,236,188,48,0,0.0,0.0
1007,1907,26-09-2019 03:12:00,0,3413.0,3204.0,0.939,16.995,39,0,0,0,39,13,26,0,0.0,0.0
1007,1908,26-09-2019 03:14:00,0,3475.0,3100.0,0.892,17.122,6,0,0,0,6,0,6,0,0.0,0.0
1007,1909,26-09-2019 03:16:00,0,3459.0,3102.0,0.897,17.064,52,0,0,0,52,39,13,0,0.0,0.0
1007,1910,26-09-2019 03:18:00,0,3433.5,3181.0,0.927,17.0505,111,0,0,0,111,94,17,0,0.0,0.0
1007,1911,26-09-2019 03:20:00,0,3408.0,3260.0,0.957,17.037,263,0,0,0,263,222,41,0,0.0,0.0
1007,1912,26-09-2019 03:22:00,0,3418.0,3204.0,0.937,17.012,464,108,76,32,356,274,82,3,0.0,0.0
1007,1913,26-09-2019 03:24:00,0,3401.0,3301.0,0.97,17.054,518,161,108,53,357,292,65,40,0.0,0.0
1007,1914,26-09-2019 03:26:00,0,3510.0,3371.0,0.96,17.561,429,140,97,43,289,229,60,62,0.0,0.0
1007,1915,26-09-2019 03:28:00,0,3500.0,3371.0,0.963,17.522,335,111,70,41,224,177,47,28,0.0,0.0
1007,1916,26-09-2019 03:30:00,0,3519.0,3351.0,0.952,17.577,283,55,35,20,228,180,48,19,0.0,0.0
1007,1917,26-09-2019 03:32:00,0,3403.0,3253.0,0.956,17.011,302,34,13,21,268,230,38,57,0.0,0.0
1007,1918,26-09-2019 03:34:00,0,3722.0,3534.0,0.95,18.575,274,39,12,27,235,191,44,69,0.0,0.0
1007,1919,26-09-2019 03:36:00,0,3940.0,3666.0,0.93,19.584,264,47,20,27,217,173,44,61,0.0,0.0
1007,1920,26-09-2019 03:38:00,0,3893.0,3827.0,0.983,19.577,320,47,18,29,273,219,54,56,0.0,0.0
1007,1921,26-09-2019 03:40:00,0,4125.0,3905.0,0.947,20.574,274,40,13,27,234,178,56,64,0.0,0.0
1007,1922,26-09-2019 03:42:00,0,4230.0,3993.0,0.944,21.087,418,157,114,43,261,216,45,26,0.0,0.1
1007,1923,26-09-2019 03:44:00,0,3927.0,3705.0,0.944,19.575,451,170,132,38,281,243,38,26,0.09,0.01
1007,1924,26-09-2019 03:46:00,0,4132.0,3916.0,0.948,20.615,1138,470,374,96,668,574,94,23,0.0,0.02
1007,1925,26-09-2019 03:48:00,0,4129.0,3889.0,0.942,20.572,1257,501,388,113,756,640,116,20,0.0,0.0
1007,1926,26-09-2019 03:50:00,0,3899.0,3819.0,0.98,19.588,777,316,255,61,461,372,89,12,0.0,0.0
1007,1927,26-09-2019 03:52:00,0,3911.0,3727.5,0.9535,19.5355,747,234,186,48,513,429,84,69,0.05,0.0
1007,1928,26-09-2019 03:54:00,0,3923.0,3636.0,0.927,19.483,426,152,106,46,274,233,41,12,0.0,0.0
1007,1929,26-09-2019 03:56:00,0,3904.0,3830.0,0.981,19.621,408,92,57,35,316,259,57,54,0.0,0.0
1007,1930,26-09-2019 03:58:00,0,4196.0,4076.0,0.971,21.043,224,49,30,19,175,131,44,1,0.0,0.0
1007,1931,26-09-2019 04:00:00,0,3901.0,3776.0,0.968,19.548,192,92,58,34,100,65,35,0,0.0,0.0
1007,1932,26-09-2019 04:02:00,0,3947.0,3694.0,0.936,19.64,207,45,9,36,162,131,31,0,0.0,0.0
1007,1933,26-09-2019 04:04:00,0,3909.0,3707.0,0.948,19.507,68,22,4,18,46,32,14,0,0.0,0.0
1007,1934,26-09-2019 04:06:00,0,3961.0,3610.0,0.911,19.602,24,12,0,12,12,4,8,0,0.0,0.0
1007,1935,26-09-2019 04:08:00,0,3734.0,3448.0,0.923,18.531,9,1,0,1,8,2,6,0,0.0,0.0
1007,1936,26-09-2019 04:10:00,0,3782.0,3321.0,0.878,18.577,21,11,0,11,10,2,8,0,0.0,0.0
1007,1937,26-09-2019 04:12:00,0,3427.0,3186.0,0.93,17.029,2,1,0,1,1,0,1,0,0.0,0.0
1007,1938,26-09-2019 04:14:00,0,3436.0,3148.0,0.916,17.023,3,0,0,0,3,0,3,0,0.0,0.0
1007,1939,26-09-2019 04:16:00,0,3445.0,3127.0,0.908,17.034,40,14,8,6,26,19,7,0,0.0,0.0
1007,1940,26-09-2019 04:18:00,0,3446.0,3163.0,0.918,17.08,0,0,0,0,0,0,0,0,0.0,0.0
1007,1941,26-09-2019 04:20:00,0,3455.0,3121.0,0.903,17.066,95,33,19,14,62,55,7,0,0.0,0.0
1007,1942,26-09-2019 04:22:00,0,3222.0,3056.0,0.948,16.079,68,18,9,9,50,43,7,0,0.0,0.0
1007,1943,26-09-2019 04:24:00,0,2903.0,2811.0,0.968,14.548,17,3,0,3,14,8,6,0,0.01,0.0
1007,1944,26-09-2019 04:26:00,0,2863.5,2715.5,0.9475,14.288,42,1,0,1,41,31,10,0,0.0,0.0
1007,1945,26-09-2019 04:28:00,0,2824.0,2620.0,0.927,14.028,21,0,0,0,21,10,11,0,0.0,0.0
1007,1946,26-09-2019 04:30:00,0,2823.0,2627.0,0.931,14.03,21,4,1,3,17,15,2,0,0.0,0.0
1007,1947,26-09-2019 04:32:00,0,2819.0,2659.0,0.943,14.051,38,8,0,8,30,20,10,0,0.0,0.0
1007,1948,26-09-2019 04:34:00,0,2809.0,2680.0,0.954,14.036,31,2,1,1,29,16,13,0,0.0,0.0
1007,1949,26-09-2019 04:36:00,0,2790.0,2734.0,0.98,14.021,247,0,0,0,247,214,33,0,0.0,0.0
1007,1950,26-09-2019 04:38:00,0,2804.0,2689.0,0.959,14.027,41,10,6,4,31,23,8,0,0.0,0.0
1007,1951,26-09-2019 04:40:00,0,2802.0,2766.0,0.987,14.101,255,56,28,28,199,162,37,0,0.0,0.0
1007,1952,26-09-2019 04:42:00,0,3122.0,2951.0,0.945,15.568,219,57,27,30,162,146,16,2,0.0,0.0
1007,1953,26-09-2019 04:44:00,0,3321.0,3110.0,0.936,16.526,353,110,77,33,243,192,51,43,0.0,0.0
1007,1954,26-09-2019 04:46:00,0,3670.0,3263.0,0.889,18.073,537,149,113,36,388,333,55,93,0.0,0.0
1007,1955,26-09-2019 04:48:00,0,3640.0,3365.0,0.925,18.066,352,40,14,26,312,260,52,71,0.0,0.0
1007,1956,26-09-2019 04:50:00,0,3852.0,3486.0,0.905,19.037,385,75,37,38,310,260,50,69,0.0,0.0
1007,1957,26-09-2019 04:52:00,0,3809.0,3690.0,0.969,19.091,375,69,32,37,306,274,32,73,0.0,0.0
1007,1958,26-09-2019 04:54:00,0,4134.0,3851.0,0.932,20.553,284,34,16,18,250,205,45,76,0.0,0.14
1007,1959,26-09-2019 04:56:00,0,4144.0,3858.0,0.931,20.6,496,134,103,31,362,294,68,52,0.08,0.05
1007,1960,26-09-2019 04:58:00,0,3789.0,3718.0,0.981,19.043,690,255,202,53,435,362,73,21,0.04,0.08
1007,1961,26-09-2019 05:00:00,0,3721.5,3534.0,0.949,18.574,605,214,169,45,391,311,80,29,0.05,0.0
1007,1962,26-09-2019 05:02:00,0,3654.0,3350.0,0.917,18.105,768,339,269,70,429,345,84,27,0.0,0.0
1007,1963,26-09-2019 05:04:00,0,3895.0,3808.0,0.978,19.562,481,66,40,26,415,375,40,46,0.1,0.0
1007,1964,26-09-2019 05:06:00,0,3805.0,3626.0,0.953,19.007,825,17,8,9,808,761,47,0,0.0,0.0
1007,1965,26-09-2019 05:08:00,0,3823.0,3638.0,0.952,19.092,739,4,0,4,735,692,43,0,0.0,0.0
1007,1966,26-09-2019 05:10:00,0,3834.0,3538.0,0.923,19.024,41,0,0,0,41,37,4,0,0.0,0.0
1007,1967,26-09-2019 05:12:00,0,3629.0,3436.0,0.947,18.102,4,2,0,2,2,2,0,0,0.0,0.0
1007,1968,26-09-2019 05:14:00,0,3631.0,3386.0,0.933,18.053,494,153,107,46,341,306,35,18,0.0,0.0
1007,1969,26-09-2019 05:16:00,0,3786.0,3755.0,0.992,19.072,192,41,18,23,151,116,35,7,0.0,0.0
1007,1970,26-09-2019 05:18:00,0,3625.0,3489.0,0.962,18.147,25,4,1,3,21,14,7,0,0.0,0.0
1007,1971,26-09-2019 05:20:00,0,3634.0,3350.0,0.922,18.027,65,0,0,0,65,56,9,0,0.0,0.0
1007,1972,26-09-2019 05:22:00,0,3294.0,3246.0,0.986,16.572,93,8,4,4,85,73,12,0,0.0,0.0
1007,1973,26-09-2019 05:24:00,0,3317.0,3187.0,0.961,16.595,74,0,0,0,74,68,6,0,0.0,0.0
1007,1974,26-09-2019 05:26:00,0,3329.0,3111.0,0.934,16.56,164,69,55,14,95,83,12,0,0.0,0.0
1007,1975,26-09-2019 05:28:00,0,3329.0,3102.0,0.932,16.551,265,0,0,0,265,239,26,0,0.0,0.0
1007,1976,26-09-2019 05:30:00,0,3114.0,3011.0,0.967,15.602,212,4,0,4,208,180,28,0,0.0,0.0
1007,1977,26-09-2019 05:32:00,0,3121.0,2943.0,0.943,15.554,254,0,0,0,254,226,28,0,0.0,0.0
1007,1978,26-09-2019 05:34:00,0,3008.0,2894.5,0.963,15.055,273,16,7,9,257,223,34,0,0.0,0.0
1007,1979,26-09-2019 05:36:00,0,2895.0,2846.0,0.983,14.556,11,0,0,0,11,0,11,0,0.0,0.0
1007,1980,26-09-2019 05:38:00,0,2934.0,2714.0,0.925,14.566,86,4,2,2,82,53,29,0,0.0,0.0
1007,1981,26-09-2019 05:40:00,0,2925.0,2736.0,0.935,14.553,107,0,0,0,107,97,10,0,0.0,0.0
1007,1982,26-09-2019 05:42:00,0,2916.0,2776.0,0.952,14.56,42,0,0,0,42,38,4,0,0.0,0.0
1007,1983,26-09-2019 05:44:00,0,2906.0,2781.0,0.957,14.527,33,0,0,0,33,28,5,0,0.0,0.0
1007,1984,26-09-2019 05:46:00,0,2902.0,2804.0,0.966,14.537,76,6,3,3,70,59,11,0,0.0,0.0
1007,1985,26-09-2019 05:48:00,0,2893.0,2849.0,0.985,14.552,138,0,0,0,138,121,17,0,0.0,0.0
1007,1986,26-09-2019 05:50:00,0,2912.0,2795.0,0.96,14.569,319,92,48,44,227,187,40,9,0.0,0.0
1007,1987,26-09-2019 05:52:00,0,3464.0,3079.0,0.889,17.057,426,111,77,34,315,300,15,120,0.0,0.0
1007,1988,26-09-2019 05:54:00,0,3655.0,3276.0,0.896,18.029,384,70,30,40,314,299,15,95,0.0,0.0
1007,1989,26-09-2019 05:56:00,0,3742.0,3452.0,0.922,18.564,338,38,10,28,300,288,12,79,0.0,0.05
1007,1990,26-09-2019 05:58:00,0,3919.0,3710.0,0.947,19.548,306,43,17,26,263,256,7,77,0.0,0.0
1007,1991,26-09-2019 06:00:00,1,4228.0,3976.0,0.94,21.059,390,109,86,23,281,268,13,69,0.0,0.24
1007,1992,26-09-2019 06:02:00,1,3902.0,3822.0,0.98,19.603,509,164,127,37,345,306,39,80,0.11,0.0
1007,1993,26-09-2019 06:04:00,1,4120.0,3899.0,0.946,20.549,363,126,95,31,237,225,12,63,0.0,0.0
1007,1994,26-09-2019 06:06:00,1,3941.0,3657.0,0.928,19.576,434,117,81,36,317,280,37,57,0.03,0.0
1007,1995,26-09-2019 06:08:00,1,4116.5,3949.0,0.958,20.5915,259,37,16,21,222,220,2,51,0.0,0.19
1007,1996,26-09-2019 06:10:00,1,4292.0,4241.0,0.988,21.607,1,1,0,1,0,0,0,0,0.0,0.01
1007,1997,26-09-2019 06:12:00,1,4191.0,4144.0,0.989,21.099,98,13,12,1,85,79,6,5,0.09,0.01
1007,1998,26-09-2019 06:14:00,1,4076.0,4137.0,1.015,20.64,632,223,186,37,409,368,41,34,0.0,0.03
1007,1999,26-09-2019 06:16:00,1,4189.0,4193.0,1.001,21.146,723,133,95,38,590,524,66,3,0.19,0.0
1007,2000,26-09-2019 06:18:00,1,3985.0,3935.0,0.987,20.058,798,211,153,58,587,513,74,14,0.0,0.0
1007,2001,26-09-2019 06:20:00,1,4072.0,4126.0,1.013,20.613,550,172,124,48,378,323,55,7,0.0,0.0
1007,2002,26-09-2019 06:22:00,1,4087.0,4073.0,0.997,20.612,643,214,162,52,429,371,58,14,0.0,0.0
1007,2003,26-09-2019 06:24:00,1,4082.0,4082.0,1.0,20.6,600,186,144,42,414,375,39,12,0.0,0.0
1007,2004,26-09-2019 06:26:00,1,4050.0,4176.0,1.031,20.581,475,91,60,31,384,355,29,37,0.05,0.0
1007,2005,26-09-2019 06:28:00,1,4081.0,4065.0,0.996,20.579,415,166,118,48,249,221,28,0,0.0,0.0
1007,2006,26-09-2019 06:30:00,1,4180.0,4236.0,1.013,21.159,549,115,79,36,434,387,47,0,0.0,0.0
1007,2007,26-09-2019 06:32:00,1,4073.0,4059.0,0.997,20.541,395,79,59,20,316,279,37,0,0.0,0.0
1007,2008,26-09-2019 06:34:00,1,4369.0,4409.0,1.009,22.095,230,22,17,5,208,189,19,0,0.0,0.0
1007,2009,26-09-2019 06:36:00,1,3786.0,3747.0,0.99,19.063,254,8,4,4,246,226,20,0,0.0,0.0
1007,2010,26-09-2019 06:38:00,1,3620.0,3434.0,0.949,18.066,165,51,22,29,114,103,11,0,0.0,0.0
1007,2011,26-09-2019 06:40:00,1,3705.0,3577.0,0.965,18.559,41,4,1,3,37,34,3,0,0.0,0.0
1007,2012,26-09-2019 06:42:00,1,3829.0,3607.5,0.9425,19.0805,267,20,9,11,247,223,24,0,0.0,0.0
1007,2013,26-09-2019 06:44:00,1,3953.0,3638.0,0.92,19.602,0,0,0,0,0,0,0,0,0.0,0.0
1007,2014,26-09-2019 06:46:00,1,3729.0,3491.0,0.936,18.557,11,1,1,0,10,10,0,0,0.0,0.0
1007,2015,26-09-2019 06:48:00,1,3752.0,3363.0,0.896,18.506,4,0,0,0,4,4,0,0,0.0,0.0
1007,2016,26-09-2019 06:50:00,1,3436.0,3212.0,0.935,17.093,0,0,0,0,0,0,0,0,0.0,0.0
1007,2017,26-09-2019 06:52:00,1,3215.0,3060.0,0.952,16.055,0,0,0,0,0,0,0,0,0.0,0.0
1007,2018,26-09-2019 06:54:00,1,3232.0,2979.0,0.922,16.032,26,17,7,10,9,8,1,0,0.0,0.0
1007,2019,26-09-2019 06:56:00,1,3128.0,2899.0,0.927,15.533,8,1,0,1,7,7,0,0,0.0,0.0
1007,2020,26-09-2019 06:58:00,1,2905.0,2821.0,0.971,14.567,12,8,5,3,4,4,0,0,0.0,0.0
1007,2021,26-09-2019 07:00:00,1,2915.0,2746.0,0.942,14.524,35,22,10,12,13,12,1,0,0.0,0.0
1007,2022,26-09-2019 07:02:00,1,2946.0,2660.0,0.903,14.551,3,3,1,2,0,0,0,0,0.0,0.0
1007,2023,26-09-2019 07:04:00,1,2707.0,2617.0,0.967,13.563,20,5,2,3,15,13,2,0,0.0,0.0
1007,2024,26-09-2019 07:06:00,1,2713.0,2580.0,0.951,13.544,0,0,0,0,0,0,0,0,0.0,0.0
1007,2025,26-09-2019 07:08:00,1,2735.0,2496.0,0.912,13.541,3,3,1,2,0,0,0,0,0.0,0.0
1007,2026,26-09-2019 07:10:00,1,2736.0,2464.0,0.901,13.508,30,12,7,5,18,17,1,0,0.0,0.0
1007,2027,26-09-2019 07:12:00,1,2692.0,2649.0,0.984,13.538,8,8,1,7,0,0,0,0,0.0,0.0
1007,2028,26-09-2019 07:14:00,1,2705.0,2632.0,0.973,13.572,3,1,0,1,2,2,0,0,0.0,0.0
1007,2029,26-09-2019 07:16:00,1,2816.5,2689.0,0.9555,14.075,48,4,2,2,44,38,6,0,0.0,0.0
1007,2030,26-09-2019 07:18:00,1,2928.0,2746.0,0.938,14.578,0,0,0,0,0,0,0,0,0.0,0.0
1007,2031,26-09-2019 07:20:00,1,2699.0,2642.0,0.979,13.56,0,0,0,0,0,0,0,0,0.0,0.0
1007,2032,26-09-2019 07:22:00,1,2723.0,2538.0,0.932,13.536,6,6,3,3,0,0,0,0,0.0,0.0
1007,2033,26-09-2019 07:24:00,1,2801.0,2692.0,0.961,14.018,0,0,0,0,0,0,0,0,0.0,0.0
1007,2034,26-09-2019 07:26:00,1,2803.0,2695.0,0.962,14.026,19,3,0,3,16,15,1,0,0.0,0.0
1007,2035,26-09-2019 07:28:00,1,2931.0,2711.0,0.925,14.549,69,21,6,15,48,44,4,0,0.0,0.0
1007,2036,26-09-2019 07:30:00,1,2702.0,2601.0,0.963,13.525,36,15,7,8,21,20,1,0,0.0,0.0
1007,2037,26-09-2019 07:32:00,1,2734.0,2537.0,0.928,13.582,9,2,0,2,7,6,1,0,0.0,0.0
1007,2038,26-09-2019 07:34:00,1,2643.0,2342.0,0.886,13.007,6,6,3,3,0,0,0,0,0.0,0.0
1007,2039,26-09-2019 07:36:00,1,2534.0,2289.0,0.903,12.516,4,4,0,4,0,0,0,0,0.0,0.0
1007,2040,26-09-2019 07:38:00,1,2428.0,2244.0,0.924,12.051,19,19,4,15,0,0,0,0,0.0,0.0
1007,2041,26-09-2019 07:40:00,1,2428.0,2273.0,0.936,12.083,2,2,0,2,0,0,0,0,0.0,0.0
1007,2042,26-09-2019 07:42:00,1,2425.0,2262.0,0.933,12.057,12,3,0,3,9,7,2,0,0.0,0.0
1007,2043,26-09-2019 07:44:00,1,2766.0,2352.0,0.85,13.502,10,8,2,6,2,2,0,0,0.0,0.0
1007,2044,26-09-2019 07:46:00,1,2751.0,2419.0,0.88,13.516,61,2,0,2,59,53,6,0,0.0,0.0
1007,2045,26-09-2019 07:48:00,1,2736.0,2511.0,0.918,13.561,13,5,1,4,8,8,0,0,0.0,0.0
1007,2046,26-09-2019 07:50:00,1,2868.5,2716.5,0.946,14.31,261,93,65,28,168,148,20,3,0.0,0.0
1007,2047,26-09-2019 07:52:00,1,3001.0,2922.0,0.974,15.059,252,81,36,45,171,153,18,1,0.0,0.0
1007,2048,26-09-2019 07:54:00,1,3428.0,3223.0,0.94,17.073,478,165,123,42,313,289,24,51,0.0,0.0
1007,2049,26-09-2019 07:56:00,1,3408.0,3247.0,0.953,17.022,338,74,53,21,264,243,21,29,0.0,0.0
1007,2050,26-09-2019 07:58:00,1,3762.0,3419.0,0.909,18.608,227,85,60,25,142,119,23,43,0.0,0.03
1007,2051,26-09-2019 08:00:00,1,3405.0,3288.0,0.965,17.056,449,67,46,21,382,339,43,7,0.0,0.0
1007,2052,26-09-2019 08:02:00,1,3722.0,3499.0,0.94,18.539,484,117,84,33,367,324,43,1,0.0,0.0
1007,2053,26-09-2019 08:04:00,1,3719.0,3513.0,0.944,18.543,549,150,110,40,399,353,46,25,0.0,0.0
1007,2054,26-09-2019 08:06:00,1,3223.0,3022.0,0.937,16.045,268,85,56,29,183,166,17,43,0.0,0.0
1007,2055,26-09-2019 08:08:00,1,3645.0,3328.0,0.913,18.047,550,180,133,47,370,325,45,13,0.0,0.0
1007,2056,26-09-2019 08:10:00,1,3539.0,3292.0,0.93,17.587,432,110,69,41,322,288,34,3,0.0,0.0
1007,2057,26-09-2019 08:12:00,1,3420.0,3258.0,0.953,17.081,419,134,96,38,285,257,28,0,0.0,0.0
1007,2058,26-09-2019 08:14:00,1,3424.0,3242.0,0.947,17.081,666,237,179,58,429,378,51,4,0.0,0.0
1007,2059,26-09-2019 08:16:00,1,3531.0,3247.0,0.92,17.506,371,102,73,29,269,240,29,10,0.0,0.0
1007,2060,26-09-2019 08:18:00,1,3532.0,3269.0,0.925,17.535,71,40,15,25,31,28,3,0,0.0,0.0
1007,2061,26-09-2019 08:20:00,1,3552.0,3240.0,0.912,17.582,169,40,15,25,129,116,13,0,0.0,0.0
1007,2062,26-09-2019 08:22:00,1,3438.0,3205.0,0.932,17.093,541,33,5,28,508,455,53,0,0.0,0.0
1007,2063,26-09-2019 08:24:00,1,3440.0,3186.5,0.926,17.0815,119,10,0,10,109,84,25,0,0.0,0.0
1007,2064,26-09-2019 08:26:00,1,3442.0,3168.0,0.92,17.07,59,2,0,2,57,36,21,0,0.0,0.0
1007,2065,26-09-2019 08:28:00,1,3358.0,2990.0,0.89,16.539,11,3,2,1,8,8,0,0,0.0,0.0
1007,2066,26-09-2019 08:30:00,1,3139.0,2831.0,0.902,15.501,233,3,0,3,230,212,18,0,0.0,0.0
1007,2067,26-09-2019 08:32:00,1,2924.0,2730.0,0.934,14.545,0,0,0,0,0,0,0,0,0.0,0.0
1007,2068,26-09-2019 08:34:00,1,2968.0,2599.0,0.876,14.57,54,7,4,3,47,42,5,0,0.0,0.0
1007,2069,26-09-2019 08:36:00,1,2729.0,2516.0,0.922,13.536,529,6,2,4,523,475,48,0,0.0,0.0
1007,2070,26-09-2019 08:38:00,1,2783.0,2300.0,0.826,13.512,463,2,0,2,461,405,56,0,0.0,0.0
1007,2071,26-09-2019 08:40:00,1,2685.0,2229.0,0.83,13.047,350,0,0,0,350,314,36,0,0.0,0.0
1007,2072,26-09-2019 08:42:00,1,2565.0,2185.0,0.852,12.523,331,1,0,1,330,286,44,0,0.0,0.0
1007,2073,26-09-2019 08:44:00,1,2569.0,2184.0,0.85,12.539,328,0,0,0,328,290,38,0,0.0,0.0
1007,2074,26-09-2019 08:46:00,1,2548.0,2209.0,0.867,12.485,287,0,0,0,287,251,36,0,0.0,0.0
1007,2075,26-09-2019 08:48:00,1,2553.0,2214.0,0.867,12.511,101,5,3,2,96,84,12,0,0.0,0.0
1007,2076,26-09-2019 08:50:00,1,2678.0,2231.0,0.833,13.02,1,1,0,1,0,0,0,0,0.0,0.0
1007,2077,26-09-2019 08:52:00,1,2669.0,2241.0,0.84,12.998,7,2,0,2,5,4,1,0,0.0,0.0
1007,2078,26-09-2019 08:54:00,1,2791.0,2241.0,0.803,13.477,17,4,0,4,13,13,0,0,0.0,0.0
1007,2079,26-09-2019 08:56:00,1,2801.0,2284.0,0.815,13.565,9,2,0,2,7,6,1,0,0.0,0.0
1007,2080,26-09-2019 08:58:00,1,2796.5,2289.5,0.8185,13.554,29,5,0,5,24,22,2,0,0.0,0.0
1007,2081,26-09-2019 09:00:00,1,2792.0,2295.0,0.822,13.543,217,0,0,0,217,205,12,0,0.0,0.0
1007,2082,26-09-2019 09:02:00,1,2803.0,2232.0,0.796,13.517,7,0,0,0,7,6,1,0,0.0,0.0
1007,2083,26-09-2019 09:04:00,1,2682.0,2207.0,0.823,13.01,80,17,11,6,63,57,6,0,0.0,0.0
1007,2084,26-09-2019 09:06:00,1,2808.0,2249.0,0.801,13.553,80,4,2,2,76,67,9,0,0.0,0.0
1007,2085,26-09-2019 09:08:00,1,2689.0,2200.0,0.818,13.029,46,14,8,6,32,29,3,0,0.0,0.0
1007,2086,26-09-2019 09:10:00,1,2576.0,2174.0,0.844,12.558,61,5,3,2,56,53,3,0,0.0,0.0
1007,2087,26-09-2019 09:12:00,1,2815.0,2196.0,0.78,13.523,28,2,1,1,26,23,3,0,0.0,0.0
1007,2088,26-09-2019 09:14:00,1,2797.0,2266.0,0.81,13.528,23,1,0,1,22,21,1,0,0.0,0.0
1007,2089,26-09-2019 09:16:00,1,2801.0,2220.0,0.793,13.492,98,2,1,1,96,83,13,0,0.0,0.0
1007,2090,26-09-2019 09:18:00,1,2806.0,2273.0,0.81,13.574,337,0,0,0,337,300,37,0,0.0,0.0
1007,2091,26-09-2019 09:20:00,1,2805.0,2216.0,0.79,13.507,500,6,3,3,494,447,47,0,0.0,0.0
1007,2092,26-09-2019 09:22:00,1,2810.0,2207.0,0.785,13.514,289,40,21,19,249,215,34,0,0.0,0.0
1007,2093,26-09-2019 09:24:00,1,2886.0,2403.0,0.833,14.032,112,30,8,22,82,76,6,0,0.0,0.0
1007,2094,26-09-2019 09:26:00,1,2878.0,2437.0,0.847,14.036,541,227,182,45,314,282,32,28,0.0,0.0
1007,2095,26-09-2019 09:28:00,1,3304.0,2771.0,0.839,16.085,408,127,88,39,281,243,38,11,0.0,0.0
1007,2096,26-09-2019 09:30:00,1,3278.0,2806.0,0.856,16.023,216,49,29,20,167,158,9,60,0.0,0.0
1007,2097,26-09-2019 09:32:00,1,3232.5,2756.5,0.8525,15.7875,257,74,41,33,183,166,17,0,0.0,0.0
1007,2098,26-09-2019 09:34:00,1,3187.0,2707.0,0.849,15.552,279,68,24,44,211,176,35,0,0.0,0.0
1007,2099,26-09-2019 09:36:00,1,3288.0,2756.0,0.838,16.007,66,12,5,7,54,49,5,0,0.0,0.0
1007,2100,26-09-2019 09:38:00,1,2959.0,2587.0,0.875,14.521,0,0,0,0,0,0,0,0,0.0,0.0
1007,2101,26-09-2019 09:40:00,1,2988.0,2494.0,0.834,14.535,0,0,0,0,0,0,0,0,0.0,0.0
1007,2102,26-09-2019 09:42:00,1,2754.0,2410.0,0.875,13.52,0,0,0,0,0,0,0,0,0.0,0.0
1007,2103,26-09-2019 09:44:00,1,2781.0,2306.0,0.829,13.511,3,0,0,0,3,3,0,0,0.0,0.0
1007,2104,26-09-2019 09:46:00,1,2821.0,2205.0,0.781,13.557,296,52,32,20,244,224,20,0,0.0,0.0
1007,2105,26-09-2019 09:48:00,1,2771.0,2339.0,0.844,13.509,287,83,51,32,204,185,19,0,0.0,0.0
1007,2106,26-09-2019 09:50:00,1,2808.0,2259.0,0.805,13.563,48,0,0,0,48,41,7,0,0.0,0.0
1007,2107,26-09-2019 09:52:00,1,2464.0,2080.0,0.844,12.012,108,19,10,9,89,83,6,0,0.0,0.0
1007,2108,26-09-2019 09:54:00,1,2809.0,2188.0,0.779,13.49,10,10,0,10,0,0,0,0,0.0,0.0
1007,2109,26-09-2019 09:56:00,1,2589.0,2100.0,0.811,12.527,0,0,0,0,0,0,0,0,0.0,0.0
1007,2110,26-09-2019 09:58:00,1,2478.0,2037.0,0.822,12.017,5,5,0,5,0,0,0,0,0.0,0.0
1007,2111,26-09-2019 10:00:00,1,2489.0,2041.0,0.82,12.068,2,2,0,2,0,0,0,0,0.0,0.0
1007,2112,26-09-2019 10:02:00,1,2488.0,2030.0,0.816,12.05,20,2,0,2,18,14,4,0,0.0,0.0
1007,2113,26-09-2019 10:04:00,1,2482.0,2013.0,0.811,12.009,98,0,0,0,98,94,4,0,0.0,0.0
1007,2114,26-09-2019 10:06:00,1,2533.5,2049.5,0.809,12.2515,709,1,0,1,708,665,43,0,0.0,0.0
1007,2115,26-09-2019 10:08:00,1,2585.0,2086.0,0.807,12.494,401,1,0,1,400,374,26,0,0.0,0.0
1007,2116,26-09-2019 10:10:00,1,2599.0,2046.0,0.787,12.506,2,2,0,2,0,0,0,0,0.0,0.0
1007,2117,26-09-2019 10:12:00,1,2625.0,1962.0,0.748,12.513,45,7,0,7,38,32,6,0,0.0,0.0
1007,2118,26-09-2019 10:14:00,1,2613.0,1954.0,0.748,12.46,3,1,0,1,2,2,0,0,0.0,0.0
1007,2119,26-09-2019 10:16:00,1,2648.0,1885.0,0.712,12.521,0,0,0,0,0,0,0,0,0.0,0.0
1007,2120,26-09-2019 10:18:00,1,2651.0,1874.0,0.707,12.519,0,0,0,0,0,0,0,0,0.0,0.0
1007,2121,26-09-2019 10:20:00,1,2638.0,1889.0,0.716,12.488,5,2,0,2,3,2,1,0,0.0,0.0
1007,2122,26-09-2019 10:22:00,1,2628.0,1938.0,0.737,12.5,4,2,0,2,2,2,0,0,0.0,0.0
1007,2123,26-09-2019 10:24:00,1,2848.0,2074.0,0.728,13.516,13,3,2,1,10,10,0,0,0.0,0.0
1007,2124,26-09-2019 10:26:00,1,2727.0,2040.0,0.748,13.003,0,0,0,0,0,0,0,0,0.0,0.0
1007,2125,26-09-2019 10:28:00,1,2641.0,1928.0,0.73,12.539,0,0,0,0,0,0,0,0,0.0,0.0
1007,2126,26-09-2019 10:30:00,1,2654.0,1878.0,0.708,12.539,22,3,0,3,19,17,2,0,0.0,0.0
1007,2127,26-09-2019 10:32:00,1,2639.0,1873.0,0.71,12.471,12,0,0,0,12,11,1,0,0.0,0.0
1007,2128,26-09-2019 10:34:00,1,2649.0,1882.0,0.71,12.523,2,0,0,0,2,2,0,0,0.0,0.0
1007,2129,26-09-2019 10:36:00,1,2646.0,1868.0,0.706,12.495,1,0,0,0,1,0,1,0,0.0,0.0
1007,2130,26-09-2019 10:38:00,1,2647.0,1873.0,0.708,12.502,18,11,6,5,7,7,0,0,0.0,0.0
1007,2131,26-09-2019 10:40:00,1,2685.5,1961.0,0.73,12.7515,5,2,1,1,3,2,1,0,0.0,0.0
1007,2132,26-09-2019 10:42:00,1,2724.0,2049.0,0.752,13.001,0,0,0,0,0,0,0,0,0.0,0.0
1007,2133,26-09-2019 10:44:00,1,2959.0,2120.0,0.716,14.006,0,0,0,0,0,0,0,0,0.0,0.0
1007,2134,26-09-2019 10:46:00,1,2845.0,2060.0,0.724,13.49,1,0,0,0,1,1,0,0,0.0,0.0
1007,2135,26-09-2019 10:48:00,1,2731.0,2026.0,0.742,13.004,111,29,20,9,82,75,7,0,0.0,0.0
1007,2136,26-09-2019 10:50:00,1,2619.0,1996.0,0.762,12.528,80,36,10,26,44,38,6,0,0.0,0.0
1007,2137,26-09-2019 10:52:00,1,2966.0,2126.0,0.717,14.039,114,73,50,23,41,39,2,0,0.0,0.0
1007,2138,26-09-2019 10:54:00,1,2951.0,2143.0,0.726,13.998,321,86,49,37,235,212,23,0,0.0,0.0
1007,2139,26-09-2019 10:56:00,1,3024.0,2346.0,0.776,14.513,551,200,153,47,351,307,44,12,0.0,0.0
1007,2140,26-09-2019 10:58:00,1,3135.0,2452.0,0.782,15.066,482,113,74,39,369,340,29,2,0.0,0.01
1007,2141,26-09-2019 11:00:00,1,3027.0,2366.0,0.781,14.547,348,84,49,35,264,240,24,10,0.0,0.0
1007,2142,26-09-2019 11:02:00,1,3128.0,2427.0,0.776,15.011,256,50,34,16,206,193,13,10,0.0,0.0
1007,2143,26-09-2019 11:04:00,1,2896.0,2333.0,0.806,13.993,144,24,2,22,120,108,12,0,0.0,0.0
1007,2144,26-09-2019 11:06:00,1,3131.0,2449.0,0.782,15.048,340,7,3,4,333,307,26,0,0.0,0.0
1007,2145,26-09-2019 11:08:00,1,3124.0,2491.0,0.797,15.068,278,31,10,21,247,224,23,0,0.0,0.0
1007,2146,26-09-2019 11:10:00,1,3124.0,2456.0,0.786,15.028,95,12,5,7,83,75,8,0,0.0,0.0
1007,2147,26-09-2019 11:12:00,1,2925.0,2284.0,0.781,14.052,5,3,0,3,2,2,0,0,0.0,0.0
1007,2148,26-09-2019 11:14:00,1,2765.0,2157.0,0.78,13.2815,1,1,0,1,0,0,0,0,0.0,0.0
1007,2149,26-09-2019 11:16:00,1,2605.0,2030.0,0.779,12.511,86,2,0,2,84,78,6,0,0.0,0.0
1007,2150,26-09-2019 11:18:00,1,2611.0,1987.0,0.761,12.488,2,2,0,2,0,0,0,0,0.0,0.0
1007,2151,26-09-2019 11:20:00,1,2631.0,1941.0,0.738,12.515,0,0,0,0,0,0,0,0,0.0,0.0
1007,2152,26-09-2019 11:22:00,1,2645.0,1886.0,0.713,12.511,76,25,14,11,51,45,6,0,0.0,0.0
1007,2153,26-09-2019 11:24:00,1,2651.0,1876.0,0.708,12.522,0,0,0,0,0,0,0,0,0.0,0.0
1007,2154,26-09-2019 11:26:00,1,2660.0,1825.0,0.686,12.5,4,2,0,2,2,2,0,0,0.0,0.0
1007,2155,26-09-2019 11:28:00,1,2653.0,1840.0,0.694,12.493,0,0,0,0,0,0,0,0,0.0,0.0
1007,2156,26-09-2019 11:30:00,1,2640.0,1904.0,0.721,12.51,62,4,1,3,58,52,6,0,0.0,0.0
1007,2157,26-09-2019 11:32:00,1,2628.0,1938.0,0.737,12.501,12,3,2,1,9,9,0,0,0.0,0.0
1007,2158,26-09-2019 11:34:00,1,2631.0,1933.0,0.735,12.507,53,18,9,9,35,32,3,0,0.01,0.0
1007,2159,26-09-2019 11:36:00,1,2736.0,2020.0,0.738,13.018,1,0,0,0,1,0,1,0,0.0,0.0
1007,2160,26-09-2019 11:38:00,1,2624.0,1964.0,0.748,12.515,4,4,2,2,0,0,0,0,0.0,0.0
1007,2161,26-09-2019 11:40:00,1,2637.0,1924.0,0.73,12.522,4,2,1,1,2,2,0,0,0.0,0.0
1007,2162,26-09-2019 11:42:00,1,2621.0,1956.0,0.746,12.495,24,20,0,20,4,4,0,0,0.0,0.0
1007,2163,26-09-2019 11:44:00,1,2627.0,1971.0,0.75,12.535,1,1,0,1,0,0,0,0,0.0,0.0
1007,2164,26-09-2019 11:46:00,1,2753.0,1964.0,0.713,13.02,16,6,2,4,10,10,0,0,0.0,0.0
1007,2165,26-09-2019 11:48:00,1,2693.0,1945.5,0.7225,12.764,0,0,0,0,0,0,0,0,0.0,0.0
1007,2166,26-09-2019 11:50:00,1,2633.0,1927.0,0.732,12.508,13,3,1,2,10,7,3,0,0.0,0.0
1007,2167,26-09-2019 11:52:00,1,2747.0,1977.0,0.72,13.014,6,0,0,0,6,6,0,0,0.0,0.0
1007,2168,26-09-2019 11:54:00,1,2862.0,2024.0,0.707,13.517,256,12,7,5,244,229,15,0,0.0,0.0
1007,2169,26-09-2019 11:56:00,1,2977.0,2045.0,0.687,13.992,11,0,0,0,11,10,1,0,0.0,0.0
1007,2170,26-09-2019 11:58:00,1,2863.0,2025.0,0.707,13.521,125,5,1,4,120,111,9,0,0.0,0.0
1007,2171,26-09-2019 12:00:00,1,2621.0,1962.0,0.748,12.5,89,2,2,0,87,79,8,0,0.0,0.0
1007,2172,26-09-2019 12:02:00,1,2648.0,1892.0,0.715,12.526,48,5,3,2,43,39,4,0,0.0,0.0
1007,2173,26-09-2019 12:04:00,1,2655.0,1851.0,0.697,12.508,0,0,0,0,0,0,0,0,0.0,0.0
1007,2174,26-09-2019 12:06:00,1,2652.0,1860.0,0.701,12.509,15,0,0,0,15,14,1,0,0.0,0.0
1007,2175,26-09-2019 12:08:00,1,2648.0,1882.0,0.711,12.518,4,0,0,0,4,4,0,0,0.0,0.0
1007,2176,26-09-2019 12:10:00,1,2629.0,1898.0,0.722,12.46,19,3,1,2,16,14,2,0,0.0,0.0
1007,2177,26-09-2019 12:12:00,1,2630.0,1967.0,0.748,12.542,2,0,0,0,2,2,0,0,0.0,0.0
1007,2178,26-09-2019 12:14:00,1,2745.0,2013.0,0.733,13.043,35,2,1,1,33,30,3,0,0.0,0.0
1007,2179,26-09-2019 12:16:00,1,2853.0,2028.0,0.711,13.488,3,3,2,1,0,0,0,0,0.0,0.0
1007,2180,26-09-2019 12:18:00,1,2619.0,1963.0,0.75,12.494,26,11,3,8,15,13,2,0,0.0,0.0
1007,2181,26-09-2019 12:20:00,1,2624.0,1965.0,0.749,12.515,3,0,0,0,3,3,0,0,0.0,0.0
1007,2182,26-09-2019 12:22:00,1,2633.5,1934.0,0.7345,12.518,18,9,6,3,9,7,2,0,0.0,0.0
1007,2183,26-09-2019 12:24:00,1,2643.0,1903.0,0.72,12.521,10,1,0,1,9,8,1,0,0.0,0.0
1007,2184,26-09-2019 12:26:00,1,2636.0,1915.0,0.726,12.507,7,0,0,0,7,6,1,0,0.0,0.0
1007,2185,26-09-2019 12:28:00,1,2642.0,1924.0,0.728,12.541,51,9,7,2,42,36,6,0,0.0,0.0
1007,2186,26-09-2019 12:30:00,1,2733.0,2023.0,0.74,13.009,9,5,2,3,4,3,1,0,0.0,0.0
1007,2187,26-09-2019 12:32:00,1,2973.0,2066.0,0.695,14.002,185,12,5,7,173,157,16,0,0.0,0.0
1007,2188,26-09-2019 12:34:00,1,2615.0,2001.0,0.765,12.521,2,0,0,0,2,2,0,0,0.0,0.0
1007,2189,26-09-2019 12:36:00,1,2633.0,1928.0,0.732,12.51,440,23,8,15,417,386,31,1,0.0,0.0
1007,2190,26-09-2019 12:38:00,1,2853.0,2043.0,0.716,13.502,355,28,12,16,327,295,32,0,0.0,0.0
1007,2191,26-09-2019 12:40:00,1,2914.0,2282.0,0.783,14.008,291,27,6,21,264,239,25,0,0.0,0.0
1007,2192,26-09-2019 12:42:00,1,3135.0,2401.0,0.766,15.012,454,78,48,30,376,337,39,7,0.0,0.0
1007,2193,26-09-2019 12:44:00,1,3213.0,2585.0,0.804,15.523,463,155,118,37,308,289,19,56,0.0,0.0
1007,2194,26-09-2019 12:46:00,1,3647.0,2803.0,0.768,17.475,344,118,88,30,226,201,25,36,0.0,0.0
1007,2195,26-09-2019 12:48:00,1,3652.0,2837.0,0.777,17.531,133,28,7,21,105,103,2,68,0.0,0.0
1007,2196,26-09-2019 12:50:00,1,3867.0,2940.0,0.76,18.493,241,0,0,0,241,226,15,61,0.0,0.0
1007,2197,26-09-2019 12:52:00,1,3979.0,3033.0,0.762,19.034,135,12,5,7,123,119,4,53,0.0,0.04
1007,2198,26-09-2019 12:54:00,1,3983.0,3023.0,0.759,19.04,25,12,5,7,13,12,1,57,0.0,0.04
1007,2199,26-09-2019 12:56:00,1,3862.5,2975.5,0.7705,18.512,460,121,88,33,339,306,33,45,0.12,0.15
1007,2200,26-09-2019 12:58:00,1,3742.0,2928.0,0.782,17.984,638,95,57,38,543,478,65,0,0.0,0.0
1007,2201,26-09-2019 13:00:00,1,3653.0,2846.0,0.779,17.544,1331,206,157,49,1125,1019,106,0,0.0,0.0
1007,2202,26-09-2019 13:02:00,1,3621.0,2967.0,0.82,17.551,1663,446,356,90,1217,1095,122,5,0.0,0.0
1007,2203,26-09-2019 13:04:00,1,3618.0,2953.0,0.816,17.525,960,183,138,45,777,686,91,0,0.0,0.0
1007,2204,26-09-2019 13:06:00,1,3835.0,3101.0,0.809,18.543,1087,106,72,34,981,864,117,6,0.04,0.0
1007,2205,26-09-2019 13:08:00,1,3604.0,3011.0,0.835,17.532,742,96,60,36,646,575,71,8,0.0,0.0
1007,2206,26-09-2019 13:10:00,1,3629.0,2981.0,0.821,17.598,813,36,11,25,777,697,80,0,0.0,0.0
1007,2207,26-09-2019 13:12:00,1,3393.0,2845.0,0.838,16.52,540,17,2,15,523,463,60,0,0.0,0.0
1007,2208,26-09-2019 13:14:00,1,3388.0,2882.0,0.851,16.541,436,20,7,13,416,376,40,0,0.0,0.0
1007,2209,26-09-2019 13:16:00,1,3618.0,2986.0,0.825,17.561,324,38,12,26,286,256,30,0,0.0,0.0
1007,2210,26-09-2019 13:18:00,1,3677.0,3171.0,0.863,17.998,478,27,11,16,451,411,40,0,0.0,0.0
1007,2211,26-09-2019 13:20:00,1,3596.0,3029.0,0.842,17.52,501,0,0,0,501,444,57,0,0.0,0.0
1007,2212,26-09-2019 13:22:00,1,3385.0,2870.0,0.848,16.516,556,0,0,0,556,501,55,0,0.0,0.0
1007,2213,26-09-2019 13:24:00,1,3057.0,2719.0,0.889,15.055,322,6,4,2,316,276,40,0,0.0,0.0
1007,2214,26-09-2019 13:26:00,1,3089.0,2582.0,0.836,15.029,407,0,0,0,407,364,43,0,0.0,0.0
1007,2215,26-09-2019 13:28:00,1,2861.0,2481.0,0.867,14.017,191,2,1,1,189,167,22,0,0.0,0.0
1007,2216,26-09-2019 13:30:00,1,2883.0,2398.0,0.832,14.0125,561,0,0,0,561,526,35,0,0.0,0.0
1007,2217,26-09-2019 13:32:00,1,2905.0,2315.0,0.797,14.008,277,6,0,6,271,239,32,0,0.0,0.0
1007,2218,26-09-2019 13:34:00,1,2674.0,2257.0,0.844,13.032,146,9,4,5,137,123,14,0,0.0,0.0
1007,2219,26-09-2019 13:36:00,1,2557.0,2260.0,0.884,12.577,42,0,0,0,42,36,6,0,0.0,0.0
1007,2220,26-09-2019 13:38:00,1,2548.0,2236.0,0.878,12.517,104,0,0,0,104,93,11,0,0.0,0.0
1007,2221,26-09-2019 13:40:00,1,2676.0,2288.0,0.855,13.076,89,0,0,0,89,78,11,0,0.0,0.0
1007,2222,26-09-2019 13:42:00,1,2880.0,2395.0,0.832,14.001,6,0,0,0,6,6,0,0,0.0,0.0
1007,2223,26-09-2019 13:44:00,1,2874.0,2464.0,0.857,14.053,67,0,0,0,67,63,4,0,0.0,0.0
1007,2224,26-09-2019 13:46:00,1,2872.0,2433.0,0.847,14.009,21,0,0,0,21,19,2,0,0.0,0.0
1007,2225,26-09-2019 13:48:00,1,2873.0,2449.0,0.853,14.031,34,14,6,8,20,17,3,0,0.0,0.0
1007,2226,26-09-2019 13:50:00,1,2895.0,2383.0,0.823,14.046,52,0,0,0,52,48,4,0,0.0,0.0
1007,2227,26-09-2019 13:52:00,1,2897.0,2357.0,0.814,14.022,0,0,0,0,0,0,0,0,0.0,0.0
1007,2228,26-09-2019 13:54:00,1,2907.0,2330.0,0.802,14.032,61,0,0,0,61,57,4,0,0.0,0.0
1007,2229,26-09-2019 13:56:00,1,2903.0,2331.0,0.803,14.02,179,0,0,0,179,166,13,0,0.0,0.0
1007,2230,26-09-2019 13:58:00,1,2897.0,2334.0,0.806,14.0,65,0,0,0,65,60,5,0,0.0,0.0
1007,2231,26-09-2019 14:00:00,1,2915.0,2311.0,0.793,14.043,79,2,1,1,77,71,6,0,0.0,0.0
1007,2232,26-09-2019 14:02:00,1,2789.0,2288.0,0.82,13.521,5,0,0,0,5,5,0,0,0.0,0.0
1007,2233,26-09-2019 14:04:00,1,2736.5,2253.0,0.8235,13.276,0,0,0,0,0,0,0,0,0.0,0.0
1007,2234,26-09-2019 14:06:00,1,2684.0,2218.0,0.827,13.031,45,11,8,3,34,30,4,0,0.0,0.0
1007,2235,26-09-2019 14:08:00,1,2802.0,2238.0,0.799,13.517,66,13,5,8,53,48,5,0,0.0,0.0
1007,2236,26-09-2019 14:10:00,1,2910.0,2298.0,0.79,14.01,8,8,0,8,0,0,0,0,0.0,0.0
1007,2237,26-09-2019 14:12:00,1,2908.0,2298.0,0.79,14.0,12,12,1,11,0,0,0,0,0.0,0.0
1007,2238,26-09-2019 14:14:00,1,2914.0,2273.0,0.78,13.999,16,7,3,4,9,8,1,0,0.0,0.0
1007,2239,26-09-2019 14:16:00,1,2910.0,2307.0,0.793,14.022,0,0,0,0,0,0,0,0,0.0,0.0
1007,2240,26-09-2019 14:18:00,1,2902.0,2315.0,0.798,13.996,0,0,0,0,0,0,0,0,0.0,0.0
1007,2241,26-09-2019 14:20:00,1,2902.0,2325.0,0.801,14.008,26,0,0,0,26,23,3,0,0.0,0.0
1007,2242,26-09-2019 14:22:00,1,2897.0,2336.0,0.806,14.001,464,57,43,14,407,351,56,3,0.0,0.0
1007,2243,26-09-2019 14:24:00,1,2902.0,2335.0,0.804,14.021,142,1,0,1,141,123,18,0,0.0,0.0
1007,2244,26-09-2019 14:26:00,1,2578.0,2175.0,0.844,12.565,15,2,1,1,13,11,2,0,0.0,0.0
1007,2245,26-09-2019 14:28:00,1,2599.0,2040.0,0.785,12.499,3,1,1,0,2,2,0,0,0.0,0.0
1007,2246,26-09-2019 14:30:00,1,2600.0,2038.0,0.784,12.498,0,0,0,0,0,0,0,0,0.0,0.0
1007,2247,26-09-2019 14:32:00,1,2589.0,2117.0,0.818,12.544,0,0,0,0,0,0,0,0,0.0,0.0
1007,2248,26-09-2019 14:34:00,1,2580.0,2107.0,0.817,12.498,0,0,0,0,0,0,0,0,0.0,0.0
1007,2249,26-09-2019 14:36:00,1,2589.0,2086.0,0.806,12.508,66,23,6,17,43,38,5,0,0.0,0.0
1007,2250,26-09-2019 14:38:00,1,2790.0,2289.5,0.82,13.5255,361,65,27,38,296,273,23,0,0.0,0.0
1007,2251,26-09-2019 14:40:00,1,2991.0,2493.0,0.834,14.543,345,69,33,36,276,246,30,0,0.0,0.0
1007,2252,26-09-2019 14:42:00,1,3096.0,2590.0,0.836,15.067,359,40,18,22,319,291,28,0,0.0,0.0
1007,2253,26-09-2019 14:44:00,1,2871.0,2459.0,0.856,14.036,55,10,1,9,45,40,5,0,0.0,0.0
1007,2254,26-09-2019 14:46:00,1,2885.0,2409.0,0.835,14.033,203,69,28,41,134,121,13,0,0.0,0.0
1007,2255,26-09-2019 14:48:00,1,3114.0,2504.0,0.804,15.041,139,17,8,9,122,102,20,0,0.0,0.0
1007,2256,26-09-2019 14:50:00,1,3093.0,2545.0,0.823,15.005,44,12,3,9,32,28,4,0,0.0,0.0
1007,2257,26-09-2019 14:52:00,1,3107.0,2529.0,0.814,15.041,179,42,10,32,137,127,10,1,0.0,0.0
1007,2258,26-09-2019 14:54:00,1,3304.0,2708.0,0.82,16.015,194,57,26,31,137,122,15,0,0.0,0.0
1007,2259,26-09-2019 14:56:00,1,3306.0,2685.0,0.812,15.997,397,112,72,40,285,260,25,33,0.0,0.0
1007,2260,26-09-2019 14:58:00,1,3610.0,2992.0,0.829,17.538,104,56,36,20,48,45,3,60,0.0,0.0
1007,2261,26-09-2019 15:00:00,1,3719.0,3105.0,0.835,18.091,181,92,58,34,89,80,9,54,0.0,0.0
1007,2262,26-09-2019 15:02:00,1,3617.0,2945.0,0.814,17.511,705,195,150,45,510,466,44,21,0.0,0.07
1007,2263,26-09-2019 15:04:00,1,3616.0,2976.0,0.823,17.541,552,136,97,39,416,387,29,9,0.0,0.0
1007,2264,26-09-2019 15:06:00,1,3413.0,2756.0,0.807,16.5,99,14,4,10,85,75,10,0,0.0,0.0
1007,2265,26-09-2019 15:08:00,1,3441.0,2731.0,0.793,16.582,288,9,3,6,279,250,29,0,0.0,0.0
1007,2266,26-09-2019 15:10:00,1,3304.0,2700.0,0.817,16.006,348,46,18,28,302,277,25,0,0.0,0.0
1007,2267,26-09-2019 15:12:00,1,3194.5,2662.5,0.834,15.5335,34,7,1,6,27,24,3,0,0.0,0.0
1007,2268,26-09-2019 15:14:00,1,3085.0,2625.0,0.851,15.061,51,5,3,2,46,44,2,0,0.0,0.0
1007,2269,26-09-2019 15:16:00,1,3107.0,2512.0,0.809,15.023,113,0,0,0,113,101,12,0,0.0,0.0
1007,2270,26-09-2019 15:18:00,1,2883.0,2442.0,0.847,14.064,615,0,0,0,615,560,55,0,0.0,0.0
1007,2271,26-09-2019 15:20:00,1,2888.0,2381.0,0.824,14.013,48,3,2,1,45,39,6,0,0.0,0.0
1007,2272,26-09-2019 15:22:00,1,2880.0,2427.0,0.843,14.035,23,2,0,2,21,20,1,0,0.01,0.0
1007,2273,26-09-2019 15:24:00,1,2872.0,2422.0,0.843,13.997,90,0,0,0,90,84,6,0,0.0,0.0
1007,2274,26-09-2019 15:26:00,1,2985.0,2506.0,0.84,14.536,38,0,0,0,38,32,6,0,0.0,0.0
1007,2275,26-09-2019 15:28:00,1,3099.0,2541.0,0.82,15.022,693,0,0,0,693,651,42,0,0.0,0.0
1007,2276,26-09-2019 15:30:00,1,3092.0,2557.0,0.827,15.013,561,0,0,0,561,542,19,0,0.0,0.0
1007,2277,26-09-2019 15:32:00,1,2855.0,2491.0,0.873,14.005,31,0,0,0,31,29,2,0,0.0,0.0
1007,2278,26-09-2019 15:34:00,1,2889.0,2437.0,0.843,14.081,0,0,0,0,0,0,0,0,0.0,0.0
1007,2279,26-09-2019 15:36:00,1,2889.0,2375.0,0.822,14.012,11,7,1,6,4,4,0,0,0.0,0.0
1007,2280,26-09-2019 15:38:00,1,2906.0,2339.0,0.805,14.039,318,0,0,0,318,292,26,0,0.0,0.0
1007,2281,26-09-2019 15:40:00,1,2906.0,2339.0,0.805,14.04,224,0,0,0,224,203,21,0,0.0,0.0
1007,2282,26-09-2019 15:42:00,1,2901.0,2368.0,0.816,14.052,224,0,0,0,224,210,14,0,0.0,0.0
1007,2283,26-09-2019 15:44:00,1,2912.0,2304.0,0.791,14.024,298,0,0,0,298,282,16,0,0.0,0.0
1007,2284,26-09-2019 15:46:00,1,2915.0,2296.0,0.7875,14.0265,47,1,0,1,46,43,3,0,0.0,0.0
1007,2285,26-09-2019 15:48:00,1,2918.0,2288.0,0.784,14.029,39,11,1,10,28,24,4,0,0.0,0.0
1007,2286,26-09-2019 15:50:00,1,2943.0,2206.0,0.749,14.037,146,37,18,19,109,104,5,0,0.0,0.0
1007,2287,26-09-2019 15:52:00,1,2938.0,2212.0,0.753,14.024,127,42,32,10,85,75,10,4,0.0,0.0
1007,2288,26-09-2019 15:54:00,1,2584.0,2131.0,0.825,12.543,24,7,4,3,17,16,1,0,0.0,0.0
1007,2289,26-09-2019 15:56:00,1,2580.0,2132.0,0.826,12.524,12,1,0,1,11,7,4,0,0.0,0.0
1007,2290,26-09-2019 15:58:00,1,2828.0,2174.0,0.769,13.548,52,3,1,2,49,44,5,0,0.0,0.0
1007,2291,26-09-2019 16:00:00,1,2819.0,2174.0,0.771,13.514,104,13,0,13,91,81,10,0,0.0,0.0
1007,2292,26-09-2019 16:02:00,1,2828.0,2151.0,0.761,13.524,340,0,0,0,340,319,21,0,0.0,0.0
1007,2293,26-09-2019 16:04:00,1,2935.0,2183.0,0.744,13.982,126,0,0,0,126,113,13,0,0.0,0.0
1007,2294,26-09-2019 16:06:00,1,2929.0,2233.0,0.762,14.015,412,0,0,0,412,382,30,0,0.0,0.0
1007,2295,26-09-2019 16:08:00,1,2938.0,2184.0,0.743,13.993,459,2,1,1,457,417,40,0,0.0,0.0
1007,2296,26-09-2019 16:10:00,1,2927.0,2235.0,0.764,14.006,285,67,43,24,218,208,10,52,0.0,0.0
1007,2297,26-09-2019 16:12:00,1,3099.0,2566.0,0.828,15.052,98,13,7,6,85,81,4,78,0.0,0.0
1007,2298,26-09-2019 16:14:00,1,3317.0,2659.0,0.802,16.015,164,97,58,39,67,60,7,46,0.0,0.0
1007,2299,26-09-2019 16:16:00,1,3410.0,2818.0,0.826,16.557,624,195,152,43,429,396,33,72,0.0,0.01
1007,2300,26-09-2019 16:18:00,1,3422.0,2778.0,0.812,16.558,271,61,30,31,210,172,38,0,0.0,0.0
1007,2301,26-09-2019 16:20:00,1,3243.0,2721.5,0.841,15.7905,351,46,16,30,305,273,32,0,0.0,0.01
1007,2302,26-09-2019 16:22:00,1,3064.0,2665.0,0.87,15.023,352,35,5,30,317,290,27,0,0.0,0.0
1007,2303,26-09-2019 16:24:00,1,3396.0,2856.0,0.841,16.543,229,35,16,19,194,172,22,0,0.0,0.0
1007,2304,26-09-2019 16:26:00,1,3406.0,2843.0,0.835,16.567,18,7,2,5,11,10,1,0,0.0,0.0
1007,2305,26-09-2019 16:28:00,1,3060.0,2700.0,0.882,15.047,44,10,1,9,34,32,2,0,0.0,0.0
1007,2306,26-09-2019 16:30:00,1,3097.0,2519.0,0.813,14.993,15,15,0,15,0,0,0,0,0.0,0.0
1007,2307,26-09-2019 16:32:00,1,2891.0,2398.0,0.829,14.047,53,4,1,3,49,44,5,0,0.0,0.0
1007,2308,26-09-2019 16:34:00,1,2903.0,2357.0,0.812,14.046,1,1,0,1,0,0,0,0,0.0,0.0
1007,2309,26-09-2019 16:36:00,1,2904.0,2306.0,0.794,13.994,16,11,4,7,5,5,0,0,0.0,0.0
1007,2310,26-09-2019 16:38:00,1,2792.0,2284.0,0.818,13.529,115,11,1,10,104,97,7,0,0.0,0.0
1007,2311,26-09-2019 16:40:00,1,2565.0,2202.0,0.859,12.543,64,1,0,1,63,58,5,0,0.0,0.0
1007,2312,26-09-2019 16:42:00,1,2564.0,2160.0,0.843,12.493,37,3,1,2,34,30,4,0,0.0,0.0
1007,2313,26-09-2019 16:44:00,1,2905.0,2322.0,0.799,14.018,0,0,0,0,0,0,0,0,0.0,0.0
1007,2314,26-09-2019 16:46:00,1,2861.0,2469.0,0.863,14.007,0,0,0,0,0,0,0,0,0.0,0.0
1007,2315,26-09-2019 16:48:00,1,2840.0,2542.0,0.895,14.003,7,3,1,2,4,4,0,0,0.0,0.0
1007,2316,26-09-2019 16:50:00,1,2843.0,2579.0,0.907,14.056,298,78,59,19,220,198,22,0,0.0,0.01
1007,2317,26-09-2019 16:52:00,1,2955.0,2632.0,0.891,14.557,87,10,0,10,77,73,4,0,0.0,0.0
1007,2318,26-09-2019 16:54:00,1,2932.0,2483.0,0.8465,14.302,52,9,5,4,43,38,5,0,0.0,0.0
1007,2319,26-09-2019 16:56:00,1,2909.0,2334.0,0.802,14.047,241,61,30,31,180,163,17,0,0.0,0.0
1007,2320,26-09-2019 16:58:00,1,2879.0,2410.0,0.837,14.011,357,78,49,29,279,255,24,0,0.0,0.0
1007,2321,26-09-2019 17:00:00,1,3086.0,2609.0,0.845,15.047,343,60,35,25,283,259,24,0,0.0,0.0
1007,2322,26-09-2019 17:02:00,1,3047.0,2755.0,0.904,15.057,225,59,32,27,166,147,19,13,0.0,0.0
1007,2323,26-09-2019 17:04:00,1,3568.0,3147.0,0.882,17.54,340,143,96,47,197,181,16,49,0.0,0.01
1007,2324,26-09-2019 17:06:00,1,3685.0,3205.0,0.87,18.067,319,94,60,34,225,217,8,61,0.0,0.02
1007,2325,26-09-2019 17:08:00,1,3909.0,3271.0,0.837,19.022,621,153,118,35,468,426,42,56,0.0,0.11
1007,2326,26-09-2019 17:10:00,1,3579.0,3136.0,0.876,17.575,439,111,77,34,328,301,27,19,0.01,0.0
1007,2327,26-09-2019 17:12:00,1,3697.0,3165.0,0.856,18.071,499,173,132,41,326,302,24,38,0.0,0.0
1007,2328,26-09-2019 17:14:00,1,3576.0,3065.0,0.857,17.482,308,75,26,49,233,213,20,0,0.0,0.0
1007,2329,26-09-2019 17:16:00,1,3601.0,2977.0,0.827,17.483,193,21,3,18,172,154,18,0,0.0,0.0
1007,2330,26-09-2019 17:18:00,1,3508.0,2906.0,0.828,17.038,296,40,10,30,256,227,29,0,0.0,0.0
1007,2331,26-09-2019 17:20:00,1,3501.0,2899.0,0.828,17.005,318,31,8,23,287,257,30,0,0.0,0.0
1007,2332,26-09-2019 17:22:00,1,3624.0,2974.0,0.82,17.572,303,47,7,40,256,238,18,0,0.0,0.0
1007,2333,26-09-2019 17:24:00,1,3516.0,2919.0,0.83,17.084,23,10,2,8,13,13,0,0,0.0,0.0
1007,2334,26-09-2019 17:26:00,1,3065.0,2699.0,0.881,15.065,476,9,0,9,467,443,24,0,0.0,0.0
1007,2335,26-09-2019 17:28:00,1,3064.0,2663.0,0.869,15.0215,22,22,18,4,0,0,0,0,0.0,0.0
1007,2336,26-09-2019 17:30:00,1,3063.0,2627.0,0.857,14.978,30,1,1,0,29,25,4,0,0.0,0.0
1007,2337,26-09-2019 17:32:00,1,3311.0,2718.0,0.821,16.056,23,0,0,0,23,21,2,0,0.01,0.0
1007,2338,26-09-2019 17:34:00,1,3306.0,2699.0,0.816,16.014,356,58,38,20,298,266,32,36,0.0,0.0
1007,2339,26-09-2019 17:36:00,1,3616.0,2981.0,0.824,17.549,313,148,106,42,165,152,13,61,0.0,0.0
1007,2340,26-09-2019 17:38:00,1,3732.0,3001.0,0.804,18.026,269,92,59,33,177,165,12,56,0.0,0.0
1007,2341,26-09-2019 17:40:00,1,3950.0,3142.0,0.796,19.041,282,77,44,33,205,198,7,74,0.0,0.0
1007,2342,26-09-2019 17:42:00,1,3940.0,3178.0,0.807,19.043,268,41,15,26,227,224,3,52,0.0,0.0
1007,2343,26-09-2019 17:44:00,1,4158.0,3313.0,0.797,20.053,193,55,24,31,138,136,2,58,0.0,0.05
1007,2344,26-09-2019 17:46:00,1,4129.0,3397.0,0.823,20.031,503,151,109,42,352,323,29,33,0.05,0.08
1007,2345,26-09-2019 17:48:00,1,4020.0,3336.0,0.83,19.533,422,148,107,41,274,245,29,16,0.08,0.0
1007,2346,26-09-2019 17:50:00,1,3594.0,2993.0,0.833,17.473,181,34,7,27,147,132,15,0,0.0,0.0
1007,2347,26-09-2019 17:52:00,1,3722.0,3053.0,0.82,18.044,318,24,5,19,294,265,29,0,0.0,0.0
1007,2348,26-09-2019 17:54:00,1,3833.0,3102.0,0.809,18.537,31,3,2,1,28,28,0,0,0.0,0.0
1007,2349,26-09-2019 17:56:00,1,3820.0,3164.0,0.828,18.555,4,0,0,0,4,4,0,0,0.0,0.0
1007,2350,26-09-2019 17:58:00,1,3806.0,3182.0,0.836,18.517,25,0,0,0,25,24,1,0,0.0,0.0
1007,2351,26-09-2019 18:00:00,0,3577.0,3132.0,0.876,17.562,75,35,29,6,40,38,2,3,0.0,0.0
1007,2352,26-09-2019 18:02:00,0,3806.0,3443.5,0.9035,18.8095,532,228,174,54,304,278,26,88,0.0,0.0
1007,2353,26-09-2019 18:04:00,0,4035.0,3755.0,0.931,20.057,597,230,184,46,367,337,30,137,0.01,0.0
1007,2354,26-09-2019 18:06:00,0,4036.0,3764.0,0.933,20.07,578,214,172,42,364,328,36,96,0.04,0.0
1007,2355,26-09-2019 18:08:00,0,4386.0,3935.0,0.897,21.637,465,180,132,48,285,265,20,63,0.0,0.0
1007,2356,26-09-2019 18:10:00,0,4040.0,3756.0,0.93,20.073,589,182,140,42,407,372,35,48,0.0,0.0
1007,2357,26-09-2019 18:12:00,0,4558.0,4129.0,0.906,22.529,443,207,151,56,236,211,25,45,0.0,0.0
1007,2358,26-09-2019 18:14:00,0,4369.0,3949.0,0.904,21.586,565,164,108,56,401,363,38,9,0.02,0.0
1007,2359,26-09-2019 18:16:00,0,4340.0,4037.0,0.93,21.569,262,106,66,40,156,139,17,11,0.0,0.0
1007,2360,26-09-2019 18:18:00,0,4335.0,4049.0,0.934,21.562,298,81,58,23,217,185,32,22,0.0,0.0
1007,2361,26-09-2019 18:20:00,0,3853.0,3470.0,0.901,19.022,660,181,131,50,479,421,58,32,0.0,0.0
1007,2362,26-09-2019 18:22:00,0,4372.0,3945.0,0.902,21.592,532,244,184,60,288,257,31,41,0.0,0.0
1007,2363,26-09-2019 18:24:00,0,4328.0,4081.0,0.943,21.569,175,103,57,46,72,65,7,1,0.0,0.0
1007,2364,26-09-2019 18:26:00,0,4353.0,3979.0,0.914,21.556,374,163,112,51,211,199,12,7,0.0,0.0
1007,2365,26-09-2019 18:28:00,0,4348.0,3971.0,0.913,21.527,517,205,148,57,312,279,33,26,0.0,0.0
1007,2366,26-09-2019 18:30:00,0,4032.0,3807.0,0.944,20.1,207,41,23,18,166,154,12,0,0.0,0.0
1007,2367,26-09-2019 18:32:00,0,3965.0,3552.0,0.896,19.552,145,40,16,24,105,79,26,0,0.0,0.0
1007,2368,26-09-2019 18:34:00,0,4073.0,3594.0,0.882,20.025,68,29,12,17,39,16,23,0,0.0,0.0
1007,2369,26-09-2019 18:36:00,0,3817.0,3373.0,0.8835,18.773,18,5,1,4,13,5,8,0,0.0,0.0
1007,2370,26-09-2019 18:38:00,0,3561.0,3152.0,0.885,17.521,2,0,0,0,2,0,2,0,0.0,0.0
1007,2371,26-09-2019 18:40:00,0,3478.0,3038.0,0.873,17.069,86,34,14,20,52,24,28,0,0.0,0.0
1007,2372,26-09-2019 18:42:00,0,3662.0,3273.0,0.894,18.052,379,221,177,44,158,102,56,30,0.0,0.0
1007,2373,26-09-2019 18:44:00,0,4080.0,3598.0,0.882,20.06,414,132,94,38,282,241,41,55,0.0,0.0
1007,2374,26-09-2019 18:46:00,0,3864.0,3443.0,0.891,19.036,135,134,107,27,1,0,1,0,0.0,0.0
1007,2375,26-09-2019 18:48:00,0,3556.0,3193.0,0.898,17.546,17,17,7,10,0,0,0,0,0.0,0.0
1007,2376,26-09-2019 18:50:00,0,3593.0,3047.0,0.848,17.528,1,1,0,1,0,0,0,0,0.0,0.0
1007,2377,26-09-2019 18:52:00,0,3373.0,2954.0,0.876,16.558,204,21,6,15,183,171,12,0,0.0,0.0
1007,2378,26-09-2019 18:54:00,0,3379.0,2867.0,0.848,16.489,35,6,4,2,29,28,1,0,0.0,0.0
1007,2379,26-09-2019 18:56:00,0,3035.0,2792.0,0.92,15.049,144,8,3,5,136,121,15,0,0.0,0.0
1007,2380,26-09-2019 18:58:00,0,3041.0,2746.0,0.903,15.023,6,4,0,4,2,2,0,0,0.0,0.0
1007,2381,26-09-2019 19:00:00,0,3063.0,2697.0,0.881,15.054,4,3,0,3,1,0,1,0,0.0,0.0
1007,2382,26-09-2019 19:02:00,0,3073.0,2626.0,0.855,15.015,9,7,0,7,2,2,0,0,0.0,0.0
1007,2383,26-09-2019 19:04:00,0,3086.0,2607.0,0.845,15.047,317,46,28,18,271,249,22,0,0.0,0.0
1007,2384,26-09-2019 19:06:00,0,3065.0,2631.0,0.858,14.989,617,205,159,46,412,365,47,29,0.0,0.0
1007,2385,26-09-2019 19:08:00,0,3385.0,2876.0,0.85,16.523,386,136,94,42,250,226,24,62,0.0,0.0
1007,2386,26-09-2019 19:10:00,0,3385.0,2882.5,0.852,16.5285,245,101,67,34,144,127,17,13,0.0,0.0
1007,2387,26-09-2019 19:12:00,0,3385.0,2889.0,0.854,16.534,361,198,129,69,163,146,17,3,0.0,0.0
1007,2388,26-09-2019 19:14:00,0,3638.0,2927.0,0.804,17.573,227,91,54,37,136,127,9,4,0.0,0.0
1007,2389,26-09-2019 19:16:00,0,3715.0,3074.0,0.827,18.041,286,119,82,37,167,151,16,20,0.0,0.0
1007,2390,26-09-2019 19:18:00,0,3602.0,3058.0,0.849,17.578,348,141,107,34,207,184,23,16,0.02,0.0
1007,2391,26-09-2019 19:20:00,0,3834.0,3071.0,0.801,18.509,475,154,127,27,321,277,44,6,0.0,0.0
1007,2392,26-09-2019 19:22:00,0,3618.0,2986.0,0.825,17.563,289,129,78,51,160,144,16,7,0.0,0.0
1007,2393,26-09-2019 19:24:00,0,3944.0,3189.0,0.809,19.072,500,181,146,35,319,279,40,59,0.02,0.0
1007,2394,26-09-2019 19:26:00,0,3843.0,3052.0,0.794,18.523,328,85,67,18,243,220,23,26,0.0,0.0
1007,2395,26-09-2019 19:28:00,0,3849.0,3028.0,0.787,18.52,264,72,53,19,192,174,18,10,0.08,0.0
1007,2396,26-09-2019 19:30:00,0,4155.0,3295.0,0.793,20.018,159,50,32,18,109,90,19,10,0.0,0.0
1007,2397,26-09-2019 19:32:00,0,3951.0,3129.0,0.792,19.032,264,34,9,25,230,202,28,1,0.0,0.0
1007,2398,26-09-2019 19:34:00,0,3621.0,2943.0,0.813,17.527,170,55,32,23,115,102,13,10,0.0,0.0
1007,2399,26-09-2019 19:36:00,0,3963.0,3119.0,0.787,19.067,526,168,127,41,358,323,35,41,0.0,0.0
1007,2400,26-09-2019 19:38:00,0,3410.0,2780.0,0.815,16.513,326,112,71,41,214,193,21,0,0.0,0.0
1007,2401,26-09-2019 19:40:00,0,3864.0,2999.0,0.776,18.544,496,155,113,42,341,310,31,34,0.0,0.0
1007,2402,26-09-2019 19:42:00,0,3623.0,2904.0,0.801,17.492,185,79,41,38,106,83,23,2,0.0,0.0
1007,2403,26-09-2019 19:44:00,0,3629.5,2922.0,0.805,17.5365,136,80,61,19,56,41,15,13,0.0,0.0
1007,2404,26-09-2019 19:46:00,0,3636.0,2940.0,0.809,17.581,338,120,76,44,218,186,32,8,0.0,0.0
1007,2405,26-09-2019 19:48:00,0,3656.0,2846.0,0.778,17.557,80,13,4,9,67,63,4,0,0.0,0.0
1007,2406,26-09-2019 19:50:00,0,3445.0,2659.0,0.772,16.517,15,13,6,7,2,2,0,0,0.0,0.0
1007,2407,26-09-2019 19:52:00,0,3108.0,2514.0,0.809,15.027,23,4,3,1,19,17,2,0,0.0,0.0
1007,2408,26-09-2019 19:54:00,0,3123.0,2465.0,0.789,15.036,3,3,0,3,0,0,0,0,0.0,0.0
1007,2409,26-09-2019 19:56:00,0,3141.0,2378.0,0.757,15.011,11,11,3,8,0,0,0,0,0.0,0.0
1007,2410,26-09-2019 19:58:00,0,3036.0,2316.0,0.763,14.525,2,1,0,1,1,0,1,0,0.0,0.0
1007,2411,26-09-2019 20:00:00,0,2926.0,2245.0,0.767,14.014,9,9,0,9,0,0,0,0,0.0,0.0
1007,2412,26-09-2019 20:02:00,0,2944.0,2167.0,0.736,14.0,173,13,7,6,160,149,11,0,0.0,0.0
1007,2413,26-09-2019 20:04:00,0,2951.0,2159.0,0.732,14.017,3,3,0,3,0,0,0,0,0.0,0.0
1007,2414,26-09-2019 20:06:00,0,2958.0,2127.0,0.719,14.01,6,4,2,2,2,2,0,0,0.0,0.0
1007,2415,26-09-2019 20:08:00,0,2976.0,2106.0,0.708,14.059,12,0,0,0,12,11,1,0,0.0,0.0
1007,2416,26-09-2019 20:10:00,0,2850.0,2057.0,0.722,13.507,141,0,0,0,141,124,17,0,0.0,0.0
1007,2417,26-09-2019 20:12:00,0,2735.0,2029.0,0.742,13.025,3,0,0,0,3,3,0,0,0.0,0.0
1007,2418,26-09-2019 20:14:00,0,2626.0,1986.0,0.757,12.544,6,0,0,0,6,6,0,0,0.0,0.0
1007,2419,26-09-2019 20:16:00,0,2627.0,1958.0,0.745,12.518,0,0,0,0,0,0,0,0,0.0,0.0
1007,2420,26-09-2019 20:18:00,0,2637.5,1925.0,0.73,12.523,0,0,0,0,0,0,0,0,0.0,0.0
1007,2421,26-09-2019 20:20:00,0,2648.0,1892.0,0.715,12.528,9,3,0,3,6,6,0,0,0.0,0.0
1007,2422,26-09-2019 20:22:00,0,2645.0,1911.0,0.723,12.539,6,3,1,2,3,2,1,0,0.0,0.0
1007,2423,26-09-2019 20:24:00,0,2636.0,1898.0,0.72,12.487,147,48,25,23,99,86,13,3,0.0,0.0
1007,2424,26-09-2019 20:26:00,0,2740.0,1994.0,0.728,13.006,476,188,148,40,288,258,30,71,0.0,0.0
1007,2425,26-09-2019 20:28:00,0,3139.0,2420.0,0.771,15.046,446,162,130,32,284,252,32,74,0.0,0.0
1007,2426,26-09-2019 20:30:00,0,3124.0,2426.0,0.776,14.995,519,168,127,41,351,312,39,55,0.0,0.0
1007,2427,26-09-2019 20:32:00,0,3579.0,2612.0,0.73,16.992,430,195,131,64,235,205,30,34,0.0,0.0
1007,2428,26-09-2019 20:34:00,0,3796.0,2770.0,0.73,18.022,458,148,111,37,310,279,31,35,0.0,0.0
1007,2429,26-09-2019 20:36:00,0,3698.0,2659.0,0.719,17.515,164,63,37,26,101,89,12,4,0.0,0.0
1007,2430,26-09-2019 20:38:00,0,3675.0,2762.0,0.752,17.538,288,128,98,30,160,138,22,12,0.0,0.0
1007,2431,26-09-2019 20:40:00,0,3790.0,2792.0,0.737,18.024,86,55,15,40,31,29,2,0,0.0,0.0
1007,2432,26-09-2019 20:42:00,0,3591.0,2580.0,0.718,17.006,221,83,43,40,138,126,12,8,0.0,0.0
1007,2433,26-09-2019 20:44:00,0,3703.0,2601.0,0.703,17.47,456,164,118,46,292,258,34,18,0.0,0.0
1007,2434,26-09-2019 20:46:00,0,3918.0,2787.0,0.711,18.523,268,93,51,42,175,148,27,6,0.0,0.0
1007,2435,26-09-2019 20:48:00,0,4095.0,3017.0,0.737,19.473,317,133,101,32,184,159,25,57,0.0,0.0
1007,2436,26-09-2019 20:50:00,0,4003.0,2917.0,0.729,19.003,357,142,105,37,215,193,22,4,0.0,0.0
1007,2437,26-09-2019 20:52:00,0,3840.5,2832.5,0.738,18.2685,167,69,38,31,98,76,22,0,0.0,0.0
1007,2438,26-09-2019 20:54:00,0,3678.0,2748.0,0.747,17.534,561,222,171,51,339,293,46,65,0.0,0.0
1007,2439,26-09-2019 20:56:00,0,3682.0,2723.0,0.74,17.522,208,92,52,40,116,104,12,0,0.0,0.0
1007,2440,26-09-2019 20:58:00,0,4036.0,2810.0,0.696,19.014,223,39,12,27,184,173,11,0,0.0,0.0
1007,2441,26-09-2019 21:00:00,0,3675.0,2737.0,0.745,17.509,240,48,25,23,192,176,16,0,0.0,0.0
1007,2442,26-09-2019 21:02:00,0,3773.0,2805.0,0.743,17.974,659,232,176,56,427,372,55,27,0.0,0.0
1007,2443,26-09-2019 21:04:00,0,3893.0,2866.0,0.736,18.511,275,123,86,37,152,132,20,34,0.0,0.0
1007,2444,26-09-2019 21:06:00,0,4165.0,3259.0,0.782,20.019,607,273,206,67,334,291,43,31,0.0,0.0
1007,2445,26-09-2019 21:08:00,0,3991.0,2946.0,0.738,18.985,508,264,209,55,244,193,51,82,0.0,0.0
1007,2446,26-09-2019 21:10:00,0,3974.0,3021.0,0.76,19.003,439,296,218,78,143,99,44,9,0.0,0.0
1007,2447,26-09-2019 21:12:00,0,3985.0,3029.0,0.76,19.056,509,307,233,74,202,152,50,10,0.0,0.0
1007,2448,26-09-2019 21:14:00,0,4215.0,3074.0,0.729,20.011,384,133,104,29,251,199,52,14,0.01,0.0
1007,2449,26-09-2019 21:16:00,0,3788.0,2773.0,0.732,17.996,251,140,96,44,111,85,26,22,0.0,0.0
1007,2450,26-09-2019 21:18:00,0,4024.0,2839.0,0.706,18.999,384,198,136,62,186,153,33,2,0.0,0.0
1007,2451,26-09-2019 21:20:00,0,4194.0,3151.0,0.751,20.013,323,120,81,39,203,167,36,9,0.0,0.0
1007,2452,26-09-2019 21:22:00,0,4036.0,2776.0,0.688,18.975,254,37,10,27,217,196,21,0,0.0,0.0
1007,2453,26-09-2019 21:24:00,0,3808.0,2767.0,0.726,18.068,235,67,26,41,168,149,19,0,0.0,0.0
1007,2454,26-09-2019 21:26:00,0,3863.0,2780.5,0.7195,18.3,307,79,34,45,228,210,18,1,0.0,0.0
1007,2455,26-09-2019 21:28:00,0,3918.0,2794.0,0.713,18.532,531,137,98,39,394,358,36,17,0.0,0.0
1007,2456,26-09-2019 21:30:00,0,3921.0,2820.0,0.719,18.57,650,220,166,54,430,383,47,33,0.05,0.0
1007,2457,26-09-2019 21:32:00,0,4007.0,2903.0,0.725,19.003,169,63,39,24,106,88,18,9,0.0,0.0
1007,2458,26-09-2019 21:34:00,0,3676.0,2760.0,0.751,17.541,347,90,65,25,257,230,27,3,0.0,0.0
1007,2459,26-09-2019 21:36:00,0,3693.0,2686.0,0.727,17.524,189,38,16,22,151,135,16,0,0.0,0.0
1007,2460,26-09-2019 21:38:00,0,3467.0,2559.0,0.738,16.493,2,0,0,0,2,0,2,0,0.0,0.0
1007,2461,26-09-2019 21:40:00,0,3273.0,2388.0,0.73,15.54,0,0,0,0,0,0,0,0,0.0,0.0
1007,2462,26-09-2019 21:42:00,0,3166.0,2289.0,0.723,15.008,7,2,1,1,5,5,0,0,0.0,0.0
1007,2463,26-09-2019 21:44:00,0,3180.0,2225.0,0.7,14.995,10,2,2,0,8,8,0,0,0.0,0.0
1007,2464,26-09-2019 21:46:00,0,3176.0,2215.0,0.697,14.964,21,5,3,2,16,12,4,0,0.0,0.0
1007,2465,26-09-2019 21:48:00,0,2949.0,2172.0,0.737,14.025,53,0,0,0,53,47,6,0,0.0,0.0
1007,2466,26-09-2019 21:50:00,0,2953.0,2107.0,0.713,13.968,1,0,0,0,1,1,0,0,0.0,0.0
1007,2467,26-09-2019 21:52:00,0,2977.0,2070.0,0.695,14.02,5,2,1,1,3,2,1,0,0.0,0.0
1007,2468,26-09-2019 21:54:00,0,2980.0,2034.0,0.683,13.993,3,0,0,0,3,3,0,0,0.0,0.0
1007,2469,26-09-2019 21:56:00,0,2766.0,1956.0,0.707,13.065,9,0,0,0,9,6,3,0,0.0,0.0
1007,2470,26-09-2019 21:58:00,0,2642.0,1924.0,0.728,12.542,30,1,0,1,29,22,7,0,0.0,0.0
1007,2471,26-09-2019 22:00:00,0,2640.5,1920.5,0.727,12.5315,18,4,1,3,14,13,1,0,0.0,0.0
1007,2472,26-09-2019 22:02:00,0,2639.0,1917.0,0.726,12.521,3,0,0,0,3,3,0,0,0.0,0.0
1007,2473,26-09-2019 22:04:00,0,2649.0,1874.0,0.708,12.511,14,10,2,8,4,4,0,0,0.0,0.0
1007,2474,26-09-2019 22:06:00,0,2651.0,1863.0,0.703,12.507,137,137,109,28,0,0,0,0,0.0,0.0
1007,2475,26-09-2019 22:08:00,0,2665.0,1811.0,0.68,12.508,18,18,2,16,0,0,0,0,0.0,0.0
1007,2476,26-09-2019 22:10:00,0,2549.0,1759.0,0.69,11.99,52,0,0,0,52,46,6,0,0.0,0.0
1007,2477,26-09-2019 22:12:00,0,2433.0,1730.0,0.711,11.504,388,120,96,24,268,232,36,33,0.0,0.0
1007,2478,26-09-2019 22:14:00,0,2653.0,1865.0,0.703,12.518,434,198,152,46,236,207,29,58,0.0,0.0
1007,2479,26-09-2019 22:16:00,0,2965.0,2140.0,0.722,14.053,312,120,82,38,192,171,21,120,0.0,0.0
1007,2480,26-09-2019 22:18:00,0,2940.0,2184.0,0.743,14.0,463,202,151,51,261,232,29,4,0.0,0.0
1007,2481,26-09-2019 22:20:00,0,3913.0,2760.0,0.705,18.475,466,225,167,58,241,206,35,15,0.0,0.0
1007,2482,26-09-2019 22:22:00,0,3810.0,2712.0,0.712,18.015,303,106,64,42,197,178,19,17,0.0,0.0
1007,2483,26-09-2019 22:24:00,0,3499.0,2486.0,0.71,16.54,242,55,22,33,187,161,26,0,0.0,0.0
1007,2484,26-09-2019 22:26:00,0,3715.0,2557.0,0.688,17.467,368,166,122,44,202,182,20,36,0.0,0.0
1007,2485,26-09-2019 22:28:00,0,3606.0,2545.0,0.706,17.028,758,299,223,76,459,401,58,16,0.0,0.0
1007,2486,26-09-2019 22:30:00,0,3690.0,2715.0,0.736,17.545,366,143,107,36,223,200,23,2,0.0,0.0
1007,2487,26-09-2019 22:32:00,0,4019.0,2890.0,0.719,19.035,227,91,65,26,136,116,20,3,0.0,0.0
1007,2488,26-09-2019 22:34:00,0,4033.0,2823.5,0.7,19.017,490,206,152,54,284,252,32,4,0.0,0.0
1007,2489,26-09-2019 22:36:00,0,4047.0,2757.0,0.681,18.999,248,104,67,37,144,122,22,3,0.0,0.0
1007,2490,26-09-2019 22:38:00,0,3719.0,2583.0,0.694,17.513,201,86,44,42,115,100,15,0,0.0,0.0
1007,2491,26-09-2019 22:40:00,0,3612.0,2546.0,0.705,17.051,110,46,13,33,64,50,14,0,0.0,0.0
1007,2492,26-09-2019 22:42:00,0,3479.0,2499.0,0.718,16.474,294,137,97,40,157,131,26,14,0.01,0.0
1007,2493,26-09-2019 22:44:00,0,3698.0,2650.0,0.717,17.504,501,240,184,56,261,235,26,67,0.0,0.0
1007,2494,26-09-2019 22:46:00,0,3929.0,2764.0,0.703,18.542,407,148,103,45,259,223,36,6,0.0,0.0
1007,2495,26-09-2019 22:48:00,0,3813.0,2699.0,0.708,18.013,89,52,33,19,37,26,11,0,0.0,0.0
1007,2496,26-09-2019 22:50:00,0,4028.0,2792.0,0.693,18.964,133,37,25,12,96,74,22,0,0.0,0.0
1007,2497,26-09-2019 22:52:00,0,3729.0,2589.0,0.694,17.558,332,55,14,41,277,238,39,0,0.0,0.0
1007,2498,26-09-2019 22:54:00,0,3487.0,2507.0,0.719,16.517,223,52,19,33,171,158,13,0,0.0,0.0
1007,2499,26-09-2019 22:56:00,0,3686.0,2655.0,0.72,17.463,497,116,83,33,381,336,45,3,0.08,0.0
1007,2500,26-09-2019 22:58:00,0,3728.0,2566.0,0.688,17.531,636,184,134,50,452,399,53,18,0.01,0.0
1007,2501,26-09-2019 23:00:00,0,3808.0,2735.0,0.718,18.031,354,213,152,61,141,120,21,6,0.0,0.0
1007,2502,26-09-2019 23:02:00,0,4039.0,2764.0,0.685,18.974,118,89,50,39,29,25,4,1,0.0,0.0
1007,2503,26-09-2019 23:04:00,0,4029.0,2812.0,0.698,18.99,388,178,124,54,210,184,26,6,0.08,0.0
1007,2504,26-09-2019 23:06:00,0,3678.0,2734.0,0.743,17.52,305,82,57,25,223,204,19,16,0.0,0.0
1007,2505,26-09-2019 23:08:00,0,3685.0,2709.0,0.735,17.519,232,71,34,37,161,134,27,0,0.0,0.0
1007,2506,26-09-2019 23:10:00,0,3692.0,2684.0,0.727,17.518,184,99,49,50,85,77,8,0,0.0,0.0
1007,2507,26-09-2019 23:12:00,0,3703.0,2649.0,0.715,17.524,185,78,46,32,107,102,5,0,0.0,0.0
1007,2508,26-09-2019 23:14:00,0,3700.0,2621.0,0.709,17.48,234,101,53,48,133,127,6,0,0.0,0.0
1007,2509,26-09-2019 23:16:00,0,3724.0,2576.0,0.692,17.524,312,74,31,43,238,219,19,0,0.0,0.0
1007,2510,26-09-2019 23:18:00,0,3703.0,2618.0,0.707,17.489,558,235,160,75,323,278,45,4,0.0,0.0
1007,2511,26-09-2019 23:20:00,0,3944.0,2762.0,0.7,18.598,491,264,203,61,227,199,28,10,0.07,0.0
1007,2512,26-09-2019 23:22:00,0,3706.0,2601.0,0.702,17.481,179,106,63,43,73,63,10,15,0.0,0.0
1007,2513,26-09-2019 23:24:00,0,3687.0,2672.0,0.725,17.484,169,52,34,18,117,95,22,43,0.0,0.0
1007,2514,26-09-2019 23:26:00,0,4023.0,2869.0,0.713,19.028,357,166,135,31,191,168,23,19,0.0,0.0
1007,2515,26-09-2019 23:28:00,0,3707.0,2567.0,0.692,17.448,470,269,199,70,201,180,21,7,0.0,0.0
1007,2516,26-09-2019 23:30:00,0,3702.0,2673.0,0.722,17.544,123,95,49,46,28,28,0,0,0.0,0.0
1007,2517,26-09-2019 23:32:00,0,3716.0,2573.0,0.692,17.491,219,79,34,45,140,128,12,0,0.0,0.0
1007,2518,26-09-2019 23:34:00,0,3726.0,2554.0,0.685,17.509,309,128,88,40,181,160,21,14,0.0,0.0
1007,2519,26-09-2019 23:36:00,0,3716.0,2569.0,0.691,17.487,317,44,9,35,273,253,20,0,0.0,0.0
1007,2520,26-09-2019 23:38:00,0,3601.0,2515.0,0.699,16.972,265,64,45,19,201,170,31,22,0.0,0.0
1007,2521,26-09-2019 23:40:00,0,3732.0,2572.0,0.689,17.552,305,183,144,39,122,84,38,59,0.0,0.0
1007,2522,26-09-2019 23:42:00,0,3606.5,2527.5,0.701,17.0085,217,110,73,37,107,54,53,4,0.0,0.0
1007,2523,26-09-2019 23:44:00,0,3481.0,2483.0,0.713,16.465,122,51,25,26,71,41,30,0,0.0,0.0
1007,2524,26-09-2019 23:46:00,0,3497.0,2462.0,0.704,16.505,28,16,10,6,12,0,12,0,0.0,0.0
1007,2525,26-09-2019 23:48:00,0,3388.0,2369.0,0.699,15.971,54,21,8,13,33,4,29,0,0.0,0.0
1007,2526,26-09-2019 23:50:00,0,3398.0,2383.0,0.701,16.028,36,17,9,8,19,8,11,0,0.0,0.0
1007,2527,26-09-2019 23:52:00,0,3200.0,2224.0,0.695,15.072,33,3,1,2,30,3,27,0,0.0,0.0
1007,2528,26-09-2019 23:54:00,0,3081.0,2117.0,0.687,14.484,13,10,4,6,3,0,3,0,0.0,0.0
1007,2529,26-09-2019 23:56:00,0,2967.0,2124.0,0.716,14.042,3,2,1,1,1,0,1,0,0.0,0.0
1007,2530,26-09-2019 23:58:00,0,2974.0,2045.0,0.688,13.984,32,29,3,26,3,0,3,0,0.0,0.0
1007,2531,27-09-2019 00:00:00,0,2889.0,1928.0,0.667,13.519,45,45,0,45,0,0,0,0,0.0,0.0
1007,2532,27-09-2019 00:02:00,0,2657.0,1837.0,0.692,12.503,1,0,0,0,1,0,1,0,0.0,0.0
1007,2533,27-09-2019 00:04:00,0,2678.0,1746.0,0.652,12.485,0,0,0,0,0,0,0,0,0.0,0.0
1007,2534,27-09-2019 00:06:00,0,2571.0,1679.0,0.653,11.987,54,39,28,11,15,6,9,3,0.0,0.0
1007,2535,27-09-2019 00:08:00,0,2750.0,1961.0,0.713,13.005,206,133,94,39,73,63,10,20,0.0,0.0
1007,2536,27-09-2019 00:10:00,0,2979.0,2089.0,0.701,14.05,352,235,187,48,117,81,36,42,0.0,0.0
1007,2537,27-09-2019 00:12:00,0,3180.0,2244.0,0.705,15.015,279,242,165,77,37,22,15,2,0.0,0.0
1007,2538,27-09-2019 00:14:00,0,3509.0,2435.0,0.694,16.521,299,269,195,74,30,19,11,8,0.0,0.0
1007,2539,27-09-2019 00:16:00,0,3496.5,2472.5,0.707,16.513,312,136,108,28,176,135,41,45,0.0,0.0
1007,2540,27-09-2019 00:18:00,0,3484.0,2510.0,0.72,16.505,237,180,116,64,57,37,20,1,0.0,0.0
1007,2541,27-09-2019 00:20:00,0,3383.0,2409.0,0.712,15.995,66,51,22,29,15,7,8,0,0.0,0.0
1007,2542,27-09-2019 00:22:00,0,3391.0,2399.0,0.708,16.016,126,94,73,21,32,20,12,9,0.0,0.0
1007,2543,27-09-2019 00:24:00,0,3574.0,2628.0,0.735,16.993,208,146,106,40,62,40,22,15,0.0,0.0
1007,2544,27-09-2019 00:26:00,0,3589.0,2580.0,0.719,16.997,316,201,160,41,115,84,31,27,0.0,0.0
1007,2545,27-09-2019 00:28:00,0,3263.0,2387.0,0.732,15.5,235,195,143,52,40,24,16,5,0.0,0.0
1007,2546,27-09-2019 00:30:00,0,3574.0,2621.0,0.733,16.983,222,147,100,47,75,42,33,5,0.0,0.0
1007,2547,27-09-2019 00:32:00,0,3597.0,2516.0,0.7,16.957,110,53,10,43,57,31,26,0,0.0,0.0
1007,2548,27-09-2019 00:34:00,0,3393.0,2403.0,0.708,16.031,106,90,51,39,16,6,10,5,0.0,0.0
1007,2549,27-09-2019 00:36:00,0,3600.0,2553.0,0.709,17.01,134,57,42,15,77,60,17,10,0.0,0.0
1007,2550,27-09-2019 00:38:00,0,3363.0,2521.0,0.75,16.044,143,75,52,23,68,46,22,29,0.0,0.0
1007,2551,27-09-2019 00:40:00,0,3613.0,2540.0,0.703,17.049,130,59,37,22,71,51,20,18,0.0,0.0
1007,2552,27-09-2019 00:42:00,0,3264.0,2382.0,0.73,15.5,297,84,55,29,213,164,49,23,0.0,0.0
1007,2553,27-09-2019 00:44:00,0,3376.0,2443.0,0.723,16.008,162,76,46,30,86,73,13,34,0.0,0.0
1007,2554,27-09-2019 00:46:00,0,3365.0,2482.0,0.737,16.008,195,79,45,34,116,92,24,12,0.05,0.0
1007,2555,27-09-2019 00:48:00,0,3406.0,2380.0,0.699,16.055,92,42,16,26,50,19,31,0,0.01,0.0
1007,2556,27-09-2019 00:50:00,0,3230.0,2311.5,0.717,15.285,15,8,1,7,7,3,4,0,0.0,0.0
1007,2557,27-09-2019 00:52:00,0,3054.0,2243.0,0.735,14.515,6,0,0,0,6,1,5,0,0.0,0.0
1007,2558,27-09-2019 00:54:00,0,2849.0,2085.0,0.732,13.534,2,1,0,1,1,0,1,0,0.0,0.0
1007,2559,27-09-2019 00:56:00,0,2875.0,1978.0,0.688,13.517,0,0,0,0,0,0,0,0,0.0,0.0
1007,2560,27-09-2019 00:58:00,0,2896.0,1889.0,0.652,13.501,35,17,7,10,18,10,8,0,0.0,0.0
1007,2561,27-09-2019 01:00:00,0,2767.0,1870.0,0.676,12.973,0,0,0,0,0,0,0,0,0.0,0.0
1007,2562,27-09-2019 01:02:00,0,2534.0,1820.0,0.718,11.998,0,0,0,0,0,0,0,0,0.0,0.0
1007,2563,27-09-2019 01:04:00,0,2548.0,1761.0,0.691,11.991,2,0,0,0,2,0,2,0,0.0,0.0
1007,2564,27-09-2019 01:06:00,0,2566.0,1715.0,0.668,12.01,4,3,1,2,1,0,1,0,0.0,0.0
1007,2565,27-09-2019 01:08:00,0,2570.0,1686.0,0.656,11.993,8,3,0,3,5,2,3,0,0.0,0.0
1007,2566,27-09-2019 01:10:00,0,2335.0,1640.0,0.703,11.016,0,0,0,0,0,0,0,0,0.0,0.0
1007,2567,27-09-2019 01:12:00,0,2344.0,1579.0,0.673,10.983,33,10,2,8,23,11,12,0,0.0,0.0
1007,2568,27-09-2019 01:14:00,0,2336.0,1617.0,0.692,10.996,1,0,0,0,1,0,1,0,0.0,0.0
1007,2569,27-09-2019 01:16:00,0,2336.0,1587.0,0.679,10.964,6,0,0,0,6,2,4,0,0.0,0.0
1007,2570,27-09-2019 01:18:00,0,2354.0,1568.0,0.666,11.012,2,0,0,0,2,0,2,0,0.0,0.0
1007,2571,27-09-2019 01:20:00,0,2234.0,1541.0,0.69,10.508,3,0,0,0,3,0,3,0,0.0,0.0
1007,2572,27-09-2019 01:22:00,0,2111.0,1521.0,0.721,9.999,5,0,0,0,5,0,5,0,0.0,0.0
1007,2573,27-09-2019 01:24:00,0,2054.5,1495.5,0.7285,9.749,2,0,0,0,2,0,2,0,0.0,0.0
1007,2574,27-09-2019 01:26:00,0,1998.0,1470.0,0.736,9.499,2,0,0,0,2,0,2,0,0.0,0.0
1007,2575,27-09-2019 01:28:00,0,2003.0,1468.0,0.733,9.518,0,0,0,0,0,0,0,0,0.0,0.0
1007,2576,27-09-2019 01:30:00,0,2001.0,1464.0,0.732,9.504,6,0,0,0,6,0,6,0,0.0,0.0
1007,2577,27-09-2019 01:32:00,0,2008.0,1457.0,0.726,9.524,253,157,119,38,96,66,30,26,0.0,0.0
1007,2578,27-09-2019 01:34:00,0,2326.0,1663.0,0.715,11.005,243,134,90,44,109,72,37,75,0.0,0.0
1007,2579,27-09-2019 01:36:00,0,2520.0,1867.0,0.741,11.998,157,111,82,29,46,30,16,58,0.0,0.0
1007,2580,27-09-2019 01:38:00,0,2851.0,2053.0,0.72,13.505,93,44,27,17,49,21,28,11,0.0,0.0
1007,2581,27-09-2019 01:40:00,0,2849.0,2070.0,0.727,13.516,233,122,74,48,111,70,41,36,0.0,0.0
1007,2582,27-09-2019 01:42:00,0,3063.0,2198.0,0.718,14.503,225,154,116,38,71,53,18,32,0.02,0.0
1007,2583,27-09-2019 01:44:00,0,3385.0,2411.0,0.712,16.007,414,271,211,60,143,104,39,13,0.0,0.0
1007,2584,27-09-2019 01:46:00,0,3493.0,2468.0,0.707,16.494,356,196,146,50,160,124,36,43,0.0,0.0
1007,2585,27-09-2019 01:48:00,0,3375.0,2443.0,0.724,16.005,110,55,41,14,55,40,15,36,0.0,0.0
1007,2586,27-09-2019 01:50:00,0,3374.0,2411.0,0.715,15.962,183,132,100,32,51,33,18,8,0.0,0.0
1007,2587,27-09-2019 01:52:00,0,3588.0,2592.0,0.722,17.006,83,39,26,13,44,26,18,1,0.0,0.0
1007,2588,27-09-2019 01:54:00,0,3386.0,2413.0,0.713,16.015,180,118,77,41,62,42,20,11,0.0,0.0
1007,2589,27-09-2019 01:56:00,0,3397.0,2384.0,0.702,16.024,155,85,64,21,70,54,16,91,0.0,0.0
1007,2590,27-09-2019 01:58:00,0,3490.5,2489.5,0.713,16.51,221,142,101,41,79,60,19,173,0.0,0.0
1007,2591,27-09-2019 02:00:00,0,3584.0,2595.0,0.724,16.996,223,130,103,27,93,67,26,142,0.0,0.0
1007,2592,27-09-2019 02:02:00,0,3696.0,2685.0,0.727,17.534,314,205,164,41,109,86,23,180,0.0,0.0
1007,2593,27-09-2019 02:04:00,0,3577.0,2653.0,0.742,17.031,418,250,192,58,168,134,34,166,0.0,0.0
1007,2594,27-09-2019 02:06:00,0,3817.0,2692.0,0.705,18.022,341,211,163,48,130,99,31,69,0.0,0.0
1007,2595,27-09-2019 02:08:00,0,3824.0,2651.0,0.693,18.004,301,232,174,58,69,53,16,28,0.0,0.0
1007,2596,27-09-2019 02:10:00,0,3696.0,2628.0,0.711,17.473,54,35,19,16,19,16,3,12,0.0,0.0
1007,2597,27-09-2019 02:12:00,0,3607.0,2534.0,0.702,17.016,52,30,16,14,22,9,13,1,0.0,0.0
1007,2598,27-09-2019 02:14:00,0,3625.0,2484.0,0.685,17.032,5,1,1,0,4,0,4,0,0.0,0.0
1007,2599,27-09-2019 02:16:00,0,3287.0,2325.0,0.707,15.524,0,0,0,0,0,0,0,0,0.0,0.0
1007,2600,27-09-2019 02:18:00,0,3078.0,2171.0,0.706,14.531,0,0,0,0,0,0,0,0,0.0,0.0
1007,2601,27-09-2019 02:20:00,0,2854.0,2029.0,0.711,13.492,0,0,0,0,0,0,0,0,0.0,0.0
1007,2602,27-09-2019 02:22:00,0,2877.0,1952.0,0.679,13.496,0,0,0,0,0,0,0,0,0.0,0.0
1007,2603,27-09-2019 02:24:00,0,2889.0,1893.0,0.655,13.478,31,18,6,12,13,9,4,0,0.0,0.0
1007,2604,27-09-2019 02:26:00,0,2891.0,1884.0,0.652,13.477,0,0,0,0,0,0,0,0,0.0,0.0
1007,2605,27-09-2019 02:28:00,0,2657.0,1836.0,0.691,12.501,10,8,1,7,2,1,1,0,0.0,0.0
1007,2606,27-09-2019 02:30:00,0,2556.0,1779.0,0.696,12.039,6,5,1,4,1,0,1,0,0.0,0.0
1007,2607,27-09-2019 02:32:00,0,2560.5,1743.0,0.6805,12.0185,13,2,0,2,11,0,11,0,0.0,0.0
1007,2608,27-09-2019 02:34:00,0,2565.0,1707.0,0.665,11.998,2,1,0,1,1,0,1,0,0.0,0.0
1007,2609,27-09-2019 02:36:00,0,2455.0,1676.0,0.683,11.53,11,4,2,2,7,1,6,0,0.02,0.0
1007,2610,27-09-2019 02:38:00,0,2575.0,1672.0,0.649,11.995,7,0,0,0,7,0,7,0,0.0,0.0
1007,2611,27-09-2019 02:40:00,0,2340.0,1612.0,0.689,11.007,98,48,30,18,50,33,17,5,0.0,0.0
1007,2612,27-09-2019 02:42:00,0,2450.0,1697.0,0.693,11.532,257,144,119,25,113,86,27,119,0.0,0.0
1007,2613,27-09-2019 02:44:00,0,2561.0,1733.0,0.677,12.009,216,117,80,37,99,58,41,20,0.0,0.0
1007,2614,27-09-2019 02:46:00,0,2751.0,1923.0,0.699,12.969,288,173,127,46,115,80,35,31,0.0,0.0
1007,2615,27-09-2019 02:48:00,0,2850.0,2035.0,0.714,13.484,305,186,139,47,119,80,39,8,0.0,0.0
1007,2616,27-09-2019 02:50:00,0,3052.0,2225.0,0.729,14.49,145,78,34,44,67,34,33,2,0.0,0.0
1007,2617,27-09-2019 02:52:00,0,2974.0,2096.0,0.705,14.039,176,107,71,36,69,47,22,15,0.0,0.0
1007,2618,27-09-2019 02:54:00,0,2966.0,2101.0,0.708,14.011,261,150,109,41,111,78,33,2,0.0,0.0
1007,2619,27-09-2019 02:56:00,0,3052.0,2215.0,0.726,14.476,259,152,112,40,107,83,24,69,0.01,0.0
1007,2620,27-09-2019 02:58:00,0,3035.0,2301.0,0.758,14.506,272,139,100,39,133,95,38,112,0.0,0.0
1007,2621,27-09-2019 03:00:00,0,3069.0,2177.0,0.709,14.504,342,200,154,46,142,103,39,154,0.0,0.0
1007,2622,27-09-2019 03:02:00,0,3050.0,2302.0,0.755,14.565,146,51,34,17,95,78,17,30,0.0,0.0
1007,2623,27-09-2019 03:04:00,0,3058.0,2229.0,0.729,14.518,61,43,21,22,18,1,17,0,0.0,0.0
1007,2624,27-09-2019 03:06:00,0,3224.5,2299.0,0.714,15.2505,192,60,27,33,132,91,41,6,0.0,0.0
1007,2625,27-09-2019 03:08:00,0,3391.0,2369.0,0.699,15.983,153,82,60,22,71,57,14,32,0.0,0.0
1007,2626,27-09-2019 03:10:00,0,3402.0,2364.0,0.695,16.021,219,119,81,38,100,64,36,37,0.0,0.0
1007,2627,27-09-2019 03:12:00,0,3413.0,2360.0,0.692,16.059,98,64,47,17,34,27,7,6,0.0,0.0
1007,2628,27-09-2019 03:14:00,0,3617.0,2482.0,0.686,17.001,246,128,99,29,118,93,25,6,0.0,0.0
1007,2629,27-09-2019 03:16:00,0,3381.0,2435.0,0.72,16.018,248,141,107,34,107,81,26,8,0.0,0.0
1007,2630,27-09-2019 03:18:00,0,3376.0,2410.0,0.714,15.971,438,150,104,46,288,212,76,5,0.02,0.0
1007,2631,27-09-2019 03:20:00,0,3051.0,2246.0,0.736,14.506,367,175,125,50,192,141,51,98,0.0,0.0
1007,2632,27-09-2019 03:22:00,0,3399.0,2353.0,0.692,16.0,389,215,171,44,174,137,37,144,0.0,0.0
1007,2633,27-09-2019 03:24:00,0,3161.0,2314.0,0.732,15.017,232,110,73,37,122,93,29,89,0.0,0.0
1007,2634,27-09-2019 03:26:00,0,3389.0,2402.0,0.709,16.011,51,35,24,11,16,12,4,76,0.0,0.0
1007,2635,27-09-2019 03:28:00,0,3573.0,2630.0,0.736,16.989,149,80,55,25,69,54,15,86,0.0,0.0
1007,2636,27-09-2019 03:30:00,0,3821.0,2661.0,0.696,18.003,102,69,59,10,33,26,7,73,0.0,0.0
1007,2637,27-09-2019 03:32:00,0,3384.0,2455.0,0.725,16.051,48,17,12,5,31,24,7,30,0.0,0.0
1007,2638,27-09-2019 03:34:00,0,3930.0,2688.0,0.684,18.461,385,172,130,42,213,162,51,85,0.0,0.0
1007,2639,27-09-2019 03:36:00,0,3923.0,2741.0,0.699,18.493,278,134,101,33,144,106,38,18,0.0,0.0
1007,2640,27-09-2019 03:38:00,0,3594.0,2573.0,0.716,17.008,446,151,111,40,295,230,65,31,0.05,0.0
1007,2641,27-09-2019 03:40:00,0,3603.5,2531.0,0.7025,16.999,115,51,34,17,64,45,19,24,0.01,0.0
1007,2642,27-09-2019 03:42:00,0,3613.0,2489.0,0.689,16.99,236,79,57,22,157,105,52,15,0.0,0.0
1007,2643,27-09-2019 03:44:00,0,3505.0,2432.0,0.694,16.503,47,18,5,13,29,15,14,2,0.07,0.0
1007,2644,27-09-2019 03:46:00,0,3630.0,2442.0,0.673,17.007,203,72,45,27,131,87,44,11,0.0,0.0
1007,2645,27-09-2019 03:48:00,0,3414.0,2330.0,0.682,16.032,152,43,26,17,109,74,35,20,0.0,0.0
1007,2646,27-09-2019 03:50:00,0,3408.0,2321.0,0.681,15.999,178,43,21,22,135,76,59,0,0.0,0.0
1007,2647,27-09-2019 03:52:00,0,3179.0,2274.0,0.715,15.044,164,15,4,11,149,99,50,0,0.0,0.0
1007,2648,27-09-2019 03:54:00,0,3167.0,2261.0,0.714,14.982,37,0,0,0,37,0,37,0,0.0,0.0
1007,2649,27-09-2019 03:56:00,0,3078.0,2153.0,0.7,14.512,35,0,0,0,35,0,35,0,0.0,0.0
1007,2650,27-09-2019 03:58:00,0,2863.0,2015.0,0.704,13.511,44,1,0,1,43,0,43,0,0.0,0.0
1007,2651,27-09-2019 04:00:00,0,2876.0,1976.0,0.687,13.517,40,0,0,0,40,0,40,0,0.0,0.0
1007,2652,27-09-2019 04:02:00,0,2886.0,1921.0,0.666,13.498,38,0,0,0,38,0,38,0,0.0,0.0
1007,2653,27-09-2019 04:04:00,0,2912.0,1872.0,0.643,13.546,38,0,0,0,38,0,38,0,0.0,0.0
1007,2654,27-09-2019 04:06:00,0,2661.0,1812.0,0.681,12.492,46,0,0,0,46,0,46,0,0.0,0.0
1007,2655,27-09-2019 04:08:00,0,2559.0,1750.0,0.684,12.021,67,0,0,0,67,23,44,0,0.0,0.0
1007,2656,27-09-2019 04:10:00,0,2569.0,1694.0,0.66,11.998,71,0,0,0,71,30,41,0,0.0,0.0
1007,2657,27-09-2019 04:12:00,0,2577.0,1652.0,0.641,11.982,345,0,0,0,345,263,82,0,0.0,0.0
1007,2658,27-09-2019 04:14:00,0,2463.0,1598.0,0.649,11.4745,213,0,0,0,213,153,60,0,0.0,0.0
1007,2659,27-09-2019 04:16:00,0,2349.0,1544.0,0.657,10.967,150,45,32,13,105,62,43,2,0.0,0.0
1007,2660,27-09-2019 04:18:00,0,2334.0,1628.0,0.698,11.0,313,143,105,38,170,128,42,63,0.0,0.0
1007,2661,27-09-2019 04:20:00,0,2562.0,1720.0,0.672,11.999,266,80,49,31,186,133,53,26,0.0,0.0
1007,2662,27-09-2019 04:22:00,0,2540.0,1778.0,0.7,11.977,309,138,107,31,171,132,39,90,0.0,0.0
1007,2663,27-09-2019 04:24:00,0,2641.0,1884.0,0.713,12.492,268,87,60,27,181,140,41,26,0.0,0.0
1007,2664,27-09-2019 04:26:00,0,2846.0,2084.0,0.732,13.522,361,162,120,42,199,159,40,81,0.0,0.0
1007,2665,27-09-2019 04:28:00,0,2848.0,2079.0,0.73,13.523,204,89,61,28,115,65,50,6,0.0,0.0
1007,2666,27-09-2019 04:30:00,0,2862.0,2009.0,0.702,13.502,266,61,37,24,205,154,51,3,0.0,0.0
1007,2667,27-09-2019 04:32:00,0,2842.0,2053.0,0.722,13.47,167,29,18,11,138,87,51,2,0.0,0.0
1007,2668,27-09-2019 04:34:00,0,2871.0,1986.0,0.692,13.511,266,82,53,29,184,131,53,20,0.0,0.0
1007,2669,27-09-2019 04:36:00,0,2849.0,2070.0,0.727,13.518,178,99,76,23,79,55,24,63,0.0,0.0
1007,2670,27-09-2019 04:38:00,0,2971.0,2093.0,0.704,14.022,256,59,45,14,197,140,57,4,0.0,0.0
1007,2671,27-09-2019 04:40:00,0,3068.0,2180.0,0.71,14.502,520,222,170,52,298,236,62,24,0.0,0.0
1007,2672,27-09-2019 04:42:00,0,3181.0,2267.0,0.713,15.044,511,284,209,75,227,161,66,11,0.0,0.0
1007,2673,27-09-2019 04:44:00,0,3415.0,2322.0,0.68,16.028,430,208,157,51,222,165,57,3,0.0,0.0
1007,2674,27-09-2019 04:46:00,0,3049.0,2236.0,0.733,14.488,168,11,2,9,157,104,53,0,0.0,0.0
1007,2675,27-09-2019 04:48:00,0,2995.0,2221.0,0.7415,14.2595,299,79,57,22,220,174,46,4,0.0,0.0
1007,2676,27-09-2019 04:50:00,0,2941.0,2206.0,0.75,14.031,303,83,56,27,220,170,50,64,0.09,0.0
1007,2677,27-09-2019 04:52:00,0,3038.0,2284.0,0.752,14.501,233,52,19,33,181,119,62,0,0.0,0.0
1007,2678,27-09-2019 04:54:00,0,2926.0,2217.0,0.758,13.984,44,7,2,5,37,9,28,0,0.0,0.0
1007,2679,27-09-2019 04:56:00,0,2956.0,2128.0,0.72,14.003,36,0,0,0,36,0,36,0,0.0,0.0
1007,2680,27-09-2019 04:58:00,0,2735.0,2006.0,0.733,12.997,41,0,0,0,41,0,41,0,0.0,0.0
1007,2681,27-09-2019 05:00:00,0,2767.0,1925.0,0.696,13.033,42,0,0,0,42,0,42,0,0.01,0.0
1007,2682,27-09-2019 05:02:00,0,2653.0,1837.0,0.692,12.485,39,3,1,2,36,0,36,0,0.01,0.0
1007,2683,27-09-2019 05:04:00,0,2415.0,1797.0,0.744,11.503,66,16,4,12,50,13,37,0,0.0,0.0
1007,2684,27-09-2019 05:06:00,0,2427.0,1754.0,0.723,11.504,41,0,0,0,41,8,33,0,0.0,0.0
1007,2685,27-09-2019 05:08:00,0,2443.0,1675.0,0.686,11.48,48,0,0,0,48,0,48,0,0.0,0.0
1007,2686,27-09-2019 05:10:00,0,2335.0,1626.0,0.697,10.999,31,0,0,0,31,0,31,0,0.0,0.0
1007,2687,27-09-2019 05:12:00,0,2225.0,1573.0,0.707,10.508,45,4,1,3,41,4,37,0,0.0,0.0
1007,2688,27-09-2019 05:14:00,0,2226.0,1568.0,0.704,10.509,39,8,3,5,31,0,31,0,0.0,0.0
1007,2689,27-09-2019 05:16:00,0,2239.0,1513.0,0.676,10.499,52,18,10,8,34,0,34,0,0.0,0.0
1007,2690,27-09-2019 05:18:00,0,2124.0,1473.0,0.693,10.001,42,0,0,0,42,0,42,0,0.0,0.0
1007,2691,27-09-2019 05:20:00,0,2003.0,1455.0,0.727,9.503,41,7,3,4,34,0,34,0,0.0,0.0
1007,2692,27-09-2019 05:22:00,0,2117.0,1507.0,0.713,10.009,125,14,2,12,111,79,32,0,0.0,0.0
1007,2693,27-09-2019 05:24:00,0,2231.0,1559.0,0.699,10.515,311,147,107,40,164,117,47,41,0.0,0.0
1007,2694,27-09-2019 05:26:00,0,2197.0,1657.0,0.754,10.493,308,114,81,33,194,134,60,15,0.0,0.0
1007,2695,27-09-2019 05:28:00,0,2428.0,1755.0,0.723,11.511,350,82,45,37,268,206,62,0,0.0,0.0
1007,2696,27-09-2019 05:30:00,0,2534.0,1856.0,0.732,12.038,268,88,63,25,180,136,44,25,0.01,0.0
1007,2697,27-09-2019 05:32:00,0,2751.0,1974.0,0.718,13.023,220,114,78,36,106,62,44,40,0.0,0.0
1007,2698,27-09-2019 05:34:00,0,2732.0,2025.0,0.741,13.007,89,31,13,18,58,25,33,0,0.0,0.0
1007,2699,27-09-2019 05:36:00,0,3279.0,2342.0,0.714,15.514,558,203,163,40,355,277,78,43,0.03,0.0
1007,2700,27-09-2019 05:38:00,0,3168.0,2286.0,0.721,15.015,457,189,138,51,268,209,59,87,0.0,0.0
1007,2701,27-09-2019 05:40:00,0,2946.0,2163.0,0.734,14.003,106,42,27,15,64,49,15,27,0.0,0.0
1007,2702,27-09-2019 05:42:00,0,3264.0,2369.0,0.726,15.485,314,65,43,22,249,176,73,0,0.0,0.0
1007,2703,27-09-2019 05:44:00,0,2931.0,2248.0,0.767,14.037,174,49,32,17,125,83,42,8,0.0,0.0
1007,2704,27-09-2019 05:46:00,0,3278.0,2328.0,0.71,15.492,273,90,71,19,183,137,46,28,0.0,0.0
1007,2705,27-09-2019 05:48:00,0,3036.0,2291.0,0.754,14.5,534,277,211,66,257,190,67,34,0.0,0.0
1007,2706,27-09-2019 05:50:00,0,3274.0,2353.0,0.719,15.504,109,36,11,25,73,34,39,0,0.0,0.0
1007,2707,27-09-2019 05:52:00,0,3158.0,2287.0,0.724,14.975,190,74,36,38,116,71,45,5,0.0,0.0
1007,2708,27-09-2019 05:54:00,0,3280.0,2320.0,0.707,15.492,430,153,113,40,277,208,69,23,0.13,0.0
1007,2709,27-09-2019 05:56:00,0,3385.5,2391.5,0.706,15.988,92,54,37,17,38,30,8,63,0.0,0.0
1007,2710,27-09-2019 05:58:00,0,3491.0,2463.0,0.705,16.484,251,104,74,30,147,100,47,39,0.05,0.0
1007,2711,27-09-2019 06:00:00,1,3292.0,2322.0,0.706,15.542,416,193,157,36,223,167,56,17,0.0,0.01
1007,2712,27-09-2019 06:02:00,1,3032.0,2306.0,0.76,14.501,403,153,118,35,250,191,59,74,0.0,0.0
1007,2713,27-09-2019 06:04:00,1,3285.0,2385.0,0.726,15.586,304,59,28,31,245,186,59,78,0.0,0.0
1007,2714,27-09-2019 06:06:00,1,3580.0,2611.0,0.729,16.996,287,40,10,30,247,179,68,62,0.0,0.0
1007,2715,27-09-2019 06:08:00,1,3795.0,2763.0,0.728,18.012,262,37,17,20,225,172,53,57,0.0,0.15
1007,2716,27-09-2019 06:10:00,1,4015.0,2926.0,0.729,19.058,462,145,110,35,317,250,67,57,0.05,0.11
1007,2717,27-09-2019 06:12:00,1,3985.0,3006.0,0.754,19.028,348,70,44,26,278,221,57,72,0.0,0.0
1007,2718,27-09-2019 06:14:00,1,3943.0,3158.0,0.801,19.034,311,79,43,36,232,173,59,76,0.0,0.0
1007,2719,27-09-2019 06:16:00,1,4169.0,3282.0,0.787,20.06,318,73,41,32,245,186,59,55,0.0,0.1
1007,2720,27-09-2019 06:18:00,1,4251.0,3390.0,0.798,20.501,442,102,72,30,340,270,70,23,0.34,0.0
1007,2721,27-09-2019 06:20:00,1,3934.0,3215.0,0.817,19.061,380,97,60,37,283,213,70,68,0.02,0.0
1007,2722,27-09-2019 06:22:00,1,4011.0,3359.0,0.837,19.522,395,88,56,32,307,242,65,67,0.0,0.0
1007,2723,27-09-2019 06:24:00,1,4417.0,3720.0,0.842,21.521,350,105,86,19,245,186,59,44,0.13,0.09
1007,2724,27-09-2019 06:26:00,1,4317.0,3678.0,0.852,21.082,308,94,72,22,214,167,47,72,0.0,0.0
1007,2725,27-09-2019 06:28:00,1,4200.0,3629.0,0.864,20.568,205,37,20,17,168,112,56,47,0.0,0.09
1007,2726,27-09-2019 06:30:00,1,4287.5,3737.5,0.8715,21.031,294,66,38,28,228,157,71,72,0.0,0.02
1007,2727,27-09-2019 06:32:00,1,4375.0,3846.0,0.879,21.494,369,95,71,24,274,210,64,64,0.12,0.04
1007,2728,27-09-2019 06:34:00,1,4507.0,3899.0,0.865,22.076,299,46,23,23,253,198,55,79,0.01,0.0
1007,2729,27-09-2019 06:36:00,1,4707.0,4048.0,0.86,23.029,498,173,129,44,325,248,77,50,0.16,0.07
1007,2730,27-09-2019 06:38:00,1,4377.0,3845.0,0.878,21.5,318,80,49,31,238,190,48,65,0.05,0.02
1007,2731,27-09-2019 06:40:00,1,4709.0,4033.0,0.856,23.017,326,46,23,23,280,210,70,58,0.0,0.08
1007,2732,27-09-2019 06:42:00,1,4612.0,3997.0,0.867,22.597,282,52,22,30,230,161,69,71,0.0,0.0
1007,2733,27-09-2019 06:44:00,1,4606.0,4020.0,0.873,22.599,320,39,26,13,281,217,64,79,0.0,0.04
1007,2734,27-09-2019 06:46:00,1,4978.0,4455.0,0.895,24.546,259,55,36,19,204,150,54,39,0.08,0.11
1007,2735,27-09-2019 06:48:00,1,4704.0,4104.0,0.872,23.076,316,46,23,23,270,213,57,60,0.01,0.0
1007,2736,27-09-2019 06:50:00,1,4703.0,4172.0,0.887,23.149,294,30,16,14,264,204,60,83,0.0,0.01
1007,2737,27-09-2019 06:52:00,1,4650.0,4310.0,0.927,23.09,317,40,26,14,277,198,79,70,0.0,0.06
1007,2738,27-09-2019 06:54:00,1,4650.0,4283.0,0.921,23.064,338,88,58,30,250,191,59,38,0.14,0.04
1007,2739,27-09-2019 06:56:00,1,4172.0,3714.0,0.89,20.549,334,115,73,42,219,153,66,58,0.1,0.0
1007,2740,27-09-2019 06:58:00,1,4176.0,3711.0,0.889,20.561,282,105,65,40,177,128,49,35,0.08,0.1
1007,2741,27-09-2019 07:00:00,1,4646.0,4295.0,0.925,23.06,317,35,19,16,282,231,51,58,0.0,0.0
1007,2742,27-09-2019 07:02:00,1,4656.0,4264.0,0.916,23.066,283,44,25,19,239,183,56,55,0.0,0.0
1007,2743,27-09-2019 07:04:00,1,4602.0,4213.0,0.9155,22.7965,291,48,32,16,243,183,60,46,0.06,0.14
1007,2744,27-09-2019 07:06:00,1,4548.0,4162.0,0.915,22.527,68,7,5,2,61,19,42,6,0.0,0.09
1007,2745,27-09-2019 07:08:00,1,4131.0,3857.0,0.933,20.547,95,23,16,7,72,41,31,3,0.02,0.0
1007,2746,27-09-2019 07:10:00,1,4628.0,4353.0,0.94,23.055,384,133,100,33,251,195,56,17,0.16,0.0
1007,2747,27-09-2019 07:12:00,1,4732.0,4461.0,0.943,23.584,91,25,15,10,66,26,40,16,0.01,0.0
1007,2748,27-09-2019 07:14:00,1,4500.0,4364.0,0.97,22.56,190,57,32,25,133,89,44,30,0.0,0.17
1007,2749,27-09-2019 07:16:00,1,4636.0,4378.0,0.944,23.111,364,94,58,36,270,209,61,73,0.0,0.0
1007,2750,27-09-2019 07:18:00,1,4550.0,4201.0,0.923,22.577,431,114,87,27,317,252,65,31,0.07,0.0
1007,2751,27-09-2019 07:20:00,1,3741.0,3463.0,0.926,18.574,432,127,105,22,305,249,56,13,0.06,0.0
1007,2752,27-09-2019 07:22:00,1,4325.0,4125.0,0.954,21.609,443,119,82,37,324,266,58,37,0.0,0.0
1007,2753,27-09-2019 07:24:00,1,4794.0,4643.0,0.968,24.028,517,180,142,38,337,266,71,57,0.0,0.0
1007,2754,27-09-2019 07:26:00,1,4782.0,4705.0,0.984,24.051,212,74,40,34,138,98,40,4,0.0,0.03
1007,2755,27-09-2019 07:28:00,1,4554.0,4214.0,0.925,22.609,248,74,41,33,174,136,38,47,0.0,0.0
1007,2756,27-09-2019 07:30:00,1,4526.0,4271.0,0.944,22.562,284,67,37,30,217,166,51,72,0.0,0.0
1007,2757,27-09-2019 07:32:00,1,4701.0,4524.0,0.962,23.53,770,213,155,58,557,462,95,24,0.09,0.0
1007,2758,27-09-2019 07:34:00,1,4317.0,4136.0,0.958,21.585,621,114,81,33,507,413,94,1,0.01,0.0
1007,2759,27-09-2019 07:36:00,1,4525.0,4317.0,0.954,22.607,275,13,2,11,262,217,45,0,0.0,0.0
1007,2760,27-09-2019 07:38:00,1,4521.0,4326.5,0.957,22.601,306,38,15,23,268,210,58,0,0.0,0.0
1007,2761,27-09-2019 07:40:00,1,4517.0,4336.0,0.96,22.595,568,54,26,28,514,448,66,0,0.0,0.0
1007,2762,27-09-2019 07:42:00,1,4316.0,4157.0,0.963,21.608,637,28,19,9,609,524,85,0,0.0,0.0
1007,2763,27-09-2019 07:44:00,1,4215.0,4012.0,0.952,21.05,378,1,0,1,377,315,62,0,0.0,0.0
1007,2764,27-09-2019 07:46:00,1,4014.0,3827.0,0.953,20.051,448,12,6,6,436,379,57,0,0.0,0.0
1007,2765,27-09-2019 07:48:00,1,3704.0,3614.0,0.976,18.596,622,0,0,0,622,567,55,0,0.0,0.0
1007,2766,27-09-2019 07:50:00,1,3611.0,3436.0,0.951,18.03,679,0,0,0,679,634,45,0,0.0,0.0
1007,2767,27-09-2019 07:52:00,1,3522.0,3339.0,0.948,17.572,571,2,0,2,569,499,70,0,0.0,0.0
1007,2768,27-09-2019 07:54:00,1,3527.0,3234.0,0.917,17.477,204,8,0,8,196,169,27,0,0.0,0.0
1007,2769,27-09-2019 07:56:00,1,3425.0,3213.0,0.938,17.051,252,5,2,3,247,227,20,0,0.0,0.0
1007,2770,27-09-2019 07:58:00,1,3190.0,3161.0,0.991,16.066,133,4,1,3,129,94,35,0,0.0,0.0
1007,2771,27-09-2019 08:00:00,1,3215.0,3052.0,0.949,16.044,359,9,1,8,350,305,45,0,0.0,0.0
1007,2772,27-09-2019 08:02:00,1,3118.0,2937.0,0.942,15.536,960,2,0,2,958,891,67,0,0.0,0.0
1007,2773,27-09-2019 08:04:00,1,3009.0,2873.0,0.955,15.036,324,2,1,1,322,299,23,0,0.0,0.0
1007,2774,27-09-2019 08:06:00,1,3009.0,2852.0,0.948,15.011,520,3,1,2,517,477,40,0,0.0,0.0
1007,2775,27-09-2019 08:08:00,1,2908.0,2782.0,0.957,14.535,700,1,0,1,699,644,55,0,0.0,0.0
1007,2776,27-09-2019 08:10:00,1,2912.0,2815.0,0.967,14.59,387,21,13,8,366,288,78,0,0.0,0.0
1007,2777,27-09-2019 08:12:00,1,2759.5,2654.5,0.962,13.811,93,0,0,0,93,69,24,0,0.0,0.0
1007,2778,27-09-2019 08:14:00,1,2607.0,2494.0,0.957,13.032,63,0,0,0,63,33,30,0,0.0,0.0
1007,2779,27-09-2019 08:16:00,1,2486.0,2486.0,1.0,12.545,75,2,1,1,73,44,29,0,0.0,0.0
1007,2780,27-09-2019 08:18:00,1,2604.0,2543.0,0.977,13.076,73,8,5,3,65,28,37,0,0.0,0.0
1007,2781,27-09-2019 08:20:00,1,2593.0,2546.0,0.982,13.035,285,64,44,20,221,180,41,9,0.0,0.0
1007,2782,27-09-2019 08:22:00,1,3189.0,3150.0,0.988,16.053,418,50,31,19,368,298,70,34,0.0,0.0
1007,2783,27-09-2019 08:24:00,1,3379.0,3377.0,1.0,17.051,221,25,11,14,196,144,52,60,0.0,0.0
1007,2784,27-09-2019 08:26:00,1,3493.0,3451.0,0.988,17.583,279,60,31,29,219,170,49,68,0.0,0.0
1007,2785,27-09-2019 08:28:00,1,3474.0,3529.0,1.016,17.593,326,34,14,20,292,227,65,62,0.0,0.0
1007,2786,27-09-2019 08:30:00,1,3665.0,3719.0,1.015,18.557,306,55,26,29,251,180,71,73,0.0,0.0
1007,2787,27-09-2019 08:32:00,1,3685.0,3684.0,1.0,18.599,213,51,17,34,162,119,43,78,0.0,0.0
1007,2788,27-09-2019 08:34:00,1,3682.0,3674.0,0.998,18.576,306,75,35,40,231,185,46,70,0.0,0.03
1007,2789,27-09-2019 08:36:00,1,3971.0,3977.0,1.002,20.048,404,152,97,55,252,200,52,45,0.08,0.21
1007,2790,27-09-2019 08:38:00,1,3661.0,3752.0,1.025,18.58,303,58,25,33,245,186,59,79,0.0,0.0
1007,2791,27-09-2019 08:40:00,1,4087.0,4063.0,0.994,20.599,355,89,54,35,266,227,39,30,0.07,0.0
1007,2792,27-09-2019 08:42:00,1,3962.0,4066.0,1.026,20.11,338,117,81,36,221,164,57,54,0.01,0.0
1007,2793,27-09-2019 08:44:00,1,4073.0,4099.0,1.006,20.586,329,93,57,36,236,184,52,47,0.0,0.0
1007,2794,27-09-2019 08:46:00,1,4030.5,4046.5,1.004,20.3605,319,65,46,19,254,209,45,32,0.13,0.0
1007,2795,27-09-2019 08:48:00,1,3988.0,3994.0,1.002,20.135,435,95,63,32,340,279,61,57,0.0,0.0
1007,2796,27-09-2019 08:50:00,1,4186.0,4154.0,0.992,21.093,350,128,76,52,222,164,58,64,0.0,0.0
1007,2797,27-09-2019 08:52:00,1,4196.0,4107.0,0.979,21.079,292,100,64,36,192,148,44,52,0.0,0.0
1007,2798,27-09-2019 08:54:00,1,3968.0,4062.0,1.024,20.129,338,121,83,38,217,165,52,59,0.0,0.0
1007,2799,27-09-2019 08:56:00,1,4407.0,4295.0,0.975,22.118,466,197,141,56,269,205,64,4,0.08,0.13
1007,2800,27-09-2019 08:58:00,1,3771.0,3791.0,1.005,19.056,833,309,239,70,524,431,93,5,0.0,0.0
1007,2801,27-09-2019 09:00:00,1,4281.0,4257.0,0.994,21.578,494,151,108,43,343,260,83,40,0.0,0.0
1007,2802,27-09-2019 09:02:00,1,4001.0,3899.0,0.974,20.082,415,128,94,34,287,227,60,59,0.0,0.0
1007,2803,27-09-2019 09:04:00,1,4204.0,4079.0,0.97,21.08,429,104,66,38,325,259,66,8,0.08,0.0
1007,2804,27-09-2019 09:06:00,1,3796.0,3720.0,0.98,19.076,735,122,93,29,613,552,61,1,0.0,0.0
1007,2805,27-09-2019 09:08:00,1,4303.0,4217.0,0.98,21.624,457,65,40,25,392,343,49,0,0.0,0.0
1007,2806,27-09-2019 09:10:00,1,4167.0,4173.0,1.001,21.037,113,18,4,14,95,79,16,0,0.0,0.0
1007,2807,27-09-2019 09:12:00,1,4092.0,4047.0,0.989,20.601,28,4,0,4,24,17,7,0,0.0,0.0
1007,2808,27-09-2019 09:14:00,1,3685.0,3628.0,0.985,18.536,103,0,0,0,103,69,34,0,0.0,0.0
1007,2809,27-09-2019 09:16:00,1,3492.0,3391.0,0.971,17.512,93,6,4,2,87,65,22,0,0.0,0.0
1007,2810,27-09-2019 09:18:00,1,3516.0,3345.0,0.951,17.556,8,0,0,0,8,0,8,0,0.0,0.0
1007,2811,27-09-2019 09:20:00,1,3526.0,3303.0,0.9365,17.55,182,9,4,5,173,144,29,0,0.0,0.0
1007,2812,27-09-2019 09:22:00,1,3536.0,3261.0,0.922,17.544,285,0,0,0,285,235,50,0,0.0,0.0
1007,2813,27-09-2019 09:24:00,1,3192.0,3142.0,0.984,16.056,239,0,0,0,239,203,36,0,0.0,0.0
1007,2814,27-09-2019 09:26:00,1,3227.0,3002.0,0.931,16.037,196,7,1,6,189,147,42,0,0.0,0.0
1007,2815,27-09-2019 09:28:00,1,3001.0,2915.0,0.971,15.05,247,0,0,0,247,194,53,0,0.0,0.0
1007,2816,27-09-2019 09:30:00,1,3020.0,2840.0,0.94,15.043,109,2,0,2,107,83,24,0,0.0,0.0
1007,2817,27-09-2019 09:32:00,1,2900.0,2837.0,0.978,14.567,158,5,2,3,153,124,29,0,0.0,0.0
1007,2818,27-09-2019 09:34:00,1,3006.0,2897.0,0.964,15.049,182,0,0,0,182,124,58,0,0.0,0.0
1007,2819,27-09-2019 09:36:00,1,3011.0,2894.0,0.961,15.066,158,2,0,2,156,135,21,0,0.0,0.0
1007,2820,27-09-2019 09:38:00,1,2780.0,2799.0,1.007,14.052,439,1,0,1,438,387,51,0,0.0,0.0
1007,2821,27-09-2019 09:40:00,1,2672.0,2757.0,1.032,13.578,96,1,0,1,95,83,12,0,0.0,0.0
1007,2822,27-09-2019 09:42:00,1,2693.0,2677.0,0.994,13.574,381,5,2,3,376,330,46,0,0.0,0.0
1007,2823,27-09-2019 09:44:00,1,2656.0,2789.0,1.05,13.55,0,0,0,0,0,0,0,0,0.0,0.0
1007,2824,27-09-2019 09:46:00,1,2661.0,2729.0,1.026,13.505,176,40,27,13,136,109,27,1,0.0,0.0
1007,2825,27-09-2019 09:48:00,1,2674.0,2713.0,1.014,13.54,17,0,0,0,17,4,13,0,0.0,0.0
1007,2826,27-09-2019 09:50:00,1,2583.0,2583.0,1.0,13.036,136,10,5,5,126,109,17,0,0.0,0.0
1007,2827,27-09-2019 09:52:00,1,2477.0,2496.0,1.007,12.523,553,4,0,4,549,491,58,0,0.0,0.0
1007,2828,27-09-2019 09:54:00,1,2492.5,2470.5,0.991,12.5555,115,6,2,4,109,73,36,0,0.0,0.0
1007,2829,27-09-2019 09:56:00,1,2508.0,2445.0,0.975,12.588,192,3,1,2,189,156,33,0,0.0,0.0
1007,2830,27-09-2019 09:58:00,1,2478.0,2482.0,1.001,12.511,464,14,10,4,450,389,61,0,0.0,0.0
1007,2831,27-09-2019 10:00:00,1,2479.0,2522.0,1.018,12.558,496,0,0,0,496,442,54,0,0.0,0.0
1007,2832,27-09-2019 10:02:00,1,2495.0,2437.0,0.976,12.529,292,12,6,6,280,241,39,0,0.0,0.0
1007,2833,27-09-2019 10:04:00,1,2492.0,2440.0,0.979,12.522,168,47,30,17,121,75,46,2,0.0,0.0
1007,2834,27-09-2019 10:06:00,1,2469.0,2566.0,1.039,12.567,30,3,0,3,27,0,27,0,0.0,0.0
1007,2835,27-09-2019 10:08:00,1,2476.0,2491.0,1.006,12.514,43,14,1,13,29,0,29,0,0.0,0.0
1007,2836,27-09-2019 10:10:00,1,2480.0,2504.0,1.01,12.542,50,11,1,10,39,9,30,0,0.0,0.0
1007,2837,27-09-2019 10:12:00,1,2476.0,2511.0,1.014,12.536,71,13,8,5,58,20,38,0,0.0,0.0
1007,2838,27-09-2019 10:14:00,1,2464.0,2548.0,1.034,12.527,103,0,0,0,103,54,49,0,0.0,0.0
1007,2839,27-09-2019 10:16:00,1,2498.0,2458.0,0.984,12.562,108,4,0,4,104,50,54,0,0.0,0.0
1007,2840,27-09-2019 10:18:00,1,2470.0,2538.0,1.028,12.542,239,53,32,21,186,149,37,0,0.0,0.0
1007,2841,27-09-2019 10:20:00,1,2588.0,2585.0,0.999,13.058,133,49,22,27,84,49,35,1,0.0,0.0
1007,2842,27-09-2019 10:22:00,1,2767.0,2836.0,1.025,14.042,86,32,13,19,54,27,27,0,0.0,0.0
1007,2843,27-09-2019 10:24:00,1,3174.0,3191.0,1.006,16.038,118,27,8,19,91,65,26,0,0.0,0.0
1007,2844,27-09-2019 10:26:00,1,3193.0,3097.0,0.97,16.007,350,32,6,26,318,256,62,0,0.0,0.0
1007,2845,27-09-2019 10:28:00,1,3354.5,3228.0,0.9625,16.79,236,35,22,13,201,137,64,11,0.0,0.0
1007,2846,27-09-2019 10:30:00,1,3516.0,3359.0,0.955,17.573,225,61,30,31,164,109,55,74,0.0,0.0
1007,2847,27-09-2019 10:32:00,1,3695.0,3605.0,0.976,18.547,315,117,79,38,198,140,58,56,0.0,0.0
1007,2848,27-09-2019 10:34:00,1,3703.0,3649.0,0.985,18.63,303,68,37,31,235,178,57,57,0.0,0.0
1007,2849,27-09-2019 10:36:00,1,3762.0,3793.0,1.008,19.022,339,131,83,48,208,157,51,66,0.0,0.03
1007,2850,27-09-2019 10:38:00,1,3887.0,3840.0,0.988,19.566,320,102,60,42,218,166,52,59,0.0,0.04
1007,2851,27-09-2019 10:40:00,1,3899.0,3816.0,0.979,19.585,289,79,43,36,210,156,54,52,0.0,0.07
1007,2852,27-09-2019 10:42:00,1,3954.0,3992.0,1.01,19.997,306,103,58,45,203,155,48,53,0.0,0.04
1007,2853,27-09-2019 10:44:00,1,4206.0,4101.0,0.975,21.113,415,81,41,40,334,277,57,38,0.14,0.07
1007,2854,27-09-2019 10:46:00,1,3881.0,3863.0,0.995,19.569,794,187,150,37,607,512,95,31,0.08,0.0
1007,2855,27-09-2019 10:48:00,1,4100.0,3975.0,0.97,20.553,736,279,219,60,457,377,80,56,0.0,0.03
1007,2856,27-09-2019 10:50:00,1,4194.0,4080.0,0.973,21.043,304,56,31,25,248,181,67,55,0.01,0.05
1007,2857,27-09-2019 10:52:00,1,4297.0,4183.0,0.974,21.561,300,59,30,29,241,184,57,61,0.0,0.25
1007,2858,27-09-2019 10:54:00,1,4411.0,4219.0,0.956,22.052,365,91,54,37,274,219,55,36,0.12,0.0
1007,2859,27-09-2019 10:56:00,1,3986.0,3944.0,0.989,20.073,963,317,246,71,646,548,98,1,0.0,0.0
1007,2860,27-09-2019 10:58:00,1,4293.0,4186.0,0.975,21.55,818,267,203,64,551,476,75,15,0.07,0.0
1007,2861,27-09-2019 11:00:00,1,3698.0,3619.0,0.979,18.575,874,362,287,75,512,432,80,11,0.0,0.0
1007,2862,27-09-2019 11:02:00,1,3830.0,3802.0,0.9925,19.297,383,159,115,44,224,168,56,27,0.03,0.0
1007,2863,27-09-2019 11:04:00,1,3962.0,3985.0,1.006,20.019,48,31,8,23,17,10,7,0,0.0,0.0
1007,2864,27-09-2019 11:06:00,1,4034.0,3803.0,0.943,20.104,44,23,0,23,21,1,20,0,0.0,0.0
1007,2865,27-09-2019 11:08:00,1,4017.0,3825.0,0.952,20.06,22,14,0,14,8,1,7,0,0.0,0.0
1007,2866,27-09-2019 11:10:00,1,3918.0,3758.0,0.959,19.596,3,0,0,0,3,1,2,0,0.0,0.0
1007,2867,27-09-2019 11:12:00,1,3699.0,3603.0,0.974,18.563,0,0,0,0,0,0,0,0,0.0,0.0
1007,2868,27-09-2019 11:14:00,1,3621.0,3443.0,0.951,18.077,11,6,2,4,5,3,2,0,0.01,0.0
1007,2869,27-09-2019 11:16:00,1,3536.0,3309.0,0.936,17.596,1,0,0,0,1,0,1,0,0.0,0.0
1007,2870,27-09-2019 11:18:00,1,3315.0,3152.0,0.951,16.55,0,0,0,0,0,0,0,0,0.0,0.0
1007,2871,27-09-2019 11:20:00,1,3210.0,3054.0,0.951,16.027,16,9,4,5,7,4,3,0,0.01,0.0
1007,2872,27-09-2019 11:22:00,1,3212.0,3076.0,0.958,16.062,5,4,1,3,1,0,1,0,0.0,0.0
1007,2873,27-09-2019 11:24:00,1,3286.0,3237.0,0.985,16.531,49,23,11,12,26,13,13,0,0.0,0.0
1007,2874,27-09-2019 11:26:00,1,3196.0,3121.0,0.976,16.048,17,15,1,14,2,0,2,0,0.0,0.0
1007,2875,27-09-2019 11:28:00,1,3103.0,2971.0,0.957,15.515,3,3,0,3,0,0,0,0,0.0,0.0
1007,2876,27-09-2019 11:30:00,1,2997.0,2884.0,0.962,15.002,3,3,0,3,0,0,0,0,0.0,0.0
1007,2877,27-09-2019 11:32:00,1,3017.0,2844.0,0.943,15.034,0,0,0,0,0,0,0,0,0.0,0.0
1007,2878,27-09-2019 11:34:00,1,2909.0,2800.0,0.963,14.562,6,6,2,4,0,0,0,0,0.0,0.0
1007,2879,27-09-2019 11:36:00,1,2788.5,2759.0,0.991,14.042,4,4,0,4,0,0,0,0,0.0,0.0
1007,2880,27-09-2019 11:38:00,1,2668.0,2718.0,1.019,13.522,3,1,0,1,2,1,1,0,0.0,0.0
1007,2881,27-09-2019 11:40:00,1,2680.0,2701.0,1.008,13.55,14,6,1,5,8,4,4,0,0.0,0.0
1007,2882,27-09-2019 11:42:00,1,2699.0,2673.0,0.99,13.592,0,0,0,0,0,0,0,0,0.0,0.0
1007,2883,27-09-2019 11:44:00,1,2606.0,2512.0,0.964,13.049,5,4,0,4,1,1,0,0,0.0,0.0
1007,2884,27-09-2019 11:46:00,1,2486.0,2470.0,0.994,12.53,11,7,2,5,4,1,3,0,0.0,0.0
1007,2885,27-09-2019 11:48:00,1,2721.0,2550.0,0.937,13.543,0,0,0,0,0,0,0,0,0.0,0.0
1007,2886,27-09-2019 11:50:00,1,2473.0,2514.0,1.017,12.524,6,5,3,2,1,0,1,0,0.0,0.0
1007,2887,27-09-2019 11:52:00,1,2599.0,2557.0,0.984,13.07,22,9,6,3,13,9,4,0,0.0,0.0
1007,2888,27-09-2019 11:54:00,1,2716.0,2596.0,0.956,13.575,1,0,0,0,1,0,1,0,0.0,0.0
1007,2889,27-09-2019 11:56:00,1,2720.0,2537.0,0.933,13.525,20,6,1,5,14,3,11,0,0.0,0.0
1007,2890,27-09-2019 11:58:00,1,3066.0,2725.0,0.889,15.097,42,0,0,0,42,0,42,0,0.0,0.0
1007,2891,27-09-2019 12:00:00,1,3056.0,2704.0,0.885,15.034,21,0,0,0,21,0,21,0,0.0,0.0
1007,2892,27-09-2019 12:02:00,1,3056.0,2705.0,0.885,15.036,7,0,0,0,7,0,7,0,0.0,0.0
1007,2893,27-09-2019 12:04:00,1,3062.0,2712.0,0.886,15.064,49,0,0,0,49,0,49,0,0.0,0.0
1007,2894,27-09-2019 12:06:00,1,3063.0,2661.0,0.869,15.014,44,0,0,0,44,0,44,0,0.0,0.0
1007,2895,27-09-2019 12:08:00,1,2964.0,2602.0,0.878,14.561,68,9,3,6,59,21,38,0,0.0,0.0
1007,2896,27-09-2019 12:10:00,1,2751.0,2687.5,0.9855,13.815,60,23,3,20,37,10,27,0,0.0,0.0
1007,2897,27-09-2019 12:12:00,1,2538.0,2773.0,1.093,13.069,73,53,9,44,20,5,15,0,0.0,0.0
1007,2898,27-09-2019 12:14:00,1,2777.0,2826.0,1.017,14.07,82,53,42,11,29,17,12,0,0.0,0.0
1007,2899,27-09-2019 12:16:00,1,2229.0,2520.0,1.131,11.57,0,0,0,0,0,0,0,0,0.0,0.0
1007,2900,27-09-2019 12:18:00,1,2269.0,2382.0,1.05,11.578,0,0,0,0,0,0,0,0,0.0,0.0
1007,2901,27-09-2019 12:20:00,1,2271.0,2347.0,1.034,11.545,19,8,3,5,11,3,8,0,0.0,0.0
1007,2902,27-09-2019 12:22:00,1,2250.0,2415.0,1.073,11.54,0,0,0,0,0,0,0,0,0.0,0.0
1007,2903,27-09-2019 12:24:00,1,2251.0,2425.0,1.077,11.551,5,0,0,0,5,2,3,0,0.0,0.0
1007,2904,27-09-2019 12:26:00,1,2244.0,2478.0,1.105,11.583,1,0,0,0,1,1,0,0,0.0,0.0
1007,2905,27-09-2019 12:28:00,1,2585.0,2575.0,0.996,13.037,1,0,0,0,1,0,1,0,0.0,0.0
1007,2906,27-09-2019 12:30:00,1,2462.0,2560.0,1.04,12.534,3,1,0,1,2,1,1,0,0.0,0.0
1007,2907,27-09-2019 12:32:00,1,2342.0,2563.0,1.094,12.066,0,0,0,0,0,0,0,0,0.0,0.0
1007,2908,27-09-2019 12:34:00,1,2223.0,2519.0,1.133,11.548,1,1,0,1,0,0,0,0,0.0,0.0
1007,2909,27-09-2019 12:36:00,1,2233.0,2485.0,1.113,11.549,12,6,0,6,6,2,4,0,0.0,0.0
1007,2910,27-09-2019 12:38:00,1,2339.0,2576.0,1.101,12.066,36,24,17,7,12,6,6,0,0.0,0.0
1007,2911,27-09-2019 12:40:00,1,2234.0,2495.0,1.117,11.563,0,0,0,0,0,0,0,0,0.0,0.0
1007,2912,27-09-2019 12:42:00,1,2260.0,2420.0,1.071,11.582,19,19,11,8,0,0,0,0,0.0,0.0
1007,2913,27-09-2019 12:44:00,1,2262.0,2386.0,1.055,11.5535,12,12,4,8,0,0,0,0,0.0,0.0
1007,2914,27-09-2019 12:46:00,1,2264.0,2352.0,1.039,11.525,26,25,2,23,1,1,0,0,0.0,0.0
1007,2915,27-09-2019 12:48:00,1,2272.0,2353.0,1.036,11.558,4,3,0,3,1,0,1,0,0.0,0.0
1007,2916,27-09-2019 12:50:00,1,2265.0,2354.0,1.039,11.531,33,26,2,24,7,3,4,0,0.0,0.0
1008,1,23-09-2019 11:40:00,1,5188.0,3190.0,0.615,23.973,196,122,90,32,74,46,28,10,0.0,0.03
1008,2,23-09-2019 11:42:00,1,5159.0,3282.0,0.636,23.963,184,132,93,39,52,29,23,3,0.0,0.01
1008,3,23-09-2019 11:44:00,1,4736.0,3120.0,0.659,22.115,140,111,76,35,29,12,17,3,0.0,0.0
1008,4,23-09-2019 11:46:00,1,4504.0,2838.0,0.63,20.889,20,13,4,9,7,1,6,0,0.0,0.0
1008,5,23-09-2019 11:48:00,1,4108.0,2616.0,0.637,19.082,1,0,0,0,1,1,0,0,0.0,0.0
1008,6,23-09-2019 11:50:00,1,3413.0,2258.0,0.662,15.947,33,17,6,11,16,4,12,0,0.0,0.0
1008,7,23-09-2019 11:52:00,1,3072.5,2080.5,0.679,14.41,5,5,0,5,0,0,0,0,0.0,0.0
1008,8,23-09-2019 11:54:00,1,2732.0,1903.0,0.696,12.873,0,0,0,0,0,0,0,0,0.0,0.0
1008,9,23-09-2019 11:56:00,1,2482.0,1695.0,0.683,11.658,30,13,5,8,17,5,12,0,0.0,0.0
1008,10,23-09-2019 11:58:00,1,2860.0,2049.0,0.716,13.536,44,31,16,15,13,2,11,0,0.0,0.0
1008,11,23-09-2019 12:00:00,1,2738.0,1908.0,0.697,12.902,48,25,7,18,23,7,16,3,0.0,0.0
1008,12,23-09-2019 12:02:00,1,2971.0,2206.0,0.743,14.15,44,31,12,19,13,2,11,0,0.0,0.0
1008,13,23-09-2019 12:04:00,1,2980.0,2180.0,0.731,14.155,26,14,1,13,12,3,9,0,0.0,0.0
1008,14,23-09-2019 12:06:00,1,2439.0,1895.0,0.777,11.709,54,42,25,17,12,1,11,0,0.0,0.0
1008,15,23-09-2019 12:08:00,1,2801.0,2239.0,0.799,13.516,91,56,18,38,35,9,26,0,0.0,0.0
1008,16,23-09-2019 12:10:00,1,2662.0,2176.0,0.817,12.899,79,57,34,23,22,9,13,1,0.0,0.0
1008,17,23-09-2019 12:12:00,1,2406.0,1990.0,0.827,11.684,16,7,0,7,9,0,9,0,0.0,0.0
1008,18,23-09-2019 12:14:00,1,2036.0,1643.0,0.807,9.842,13,4,0,4,9,0,9,0,0.0,0.0
1008,19,23-09-2019 12:16:00,1,2011.0,1751.0,0.871,9.861,5,1,0,1,4,0,4,0,0.0,0.0
1008,20,23-09-2019 12:18:00,1,2003.0,1752.0,0.875,9.833,57,40,17,23,17,6,11,0,0.0,0.0
1008,21,23-09-2019 12:20:00,1,2264.0,1980.0,0.875,11.112,10,7,5,2,3,2,1,0,0.0,0.0
1008,22,23-09-2019 12:22:00,1,2267.0,1940.0,0.856,11.08,1,1,1,0,0,0,0,0,0.0,0.0
1008,23,23-09-2019 12:24:00,1,2020.0,1708.0,0.846,9.849,53,38,12,26,15,5,10,0,0.0,0.0
1008,24,23-09-2019 12:26:00,1,2395.5,1735.5,0.741,11.3605,70,45,18,27,25,11,14,0,0.0,0.0
1008,25,23-09-2019 12:28:00,1,2771.0,1763.0,0.636,12.872,0,0,0,0,0,0,0,0,0.0,0.0
1008,26,23-09-2019 12:30:00,1,2346.0,1617.0,0.689,11.034,1,0,0,0,1,1,0,0,0.0,0.0
1008,27,23-09-2019 12:32:00,1,2386.0,1486.0,0.623,11.046,20,19,6,13,1,0,1,0,0.0,0.0
1008,28,23-09-2019 12:34:00,1,2364.0,1569.0,0.664,11.051,61,45,19,26,16,3,13,3,0.0,0.0
1008,29,23-09-2019 12:36:00,1,2772.0,1792.0,0.647,12.907,50,36,19,17,14,4,10,0,0.0,0.0
1008,30,23-09-2019 12:38:00,1,2345.0,1664.0,0.709,11.083,1,0,0,0,1,0,1,0,0.0,0.0
1008,31,23-09-2019 12:40:00,1,2362.0,1554.0,0.658,11.03,0,0,0,0,0,0,0,0,0.0,0.0
1008,32,23-09-2019 12:42:00,1,2082.0,1472.0,0.707,9.833,4,0,0,0,4,0,4,0,0.0,0.0
1008,33,23-09-2019 12:44:00,1,2085.0,1456.0,0.698,9.826,1,0,0,0,1,0,1,0,0.0,0.0
1008,34,23-09-2019 12:46:00,1,2081.0,1475.0,0.709,9.834,9,6,2,4,3,0,3,0,0.0,0.0
1008,35,23-09-2019 12:48:00,1,1939.0,1410.0,0.727,9.203,0,0,0,0,0,0,0,0,0.0,0.0
1008,36,23-09-2019 12:50:00,1,1795.0,1398.0,0.779,8.622,0,0,0,0,0,0,0,0,0.0,0.0
1008,37,23-09-2019 12:52:00,1,1782.0,1432.0,0.804,8.608,68,42,20,22,26,5,21,0,0.0,0.0
1008,38,23-09-2019 12:54:00,1,2047.0,1609.0,0.786,9.848,0,0,0,0,0,0,0,0,0.0,0.0
1008,39,23-09-2019 12:56:00,1,2063.0,1552.0,0.752,9.847,0,0,0,0,0,0,0,0,0.0,0.0
1008,40,23-09-2019 12:58:00,1,1921.0,1498.0,0.78,9.227,0,0,0,0,0,0,0,0,0.0,0.0
1008,41,23-09-2019 13:00:00,1,2074.5,1495.5,0.725,9.83,0,0,0,0,0,0,0,0,0.0,0.0
1008,42,23-09-2019 13:02:00,1,2228.0,1493.0,0.67,10.433,34,23,15,8,11,6,5,0,0.0,0.0
1008,43,23-09-2019 13:04:00,1,2220.0,1516.0,0.683,10.425,20,8,0,8,12,0,12,0,0.0,0.0
1008,44,23-09-2019 13:06:00,1,1932.0,1453.0,0.752,9.22,5,3,0,3,2,0,2,0,0.0,0.0
1008,45,23-09-2019 13:08:00,1,1933.0,1464.0,0.757,9.236,3,3,0,3,0,0,0,0,0.0,0.0
1008,46,23-09-2019 13:10:00,1,1926.0,1459.0,0.757,9.205,9,1,0,1,8,0,8,0,0.0,0.0
1008,47,23-09-2019 13:12:00,1,1929.0,1480.0,0.767,9.239,3,1,0,1,2,0,2,0,0.0,0.0
1008,48,23-09-2019 13:14:00,1,1945.0,1415.0,0.728,9.23,5,0,0,0,5,0,5,0,0.0,0.0
1008,49,23-09-2019 13:16:00,1,1935.0,1444.0,0.746,9.223,17,12,3,9,5,2,3,0,0.0,0.0
1008,50,23-09-2019 13:18:00,1,1947.0,1414.0,0.727,9.235,4,3,0,3,1,0,1,0,0.0,0.0
1008,51,23-09-2019 13:20:00,1,1949.0,1415.0,0.726,9.247,5,2,0,2,3,0,3,0,0.0,0.0
1008,52,23-09-2019 13:22:00,1,1802.0,1360.0,0.755,8.605,27,8,3,5,19,7,12,0,0.0,0.0
1008,53,23-09-2019 13:24:00,1,1642.0,1381.0,0.841,7.997,9,0,0,0,9,0,9,0,0.0,0.0
1008,54,23-09-2019 13:26:00,1,1796.0,1408.0,0.784,8.636,10,0,0,0,10,0,10,0,0.0,0.0
1008,55,23-09-2019 13:28:00,1,1908.0,1563.0,0.819,9.249,0,0,0,0,0,0,0,0,0.0,0.0
1008,56,23-09-2019 13:30:00,1,1924.0,1476.0,0.767,9.214,21,20,8,12,1,1,0,2,0.0,0.0
1008,57,23-09-2019 13:32:00,1,1911.0,1528.0,0.8,9.221,131,95,58,37,36,23,13,2,0.0,0.0
1008,58,23-09-2019 13:34:00,1,2333.5,1699.5,0.7395,11.076,207,114,75,39,93,62,31,8,0.0,0.0
1008,59,23-09-2019 13:36:00,1,2756.0,1871.0,0.679,12.931,124,75,48,27,49,24,25,13,0.0,0.0
1008,60,23-09-2019 13:38:00,1,3022.0,1982.0,0.656,14.103,82,62,37,25,20,7,13,5,0.0,0.0
1008,61,23-09-2019 13:40:00,1,2740.0,1887.0,0.689,12.886,69,47,26,21,22,8,14,1,0.0,0.0
1008,62,23-09-2019 13:42:00,1,3053.0,1934.0,0.633,14.172,52,23,5,18,29,3,26,0,0.0,0.0
1008,63,23-09-2019 13:44:00,1,3019.0,2022.0,0.67,14.134,47,19,8,11,28,12,16,0,0.0,0.0
1008,64,23-09-2019 13:46:00,1,2882.0,1958.0,0.679,13.524,127,77,53,24,50,30,20,0,0.0,0.01
1008,65,23-09-2019 13:48:00,1,2764.0,1808.0,0.654,12.892,89,47,27,20,42,19,23,0,0.0,0.0
1008,66,23-09-2019 13:50:00,1,2628.0,1754.0,0.668,12.298,111,73,47,26,38,24,14,6,0.0,0.0
1008,67,23-09-2019 13:52:00,1,2329.0,1704.0,0.732,11.062,77,31,14,17,46,2,44,0,0.0,0.0
1008,68,23-09-2019 13:54:00,1,2371.0,1572.0,0.663,11.083,45,16,2,14,29,0,29,0,0.0,0.0
1008,69,23-09-2019 13:56:00,1,2623.0,1743.0,0.664,12.264,60,40,12,28,20,6,14,0,0.0,0.0
1008,70,23-09-2019 13:58:00,1,2474.0,1756.0,0.71,11.692,47,38,10,28,9,2,7,0,0.0,0.0
1008,71,23-09-2019 14:00:00,1,2607.0,1798.0,0.689,12.263,113,60,34,26,53,20,33,0,0.0,0.0
1008,72,23-09-2019 14:02:00,1,2759.0,1858.0,0.673,12.926,2,0,0,0,2,0,2,0,0.0,0.0
1008,73,23-09-2019 14:04:00,1,2331.0,1688.0,0.724,11.052,0,0,0,0,0,0,0,0,0.0,0.0
1008,74,23-09-2019 14:06:00,1,1934.0,1461.0,0.755,9.238,0,0,0,0,0,0,0,0,0.0,0.0
1008,75,23-09-2019 14:08:00,1,1881.0,1358.0,0.721,8.916,1,0,0,0,1,0,1,0,0.0,0.0
1008,76,23-09-2019 14:10:00,1,1828.0,1255.0,0.687,8.594,0,0,0,0,0,0,0,0,0.0,0.0
1008,77,23-09-2019 14:12:00,1,1837.0,1251.0,0.681,8.622,19,11,4,7,8,2,6,0,0.0,0.0
1008,78,23-09-2019 14:14:00,1,2126.0,1341.0,0.631,9.86,1,0,0,0,1,0,1,0,0.0,0.0
1008,79,23-09-2019 14:16:00,1,2111.0,1346.0,0.637,9.809,0,0,0,0,0,0,0,0,0.0,0.0
1008,80,23-09-2019 14:18:00,1,2100.0,1396.0,0.665,9.82,1,0,0,0,1,0,1,0,0.0,0.0
1008,81,23-09-2019 14:20:00,1,1965.0,1323.0,0.673,9.207,2,1,0,1,1,0,1,0,0.0,0.0
1008,82,23-09-2019 14:22:00,1,1823.0,1282.0,0.703,8.601,0,0,0,0,0,0,0,0,0.0,0.0
1008,83,23-09-2019 14:24:00,1,1826.0,1266.0,0.693,8.597,6,1,0,1,5,0,5,0,0.0,0.0
1008,84,23-09-2019 14:26:00,1,1835.0,1258.0,0.685,8.624,1,1,1,0,0,0,0,0,0.0,0.0
1008,85,23-09-2019 14:28:00,1,1833.0,1237.0,0.675,8.592,0,0,0,0,0,0,0,0,0.0,0.0
1008,86,23-09-2019 14:30:00,1,1832.0,1261.0,0.688,8.616,0,0,0,0,0,0,0,0,0.0,0.0
1008,87,23-09-2019 14:32:00,1,1845.0,1190.0,0.645,8.586,0,0,0,0,0,0,0,0,0.0,0.0
1008,88,23-09-2019 14:34:00,1,1845.0,1208.0,0.655,8.608,10,10,0,10,0,0,0,0,0.0,0.0
1008,89,23-09-2019 14:36:00,1,1827.0,1263.0,0.691,8.596,0,0,0,0,0,0,0,0,0.0,0.0
1008,90,23-09-2019 14:38:00,1,1816.0,1324.0,0.729,8.621,14,10,5,5,4,0,4,0,0.0,0.0
1008,91,23-09-2019 14:40:00,1,2095.0,1426.0,0.681,9.835,0,0,0,0,0,0,0,0,0.0,0.0
1008,92,23-09-2019 14:42:00,1,2176.5,1411.0,0.6495,10.1385,0,0,0,0,0,0,0,0,0.0,0.0
1008,93,23-09-2019 14:44:00,1,2258.0,1396.0,0.618,10.442,0,0,0,0,0,0,0,0,0.0,0.0
1008,94,23-09-2019 14:46:00,1,2260.0,1376.0,0.609,10.428,0,0,0,0,0,0,0,0,0.0,0.0
1008,95,23-09-2019 14:48:00,1,2114.0,1362.0,0.644,9.838,0,0,0,0,0,0,0,0,0.0,0.0
1008,96,23-09-2019 14:50:00,1,1964.0,1342.0,0.683,9.225,0,0,0,0,0,0,0,0,0.0,0.0
1008,97,23-09-2019 14:52:00,1,1971.0,1320.0,0.67,9.226,39,22,13,9,17,4,13,0,0.0,0.0
1008,98,23-09-2019 14:54:00,1,1967.0,1328.0,0.675,9.221,1,0,0,0,1,0,1,0,0.0,0.0
1008,99,23-09-2019 14:56:00,1,1977.0,1310.0,0.663,9.242,8,2,1,1,6,0,6,0,0.0,0.0
1008,100,23-09-2019 14:58:00,1,1954.0,1356.0,0.694,9.199,8,8,0,8,0,0,0,0,0.0,0.01
1008,101,23-09-2019 15:00:00,1,1960.0,1364.0,0.696,9.234,2,0,0,0,2,0,2,0,0.0,0.0
1008,102,23-09-2019 15:02:00,1,1972.0,1327.0,0.673,9.238,3,0,0,0,3,2,1,0,0.0,0.0
1008,103,23-09-2019 15:04:00,1,1972.0,1307.0,0.663,9.217,0,0,0,0,0,0,0,0,0.0,0.0
1008,104,23-09-2019 15:06:00,1,1988.0,1257.0,0.632,9.226,3,3,1,2,0,0,0,0,0.0,0.0
1008,105,23-09-2019 15:08:00,1,1850.0,1192.0,0.645,8.608,7,2,0,2,5,1,4,0,0.0,0.0
1008,106,23-09-2019 15:10:00,1,1703.0,1146.0,0.673,7.979,8,5,0,5,3,0,3,0,0.0,0.0
1008,107,23-09-2019 15:12:00,1,1704.0,1156.0,0.678,7.996,3,3,0,3,0,0,0,0,0.0,0.0
1008,108,23-09-2019 15:14:00,1,1845.0,1196.0,0.648,8.596,1,1,0,1,0,0,0,0,0.0,0.0
1008,109,23-09-2019 15:16:00,1,1916.0,1232.0,0.643,8.914,1,1,0,1,0,0,0,0,0.0,0.0
1008,110,23-09-2019 15:18:00,1,1987.0,1268.0,0.638,9.232,2,2,0,2,0,0,0,0,0.0,0.0
1008,111,23-09-2019 15:20:00,1,1989.0,1250.0,0.628,9.219,3,3,0,3,0,0,0,0,0.0,0.0
1008,112,23-09-2019 15:22:00,1,1982.0,1261.0,0.636,9.207,0,0,0,0,0,0,0,0,0.0,0.0
1008,113,23-09-2019 15:24:00,1,1985.0,1270.0,0.64,9.229,0,0,0,0,0,0,0,0,0.0,0.0
1008,114,23-09-2019 15:26:00,1,1967.0,1299.0,0.66,9.19,61,41,25,16,20,5,15,0,0.0,0.0
1008,115,23-09-2019 15:28:00,1,2209.0,1565.0,0.708,10.434,117,76,34,42,41,10,31,1,0.0,0.0
1008,116,23-09-2019 15:30:00,1,2486.0,1721.0,0.692,11.701,179,107,79,28,72,48,24,5,0.0,0.0
1008,117,23-09-2019 15:32:00,1,2630.0,1780.0,0.677,12.332,41,31,10,21,10,3,7,0,0.0,0.0
1008,118,23-09-2019 15:34:00,1,2620.0,1785.0,0.681,12.301,61,29,14,15,32,5,27,0,0.0,0.0
1008,119,23-09-2019 15:36:00,1,2606.0,1816.0,0.697,12.279,115,62,43,19,53,35,18,4,0.0,0.0
1008,120,23-09-2019 15:38:00,1,2599.0,1878.0,0.723,12.32,64,40,25,15,24,6,18,0,0.0,0.0
1008,121,23-09-2019 15:40:00,1,2620.0,1745.0,0.666,12.255,58,32,13,19,26,8,18,0,0.0,0.0
1008,122,23-09-2019 15:42:00,1,2337.0,1720.0,0.736,11.112,106,81,47,34,25,5,20,0,0.0,0.0
1008,123,23-09-2019 15:44:00,1,2617.0,1781.0,0.68,12.283,137,100,50,50,37,0,37,0,0.0,0.0
1008,124,23-09-2019 15:46:00,1,2618.0,1801.0,0.688,12.31,90,57,30,27,33,8,25,0,0.0,0.0
1008,125,23-09-2019 15:48:00,1,2464.0,1752.0,0.711,11.649,86,46,26,20,40,23,17,0,0.0,0.0
1008,126,23-09-2019 15:50:00,1,2328.0,1689.0,0.7265,11.0425,132,92,68,24,40,25,15,0,0.0,0.0
1008,127,23-09-2019 15:52:00,1,2192.0,1626.0,0.742,10.436,0,0,0,0,0,0,0,0,0.0,0.0
1008,128,23-09-2019 15:54:00,1,2214.0,1562.0,0.705,10.453,0,0,0,0,0,0,0,0,0.0,0.0
1008,129,23-09-2019 15:56:00,1,1937.0,1449.0,0.748,9.237,0,0,0,0,0,0,0,0,0.0,0.0
1008,130,23-09-2019 15:58:00,1,1957.0,1358.0,0.694,9.213,0,0,0,0,0,0,0,0,0.0,0.0
1008,131,23-09-2019 16:00:00,1,1967.0,1323.0,0.673,9.218,1,0,0,0,1,0,1,0,0.0,0.0
1008,132,23-09-2019 16:02:00,1,1974.0,1308.0,0.663,9.227,6,0,0,0,6,0,6,0,0.0,0.0
1008,133,23-09-2019 16:04:00,1,1686.0,1226.0,0.727,7.999,0,0,0,0,0,0,0,0,0.0,0.0
1008,134,23-09-2019 16:06:00,1,1547.0,1147.0,0.742,7.364,3,0,0,0,3,0,3,0,0.0,0.0
1008,135,23-09-2019 16:08:00,1,1548.0,1177.0,0.76,7.401,1,0,0,0,1,0,1,0,0.0,0.0
1008,136,23-09-2019 16:10:00,1,1679.0,1251.0,0.745,7.998,8,5,2,3,3,0,3,0,0.0,0.0
1008,137,23-09-2019 16:12:00,1,1961.0,1359.0,0.693,9.232,0,0,0,0,0,0,0,0,0.0,0.0
1008,138,23-09-2019 16:14:00,1,1978.0,1308.0,0.661,9.242,0,0,0,0,0,0,0,0,0.0,0.0
1008,139,23-09-2019 16:16:00,1,1964.0,1325.0,0.674,9.206,13,0,0,0,13,1,12,0,0.0,0.0
1008,140,23-09-2019 16:18:00,1,1821.0,1296.0,0.712,8.612,0,0,0,0,0,0,0,0,0.0,0.0
1008,141,23-09-2019 16:20:00,1,1685.0,1234.0,0.732,8.004,1,0,0,0,1,0,1,0,0.0,0.0
1008,142,23-09-2019 16:22:00,1,1817.0,1298.0,0.714,8.596,0,0,0,0,0,0,0,0,0.0,0.0
1008,143,23-09-2019 16:24:00,1,1896.0,1296.5,0.685,8.905,1,1,1,0,0,0,0,0,0.0,0.0
1008,144,23-09-2019 16:26:00,1,1975.0,1295.0,0.656,9.214,5,5,2,3,0,0,0,0,0.0,0.0
1008,145,23-09-2019 16:28:00,1,2115.0,1363.0,0.644,9.845,12,5,3,2,7,3,4,0,0.0,0.0
1008,146,23-09-2019 16:30:00,1,2130.0,1313.0,0.616,9.847,0,0,0,0,0,0,0,0,0.0,0.0
1008,147,23-09-2019 16:32:00,1,1976.0,1281.0,0.648,9.203,34,16,7,9,18,8,10,0,0.0,0.0
1008,148,23-09-2019 16:34:00,1,2114.0,1338.0,0.633,9.81,0,0,0,0,0,0,0,0,0.0,0.0
1008,149,23-09-2019 16:36:00,1,2120.0,1330.0,0.627,9.824,3,0,0,0,3,1,2,0,0.0,0.0
1008,150,23-09-2019 16:38:00,1,2121.0,1347.0,0.635,9.849,0,0,0,0,0,0,0,0,0.0,0.0
1008,151,23-09-2019 16:40:00,1,2116.0,1353.0,0.639,9.835,0,0,0,0,0,0,0,0,0.0,0.0
1008,152,23-09-2019 16:42:00,1,2122.0,1319.0,0.621,9.823,3,0,0,0,3,0,3,0,0.0,0.0
1008,153,23-09-2019 16:44:00,1,2130.0,1320.0,0.62,9.853,3,1,1,0,2,0,2,0,0.0,0.0
1008,154,23-09-2019 16:46:00,1,2115.0,1340.0,0.633,9.817,3,2,1,1,1,0,1,0,0.0,0.0
1008,155,23-09-2019 16:48:00,1,1975.0,1286.0,0.651,9.205,12,0,0,0,12,3,9,0,0.0,0.0
1008,156,23-09-2019 16:50:00,1,1984.0,1272.0,0.641,9.228,7,6,0,6,1,0,1,0,0.0,0.0
1008,157,23-09-2019 16:52:00,1,1977.0,1276.0,0.645,9.203,2,1,0,1,1,1,0,0,0.0,0.0
1008,158,23-09-2019 16:54:00,1,2116.0,1333.0,0.63,9.812,0,0,0,0,0,0,0,0,0.0,0.0
1008,159,23-09-2019 16:56:00,1,2117.0,1356.0,0.641,9.843,2,0,0,0,2,1,1,0,0.0,0.0
1008,160,23-09-2019 16:58:00,1,2110.0,1370.5,0.65,9.831,1,0,0,0,1,0,1,0,0.0,0.0
1008,161,23-09-2019 17:00:00,1,2103.0,1385.0,0.659,9.819,4,0,0,0,4,0,4,0,0.0,0.0
1008,162,23-09-2019 17:02:00,1,2124.0,1342.0,0.632,9.853,4,0,0,0,4,0,4,0,0.0,0.0
1008,163,23-09-2019 17:04:00,1,2089.0,1425.0,0.682,9.81,0,0,0,0,0,0,0,0,0.0,0.0
1008,164,23-09-2019 17:06:00,1,2108.0,1375.0,0.652,9.826,0,0,0,0,0,0,0,0,0.0,0.0
1008,165,23-09-2019 17:08:00,1,2104.0,1391.0,0.661,9.828,2,2,2,0,0,0,0,0,0.0,0.0
1008,166,23-09-2019 17:10:00,1,2090.0,1451.0,0.694,9.842,0,0,0,0,0,0,0,0,0.0,0.0
1008,167,23-09-2019 17:12:00,1,2103.0,1409.0,0.67,9.848,32,22,12,10,10,5,5,0,0.0,0.0
1008,168,23-09-2019 17:14:00,1,2080.0,1482.0,0.713,9.836,4,4,1,3,0,0,0,0,0.0,0.0
1008,169,23-09-2019 17:16:00,1,2103.0,1390.0,0.661,9.826,15,15,2,13,0,0,0,0,0.0,0.0
1008,170,23-09-2019 17:18:00,1,2105.0,1407.0,0.668,9.853,0,0,0,0,0,0,0,0,0.0,0.0
1008,171,23-09-2019 17:20:00,1,2105.0,1401.0,0.666,9.845,12,7,2,5,5,1,4,0,0.0,0.0
1008,172,23-09-2019 17:22:00,1,2084.0,1438.0,0.69,9.803,39,27,18,9,12,6,6,0,0.0,0.0
1008,173,23-09-2019 17:24:00,1,2076.0,1477.0,0.712,9.815,0,0,0,0,0,0,0,0,0.0,0.0
1008,174,23-09-2019 17:26:00,1,2100.0,1415.0,0.674,9.841,2,0,0,0,2,0,2,0,0.0,0.0
1008,175,23-09-2019 17:28:00,1,2105.0,1372.0,0.652,9.814,18,11,8,3,7,1,6,0,0.0,0.0
1008,176,23-09-2019 17:30:00,1,2095.0,1423.0,0.679,9.829,29,9,3,6,20,5,15,0,0.0,0.0
1008,177,23-09-2019 17:32:00,1,2230.5,1505.0,0.675,10.4535,51,30,16,14,21,5,16,1,0.0,0.0
1008,178,23-09-2019 17:34:00,1,2366.0,1587.0,0.671,11.078,75,40,19,21,35,5,30,0,0.0,0.0
1008,179,23-09-2019 17:36:00,1,2339.0,1646.0,0.704,11.038,167,106,72,34,61,39,22,3,0.0,0.0
1008,180,23-09-2019 17:38:00,1,2326.0,1733.0,0.745,11.084,107,62,39,23,45,26,19,0,0.0,0.0
1008,181,23-09-2019 17:40:00,1,2325.0,1735.0,0.746,11.081,126,73,33,40,53,29,24,0,0.0,0.0
1008,182,23-09-2019 17:42:00,1,2327.0,1705.0,0.732,11.057,51,23,11,12,28,4,24,0,0.0,0.0
1008,183,23-09-2019 17:44:00,1,2625.0,1792.0,0.683,12.326,42,30,8,22,12,1,11,0,0.0,0.0
1008,184,23-09-2019 17:46:00,1,2742.0,1883.0,0.687,12.889,138,13,7,6,125,86,39,0,0.0,0.0
1008,185,23-09-2019 17:48:00,1,2467.0,1759.0,0.713,11.667,75,28,13,15,47,22,25,0,0.0,0.0
1008,186,23-09-2019 17:50:00,1,2348.0,1675.0,0.713,11.106,13,4,2,2,9,1,8,0,0.0,0.0
1008,187,23-09-2019 17:52:00,1,2216.0,1548.0,0.698,10.446,14,10,7,3,4,2,2,0,0.0,0.0
1008,188,23-09-2019 17:54:00,1,2083.0,1447.0,0.695,9.808,2,0,0,0,2,1,1,0,0.0,0.0
1008,189,23-09-2019 17:56:00,1,2109.0,1390.0,0.659,9.849,28,1,0,1,27,0,27,0,0.0,0.0
1008,190,23-09-2019 17:58:00,1,1973.0,1310.0,0.664,9.223,15,8,6,2,7,1,6,0,0.0,0.0
1008,191,23-09-2019 18:00:00,0,1682.0,1231.0,0.731,7.991,3,0,0,0,3,0,3,0,0.0,0.0
1008,192,23-09-2019 18:02:00,0,1699.0,1175.0,0.692,7.997,1,0,0,0,1,0,1,0,0.0,0.0
1008,193,23-09-2019 18:04:00,0,1829.0,1264.0,0.691,8.607,2,2,0,2,0,0,0,0,0.0,0.0
1008,194,23-09-2019 18:06:00,0,1899.5,1288.5,0.679,8.911,2,2,0,2,0,0,0,0,0.0,0.0
1008,195,23-09-2019 18:08:00,0,1970.0,1313.0,0.667,9.215,1,1,0,1,0,0,0,0,0.0,0.0
1008,196,23-09-2019 18:10:00,0,2123.0,1352.0,0.637,9.861,4,4,2,2,0,0,0,0,0.0,0.0
1008,197,23-09-2019 18:12:00,0,1675.0,1245.0,0.743,7.98,6,4,1,3,2,0,2,0,0.0,0.0
1008,198,23-09-2019 18:14:00,0,1968.0,1325.0,0.673,9.221,6,5,0,5,1,0,1,0,0.0,0.0
1008,199,23-09-2019 18:16:00,0,2111.0,1354.0,0.641,9.818,13,6,2,4,7,0,7,0,0.0,0.0
1008,200,23-09-2019 18:18:00,0,1816.0,1309.0,0.721,8.605,18,18,6,12,0,0,0,0,0.0,0.0
1008,201,23-09-2019 18:20:00,0,2118.0,1356.0,0.64,9.847,11,9,5,4,2,1,1,0,0.0,0.0
1008,202,23-09-2019 18:22:00,0,2116.0,1361.0,0.643,9.845,22,22,4,18,0,0,0,0,0.0,0.0
1008,203,23-09-2019 18:24:00,0,2097.0,1414.0,0.674,9.827,27,18,1,17,9,5,4,0,0.0,0.0
1008,204,23-09-2019 18:26:00,0,2067.0,1539.0,0.744,9.847,257,155,99,56,102,52,50,7,0.0,0.0
1008,205,23-09-2019 18:28:00,0,2342.0,1655.0,0.707,11.058,321,178,136,42,143,104,39,23,0.0,0.0
1008,206,23-09-2019 18:30:00,0,2755.0,1843.0,0.669,12.898,297,173,132,41,124,91,33,43,0.0,0.0
1008,207,23-09-2019 18:32:00,0,2724.0,1985.0,0.729,12.93,152,99,69,30,53,26,27,8,0.0,0.0
1008,208,23-09-2019 18:34:00,0,3023.0,2016.0,0.667,14.145,197,111,74,37,86,54,32,14,0.0,0.0
1008,209,23-09-2019 18:36:00,0,3161.0,2089.0,0.661,14.768,133,79,52,27,54,35,19,22,0.0,0.0
1008,210,23-09-2019 18:38:00,0,2730.0,1970.0,0.722,12.937,118,63,41,22,55,41,14,32,0.0,0.0
1008,211,23-09-2019 18:40:00,0,2807.0,1953.0,0.6965,13.2215,198,120,83,37,78,50,28,30,0.0,0.0
1008,212,23-09-2019 18:42:00,0,2884.0,1936.0,0.671,13.506,112,73,41,32,39,9,30,0,0.0,0.0
1008,213,23-09-2019 18:44:00,0,2895.0,1941.0,0.671,13.558,139,63,31,32,76,46,30,5,0.0,0.0
1008,214,23-09-2019 18:46:00,0,3329.0,2036.0,0.612,15.37,131,86,53,33,45,19,26,0,0.0,0.0
1008,215,23-09-2019 18:48:00,0,3173.0,2030.0,0.64,14.748,92,48,31,17,44,14,30,0,0.0,0.0
1008,216,23-09-2019 18:50:00,0,2876.0,1972.0,0.686,13.514,86,38,15,23,48,21,27,0,0.0,0.0
1008,217,23-09-2019 18:52:00,0,2772.0,1820.0,0.657,12.938,92,45,26,19,47,31,16,13,0.0,0.0
1008,218,23-09-2019 18:54:00,0,2919.0,1828.0,0.626,13.525,221,113,80,33,108,79,29,44,0.0,0.0
1008,219,23-09-2019 18:56:00,0,2910.0,1837.0,0.631,13.5,110,61,29,32,49,32,17,7,0.0,0.0
1008,220,23-09-2019 18:58:00,0,2896.0,1872.0,0.646,13.484,66,29,19,10,37,18,19,1,0.0,0.0
1008,221,23-09-2019 19:00:00,0,2884.0,1961.0,0.68,13.535,60,37,18,19,23,7,16,0,0.0,0.0
1008,222,23-09-2019 19:02:00,0,2894.0,1945.0,0.672,13.557,20,17,1,16,3,1,2,0,0.0,0.0
1008,223,23-09-2019 19:04:00,0,2477.0,1706.0,0.689,11.65,12,12,0,12,0,0,0,0,0.0,0.0
1008,224,23-09-2019 19:06:00,0,2520.0,1572.0,0.624,11.672,11,10,1,9,1,1,0,0,0.0,0.0
1008,225,23-09-2019 19:08:00,0,2244.0,1487.0,0.662,10.489,3,3,1,2,0,0,0,0,0.0,0.0
1008,226,23-09-2019 19:10:00,0,2255.0,1429.0,0.634,10.467,14,13,5,8,1,1,0,0,0.0,0.0
1008,227,23-09-2019 19:12:00,0,2249.0,1430.0,0.636,10.445,36,32,1,31,4,2,2,0,0.0,0.0
1008,228,23-09-2019 19:14:00,0,2248.5,1442.0,0.6415,10.4555,19,17,1,16,2,1,1,0,0.0,0.0
1008,229,23-09-2019 19:16:00,0,2248.0,1454.0,0.647,10.466,21,21,2,19,0,0,0,0,0.0,0.0
1008,230,23-09-2019 19:18:00,0,2240.0,1470.0,0.656,10.452,29,27,11,16,2,1,1,0,0.0,0.0
1008,231,23-09-2019 19:20:00,0,2241.0,1427.0,0.637,10.409,22,20,5,15,2,1,1,0,0.0,0.0
1008,232,23-09-2019 19:22:00,0,2256.0,1424.0,0.631,10.466,18,15,4,11,3,1,2,0,0.0,0.0
1008,233,23-09-2019 19:24:00,0,2241.0,1449.0,0.647,10.434,25,14,5,9,11,0,11,0,0.0,0.0
1008,234,23-09-2019 19:26:00,0,2249.0,1426.0,0.634,10.439,77,41,23,18,36,21,15,0,0.0,0.0
1008,235,23-09-2019 19:28:00,0,2232.0,1497.0,0.671,10.451,261,144,99,45,117,78,39,27,0.0,0.0
1008,236,23-09-2019 19:30:00,0,2516.0,1617.0,0.643,11.706,301,175,133,42,126,97,29,36,0.0,0.0
1008,237,23-09-2019 19:32:00,0,2225.0,1539.0,0.692,10.47,256,149,115,34,107,74,33,24,0.0,0.0
1008,238,23-09-2019 19:34:00,0,2500.0,1642.0,0.657,11.669,260,139,92,47,121,85,36,33,0.0,0.0
1008,239,23-09-2019 19:36:00,0,2623.0,1754.0,0.669,12.278,306,189,151,38,117,92,25,19,0.0,0.0
1008,240,23-09-2019 19:38:00,0,2919.0,1813.0,0.621,13.508,238,133,92,41,105,71,34,24,0.0,0.0
1008,241,23-09-2019 19:40:00,0,2903.0,1899.0,0.654,13.54,290,133,100,33,157,113,44,15,0.0,0.0
1008,242,23-09-2019 19:42:00,0,2901.0,1893.0,0.652,13.528,315,111,69,42,204,161,43,9,0.0,0.0
1008,243,23-09-2019 19:44:00,0,3178.0,1996.0,0.628,14.734,439,194,141,53,245,193,52,33,0.0,0.0
1008,244,23-09-2019 19:46:00,0,2888.0,1938.0,0.671,13.524,408,175,140,35,233,173,60,19,0.0,0.0
1008,245,23-09-2019 19:48:00,0,3184.5,1999.5,0.6315,14.761,372,181,139,42,191,145,46,19,0.0,0.0
1008,246,23-09-2019 19:50:00,0,3481.0,2061.0,0.592,15.998,343,165,129,36,178,128,50,28,0.0,0.0
1008,247,23-09-2019 19:52:00,0,3481.0,2050.0,0.589,15.987,308,152,109,43,156,104,52,29,0.0,0.0
1008,248,23-09-2019 19:54:00,0,3042.0,1904.0,0.626,14.093,212,103,77,26,109,67,42,30,0.0,0.0
1008,249,23-09-2019 19:56:00,0,3345.0,1990.0,0.595,15.384,144,73,40,33,71,35,36,0,0.0,0.0
1008,250,23-09-2019 19:58:00,0,3484.0,2042.0,0.586,15.989,74,11,2,9,63,19,44,0,0.0,0.0
1008,251,23-09-2019 20:00:00,0,3486.0,2013.0,0.577,15.966,98,52,21,31,46,17,29,0,0.0,0.0
1008,252,23-09-2019 20:02:00,0,3043.0,1926.0,0.633,14.124,163,80,44,36,83,50,33,31,0.0,0.0
1008,253,23-09-2019 20:04:00,0,3488.0,2017.0,0.578,15.977,149,82,51,31,67,52,15,44,0.0,0.0
1008,254,23-09-2019 20:06:00,0,3190.0,1940.0,0.608,14.717,176,124,80,44,52,43,9,63,0.0,0.0
1008,255,23-09-2019 20:08:00,0,3192.0,1931.0,0.605,14.716,122,90,53,37,32,22,10,53,0.0,0.0
1008,256,23-09-2019 20:10:00,0,3053.0,1889.0,0.619,14.123,85,63,40,23,22,8,14,54,0.0,0.0
1008,257,23-09-2019 20:12:00,0,3331.0,2019.0,0.606,15.359,162,104,71,33,58,41,17,61,0.0,0.0
1008,258,23-09-2019 20:14:00,0,3185.0,1972.0,0.619,14.733,123,74,52,22,49,34,15,39,0.0,0.0
1008,259,23-09-2019 20:16:00,0,3193.0,1931.0,0.605,14.719,86,62,21,41,24,2,22,79,0.0,0.0
1008,260,23-09-2019 20:18:00,0,3331.0,2018.0,0.606,15.362,150,68,39,29,82,49,33,58,0.0,0.04
1008,261,23-09-2019 20:20:00,0,3564.0,2271.0,0.637,16.559,164,84,58,26,80,51,29,15,0.0,0.0
1008,262,23-09-2019 20:22:00,0,3488.5,2281.0,0.654,16.272,172,72,31,41,100,52,48,3,0.0,0.0
1008,263,23-09-2019 20:24:00,0,3413.0,2291.0,0.671,15.985,173,103,64,39,70,40,30,4,0.0,0.01
1008,264,23-09-2019 20:26:00,0,3418.0,2287.0,0.669,15.999,141,63,44,19,78,56,22,25,0.0,0.0
1008,265,23-09-2019 20:28:00,0,3539.0,2367.0,0.669,16.564,9,2,1,1,7,2,5,0,0.0,0.0
1008,266,23-09-2019 20:30:00,0,3437.0,2248.0,0.654,16.034,3,3,1,2,0,0,0,0,0.0,0.0
1008,267,23-09-2019 20:32:00,0,3277.0,2201.0,0.672,15.349,3,1,0,1,2,1,1,0,0.0,0.0
1008,268,23-09-2019 20:34:00,0,3008.0,2013.0,0.669,14.08,54,22,16,6,32,23,9,0,0.0,0.0
1008,269,23-09-2019 20:36:00,0,2607.0,1845.0,0.708,12.315,21,6,5,1,15,6,9,0,0.0,0.0
1008,270,23-09-2019 20:38:00,0,2500.0,1637.0,0.655,11.661,8,5,2,3,3,1,2,0,0.0,0.0
1008,271,23-09-2019 20:40:00,0,2349.0,1629.0,0.693,11.058,80,44,19,25,36,14,22,0,0.0,0.0
1008,272,23-09-2019 20:42:00,0,2893.0,1906.0,0.659,13.509,191,115,76,39,76,61,15,33,0.0,0.03
1008,273,23-09-2019 20:44:00,0,3035.0,1998.0,0.658,14.17,123,95,55,40,28,17,11,61,0.0,0.0
1008,274,23-09-2019 20:46:00,0,3009.0,2070.0,0.688,14.148,191,125,81,44,66,45,21,53,0.0,0.0
1008,275,23-09-2019 20:48:00,0,3002.0,2082.0,0.694,14.133,284,191,144,47,93,70,23,34,0.0,0.04
1008,276,23-09-2019 20:50:00,0,3428.0,2229.0,0.65,15.976,205,125,83,42,80,56,24,17,0.0,0.0
1008,277,23-09-2019 20:52:00,0,3419.0,2290.0,0.67,16.006,139,73,49,24,66,46,20,16,0.0,0.0
1008,278,23-09-2019 20:54:00,0,3405.0,2307.0,0.677,15.971,92,47,25,22,45,18,27,0,0.0,0.0
1008,279,23-09-2019 20:56:00,0,3297.5,2433.5,0.7395,15.6875,96,42,19,23,54,23,31,10,0.0,0.0
1008,280,23-09-2019 20:58:00,0,3190.0,2560.0,0.802,15.404,88,41,32,9,47,32,15,2,0.0,0.0
1008,281,23-09-2019 21:00:00,0,2959.0,2240.0,0.757,14.139,12,6,0,6,6,2,4,0,0.0,0.0
1008,282,23-09-2019 21:02:00,0,2841.0,2126.0,0.748,13.548,29,20,0,20,9,1,8,0,0.0,0.0
1008,283,23-09-2019 21:04:00,0,2549.0,2040.0,0.8,12.301,32,12,7,5,20,14,6,0,0.0,0.0
1008,284,23-09-2019 21:06:00,0,2550.0,2027.0,0.795,12.291,157,0,0,0,157,141,16,0,0.0,0.0
1008,285,23-09-2019 21:08:00,0,2583.0,1927.0,0.746,12.309,180,83,47,36,97,70,27,45,0.0,0.0
1008,286,23-09-2019 21:10:00,0,2552.0,2018.0,0.791,12.291,98,80,39,41,18,6,12,61,0.0,0.0
1008,287,23-09-2019 21:12:00,0,2699.0,2056.0,0.762,12.912,281,158,112,46,123,92,31,74,0.0,0.0
1008,288,23-09-2019 21:14:00,0,2548.0,2065.0,0.81,12.326,295,167,119,48,128,104,24,57,0.0,0.0
1008,289,23-09-2019 21:16:00,0,2954.0,2249.0,0.761,14.131,240,121,87,34,119,88,31,38,0.0,0.0
1008,290,23-09-2019 21:18:00,0,2946.0,2292.0,0.778,14.146,451,221,172,49,230,185,45,123,0.0,0.0
1008,291,23-09-2019 21:20:00,0,3096.0,2329.0,0.752,14.776,406,203,162,41,203,150,53,37,0.0,0.01
1008,292,23-09-2019 21:22:00,0,3191.0,2526.0,0.792,15.371,209,136,97,39,73,45,28,39,0.0,0.0
1008,293,23-09-2019 21:24:00,0,3206.0,2470.0,0.771,15.368,226,149,106,43,77,53,24,58,0.0,0.03
1008,294,23-09-2019 21:26:00,0,3218.0,2428.0,0.754,15.367,116,68,40,28,48,32,16,65,0.0,0.0
1008,295,23-09-2019 21:28:00,0,3496.0,2603.0,0.744,16.658,199,130,87,43,69,42,27,47,0.0,0.01
1008,296,23-09-2019 21:30:00,0,3346.0,2570.0,0.769,16.029,194,102,64,38,92,62,30,60,0.0,0.01
1008,297,23-09-2019 21:32:00,0,3196.0,2537.0,0.794,15.4,344,166,125,41,178,141,37,124,0.0,0.0
1008,298,23-09-2019 21:34:00,0,3208.0,2500.0,0.779,15.407,239,142,109,33,97,71,26,103,0.0,0.0
1008,299,23-09-2019 21:36:00,0,3327.0,2589.0,0.778,15.974,439,182,146,36,257,188,69,19,0.0,0.01
1008,300,23-09-2019 21:38:00,0,3195.0,2525.0,0.79,15.384,339,179,144,35,160,134,26,213,0.0,0.0
1008,301,23-09-2019 21:40:00,0,3081.0,2352.0,0.763,14.745,338,210,162,48,128,95,33,89,0.0,0.0
1008,302,23-09-2019 21:42:00,0,2945.0,2306.0,0.783,14.156,442,291,236,55,151,110,41,106,0.0,0.0
1008,303,23-09-2019 21:44:00,0,3078.0,2363.0,0.768,14.742,278,139,104,35,139,106,33,120,0.0,0.03
1008,304,23-09-2019 21:46:00,0,3237.0,2380.0,0.735,15.39,358,199,155,44,159,117,42,91,0.0,0.0
1008,305,23-09-2019 21:48:00,0,3621.0,2726.0,0.753,17.285,320,156,110,46,164,127,37,69,0.0,0.0
1008,306,23-09-2019 21:50:00,0,3578.0,2841.0,0.794,17.242,176,120,77,43,56,35,21,107,0.0,0.0
1008,307,23-09-2019 21:52:00,0,3201.0,2500.0,0.781,15.38,73,55,27,28,18,5,13,56,0.0,0.0
1008,308,23-09-2019 21:54:00,0,3468.0,2645.0,0.763,16.595,212,147,114,33,65,48,17,15,0.0,0.0
1008,309,23-09-2019 21:56:00,0,3178.0,2609.0,0.821,15.411,185,123,79,44,62,46,16,63,0.0,0.0
1008,310,23-09-2019 21:58:00,0,3626.0,2624.0,0.724,17.191,297,161,126,35,136,101,35,94,0.0,0.03
1008,311,23-09-2019 22:00:00,0,3175.0,2601.0,0.819,15.389,367,199,160,39,168,118,50,69,0.0,0.0
1008,312,23-09-2019 22:02:00,0,3201.0,2538.0,0.793,15.423,244,129,92,37,115,78,37,24,0.0,0.0
1008,313,23-09-2019 22:04:00,0,3208.5,2501.5,0.7795,15.412,306,169,126,43,137,97,40,76,0.0,0.0
1008,314,23-09-2019 22:06:00,0,3216.0,2465.0,0.766,15.401,261,131,99,32,130,96,34,82,0.0,0.0
1008,315,23-09-2019 22:08:00,0,3223.0,2425.0,0.752,15.385,159,113,83,30,46,27,19,12,0.0,0.0
1008,316,23-09-2019 22:10:00,0,3092.0,2303.0,0.745,14.735,251,159,114,45,92,63,29,33,0.0,0.02
1008,317,23-09-2019 22:12:00,0,3350.0,2544.0,0.759,16.016,174,116,72,44,58,29,29,71,0.0,0.0
1008,318,23-09-2019 22:14:00,0,3582.0,2842.0,0.793,17.261,105,73,43,30,32,16,16,59,0.0,0.0
1008,319,23-09-2019 22:16:00,0,3200.0,2496.0,0.78,15.37,60,49,14,35,11,0,11,42,0.0,0.0
1008,320,23-09-2019 22:18:00,0,3203.0,2523.0,0.788,15.415,89,60,31,29,29,11,18,47,0.0,0.0
1008,321,23-09-2019 22:20:00,0,3183.0,2529.0,0.795,15.343,58,43,24,19,15,0,15,62,0.0,0.01
1008,322,23-09-2019 22:22:00,0,3218.0,2421.0,0.752,15.359,57,47,22,25,10,2,8,39,0.0,0.03
1008,323,23-09-2019 22:24:00,0,2965.0,2226.0,0.751,14.149,267,163,124,39,104,76,28,56,0.0,0.01
1008,324,23-09-2019 22:26:00,0,3237.0,2402.0,0.742,15.414,157,97,66,31,60,38,22,63,0.0,0.0
1008,325,23-09-2019 22:28:00,0,3329.0,2573.0,0.773,15.964,148,93,66,27,55,33,22,91,0.0,0.0
1008,326,23-09-2019 22:30:00,0,2953.0,2264.0,0.766,14.143,224,137,98,39,87,62,25,36,0.0,0.02
1008,327,23-09-2019 22:32:00,0,3472.0,2653.0,0.764,16.619,248,148,113,35,100,64,36,13,0.0,0.0
1008,328,23-09-2019 22:34:00,0,3467.0,2653.0,0.765,16.597,142,106,70,36,36,21,15,43,0.0,0.02
1008,329,23-09-2019 22:36:00,0,3176.0,2584.0,0.814,15.376,223,124,91,33,99,67,32,39,0.0,0.0
1008,330,23-09-2019 22:38:00,0,3189.0,2555.0,0.8015,15.395,224,118,94,24,106,71,35,31,0.0,0.0
1008,331,23-09-2019 22:40:00,0,3202.0,2526.0,0.789,15.414,126,89,69,20,37,27,10,105,0.0,0.0
1008,332,23-09-2019 22:42:00,0,2971.0,2208.0,0.743,14.152,169,115,87,28,54,35,19,111,0.0,0.0
1008,333,23-09-2019 22:44:00,0,3200.0,2488.0,0.778,15.362,48,36,23,13,12,5,7,35,0.0,0.0
1008,334,23-09-2019 22:46:00,0,3212.0,2485.0,0.773,15.407,178,126,89,37,52,33,19,58,0.0,0.0
1008,335,23-09-2019 22:48:00,0,3227.0,2417.0,0.749,15.393,47,37,19,18,10,6,4,18,0.0,0.02
1008,336,23-09-2019 22:50:00,0,3185.0,2510.0,0.788,15.328,85,65,39,26,20,17,3,20,0.0,0.0
1008,337,23-09-2019 22:52:00,0,3192.0,2514.0,0.787,15.361,98,75,42,33,23,7,16,55,0.0,0.0
1008,338,23-09-2019 22:54:00,0,3209.0,2480.0,0.773,15.39,91,71,43,28,20,9,11,48,0.0,0.0
1008,339,23-09-2019 22:56:00,0,3183.0,2559.0,0.804,15.376,103,79,42,37,24,2,22,51,0.0,0.0
1008,340,23-09-2019 22:58:00,0,3607.0,2703.0,0.749,17.206,51,33,21,12,18,9,9,22,0.0,0.0
1008,341,23-09-2019 23:00:00,0,2952.0,2271.0,0.769,14.147,234,135,93,42,99,73,26,39,0.0,0.01
1008,342,23-09-2019 23:02:00,0,3236.0,2388.0,0.738,15.396,88,76,51,25,12,5,7,55,0.0,0.02
1008,343,23-09-2019 23:04:00,0,2949.0,2283.0,0.774,14.146,131,114,74,40,17,6,11,57,0.0,0.0
1008,344,23-09-2019 23:06:00,0,3089.0,2330.0,0.754,14.752,118,94,55,39,24,9,15,43,0.0,0.03
1008,345,23-09-2019 23:08:00,0,3206.0,2466.0,0.769,15.364,174,102,77,25,72,48,24,74,0.0,0.05
1008,346,23-09-2019 23:10:00,0,3595.0,2786.0,0.775,17.248,141,91,53,38,50,28,22,34,0.0,0.0
1008,347,23-09-2019 23:12:00,0,3286.5,2486.0,0.7545,15.701,340,129,103,26,211,174,37,74,0.0,0.01
1008,348,23-09-2019 23:14:00,0,2978.0,2186.0,0.734,14.154,351,226,180,46,125,90,35,69,0.0,0.0
1008,349,23-09-2019 23:16:00,0,3839.0,3030.0,0.789,18.481,384,255,200,55,129,99,30,65,0.0,0.07
1008,350,23-09-2019 23:18:00,0,3234.0,2415.0,0.747,15.417,134,73,56,17,61,46,15,177,0.0,0.0
1008,351,23-09-2019 23:20:00,0,3841.0,2964.0,0.772,18.417,241,145,104,41,96,72,24,19,0.0,0.0
1008,352,23-09-2019 23:22:00,0,3159.0,2649.0,0.838,15.381,112,76,45,31,36,24,12,50,0.0,0.0
1008,353,23-09-2019 23:24:00,0,3186.0,2575.0,0.808,15.406,85,64,35,29,21,2,19,35,0.0,0.0
1008,354,23-09-2019 23:26:00,0,3315.0,2676.0,0.807,16.025,52,45,25,20,7,3,4,22,0.0,0.0
1008,355,23-09-2019 23:28:00,0,3200.0,2458.0,0.768,15.33,14,5,1,4,9,4,5,0,0.0,0.0
1008,356,23-09-2019 23:30:00,0,3074.0,2428.0,0.79,14.799,138,87,61,26,51,34,17,13,0.0,0.0
1008,357,23-09-2019 23:32:00,0,2560.0,1992.0,0.778,12.294,183,115,77,38,68,48,20,41,0.0,0.0
1008,358,23-09-2019 23:34:00,0,3209.0,2453.0,0.765,15.359,98,90,56,34,8,2,6,52,0.0,0.0
1008,359,23-09-2019 23:36:00,0,3168.0,2614.0,0.825,15.378,94,81,46,35,13,7,6,38,0.0,0.02
1008,360,23-09-2019 23:38:00,0,3168.0,2643.0,0.834,15.407,66,46,22,24,20,9,11,39,0.0,0.0
1008,361,23-09-2019 23:40:00,0,3792.0,3158.0,0.833,18.436,290,157,119,38,133,105,28,169,0.0,0.01
1008,362,23-09-2019 23:42:00,0,3449.0,2730.0,0.791,16.613,335,203,153,50,132,96,36,67,0.0,0.0
1008,363,23-09-2019 23:44:00,0,3542.0,2978.0,0.841,17.252,322,160,131,29,162,116,46,75,0.0,0.0
1008,364,23-09-2019 23:46:00,0,3364.0,2772.0,0.8235,16.323,340,172,122,50,168,122,46,83,0.0,0.07
1008,365,23-09-2019 23:48:00,0,3186.0,2566.0,0.806,15.394,174,69,37,32,105,56,49,53,0.0,0.0
1008,366,23-09-2019 23:50:00,0,3571.0,2823.0,0.791,17.194,166,52,27,25,114,54,60,25,0.0,0.0
1008,367,23-09-2019 23:52:00,0,2930.0,2341.0,0.799,14.137,88,13,5,8,75,29,46,0,0.0,0.0
1008,368,23-09-2019 23:54:00,0,3199.0,2480.0,0.775,15.348,75,0,0,0,75,25,50,0,0.0,0.0
1008,369,23-09-2019 23:56:00,0,2925.0,2376.0,0.812,14.155,110,3,1,2,107,54,53,0,0.0,0.0
1008,370,23-09-2019 23:58:00,0,2958.0,2289.0,0.774,14.191,115,1,1,0,114,68,46,0,0.0,0.0
1008,371,24-09-2019 00:00:00,0,2817.0,2222.0,0.789,13.56,287,110,79,31,177,131,46,17,0.0,0.0
1008,372,24-09-2019 00:02:00,0,3042.0,2481.0,0.815,14.732,414,159,118,41,255,195,60,63,0.0,0.0
1008,373,24-09-2019 00:04:00,0,2819.0,2175.0,0.771,13.516,204,83,42,41,121,69,52,28,0.0,0.0
1008,374,24-09-2019 00:06:00,0,3197.0,2523.0,0.789,15.39,167,42,23,19,125,69,56,47,0.0,0.0
1008,375,24-09-2019 00:08:00,0,3200.0,2533.0,0.792,15.411,178,82,49,33,96,56,40,42,0.0,0.0
1008,376,24-09-2019 00:10:00,0,3167.0,2612.0,0.825,15.368,152,52,22,30,100,52,48,51,0.0,0.0
1008,377,24-09-2019 00:12:00,0,3578.0,2805.0,0.784,17.205,177,32,18,14,145,88,57,51,0.0,0.02
1008,378,24-09-2019 00:14:00,0,3174.0,2631.0,0.829,15.418,289,140,102,38,149,110,39,126,0.0,0.03
1008,379,24-09-2019 00:16:00,0,2944.0,2324.0,0.789,14.174,548,288,229,59,260,198,62,30,0.0,0.0
1008,380,24-09-2019 00:18:00,0,3191.0,2510.0,0.787,15.35,216,100,68,32,116,81,35,21,0.0,0.05
1008,381,24-09-2019 00:20:00,0,2555.5,2014.5,0.789,12.299,145,42,22,20,103,54,49,2,0.0,0.0
1008,382,24-09-2019 00:22:00,0,1920.0,1519.0,0.791,9.248,419,195,139,56,224,164,60,38,0.0,0.0
1008,383,24-09-2019 00:24:00,0,3198.0,2511.0,0.785,15.382,105,60,32,28,45,24,21,57,0.0,0.0
1008,384,24-09-2019 00:26:00,0,3556.0,2944.0,0.828,17.27,107,46,20,26,61,37,24,35,0.0,0.0
1008,385,24-09-2019 00:28:00,0,3136.0,2741.0,0.874,15.391,305,160,126,34,145,110,35,108,0.0,0.0
1008,386,24-09-2019 00:30:00,0,3202.0,2504.0,0.782,15.388,150,74,39,35,76,49,27,42,0.0,0.0
1008,387,24-09-2019 00:32:00,0,3134.0,2768.0,0.883,15.414,145,99,68,31,46,31,15,100,0.0,0.0
1008,388,24-09-2019 00:34:00,0,3442.0,2737.0,0.795,16.591,95,54,23,31,41,21,20,34,0.0,0.0
1008,389,24-09-2019 00:36:00,0,3451.0,2716.0,0.787,16.603,237,88,65,23,149,102,47,33,0.0,0.0
1008,390,24-09-2019 00:38:00,0,3577.0,2821.0,0.788,17.217,308,122,83,39,186,140,46,15,0.0,0.01
1008,391,24-09-2019 00:40:00,0,3304.0,2726.0,0.825,16.036,280,109,86,23,171,127,44,8,0.0,0.03
1008,392,24-09-2019 00:42:00,0,3441.0,2748.0,0.799,16.6,236,161,120,41,75,56,19,64,0.0,0.0
1008,393,24-09-2019 00:44:00,0,2587.0,1906.0,0.737,12.302,234,155,111,44,79,51,28,92,0.0,0.0
1008,394,24-09-2019 00:46:00,0,2057.0,1586.0,0.771,9.862,202,108,83,25,94,62,32,89,0.0,0.0
1008,395,24-09-2019 00:48:00,0,2588.0,1902.0,0.735,12.302,42,25,17,8,17,6,11,0,0.0,0.0
1008,396,24-09-2019 00:50:00,0,2306.0,1789.0,0.776,11.069,227,136,95,41,91,73,18,51,0.0,0.0
1008,397,24-09-2019 00:52:00,0,3605.0,2710.0,0.752,17.206,116,88,58,30,28,12,16,77,0.0,0.0
1008,398,24-09-2019 00:54:00,0,3712.0,2884.0,0.7765,17.82,121,101,68,33,20,5,15,76,0.0,0.0
1008,399,24-09-2019 00:56:00,0,3819.0,3058.0,0.801,18.434,74,60,33,27,14,8,6,33,0.0,0.03
1008,400,24-09-2019 00:58:00,0,3302.0,2702.0,0.818,15.999,42,34,17,17,8,3,5,24,0.0,0.0
1008,401,24-09-2019 01:00:00,0,3168.0,2650.0,0.836,15.418,69,56,33,23,13,8,5,33,0.0,0.03
1008,402,24-09-2019 01:02:00,0,3064.0,2433.0,0.794,14.766,309,164,125,39,145,111,34,96,0.0,0.0
1008,403,24-09-2019 01:04:00,0,2934.0,2354.0,0.802,14.165,282,164,126,38,118,87,31,97,0.0,0.02
1008,404,24-09-2019 01:06:00,0,3574.0,2841.0,0.795,17.228,184,112,73,39,72,54,18,101,0.0,0.0
1008,405,24-09-2019 01:08:00,0,3198.0,2530.0,0.791,15.401,160,95,66,29,65,38,27,8,0.0,0.0
1008,406,24-09-2019 01:10:00,0,2836.0,2115.0,0.746,13.515,53,24,9,15,29,16,13,0,0.0,0.0
1008,407,24-09-2019 01:12:00,0,2689.0,2068.0,0.769,12.886,139,48,36,12,91,48,43,5,0.0,0.0
1008,408,24-09-2019 01:14:00,0,3203.0,2537.0,0.792,15.428,242,163,117,46,79,62,17,68,0.0,0.0
1008,409,24-09-2019 01:16:00,0,3607.0,2743.0,0.76,17.247,57,49,26,23,8,0,8,58,0.0,0.0
1008,410,24-09-2019 01:18:00,0,3223.0,2437.0,0.756,15.398,50,43,14,29,7,2,5,54,0.0,0.0
1008,411,24-09-2019 01:20:00,0,3335.0,2624.0,0.787,16.044,87,70,33,37,17,1,16,50,0.0,0.04
1008,412,24-09-2019 01:22:00,0,3222.0,2440.0,0.757,15.397,76,73,35,38,3,0,3,44,0.0,0.02
1008,413,24-09-2019 01:24:00,0,2953.0,2296.0,0.777,14.178,79,70,52,18,9,2,7,42,0.0,0.07
1008,414,24-09-2019 01:26:00,0,3083.0,2338.0,0.758,14.735,138,107,73,34,31,18,13,48,0.0,0.14
1008,415,24-09-2019 01:28:00,0,3006.5,2348.0,0.7815,14.4445,297,188,141,47,109,77,32,71,0.0,0.0
1008,416,24-09-2019 01:30:00,0,2930.0,2358.0,0.805,14.154,254,159,119,40,95,65,30,72,0.0,0.0
1008,417,24-09-2019 01:32:00,0,2176.0,1712.0,0.787,10.47,341,160,111,49,181,133,48,14,0.11,0.0
1008,418,24-09-2019 01:34:00,0,3081.0,2370.0,0.769,14.765,377,192,146,46,185,137,48,14,0.05,0.0
1008,419,24-09-2019 01:36:00,0,3465.0,2699.0,0.779,16.639,295,141,108,33,154,117,37,39,0.21,0.0
1008,420,24-09-2019 01:38:00,0,3189.0,2540.0,0.796,15.375,291,141,100,41,150,113,37,35,0.09,0.0
1008,421,24-09-2019 01:40:00,0,3593.0,2732.0,0.76,17.182,156,49,28,21,107,66,41,2,0.06,0.0
1008,422,24-09-2019 01:42:00,0,3192.0,2531.0,0.793,15.379,190,92,57,35,98,61,37,18,0.05,0.0
1008,423,24-09-2019 01:44:00,0,3178.0,2595.0,0.817,15.394,296,153,118,35,143,104,39,88,0.06,0.0
1008,424,24-09-2019 01:46:00,0,3602.0,2735.0,0.759,17.222,163,64,46,18,99,63,36,0,0.0,0.0
1008,425,24-09-2019 01:48:00,0,2837.0,2120.0,0.747,13.524,170,81,50,31,89,59,30,10,0.23,0.0
1008,426,24-09-2019 01:50:00,0,3203.0,2516.0,0.785,15.404,99,88,46,42,11,8,3,69,0.0,0.0
1008,427,24-09-2019 01:52:00,0,3167.0,2601.0,0.821,15.357,82,72,37,35,10,5,5,66,0.0,0.0
1008,428,24-09-2019 01:54:00,0,3322.0,2632.0,0.792,16.002,76,64,30,34,12,6,6,54,0.0,0.0
1008,429,24-09-2019 01:56:00,0,3179.0,2584.0,0.813,15.386,110,100,60,40,10,8,2,71,0.0,0.03
1008,430,24-09-2019 01:58:00,0,3599.0,2802.0,0.778,17.283,76,57,34,23,19,10,9,39,0.0,0.0
1008,431,24-09-2019 02:00:00,0,3210.0,2435.0,0.759,15.346,92,78,36,42,14,4,10,56,0.0,0.04
1008,432,24-09-2019 02:02:00,0,3019.5,2286.5,0.7575,14.43,166,100,69,31,66,46,20,9,0.26,0.05
1008,433,24-09-2019 02:04:00,0,2829.0,2138.0,0.756,13.514,384,193,154,39,191,152,39,31,0.0,0.0
1008,434,24-09-2019 02:06:00,0,3449.0,2771.0,0.803,16.658,396,219,165,54,177,135,42,46,0.0,0.03
1008,435,24-09-2019 02:08:00,0,2938.0,2324.0,0.791,14.149,526,286,219,67,240,178,62,7,0.01,0.0
1008,436,24-09-2019 02:10:00,0,3328.0,2620.0,0.787,16.014,411,206,164,42,205,151,54,36,0.03,0.0
1008,437,24-09-2019 02:12:00,0,3557.0,2910.0,0.818,17.237,360,196,158,38,164,115,49,10,0.02,0.0
1008,438,24-09-2019 02:14:00,0,3658.0,3086.0,0.844,17.831,270,166,115,51,104,75,29,47,0.01,0.02
1008,439,24-09-2019 02:16:00,0,3548.0,2953.0,0.832,17.246,97,87,44,43,10,4,6,50,0.01,0.02
1008,440,24-09-2019 02:18:00,0,3387.0,2989.0,0.883,16.652,85,84,49,35,1,0,1,33,0.0,0.07
1008,441,24-09-2019 02:20:00,0,3039.0,2526.0,0.831,14.772,73,72,35,37,1,0,1,47,0.0,0.05
1008,442,24-09-2019 02:22:00,0,3437.0,2798.0,0.814,16.64,130,89,53,36,41,26,15,35,0.27,0.08
1008,443,24-09-2019 02:24:00,0,2810.0,2245.0,0.799,13.556,453,253,195,58,200,150,50,16,0.09,0.0
1008,444,24-09-2019 02:26:00,0,2904.0,2456.0,0.846,14.162,95,35,14,21,60,30,30,0,0.0,0.0
1008,445,24-09-2019 02:28:00,0,3912.0,3338.0,0.853,19.109,195,101,73,28,94,55,39,2,0.0,0.0
1008,446,24-09-2019 02:30:00,0,3649.0,3174.0,0.87,17.89,584,307,241,66,277,216,61,9,0.0,0.0
1008,447,24-09-2019 02:32:00,0,3354.0,3032.0,0.904,16.573,718,409,330,79,309,228,81,4,0.0,0.05
1008,448,24-09-2019 02:34:00,0,3666.0,3101.0,0.846,17.877,825,455,363,92,370,277,93,2,0.0,0.0
1008,449,24-09-2019 02:36:00,0,3622.5,2966.0,0.8185,17.557,596,346,291,55,250,197,53,13,0.0,0.0
1008,450,24-09-2019 02:38:00,0,3579.0,2831.0,0.791,17.237,59,59,24,35,0,0,0,43,0.0,0.0
1008,451,24-09-2019 02:40:00,0,3560.0,2872.0,0.807,17.206,140,92,57,35,48,35,13,26,0.0,0.02
1008,452,24-09-2019 02:42:00,0,2438.0,1900.0,0.779,11.709,130,80,55,25,50,32,18,12,0.0,0.0
1008,453,24-09-2019 02:44:00,0,3190.0,2559.0,0.802,15.403,61,35,13,22,26,8,18,0,0.0,0.0
1008,454,24-09-2019 02:46:00,0,3563.0,2884.0,0.809,17.23,25,1,0,1,24,2,22,0,0.0,0.0
1008,455,24-09-2019 02:48:00,0,3577.0,2830.0,0.791,17.228,23,0,0,0,23,0,23,0,0.0,0.0
1008,456,24-09-2019 02:50:00,0,3282.0,2768.0,0.843,15.997,37,0,0,0,37,0,37,0,0.0,0.0
1008,457,24-09-2019 02:52:00,0,3174.0,2605.0,0.821,15.388,51,9,4,5,42,5,37,0,0.0,0.0
1008,458,24-09-2019 02:54:00,0,3190.0,2552.0,0.8,15.395,43,2,0,2,41,1,40,0,0.0,0.0
1008,459,24-09-2019 02:56:00,0,2916.0,2419.0,0.83,14.166,8,0,0,0,8,0,8,0,0.0,0.01
1008,460,24-09-2019 02:58:00,0,2791.0,2256.0,0.808,13.493,4,0,0,0,4,0,4,0,0.0,0.0
1008,461,24-09-2019 03:00:00,0,2550.0,2085.0,0.818,12.356,17,2,0,2,15,2,13,0,0.0,0.0
1008,462,24-09-2019 03:02:00,0,2556.0,2031.0,0.795,12.321,24,7,4,3,17,10,7,0,0.0,0.0
1008,463,24-09-2019 03:04:00,0,2536.0,2086.0,0.823,12.3,18,6,4,2,12,8,4,0,0.0,0.0
1008,464,24-09-2019 03:06:00,0,2543.0,2076.0,0.816,12.318,0,0,0,0,0,0,0,0,0.0,0.0
1008,465,24-09-2019 03:08:00,0,2565.0,2018.0,0.787,12.339,6,1,0,1,5,3,2,0,0.0,0.0
1008,466,24-09-2019 03:10:00,0,2349.5,1942.0,0.8305,11.4065,26,0,0,0,26,15,11,0,0.0,0.0
1008,467,24-09-2019 03:12:00,0,2134.0,1866.0,0.874,10.474,75,34,15,19,41,26,15,0,0.0,0.0
1008,468,24-09-2019 03:14:00,0,2537.0,2074.0,0.817,12.293,150,37,18,19,113,80,33,1,0.1,0.0
1008,469,24-09-2019 03:16:00,0,2543.0,2088.0,0.821,12.329,3,1,0,1,2,2,0,0,0.0,0.0
1008,470,24-09-2019 03:18:00,0,2556.0,2019.0,0.79,12.308,5,2,0,2,3,0,3,0,0.0,0.0
1008,471,24-09-2019 03:20:00,0,2559.0,2000.0,0.781,12.298,4,2,1,1,2,0,2,0,0.0,0.0
1008,472,24-09-2019 03:22:00,0,2561.0,2009.0,0.784,12.315,32,3,1,2,29,12,17,0,0.0,0.0
1008,473,24-09-2019 03:24:00,0,2139.0,1854.0,0.867,10.483,17,8,2,6,9,4,5,0,0.0,0.0
1008,474,24-09-2019 03:26:00,0,2136.0,1873.0,0.877,10.488,15,14,6,8,1,0,1,0,0.0,0.0
1008,475,24-09-2019 03:28:00,0,2126.0,1877.0,0.883,10.453,11,9,3,6,2,1,1,0,0.0,0.0
1008,476,24-09-2019 03:30:00,0,2121.0,1871.0,0.882,10.43,6,5,3,2,1,1,0,0,0.0,0.0
1008,477,24-09-2019 03:32:00,0,2137.0,1871.0,0.875,10.491,6,6,0,6,0,0,0,0,0.0,0.0
1008,478,24-09-2019 03:34:00,0,2161.0,1793.0,0.83,10.5,97,37,17,20,60,40,20,2,0.0,0.0
1008,479,24-09-2019 03:36:00,0,2406.0,1966.0,0.817,11.655,243,142,105,37,101,64,37,16,0.0,0.0
1008,480,24-09-2019 03:38:00,0,2507.0,2197.0,0.876,12.311,229,129,93,36,100,69,31,43,0.0,0.03
1008,481,24-09-2019 03:40:00,0,2555.0,2021.0,0.791,12.304,288,51,37,14,237,158,79,6,0.0,0.01
1008,482,24-09-2019 03:42:00,0,2521.0,2155.0,0.855,12.321,106,18,9,9,88,35,53,1,0.0,0.0
1008,483,24-09-2019 03:44:00,0,2182.0,1975.0,0.9145,10.785,51,0,0,0,51,3,48,0,0.0,0.0
1008,484,24-09-2019 03:46:00,0,1843.0,1795.0,0.974,9.249,44,0,0,0,44,1,43,0,0.0,0.0
1008,485,24-09-2019 03:48:00,0,1848.0,1756.0,0.95,9.225,52,2,0,2,50,2,48,0,0.0,0.0
1008,486,24-09-2019 03:50:00,0,1842.0,1783.0,0.968,9.233,45,2,0,2,43,5,38,0,0.0,0.0
1008,487,24-09-2019 03:52:00,0,1852.0,1771.0,0.956,9.259,49,2,0,2,47,8,39,0,0.0,0.0
1008,488,24-09-2019 03:54:00,0,1871.0,1693.0,0.905,9.244,23,1,0,1,22,4,18,0,0.0,0.0
1008,489,24-09-2019 03:56:00,0,1858.0,1745.0,0.939,9.254,55,0,0,0,55,10,45,0,0.0,0.0
1008,490,24-09-2019 03:58:00,0,1868.0,1690.0,0.905,9.232,173,0,0,0,173,111,62,0,0.0,0.0
1008,491,24-09-2019 04:00:00,0,1866.0,1713.0,0.918,9.25,304,2,1,1,302,243,59,0,0.0,0.0
1008,492,24-09-2019 04:02:00,0,1865.0,1712.0,0.918,9.244,138,6,0,6,132,86,46,0,0.0,0.0
1008,493,24-09-2019 04:04:00,0,1736.0,1617.0,0.931,8.628,110,2,1,1,108,50,58,0,0.0,0.0
1008,494,24-09-2019 04:06:00,0,1585.0,1588.0,1.002,8.005,54,0,0,0,54,6,48,0,0.0,0.0
1008,495,24-09-2019 04:08:00,0,1604.0,1525.0,0.951,8.007,54,4,2,2,50,2,48,0,0.0,0.0
1008,496,24-09-2019 04:10:00,0,1600.0,1545.0,0.966,8.016,55,2,0,2,53,4,49,0,0.0,0.0
1008,497,24-09-2019 04:12:00,0,1595.0,1543.0,0.967,7.993,128,6,1,5,122,86,36,0,0.0,0.0
1008,498,24-09-2019 04:14:00,0,1852.0,1751.0,0.945,9.235,270,19,0,19,251,208,43,0,0.0,0.0
1008,499,24-09-2019 04:16:00,0,2266.0,1973.0,0.871,11.113,197,14,0,14,183,149,34,0,0.0,0.0
1008,500,24-09-2019 04:18:00,0,2191.5,1945.0,0.8885,10.7885,16,0,0,0,16,3,13,0,0.0,0.0
1008,501,24-09-2019 04:20:00,0,2117.0,1917.0,0.906,10.464,12,0,0,0,12,1,11,0,0.0,0.0
1008,502,24-09-2019 04:22:00,0,1981.0,1873.0,0.945,9.88,169,96,70,26,73,55,18,33,0.0,0.0
1008,503,24-09-2019 04:24:00,0,2222.0,2134.0,0.96,11.115,46,37,18,19,9,3,6,54,0.0,0.0
1008,504,24-09-2019 04:26:00,0,2628.0,2304.0,0.876,12.906,39,38,11,27,1,0,1,57,0.0,0.04
1008,505,24-09-2019 04:28:00,0,2608.0,2436.0,0.934,12.974,165,92,58,34,73,52,21,37,0.0,0.07
1008,506,24-09-2019 04:30:00,0,2877.0,2568.0,0.893,14.177,199,86,55,31,113,81,32,56,0.0,0.01
1008,507,24-09-2019 04:32:00,0,2618.0,2365.0,0.903,12.933,412,157,121,36,255,189,66,8,0.04,0.0
1008,508,24-09-2019 04:34:00,0,2880.0,2573.0,0.894,14.196,568,317,255,62,251,197,54,40,0.0,0.0
1008,509,24-09-2019 04:36:00,0,2744.0,2476.0,0.902,13.552,268,142,100,42,126,88,38,13,0.17,0.0
1008,510,24-09-2019 04:38:00,0,2649.0,2269.0,0.857,12.947,383,205,150,55,178,136,42,0,0.0,0.0
1008,511,24-09-2019 04:40:00,0,2854.0,2650.0,0.929,14.179,371,176,126,50,195,144,51,36,0.0,0.07
1008,512,24-09-2019 04:42:00,0,2842.0,2691.0,0.947,14.178,23,1,0,1,22,5,17,0,0.0,0.0
1008,513,24-09-2019 04:44:00,0,2895.0,2503.0,0.865,14.176,30,0,0,0,30,3,27,0,0.0,0.0
1008,514,24-09-2019 04:46:00,0,2630.0,2298.0,0.874,12.905,29,3,1,2,26,4,22,0,0.0,0.0
1008,515,24-09-2019 04:48:00,0,2376.0,2143.0,0.902,11.734,27,0,0,0,27,2,25,0,0.0,0.0
1008,516,24-09-2019 04:50:00,0,2252.0,2008.0,0.892,11.098,28,0,0,0,28,2,26,0,0.0,0.0
1008,517,24-09-2019 04:52:00,0,2259.0,1987.0,0.88,11.102,30,2,0,2,28,1,27,0,0.0,0.0
1008,518,24-09-2019 04:54:00,0,2266.0,1966.0,0.868,11.106,48,8,4,4,40,19,21,0,0.0,0.0
1008,519,24-09-2019 04:56:00,0,1986.0,1837.0,0.925,9.86,55,0,0,0,55,27,28,0,0.0,0.0
1008,520,24-09-2019 04:58:00,0,1993.0,1791.0,0.898,9.836,70,0,0,0,70,35,35,0,0.0,0.0
1008,521,24-09-2019 05:00:00,0,1853.0,1753.0,0.946,9.243,73,14,4,10,59,30,29,0,0.0,0.0
1008,522,24-09-2019 05:02:00,0,1853.0,1776.0,0.958,9.267,14,0,0,0,14,1,13,0,0.0,0.0
1008,523,24-09-2019 05:04:00,0,1855.0,1739.0,0.937,9.235,8,0,0,0,8,0,8,0,0.0,0.0
1008,524,24-09-2019 05:06:00,0,1865.0,1722.0,0.923,9.253,12,1,0,1,11,2,9,0,0.0,0.0
1008,525,24-09-2019 05:08:00,0,1871.0,1687.0,0.902,9.241,10,0,0,0,10,0,10,0,0.0,0.0
1008,526,24-09-2019 05:10:00,0,1877.0,1687.0,0.899,9.264,23,0,0,0,23,6,17,0,0.0,0.0
1008,527,24-09-2019 05:12:00,0,1867.0,1684.0,0.902,9.22,65,28,17,11,37,16,21,3,0.0,0.0
1008,528,24-09-2019 05:14:00,0,2117.0,1924.0,0.909,10.47,39,16,4,12,23,14,9,0,0.0,0.0
1008,529,24-09-2019 05:16:00,0,1981.0,1845.0,0.931,9.846,54,1,1,0,53,13,40,0,0.0,0.0
1008,530,24-09-2019 05:18:00,0,1839.0,1818.0,0.988,9.259,52,0,0,0,52,5,47,0,0.0,0.0
1008,531,24-09-2019 05:20:00,0,1837.0,1802.0,0.981,9.231,64,9,4,5,55,13,42,0,0.0,0.0
1008,532,24-09-2019 05:22:00,0,2123.0,1894.0,0.892,10.461,28,2,1,1,26,2,24,0,0.0,0.0
1008,533,24-09-2019 05:24:00,0,2128.0,1872.0,0.879,10.459,40,0,0,0,40,4,36,0,0.0,0.0
1008,534,24-09-2019 05:26:00,0,2192.5,1923.5,0.877,10.7695,65,13,2,11,52,20,32,0,0.0,0.0
1008,535,24-09-2019 05:28:00,0,2257.0,1975.0,0.875,11.08,151,76,37,39,75,39,36,0,0.0,0.0
1008,536,24-09-2019 05:30:00,0,2512.0,2174.0,0.866,12.305,69,32,10,22,37,14,23,0,0.0,0.0
1008,537,24-09-2019 05:32:00,0,2631.0,2314.0,0.879,12.929,166,40,5,35,126,89,37,0,0.0,0.0
1008,538,24-09-2019 05:34:00,0,2634.0,2313.0,0.878,12.94,71,50,19,31,21,7,14,0,0.0,0.0
1008,539,24-09-2019 05:36:00,0,2620.0,2358.0,0.9,12.933,300,135,93,42,165,113,52,30,0.0,0.0
1008,540,24-09-2019 05:38:00,0,2884.0,2559.0,0.887,14.196,215,150,106,44,65,49,16,73,0.0,0.0
1008,541,24-09-2019 05:40:00,0,2859.0,2633.0,0.921,14.178,37,33,5,28,4,1,3,60,0.0,0.0
1008,542,24-09-2019 05:42:00,0,3278.0,2761.0,0.842,15.973,48,45,17,28,3,0,3,50,0.0,0.03
1008,543,24-09-2019 05:44:00,0,3275.0,2833.0,0.865,16.04,46,41,22,19,5,0,5,63,0.0,0.08
1008,544,24-09-2019 05:46:00,0,3260.0,2877.0,0.883,16.029,24,23,9,14,1,0,1,20,0.0,0.27
1008,545,24-09-2019 05:48:00,0,2861.0,2591.0,0.906,14.141,24,24,0,24,0,0,0,0,0.0,0.0
1008,546,24-09-2019 05:50:00,0,2996.0,2705.0,0.903,14.801,151,74,55,19,77,62,15,7,0.0,0.01
1008,547,24-09-2019 05:52:00,0,2888.0,2513.0,0.87,14.161,234,105,70,35,129,91,38,24,0.15,0.02
1008,548,24-09-2019 05:54:00,0,3250.0,2867.0,0.882,15.98,267,131,97,34,136,101,35,43,0.05,0.0
1008,549,24-09-2019 05:56:00,0,3249.0,2905.0,0.894,16.017,269,144,110,34,125,91,34,16,0.0,0.0
1008,550,24-09-2019 05:58:00,0,2882.0,2529.0,0.878,14.154,16,10,2,8,6,4,2,0,0.0,0.0
1008,551,24-09-2019 06:00:00,1,3060.0,2746.5,0.8965,15.0965,265,149,116,33,116,86,30,18,0.0,0.0
1008,552,24-09-2019 06:02:00,1,3238.0,2964.0,0.915,16.039,292,190,151,39,102,76,26,131,0.0,0.0
1008,553,24-09-2019 06:04:00,1,3504.0,3105.0,0.886,17.245,245,127,101,26,118,91,27,56,0.0,0.0
1008,554,24-09-2019 06:06:00,1,2901.0,2486.0,0.857,14.184,156,116,84,32,40,27,13,83,0.0,0.0
1008,555,24-09-2019 06:08:00,1,3384.0,2971.0,0.878,16.624,305,153,113,40,152,107,45,41,0.11,0.01
1008,556,24-09-2019 06:10:00,1,3264.0,2877.0,0.882,16.043,205,98,64,34,107,69,38,53,0.03,0.0
1008,557,24-09-2019 06:12:00,1,3260.0,2838.0,0.871,15.984,23,19,2,17,4,1,3,71,0.0,0.0
1008,558,24-09-2019 06:14:00,1,3239.0,2970.0,0.917,16.049,47,45,14,31,2,0,2,58,0.0,0.0
1008,559,24-09-2019 06:16:00,1,3003.0,2657.0,0.885,14.773,30,29,12,17,1,0,1,42,0.0,0.0
1008,560,24-09-2019 06:18:00,1,3273.0,2843.0,0.869,16.042,81,69,36,33,12,3,9,27,0.0,0.05
1008,561,24-09-2019 06:20:00,1,3295.0,2717.0,0.825,15.992,227,94,62,32,133,99,34,10,0.11,0.0
1008,562,24-09-2019 06:22:00,1,2878.0,2564.0,0.891,14.178,149,66,21,45,83,50,33,0,0.0,0.0
1008,563,24-09-2019 06:24:00,1,3303.0,2699.0,0.817,16.001,120,45,20,25,75,33,42,0,0.0,0.0
1008,564,24-09-2019 06:26:00,1,2648.0,2237.0,0.845,12.909,89,41,22,19,48,21,27,0,0.0,0.0
1008,565,24-09-2019 06:28:00,1,3282.0,2758.0,0.84,15.985,177,67,38,29,110,65,45,5,0.0,0.08
1008,566,24-09-2019 06:30:00,1,3545.0,2919.0,0.823,17.201,191,130,87,43,61,34,27,29,0.0,0.0
1008,567,24-09-2019 06:32:00,1,3552.0,2965.0,0.835,17.279,218,130,89,41,88,58,30,24,0.0,0.0
1008,568,24-09-2019 06:34:00,1,3557.0,2944.5,0.828,17.2745,251,133,85,48,118,88,30,15,0.0,0.0
1008,569,24-09-2019 06:36:00,1,3562.0,2924.0,0.821,17.27,241,90,58,32,151,103,48,4,0.0,0.0
1008,570,24-09-2019 06:38:00,1,3443.0,2793.0,0.811,16.658,155,31,3,28,124,76,48,0,0.0,0.0
1008,571,24-09-2019 06:40:00,1,3340.0,2529.0,0.757,15.961,173,0,0,0,173,119,54,0,0.0,0.0
1008,572,24-09-2019 06:42:00,1,2969.0,2226.0,0.75,14.162,77,9,5,4,68,28,40,0,0.0,0.0
1008,573,24-09-2019 06:44:00,1,2701.0,2057.0,0.762,12.922,27,2,0,2,25,0,25,0,0.0,0.0
1008,574,24-09-2019 06:46:00,1,2727.0,1982.0,0.727,12.937,18,0,0,0,18,3,15,0,0.0,0.0
1008,575,24-09-2019 06:48:00,1,2717.0,1970.0,0.725,12.885,3,0,0,0,3,0,3,0,0.0,0.0
1008,576,24-09-2019 06:50:00,1,2736.0,1933.0,0.706,12.919,154,45,20,25,109,73,36,1,0.0,0.0
1008,577,24-09-2019 06:52:00,1,2694.0,2097.0,0.778,12.938,96,40,24,16,56,31,25,7,0.0,0.0
1008,578,24-09-2019 06:54:00,1,2958.0,2241.0,0.758,14.138,239,135,87,48,104,76,28,23,0.0,0.0
1008,579,24-09-2019 06:56:00,1,2937.0,2341.0,0.797,14.164,208,108,73,35,100,62,38,79,0.0,0.0
1008,580,24-09-2019 06:58:00,1,2984.0,2159.0,0.723,14.149,128,89,60,29,39,30,9,44,0.0,0.0
1008,581,24-09-2019 07:00:00,1,2922.0,2386.0,0.816,14.155,124,82,41,41,42,23,19,15,0.0,0.0
1008,582,24-09-2019 07:02:00,1,2937.0,2353.0,0.801,14.178,46,40,14,26,6,0,6,65,0.0,0.0
1008,583,24-09-2019 07:04:00,1,3357.0,2476.0,0.738,15.968,57,50,15,35,7,0,7,64,0.0,0.0
1008,584,24-09-2019 07:06:00,1,3358.0,2522.0,0.751,16.021,62,57,23,34,5,0,5,63,0.0,0.0
1008,585,24-09-2019 07:08:00,1,2796.5,2292.0,0.8365,13.5545,250,181,132,49,69,47,22,72,0.0,0.0
1008,586,24-09-2019 07:10:00,1,2235.0,2062.0,0.922,11.088,372,208,154,54,164,113,51,44,0.02,0.0
1008,587,24-09-2019 07:12:00,1,2912.0,2422.0,0.832,14.153,444,219,169,50,225,169,56,1,0.0,0.0
1008,588,24-09-2019 07:14:00,1,3008.0,2660.0,0.884,14.796,329,182,134,48,147,95,52,4,0.0,0.0
1008,589,24-09-2019 07:16:00,1,2901.0,2495.0,0.86,14.194,82,38,0,38,44,15,29,0,0.0,0.0
1008,590,24-09-2019 07:18:00,1,2490.0,2265.0,0.91,12.317,65,12,6,6,53,36,17,0,0.0,0.0
1008,591,24-09-2019 07:20:00,1,2540.0,2062.0,0.812,12.29,5,0,0,0,5,0,5,0,0.0,0.0
1008,592,24-09-2019 07:22:00,1,2275.0,1913.0,0.841,11.084,14,3,1,2,11,1,10,0,0.0,0.0
1008,593,24-09-2019 07:24:00,1,2261.0,1958.0,0.866,11.074,6,0,0,0,6,3,3,0,0.0,0.0
1008,594,24-09-2019 07:26:00,1,2265.0,1949.0,0.861,11.081,95,9,3,6,86,36,50,0,0.0,0.0
1008,595,24-09-2019 07:28:00,1,2137.0,1861.0,0.871,10.481,22,0,0,0,22,8,14,0,0.0,0.0
1008,596,24-09-2019 07:30:00,1,1996.0,1798.0,0.901,9.856,4,0,0,0,4,1,3,0,0.0,0.0
1008,597,24-09-2019 07:32:00,1,1847.0,1777.0,0.962,9.244,5,0,0,0,5,1,4,0,0.0,0.0
1008,598,24-09-2019 07:34:00,1,1862.0,1725.0,0.926,9.247,11,0,0,0,11,3,8,0,0.0,0.0
1008,599,24-09-2019 07:36:00,1,1864.0,1726.0,0.926,9.254,43,9,4,5,34,15,19,0,0.0,0.0
1008,600,24-09-2019 07:38:00,1,1833.0,1822.0,0.994,9.241,18,0,0,0,18,4,14,0,0.0,0.0
1008,601,24-09-2019 07:40:00,1,1856.0,1729.0,0.931,9.229,21,1,1,0,20,5,15,0,0.0,0.0
1008,602,24-09-2019 07:42:00,1,2015.5,1721.5,0.8595,9.848,24,2,0,2,22,10,12,0,0.0,0.0
1008,603,24-09-2019 07:44:00,1,2175.0,1714.0,0.788,10.467,0,0,0,0,0,0,0,0,0.0,0.0
1008,604,24-09-2019 07:46:00,1,2321.0,1731.0,0.746,11.062,5,4,0,4,1,0,1,0,0.0,0.0
1008,605,24-09-2019 07:48:00,1,2318.0,1779.0,0.767,11.103,3,2,0,2,1,0,1,0,0.0,0.0
1008,606,24-09-2019 07:50:00,1,2021.0,1699.0,0.84,9.843,33,19,8,11,14,7,7,0,0.0,0.0
1008,607,24-09-2019 07:52:00,1,2166.0,1739.0,0.803,10.459,22,12,7,5,10,6,4,0,0.0,0.0
1008,608,24-09-2019 07:54:00,1,2166.0,1738.0,0.802,10.461,0,0,0,0,0,0,0,0,0.0,0.0
1008,609,24-09-2019 07:56:00,1,2163.0,1738.0,0.803,10.449,0,0,0,0,0,0,0,0,0.0,0.0
1008,610,24-09-2019 07:58:00,1,2173.0,1738.0,0.8,10.485,24,15,6,9,9,4,5,0,0.0,0.0
1008,611,24-09-2019 08:00:00,1,2306.0,1769.0,0.767,11.044,157,47,23,24,110,68,42,0,0.0,0.0
1008,612,24-09-2019 08:02:00,1,2287.0,1869.0,0.817,11.082,84,10,0,10,74,38,36,0,0.0,0.0
1008,613,24-09-2019 08:04:00,1,2304.0,1798.0,0.78,11.067,52,0,0,0,52,24,28,0,0.0,0.0
1008,614,24-09-2019 08:06:00,1,2158.0,1765.0,0.818,10.457,94,0,0,0,94,68,26,0,0.0,0.0
1008,615,24-09-2019 08:08:00,1,2025.0,1691.0,0.835,9.853,104,9,5,4,95,57,38,0,0.0,0.0
1008,616,24-09-2019 08:10:00,1,2016.0,1731.0,0.859,9.859,51,35,11,24,16,10,6,17,0.0,0.0
1008,617,24-09-2019 08:12:00,1,2402.0,2016.0,0.839,11.697,267,142,110,32,125,91,34,80,0.0,0.0
1008,618,24-09-2019 08:14:00,1,2263.0,1969.0,0.87,11.097,151,85,57,28,66,48,18,57,0.0,0.0
1008,619,24-09-2019 08:16:00,1,2409.5,1993.0,0.8295,11.701,314,165,136,29,149,105,44,0,0.0,0.0
1008,620,24-09-2019 08:18:00,1,2556.0,2017.0,0.789,12.305,309,162,120,42,147,112,35,14,0.0,0.0
1008,621,24-09-2019 08:20:00,1,2671.0,2165.0,0.811,12.92,88,81,54,27,7,1,6,7,0.0,0.0
1008,622,24-09-2019 08:22:00,1,2924.0,2337.0,0.799,14.108,162,106,75,31,56,36,20,8,0.0,0.05
1008,623,24-09-2019 08:24:00,1,2683.0,2148.0,0.801,12.948,106,65,46,19,41,32,9,14,0.0,0.0
1008,624,24-09-2019 08:26:00,1,2664.0,2225.0,0.835,12.959,607,351,288,63,256,190,66,9,0.0,0.0
1008,625,24-09-2019 08:28:00,1,2795.0,2299.0,0.823,13.556,348,186,144,42,162,117,45,10,0.0,0.0
1008,626,24-09-2019 08:30:00,1,2945.0,2298.0,0.78,14.147,370,176,131,45,194,151,43,0,0.0,0.05
1008,627,24-09-2019 08:32:00,1,2680.0,2141.0,0.799,12.928,395,220,163,57,175,125,50,8,0.0,0.0
1008,628,24-09-2019 08:34:00,1,2699.0,2102.0,0.779,12.96,581,261,201,60,320,241,79,7,0.0,0.0
1008,629,24-09-2019 08:36:00,1,2707.0,2022.0,0.747,12.904,302,130,92,38,172,122,50,0,0.0,0.0
1008,630,24-09-2019 08:38:00,1,2697.0,2056.0,0.762,12.901,431,205,150,55,226,167,59,39,0.0,0.0
1008,631,24-09-2019 08:40:00,1,2665.0,2164.0,0.812,12.897,304,65,33,32,239,173,66,5,0.0,0.0
1008,632,24-09-2019 08:42:00,1,2799.0,2285.0,0.817,13.558,238,115,72,43,123,79,44,31,0.0,0.0
1008,633,24-09-2019 08:44:00,1,2799.0,2240.0,0.8,13.51,156,93,54,39,63,32,31,2,0.0,0.0
1008,634,24-09-2019 08:46:00,1,2678.0,2189.0,0.818,12.974,112,14,1,13,98,74,24,0,0.0,0.0
1008,635,24-09-2019 08:48:00,1,2723.0,1971.0,0.724,12.912,115,0,0,0,115,66,49,0,0.0,0.0
1008,636,24-09-2019 08:50:00,1,2532.0,1825.5,0.721,11.998,120,0,0,0,120,69,51,0,0.0,0.0
1008,637,24-09-2019 08:52:00,1,2341.0,1680.0,0.718,11.084,46,3,1,2,43,29,14,0,0.0,0.0
1008,638,24-09-2019 08:54:00,1,2338.0,1675.0,0.716,11.067,8,0,0,0,8,0,8,0,0.0,0.0
1008,639,24-09-2019 08:56:00,1,2342.0,1672.0,0.714,11.079,15,2,2,0,13,3,10,0,0.0,0.0
1008,640,24-09-2019 08:58:00,1,2312.0,1746.0,0.755,11.043,32,0,0,0,32,15,17,0,0.0,0.0
1008,641,24-09-2019 09:00:00,1,2329.0,1723.0,0.74,11.084,10,0,0,0,10,3,7,0,0.0,0.0
1008,642,24-09-2019 09:02:00,1,2043.0,1645.0,0.805,9.87,11,0,0,0,11,6,5,0,0.0,0.0
1008,643,24-09-2019 09:04:00,1,1903.0,1571.0,0.826,9.237,18,2,0,2,16,6,10,0,0.0,0.0
1008,644,24-09-2019 09:06:00,1,1898.0,1567.0,0.826,9.214,5,2,0,2,3,2,1,0,0.0,0.0
1008,645,24-09-2019 09:08:00,1,1909.0,1567.0,0.821,9.255,14,0,0,0,14,3,11,0,0.0,0.0
1008,646,24-09-2019 09:10:00,1,2187.0,1629.0,0.745,10.42,11,2,0,2,9,1,8,0,0.0,0.0
1008,647,24-09-2019 09:12:00,1,2205.0,1605.0,0.728,10.466,16,7,2,5,9,2,7,0,0.0,0.0
1008,648,24-09-2019 09:14:00,1,2199.0,1642.0,0.747,10.482,20,14,0,14,6,1,5,0,0.0,0.0
1008,649,24-09-2019 09:16:00,1,2043.0,1603.0,0.785,9.825,21,13,6,7,8,1,7,0,0.0,0.0
1008,650,24-09-2019 09:18:00,1,2198.0,1628.0,0.741,10.462,12,3,0,3,9,2,7,0,0.0,0.0
1008,651,24-09-2019 09:20:00,1,2191.0,1631.0,0.745,10.439,12,0,0,0,12,1,11,0,0.0,0.0
1008,652,24-09-2019 09:22:00,1,2044.0,1617.0,0.791,9.843,12,0,0,0,12,0,12,0,0.0,0.0
1008,653,24-09-2019 09:24:00,1,2048.0,1608.5,0.7855,9.8495,31,0,0,0,31,17,14,0,0.0,0.0
1008,654,24-09-2019 09:26:00,1,2052.0,1600.0,0.78,9.856,100,21,13,8,79,34,45,0,0.0,0.0
1008,655,24-09-2019 09:28:00,1,2319.0,1744.0,0.752,11.07,78,39,15,24,39,22,17,0,0.0,0.0
1008,656,24-09-2019 09:30:00,1,2297.0,1818.0,0.791,11.065,126,82,55,27,44,26,18,43,0.0,0.0
1008,657,24-09-2019 09:32:00,1,2582.0,1927.0,0.746,12.308,177,84,51,33,93,64,29,29,0.0,0.0
1008,658,24-09-2019 09:34:00,1,2594.0,1892.0,0.729,12.315,68,26,4,22,42,25,17,0,0.0,0.0
1008,659,24-09-2019 09:36:00,1,2316.0,1743.0,0.753,11.055,73,29,13,16,44,29,15,0,0.0,0.0
1008,660,24-09-2019 09:38:00,1,2590.0,1888.0,0.729,12.298,46,0,0,0,46,16,30,0,0.0,0.0
1008,661,24-09-2019 09:40:00,1,2303.0,1827.0,0.793,11.098,9,0,0,0,9,3,6,0,0.0,0.0
1008,662,24-09-2019 09:42:00,1,2324.0,1756.0,0.756,11.099,16,7,1,6,9,0,9,0,0.0,0.0
1008,663,24-09-2019 09:44:00,1,2329.0,1697.0,0.728,11.055,19,17,0,17,2,0,2,0,0.0,0.0
1008,664,24-09-2019 09:46:00,1,2345.0,1656.0,0.706,11.072,31,20,0,20,11,0,11,0,0.0,0.0
1008,665,24-09-2019 09:48:00,1,2357.0,1617.0,0.686,11.077,184,64,41,23,120,82,38,0,0.0,0.0
1008,666,24-09-2019 09:50:00,1,2321.0,1741.0,0.75,11.071,135,11,3,8,124,67,57,0,0.0,0.0
1008,667,24-09-2019 09:52:00,1,2334.0,1706.0,0.731,11.083,71,0,0,0,71,23,48,0,0.0,0.0
1008,668,24-09-2019 09:54:00,1,2330.0,1677.0,0.72,11.036,175,0,0,0,175,103,72,0,0.0,0.0
1008,669,24-09-2019 09:56:00,1,2346.0,1648.0,0.703,11.067,97,0,0,0,97,38,59,0,0.0,0.0
1008,670,24-09-2019 09:58:00,1,2278.0,1614.0,0.709,10.762,69,0,0,0,69,21,48,0,0.0,0.0
1008,671,24-09-2019 10:00:00,1,2210.0,1580.0,0.715,10.457,110,7,5,2,103,48,55,0,0.0,0.0
1008,672,24-09-2019 10:02:00,1,2360.0,1587.0,0.673,11.056,59,21,0,21,38,16,22,0,0.0,0.0
1008,673,24-09-2019 10:04:00,1,2319.0,1741.0,0.75,11.065,18,4,1,3,14,6,8,0,0.0,0.0
1008,674,24-09-2019 10:06:00,1,2323.0,1735.0,0.747,11.076,1,0,0,0,1,0,1,0,0.0,0.0
1008,675,24-09-2019 10:08:00,1,2345.0,1641.0,0.7,11.057,22,4,1,3,18,11,7,0,0.0,0.0
1008,676,24-09-2019 10:10:00,1,2226.0,1524.0,0.685,10.459,3,1,0,1,2,0,2,0,0.0,0.0
1008,677,24-09-2019 10:12:00,1,2226.0,1524.0,0.685,10.46,12,2,0,2,10,4,6,0,0.0,0.0
1008,678,24-09-2019 10:14:00,1,2076.0,1505.0,0.725,9.847,45,0,0,0,45,0,45,0,0.0,0.0
1008,679,24-09-2019 10:16:00,1,2221.0,1530.0,0.689,10.444,43,1,0,1,42,4,38,0,0.0,0.0
1008,680,24-09-2019 10:18:00,1,2350.0,1614.0,0.687,11.048,141,17,8,9,124,64,60,0,0.0,0.0
1008,681,24-09-2019 10:20:00,1,2312.0,1763.0,0.762,11.062,153,1,0,1,152,95,57,0,0.0,0.0
1008,682,24-09-2019 10:22:00,1,2333.0,1708.0,0.732,11.083,304,0,0,0,304,260,44,0,0.0,0.0
1008,683,24-09-2019 10:24:00,1,2337.0,1675.0,0.717,11.065,144,0,0,0,144,96,48,0,0.0,0.0
1008,684,24-09-2019 10:26:00,1,2334.0,1675.0,0.718,11.052,26,1,0,1,25,14,11,0,0.0,0.0
1008,685,24-09-2019 10:28:00,1,2353.0,1606.0,0.683,11.048,204,0,0,0,204,169,35,0,0.0,0.0
1008,686,24-09-2019 10:30:00,1,2222.0,1537.0,0.691,10.457,50,0,0,0,50,10,40,0,0.0,0.0
1008,687,24-09-2019 10:32:00,1,2004.0,1486.0,0.747,9.5415,64,2,1,1,62,15,47,0,0.0,0.0
1008,688,24-09-2019 10:34:00,1,1786.0,1435.0,0.803,8.626,79,5,3,2,74,26,48,0,0.01,0.0
1008,689,24-09-2019 10:36:00,1,1935.0,1447.0,0.748,9.225,61,13,8,5,48,24,24,0,0.0,0.0
1008,690,24-09-2019 10:38:00,1,1817.0,1324.0,0.729,8.626,49,0,0,0,49,22,27,0,0.0,0.0
1008,691,24-09-2019 10:40:00,1,1807.0,1333.0,0.737,8.596,55,0,0,0,55,24,31,0,0.0,0.0
1008,692,24-09-2019 10:42:00,1,1806.0,1345.0,0.745,8.604,67,0,0,0,67,23,44,0,0.0,0.0
1008,693,24-09-2019 10:44:00,1,1803.0,1381.0,0.766,8.632,93,6,4,2,87,42,45,0,0.0,0.0
1008,694,24-09-2019 10:46:00,1,1938.0,1429.0,0.737,9.218,72,0,0,0,72,25,47,0,0.0,0.0
1008,695,24-09-2019 10:48:00,1,2081.0,1479.0,0.711,9.837,38,1,1,0,37,2,35,0,0.0,0.0
1008,696,24-09-2019 10:50:00,1,1800.0,1369.0,0.76,8.61,142,38,27,11,104,63,41,13,0.0,0.0
1008,697,24-09-2019 10:52:00,1,1934.0,1447.0,0.748,9.224,201,100,65,35,101,63,38,26,0.0,0.0
1008,698,24-09-2019 10:54:00,1,2209.0,1585.0,0.718,10.458,173,88,63,25,85,69,16,33,0.0,0.0
1008,699,24-09-2019 10:56:00,1,2212.0,1567.0,0.709,10.451,67,27,6,21,40,14,26,0,0.0,0.0
1008,700,24-09-2019 10:58:00,1,2081.0,1478.0,0.71,9.837,93,47,26,21,46,21,25,0,0.0,0.0
1008,701,24-09-2019 11:00:00,1,2197.0,1618.0,0.737,10.446,30,18,0,18,12,7,5,0,0.0,0.0
1008,702,24-09-2019 11:02:00,1,2194.0,1628.0,0.742,10.449,50,18,8,10,32,15,17,0,0.0,0.0
1008,703,24-09-2019 11:04:00,1,2486.0,1719.0,0.692,11.699,42,12,2,10,30,9,21,0,0.0,0.0
1008,704,24-09-2019 11:06:00,1,2545.0,1781.0,0.7,12.0,257,103,71,32,154,112,42,0,0.0,0.0
1008,705,24-09-2019 11:08:00,1,2604.0,1843.0,0.708,12.301,578,237,183,54,341,274,67,2,0.0,0.0
1008,706,24-09-2019 11:10:00,1,2583.0,1906.0,0.738,12.289,253,142,112,30,111,81,30,2,0.0,0.0
1008,707,24-09-2019 11:12:00,1,2617.0,1806.0,0.69,12.31,380,216,173,43,164,122,42,2,0.0,0.0
1008,708,24-09-2019 11:14:00,1,2602.0,1824.0,0.701,12.273,290,129,91,38,161,112,49,10,0.02,0.0
1008,709,24-09-2019 11:16:00,1,2613.0,1811.0,0.693,12.302,276,165,126,39,111,75,36,0,0.0,0.0
1008,710,24-09-2019 11:18:00,1,2613.0,1813.0,0.694,12.304,700,377,311,66,323,245,78,9,0.0,0.0
1008,711,24-09-2019 11:20:00,1,2621.0,1786.0,0.681,12.306,449,261,210,51,188,142,46,10,0.0,0.0
1008,712,24-09-2019 11:22:00,1,2603.0,1850.0,0.711,12.303,477,217,158,59,260,187,73,4,0.0,0.0
1008,713,24-09-2019 11:24:00,1,2621.0,1775.0,0.677,12.291,525,304,237,67,221,176,45,2,0.0,0.0
1008,714,24-09-2019 11:26:00,1,2623.0,1769.0,0.674,12.295,114,22,12,10,92,45,47,0,0.0,0.0
1008,715,24-09-2019 11:28:00,1,2502.0,1625.0,0.649,11.656,56,10,1,9,46,26,20,0,0.0,0.0
1008,716,24-09-2019 11:30:00,1,2658.0,1643.0,0.618,12.294,1,0,0,0,1,0,1,0,0.0,0.0
1008,717,24-09-2019 11:32:00,1,2504.0,1617.0,0.646,11.658,3,1,0,1,2,1,1,0,0.0,0.0
1008,718,24-09-2019 11:34:00,1,2368.0,1580.0,0.667,11.081,0,0,0,0,0,0,0,0,0.0,0.0
1008,719,24-09-2019 11:36:00,1,2228.0,1518.0,0.681,10.459,17,0,0,0,17,6,11,0,0.0,0.0
1008,720,24-09-2019 11:38:00,1,2229.0,1501.0,0.673,10.446,31,1,0,1,30,4,26,0,0.0,0.0
1008,721,24-09-2019 11:40:00,1,2166.0,1444.5,0.6665,10.135,55,0,0,0,55,12,43,0,0.0,0.0
1008,722,24-09-2019 11:42:00,1,2103.0,1388.0,0.66,9.824,78,6,4,2,72,25,47,0,0.0,0.0
1008,723,24-09-2019 11:44:00,1,2096.0,1441.0,0.688,9.852,44,0,0,0,44,12,32,0,0.0,0.0
1008,724,24-09-2019 11:46:00,1,2102.0,1400.0,0.666,9.832,308,0,0,0,308,257,51,0,0.0,0.0
1008,725,24-09-2019 11:48:00,1,2105.0,1411.0,0.67,9.857,319,0,0,0,319,267,52,0,0.0,0.0
1008,726,24-09-2019 11:50:00,1,2099.0,1399.0,0.667,9.818,40,0,0,0,40,5,35,0,0.0,0.0
1008,727,24-09-2019 11:52:00,1,2095.0,1412.0,0.674,9.818,38,0,0,0,38,0,38,0,0.0,0.0
1008,728,24-09-2019 11:54:00,1,2106.0,1394.0,0.662,9.843,47,0,0,0,47,2,45,0,0.0,0.0
1008,729,24-09-2019 11:56:00,1,2101.0,1376.0,0.655,9.801,33,0,0,0,33,0,33,0,0.0,0.0
1008,730,24-09-2019 11:58:00,1,2108.0,1357.0,0.644,9.81,59,11,3,8,48,9,39,0,0.0,0.0
1008,731,24-09-2019 12:00:00,1,2106.0,1382.0,0.656,9.829,10,1,1,0,9,6,3,0,0.0,0.0
1008,732,24-09-2019 12:02:00,1,2074.0,1526.0,0.736,9.861,6,3,1,2,3,0,3,0,0.0,0.0
1008,733,24-09-2019 12:04:00,1,2204.0,1564.0,0.71,10.416,0,0,0,0,0,0,0,0,0.0,0.0
1008,734,24-09-2019 12:06:00,1,2214.0,1559.0,0.704,10.448,12,7,2,5,5,3,2,0,0.0,0.0
1008,735,24-09-2019 12:08:00,1,2074.0,1501.0,0.724,9.832,27,9,2,7,18,5,13,0,0.0,0.0
1008,736,24-09-2019 12:10:00,1,2070.0,1521.0,0.735,9.839,15,4,3,1,11,7,4,0,0.0,0.0
1008,737,24-09-2019 12:12:00,1,2088.0,1460.0,0.699,9.844,10,9,1,8,1,0,1,0,0.0,0.0
1008,738,24-09-2019 12:14:00,1,2100.5,1406.5,0.6695,9.833,0,0,0,0,0,0,0,0,0.0,0.0
1008,739,24-09-2019 12:16:00,1,2113.0,1353.0,0.64,9.822,49,19,13,6,30,13,17,0,0.0,0.0
1008,740,24-09-2019 12:18:00,1,2098.0,1403.0,0.669,9.819,29,2,0,2,27,4,23,0,0.0,0.0
1008,741,24-09-2019 12:20:00,1,2106.0,1377.0,0.654,9.823,48,5,0,5,43,2,41,0,0.0,0.0
1008,742,24-09-2019 12:22:00,1,2111.0,1372.0,0.65,9.835,40,3,2,1,37,10,27,0,0.0,0.0
1008,743,24-09-2019 12:24:00,1,2111.0,1382.0,0.655,9.849,10,0,0,0,10,0,10,0,0.0,0.0
1008,744,24-09-2019 12:26:00,1,2105.0,1362.0,0.647,9.802,6,0,0,0,6,0,6,0,0.0,0.0
1008,745,24-09-2019 12:28:00,1,2116.0,1350.0,0.638,9.834,15,4,1,3,11,3,8,0,0.0,0.0
1008,746,24-09-2019 12:30:00,1,1970.0,1335.0,0.678,9.24,19,2,0,2,17,1,16,0,0.0,0.0
1008,747,24-09-2019 12:32:00,1,1821.0,1291.0,0.709,8.605,11,2,0,2,9,1,8,0,0.0,0.0
1008,748,24-09-2019 12:34:00,1,1677.0,1249.0,0.745,7.99,9,9,0,9,0,0,0,0,0.0,0.0
1008,749,24-09-2019 12:36:00,1,1687.0,1216.0,0.721,7.993,14,10,0,10,4,1,3,0,0.0,0.0
1008,750,24-09-2019 12:38:00,1,1694.0,1191.0,0.703,7.994,2,1,0,1,1,0,1,0,0.0,0.0
1008,751,24-09-2019 12:40:00,1,1709.0,1138.0,0.666,7.994,19,5,2,3,14,4,10,0,0.0,0.0
1008,752,24-09-2019 12:42:00,1,1700.0,1162.0,0.683,7.983,91,12,6,6,79,39,40,0,0.0,0.0
1008,753,24-09-2019 12:44:00,1,2106.0,1401.0,0.665,9.85,41,1,0,1,40,2,38,0,0.0,0.0
1008,754,24-09-2019 12:46:00,1,2086.0,1466.0,0.703,9.842,14,1,0,1,13,2,11,0,0.0,0.0
1008,755,24-09-2019 12:48:00,1,2001.5,1490.0,0.7465,9.535,0,0,0,0,0,0,0,0,0.0,0.0
1008,756,24-09-2019 12:50:00,1,1917.0,1514.0,0.79,9.228,9,2,0,2,7,4,3,0,0.0,0.0
1008,757,24-09-2019 12:52:00,1,1929.0,1460.0,0.757,9.216,4,1,1,0,3,2,1,0,0.0,0.0
1008,758,24-09-2019 12:54:00,1,1938.0,1428.0,0.737,9.217,22,3,1,2,19,7,12,0,0.0,0.0
1008,759,24-09-2019 12:56:00,1,1941.0,1431.0,0.737,9.234,64,8,0,8,56,15,41,0,0.0,0.0
1008,760,24-09-2019 12:58:00,1,1964.0,1333.0,0.679,9.217,57,10,0,10,47,0,47,0,0.0,0.0
1008,761,24-09-2019 13:00:00,1,1672.0,1265.0,0.757,7.989,30,0,0,0,30,0,30,0,0.0,0.0
1008,762,24-09-2019 13:02:00,1,1683.0,1230.0,0.731,7.995,55,20,8,12,35,14,21,0,0.0,0.0
1008,763,24-09-2019 13:04:00,1,1522.0,1263.0,0.83,7.395,19,6,3,3,13,7,6,0,0.0,0.0
1008,764,24-09-2019 13:06:00,1,1816.0,1311.0,0.722,8.606,2,0,0,0,2,1,1,0,0.0,0.0
1008,765,24-09-2019 13:08:00,1,1672.0,1265.0,0.757,7.991,0,0,0,0,0,0,0,0,0.0,0.0
1008,766,24-09-2019 13:10:00,1,1675.0,1250.0,0.747,7.983,0,0,0,0,0,0,0,0,0.0,0.0
1008,767,24-09-2019 13:12:00,1,1674.0,1250.0,0.747,7.978,1,0,0,0,1,1,0,0,0.0,0.0
1008,768,24-09-2019 13:14:00,1,1683.0,1224.0,0.727,7.987,3,0,0,0,3,1,2,0,0.0,0.0
1008,769,24-09-2019 13:16:00,1,1676.0,1247.0,0.744,7.985,1,0,0,0,1,0,1,0,0.0,0.0
1008,770,24-09-2019 13:18:00,1,1966.0,1324.0,0.673,9.214,0,0,0,0,0,0,0,0,0.0,0.0
1008,771,24-09-2019 13:20:00,1,1955.0,1374.0,0.703,9.225,0,0,0,0,0,0,0,0,0.0,0.0
1008,772,24-09-2019 13:22:00,1,1954.5,1370.5,0.701,9.2195,3,0,0,0,3,0,3,0,0.0,0.0
1008,773,24-09-2019 13:24:00,1,1954.0,1367.0,0.699,9.214,0,0,0,0,0,0,0,0,0.0,0.0
1008,774,24-09-2019 13:26:00,1,1956.0,1356.0,0.693,9.209,0,0,0,0,0,0,0,0,0.0,0.0
1008,775,24-09-2019 13:28:00,1,1972.0,1334.0,0.676,9.247,34,7,5,2,27,16,11,0,0.0,0.0
1008,776,24-09-2019 13:30:00,1,1952.0,1385.0,0.709,9.226,76,45,30,15,31,19,12,0,0.0,0.0
1008,777,24-09-2019 13:32:00,1,1954.0,1366.0,0.699,9.212,152,35,29,6,117,62,55,0,0.0,0.0
1008,778,24-09-2019 13:34:00,1,1936.0,1444.0,0.746,9.228,128,17,3,14,111,71,40,0,0.0,0.0
1008,779,24-09-2019 13:36:00,1,2083.0,1465.0,0.703,9.828,123,42,27,15,81,44,37,0,0.0,0.0
1008,780,24-09-2019 13:38:00,1,2368.0,1569.0,0.663,11.067,126,86,43,43,40,16,24,0,0.0,0.0
1008,781,24-09-2019 13:40:00,1,2359.0,1609.0,0.682,11.076,18,11,3,8,7,2,5,0,0.0,0.0
1008,782,24-09-2019 13:42:00,1,2342.0,1672.0,0.714,11.079,62,15,6,9,47,26,21,0,0.0,0.0
1008,783,24-09-2019 13:44:00,1,2338.0,1673.0,0.715,11.066,240,87,63,24,153,111,42,5,0.0,0.0
1008,784,24-09-2019 13:46:00,1,2492.0,1669.0,0.67,11.667,110,13,0,13,97,63,34,0,0.0,0.0
1008,785,24-09-2019 13:48:00,1,2369.0,1561.0,0.659,11.061,27,5,0,5,22,10,12,0,0.0,0.0
1008,786,24-09-2019 13:50:00,1,2090.0,1440.0,0.689,9.829,35,0,0,0,35,4,31,0,0.0,0.0
1008,787,24-09-2019 13:52:00,1,1970.0,1317.0,0.669,9.221,68,19,1,18,49,2,47,0,0.0,0.0
1008,788,24-09-2019 13:54:00,1,1986.0,1264.0,0.636,9.225,63,12,0,12,51,4,47,0,0.0,0.0
1008,789,24-09-2019 13:56:00,1,1971.5,1307.5,0.663,9.2155,38,0,0,0,38,0,38,0,0.0,0.0
1008,790,24-09-2019 13:58:00,1,1957.0,1351.0,0.69,9.206,47,0,0,0,47,2,45,0,0.0,0.0
1008,791,24-09-2019 14:00:00,1,1958.0,1368.0,0.699,9.231,51,0,0,0,51,1,50,0,0.0,0.0
1008,792,24-09-2019 14:02:00,1,2250.0,1438.0,0.639,10.457,39,0,0,0,39,0,39,0,0.0,0.0
1008,793,24-09-2019 14:04:00,1,2252.0,1443.0,0.641,10.47,125,1,0,1,124,71,53,0,0.0,0.0
1008,794,24-09-2019 14:06:00,1,2247.0,1402.0,0.624,10.408,110,2,1,1,108,50,58,0,0.0,0.0
1008,795,24-09-2019 14:08:00,1,2109.0,1373.0,0.651,9.83,92,0,0,0,92,44,48,0,0.0,0.0
1008,796,24-09-2019 14:10:00,1,1968.0,1322.0,0.672,9.217,109,0,0,0,109,55,54,0,0.0,0.0
1008,797,24-09-2019 14:12:00,1,1986.0,1267.0,0.638,9.226,78,10,5,5,68,33,35,0,0.0,0.0
1008,798,24-09-2019 14:14:00,1,2100.0,1387.0,0.66,9.811,0,0,0,0,0,0,0,0,0.0,0.0
1008,799,24-09-2019 14:16:00,1,2109.0,1365.0,0.647,9.821,0,0,0,0,0,0,0,0,0.0,0.0
1008,800,24-09-2019 14:18:00,1,1965.0,1339.0,0.681,9.226,0,0,0,0,0,0,0,0,0.0,0.0
1008,801,24-09-2019 14:20:00,1,2266.0,1361.0,0.601,10.438,0,0,0,0,0,0,0,0,0.0,0.0
1008,802,24-09-2019 14:22:00,1,2414.0,1368.0,0.567,11.026,0,0,0,0,0,0,0,0,0.0,0.0
1008,803,24-09-2019 14:24:00,1,2424.0,1355.0,0.559,11.051,10,6,2,4,4,1,3,0,0.0,0.0
1008,804,24-09-2019 14:26:00,1,2433.0,1317.0,0.541,11.044,70,20,9,11,50,25,25,0,0.0,0.0
1008,805,24-09-2019 14:28:00,1,2281.0,1306.0,0.572,10.434,27,2,0,2,25,0,25,0,0.0,0.0
1008,806,24-09-2019 14:30:00,1,1983.5,1274.5,0.6545,9.227,51,1,0,1,50,2,48,0,0.0,0.0
1008,807,24-09-2019 14:32:00,1,1686.0,1243.0,0.737,8.02,96,6,1,5,90,37,53,0,0.0,0.0
1008,808,24-09-2019 14:34:00,1,1833.0,1259.0,0.687,8.617,47,4,0,4,43,0,43,0,0.0,0.0
1008,809,24-09-2019 14:36:00,1,1982.0,1259.0,0.635,9.204,17,2,0,2,15,0,15,0,0.0,0.0
1008,810,24-09-2019 14:38:00,1,1985.0,1261.0,0.635,9.217,80,4,2,2,76,55,21,0,0.0,0.0
1008,811,24-09-2019 14:40:00,1,1974.0,1293.0,0.655,9.208,59,2,0,2,57,29,28,0,0.0,0.0
1008,812,24-09-2019 14:42:00,1,2120.0,1348.0,0.636,9.846,55,1,1,0,54,12,42,0,0.0,0.0
1008,813,24-09-2019 14:44:00,1,1671.0,1264.0,0.757,7.982,99,0,0,0,99,47,52,0,0.0,0.0
1008,814,24-09-2019 14:46:00,1,1681.0,1230.0,0.732,7.983,177,27,11,16,150,86,64,0,0.0,0.0
1008,815,24-09-2019 14:48:00,1,1974.0,1313.0,0.665,9.234,69,48,23,25,21,0,21,0,0.0,0.0
1008,816,24-09-2019 14:50:00,1,2096.0,1441.0,0.688,9.852,39,17,0,17,22,7,15,0,0.0,0.0
1008,817,24-09-2019 14:52:00,1,2207.0,1591.0,0.721,10.457,32,23,2,21,9,2,7,0,0.0,0.0
1008,818,24-09-2019 14:54:00,1,2352.0,1629.0,0.693,11.069,43,26,7,19,17,3,14,0,0.0,0.0
1008,819,24-09-2019 14:56:00,1,2341.0,1663.0,0.71,11.066,68,39,16,23,29,20,9,44,0.0,0.0
1008,820,24-09-2019 14:58:00,1,2608.0,1834.0,0.703,12.306,47,43,19,24,4,0,4,57,0.0,0.0
1008,821,24-09-2019 15:00:00,1,2724.0,1952.0,0.717,12.894,36,36,13,23,0,0,0,37,0.0,0.0
1008,822,24-09-2019 15:02:00,1,2710.0,2012.0,0.742,12.907,51,47,23,24,4,0,4,53,0.0,0.0
1008,823,24-09-2019 15:04:00,1,2915.0,2121.0,0.7285,13.8355,75,55,26,29,20,5,15,69,0.0,0.0
1008,824,24-09-2019 15:06:00,1,3120.0,2230.0,0.715,14.764,87,70,25,45,17,3,14,37,0.0,0.0
1008,825,24-09-2019 15:08:00,1,2987.0,2144.0,0.718,14.142,243,143,104,39,100,74,26,75,0.05,0.0
1008,826,24-09-2019 15:10:00,1,3116.0,2237.0,0.718,14.753,439,242,196,46,197,147,50,31,0.03,0.0
1008,827,24-09-2019 15:12:00,1,3116.0,2270.0,0.728,14.791,538,312,249,63,226,178,48,2,0.0,0.0
1008,828,24-09-2019 15:14:00,1,2994.0,2155.0,0.72,14.182,368,197,148,49,171,136,35,53,0.0,0.0
1008,829,24-09-2019 15:16:00,1,2877.0,1963.0,0.682,13.509,213,51,30,21,162,104,58,0,0.01,0.0
1008,830,24-09-2019 15:18:00,1,2895.0,1907.0,0.659,13.518,379,9,6,3,370,278,92,0,0.0,0.0
1008,831,24-09-2019 15:20:00,1,2884.0,1931.0,0.67,13.5,287,28,2,26,259,191,68,0,0.0,0.0
1008,832,24-09-2019 15:22:00,1,2460.0,1804.0,0.733,11.691,242,13,4,9,229,182,47,0,0.0,0.0
1008,833,24-09-2019 15:24:00,1,2476.0,1767.0,0.714,11.712,211,11,2,9,200,162,38,0,0.0,0.0
1008,834,24-09-2019 15:26:00,1,2488.0,1676.0,0.673,11.66,216,8,0,8,208,166,42,0,0.0,0.0
1008,835,24-09-2019 15:28:00,1,2358.0,1596.0,0.677,11.059,75,7,0,7,68,26,42,0,0.0,0.0
1008,836,24-09-2019 15:30:00,1,2214.0,1555.0,0.702,10.446,97,0,0,0,97,50,47,0,0.0,0.0
1008,837,24-09-2019 15:32:00,1,2221.0,1550.0,0.698,10.469,162,28,15,13,134,72,62,0,0.0,0.0
1008,838,24-09-2019 15:34:00,1,2499.0,1643.0,0.657,11.665,18,0,0,0,18,2,16,0,0.0,0.0
1008,839,24-09-2019 15:36:00,1,2204.0,1568.0,0.711,10.421,22,22,0,22,0,0,0,0,0.0,0.0
1008,840,24-09-2019 15:38:00,1,2205.0,1585.0,0.7185,10.4425,0,0,0,0,0,0,0,0,0.0,0.0
1008,841,24-09-2019 15:40:00,1,2206.0,1602.0,0.726,10.464,26,1,0,1,25,6,19,0,0.0,0.0
1008,842,24-09-2019 15:42:00,1,2054.0,1577.0,0.768,9.84,94,18,6,12,76,41,35,0,0.0,0.0
1008,843,24-09-2019 15:44:00,1,2349.0,1615.0,0.687,11.045,42,1,0,1,41,2,39,0,0.0,0.0
1008,844,24-09-2019 15:46:00,1,2199.0,1597.0,0.726,10.431,64,8,0,8,56,11,45,0,0.0,0.0
1008,845,24-09-2019 15:48:00,1,2054.0,1592.0,0.775,9.856,177,24,4,20,153,91,62,0,0.0,0.0
1008,846,24-09-2019 15:50:00,1,2348.0,1637.0,0.697,11.063,36,2,0,2,34,7,27,0,0.0,0.0
1008,847,24-09-2019 15:52:00,1,2056.0,1583.0,0.77,9.853,9,0,0,0,9,3,6,0,0.0,0.0
1008,848,24-09-2019 15:54:00,1,2197.0,1614.0,0.734,10.443,317,0,0,0,317,298,19,0,0.0,0.0
1008,849,24-09-2019 15:56:00,1,2347.0,1639.0,0.698,11.062,115,0,0,0,115,90,25,0,0.0,0.0
1008,850,24-09-2019 15:58:00,1,2367.0,1586.0,0.67,11.082,35,0,0,0,35,20,15,0,0.0,0.0
1008,851,24-09-2019 16:00:00,1,2215.0,1540.0,0.695,10.431,109,33,24,9,76,54,22,4,0.0,0.0
1008,852,24-09-2019 16:02:00,1,2347.0,1638.0,0.698,11.061,9,0,0,0,9,0,9,0,0.0,0.0
1008,853,24-09-2019 16:04:00,1,2217.0,1567.0,0.707,10.471,12,0,0,0,12,0,12,0,0.01,0.0
1008,854,24-09-2019 16:06:00,1,2217.0,1563.0,0.705,10.468,51,0,0,0,51,6,45,0,0.0,0.0
1008,855,24-09-2019 16:08:00,1,2360.0,1595.0,0.676,11.066,51,4,1,3,47,2,45,0,0.0,0.0
1008,856,24-09-2019 16:10:00,1,2365.0,1562.0,0.66,11.048,119,9,4,5,110,52,58,0,0.0,0.0
1008,857,24-09-2019 16:12:00,1,2358.5,1599.0,0.678,11.0635,113,22,8,14,91,53,38,0,0.0,0.0
1008,858,24-09-2019 16:14:00,1,2352.0,1636.0,0.696,11.079,235,19,5,14,216,166,50,0,0.0,0.0
1008,859,24-09-2019 16:16:00,1,2458.0,1783.0,0.725,11.658,209,10,1,9,199,139,60,0,0.0,0.0
1008,860,24-09-2019 16:18:00,1,2618.0,1789.0,0.683,12.294,136,54,20,34,82,46,36,16,0.0,0.0
1008,861,24-09-2019 16:20:00,1,2741.0,1899.0,0.693,12.903,56,54,34,20,2,1,1,44,0.0,0.0
1008,862,24-09-2019 16:22:00,1,2972.0,2194.0,0.738,14.138,61,50,21,29,11,0,11,54,0.0,0.0
1008,863,24-09-2019 16:24:00,1,2958.0,2257.0,0.763,14.152,44,37,16,21,7,1,6,26,0.0,0.38
1008,864,24-09-2019 16:26:00,1,2953.0,2250.0,0.762,14.126,0,0,0,0,0,0,0,0,0.0,0.02
1008,865,24-09-2019 16:28:00,1,2967.0,2222.0,0.749,14.152,0,0,0,0,0,0,0,0,0.0,0.0
1008,866,24-09-2019 16:30:00,1,2828.0,2129.0,0.753,13.501,10,3,2,1,7,5,2,0,0.0,0.0
1008,867,24-09-2019 16:32:00,1,2956.0,2270.0,0.768,14.161,210,134,96,38,76,57,19,82,0.16,0.0
1008,868,24-09-2019 16:34:00,1,2702.0,2070.0,0.766,12.94,207,102,76,26,105,83,22,28,0.0,0.0
1008,869,24-09-2019 16:36:00,1,2686.0,2115.0,0.787,12.926,102,29,20,9,73,51,22,3,0.13,0.0
1008,870,24-09-2019 16:38:00,1,2958.0,2247.0,0.76,14.144,600,310,242,68,290,221,69,4,0.0,0.0
1008,871,24-09-2019 16:40:00,1,3338.0,2566.0,0.769,15.991,395,208,163,45,187,140,47,0,0.0,0.01
1008,872,24-09-2019 16:42:00,1,3340.0,2575.0,0.771,16.009,338,192,151,41,146,109,37,9,0.0,0.0
1008,873,24-09-2019 16:44:00,1,2928.0,2376.0,0.812,14.166,369,172,132,40,197,145,52,29,0.0,0.0
1008,874,24-09-2019 16:46:00,1,2940.0,2323.0,0.7905,14.156,273,91,61,30,182,147,35,13,0.0,0.0
1008,875,24-09-2019 16:48:00,1,2952.0,2270.0,0.769,14.146,15,3,0,3,12,0,12,0,0.0,0.0
1008,876,24-09-2019 16:50:00,1,2684.0,2148.0,0.8,12.953,47,0,0,0,47,18,29,0,0.0,0.0
1008,877,24-09-2019 16:52:00,1,2673.0,2141.0,0.801,12.903,28,21,4,17,7,3,4,0,0.0,0.0
1008,878,24-09-2019 16:54:00,1,2965.0,2209.0,0.745,14.129,75,20,3,17,55,29,26,0,0.0,0.0
1008,879,24-09-2019 16:56:00,1,2953.0,2232.0,0.756,14.106,66,8,5,3,58,27,31,0,0.0,0.0
1008,880,24-09-2019 16:58:00,1,2683.0,2127.0,0.792,12.928,188,14,8,6,174,144,30,0,0.0,0.0
1008,881,24-09-2019 17:00:00,1,2699.0,2073.0,0.768,12.931,39,1,1,0,38,0,38,0,0.0,0.0
1008,882,24-09-2019 17:02:00,1,2699.0,2050.0,0.76,12.905,194,21,7,14,173,123,50,0,0.0,0.0
1008,883,24-09-2019 17:04:00,1,2567.0,1974.0,0.769,12.302,97,4,0,4,93,48,45,0,0.0,0.0
1008,884,24-09-2019 17:06:00,1,2278.0,1913.0,0.84,11.095,43,1,0,1,42,6,36,0,0.0,0.0
1008,885,24-09-2019 17:08:00,1,2283.0,1886.0,0.826,11.084,78,10,4,6,68,25,43,0,0.0,0.0
1008,886,24-09-2019 17:10:00,1,2271.0,1924.0,0.847,11.08,30,0,0,0,30,0,30,0,0.0,0.0
1008,887,24-09-2019 17:12:00,1,2284.0,1870.0,0.819,11.068,20,11,0,11,9,2,7,0,0.0,0.0
1008,888,24-09-2019 17:14:00,1,2286.0,1877.0,0.821,11.083,7,7,0,7,0,0,0,0,0.0,0.0
1008,889,24-09-2019 17:16:00,1,2419.0,1943.0,0.803,11.682,9,2,1,1,7,1,6,0,0.0,0.0
1008,890,24-09-2019 17:18:00,1,2301.0,1814.0,0.788,11.075,1,0,0,0,1,1,0,0,0.0,0.0
1008,891,24-09-2019 17:20:00,1,2142.5,1839.5,0.864,10.479,1,0,0,0,1,0,1,0,0.0,0.0
1008,892,24-09-2019 17:22:00,1,1984.0,1865.0,0.94,9.883,83,23,13,10,60,24,36,0,0.0,0.0
1008,893,24-09-2019 17:24:00,1,2366.0,2118.0,0.895,11.665,46,0,0,0,46,0,46,0,0.0,0.0
1008,894,24-09-2019 17:26:00,1,2389.0,2068.0,0.865,11.703,45,0,0,0,45,2,43,0,0.0,0.0
1008,895,24-09-2019 17:28:00,1,2392.0,2021.0,0.845,11.663,39,0,0,0,39,0,39,0,0.0,0.0
1008,896,24-09-2019 17:30:00,1,2255.0,1986.0,0.881,11.083,119,0,0,0,119,86,33,0,0.0,0.0
1008,897,24-09-2019 17:32:00,1,2113.0,1955.0,0.925,10.491,164,0,0,0,164,114,50,0,0.0,0.0
1008,898,24-09-2019 17:34:00,1,2111.0,1935.0,0.917,10.458,129,11,9,2,118,74,44,0,0.0,0.0
1008,899,24-09-2019 17:36:00,1,1992.0,1814.0,0.911,9.855,26,0,0,0,26,0,26,0,0.0,0.0
1008,900,24-09-2019 17:38:00,1,2037.0,1661.0,0.816,9.864,62,4,1,3,58,14,44,0,0.0,0.0
1008,901,24-09-2019 17:40:00,1,2028.0,1661.0,0.819,9.832,44,0,0,0,44,2,42,0,0.0,0.0
1008,902,24-09-2019 17:42:00,1,2022.0,1702.0,0.842,9.85,112,2,1,1,110,70,40,0,0.0,0.0
1008,903,24-09-2019 17:44:00,1,2268.0,1951.0,0.86,11.095,17,14,0,14,3,0,3,0,0.0,0.0
1008,904,24-09-2019 17:46:00,1,2399.0,2002.0,0.834,11.671,74,13,3,10,61,23,38,0,0.0,0.0
1008,905,24-09-2019 17:48:00,1,2397.0,2025.0,0.845,11.687,65,0,0,0,65,27,38,0,0.0,0.0
1008,906,24-09-2019 17:50:00,1,2401.0,2020.0,0.841,11.696,73,22,11,11,51,29,22,0,0.0,0.0
1008,907,24-09-2019 17:52:00,1,2112.0,1953.0,0.924,10.485,43,8,2,6,35,12,23,0,0.0,0.0
1008,908,24-09-2019 17:54:00,1,1970.0,1900.0,0.9675,9.8655,65,40,13,27,25,5,20,0,0.0,0.0
1008,909,24-09-2019 17:56:00,1,1828.0,1847.0,1.011,9.246,211,80,47,33,131,93,38,3,0.0,0.0
1008,910,24-09-2019 17:58:00,1,2123.0,1920.0,0.904,10.49,19,17,6,11,2,0,2,0,0.0,0.0
1008,911,24-09-2019 18:00:00,0,1854.0,1749.0,0.943,9.241,51,18,3,15,33,3,30,0,0.0,0.0
1008,912,24-09-2019 18:02:00,0,1871.0,1697.0,0.907,9.25,56,5,0,5,51,20,31,0,0.0,0.0
1008,913,24-09-2019 18:04:00,0,1874.0,1681.0,0.897,9.246,48,2,0,2,46,18,28,0,0.0,0.0
1008,914,24-09-2019 18:06:00,0,1837.0,1802.0,0.981,9.232,108,12,2,10,96,55,41,0,0.0,0.0
1008,915,24-09-2019 18:08:00,0,1831.0,1819.0,0.993,9.229,245,118,84,34,127,80,47,18,0.0,0.0
1008,916,24-09-2019 18:10:00,0,2215.0,2138.0,0.965,11.094,174,97,64,33,77,51,26,47,0.0,0.0
1008,917,24-09-2019 18:12:00,0,2479.0,2301.0,0.928,12.313,182,103,79,24,79,56,23,47,0.0,0.0
1008,918,24-09-2019 18:14:00,0,2505.0,2234.0,0.892,12.342,52,43,21,22,9,1,8,27,0.0,0.0
1008,919,24-09-2019 18:16:00,0,2496.0,2240.0,0.898,12.315,44,40,18,22,4,0,4,60,0.0,0.0
1008,920,24-09-2019 18:18:00,0,2735.0,2505.0,0.916,13.55,223,127,101,26,96,74,22,120,0.11,0.03
1008,921,24-09-2019 18:20:00,0,2448.0,2399.0,0.98,12.302,359,144,111,33,215,161,54,16,0.0,0.0
1008,922,24-09-2019 18:22:00,0,2592.0,2446.0,0.944,12.922,490,155,114,41,335,250,85,8,0.0,0.0
1008,923,24-09-2019 18:24:00,0,2608.0,2416.0,0.926,12.952,172,51,22,29,121,79,42,0,0.0,0.0
1008,924,24-09-2019 18:26:00,0,2481.0,2307.0,0.93,12.328,153,28,13,15,125,81,44,0,0.0,0.0
1008,925,24-09-2019 18:28:00,0,2496.5,2245.0,0.8995,12.321,76,31,5,26,45,18,27,0,0.0,0.01
1008,926,24-09-2019 18:30:00,0,2512.0,2183.0,0.869,12.314,143,56,24,32,87,55,32,0,0.0,0.0
1008,927,24-09-2019 18:32:00,0,2495.0,2254.0,0.903,12.327,25,0,0,0,25,8,17,0,0.0,0.0
1008,928,24-09-2019 18:34:00,0,2532.0,2090.0,0.826,12.289,18,0,0,0,18,0,18,0,0.0,0.0
1008,929,24-09-2019 18:36:00,0,2256.0,1990.0,0.882,11.09,47,5,1,4,42,15,27,0,0.0,0.0
1008,930,24-09-2019 18:38:00,0,2258.0,1974.0,0.874,11.081,113,40,31,9,73,49,24,3,0.0,0.0
1008,931,24-09-2019 18:40:00,0,2493.0,2245.0,0.9,12.309,16,0,0,0,16,3,13,0,0.0,0.0
1008,932,24-09-2019 18:42:00,0,2526.0,2100.0,0.831,12.279,27,0,0,0,27,2,25,0,0.0,0.0
1008,933,24-09-2019 18:44:00,0,2548.0,2051.0,0.805,12.312,55,1,1,0,54,6,48,0,0.0,0.0
1008,934,24-09-2019 18:46:00,0,2402.0,1993.0,0.83,11.671,39,0,0,0,39,4,35,0,0.0,0.0
1008,935,24-09-2019 18:48:00,0,2252.0,1990.0,0.883,11.077,35,1,0,1,34,6,28,0,0.0,0.0
1008,936,24-09-2019 18:50:00,0,2255.0,1985.0,0.88,11.083,32,11,9,2,21,5,16,0,0.0,0.0
1008,937,24-09-2019 18:52:00,0,2260.0,1974.0,0.874,11.089,7,2,2,0,5,2,3,0,0.0,0.0
1008,938,24-09-2019 18:54:00,0,2288.0,1895.0,0.828,11.113,14,4,0,4,10,7,3,0,0.0,0.0
1008,939,24-09-2019 18:56:00,0,2276.0,1920.0,0.844,11.092,10,0,0,0,10,4,6,0,0.0,0.0
1008,940,24-09-2019 18:58:00,0,2300.0,1831.0,0.796,11.088,26,5,1,4,21,7,14,0,0.0,0.0
1008,941,24-09-2019 19:00:00,0,2273.0,1895.0,0.833,11.054,10,2,1,1,8,3,5,0,0.0,0.0
1008,942,24-09-2019 19:02:00,0,2258.5,1958.5,0.867,11.0665,16,2,0,2,14,4,10,0,0.0,0.0
1008,943,24-09-2019 19:04:00,0,2244.0,2022.0,0.901,11.079,87,39,23,16,48,24,24,2,0.0,0.0
1008,944,24-09-2019 19:06:00,0,2511.0,2186.0,0.871,12.312,214,150,105,45,64,38,26,19,0.0,0.0
1008,945,24-09-2019 19:08:00,0,2919.0,2404.0,0.824,14.162,60,59,29,30,1,1,0,65,0.0,0.0
1008,946,24-09-2019 19:10:00,0,2885.0,2540.0,0.88,14.181,72,65,26,39,7,0,7,63,0.0,0.1
1008,947,24-09-2019 19:12:00,0,2906.0,2445.0,0.841,14.156,90,86,41,45,4,2,2,61,0.0,0.0
1008,948,24-09-2019 19:14:00,0,2882.0,2544.0,0.883,14.173,73,59,28,31,14,2,12,54,0.0,0.0
1008,949,24-09-2019 19:16:00,0,3149.0,2683.0,0.852,15.376,174,120,80,40,54,36,18,71,0.0,0.04
1008,950,24-09-2019 19:18:00,0,2882.0,2525.0,0.876,14.152,227,93,55,38,134,106,28,10,0.0,0.06
1008,951,24-09-2019 19:20:00,0,2902.0,2401.0,0.827,14.093,341,34,13,21,307,236,71,3,0.0,0.0
1008,952,24-09-2019 19:22:00,0,3150.0,2688.0,0.853,15.388,261,60,30,30,201,149,52,0,0.0,0.0
1008,953,24-09-2019 19:24:00,0,3161.0,2691.0,0.851,15.433,93,32,6,26,61,28,33,0,0.0,0.0
1008,954,24-09-2019 19:26:00,0,3175.0,2573.0,0.81,15.36,222,81,43,38,141,93,48,14,0.14,0.0
1008,955,24-09-2019 19:28:00,0,3133.0,2754.0,0.879,15.392,23,5,1,4,18,2,16,0,0.0,0.0
1008,956,24-09-2019 19:30:00,0,3164.0,2598.0,0.821,15.342,4,0,0,0,4,0,4,0,0.0,0.0
1008,957,24-09-2019 19:32:00,0,2898.0,2489.0,0.859,14.173,16,8,3,5,8,0,8,0,0.0,0.0
1008,958,24-09-2019 19:34:00,0,2882.0,2552.0,0.886,14.18,57,6,4,2,51,13,38,0,0.0,0.0
1008,959,24-09-2019 19:36:00,0,2723.5,2272.0,0.831,13.246,51,4,2,2,47,24,23,0,0.0,0.0
1008,960,24-09-2019 19:38:00,0,2565.0,1992.0,0.776,12.312,21,6,2,4,15,1,14,0,0.0,0.0
1008,961,24-09-2019 19:40:00,0,2266.0,1945.0,0.859,11.08,30,2,0,2,28,6,22,0,0.0,0.0
1008,962,24-09-2019 19:42:00,0,2282.0,1905.0,0.835,11.099,35,14,6,8,21,8,13,0,0.0,0.0
1008,963,24-09-2019 19:44:00,0,2265.0,1923.0,0.849,11.055,21,0,0,0,21,0,21,0,0.0,0.0
1008,964,24-09-2019 19:46:00,0,2274.0,1912.0,0.841,11.077,19,12,1,11,7,2,5,0,0.0,0.0
1008,965,24-09-2019 19:48:00,0,2280.0,1913.0,0.839,11.1,33,8,2,6,25,8,17,0,0.0,0.0
1008,966,24-09-2019 19:50:00,0,2264.0,1955.0,0.863,11.087,77,1,0,1,76,38,38,0,0.0,0.0
1008,967,24-09-2019 19:52:00,0,2270.0,1923.0,0.847,11.071,44,2,1,1,42,12,30,0,0.0,0.0
1008,968,24-09-2019 19:54:00,0,2261.0,1956.0,0.865,11.073,52,0,0,0,52,36,16,0,0.0,0.0
1008,969,24-09-2019 19:56:00,0,2257.0,1983.0,0.879,11.088,163,87,45,42,76,51,25,0,0.0,0.0
1008,970,24-09-2019 19:58:00,0,2539.0,2090.0,0.823,12.317,167,54,25,29,113,82,31,5,0.0,0.0
1008,971,24-09-2019 20:00:00,0,2929.0,2344.0,0.8,14.135,134,97,61,36,37,25,12,38,0.0,0.0
1008,972,24-09-2019 20:02:00,0,2890.0,2535.0,0.877,14.193,38,36,25,11,2,0,2,71,0.0,0.0
1008,973,24-09-2019 20:04:00,0,3173.0,2603.0,0.82,15.385,49,39,15,24,10,0,10,65,0.0,0.0
1008,974,24-09-2019 20:06:00,0,3153.0,2672.0,0.847,15.379,82,74,37,37,8,0,8,64,0.0,0.04
1008,975,24-09-2019 20:08:00,0,3137.0,2699.0,0.86,15.349,86,75,41,34,11,2,9,70,0.0,0.07
1008,976,24-09-2019 20:10:00,0,3021.0,2589.0,0.8565,14.7705,349,195,141,54,154,124,30,60,0.0,0.0
1008,977,24-09-2019 20:12:00,0,2905.0,2479.0,0.853,14.192,172,28,10,18,144,108,36,0,0.0,0.0
1008,978,24-09-2019 20:14:00,0,2814.0,2189.0,0.778,13.51,276,113,68,45,163,132,31,6,0.03,0.0
1008,979,24-09-2019 20:16:00,0,3160.0,2651.0,0.839,15.384,189,31,19,12,158,95,63,0,0.0,0.0
1008,980,24-09-2019 20:18:00,0,2906.0,2436.0,0.838,14.146,119,10,5,5,109,59,50,0,0.0,0.01
1008,981,24-09-2019 20:20:00,0,3185.0,2567.0,0.806,15.39,84,31,11,20,53,23,30,0,0.0,0.0
1008,982,24-09-2019 20:22:00,0,2908.0,2459.0,0.845,14.181,130,44,14,30,86,52,34,0,0.0,0.0
1008,983,24-09-2019 20:24:00,0,2957.0,2249.0,0.761,14.143,26,4,2,2,22,11,11,0,0.0,0.0
1008,984,24-09-2019 20:26:00,0,2662.0,2183.0,0.82,12.904,128,3,2,1,125,79,46,0,0.0,0.0
1008,985,24-09-2019 20:28:00,0,2645.0,2219.0,0.839,12.88,31,0,0,0,31,22,9,0,0.0,0.0
1008,986,24-09-2019 20:30:00,0,2806.0,2247.0,0.801,13.542,88,12,10,2,76,41,35,1,0.0,0.0
1008,987,24-09-2019 20:32:00,0,2660.0,2208.0,0.83,12.924,173,0,0,0,173,142,31,0,0.0,0.0
1008,988,24-09-2019 20:34:00,0,2522.0,2141.0,0.849,12.308,54,2,1,1,52,6,46,0,0.0,0.0
1008,989,24-09-2019 20:36:00,0,2539.0,2069.0,0.815,12.296,136,8,5,3,128,79,49,0,0.0,0.0
1008,990,24-09-2019 20:38:00,0,2527.0,2116.0,0.837,12.301,80,25,17,8,55,34,21,0,0.0,0.0
1008,991,24-09-2019 20:40:00,0,2267.0,1953.0,0.861,11.095,6,1,0,1,5,1,4,0,0.0,0.0
1008,992,24-09-2019 20:42:00,0,2275.0,1919.0,0.844,11.086,4,0,0,0,4,1,3,0,0.0,0.0
1008,993,24-09-2019 20:44:00,0,2607.0,2115.5,0.8155,12.6115,137,79,47,32,58,42,16,44,0.0,0.0
1008,994,24-09-2019 20:46:00,0,2939.0,2312.0,0.787,14.137,40,38,16,22,2,0,2,60,0.0,0.0
1008,995,24-09-2019 20:48:00,0,2882.0,2534.0,0.879,14.161,102,90,45,45,12,2,10,54,0.0,0.0
1008,996,24-09-2019 20:50:00,0,3179.0,2617.0,0.823,15.424,93,82,45,37,11,0,11,59,0.0,0.0
1008,997,24-09-2019 20:52:00,0,3142.0,2745.0,0.873,15.419,77,66,34,32,11,0,11,66,0.0,0.0
1008,998,24-09-2019 20:54:00,0,3278.0,2831.0,0.864,16.051,50,40,12,28,10,0,10,53,0.0,0.05
1008,999,24-09-2019 20:56:00,0,3415.0,2875.0,0.842,16.638,99,50,23,27,49,29,20,41,0.0,0.13
1008,1000,24-09-2019 20:58:00,0,3163.0,2642.0,0.835,15.388,303,186,143,43,117,89,28,69,0.04,0.01
1008,1001,24-09-2019 21:00:00,0,2928.0,2349.0,0.802,14.139,164,108,73,35,56,37,19,36,0.04,0.0
1008,1002,24-09-2019 21:02:00,0,3141.0,2734.0,0.87,15.402,212,150,111,39,62,45,17,51,0.0,0.0
1008,1003,24-09-2019 21:04:00,0,2540.0,2069.0,0.815,12.299,178,37,10,27,141,82,59,0,0.0,0.0
1008,1004,24-09-2019 21:06:00,0,2312.0,1769.0,0.765,11.067,285,72,26,46,213,151,62,0,0.0,0.0
1008,1005,24-09-2019 21:08:00,0,2297.0,1823.0,0.794,11.069,324,48,23,25,276,196,80,0,0.0,0.0
1008,1006,24-09-2019 21:10:00,0,3154.0,2679.0,0.849,15.392,115,44,13,31,71,31,40,0,0.0,0.0
1008,1007,24-09-2019 21:12:00,0,3191.0,2555.0,0.801,15.401,70,0,0,0,70,54,16,0,0.0,0.0
1008,1008,24-09-2019 21:14:00,0,2908.0,2454.0,0.844,14.174,124,2,1,1,122,70,52,0,0.0,0.0
1008,1009,24-09-2019 21:16:00,0,2894.0,2491.0,0.861,14.16,35,0,0,0,35,0,35,0,0.0,0.0
1008,1010,24-09-2019 21:18:00,0,2893.5,2469.5,0.8535,14.1335,41,0,0,0,41,0,41,0,0.0,0.0
1008,1011,24-09-2019 21:20:00,0,2893.0,2448.0,0.846,14.107,183,50,32,18,133,82,51,0,0.0,0.0
1008,1012,24-09-2019 21:22:00,0,2949.0,2292.0,0.777,14.158,84,12,4,8,72,31,41,0,0.0,0.01
1008,1013,24-09-2019 21:24:00,0,2522.0,2158.0,0.855,12.327,152,8,0,8,144,90,54,0,0.0,0.0
1008,1014,24-09-2019 21:26:00,0,2542.0,2074.0,0.816,12.313,237,21,0,21,216,174,42,0,0.0,0.0
1008,1015,24-09-2019 21:28:00,0,2427.0,1952.0,0.804,11.726,137,0,0,0,137,104,33,0,0.0,0.0
1008,1016,24-09-2019 21:30:00,0,2281.0,1879.0,0.824,11.068,66,1,1,0,65,26,39,0,0.0,0.0
1008,1017,24-09-2019 21:32:00,0,2304.0,1813.0,0.787,11.085,30,0,0,0,30,2,28,0,0.0,0.0
1008,1018,24-09-2019 21:34:00,0,2303.0,1810.0,0.786,11.08,90,4,3,1,86,42,44,0,0.0,0.0
1008,1019,24-09-2019 21:36:00,0,2289.0,1847.0,0.807,11.066,73,1,0,1,72,33,39,0,0.0,0.0
1008,1020,24-09-2019 21:38:00,0,2289.0,1862.0,0.813,11.081,49,3,0,3,46,13,33,0,0.0,0.0
1008,1021,24-09-2019 21:40:00,0,2274.0,1906.0,0.838,11.072,99,5,0,5,94,37,57,0,0.0,0.0
1008,1022,24-09-2019 21:42:00,0,2424.0,1945.0,0.802,11.703,49,21,8,13,28,6,22,0,0.0,0.0
1008,1023,24-09-2019 21:44:00,0,2542.0,2089.0,0.822,12.326,33,16,9,7,17,10,7,0,0.0,0.0
1008,1024,24-09-2019 21:46:00,0,2540.0,2103.0,0.828,12.335,165,81,51,30,84,55,29,51,0.0,0.0
1008,1025,24-09-2019 21:48:00,0,2932.0,2339.0,0.798,14.141,65,53,23,30,12,4,8,49,0.0,0.0
1008,1026,24-09-2019 21:50:00,0,2886.0,2498.0,0.866,14.138,57,44,17,27,13,0,13,43,0.0,0.07
1008,1027,24-09-2019 21:52:00,0,2865.0,2600.0,0.908,14.1675,71,53,20,33,18,0,18,48,0.0,0.0
1008,1028,24-09-2019 21:54:00,0,2844.0,2702.0,0.95,14.197,69,57,24,33,12,0,12,44,0.0,0.07
1008,1029,24-09-2019 21:56:00,0,2970.0,2778.0,0.935,14.778,84,61,33,28,23,3,20,64,0.0,0.0
1008,1030,24-09-2019 21:58:00,0,3225.0,2966.0,0.92,15.989,125,80,57,23,45,13,32,47,0.0,0.13
1008,1031,24-09-2019 22:00:00,0,2861.0,2613.0,0.913,14.167,372,185,138,47,187,141,46,50,0.0,0.09
1008,1032,24-09-2019 22:02:00,0,2730.0,2530.0,0.927,13.559,209,107,71,36,102,75,27,68,0.27,0.0
1008,1033,24-09-2019 22:04:00,0,2865.0,2625.0,0.916,14.195,416,223,182,41,193,152,41,3,0.0,0.0
1008,1034,24-09-2019 22:06:00,0,2885.0,2533.0,0.878,14.173,40,22,14,8,18,2,16,0,0.0,0.0
1008,1035,24-09-2019 22:08:00,0,3266.0,2876.0,0.881,16.054,133,44,35,9,89,70,19,0,0.0,0.0
1008,1036,24-09-2019 22:10:00,0,2832.0,2700.0,0.954,14.146,262,108,74,34,154,110,44,10,0.0,0.0
1008,1037,24-09-2019 22:12:00,0,2259.0,1961.0,0.868,11.072,261,138,103,35,123,94,29,3,0.0,0.0
1008,1038,24-09-2019 22:14:00,0,2236.0,2078.0,0.929,11.111,166,151,105,46,15,6,9,60,0.0,0.0
1008,1039,24-09-2019 22:16:00,0,3265.0,2837.0,0.869,16.007,70,64,39,25,6,0,6,72,0.0,0.0
1008,1040,24-09-2019 22:18:00,0,3243.0,2923.0,0.901,16.011,75,64,34,30,11,0,11,57,0.0,0.0
1008,1041,24-09-2019 22:20:00,0,3525.0,3038.0,0.862,17.253,57,56,37,19,1,0,1,50,0.0,0.03
1008,1042,24-09-2019 22:22:00,0,2984.0,2725.0,0.913,14.774,91,68,35,33,23,13,10,69,0.0,0.05
1008,1043,24-09-2019 22:24:00,0,3247.0,2898.0,0.892,16.002,347,98,64,34,249,174,75,9,0.15,0.0
1008,1044,24-09-2019 22:26:00,0,3071.0,2704.5,0.8795,15.095,439,247,190,57,192,147,45,28,0.0,0.09
1008,1045,24-09-2019 22:28:00,0,2895.0,2511.0,0.867,14.188,267,103,62,41,164,115,49,10,0.0,0.0
1008,1046,24-09-2019 22:30:00,0,2999.0,2665.0,0.889,14.766,693,318,246,72,375,292,83,2,0.05,0.0
1008,1047,24-09-2019 22:32:00,0,3897.0,3322.0,0.852,19.031,922,490,415,75,432,350,82,3,0.0,0.0
1008,1048,24-09-2019 22:34:00,0,3877.0,3464.0,0.893,19.112,270,194,147,47,76,55,21,80,0.0,0.0
1008,1049,24-09-2019 22:36:00,0,2243.0,2029.0,0.904,11.084,177,109,76,33,68,51,17,66,0.05,0.0
1008,1050,24-09-2019 22:38:00,0,3281.0,2809.0,0.856,16.038,386,200,149,51,186,138,48,9,0.0,0.0
1008,1051,24-09-2019 22:40:00,0,2881.0,2552.0,0.886,14.178,184,94,63,31,90,59,31,5,0.0,0.0
1008,1052,24-09-2019 22:42:00,0,2881.0,2557.0,0.888,14.182,47,19,14,5,28,20,8,0,0.0,0.0
1008,1053,24-09-2019 22:44:00,0,2890.0,2539.0,0.879,14.197,29,20,4,16,9,5,4,0,0.0,0.0
1008,1054,24-09-2019 22:46:00,0,2884.0,2492.0,0.864,14.121,47,41,17,24,6,1,5,0,0.0,0.0
1008,1055,24-09-2019 22:48:00,0,2767.0,2385.0,0.862,13.542,13,0,0,0,13,5,8,0,0.0,0.0
1008,1056,24-09-2019 22:50:00,0,2629.0,2345.0,0.892,12.956,15,4,3,1,11,2,9,0,0.0,0.0
1008,1057,24-09-2019 22:52:00,0,2641.0,2279.0,0.863,12.93,39,0,0,0,39,0,39,0,0.0,0.0
1008,1058,24-09-2019 22:54:00,0,2661.0,2187.0,0.822,12.905,60,4,0,4,56,24,32,0,0.0,0.0
1008,1059,24-09-2019 22:56:00,0,2523.0,2124.0,0.842,12.293,83,46,13,33,37,16,21,0,0.0,0.0
1008,1060,24-09-2019 22:58:00,0,2629.0,2328.0,0.886,12.936,173,116,64,52,57,33,24,1,0.0,0.0
1008,1061,24-09-2019 23:00:00,0,2686.5,2393.5,0.891,13.2345,114,73,34,39,41,15,26,0,0.0,0.0
1008,1062,24-09-2019 23:02:00,0,2744.0,2459.0,0.896,13.533,7,4,0,4,3,3,0,0,0.0,0.0
1008,1063,24-09-2019 23:04:00,0,2633.0,2317.0,0.88,12.937,1,1,0,1,0,0,0,0,0.0,0.0
1008,1064,24-09-2019 23:06:00,0,2654.0,2211.0,0.833,12.905,21,15,8,7,6,3,3,0,0.0,0.0
1008,1065,24-09-2019 23:08:00,0,2653.0,2234.0,0.842,12.925,14,10,7,3,4,0,4,0,0.0,0.0
1008,1066,24-09-2019 23:10:00,0,2376.0,2111.0,0.889,11.699,27,26,0,26,1,1,0,0,0.0,0.0
1008,1067,24-09-2019 23:12:00,0,2250.0,2012.0,0.894,11.093,15,7,0,7,8,3,5,0,0.0,0.0
1008,1068,24-09-2019 23:14:00,0,2249.0,2015.0,0.896,11.091,2,0,0,0,2,1,1,0,0.0,0.0
1008,1069,24-09-2019 23:16:00,0,2271.0,1936.0,0.853,11.092,2,0,0,0,2,0,2,0,0.0,0.0
1008,1070,24-09-2019 23:18:00,0,1991.0,1826.0,0.917,9.868,4,1,1,0,3,0,3,0,0.0,0.0
1008,1071,24-09-2019 23:20:00,0,2010.0,1778.0,0.884,9.887,21,9,8,1,12,7,5,0,0.0,0.0
1008,1072,24-09-2019 23:22:00,0,1992.0,1805.0,0.906,9.848,14,5,1,4,9,5,4,0,0.0,0.0
1008,1073,24-09-2019 23:24:00,0,2006.0,1741.0,0.868,9.832,5,3,1,2,2,0,2,0,0.0,0.0
1008,1074,24-09-2019 23:26:00,0,1992.0,1823.0,0.915,9.866,11,5,2,3,6,2,4,0,0.0,0.0
1008,1075,24-09-2019 23:28:00,0,2138.0,1842.0,0.861,10.464,65,34,16,18,31,16,15,0,0.0,0.0
1008,1076,24-09-2019 23:30:00,0,2235.0,2066.0,0.924,11.095,128,60,28,32,68,44,24,28,0.0,0.0
1008,1077,24-09-2019 23:32:00,0,2644.0,2276.0,0.861,12.938,77,65,35,30,12,6,6,64,0.0,0.0
1008,1078,24-09-2019 23:34:00,0,2749.5,2474.0,0.8985,13.572,85,68,40,28,17,8,9,63,0.0,0.0
1008,1079,24-09-2019 23:36:00,0,2855.0,2672.0,0.936,14.206,87,60,34,26,27,6,21,63,0.0,0.02
1008,1080,24-09-2019 23:38:00,0,3138.0,2734.0,0.871,15.389,71,60,39,21,11,4,7,57,0.0,0.03
1008,1081,24-09-2019 23:40:00,0,3273.0,2815.0,0.86,16.014,122,83,38,45,39,11,28,68,0.0,0.0
1008,1082,24-09-2019 23:42:00,0,3379.0,2976.0,0.881,16.61,86,63,36,27,23,4,19,58,0.0,0.09
1008,1083,24-09-2019 23:44:00,0,3536.0,3020.0,0.854,17.275,111,83,60,23,28,17,11,47,0.0,0.06
1008,1084,24-09-2019 23:46:00,0,3234.0,2937.0,0.908,15.993,290,168,125,43,122,80,42,40,0.2,0.0
1008,1085,24-09-2019 23:48:00,0,3133.0,2741.0,0.875,15.379,422,257,195,62,165,126,39,63,0.03,0.02
1008,1086,24-09-2019 23:50:00,0,3913.0,3334.0,0.852,19.108,117,65,44,21,52,38,14,54,0.0,0.0
1008,1087,24-09-2019 23:52:00,0,3648.0,3126.0,0.857,17.835,83,71,38,33,12,2,10,55,0.0,0.05
1008,1088,24-09-2019 23:54:00,0,3657.0,3091.0,0.845,17.83,70,61,38,23,9,2,7,43,0.0,0.07
1008,1089,24-09-2019 23:56:00,0,3679.0,3037.0,0.826,17.858,83,50,28,22,33,20,13,40,0.07,0.06
1008,1090,24-09-2019 23:58:00,0,3532.0,3003.0,0.85,17.243,148,35,20,15,113,63,50,0,0.0,0.0
1008,1091,25-09-2019 00:00:00,0,3273.0,2804.0,0.857,16.001,43,9,1,8,34,13,21,0,0.0,0.0
1008,1092,25-09-2019 00:02:00,0,3295.0,2754.0,0.836,16.032,50,17,0,17,33,14,19,0,0.0,0.0
1008,1093,25-09-2019 00:04:00,0,3293.0,2742.0,0.833,16.011,92,13,0,13,79,61,18,0,0.0,0.0
1008,1094,25-09-2019 00:06:00,0,2855.0,2653.0,0.929,14.185,38,5,1,4,33,14,19,0,0.0,0.0
1008,1095,25-09-2019 00:08:00,0,2884.5,2520.5,0.8745,14.1545,19,0,0,0,19,2,17,0,0.0,0.0
1008,1096,25-09-2019 00:10:00,0,2914.0,2388.0,0.82,14.124,5,0,0,0,5,1,4,0,0.0,0.0
1008,1097,25-09-2019 00:12:00,0,2797.0,2280.0,0.815,13.545,45,15,7,8,30,15,15,0,0.0,0.0
1008,1098,25-09-2019 00:14:00,0,2792.0,2327.0,0.834,13.575,109,64,19,45,45,25,20,0,0.0,0.01
1008,1099,25-09-2019 00:16:00,0,2653.0,2263.0,0.853,12.959,84,42,15,27,42,26,16,0,0.0,0.0
1008,1100,25-09-2019 00:18:00,0,2940.0,2326.0,0.791,14.157,56,30,11,19,26,8,18,0,0.0,0.0
1008,1101,25-09-2019 00:20:00,0,2896.0,2482.0,0.857,14.157,374,194,140,54,180,126,54,21,0.08,0.0
1008,1102,25-09-2019 00:22:00,0,3157.0,2660.0,0.843,15.385,434,224,180,44,210,161,49,25,0.0,0.0
1008,1103,25-09-2019 00:24:00,0,3328.0,2598.0,0.78,15.99,255,65,52,13,190,139,51,9,0.0,0.0
1008,1104,25-09-2019 00:26:00,0,2902.0,2470.0,0.851,14.169,298,133,89,44,165,114,51,23,0.0,0.0
1008,1105,25-09-2019 00:28:00,0,3294.0,2730.0,0.829,16.0,49,40,23,17,9,1,8,46,0.0,0.02
1008,1106,25-09-2019 00:30:00,0,3565.0,2870.0,0.805,17.225,70,60,32,28,10,3,7,49,0.0,0.09
1008,1107,25-09-2019 00:32:00,0,3691.0,2982.0,0.808,17.844,70,59,24,35,11,2,9,44,0.0,0.06
1008,1108,25-09-2019 00:34:00,0,3706.0,2945.0,0.795,17.861,103,75,46,29,28,13,15,47,0.0,0.06
1008,1109,25-09-2019 00:36:00,0,3416.0,2834.0,0.83,16.595,476,260,213,47,216,158,58,10,0.02,0.0
1008,1110,25-09-2019 00:38:00,0,3292.0,2764.0,0.84,16.033,656,380,300,80,276,209,67,8,0.0,0.01
1008,1111,25-09-2019 00:40:00,0,3441.0,2751.0,0.799,16.604,233,161,115,46,72,51,21,17,0.0,0.01
1008,1112,25-09-2019 00:42:00,0,3088.0,2627.5,0.857,15.0765,185,130,91,39,55,45,10,129,0.0,0.0
1008,1113,25-09-2019 00:44:00,0,2735.0,2504.0,0.915,13.549,258,142,99,43,116,77,39,33,0.1,0.0
1008,1114,25-09-2019 00:46:00,0,2982.0,2701.0,0.906,14.738,314,159,123,36,155,116,39,28,0.0,0.01
1008,1115,25-09-2019 00:48:00,0,3406.0,2907.0,0.854,16.637,10,7,0,7,3,1,2,0,0.0,0.32
1008,1116,25-09-2019 00:50:00,0,3407.0,2872.0,0.843,16.605,0,0,0,0,0,0,0,0,0.0,0.0
1008,1117,25-09-2019 00:52:00,0,3428.0,2797.0,0.816,16.601,136,93,73,20,43,23,20,13,0.12,0.0
1008,1118,25-09-2019 00:54:00,0,3399.0,2914.0,0.857,16.617,305,173,129,44,132,86,46,0,0.0,0.0
1008,1119,25-09-2019 00:56:00,0,3293.0,2714.0,0.824,15.978,380,197,145,52,183,136,47,29,0.0,0.0
1008,1120,25-09-2019 00:58:00,0,3534.0,3009.0,0.851,17.256,243,158,117,41,85,66,19,32,0.04,0.02
1008,1121,25-09-2019 01:00:00,0,3398.0,2917.0,0.859,16.616,18,18,3,15,0,0,0,0,0.0,0.0
1008,1122,25-09-2019 01:02:00,0,3542.0,2945.0,0.831,17.217,414,221,170,51,193,146,47,5,0.0,0.0
1008,1123,25-09-2019 01:04:00,0,3428.0,2832.0,0.826,16.642,161,79,59,20,82,61,21,30,0.0,0.0
1008,1124,25-09-2019 01:06:00,0,3426.0,2814.0,0.821,16.613,317,170,125,45,147,111,36,12,0.0,0.0
1008,1125,25-09-2019 01:08:00,0,3396.0,2903.0,0.855,16.595,194,98,62,36,96,67,29,9,0.06,0.0
1008,1126,25-09-2019 01:10:00,0,3446.0,2702.0,0.784,16.571,161,53,26,27,108,70,38,0,0.0,0.0
1008,1127,25-09-2019 01:12:00,0,3488.0,2619.0,0.751,16.643,71,19,0,19,52,13,39,0,0.0,0.0
1008,1128,25-09-2019 01:14:00,0,3775.0,2636.0,0.698,17.794,160,37,14,23,123,72,51,1,0.0,0.0
1008,1129,25-09-2019 01:16:00,0,3543.0,2654.0,0.7525,16.898,217,112,78,34,105,61,44,0,0.0,0.0
1008,1130,25-09-2019 01:18:00,0,3311.0,2672.0,0.807,16.002,150,35,10,25,115,61,54,0,0.0,0.0
1008,1131,25-09-2019 01:20:00,0,3314.0,2631.0,0.794,15.97,174,47,28,19,127,73,54,0,0.0,0.0
1008,1132,25-09-2019 01:22:00,0,3041.0,2520.0,0.829,14.773,85,26,10,16,59,11,48,0,0.0,0.0
1008,1133,25-09-2019 01:24:00,0,3093.0,2316.0,0.749,14.753,22,4,4,0,18,2,16,0,0.0,0.0
1008,1134,25-09-2019 01:26:00,0,2973.0,2207.0,0.742,14.156,9,4,1,3,5,0,5,0,0.0,0.0
1008,1135,25-09-2019 01:28:00,0,2669.0,2169.0,0.813,12.917,11,4,2,2,7,4,3,0,0.0,0.0
1008,1136,25-09-2019 01:30:00,0,2687.0,2133.0,0.794,12.948,13,3,0,3,10,1,9,0,0.0,0.0
1008,1137,25-09-2019 01:32:00,0,2689.0,2061.0,0.766,12.878,25,11,4,7,14,0,14,0,0.0,0.0
1008,1138,25-09-2019 01:34:00,0,2689.0,2109.0,0.784,12.93,1,0,0,0,1,0,1,0,0.0,0.0
1008,1139,25-09-2019 01:36:00,0,2691.0,2083.0,0.774,12.91,6,4,2,2,2,0,2,0,0.0,0.0
1008,1140,25-09-2019 01:38:00,0,2542.0,2057.0,0.809,12.295,40,38,0,38,2,1,1,0,0.0,0.0
1008,1141,25-09-2019 01:40:00,0,2690.0,2122.0,0.789,12.949,24,22,0,22,2,0,2,0,0.0,0.0
1008,1142,25-09-2019 01:42:00,0,2647.0,2270.0,0.858,12.943,76,30,20,10,46,27,19,0,0.0,0.0
1008,1143,25-09-2019 01:44:00,0,2671.0,2181.0,0.817,12.939,45,11,5,6,34,3,31,0,0.0,0.0
1008,1144,25-09-2019 01:46:00,0,2391.0,2052.0,0.858,11.693,53,5,0,5,48,2,46,0,0.0,0.0
1008,1145,25-09-2019 01:48:00,0,2276.0,1911.0,0.839,11.083,130,13,2,11,117,71,46,0,0.0,0.0
1008,1146,25-09-2019 01:50:00,0,2219.0,1830.0,0.824,10.77,327,17,1,16,310,261,49,0,0.0,0.0
1008,1147,25-09-2019 01:52:00,0,2162.0,1749.0,0.809,10.457,181,5,1,4,176,136,40,0,0.0,0.0
1008,1148,25-09-2019 01:54:00,0,2135.0,1848.0,0.865,10.457,170,11,0,11,159,97,62,0,0.0,0.0
1008,1149,25-09-2019 01:56:00,0,2402.0,2010.0,0.837,11.691,130,33,23,10,97,65,32,0,0.0,0.0
1008,1150,25-09-2019 01:58:00,0,2526.0,2109.0,0.835,12.285,0,0,0,0,0,0,0,0,0.0,0.0
1008,1151,25-09-2019 02:00:00,0,2399.0,2029.0,0.846,11.699,1,0,0,0,1,0,1,0,0.0,0.0
1008,1152,25-09-2019 02:02:00,0,2123.0,1912.0,0.901,10.482,10,8,1,7,2,0,2,0,0.0,0.0
1008,1153,25-09-2019 02:04:00,0,2127.0,1878.0,0.883,10.46,137,53,23,30,84,53,31,0,0.0,0.0
1008,1154,25-09-2019 02:06:00,0,2405.0,2014.0,0.838,11.705,354,145,102,43,209,146,63,8,0.0,0.0
1008,1155,25-09-2019 02:08:00,0,2499.0,2224.0,0.89,12.307,310,70,32,38,240,163,77,0,0.0,0.0
1008,1156,25-09-2019 02:10:00,0,2791.0,2342.0,0.839,13.591,179,54,21,33,125,79,46,0,0.0,0.0
1008,1157,25-09-2019 02:12:00,0,2914.0,2383.0,0.818,14.119,301,59,26,33,242,186,56,0,0.0,0.0
1008,1158,25-09-2019 02:14:00,0,2889.0,2505.0,0.867,14.157,129,89,63,26,40,25,15,2,0.0,0.02
1008,1159,25-09-2019 02:16:00,0,3036.0,2526.0,0.832,14.759,217,104,69,35,113,87,26,23,0.0,0.0
1008,1160,25-09-2019 02:18:00,0,3182.0,2601.0,0.817,15.418,235,90,58,32,145,97,48,56,0.0,0.0
1008,1161,25-09-2019 02:20:00,0,2888.0,2510.0,0.869,14.159,714,337,254,83,377,291,86,4,0.0,0.0
1008,1162,25-09-2019 02:22:00,0,3163.0,2657.0,0.84,15.405,303,174,128,46,129,97,32,33,0.0,0.06
1008,1163,25-09-2019 02:24:00,0,2952.0,2563.5,0.8705,14.4695,213,120,77,43,93,71,22,38,0.0,0.0
1008,1164,25-09-2019 02:26:00,0,2741.0,2470.0,0.901,13.534,436,182,137,45,254,194,60,6,0.0,0.0
1008,1165,25-09-2019 02:28:00,0,3038.0,2533.0,0.834,14.776,686,377,313,64,309,249,60,0,0.0,0.0
1008,1166,25-09-2019 02:30:00,0,2998.0,2695.0,0.899,14.796,306,171,133,38,135,101,34,154,0.0,0.0
1008,1167,25-09-2019 02:32:00,0,2887.0,2515.0,0.871,14.16,115,48,31,17,67,26,41,1,0.0,0.0
1008,1168,25-09-2019 02:34:00,0,3023.0,2584.0,0.855,14.773,100,24,6,18,76,48,28,0,0.0,0.0
1008,1169,25-09-2019 02:36:00,0,2997.0,2662.0,0.888,14.755,86,32,7,25,54,24,30,2,0.0,0.0
1008,1170,25-09-2019 02:38:00,0,2743.0,2478.0,0.903,13.552,38,9,1,8,29,7,22,0,0.0,0.0
1008,1171,25-09-2019 02:40:00,0,2804.0,2262.0,0.807,13.551,34,0,0,0,34,21,13,0,0.0,0.0
1008,1172,25-09-2019 02:42:00,0,2377.0,2120.0,0.892,11.713,10,2,1,1,8,2,6,0,0.0,0.0
1008,1173,25-09-2019 02:44:00,0,2414.0,1968.0,0.815,11.69,1,1,0,1,0,0,0,0,0.0,0.0
1008,1174,25-09-2019 02:46:00,0,2125.0,1902.0,0.895,10.478,0,0,0,0,0,0,0,0,0.0,0.0
1008,1175,25-09-2019 02:48:00,0,1992.0,1822.0,0.915,9.867,3,3,0,3,0,0,0,0,0.0,0.0
1008,1176,25-09-2019 02:50:00,0,1990.0,1806.0,0.908,9.839,187,24,14,10,163,128,35,0,0.0,0.0
1008,1177,25-09-2019 02:52:00,0,2402.0,1992.0,0.83,11.668,434,14,0,14,420,378,42,0,0.0,0.0
1008,1178,25-09-2019 02:54:00,0,2415.0,1978.0,0.819,11.707,400,47,11,36,353,300,53,0,0.0,0.0
1008,1179,25-09-2019 02:56:00,0,2392.0,2055.0,0.859,11.7,278,0,0,0,278,238,40,0,0.0,0.0
1008,1180,25-09-2019 02:58:00,0,2316.5,2052.0,0.8865,11.3995,334,0,0,0,334,282,52,0,0.0,0.0
1008,1181,25-09-2019 03:00:00,0,2241.0,2049.0,0.914,11.099,74,5,1,4,69,24,45,0,0.0,0.0
1008,1182,25-09-2019 03:02:00,0,2241.0,2063.0,0.92,11.115,139,13,5,8,126,66,60,0,0.0,0.0
1008,1183,25-09-2019 03:04:00,0,2228.0,2093.0,0.94,11.094,47,0,0,0,47,0,47,0,0.0,0.0
1008,1184,25-09-2019 03:06:00,0,2099.0,1974.0,0.94,10.457,55,8,1,7,47,5,42,0,0.0,0.0
1008,1185,25-09-2019 03:08:00,0,1823.0,1886.0,1.035,9.269,51,2,1,1,49,4,45,0,0.0,0.0
1008,1186,25-09-2019 03:10:00,0,1969.0,1911.0,0.971,9.872,52,0,0,0,52,0,52,0,0.0,0.0
1008,1187,25-09-2019 03:12:00,0,2230.0,2074.0,0.93,11.081,49,0,0,0,49,0,49,0,0.0,0.0
1008,1188,25-09-2019 03:14:00,0,2523.0,2176.0,0.862,12.351,45,0,0,0,45,0,45,0,0.0,0.0
1008,1189,25-09-2019 03:16:00,0,2663.0,2167.0,0.814,12.89,188,28,20,8,160,99,61,0,0.0,0.0
1008,1190,25-09-2019 03:18:00,0,2816.0,2201.0,0.781,13.534,137,39,11,28,98,66,32,3,0.0,0.0
1008,1191,25-09-2019 03:20:00,0,2966.0,2215.0,0.747,14.139,237,46,23,23,191,142,49,0,0.0,0.0
1008,1192,25-09-2019 03:22:00,0,2953.0,2255.0,0.764,14.131,68,37,14,23,31,15,16,1,0.0,0.0
1008,1193,25-09-2019 03:24:00,0,3224.0,2453.0,0.761,15.417,287,175,122,53,112,86,26,39,0.0,0.0
1008,1194,25-09-2019 03:26:00,0,3325.0,2627.0,0.79,16.011,70,59,35,24,11,3,8,74,0.0,0.0
1008,1195,25-09-2019 03:28:00,0,3302.0,2691.0,0.815,15.991,83,73,40,33,10,1,9,74,0.0,0.0
1008,1196,25-09-2019 03:30:00,0,3587.0,2788.0,0.777,17.218,69,58,24,34,11,0,11,63,0.0,0.01
1008,1197,25-09-2019 03:32:00,0,3342.0,2842.0,0.856,16.314,88,69,37,32,19,0,19,79,0.0,0.03
1008,1198,25-09-2019 03:34:00,0,3097.0,2896.0,0.935,15.41,89,78,39,39,11,5,6,48,0.0,0.07
1008,1199,25-09-2019 03:36:00,0,3530.0,2975.0,0.843,17.203,51,46,24,22,5,1,4,55,0.0,0.04
1008,1200,25-09-2019 03:38:00,0,3528.0,3002.0,0.851,17.222,297,176,136,40,121,92,29,57,0.16,0.03
1008,1201,25-09-2019 03:40:00,0,3238.0,2971.0,0.918,16.045,412,245,193,52,167,124,43,21,0.0,0.0
1008,1202,25-09-2019 03:42:00,0,2865.0,2586.0,0.903,14.15,235,147,114,33,88,59,29,30,0.0,0.0
1008,1203,25-09-2019 03:44:00,0,2877.0,2567.0,0.892,14.177,54,28,9,19,26,18,8,0,0.0,0.0
1008,1204,25-09-2019 03:46:00,0,2395.0,2006.0,0.838,11.658,381,200,152,48,181,123,58,15,0.08,0.06
1008,1205,25-09-2019 03:48:00,0,3107.0,2858.0,0.92,15.406,564,259,189,70,305,236,69,19,0.0,0.0
1008,1206,25-09-2019 03:50:00,0,3508.0,3042.0,0.867,17.189,439,222,179,43,217,165,52,26,0.0,0.0
1008,1207,25-09-2019 03:52:00,0,3124.0,2777.0,0.889,15.384,94,84,55,29,10,3,7,58,0.0,0.04
1008,1208,25-09-2019 03:54:00,0,3515.0,3114.0,0.886,17.298,68,62,37,25,6,0,6,58,0.0,0.0
1008,1209,25-09-2019 03:56:00,0,3482.0,3173.0,0.911,17.232,73,63,41,22,10,1,9,57,0.0,0.0
1008,1210,25-09-2019 03:58:00,0,3487.0,3131.0,0.898,17.204,311,53,38,15,258,217,41,0,0.0,0.02
1008,1211,25-09-2019 04:00:00,0,3376.0,3010.0,0.892,16.632,144,2,0,2,142,111,31,0,0.0,0.0
1008,1212,25-09-2019 04:02:00,0,3114.0,2805.0,0.901,15.376,110,35,2,33,75,50,25,0,0.0,0.0
1008,1213,25-09-2019 04:04:00,0,2495.0,2250.0,0.902,12.32,63,10,1,9,53,29,24,0,0.0,0.0
1008,1214,25-09-2019 04:06:00,0,2701.0,2346.5,0.871,13.2395,98,25,14,11,73,41,32,0,0.0,0.0
1008,1215,25-09-2019 04:08:00,0,2907.0,2443.0,0.84,14.159,7,4,2,2,3,0,3,0,0.0,0.0
1008,1216,25-09-2019 04:10:00,0,2771.0,2361.0,0.852,13.532,33,33,0,33,0,0,0,0,0.0,0.0
1008,1217,25-09-2019 04:12:00,0,2486.0,2284.0,0.918,12.324,26,25,0,25,1,1,0,0,0.0,0.0
1008,1218,25-09-2019 04:14:00,0,2519.0,2174.0,0.863,12.33,0,0,0,0,0,0,0,0,0.0,0.0
1008,1219,25-09-2019 04:16:00,0,2543.0,2087.0,0.821,12.33,0,0,0,0,0,0,0,0,0.0,0.0
1008,1220,25-09-2019 04:18:00,0,2392.0,2049.0,0.856,11.693,44,0,0,0,44,27,17,0,0.0,0.0
1008,1221,25-09-2019 04:20:00,0,2534.0,2082.0,0.822,12.288,265,1,0,1,264,219,45,0,0.0,0.0
1008,1222,25-09-2019 04:22:00,0,2395.0,2037.0,0.85,11.693,237,0,0,0,237,196,41,0,0.0,0.0
1008,1223,25-09-2019 04:24:00,0,2253.0,2004.0,0.89,11.094,178,22,15,7,156,116,40,0,0.0,0.0
1008,1224,25-09-2019 04:26:00,0,2394.0,2011.0,0.84,11.659,4,4,2,2,0,0,0,0,0.0,0.0
1008,1225,25-09-2019 04:28:00,0,2265.0,1956.0,0.864,11.09,31,14,5,9,17,1,16,0,0.0,0.0
1008,1226,25-09-2019 04:30:00,0,2412.0,1990.0,0.825,11.706,278,2,1,1,276,229,47,0,0.0,0.0
1008,1227,25-09-2019 04:32:00,0,2251.0,1965.0,0.873,11.043,240,0,0,0,240,181,59,0,0.0,0.0
1008,1228,25-09-2019 04:34:00,0,2265.0,1959.0,0.865,11.094,314,5,1,4,309,243,66,0,0.0,0.01
1008,1229,25-09-2019 04:36:00,0,2544.0,2087.0,0.82,12.334,606,0,0,0,606,547,59,0,0.0,0.0
1008,1230,25-09-2019 04:38:00,0,2520.0,2147.0,0.852,12.307,394,0,0,0,394,333,61,0,0.0,0.0
1008,1231,25-09-2019 04:40:00,0,2458.0,2081.5,0.8465,11.99,251,0,0,0,251,216,35,0,0.0,0.0
1008,1232,25-09-2019 04:42:00,0,2396.0,2016.0,0.841,11.673,369,2,2,0,367,301,66,0,0.0,0.0
1008,1233,25-09-2019 04:44:00,0,2409.0,1990.0,0.826,11.695,189,0,0,0,189,153,36,0,0.0,0.0
1008,1234,25-09-2019 04:46:00,0,2260.0,1950.0,0.863,11.062,167,73,55,18,94,64,30,3,0.0,0.0
1008,1235,25-09-2019 04:48:00,0,2547.0,2028.0,0.796,12.282,433,218,164,54,215,154,61,18,0.0,0.0
1008,1236,25-09-2019 04:50:00,0,2494.0,2254.0,0.904,12.323,399,184,125,59,215,162,53,16,0.0,0.0
1008,1237,25-09-2019 04:52:00,0,2786.0,2304.0,0.827,13.528,119,64,34,30,55,27,28,0,0.0,0.0
1008,1238,25-09-2019 04:54:00,0,2777.0,2315.0,0.834,13.505,25,16,6,10,9,3,6,0,0.0,0.0
1008,1239,25-09-2019 04:56:00,0,2940.0,2308.0,0.785,14.141,50,21,12,9,29,15,14,0,0.0,0.0
1008,1240,25-09-2019 04:58:00,0,2916.0,2422.0,0.831,14.17,206,6,0,6,200,168,32,0,0.0,0.0
1008,1241,25-09-2019 05:00:00,0,2658.0,2203.0,0.829,12.912,201,0,0,0,201,174,27,0,0.0,0.0
1008,1242,25-09-2019 05:02:00,0,2537.0,2063.0,0.813,12.279,207,1,0,1,206,173,33,0,0.0,0.0
1008,1243,25-09-2019 05:04:00,0,2535.0,2094.0,0.826,12.304,34,0,0,0,34,12,22,0,0.0,0.0
1008,1244,25-09-2019 05:06:00,0,2538.0,2059.0,0.811,12.281,22,0,0,0,22,2,20,0,0.0,0.0
1008,1245,25-09-2019 05:08:00,0,2559.0,2002.0,0.782,12.298,81,22,5,17,59,17,42,0,0.0,0.0
1008,1246,25-09-2019 05:10:00,0,2536.0,2101.0,0.828,12.319,69,2,0,2,67,17,50,0,0.0,0.0
1008,1247,25-09-2019 05:12:00,0,2519.0,2182.0,0.866,12.342,70,5,3,2,65,25,40,0,0.0,0.0
1008,1248,25-09-2019 05:14:00,0,2509.5,2200.0,0.8765,12.3245,88,9,4,5,79,41,38,0,0.0,0.0
1008,1249,25-09-2019 05:16:00,0,2500.0,2218.0,0.887,12.307,8,0,0,0,8,0,8,0,0.0,0.0
1008,1250,25-09-2019 05:18:00,0,2501.0,2213.0,0.885,12.302,19,0,0,0,19,14,5,0,0.0,0.0
1008,1251,25-09-2019 05:20:00,0,2929.0,2350.0,0.802,14.144,680,0,0,0,680,642,38,0,0.0,0.0
1008,1252,25-09-2019 05:22:00,0,2928.0,2363.0,0.807,14.151,39,0,0,0,39,16,23,0,0.0,0.0
1008,1253,25-09-2019 05:24:00,0,2795.0,2291.0,0.82,13.548,47,0,0,0,47,35,12,0,0.0,0.0
1008,1254,25-09-2019 05:26:00,0,2650.0,2225.0,0.84,12.905,185,13,7,6,172,130,42,0,0.0,0.0
1008,1255,25-09-2019 05:28:00,0,2938.0,2336.0,0.795,14.162,230,60,33,27,170,123,47,0,0.0,0.0
1008,1256,25-09-2019 05:30:00,0,2936.0,2325.0,0.792,14.141,157,90,51,39,67,45,22,55,0.0,0.0
1008,1257,25-09-2019 05:32:00,0,2958.0,2277.0,0.77,14.175,80,55,23,32,25,2,23,71,0.0,0.0
1008,1258,25-09-2019 05:34:00,0,2898.0,2479.0,0.855,14.164,81,66,39,27,15,0,15,73,0.0,0.0
1008,1259,25-09-2019 05:36:00,0,3164.0,2651.0,0.838,15.4,58,46,20,26,12,2,10,62,0.0,0.09
1008,1260,25-09-2019 05:38:00,0,3139.0,2741.0,0.873,15.401,82,58,34,24,24,4,20,48,0.0,0.07
1008,1261,25-09-2019 05:40:00,0,3575.0,2810.0,0.786,17.195,276,146,97,49,130,91,39,103,0.13,0.0
1008,1262,25-09-2019 05:42:00,0,3291.0,2752.0,0.836,16.013,221,159,114,45,62,47,15,43,0.0,0.15
1008,1263,25-09-2019 05:44:00,0,3184.0,2565.0,0.806,15.385,252,143,112,31,109,76,33,80,0.0,0.0
1008,1264,25-09-2019 05:46:00,0,3174.0,2577.0,0.812,15.358,497,278,224,54,219,169,50,80,0.0,0.0
1008,1265,25-09-2019 05:48:00,0,3404.5,2889.5,0.8465,16.6115,653,405,329,76,248,182,66,13,0.0,0.0
1008,1266,25-09-2019 05:50:00,0,3635.0,3202.0,0.881,17.865,514,299,246,53,215,172,43,52,0.0,0.0
1008,1267,25-09-2019 05:52:00,0,3025.0,2571.0,0.85,14.767,70,37,14,23,33,16,17,0,0.0,0.0
1008,1268,25-09-2019 05:54:00,0,2787.0,2329.0,0.835,13.561,193,112,86,26,81,52,29,0,0.0,0.0
1008,1269,25-09-2019 05:56:00,0,2772.0,2386.0,0.861,13.565,377,222,163,59,155,120,35,38,0.0,0.0
1008,1270,25-09-2019 05:58:00,0,3433.0,2794.0,0.814,16.618,606,320,259,61,286,224,62,3,0.0,0.0
1008,1271,25-09-2019 06:00:00,1,2987.0,2704.0,0.905,14.761,257,186,145,41,71,58,13,52,0.0,0.0
1008,1272,25-09-2019 06:02:00,1,3358.0,3078.0,0.917,16.639,342,180,141,39,162,119,43,69,0.0,0.0
1008,1273,25-09-2019 06:04:00,1,3393.0,2953.0,0.87,16.64,243,88,60,28,155,117,38,76,0.0,0.0
1008,1274,25-09-2019 06:06:00,1,3418.0,2849.0,0.834,16.621,89,40,27,13,49,32,17,6,0.0,0.0
1008,1275,25-09-2019 06:08:00,1,3397.0,2922.0,0.86,16.618,167,52,18,34,115,65,50,0,0.0,0.0
1008,1276,25-09-2019 06:10:00,1,3049.0,2470.0,0.81,14.75,300,99,58,41,201,142,59,0,0.0,0.0
1008,1277,25-09-2019 06:12:00,1,3008.0,2651.0,0.881,14.787,355,158,114,44,197,134,63,2,0.0,0.0
1008,1278,25-09-2019 06:14:00,1,3004.0,2631.0,0.876,14.748,332,171,124,47,161,110,51,3,0.0,0.0
1008,1279,25-09-2019 06:16:00,1,2994.0,2664.0,0.89,14.745,114,78,34,44,36,15,21,0,0.0,0.0
1008,1280,25-09-2019 06:18:00,1,3049.0,2484.0,0.814,14.764,124,48,4,44,76,45,31,0,0.0,0.0
1008,1281,25-09-2019 06:20:00,1,3054.0,2499.0,0.818,14.8,369,46,16,30,323,247,76,0,0.0,0.0
1008,1282,25-09-2019 06:22:00,1,2978.5,2474.5,0.831,14.4755,204,55,23,32,149,98,51,0,0.0,0.0
1008,1283,25-09-2019 06:24:00,1,2903.0,2450.0,0.844,14.151,7,0,0,0,7,3,4,0,0.0,0.0
1008,1284,25-09-2019 06:26:00,1,2637.0,2332.0,0.884,12.972,18,1,0,1,17,11,6,0,0.0,0.0
1008,1285,25-09-2019 06:28:00,1,2655.0,2222.0,0.837,12.92,33,5,0,5,28,2,26,0,0.0,0.0
1008,1286,25-09-2019 06:30:00,1,2231.0,2055.0,0.921,11.066,32,1,0,1,31,0,31,0,0.0,0.0
1008,1287,25-09-2019 06:32:00,1,2290.0,1857.0,0.811,11.081,72,7,3,4,65,30,35,0,0.0,0.0
1008,1288,25-09-2019 06:34:00,1,2139.0,1849.0,0.864,10.477,68,0,0,0,68,26,42,0,0.0,0.0
1008,1289,25-09-2019 06:36:00,1,2290.0,1853.0,0.809,11.075,46,0,0,0,46,0,46,0,0.0,0.0
1008,1290,25-09-2019 06:38:00,1,2266.0,1929.0,0.851,11.063,54,0,0,0,54,2,52,0,0.0,0.0
1008,1291,25-09-2019 06:40:00,1,2293.0,1870.0,0.816,11.104,57,0,0,0,57,19,38,0,0.0,0.0
1008,1292,25-09-2019 06:42:00,1,2002.0,1769.0,0.883,9.848,60,11,2,9,49,9,40,0,0.0,0.0
1008,1293,25-09-2019 06:44:00,1,2302.0,1815.0,0.788,11.077,42,0,0,0,42,0,42,0,0.0,0.0
1008,1294,25-09-2019 06:46:00,1,2006.0,1750.0,0.872,9.841,54,1,0,1,53,8,45,0,0.0,0.0
1008,1295,25-09-2019 06:48:00,1,2009.0,1742.0,0.868,9.843,57,1,0,1,56,7,49,0,0.0,0.0
1008,1296,25-09-2019 06:50:00,1,2033.0,1683.0,0.828,9.871,50,0,0,0,50,11,39,0,0.0,0.0
1008,1297,25-09-2019 06:52:00,1,2014.0,1718.0,0.853,9.838,84,3,2,1,81,31,50,0,0.0,0.0
1008,1298,25-09-2019 06:54:00,1,2155.0,1777.0,0.825,10.457,116,1,0,1,115,69,46,0,0.0,0.0
1008,1299,25-09-2019 06:56:00,1,2222.0,1818.0,0.8185,10.768,227,0,0,0,227,154,73,0,0.0,0.0
1008,1300,25-09-2019 06:58:00,1,2289.0,1859.0,0.812,11.079,86,1,0,1,85,31,54,0,0.0,0.0
1008,1301,25-09-2019 07:00:00,1,2290.0,1888.0,0.825,11.111,143,20,9,11,123,67,56,0,0.0,0.0
1008,1302,25-09-2019 07:02:00,1,2287.0,1860.0,0.814,11.069,72,24,0,24,48,9,39,0,0.0,0.0
1008,1303,25-09-2019 07:04:00,1,2307.0,1790.0,0.776,11.073,83,4,0,4,79,39,40,0,0.0,0.0
1008,1304,25-09-2019 07:06:00,1,2295.0,1848.0,0.805,11.091,156,1,0,1,155,107,48,0,0.0,0.0
1008,1305,25-09-2019 07:08:00,1,2266.0,1940.0,0.856,11.077,255,4,1,3,251,212,39,0,0.0,0.0
1008,1306,25-09-2019 07:10:00,1,2251.0,2010.0,0.893,11.096,70,5,0,5,65,17,48,0,0.0,0.0
1008,1307,25-09-2019 07:12:00,1,2286.0,1860.0,0.814,11.065,52,0,0,0,52,17,35,0,0.0,0.0
1008,1308,25-09-2019 07:14:00,1,2291.0,1828.0,0.798,11.051,97,2,0,2,95,52,43,0,0.0,0.0
1008,1309,25-09-2019 07:16:00,1,2290.0,1877.0,0.819,11.101,111,0,0,0,111,87,24,0,0.0,0.0
1008,1310,25-09-2019 07:18:00,1,2168.0,1747.0,0.806,10.475,25,4,0,4,21,11,10,0,0.0,0.0
1008,1311,25-09-2019 07:20:00,1,2019.0,1687.0,0.836,9.823,75,7,2,5,68,21,47,0,0.0,0.0
1008,1312,25-09-2019 07:22:00,1,2047.0,1600.0,0.782,9.836,58,0,0,0,58,19,39,0,0.0,0.0
1008,1313,25-09-2019 07:24:00,1,2059.0,1566.0,0.761,9.847,81,10,4,6,71,31,40,0,0.0,0.0
1008,1314,25-09-2019 07:26:00,1,2037.0,1640.0,0.805,9.84,67,6,4,2,61,18,43,0,0.0,0.0
1008,1315,25-09-2019 07:28:00,1,2035.0,1626.0,0.799,9.82,35,4,2,2,31,0,31,0,0.0,0.0
1008,1316,25-09-2019 07:30:00,1,2031.5,1659.5,0.817,9.8415,3,0,0,0,3,1,2,0,0.0,0.0
1008,1317,25-09-2019 07:32:00,1,2028.0,1693.0,0.835,9.863,209,0,0,0,209,181,28,0,0.0,0.0
1008,1318,25-09-2019 07:34:00,1,2011.0,1737.0,0.864,9.847,279,61,38,23,218,158,60,0,0.0,0.0
1008,1319,25-09-2019 07:36:00,1,2281.0,1894.0,0.831,11.085,34,5,3,2,29,11,18,0,0.0,0.0
1008,1320,25-09-2019 07:38:00,1,2267.0,1917.0,0.845,11.056,59,2,2,0,57,26,31,0,0.0,0.0
1008,1321,25-09-2019 07:40:00,1,2283.0,1898.0,0.831,11.097,50,14,0,14,36,6,30,0,0.0,0.0
1008,1322,25-09-2019 07:42:00,1,2283.0,1883.0,0.825,11.08,121,31,14,17,90,52,38,0,0.0,0.0
1008,1323,25-09-2019 07:44:00,1,2275.0,1905.0,0.837,11.072,460,272,213,59,188,132,56,25,0.0,0.0
1008,1324,25-09-2019 07:46:00,1,2259.0,1961.0,0.868,11.072,709,382,303,79,327,247,80,0,0.0,0.0
1008,1325,25-09-2019 07:48:00,1,2706.0,2036.0,0.752,12.918,487,280,220,60,207,149,58,0,0.0,0.0
1008,1326,25-09-2019 07:50:00,1,2694.0,2065.0,0.767,12.899,444,271,217,54,173,122,51,14,0.0,0.0
1008,1327,25-09-2019 07:52:00,1,2552.0,2009.0,0.787,12.281,208,124,100,24,84,54,30,8,0.0,0.0
1008,1328,25-09-2019 07:54:00,1,2687.0,2084.0,0.776,12.894,207,136,100,36,71,55,16,30,0.0,0.0
1008,1329,25-09-2019 07:56:00,1,2699.0,2042.0,0.757,12.896,280,117,82,35,163,115,48,0,0.0,0.0
1008,1330,25-09-2019 07:58:00,1,2713.0,2005.0,0.739,12.909,508,223,173,50,285,227,58,1,0.0,0.0
1008,1331,25-09-2019 08:00:00,1,2700.0,2049.0,0.759,12.908,394,189,144,45,205,153,52,0,0.0,0.0
1008,1332,25-09-2019 08:02:00,1,2695.0,2077.0,0.771,12.92,265,145,112,33,120,83,37,45,0.0,0.0
1008,1333,25-09-2019 08:04:00,1,2701.5,2044.0,0.7565,12.909,107,41,14,27,66,25,41,0,0.0,0.0
1008,1334,25-09-2019 08:06:00,1,2708.0,2011.0,0.742,12.898,259,114,72,42,145,113,32,0,0.0,0.0
1008,1335,25-09-2019 08:08:00,1,2714.0,2010.0,0.741,12.919,275,74,44,30,201,162,39,1,0.0,0.0
1008,1336,25-09-2019 08:10:00,1,2692.0,2068.0,0.768,12.897,186,81,40,41,105,82,23,0,0.0,0.0
1008,1337,25-09-2019 08:12:00,1,2694.0,2074.0,0.77,12.91,57,43,16,27,14,2,12,0,0.0,0.0
1008,1338,25-09-2019 08:14:00,1,2593.0,1879.0,0.725,12.295,16,0,0,0,16,0,16,0,0.0,0.0
1008,1339,25-09-2019 08:16:00,1,2351.0,1631.0,0.694,11.069,9,6,4,2,3,0,3,0,0.0,0.0
1008,1340,25-09-2019 08:18:00,1,2066.0,1536.0,0.743,9.839,33,27,6,21,6,0,6,0,0.0,0.0
1008,1341,25-09-2019 08:20:00,1,2078.0,1467.0,0.706,9.812,13,11,1,10,2,0,2,0,0.0,0.0
1008,1342,25-09-2019 08:22:00,1,2058.0,1544.0,0.75,9.819,7,6,1,5,1,0,1,0,0.0,0.0
1008,1343,25-09-2019 08:24:00,1,2330.0,1695.0,0.728,11.058,20,19,0,19,1,0,1,0,0.0,0.0
1008,1344,25-09-2019 08:26:00,1,2316.0,1748.0,0.755,11.06,51,22,11,11,29,3,26,0,0.0,0.0
1008,1345,25-09-2019 08:28:00,1,2321.0,1723.0,0.742,11.052,31,12,6,6,19,3,16,0,0.0,0.0
1008,1346,25-09-2019 08:30:00,1,2315.0,1753.0,0.757,11.063,1,0,0,0,1,0,1,0,0.0,0.0
1008,1347,25-09-2019 08:32:00,1,2351.0,1621.0,0.689,11.06,2,0,0,0,2,0,2,0,0.0,0.0
1008,1348,25-09-2019 08:34:00,1,2224.0,1535.0,0.69,10.46,0,0,0,0,0,0,0,0,0.0,0.0
1008,1349,25-09-2019 08:36:00,1,2360.0,1548.0,0.656,11.013,0,0,0,0,0,0,0,0,0.0,0.0
1008,1350,25-09-2019 08:38:00,1,2355.0,1566.0,0.665,11.013,29,13,5,8,16,4,12,0,0.0,0.0
1008,1351,25-09-2019 08:40:00,1,2350.0,1584.0,0.674,11.013,3,1,1,0,2,2,0,0,0.0,0.0
1008,1352,25-09-2019 08:42:00,1,2366.0,1583.0,0.669,11.077,27,16,8,8,11,3,8,0,0.0,0.0
1008,1353,25-09-2019 08:44:00,1,2342.0,1629.0,0.696,11.03,2,2,1,1,0,0,0,0,0.0,0.0
1008,1354,25-09-2019 08:46:00,1,2354.0,1620.0,0.688,11.067,1,1,0,1,0,0,0,0,0.0,0.0
1008,1355,25-09-2019 08:48:00,1,2375.0,1539.0,0.648,11.062,0,0,0,0,0,0,0,0,0.0,0.0
1008,1356,25-09-2019 08:50:00,1,2379.0,1525.0,0.641,11.062,1,1,0,1,0,0,0,0,0.0,0.0
1008,1357,25-09-2019 08:52:00,1,2234.0,1491.0,0.668,10.455,0,0,0,0,0,0,0,0,0.0,0.0
1008,1358,25-09-2019 08:54:00,1,2080.0,1465.0,0.704,9.818,0,0,0,0,0,0,0,0,0.0,0.0
1008,1359,25-09-2019 08:56:00,1,2079.0,1462.0,0.703,9.811,0,0,0,0,0,0,0,0,0.0,0.0
1008,1360,25-09-2019 08:58:00,1,2092.0,1430.0,0.684,9.825,0,0,0,0,0,0,0,0,0.0,0.0
1008,1361,25-09-2019 09:00:00,1,2225.0,1511.0,0.679,10.439,56,11,7,4,45,11,34,0,0.0,0.0
1008,1362,25-09-2019 09:02:00,1,2347.0,1647.0,0.702,11.071,20,0,0,0,20,3,17,0,0.0,0.0
1008,1363,25-09-2019 09:04:00,1,2335.0,1668.0,0.714,11.048,2,0,0,0,2,1,1,0,0.0,0.0
1008,1364,25-09-2019 09:06:00,1,2343.0,1650.0,0.704,11.058,7,0,0,0,7,4,3,0,0.0,0.0
1008,1365,25-09-2019 09:08:00,1,2358.0,1604.0,0.68,11.066,48,0,0,0,48,16,32,0,0.0,0.0
1008,1366,25-09-2019 09:10:00,1,2384.0,1493.0,0.626,11.045,26,0,0,0,26,10,16,0,0.0,0.0
1008,1367,25-09-2019 09:12:00,1,2244.0,1440.0,0.6425,10.436,19,0,0,0,19,10,9,0,0.0,0.0
1008,1368,25-09-2019 09:14:00,1,2104.0,1387.0,0.659,9.827,86,22,15,7,64,37,27,0,0.0,0.0
1008,1369,25-09-2019 09:16:00,1,2358.0,1604.0,0.68,11.067,63,0,0,0,63,14,49,0,0.0,0.0
1008,1370,25-09-2019 09:18:00,1,2765.0,1806.0,0.653,12.895,62,0,0,0,62,14,48,0,0.0,0.0
1008,1371,25-09-2019 09:20:00,1,2620.0,1768.0,0.675,12.28,3,0,0,0,3,0,3,0,0.0,0.0
1008,1372,25-09-2019 09:22:00,1,2477.0,1708.0,0.69,11.652,38,6,5,1,32,4,28,0,0.0,0.0
1008,1373,25-09-2019 09:24:00,1,2482.0,1723.0,0.694,11.687,90,10,6,4,80,37,43,0,0.0,0.0
1008,1374,25-09-2019 09:26:00,1,2356.0,1589.0,0.674,11.044,47,0,0,0,47,1,46,0,0.0,0.0
1008,1375,25-09-2019 09:28:00,1,2378.0,1515.0,0.637,11.045,102,1,1,0,101,50,51,0,0.0,0.0
1008,1376,25-09-2019 09:30:00,1,2379.0,1507.0,0.634,11.043,54,0,0,0,54,5,49,0,0.0,0.0
1008,1377,25-09-2019 09:32:00,1,2394.0,1474.0,0.616,11.064,86,12,5,7,74,39,35,0,0.0,0.0
1008,1378,25-09-2019 09:34:00,1,2347.0,1650.0,0.703,11.074,196,54,23,31,142,84,58,0,0.0,0.0
1008,1379,25-09-2019 09:36:00,1,2495.0,1677.0,0.672,11.687,52,19,10,9,33,15,18,0,0.0,0.0
1008,1380,25-09-2019 09:38:00,1,2355.0,1586.0,0.673,11.036,96,21,6,15,75,41,34,0,0.0,0.0
1008,1381,25-09-2019 09:40:00,1,2363.0,1569.0,0.664,11.048,164,11,1,10,153,95,58,0,0.0,0.0
1008,1382,25-09-2019 09:42:00,1,2359.0,1597.0,0.677,11.065,242,41,18,23,201,141,60,0,0.0,0.0
1008,1383,25-09-2019 09:44:00,1,2627.0,1752.0,0.667,12.291,167,45,17,28,122,74,48,0,0.0,0.0
1008,1384,25-09-2019 09:46:00,1,2695.0,1775.0,0.659,12.585,170,57,36,21,113,72,41,0,0.0,0.0
1008,1385,25-09-2019 09:48:00,1,2763.0,1798.0,0.651,12.879,267,139,89,50,128,69,59,0,0.0,0.0
1008,1386,25-09-2019 09:50:00,1,2750.0,1875.0,0.682,12.911,247,85,45,40,162,114,48,0,0.0,0.0
1008,1387,25-09-2019 09:52:00,1,2727.0,1956.0,0.717,12.91,48,9,0,9,39,0,39,0,0.0,0.0
1008,1388,25-09-2019 09:54:00,1,2752.0,1871.0,0.68,12.914,55,5,2,3,50,12,38,0,0.0,0.0
1008,1389,25-09-2019 09:56:00,1,2779.0,1773.0,0.638,12.912,32,0,0,0,32,0,32,0,0.0,0.0
1008,1390,25-09-2019 09:58:00,1,2341.0,1655.0,0.707,11.056,165,2,1,1,163,104,59,0,0.0,0.0
1008,1391,25-09-2019 10:00:00,1,2354.0,1618.0,0.687,11.067,85,2,0,2,83,44,39,0,0.0,0.0
1008,1392,25-09-2019 10:02:00,1,2355.0,1588.0,0.674,11.037,63,0,0,0,63,24,39,0,0.0,0.0
1008,1393,25-09-2019 10:04:00,1,2359.0,1598.0,0.677,11.065,2,0,0,0,2,0,2,0,0.0,0.0
1008,1394,25-09-2019 10:06:00,1,2359.0,1587.0,0.673,11.051,0,0,0,0,0,0,0,0,0.0,0.0
1008,1395,25-09-2019 10:08:00,1,2508.0,1620.0,0.646,11.674,10,0,0,0,10,6,4,0,0.0,0.0
1008,1396,25-09-2019 10:10:00,1,2512.0,1619.0,0.645,11.691,48,3,2,1,45,15,30,0,0.0,0.0
1008,1397,25-09-2019 10:12:00,1,2358.0,1573.0,0.667,11.034,71,4,1,3,67,15,52,0,0.0,0.0
1008,1398,25-09-2019 10:14:00,1,2651.0,1648.0,0.622,12.271,71,3,1,2,68,29,39,0,0.0,0.0
1008,1399,25-09-2019 10:16:00,1,2798.0,1697.0,0.606,12.905,21,6,2,4,15,7,8,0,0.0,0.0
1008,1400,25-09-2019 10:18:00,1,2791.0,1689.0,0.605,12.865,39,17,12,5,22,15,7,0,0.0,0.0
1008,1401,25-09-2019 10:20:00,1,2421.5,1638.0,0.6895,11.354,8,7,1,6,1,0,1,0,0.0,0.0
1008,1402,25-09-2019 10:22:00,1,2052.0,1587.0,0.774,9.843,80,19,15,4,61,46,15,0,0.0,0.0
1008,1403,25-09-2019 10:24:00,1,2351.0,1609.0,0.684,11.044,49,3,1,2,46,2,44,0,0.0,0.0
1008,1404,25-09-2019 10:26:00,1,2087.0,1474.0,0.706,9.853,37,2,1,1,35,2,33,0,0.0,0.0
1008,1405,25-09-2019 10:28:00,1,2075.0,1494.0,0.72,9.828,49,0,0,0,49,27,22,0,0.0,0.0
1008,1406,25-09-2019 10:30:00,1,2059.0,1534.0,0.745,9.812,113,4,1,3,109,74,35,0,0.0,0.0
1008,1407,25-09-2019 10:32:00,1,2070.0,1508.0,0.729,9.824,113,8,2,6,105,62,43,0,0.0,0.0
1008,1408,25-09-2019 10:34:00,1,2105.0,1396.0,0.663,9.84,155,19,5,14,136,83,53,0,0.0,0.0
1008,1409,25-09-2019 10:36:00,1,2109.0,1369.0,0.649,9.826,271,1,1,0,270,230,40,0,0.0,0.0
1008,1410,25-09-2019 10:38:00,1,1968.0,1300.0,0.661,9.194,224,7,1,6,217,166,51,0,0.0,0.0
1008,1411,25-09-2019 10:40:00,1,2122.0,1323.0,0.624,9.827,98,5,1,4,93,38,55,0,0.0,0.0
1008,1412,25-09-2019 10:42:00,1,2098.0,1410.0,0.672,9.828,162,11,3,8,151,112,39,0,0.0,0.0
1008,1413,25-09-2019 10:44:00,1,2112.0,1346.0,0.637,9.811,127,3,0,3,124,63,61,0,0.0,0.0
1008,1414,25-09-2019 10:46:00,1,2095.0,1394.0,0.665,9.8,375,5,1,4,370,301,69,0,0.0,0.0
1008,1415,25-09-2019 10:48:00,1,2092.0,1458.0,0.697,9.857,222,3,1,2,219,179,40,0,0.0,0.0
1008,1416,25-09-2019 10:50:00,1,2079.0,1451.0,0.698,9.8,18,7,0,7,11,0,11,0,0.0,0.0
1008,1417,25-09-2019 10:52:00,1,2101.0,1387.0,0.66,9.814,262,90,50,40,172,125,47,0,0.0,0.0
1008,1418,25-09-2019 10:54:00,1,2009.0,1449.5,0.7245,9.52,199,41,23,18,158,101,57,0,0.0,0.0
1008,1419,25-09-2019 10:56:00,1,1917.0,1512.0,0.789,9.226,176,8,1,7,168,120,48,0,0.0,0.0
1008,1420,25-09-2019 10:58:00,1,2324.0,1702.0,0.732,11.043,129,89,51,38,40,22,18,40,0.0,0.0
1008,1421,25-09-2019 11:00:00,1,2593.0,1868.0,0.72,12.286,67,48,24,24,19,2,17,66,0.0,0.0
1008,1422,25-09-2019 11:02:00,1,2556.0,2008.0,0.785,12.294,55,47,20,27,8,0,8,46,0.0,0.0
1008,1423,25-09-2019 11:04:00,1,2691.0,2098.0,0.78,12.925,59,40,18,22,19,1,18,57,0.0,0.0
1008,1424,25-09-2019 11:06:00,1,2953.0,2288.0,0.775,14.168,64,40,17,23,24,0,24,48,0.0,0.0
1008,1425,25-09-2019 11:08:00,1,2911.0,2397.0,0.823,14.123,88,61,29,32,27,8,19,70,0.0,0.06
1008,1426,25-09-2019 11:10:00,1,2965.0,2204.0,0.743,14.122,517,266,209,57,251,191,60,44,0.06,0.02
1008,1427,25-09-2019 11:12:00,1,2955.0,2241.0,0.758,14.125,529,264,209,55,265,206,59,27,0.22,0.0
1008,1428,25-09-2019 11:14:00,1,2937.0,2335.0,0.795,14.156,302,142,99,43,160,118,42,0,0.0,0.0
1008,1429,25-09-2019 11:16:00,1,2292.0,1825.0,0.796,11.053,219,110,77,33,109,74,35,32,0.0,0.01
1008,1430,25-09-2019 11:18:00,1,2555.0,2017.0,0.79,12.299,193,16,0,16,177,115,62,0,0.0,0.0
1008,1431,25-09-2019 11:20:00,1,2280.0,1869.0,0.819,11.053,187,21,1,20,166,111,55,0,0.0,0.0
1008,1432,25-09-2019 11:22:00,1,2565.0,1990.0,0.776,12.308,148,20,3,17,128,73,55,0,0.0,0.0
1008,1433,25-09-2019 11:24:00,1,2274.0,1905.0,0.838,11.068,69,10,5,5,59,17,42,0,0.0,0.0
1008,1434,25-09-2019 11:26:00,1,2261.0,1930.0,0.854,11.047,154,0,0,0,154,108,46,0,0.0,0.0
1008,1435,25-09-2019 11:28:00,1,2279.0,1879.5,0.825,11.06,184,0,0,0,184,119,65,0,0.0,0.0
1008,1436,25-09-2019 11:30:00,1,2297.0,1829.0,0.796,11.073,178,0,0,0,178,122,56,0,0.0,0.0
1008,1437,25-09-2019 11:32:00,1,2301.0,1800.0,0.782,11.061,258,0,0,0,258,232,26,0,0.0,0.0
1008,1438,25-09-2019 11:34:00,1,2295.0,1834.0,0.799,11.072,106,1,1,0,105,82,23,0,0.0,0.0
1008,1439,25-09-2019 11:36:00,1,2375.0,2098.0,0.883,11.681,12,0,0,0,12,0,12,0,0.0,0.0
1008,1440,25-09-2019 11:38:00,1,2500.0,2224.0,0.889,12.314,13,0,0,0,13,0,13,0,0.0,0.0
1008,1441,25-09-2019 11:40:00,1,2529.0,2119.0,0.838,12.31,6,0,0,0,6,0,6,0,0.0,0.0
1008,1442,25-09-2019 11:42:00,1,2246.0,2020.0,0.9,11.086,5,0,0,0,5,0,5,0,0.0,0.0
1008,1443,25-09-2019 11:44:00,1,2254.0,1971.0,0.875,11.063,8,3,1,2,5,0,5,0,0.0,0.0
1008,1444,25-09-2019 11:46:00,1,2272.0,1903.0,0.838,11.061,0,0,0,0,0,0,0,0,0.0,0.0
1008,1445,25-09-2019 11:48:00,1,2259.0,1965.0,0.87,11.077,114,25,9,16,89,44,45,0,0.0,0.0
1008,1446,25-09-2019 11:50:00,1,2148.0,1813.0,0.844,10.471,64,3,0,3,61,16,45,0,0.0,0.0
1008,1447,25-09-2019 11:52:00,1,1859.0,1742.0,0.937,9.253,45,2,0,2,43,0,43,0,0.0,0.0
1008,1448,25-09-2019 11:54:00,1,2153.0,1783.0,0.828,10.459,81,19,8,11,62,14,48,0,0.0,0.0
1008,1449,25-09-2019 11:56:00,1,2302.0,1814.0,0.788,11.079,56,15,4,11,41,0,41,0,0.0,0.0
1008,1450,25-09-2019 11:58:00,1,1865.0,1702.0,0.912,9.233,55,14,0,14,41,0,41,0,0.0,0.0
1008,1451,25-09-2019 12:00:00,1,2166.0,1762.0,0.814,10.484,34,0,0,0,34,2,32,0,0.0,0.0
1008,1452,25-09-2019 12:02:00,1,2237.0,1758.0,0.787,10.7595,67,3,0,3,64,15,49,0,0.0,0.0
1008,1453,25-09-2019 12:04:00,1,2308.0,1754.0,0.76,11.035,36,0,0,0,36,10,26,0,0.0,0.0
1008,1454,25-09-2019 12:06:00,1,2315.0,1780.0,0.769,11.093,56,9,3,6,47,18,29,0,0.0,0.0
1008,1455,25-09-2019 12:08:00,1,2163.0,1746.0,0.807,10.455,62,7,4,3,55,12,43,0,0.0,0.0
1008,1456,25-09-2019 12:10:00,1,2015.0,1716.0,0.851,9.84,69,0,0,0,69,24,45,0,0.0,0.0
1008,1457,25-09-2019 12:12:00,1,2174.0,1730.0,0.796,10.482,82,2,0,2,80,37,43,0,0.0,0.0
1008,1458,25-09-2019 12:14:00,1,2446.0,1826.0,0.747,11.658,4,0,0,0,4,0,4,0,0.0,0.0
1008,1459,25-09-2019 12:16:00,1,2441.0,1866.0,0.764,11.685,1,0,0,0,1,1,0,0,0.0,0.0
1008,1460,25-09-2019 12:18:00,1,2446.0,1850.0,0.756,11.686,0,0,0,0,0,0,0,0,0.0,0.0
1008,1461,25-09-2019 12:20:00,1,2452.0,1823.0,0.743,11.679,361,1,1,0,360,326,34,0,0.0,0.0
1008,1462,25-09-2019 12:22:00,1,2023.0,1672.0,0.827,9.823,109,42,25,17,67,46,21,0,0.0,0.0
1008,1463,25-09-2019 12:24:00,1,2312.0,1761.0,0.761,11.058,73,39,20,19,34,21,13,27,0.0,0.02
1008,1464,25-09-2019 12:26:00,1,2403.0,2003.0,0.834,11.685,68,51,23,28,17,1,16,47,0.0,0.04
1008,1465,25-09-2019 12:28:00,1,2683.0,2120.0,0.79,12.919,34,33,9,24,1,0,1,30,0.0,0.06
1008,1466,25-09-2019 12:30:00,1,2680.0,2122.0,0.792,12.911,4,4,2,2,0,0,0,2,0.0,0.36
1008,1467,25-09-2019 12:32:00,1,2670.0,2134.0,0.799,12.883,359,200,152,48,159,117,42,33,0.0,0.0
1008,1468,25-09-2019 12:34:00,1,2534.0,2084.0,0.822,12.292,318,155,113,42,163,108,55,2,0.0,0.0
1008,1469,25-09-2019 12:36:00,1,2529.5,2114.0,0.8355,12.3065,240,70,48,22,170,114,56,0,0.0,0.0
1008,1470,25-09-2019 12:38:00,1,2525.0,2144.0,0.849,12.321,468,259,201,58,209,164,45,28,0.0,0.0
1008,1471,25-09-2019 12:40:00,1,2545.0,2049.0,0.805,12.297,254,122,87,35,132,93,39,38,0.17,0.05
1008,1472,25-09-2019 12:42:00,1,2516.0,2150.0,0.854,12.294,340,204,148,56,136,99,37,3,0.0,0.0
1008,1473,25-09-2019 12:44:00,1,2533.0,2099.0,0.829,12.304,197,106,74,32,91,55,36,0,0.0,0.0
1008,1474,25-09-2019 12:46:00,1,2530.0,2131.0,0.842,12.328,41,0,0,0,41,0,41,0,0.0,0.0
1008,1475,25-09-2019 12:48:00,1,2539.0,2073.0,0.817,12.298,142,46,27,19,96,54,42,0,0.0,0.0
1008,1476,25-09-2019 12:50:00,1,2508.0,2227.0,0.888,12.347,503,220,173,47,283,214,69,2,0.16,0.0
1008,1477,25-09-2019 12:52:00,1,2482.0,2310.0,0.931,12.336,559,313,246,67,246,180,66,0,0.0,0.0
1008,1478,25-09-2019 12:54:00,1,2739.0,2511.0,0.916,13.573,268,133,106,27,135,95,40,2,0.0,0.0
1008,1479,25-09-2019 12:56:00,1,2472.0,2325.0,0.94,12.313,434,188,146,42,246,193,53,0,0.0,0.0
1008,1480,25-09-2019 12:58:00,1,2758.0,2407.0,0.873,13.533,204,104,67,37,100,77,23,0,0.0,0.0
1008,1481,25-09-2019 13:00:00,1,2493.0,2282.0,0.916,12.349,61,42,26,16,19,1,18,0,0.0,0.0
1008,1482,25-09-2019 13:02:00,1,2474.0,2317.0,0.936,12.315,21,11,5,6,10,6,4,0,0.0,0.0
1008,1483,25-09-2019 13:04:00,1,2534.0,2132.0,0.841,12.346,0,0,0,0,0,0,0,0,0.0,0.0
1008,1484,25-09-2019 13:06:00,1,2235.0,2046.0,0.915,11.07,0,0,0,0,0,0,0,0,0.0,0.0
1008,1485,25-09-2019 13:08:00,1,2103.0,1977.0,0.94,10.474,12,8,4,4,4,3,1,0,0.0,0.0
1008,1486,25-09-2019 13:10:00,1,2195.5,1919.0,0.8765,10.7755,5,0,0,0,5,1,4,0,0.0,0.0
1008,1487,25-09-2019 13:12:00,1,2288.0,1861.0,0.813,11.077,1,0,0,0,1,0,1,0,0.0,0.0
1008,1488,25-09-2019 13:14:00,1,2264.0,1964.0,0.867,11.094,51,26,11,15,25,14,11,0,0.0,0.0
1008,1489,25-09-2019 13:16:00,1,2271.0,1936.0,0.852,11.09,7,3,0,3,4,3,1,0,0.0,0.0
1008,1490,25-09-2019 13:18:00,1,2149.0,1799.0,0.837,10.461,2,0,0,0,2,0,2,0,0.0,0.0
1008,1491,25-09-2019 13:20:00,1,2003.0,1751.0,0.874,9.831,17,17,4,13,0,0,0,0,0.0,0.0
1008,1492,25-09-2019 13:22:00,1,2000.0,1774.0,0.887,9.844,180,179,153,26,1,1,0,0,0.0,0.0
1008,1493,25-09-2019 13:24:00,1,2286.0,1872.0,0.819,11.077,1,0,0,0,1,1,0,0,0.0,0.0
1008,1494,25-09-2019 13:26:00,1,2274.0,1929.0,0.848,11.097,1,1,0,1,0,0,0,0,0.0,0.0
1008,1495,25-09-2019 13:28:00,1,2266.0,1918.0,0.847,11.053,2,1,0,1,1,1,0,0,0.0,0.0
1008,1496,25-09-2019 13:30:00,1,2265.0,1946.0,0.859,11.078,21,21,1,20,0,0,0,0,0.0,0.0
1008,1497,25-09-2019 13:32:00,1,2267.0,1938.0,0.855,11.079,46,43,4,39,3,0,3,0,0.0,0.0
1008,1498,25-09-2019 13:34:00,1,2260.0,1973.0,0.873,11.087,46,23,16,7,23,10,13,0,0.0,0.0
1008,1499,25-09-2019 13:36:00,1,2539.0,2073.0,0.816,12.301,1,0,0,0,1,1,0,0,0.0,0.0
1008,1500,25-09-2019 13:38:00,1,2241.0,2024.0,0.903,11.069,2,0,0,0,2,0,2,0,0.0,0.0
1008,1501,25-09-2019 13:40:00,1,2263.0,1968.0,0.87,11.093,32,1,1,0,31,0,31,0,0.0,0.0
1008,1502,25-09-2019 13:42:00,1,2268.0,1932.0,0.852,11.077,16,6,1,5,10,5,5,0,0.0,0.0
1008,1503,25-09-2019 13:44:00,1,2477.5,2020.0,0.818,11.998,1,0,0,0,1,0,1,0,0.0,0.0
1008,1504,25-09-2019 13:46:00,1,2687.0,2108.0,0.784,12.919,148,68,43,25,80,57,23,13,0.0,0.0
1008,1505,25-09-2019 13:48:00,1,2637.0,2276.0,0.863,12.908,313,149,103,46,164,118,46,3,0.01,0.0
1008,1506,25-09-2019 13:50:00,1,2638.0,2278.0,0.863,12.917,34,15,1,14,19,9,10,0,0.0,0.0
1008,1507,25-09-2019 13:52:00,1,2354.0,2179.0,0.926,11.688,54,21,0,21,33,19,14,0,0.0,0.0
1008,1508,25-09-2019 13:54:00,1,2644.0,2255.0,0.853,12.914,74,33,15,18,41,23,18,0,0.0,0.0
1008,1509,25-09-2019 13:56:00,1,2650.0,2249.0,0.849,12.933,34,23,1,22,11,0,11,0,0.0,0.0
1008,1510,25-09-2019 13:58:00,1,2642.0,2277.0,0.862,12.932,64,45,18,27,19,0,19,0,0.0,0.0
1008,1511,25-09-2019 14:00:00,1,2638.0,2289.0,0.868,12.928,48,28,12,16,20,9,11,0,0.0,0.0
1008,1512,25-09-2019 14:02:00,1,2637.0,2289.0,0.868,12.925,10,6,0,6,4,2,2,0,0.0,0.0
1008,1513,25-09-2019 14:04:00,1,2534.0,2094.0,0.826,12.302,2,1,0,1,1,1,0,0,0.0,0.0
1008,1514,25-09-2019 14:06:00,1,2274.0,1917.0,0.843,11.081,3,2,0,2,1,1,0,0,0.0,0.0
1008,1515,25-09-2019 14:08:00,1,2291.0,1855.0,0.81,11.08,0,0,0,0,0,0,0,0,0.0,0.0
1008,1516,25-09-2019 14:10:00,1,2283.0,1856.0,0.813,11.049,1,1,1,0,0,0,0,0,0.0,0.0
1008,1517,25-09-2019 14:12:00,1,2290.0,1849.0,0.807,11.07,3,2,0,2,1,0,1,0,0.0,0.0
1008,1518,25-09-2019 14:14:00,1,2260.0,1978.0,0.876,11.093,0,0,0,0,0,0,0,0,0.0,0.0
1008,1519,25-09-2019 14:16:00,1,2254.0,2020.0,0.896,11.119,2,1,0,1,1,0,1,0,0.0,0.0
1008,1520,25-09-2019 14:18:00,1,2260.0,1981.5,0.8765,11.099,1,0,0,0,1,0,1,0,0.0,0.0
1008,1521,25-09-2019 14:20:00,1,2266.0,1943.0,0.857,11.079,1,0,0,0,1,0,1,0,0.0,0.0
1008,1522,25-09-2019 14:22:00,1,2275.0,1897.0,0.834,11.065,85,16,8,8,69,49,20,0,0.0,0.0
1008,1523,25-09-2019 14:24:00,1,2284.0,1884.0,0.825,11.086,17,1,0,1,16,2,14,0,0.0,0.0
1008,1524,25-09-2019 14:26:00,1,2294.0,1833.0,0.799,11.069,48,2,0,2,46,38,8,0,0.0,0.0
1008,1525,25-09-2019 14:28:00,1,2287.0,1875.0,0.82,11.086,29,0,0,0,29,20,9,0,0.0,0.0
1008,1526,25-09-2019 14:30:00,1,2271.0,1901.0,0.837,11.051,25,2,0,2,23,4,19,0,0.0,0.0
1008,1527,25-09-2019 14:32:00,1,2277.0,1894.0,0.832,11.068,9,2,0,2,7,3,4,0,0.0,0.0
1008,1528,25-09-2019 14:34:00,1,2285.0,1861.0,0.815,11.064,74,16,7,9,58,23,35,0,0.0,0.0
1008,1529,25-09-2019 14:36:00,1,2252.0,1989.0,0.883,11.076,73,0,0,0,73,24,49,0,0.0,0.0
1008,1530,25-09-2019 14:38:00,1,2246.0,2015.0,0.897,11.081,39,2,1,1,37,11,26,0,0.0,0.0
1008,1531,25-09-2019 14:40:00,1,2384.0,2071.0,0.869,11.686,25,0,0,0,25,4,21,0,0.0,0.0
1008,1532,25-09-2019 14:42:00,1,2240.0,2049.0,0.915,11.093,13,0,0,0,13,3,10,0,0.0,0.0
1008,1533,25-09-2019 14:44:00,1,2382.0,2093.0,0.879,11.702,2,0,0,0,2,0,2,0,0.0,0.0
1008,1534,25-09-2019 14:46:00,1,2381.0,2081.0,0.874,11.687,2,0,0,0,2,0,2,0,0.0,0.0
1008,1535,25-09-2019 14:48:00,1,2380.0,2086.0,0.876,11.687,1,0,0,0,1,1,0,0,0.0,0.0
1008,1536,25-09-2019 14:50:00,1,2240.0,2054.0,0.917,11.098,42,0,0,0,42,0,42,0,0.0,0.0
1008,1537,25-09-2019 14:52:00,1,2253.0,1997.0,0.8865,11.088,41,0,0,0,41,5,36,0,0.0,0.0
1008,1538,25-09-2019 14:54:00,1,2266.0,1940.0,0.856,11.078,62,24,19,5,38,27,11,0,0.0,0.0
1008,1539,25-09-2019 14:56:00,1,2287.0,1883.0,0.824,11.094,199,71,33,38,128,74,54,3,0.0,0.0
1008,1540,25-09-2019 14:58:00,1,2232.0,2066.0,0.926,11.08,85,43,16,27,42,15,27,0,0.0,0.0
1008,1541,25-09-2019 15:00:00,1,2228.0,2063.0,0.926,11.063,88,52,20,32,36,10,26,0,0.0,0.0
1008,1542,25-09-2019 15:02:00,1,2524.0,2137.0,0.847,12.311,117,108,76,32,9,3,6,0,0.0,0.0
1008,1543,25-09-2019 15:04:00,1,2646.0,2245.0,0.848,12.913,41,34,21,13,7,2,5,0,0.0,0.0
1008,1544,25-09-2019 15:06:00,1,2666.0,2156.0,0.809,12.89,94,19,7,12,75,38,37,2,0.0,0.0
1008,1545,25-09-2019 15:08:00,1,2642.0,2278.0,0.862,12.931,384,181,132,49,203,153,50,15,0.0,0.0
1008,1546,25-09-2019 15:10:00,1,2635.0,2288.0,0.868,12.915,228,94,67,27,134,97,37,1,0.0,0.0
1008,1547,25-09-2019 15:12:00,1,2389.0,2065.0,0.864,11.7,10,2,0,2,8,2,6,0,0.0,0.0
1008,1548,25-09-2019 15:14:00,1,2287.0,1865.0,0.816,11.076,24,7,0,7,17,0,17,0,0.0,0.0
1008,1549,25-09-2019 15:16:00,1,2012.0,1729.0,0.86,9.84,21,1,0,1,20,4,16,0,0.0,0.0
1008,1550,25-09-2019 15:18:00,1,2028.0,1658.0,0.818,9.827,25,3,1,2,22,3,19,0,0.0,0.0
1008,1551,25-09-2019 15:20:00,1,2023.0,1679.0,0.83,9.829,27,19,0,19,8,2,6,0,0.0,0.0
1008,1552,25-09-2019 15:22:00,1,2310.0,1779.0,0.77,11.071,42,27,0,27,15,9,6,0,0.0,0.0
1008,1553,25-09-2019 15:24:00,1,2453.0,1828.0,0.745,11.69,24,3,0,3,21,9,12,0,0.0,0.0
1008,1554,25-09-2019 15:26:00,1,2294.5,1831.0,0.802,11.0685,23,3,0,3,20,8,12,0,0.0,0.0
1008,1555,25-09-2019 15:28:00,1,2136.0,1834.0,0.859,10.447,28,11,0,11,17,2,15,0,0.0,0.0
1008,1556,25-09-2019 15:30:00,1,2147.0,1798.0,0.837,10.451,42,2,0,2,40,16,24,0,0.0,0.0
1008,1557,25-09-2019 15:32:00,1,2149.0,1815.0,0.845,10.479,6,4,0,4,2,1,1,0,0.0,0.0
1008,1558,25-09-2019 15:34:00,1,2147.0,1816.0,0.846,10.471,0,0,0,0,0,0,0,0,0.0,0.0
1008,1559,25-09-2019 15:36:00,1,2153.0,1810.0,0.841,10.487,31,15,7,8,16,9,7,0,0.0,0.0
1008,1560,25-09-2019 15:38:00,1,2148.0,1796.0,0.836,10.452,7,1,0,1,6,1,5,0,0.0,0.0
1008,1561,25-09-2019 15:40:00,1,2021.0,1722.0,0.852,9.869,72,6,0,6,66,35,31,0,0.0,0.0
1008,1562,25-09-2019 15:42:00,1,2169.0,1741.0,0.802,10.475,38,1,0,1,37,6,31,0,0.0,0.0
1008,1563,25-09-2019 15:44:00,1,2022.0,1703.0,0.842,9.854,56,5,1,4,51,13,38,0,0.0,0.0
1008,1564,25-09-2019 15:46:00,1,2138.0,1819.0,0.851,10.439,96,17,3,14,79,39,40,0,0.0,0.0
1008,1565,25-09-2019 15:48:00,1,2117.0,1931.0,0.912,10.478,135,34,7,27,101,53,48,0,0.0,0.0
1008,1566,25-09-2019 15:50:00,1,2538.0,2075.0,0.817,12.297,150,43,13,30,107,71,36,0,0.0,0.0
1008,1567,25-09-2019 15:52:00,1,2397.0,2017.0,0.842,11.676,25,14,0,14,11,1,10,0,0.0,0.0
1008,1568,25-09-2019 15:54:00,1,2106.0,1957.0,0.929,10.464,51,31,9,22,20,3,17,0,0.0,0.0
1008,1569,25-09-2019 15:56:00,1,2110.0,1941.0,0.92,10.462,118,41,12,29,77,40,37,0,0.0,0.0
1008,1570,25-09-2019 15:58:00,1,2541.0,2052.0,0.808,12.282,1,0,0,0,1,0,1,0,0.0,0.0
1008,1571,25-09-2019 16:00:00,1,2415.0,1955.5,0.81,11.679,33,6,4,2,27,20,7,0,0.0,0.0
1008,1572,25-09-2019 16:02:00,1,2289.0,1859.0,0.812,11.076,3,0,0,0,3,0,3,0,0.0,0.0
1008,1573,25-09-2019 16:04:00,1,2310.0,1778.0,0.77,11.068,44,2,2,0,42,14,28,0,0.0,0.0
1008,1574,25-09-2019 16:06:00,1,2459.0,1772.0,0.721,11.649,42,0,0,0,42,0,42,0,0.0,0.0
1008,1575,25-09-2019 16:08:00,1,2488.0,1669.0,0.671,11.651,64,0,0,0,64,12,52,0,0.0,0.0
1008,1576,25-09-2019 16:10:00,1,2358.0,1602.0,0.679,11.065,64,0,0,0,64,12,52,0,0.0,0.0
1008,1577,25-09-2019 16:12:00,1,2359.0,1578.0,0.669,11.043,42,0,0,0,42,3,39,0,0.0,0.0
1008,1578,25-09-2019 16:14:00,1,2359.0,1585.0,0.672,11.049,62,9,6,3,53,21,32,0,0.0,0.0
1008,1579,25-09-2019 16:16:00,1,2782.0,1750.0,0.629,12.899,207,3,0,3,204,172,32,0,0.0,0.0
1008,1580,25-09-2019 16:18:00,1,2723.0,1980.0,0.727,12.919,168,5,0,5,163,142,21,0,0.0,0.0
1008,1581,25-09-2019 16:20:00,1,2727.0,1930.0,0.708,12.883,141,32,23,9,109,87,22,9,0.0,0.0
1008,1582,25-09-2019 16:22:00,1,2771.0,1773.0,0.64,12.881,17,0,0,0,17,4,13,0,0.0,0.0
1008,1583,25-09-2019 16:24:00,1,2346.0,1624.0,0.692,11.043,7,0,0,0,7,0,7,0,0.0,0.0
1008,1584,25-09-2019 16:26:00,1,2347.0,1618.0,0.689,11.039,33,0,0,0,33,9,24,0,0.0,0.0
1008,1585,25-09-2019 16:28:00,1,2346.0,1634.0,0.696,11.053,320,14,1,13,306,239,67,0,0.0,0.0
1008,1586,25-09-2019 16:30:00,1,2355.0,1614.0,0.685,11.065,38,0,0,0,38,10,28,0,0.0,0.0
1008,1587,25-09-2019 16:32:00,1,2372.0,1514.0,0.639,11.022,33,5,0,5,28,6,22,0,0.0,0.0
1008,1588,25-09-2019 16:34:00,1,2373.0,1531.5,0.6455,11.046,51,1,0,1,50,6,44,0,0.0,0.0
1008,1589,25-09-2019 16:36:00,1,2374.0,1549.0,0.652,11.07,30,1,0,1,29,12,17,0,0.0,0.0
1008,1590,25-09-2019 16:38:00,1,2360.0,1574.0,0.667,11.044,103,9,0,9,94,43,51,0,0.0,0.0
1008,1591,25-09-2019 16:40:00,1,2340.0,1627.0,0.695,11.023,95,0,0,0,95,57,38,0,0.0,0.0
1008,1592,25-09-2019 16:42:00,1,2353.0,1636.0,0.695,11.081,58,4,2,2,54,7,47,0,0.0,0.0
1008,1593,25-09-2019 16:44:00,1,2480.0,1702.0,0.686,11.658,162,65,35,30,97,61,36,0,0.0,0.0
1008,1594,25-09-2019 16:46:00,1,2763.0,1829.0,0.662,12.914,138,63,32,31,75,46,29,0,0.0,0.0
1008,1595,25-09-2019 16:48:00,1,2716.0,1972.0,0.726,12.884,245,99,57,42,146,93,53,25,0.0,0.0
1008,1596,25-09-2019 16:50:00,1,2704.0,2037.0,0.753,12.908,87,64,34,30,23,8,15,69,0.0,0.0
1008,1597,25-09-2019 16:52:00,1,2671.0,2173.0,0.814,12.93,151,114,78,36,37,20,17,68,0.0,0.0
1008,1598,25-09-2019 16:54:00,1,2961.0,2234.0,0.755,14.14,61,43,22,21,18,2,16,73,0.0,0.0
1008,1599,25-09-2019 16:56:00,1,2950.0,2264.0,0.768,14.13,47,36,18,18,11,0,11,58,0.0,0.01
1008,1600,25-09-2019 16:58:00,1,2939.0,2329.0,0.792,14.157,68,54,27,27,14,2,12,82,0.0,0.07
1008,1601,25-09-2019 17:00:00,1,2927.0,2371.0,0.81,14.156,391,171,130,41,220,153,67,1,0.0,0.03
1008,1602,25-09-2019 17:02:00,1,2923.0,2374.0,0.812,14.147,349,197,162,35,152,119,33,13,0.04,0.0
1008,1603,25-09-2019 17:04:00,1,2667.0,2157.0,0.809,12.897,37,25,9,16,12,6,6,0,0.0,0.01
1008,1604,25-09-2019 17:06:00,1,2554.0,2023.0,0.792,12.304,194,99,48,51,95,60,35,0,0.0,0.01
1008,1605,25-09-2019 17:08:00,1,2502.0,1919.0,0.7665,11.984,130,10,2,8,120,64,56,0,0.0,0.01
1008,1606,25-09-2019 17:10:00,1,2450.0,1815.0,0.741,11.664,120,2,1,1,118,77,41,0,0.0,0.0
1008,1607,25-09-2019 17:12:00,1,2177.0,1696.0,0.779,10.455,133,41,26,15,92,45,47,0,0.0,0.0
1008,1608,25-09-2019 17:14:00,1,2425.0,1945.0,0.802,11.708,197,101,77,24,96,65,31,1,0.0,0.0
1008,1609,25-09-2019 17:16:00,1,2451.0,1824.0,0.744,11.678,0,0,0,0,0,0,0,0,0.0,0.0
1008,1610,25-09-2019 17:18:00,1,2175.0,1706.0,0.785,10.458,2,0,0,0,2,0,2,0,0.0,0.0
1008,1611,25-09-2019 17:20:00,1,2166.0,1738.0,0.802,10.456,0,0,0,0,0,0,0,0,0.0,0.0
1008,1612,25-09-2019 17:22:00,1,2158.0,1775.0,0.822,10.467,4,2,1,1,2,1,1,0,0.0,0.0
1008,1613,25-09-2019 17:24:00,1,2453.0,1838.0,0.749,11.701,6,2,1,1,4,1,3,0,0.0,0.0
1008,1614,25-09-2019 17:26:00,1,2445.0,1849.0,0.756,11.679,1,0,0,0,1,1,0,0,0.0,0.0
1008,1615,25-09-2019 17:28:00,1,2455.0,1830.0,0.745,11.7,0,0,0,0,0,0,0,0,0.0,0.0
1008,1616,25-09-2019 17:30:00,1,2448.0,1842.0,0.752,11.685,11,10,1,9,1,1,0,0,0.0,0.0
1008,1617,25-09-2019 17:32:00,1,2422.0,1922.0,0.794,11.67,0,0,0,0,0,0,0,0,0.0,0.0
1008,1618,25-09-2019 17:34:00,1,2420.0,1948.0,0.805,11.692,0,0,0,0,0,0,0,0,0.0,0.0
1008,1619,25-09-2019 17:36:00,1,2410.0,1985.0,0.824,11.692,22,21,2,19,1,0,1,0,0.0,0.0
1008,1620,25-09-2019 17:38:00,1,2394.0,2019.0,0.843,11.67,21,19,1,18,2,1,1,0,0.0,0.0
1008,1621,25-09-2019 17:40:00,1,2414.0,1966.0,0.815,11.686,0,0,0,0,0,0,0,0,0.0,0.0
1008,1622,25-09-2019 17:42:00,1,2412.0,1976.0,0.8195,11.6905,9,9,0,9,0,0,0,0,0.0,0.0
1008,1623,25-09-2019 17:44:00,1,2410.0,1986.0,0.824,11.695,5,2,0,2,3,1,2,0,0.0,0.0
1008,1624,25-09-2019 17:46:00,1,2255.0,1972.0,0.875,11.066,3,0,0,0,3,2,1,0,0.0,0.0
1008,1625,25-09-2019 17:48:00,1,2246.0,2002.0,0.891,11.065,3,1,0,1,2,0,2,0,0.0,0.0
1008,1626,25-09-2019 17:50:00,1,2265.0,1950.0,0.861,11.085,75,21,5,16,54,35,19,0,0.0,0.0
1008,1627,25-09-2019 17:52:00,1,2227.0,2079.0,0.934,11.075,46,26,9,17,20,6,14,0,0.0,0.0
1008,1628,25-09-2019 17:54:00,1,2377.0,2119.0,0.891,11.711,48,38,7,31,10,7,3,0,0.0,0.0
1008,1629,25-09-2019 17:56:00,1,2519.0,2168.0,0.861,12.326,69,26,3,23,43,20,23,0,0.0,0.0
1008,1630,25-09-2019 17:58:00,1,2647.0,2237.0,0.845,12.905,99,77,43,34,22,4,18,0,0.0,0.0
1008,1631,25-09-2019 18:00:00,0,2932.0,2334.0,0.796,14.134,62,40,12,28,22,6,16,0,0.0,0.0
1008,1632,25-09-2019 18:02:00,0,2963.0,2253.0,0.76,14.171,237,118,88,30,119,86,33,58,0.0,0.0
1008,1633,25-09-2019 18:04:00,0,3230.0,2381.0,0.737,15.361,57,43,21,22,14,3,11,64,0.0,0.0
1008,1634,25-09-2019 18:06:00,0,3360.0,2456.0,0.731,15.957,63,41,19,22,22,3,19,58,0.0,0.04
1008,1635,25-09-2019 18:08:00,0,3350.0,2515.0,0.751,15.983,76,59,23,36,17,8,9,64,0.0,0.04
1008,1636,25-09-2019 18:10:00,0,3614.0,2717.0,0.752,17.248,85,62,31,31,23,4,19,54,0.0,0.05
1008,1637,25-09-2019 18:12:00,0,3606.0,2733.0,0.758,17.233,373,203,163,40,170,128,42,67,0.0,0.07
1008,1638,25-09-2019 18:14:00,0,3237.0,2400.0,0.742,15.41,122,83,36,47,39,13,26,0,0.0,0.0
1008,1639,25-09-2019 18:16:00,0,2962.0,2239.0,0.7575,14.15,138,91,49,42,47,21,26,6,0.0,0.0
1008,1640,25-09-2019 18:18:00,0,2687.0,2078.0,0.773,12.89,219,125,94,31,94,62,32,107,0.1,0.0
1008,1641,25-09-2019 18:20:00,0,2948.0,2281.0,0.774,14.142,15,0,0,0,15,6,9,0,0.0,0.0
1008,1642,25-09-2019 18:22:00,0,2716.0,1994.0,0.734,12.91,9,0,0,0,9,2,7,0,0.0,0.0
1008,1643,25-09-2019 18:24:00,0,2582.0,1914.0,0.741,12.291,6,5,1,4,1,0,1,0,0.0,0.0
1008,1644,25-09-2019 18:26:00,0,2430.0,1887.0,0.776,11.665,16,12,5,7,4,1,3,0,0.0,0.0
1008,1645,25-09-2019 18:28:00,0,2599.0,1842.0,0.709,12.279,47,14,6,8,33,10,23,0,0.0,0.0
1008,1646,25-09-2019 18:30:00,0,2728.0,1961.0,0.719,12.92,28,1,1,0,27,2,25,0,0.0,0.0
1008,1647,25-09-2019 18:32:00,0,2723.0,1965.0,0.722,12.906,14,0,0,0,14,2,12,0,0.0,0.0
1008,1648,25-09-2019 18:34:00,0,2727.0,1962.0,0.72,12.916,9,2,0,2,7,0,7,0,0.0,0.0
1008,1649,25-09-2019 18:36:00,0,2716.0,1975.0,0.727,12.888,17,1,0,1,16,0,16,0,0.0,0.0
1008,1650,25-09-2019 18:38:00,0,2694.0,2058.0,0.764,12.893,7,1,1,0,6,2,4,0,0.0,0.0
1008,1651,25-09-2019 18:40:00,0,2691.0,2082.0,0.774,12.909,23,6,3,3,17,7,10,0,0.0,0.0
1008,1652,25-09-2019 18:42:00,0,2682.0,2115.0,0.788,12.911,9,0,0,0,9,3,6,0,0.0,0.0
1008,1653,25-09-2019 18:44:00,0,2687.0,2094.0,0.779,12.906,70,42,15,27,28,12,16,0,0.0,0.0
1008,1654,25-09-2019 18:46:00,0,2951.0,2262.0,0.767,14.13,154,71,40,31,83,39,44,14,0.0,0.0
1008,1655,25-09-2019 18:48:00,0,3339.0,2550.0,0.764,15.98,66,50,20,30,16,1,15,36,0.0,0.0
1008,1656,25-09-2019 18:50:00,0,3447.5,2735.0,0.7925,16.6125,104,70,34,36,34,12,22,78,0.0,0.01
1008,1657,25-09-2019 18:52:00,0,3556.0,2920.0,0.821,17.245,60,47,19,28,13,5,8,41,0.0,0.08
1008,1658,25-09-2019 18:54:00,0,3556.0,2943.0,0.828,17.268,87,74,38,36,13,3,10,55,0.0,0.03
1008,1659,25-09-2019 18:56:00,0,3511.0,3038.0,0.865,17.196,14,11,6,5,3,1,2,8,0.0,0.32
1008,1660,25-09-2019 18:58:00,0,3559.0,2852.0,0.801,17.18,207,104,76,28,103,75,28,29,0.05,0.03
1008,1661,25-09-2019 19:00:00,0,3557.0,2896.0,0.814,17.223,374,198,155,43,176,132,44,48,0.07,0.0
1008,1662,25-09-2019 19:02:00,0,3668.0,3067.0,0.836,17.845,174,99,71,28,75,61,14,73,0.0,0.15
1008,1663,25-09-2019 19:04:00,0,3543.0,2950.0,0.833,17.227,399,262,204,58,137,102,35,55,0.03,0.0
1008,1664,25-09-2019 19:06:00,0,3567.0,2880.0,0.807,17.244,541,314,253,61,227,174,53,30,0.04,0.0
1008,1665,25-09-2019 19:08:00,0,3292.0,2753.0,0.836,16.02,581,244,188,56,337,266,71,7,0.0,0.0
1008,1666,25-09-2019 19:10:00,0,3435.0,2812.0,0.819,16.649,5,2,1,1,3,1,2,0,0.0,0.0
1008,1667,25-09-2019 19:12:00,0,3935.0,3222.0,0.819,19.071,0,0,0,0,0,0,0,0,0.0,0.0
1008,1668,25-09-2019 19:14:00,0,3916.0,3269.0,0.835,19.047,242,114,88,26,128,97,31,11,0.04,0.0
1008,1669,25-09-2019 19:16:00,0,3318.0,2623.0,0.79,15.975,199,69,42,27,130,82,48,4,0.0,0.0
1008,1670,25-09-2019 19:18:00,0,2912.0,2445.0,0.84,14.18,273,27,2,25,246,176,70,0,0.0,0.0
1008,1671,25-09-2019 19:20:00,0,3047.0,2478.0,0.813,14.751,271,37,20,17,234,169,65,0,0.0,0.0
1008,1672,25-09-2019 19:22:00,0,3332.0,2621.0,0.787,16.03,138,33,15,18,105,65,40,0,0.0,0.0
1008,1673,25-09-2019 19:24:00,0,3119.0,2526.5,0.812,15.087,28,12,0,12,16,6,10,0,0.0,0.0
1008,1674,25-09-2019 19:26:00,0,2906.0,2432.0,0.837,14.144,19,5,0,5,14,4,10,0,0.0,0.0
1008,1675,25-09-2019 19:28:00,0,2916.0,2391.0,0.82,14.136,9,0,0,0,9,0,9,0,0.0,0.0
1008,1676,25-09-2019 19:30:00,0,2942.0,2301.0,0.782,14.141,10,4,2,2,6,0,6,0,0.0,0.0
1008,1677,25-09-2019 19:32:00,0,2810.0,2191.0,0.78,13.498,110,20,13,7,90,44,46,0,0.0,0.0
1008,1678,25-09-2019 19:34:00,0,2946.0,2297.0,0.78,14.151,69,0,0,0,69,25,44,0,0.0,0.0
1008,1679,25-09-2019 19:36:00,0,2806.0,2254.0,0.803,13.55,99,9,4,5,90,42,48,0,0.0,0.0
1008,1680,25-09-2019 19:38:00,0,2652.0,2224.0,0.839,12.912,9,4,2,2,5,5,0,0,0.0,0.0
1008,1681,25-09-2019 19:40:00,0,2662.0,2177.0,0.818,12.897,2,0,0,0,2,1,1,0,0.0,0.0
1008,1682,25-09-2019 19:42:00,0,2656.0,2205.0,0.83,12.908,74,23,6,17,51,19,32,0,0.0,0.0
1008,1683,25-09-2019 19:44:00,0,2650.0,2239.0,0.845,12.919,73,5,0,5,68,32,36,0,0.0,0.0
1008,1684,25-09-2019 19:46:00,0,2650.0,2257.0,0.852,12.939,31,7,0,7,24,6,18,0,0.0,0.0
1008,1685,25-09-2019 19:48:00,0,2664.0,2204.0,0.827,12.938,149,11,7,4,138,87,51,0,0.0,0.0
1008,1686,25-09-2019 19:50:00,0,2942.0,2300.0,0.782,14.139,171,23,9,14,148,96,52,0,0.0,0.0
1008,1687,25-09-2019 19:52:00,0,3032.0,2541.0,0.838,14.759,72,27,16,11,45,27,18,0,0.0,0.0
1008,1688,25-09-2019 19:54:00,0,2647.0,2251.0,0.851,12.922,15,6,2,4,9,1,8,0,0.0,0.0
1008,1689,25-09-2019 19:56:00,0,2687.0,2135.0,0.794,12.952,8,5,0,5,3,1,2,0,0.0,0.0
1008,1690,25-09-2019 19:58:00,0,2926.0,2385.0,0.813,14.1705,162,53,21,32,109,63,46,0,0.0,0.0
1008,1691,25-09-2019 20:00:00,0,3165.0,2635.0,0.832,15.389,132,53,20,33,79,40,39,0,0.0,0.0
1008,1692,25-09-2019 20:02:00,0,3151.0,2699.0,0.857,15.402,52,29,9,20,23,12,11,0,0.0,0.0
1008,1693,25-09-2019 20:04:00,0,3131.0,2750.0,0.878,15.38,124,51,18,33,73,37,36,0,0.0,0.0
1008,1694,25-09-2019 20:06:00,0,3124.0,2768.0,0.886,15.373,111,49,26,23,62,26,36,0,0.0,0.0
1008,1695,25-09-2019 20:08:00,0,3123.0,2823.0,0.904,15.432,138,83,43,40,55,27,28,3,0.0,0.0
1008,1696,25-09-2019 20:10:00,0,3388.0,2947.0,0.87,16.611,312,168,140,28,144,100,44,68,0.0,0.0
1008,1697,25-09-2019 20:12:00,0,3368.0,3052.0,0.906,16.649,431,208,145,63,223,171,52,42,0.0,0.0
1008,1698,25-09-2019 20:14:00,0,3136.0,2741.0,0.874,15.389,115,66,35,31,49,38,11,4,0.0,0.0
1008,1699,25-09-2019 20:16:00,0,3140.0,2743.0,0.873,15.409,312,183,142,41,129,85,44,20,0.0,0.0
1008,1700,25-09-2019 20:18:00,0,3419.0,2869.0,0.839,16.647,604,283,225,58,321,242,79,48,0.12,0.0
1008,1701,25-09-2019 20:20:00,0,3263.0,2828.0,0.867,15.987,286,169,125,44,117,96,21,95,0.0,0.0
1008,1702,25-09-2019 20:22:00,0,3426.0,2799.0,0.817,16.599,115,80,42,38,35,24,11,0,0.0,0.0
1008,1703,25-09-2019 20:24:00,0,3281.0,2786.0,0.849,16.011,352,203,144,59,149,115,34,20,0.0,0.0
1008,1704,25-09-2019 20:26:00,0,3276.0,2802.0,0.855,16.01,332,212,161,51,120,81,39,62,0.0,0.0
1008,1705,25-09-2019 20:28:00,0,3416.0,2850.0,0.834,16.613,112,95,54,41,17,12,5,79,0.0,0.0
1008,1706,25-09-2019 20:30:00,0,3386.0,2951.0,0.871,16.609,64,57,25,32,7,4,3,58,0.0,0.0
1008,1707,25-09-2019 20:32:00,0,3515.0,3047.0,0.8665,17.224,114,86,51,35,28,5,23,74,0.0,0.0
1008,1708,25-09-2019 20:34:00,0,3644.0,3143.0,0.862,17.839,193,135,85,50,58,39,19,46,0.0,0.0
1008,1709,25-09-2019 20:36:00,0,3127.0,2750.0,0.88,15.365,78,35,10,25,43,28,15,0,0.0,0.0
1008,1710,25-09-2019 20:38:00,0,2407.0,2029.0,0.843,11.731,4,2,0,2,2,0,2,0,0.0,0.0
1008,1711,25-09-2019 20:40:00,0,2759.0,2397.0,0.869,13.522,15,0,0,0,15,1,14,0,0.0,0.0
1008,1712,25-09-2019 20:42:00,0,2629.0,2353.0,0.895,12.963,64,13,2,11,51,2,49,0,0.0,0.0
1008,1713,25-09-2019 20:44:00,0,2638.0,2279.0,0.864,12.916,29,10,5,5,19,4,15,0,0.0,0.0
1008,1714,25-09-2019 20:46:00,0,2621.0,2318.0,0.884,12.893,31,0,0,0,31,0,31,0,0.0,0.0
1008,1715,25-09-2019 20:48:00,0,2638.0,2269.0,0.86,12.907,56,34,1,33,22,2,20,0,0.0,0.0
1008,1716,25-09-2019 20:50:00,0,2658.0,2207.0,0.83,12.916,30,6,0,6,24,0,24,0,0.0,0.0
1008,1717,25-09-2019 20:52:00,0,2374.0,2139.0,0.901,11.721,10,5,2,3,5,2,3,0,0.0,0.0
1008,1718,25-09-2019 20:54:00,0,2365.0,2158.0,0.913,11.706,35,29,7,22,6,0,6,0,0.0,0.0
1008,1719,25-09-2019 20:56:00,0,2369.0,2128.0,0.898,11.69,16,8,2,6,8,0,8,0,0.0,0.0
1008,1720,25-09-2019 20:58:00,0,2402.0,2036.0,0.848,11.717,19,0,0,0,19,0,19,0,0.0,0.0
1008,1721,25-09-2019 21:00:00,0,2382.0,2068.0,0.868,11.673,45,18,14,4,27,19,8,0,0.0,0.0
1008,1722,25-09-2019 21:02:00,0,2374.0,2095.0,0.883,11.674,42,0,0,0,42,4,38,0,0.0,0.0
1008,1723,25-09-2019 21:04:00,0,2400.0,2035.0,0.848,11.707,155,2,0,2,153,120,33,0,0.0,0.0
1008,1724,25-09-2019 21:06:00,0,2320.5,2023.0,0.8725,11.3825,173,5,2,3,168,149,19,0,0.0,0.0
1008,1725,25-09-2019 21:08:00,0,2241.0,2011.0,0.897,11.058,11,3,0,3,8,2,6,0,0.0,0.0
1008,1726,25-09-2019 21:10:00,0,2242.0,2050.0,0.914,11.103,13,8,2,6,5,3,2,0,0.0,0.0
1008,1727,25-09-2019 21:12:00,0,2220.0,2114.0,0.952,11.086,17,0,0,0,17,2,15,0,0.0,0.0
1008,1728,25-09-2019 21:14:00,0,2226.0,2107.0,0.947,11.105,81,0,0,0,81,45,36,0,0.0,0.0
1008,1729,25-09-2019 21:16:00,0,2226.0,2093.0,0.94,11.087,134,1,0,1,133,112,21,0,0.0,0.0
1008,1730,25-09-2019 21:18:00,0,2250.0,1982.0,0.881,11.059,206,0,0,0,206,172,34,0,0.0,0.0
1008,1731,25-09-2019 21:20:00,0,2254.0,1985.0,0.881,11.078,248,100,65,35,148,96,52,10,0.0,0.0
1008,1732,25-09-2019 21:22:00,0,2449.0,2434.0,0.994,12.343,92,67,38,29,25,5,20,56,0.0,0.0
1008,1733,25-09-2019 21:24:00,0,2838.0,2717.0,0.958,14.189,89,71,35,36,18,2,16,61,0.0,0.02
1008,1734,25-09-2019 21:26:00,0,3124.0,2773.0,0.887,15.379,66,62,34,28,4,2,2,64,0.0,0.0
1008,1735,25-09-2019 21:28:00,0,3126.0,2825.0,0.904,15.446,59,39,17,22,20,1,19,63,0.0,0.03
1008,1736,25-09-2019 21:30:00,0,3386.0,2993.0,0.884,16.654,142,76,44,32,66,47,19,43,0.09,0.08
1008,1737,25-09-2019 21:32:00,0,3106.0,2845.0,0.916,15.387,185,124,97,27,61,29,32,59,0.0,0.05
1008,1738,25-09-2019 21:34:00,0,3398.0,2954.0,0.869,16.658,78,61,36,25,17,4,13,46,0.0,0.01
1008,1739,25-09-2019 21:36:00,0,3523.0,3012.0,0.855,17.216,137,109,70,39,28,3,25,44,0.0,0.0
1008,1740,25-09-2019 21:38:00,0,3521.0,3026.0,0.859,17.225,79,59,38,21,20,1,19,39,0.0,0.09
1008,1741,25-09-2019 21:40:00,0,3311.0,2942.5,0.8905,16.305,432,251,197,54,181,138,43,50,0.13,0.02
1008,1742,25-09-2019 21:42:00,0,3101.0,2859.0,0.922,15.385,316,223,167,56,93,70,23,43,0.0,0.01
1008,1743,25-09-2019 21:44:00,0,3261.0,2869.0,0.88,16.026,544,358,281,77,186,132,54,17,0.0,0.01
1008,1744,25-09-2019 21:46:00,0,3610.0,3250.0,0.9,17.822,221,111,79,32,110,77,33,7,0.0,0.07
1008,1745,25-09-2019 21:48:00,0,3475.0,3215.0,0.925,17.249,695,380,309,71,315,235,80,6,0.0,0.0
1008,1746,25-09-2019 21:50:00,0,3760.0,3299.0,0.877,18.468,430,267,215,52,163,119,44,77,0.0,0.0
1008,1747,25-09-2019 21:52:00,0,3485.0,3154.0,0.905,17.222,85,55,34,21,30,14,16,55,0.0,0.0
1008,1748,25-09-2019 21:54:00,0,3871.0,3450.0,0.891,19.07,96,63,42,21,33,10,23,56,0.0,0.0
1008,1749,25-09-2019 21:56:00,0,3902.0,3371.0,0.864,19.105,231,110,79,31,121,85,36,41,0.24,0.0
1008,1750,25-09-2019 21:58:00,0,3250.0,2871.0,0.883,15.984,72,13,2,11,59,39,20,0,0.0,0.0
1008,1751,25-09-2019 22:00:00,0,3512.0,3067.0,0.873,17.233,154,35,11,24,119,71,48,0,0.0,0.0
1008,1752,25-09-2019 22:02:00,0,3503.0,3076.0,0.878,17.205,97,70,31,39,27,4,23,0,0.0,0.0
1008,1753,25-09-2019 22:04:00,0,3257.0,2924.0,0.898,16.069,126,100,47,53,26,9,17,0,0.0,0.01
1008,1754,25-09-2019 22:06:00,0,3122.0,2803.0,0.898,15.402,107,71,36,35,36,14,22,0,0.0,0.0
1008,1755,25-09-2019 22:08:00,0,3252.0,2905.0,0.893,16.03,120,68,33,35,52,0,52,0,0.0,0.0
1008,1756,25-09-2019 22:10:00,0,3114.0,2805.0,0.901,15.374,253,201,134,67,52,2,50,0,0.0,0.0
1008,1757,25-09-2019 22:12:00,0,3150.0,2699.0,0.857,15.399,199,153,97,56,46,0,46,0,0.0,0.0
1008,1758,25-09-2019 22:14:00,0,3018.0,2599.0,0.8615,14.7685,32,1,1,0,31,0,31,0,0.0,0.0
1008,1759,25-09-2019 22:16:00,0,2886.0,2499.0,0.866,14.138,98,41,22,19,57,14,43,0,0.0,0.0
1008,1760,25-09-2019 22:18:00,0,2901.0,2489.0,0.858,14.187,49,6,2,4,43,0,43,0,0.0,0.0
1008,1761,25-09-2019 22:20:00,0,2636.0,2318.0,0.879,12.953,67,7,2,5,60,10,50,0,0.0,0.0
1008,1762,25-09-2019 22:22:00,0,2473.0,2304.0,0.931,12.296,45,0,0,0,45,0,45,0,0.0,0.0
1008,1763,25-09-2019 22:24:00,0,2476.0,2321.0,0.937,12.324,41,0,0,0,41,0,41,0,0.0,0.0
1008,1764,25-09-2019 22:26:00,0,2624.0,2355.0,0.897,12.947,67,17,11,6,50,15,35,0,0.0,0.0
1008,1765,25-09-2019 22:28:00,0,2621.0,2337.0,0.892,12.914,1,0,0,0,1,1,0,0,0.0,0.01
1008,1766,25-09-2019 22:30:00,0,2489.0,2286.0,0.919,12.335,24,17,8,9,7,2,5,0,0.0,0.0
1008,1767,25-09-2019 22:32:00,0,2880.0,2568.0,0.892,14.189,142,57,32,25,85,51,34,0,0.0,0.0
1008,1768,25-09-2019 22:34:00,0,2873.0,2568.0,0.894,14.162,208,64,28,36,144,88,56,0,0.0,0.0
1008,1769,25-09-2019 22:36:00,0,2849.0,2631.0,0.924,14.137,149,99,56,43,50,34,16,11,0.0,0.0
1008,1770,25-09-2019 22:38:00,0,3142.0,2754.0,0.877,15.428,91,56,35,21,35,13,22,65,0.0,0.0
1008,1771,25-09-2019 22:40:00,0,3103.0,2913.0,0.939,15.449,60,46,23,23,14,2,12,59,0.0,0.08
1008,1772,25-09-2019 22:42:00,0,3510.0,3089.0,0.88,17.249,62,47,19,28,15,1,14,41,0.0,0.07
1008,1773,25-09-2019 22:44:00,0,3490.0,3139.0,0.899,17.227,88,80,50,30,8,1,7,38,0.0,0.05
1008,1774,25-09-2019 22:46:00,0,3482.0,3179.0,0.913,17.239,76,57,25,32,19,11,8,29,0.0,0.09
1008,1775,25-09-2019 22:48:00,0,3432.5,3068.0,0.8935,16.9215,12,11,3,8,1,0,1,3,0.0,0.14
1008,1776,25-09-2019 22:50:00,0,3383.0,2957.0,0.874,16.604,311,156,126,30,155,113,42,20,0.07,0.0
1008,1777,25-09-2019 22:52:00,0,3147.0,2711.0,0.861,15.402,523,283,227,56,240,186,54,81,0.06,0.0
1008,1778,25-09-2019 22:54:00,0,3607.0,3283.0,0.91,17.848,565,323,254,69,242,189,53,93,0.0,0.0
1008,1779,25-09-2019 22:56:00,0,3007.0,2672.0,0.889,14.806,420,210,159,51,210,157,53,81,0.0,0.03
1008,1780,25-09-2019 22:58:00,0,3757.0,3282.0,0.873,18.438,340,175,131,44,165,128,37,37,0.0,0.21
1008,1781,25-09-2019 23:00:00,0,3504.0,3096.0,0.883,17.234,3,0,0,0,3,1,2,0,0.0,0.0
1008,1782,25-09-2019 23:02:00,0,3532.0,2987.0,0.846,17.223,2,0,0,0,2,0,2,0,0.0,0.01
1008,1783,25-09-2019 23:04:00,0,3511.0,3092.0,0.881,17.257,347,167,127,40,180,134,46,12,0.12,0.0
1008,1784,25-09-2019 23:06:00,0,3477.0,3240.0,0.932,17.287,94,22,3,19,72,32,40,0,0.0,0.0
1008,1785,25-09-2019 23:08:00,0,3476.0,3173.0,0.913,17.208,62,9,1,8,53,15,38,0,0.0,0.0
1008,1786,25-09-2019 23:10:00,0,3260.0,2891.0,0.887,16.047,87,34,13,21,53,31,22,0,0.0,0.0
1008,1787,25-09-2019 23:12:00,0,3523.0,3036.0,0.862,17.24,368,237,186,51,131,91,40,10,0.06,0.0
1008,1788,25-09-2019 23:14:00,0,3485.0,3190.0,0.915,17.264,293,158,111,47,135,89,46,1,0.0,0.0
1008,1789,25-09-2019 23:16:00,0,3498.0,3101.0,0.886,17.217,170,76,43,33,94,73,21,0,0.0,0.01
1008,1790,25-09-2019 23:18:00,0,3481.0,3188.0,0.916,17.245,272,179,137,42,93,72,21,109,0.0,0.0
1008,1791,25-09-2019 23:20:00,0,3346.0,3115.0,0.931,16.633,502,269,200,69,233,173,60,13,0.0,0.04
1008,1792,25-09-2019 23:22:00,0,3282.0,3069.0,0.935,16.3305,261,146,107,39,115,75,40,1,0.0,0.0
1008,1793,25-09-2019 23:24:00,0,3218.0,3023.0,0.939,16.028,575,310,234,76,265,204,61,4,0.0,0.0
1008,1794,25-09-2019 23:26:00,0,3507.0,3103.0,0.885,17.254,343,208,163,45,135,99,36,66,0.0,0.0
1008,1795,25-09-2019 23:28:00,0,3497.0,3103.0,0.887,17.214,312,184,139,45,128,107,21,216,0.0,0.0
1008,1796,25-09-2019 23:30:00,0,3496.0,3114.0,0.891,17.223,298,175,133,42,123,95,28,154,0.15,0.0
1008,1797,25-09-2019 23:32:00,0,3521.0,3058.0,0.869,17.257,79,38,13,25,41,21,20,0,0.0,0.0
1008,1798,25-09-2019 23:34:00,0,3498.0,3112.0,0.89,17.228,180,31,10,21,149,113,36,0,0.0,0.0
1008,1799,25-09-2019 23:36:00,0,3492.0,3165.0,0.906,17.263,55,41,14,27,14,7,7,0,0.0,0.0
1008,1800,25-09-2019 23:38:00,0,3504.0,3121.0,0.891,17.26,15,15,5,10,0,0,0,0,0.0,0.0
1008,1801,25-09-2019 23:40:00,0,3085.0,2932.0,0.951,15.4,5,5,1,4,0,0,0,0,0.0,0.0
1008,1802,25-09-2019 23:42:00,0,3096.0,2921.0,0.943,15.431,4,4,2,2,0,0,0,0,0.0,0.0
1008,1803,25-09-2019 23:44:00,0,2985.0,2728.0,0.914,14.779,2,0,0,0,2,1,1,0,0.0,0.0
1008,1804,25-09-2019 23:46:00,0,2866.0,2584.0,0.902,14.152,0,0,0,0,0,0,0,0,0.0,0.0
1008,1805,25-09-2019 23:48:00,0,2481.0,2335.0,0.941,12.361,43,29,14,15,14,9,5,0,0.0,0.0
1008,1806,25-09-2019 23:50:00,0,2483.0,2282.0,0.919,12.307,9,8,3,5,1,1,0,0,0.0,0.0
1008,1807,25-09-2019 23:52:00,0,2220.0,2100.0,0.946,11.073,0,0,0,0,0,0,0,0,0.0,0.0
1008,1808,25-09-2019 23:54:00,0,2249.0,2000.0,0.889,11.075,2,2,0,2,0,0,0,0,0.0,0.0
1008,1809,25-09-2019 23:56:00,0,2445.0,2132.5,0.873,11.995,85,38,19,19,47,35,12,0,0.0,0.0
1008,1810,25-09-2019 23:58:00,0,2641.0,2265.0,0.857,12.915,599,316,230,86,283,205,78,0,0.0,0.0
1008,1811,26-09-2019 00:00:00,0,3361.0,2488.0,0.74,15.999,1004,540,427,113,464,355,109,7,0.0,0.0
1008,1812,26-09-2019 00:02:00,0,3356.0,2517.0,0.75,16.009,1541,734,595,139,807,663,144,9,0.0,0.0
1008,1813,26-09-2019 00:04:00,0,3588.0,2768.0,0.771,17.203,288,127,104,23,161,127,34,11,0.0,0.0
1008,1814,26-09-2019 00:06:00,0,3420.0,2828.0,0.827,16.606,675,368,296,72,307,229,78,68,0.0,0.0
1008,1815,26-09-2019 00:08:00,0,3318.0,2633.0,0.794,15.987,738,431,346,85,307,232,75,20,0.0,0.0
1008,1816,26-09-2019 00:10:00,0,3559.0,2877.0,0.808,17.208,392,246,198,48,146,105,41,87,0.0,0.01
1008,1817,26-09-2019 00:12:00,0,3545.0,2918.0,0.823,17.2,360,235,184,51,125,89,36,48,0.0,0.01
1008,1818,26-09-2019 00:14:00,0,3978.0,3124.0,0.785,19.131,211,127,86,41,84,53,31,18,0.0,0.01
1008,1819,26-09-2019 00:16:00,0,3990.0,2937.0,0.736,18.973,488,265,212,53,223,160,63,15,0.0,0.0
1008,1820,26-09-2019 00:18:00,0,3745.0,2835.0,0.757,17.894,211,132,96,36,79,53,26,113,0.0,0.0
1008,1821,26-09-2019 00:20:00,0,3976.0,3051.0,0.767,19.045,735,466,386,80,269,215,54,9,0.0,0.0
1008,1822,26-09-2019 00:22:00,0,3970.0,3054.0,0.769,19.022,135,100,66,34,35,24,11,25,0.0,0.0
1008,1823,26-09-2019 00:24:00,0,3573.0,2847.0,0.797,17.229,138,74,54,20,64,49,15,7,0.0,0.0
1008,1824,26-09-2019 00:26:00,0,3986.0,3038.0,0.762,19.068,301,153,112,41,148,113,35,18,0.0,0.0
1008,1825,26-09-2019 00:28:00,0,3564.0,2862.0,0.803,17.21,399,244,179,65,155,112,43,5,0.07,0.0
1008,1826,26-09-2019 00:30:00,0,3555.0,2914.5,0.82,17.234,615,301,237,64,314,239,75,32,0.0,0.0
1008,1827,26-09-2019 00:32:00,0,3546.0,2967.0,0.837,17.258,96,56,33,23,40,21,19,31,0.0,0.0
1008,1828,26-09-2019 00:34:00,0,3512.0,3053.0,0.869,17.218,58,49,22,27,9,1,8,62,0.0,0.0
1008,1829,26-09-2019 00:36:00,0,3490.0,3120.0,0.894,17.204,65,52,21,31,13,7,6,56,0.0,0.0
1008,1830,26-09-2019 00:38:00,0,3486.0,3206.0,0.92,17.284,142,105,66,39,37,21,16,54,0.0,0.0
1008,1831,26-09-2019 00:40:00,0,3503.0,3103.0,0.886,17.239,481,299,239,60,182,130,52,36,0.0,0.0
1008,1832,26-09-2019 00:42:00,0,3475.0,3201.0,0.921,17.235,457,240,185,55,217,162,55,17,0.0,0.07
1008,1833,26-09-2019 00:44:00,0,3171.0,2618.0,0.826,15.392,361,154,125,29,207,154,53,29,0.0,0.0
1008,1834,26-09-2019 00:46:00,0,3406.0,2893.0,0.849,16.623,58,28,18,10,30,3,27,46,0.0,0.0
1008,1835,26-09-2019 00:48:00,0,3768.0,3221.0,0.855,18.413,194,93,63,30,101,64,37,37,0.04,0.0
1008,1836,26-09-2019 00:50:00,0,3264.0,2870.0,0.879,16.038,885,342,274,68,543,467,76,5,0.0,0.0
1008,1837,26-09-2019 00:52:00,0,2893.0,2478.0,0.857,14.143,756,369,286,83,387,320,67,4,0.0,0.02
1008,1838,26-09-2019 00:54:00,0,3546.0,2955.0,0.833,17.244,608,336,262,74,272,215,57,26,0.0,0.09
1008,1839,26-09-2019 00:56:00,0,3143.0,2750.0,0.875,15.427,330,173,134,39,157,106,51,2,0.0,0.0
1008,1840,26-09-2019 00:58:00,0,3127.0,2763.0,0.884,15.381,394,222,168,54,172,134,38,1,0.0,0.0
1008,1841,26-09-2019 01:00:00,0,2883.0,2553.0,0.885,14.185,28,23,0,23,5,0,5,0,0.0,0.0
1008,1842,26-09-2019 01:02:00,0,2905.0,2450.0,0.843,14.158,137,102,57,45,35,12,23,0,0.0,0.0
1008,1843,26-09-2019 01:04:00,0,3034.0,2547.0,0.8395,14.7735,52,14,6,8,38,11,27,0,0.0,0.0
1008,1844,26-09-2019 01:06:00,0,3163.0,2644.0,0.836,15.389,53,37,5,32,16,1,15,0,0.0,0.0
1008,1845,26-09-2019 01:08:00,0,3017.0,2618.0,0.868,14.785,28,20,2,18,8,4,4,0,0.0,0.0
1008,1846,26-09-2019 01:10:00,0,2886.0,2533.0,0.878,14.175,1,1,0,1,0,0,0,0,0.0,0.0
1008,1847,26-09-2019 01:12:00,0,2905.0,2461.0,0.847,14.171,29,14,4,10,15,10,5,0,0.0,0.0
1008,1848,26-09-2019 01:14:00,0,2891.0,2460.0,0.851,14.113,23,11,6,5,12,10,2,0,0.0,0.0
1008,1849,26-09-2019 01:16:00,0,2898.0,2506.0,0.865,14.192,3,2,0,2,1,0,1,0,0.0,0.0
1008,1850,26-09-2019 01:18:00,0,2882.0,2504.0,0.869,14.126,3,1,0,1,2,1,1,0,0.0,0.0
1008,1851,26-09-2019 01:20:00,0,2908.0,2429.0,0.835,14.148,12,9,1,8,3,0,3,0,0.0,0.0
1008,1852,26-09-2019 01:22:00,0,2483.0,2277.0,0.917,12.306,3,2,1,1,1,0,1,0,0.0,0.0
1008,1853,26-09-2019 01:24:00,0,2513.0,2164.0,0.861,12.297,152,79,53,26,73,50,23,0,0.0,0.0
1008,1854,26-09-2019 01:26:00,0,2510.0,2189.0,0.872,12.311,655,352,280,72,303,230,73,7,0.0,0.0
1008,1855,26-09-2019 01:28:00,0,2785.0,2329.0,0.836,13.552,131,93,57,36,38,25,13,44,0.0,0.0
1008,1856,26-09-2019 01:30:00,0,2636.0,2312.0,0.877,12.944,280,130,84,46,150,99,51,14,0.0,0.0
1008,1857,26-09-2019 01:32:00,0,2513.0,2184.0,0.869,12.321,607,305,246,59,302,231,71,22,0.0,0.0
1008,1858,26-09-2019 01:34:00,0,3191.0,2527.0,0.792,15.369,488,266,213,53,222,169,53,51,0.0,0.0
1008,1859,26-09-2019 01:36:00,0,3209.0,2477.0,0.772,15.387,541,287,222,65,254,186,68,14,0.0,0.0
1008,1860,26-09-2019 01:38:00,0,3247.5,2599.5,0.8005,15.674,168,98,58,40,70,49,21,40,0.0,0.0
1008,1861,26-09-2019 01:40:00,0,3286.0,2722.0,0.829,15.961,65,52,26,26,13,2,11,46,0.0,0.0
1008,1862,26-09-2019 01:42:00,0,3266.0,2832.0,0.867,16.003,79,49,24,25,30,3,27,48,0.0,0.0
1008,1863,26-09-2019 01:44:00,0,3687.0,3016.0,0.818,17.866,70,59,28,31,11,4,7,42,0.0,0.0
1008,1864,26-09-2019 01:46:00,0,3687.0,3009.0,0.816,17.857,231,153,107,46,78,56,22,44,0.0,0.0
1008,1865,26-09-2019 01:48:00,0,3159.0,2654.0,0.84,15.387,55,46,7,39,9,2,7,0,0.0,0.01
1008,1866,26-09-2019 01:50:00,0,3026.0,2570.0,0.849,14.767,44,34,19,15,10,0,10,0,0.0,0.0
1008,1867,26-09-2019 01:52:00,0,2925.0,2383.0,0.815,14.163,56,56,0,56,0,0,0,0,0.0,0.0
1008,1868,26-09-2019 01:54:00,0,2663.0,2193.0,0.823,12.922,35,32,3,29,3,0,3,0,0.0,0.0
1008,1869,26-09-2019 01:56:00,0,2669.0,2134.0,0.799,12.879,7,3,1,2,4,0,4,0,0.0,0.0
1008,1870,26-09-2019 01:58:00,0,2803.0,2251.0,0.803,13.536,2,0,0,0,2,0,2,0,0.0,0.0
1008,1871,26-09-2019 02:00:00,0,2796.0,2270.0,0.812,13.528,0,0,0,0,0,0,0,0,0.0,0.0
1008,1872,26-09-2019 02:02:00,0,2951.0,2300.0,0.779,14.175,0,0,0,0,0,0,0,0,0.0,0.0
1008,1873,26-09-2019 02:04:00,0,2957.0,2227.0,0.753,14.119,8,4,0,4,4,0,4,0,0.0,0.0
1008,1874,26-09-2019 02:06:00,0,2660.0,2214.0,0.832,12.932,0,0,0,0,0,0,0,0,0.0,0.0
1008,1875,26-09-2019 02:08:00,0,2666.0,2196.0,0.824,12.934,2,2,0,2,0,0,0,0,0.0,0.0
1008,1876,26-09-2019 02:10:00,0,2791.0,2245.0,0.804,13.482,0,0,0,0,0,0,0,0,0.0,0.0
1008,1877,26-09-2019 02:12:00,0,2561.0,2274.5,0.896,12.608,0,0,0,0,0,0,0,0,0.0,0.0
1008,1878,26-09-2019 02:14:00,0,2331.0,2304.0,0.988,11.734,3,1,0,1,2,0,2,0,0.0,0.0
1008,1879,26-09-2019 02:16:00,0,2319.0,2321.0,1.001,11.706,21,9,5,4,12,0,12,0,0.0,0.0
1008,1880,26-09-2019 02:18:00,0,2215.0,2152.0,0.972,11.108,2,1,0,1,1,0,1,0,0.0,0.0
1008,1881,26-09-2019 02:20:00,0,2217.0,2122.0,0.957,11.082,8,3,1,2,5,0,5,0,0.0,0.0
1008,1882,26-09-2019 02:22:00,0,2237.0,2072.0,0.926,11.107,9,0,0,0,9,0,9,0,0.0,0.01
1008,1883,26-09-2019 02:24:00,0,2224.0,2117.0,0.952,11.105,2,0,0,0,2,0,2,0,0.0,0.0
1008,1884,26-09-2019 02:26:00,0,2212.0,2112.0,0.955,11.052,3,0,0,0,3,0,3,0,0.0,0.0
1008,1885,26-09-2019 02:28:00,0,2235.0,2043.0,0.914,11.068,1,0,0,0,1,0,1,0,0.0,0.0
1008,1886,26-09-2019 02:30:00,0,2099.0,1994.0,0.95,10.479,1,0,0,0,1,0,1,0,0.0,0.0
1008,1887,26-09-2019 02:32:00,0,1976.0,1887.0,0.955,9.876,34,26,11,15,8,2,6,0,0.0,0.0
1008,1888,26-09-2019 02:34:00,0,2229.0,2055.0,0.922,11.058,41,20,2,18,21,7,14,0,0.0,0.0
1008,1889,26-09-2019 02:36:00,0,2496.0,2258.0,0.905,12.333,46,31,13,18,15,3,12,0,0.0,0.0
1008,1890,26-09-2019 02:38:00,0,2471.0,2332.0,0.944,12.316,58,39,13,26,19,2,17,0,0.0,0.0
1008,1891,26-09-2019 02:40:00,0,2467.0,2338.0,0.948,12.307,181,103,68,35,78,38,40,15,0.0,0.0
1008,1892,26-09-2019 02:42:00,0,2585.0,2485.0,0.962,12.935,95,68,41,27,27,6,21,58,0.0,0.0
1008,1893,26-09-2019 02:44:00,0,2856.0,2653.0,0.929,14.191,90,54,27,27,36,20,16,54,0.0,0.0
1008,1894,26-09-2019 02:46:00,0,3058.5,2745.5,0.8995,15.091,66,52,18,34,14,2,12,50,0.0,0.0
1008,1895,26-09-2019 02:48:00,0,3261.0,2838.0,0.87,15.991,55,25,12,13,30,0,30,17,0.0,0.14
1008,1896,26-09-2019 02:50:00,0,3261.0,2866.0,0.879,16.023,92,67,32,35,25,4,21,48,0.0,0.0
1008,1897,26-09-2019 02:52:00,0,3252.0,2904.0,0.893,16.026,339,206,158,48,133,96,37,62,0.24,0.02
1008,1898,26-09-2019 02:54:00,0,3236.0,2914.0,0.901,15.976,387,256,203,53,131,90,41,5,0.0,0.0
1008,1899,26-09-2019 02:56:00,0,3485.0,3142.0,0.902,17.208,377,212,164,48,165,126,39,80,0.0,0.01
1008,1900,26-09-2019 02:58:00,0,3488.0,3137.0,0.9,17.216,417,206,153,53,211,149,62,12,0.0,0.0
1008,1901,26-09-2019 03:00:00,0,2749.0,2465.0,0.897,13.56,342,78,54,24,264,211,53,15,0.0,0.11
1008,1902,26-09-2019 03:02:00,0,2886.0,2506.0,0.869,14.144,165,8,0,8,157,121,36,0,0.0,0.0
1008,1903,26-09-2019 03:04:00,0,2475.0,2321.0,0.938,12.321,83,3,0,3,80,70,10,0,0.0,0.0
1008,1904,26-09-2019 03:06:00,0,2469.0,2343.0,0.949,12.321,127,4,1,3,123,109,14,0,0.0,0.0
1008,1905,26-09-2019 03:08:00,0,2462.0,2361.0,0.959,12.314,104,1,0,1,103,87,16,0,0.0,0.0
1008,1906,26-09-2019 03:10:00,0,2479.0,2302.0,0.929,12.316,83,0,0,0,83,71,12,0,0.0,0.0
1008,1907,26-09-2019 03:12:00,0,2495.0,2247.0,0.9,12.32,45,0,0,0,45,25,20,0,0.0,0.0
1008,1908,26-09-2019 03:14:00,0,2501.0,2247.0,0.898,12.343,20,0,0,0,20,0,20,0,0.0,0.0
1008,1909,26-09-2019 03:16:00,0,2511.0,2204.0,0.878,12.333,37,0,0,0,37,7,30,0,0.0,0.0
1008,1910,26-09-2019 03:18:00,0,2234.0,2055.0,0.92,11.076,57,0,0,0,57,26,31,0,0.0,0.0
1008,1911,26-09-2019 03:20:00,0,2248.0,2004.0,0.8915,11.075,78,0,0,0,78,53,25,0,0.0,0.0
1008,1912,26-09-2019 03:22:00,0,2262.0,1953.0,0.863,11.074,65,5,1,4,60,24,36,0,0.0,0.0
1008,1913,26-09-2019 03:24:00,0,2260.0,1960.0,0.867,11.075,46,13,2,11,33,14,19,0,0.0,0.0
1008,1914,26-09-2019 03:26:00,0,2510.0,2185.0,0.87,12.309,69,31,21,10,38,28,10,0,0.0,0.0
1008,1915,26-09-2019 03:28:00,0,2501.0,2234.0,0.893,12.327,3,2,0,2,1,0,1,0,0.0,0.0
1008,1916,26-09-2019 03:30:00,0,2508.0,2190.0,0.873,12.305,8,1,1,0,7,4,3,0,0.0,0.0
1008,1917,26-09-2019 03:32:00,0,2509.0,2189.0,0.872,12.308,7,3,0,3,4,0,4,0,0.0,0.0
1008,1918,26-09-2019 03:34:00,0,2521.0,2157.0,0.855,12.323,2,0,0,0,2,0,2,0,0.0,0.0
1008,1919,26-09-2019 03:36:00,0,2536.0,2101.0,0.829,12.317,2,1,0,1,1,0,1,0,0.0,0.0
1008,1920,26-09-2019 03:38:00,0,2380.0,2112.0,0.887,11.718,10,5,0,5,5,0,5,0,0.0,0.0
1008,1921,26-09-2019 03:40:00,0,2248.0,2001.0,0.89,11.072,14,2,0,2,12,2,10,0,0.0,0.0
1008,1922,26-09-2019 03:42:00,0,2384.0,2066.0,0.867,11.68,24,0,0,0,24,0,24,0,0.0,0.0
1008,1923,26-09-2019 03:44:00,0,2546.0,2086.0,0.82,12.341,0,0,0,0,0,0,0,0,0.0,0.0
1008,1924,26-09-2019 03:46:00,0,2534.0,2091.0,0.825,12.3,3,0,0,0,3,0,3,0,0.0,0.0
1008,1925,26-09-2019 03:48:00,0,2535.0,2088.0,0.823,12.301,13,8,4,4,5,2,3,0,0.0,0.0
1008,1926,26-09-2019 03:50:00,0,2393.0,2048.0,0.856,11.696,11,11,0,11,0,0,0,0,0.0,0.0
1008,1927,26-09-2019 03:52:00,0,2526.0,2116.0,0.838,12.296,122,59,34,25,63,43,20,0,0.0,0.0
1008,1928,26-09-2019 03:54:00,0,2511.5,2194.5,0.874,12.3255,53,37,6,31,16,8,8,1,0.0,0.0
1008,1929,26-09-2019 03:56:00,0,2497.0,2273.0,0.91,12.355,262,119,80,39,143,105,38,2,0.0,0.0
1008,1930,26-09-2019 03:58:00,0,2895.0,2455.0,0.848,14.124,139,69,39,30,70,43,27,32,0.0,0.0
1008,1931,26-09-2019 04:00:00,0,2898.0,2505.0,0.864,14.19,80,64,40,24,16,1,15,43,0.0,0.0
1008,1932,26-09-2019 04:02:00,0,3318.0,2655.0,0.8,16.014,61,54,26,28,7,1,6,60,0.0,0.0
1008,1933,26-09-2019 04:04:00,0,3302.0,2669.0,0.808,15.964,63,47,18,29,16,2,14,36,0.0,0.02
1008,1934,26-09-2019 04:06:00,0,3261.0,2847.0,0.873,15.999,62,56,25,31,6,0,6,49,0.0,0.03
1008,1935,26-09-2019 04:08:00,0,3552.0,2911.0,0.819,17.219,67,59,26,33,8,0,8,46,0.0,0.11
1008,1936,26-09-2019 04:10:00,0,3513.0,3037.0,0.864,17.205,200,129,91,38,71,52,19,40,0.09,0.01
1008,1937,26-09-2019 04:12:00,0,3274.0,2830.0,0.864,16.032,710,365,294,71,345,278,67,53,0.0,0.01
1008,1938,26-09-2019 04:14:00,0,3539.0,2975.0,0.841,17.237,535,260,202,58,275,219,56,36,0.0,0.03
1008,1939,26-09-2019 04:16:00,0,3517.0,3039.0,0.864,17.221,345,157,112,45,188,143,45,8,0.03,0.0
1008,1940,26-09-2019 04:18:00,0,2506.0,2213.0,0.883,12.325,462,205,159,46,257,198,59,53,0.02,0.0
1008,1941,26-09-2019 04:20:00,0,3273.0,2820.0,0.861,16.019,620,274,219,55,346,263,83,3,0.0,0.0
1008,1942,26-09-2019 04:22:00,0,3551.0,2911.0,0.82,17.213,803,447,371,76,356,286,70,87,0.0,0.0
1008,1943,26-09-2019 04:24:00,0,3536.0,2958.0,0.836,17.209,300,179,148,31,121,86,35,11,0.0,0.0
1008,1944,26-09-2019 04:26:00,0,3291.0,2754.0,0.837,16.015,388,228,183,45,160,120,40,27,0.0,0.05
1008,1945,26-09-2019 04:28:00,0,3603.5,3004.0,0.834,17.5235,153,113,81,32,40,28,12,49,0.0,0.0
1008,1946,26-09-2019 04:30:00,0,3916.0,3254.0,0.831,19.032,100,68,45,23,32,0,32,42,0.0,0.01
1008,1947,26-09-2019 04:32:00,0,3922.0,3277.0,0.836,19.08,91,60,38,22,31,0,31,43,0.0,0.0
1008,1948,26-09-2019 04:34:00,0,3779.0,3234.0,0.856,18.468,92,58,40,18,34,4,30,43,0.0,0.06
1008,1949,26-09-2019 04:36:00,0,3640.0,3166.0,0.87,17.847,78,61,38,23,17,4,13,33,0.0,0.47
1008,1950,26-09-2019 04:38:00,0,3532.0,2972.0,0.842,17.206,95,48,24,24,47,28,19,2,0.22,0.02
1008,1951,26-09-2019 04:40:00,0,3414.0,2902.0,0.85,16.663,344,176,135,41,168,110,58,2,0.0,0.01
1008,1952,26-09-2019 04:42:00,0,3506.0,3087.0,0.88,17.232,426,226,174,52,200,147,53,8,0.0,0.0
1008,1953,26-09-2019 04:44:00,0,2918.0,2369.0,0.812,14.119,320,202,146,56,118,77,41,15,0.0,0.0
1008,1954,26-09-2019 04:46:00,0,2889.0,2513.0,0.87,14.163,416,195,137,58,221,157,64,11,0.0,0.0
1008,1955,26-09-2019 04:48:00,0,3163.0,2642.0,0.835,15.389,339,171,128,43,168,126,42,69,0.02,0.03
1008,1956,26-09-2019 04:50:00,0,3772.0,3224.0,0.855,18.43,438,233,179,54,205,152,53,3,0.0,0.0
1008,1957,26-09-2019 04:52:00,0,3502.0,3100.0,0.885,17.229,584,288,214,74,296,216,80,11,0.0,0.0
1008,1958,26-09-2019 04:54:00,0,3531.0,3004.0,0.851,17.237,504,242,184,58,262,188,74,25,0.0,0.0
1008,1959,26-09-2019 04:56:00,0,3302.0,2719.0,0.823,16.021,183,100,57,43,83,52,31,36,0.0,0.0
1008,1960,26-09-2019 04:58:00,0,3301.0,2675.0,0.81,15.967,684,371,286,85,313,230,83,14,0.0,0.0
1008,1961,26-09-2019 05:00:00,0,3270.0,2816.0,0.861,16.001,499,294,238,56,205,156,49,1,0.0,0.0
1008,1962,26-09-2019 05:02:00,0,3393.0,2923.0,0.8615,16.6045,660,369,286,83,291,230,61,9,0.0,0.0
1008,1963,26-09-2019 05:04:00,0,3516.0,3030.0,0.862,17.208,505,318,251,67,187,131,56,45,0.0,0.0
1008,1964,26-09-2019 05:06:00,0,3499.0,3069.0,0.877,17.185,373,177,127,50,196,144,52,38,0.06,0.0
1008,1965,26-09-2019 05:08:00,0,3271.0,2809.0,0.859,15.997,486,215,161,54,271,200,71,1,0.0,0.0
1008,1966,26-09-2019 05:10:00,0,3412.0,2886.0,0.846,16.638,139,20,4,16,119,69,50,0,0.0,0.0
1008,1967,26-09-2019 05:12:00,0,3522.0,3006.0,0.854,17.204,145,16,5,11,129,73,56,0,0.0,0.0
1008,1968,26-09-2019 05:14:00,0,3540.0,2982.0,0.842,17.25,256,21,7,14,235,162,73,0,0.0,0.0
1008,1969,26-09-2019 05:16:00,0,3284.0,2790.0,0.85,16.03,70,34,19,15,36,3,33,0,0.0,0.0
1008,1970,26-09-2019 05:18:00,0,3020.0,2601.0,0.861,14.777,56,22,0,22,34,0,34,0,0.0,0.0
1008,1971,26-09-2019 05:20:00,0,2884.0,2512.0,0.871,14.144,56,5,2,3,51,8,43,0,0.0,0.0
1008,1972,26-09-2019 05:22:00,0,2878.0,2531.0,0.88,14.142,65,15,1,14,50,11,39,0,0.0,0.0
1008,1973,26-09-2019 05:24:00,0,2913.0,2444.0,0.839,14.182,77,9,4,5,68,28,40,0,0.0,0.0
1008,1974,26-09-2019 05:26:00,0,2766.0,2375.0,0.859,13.526,55,14,12,2,41,5,36,0,0.0,0.0
1008,1975,26-09-2019 05:28:00,0,2491.0,2262.0,0.908,12.318,12,3,2,1,9,6,3,0,0.0,0.0
1008,1976,26-09-2019 05:30:00,0,2245.0,2019.0,0.899,11.082,50,21,9,12,29,22,7,0,0.0,0.0
1008,1977,26-09-2019 05:32:00,0,2252.0,1986.0,0.882,11.071,37,21,12,9,16,12,4,0,0.0,0.0
1008,1978,26-09-2019 05:34:00,0,2519.0,2139.0,0.849,12.293,17,2,1,1,15,0,15,0,0.0,0.0
1008,1979,26-09-2019 05:36:00,0,2315.5,2036.5,0.8825,11.377,5,0,0,0,5,0,5,0,0.0,0.0
1008,1980,26-09-2019 05:38:00,0,2112.0,1934.0,0.916,10.461,13,4,0,4,9,0,9,0,0.0,0.0
1008,1981,26-09-2019 05:40:00,0,2118.0,1925.0,0.909,10.474,1,1,1,0,0,0,0,0,0.0,0.0
1008,1982,26-09-2019 05:42:00,0,2126.0,1896.0,0.892,10.475,5,3,0,3,2,1,1,0,0.0,0.0
1008,1983,26-09-2019 05:44:00,0,2130.0,1872.0,0.879,10.465,20,11,3,8,9,4,5,0,0.0,0.0
1008,1984,26-09-2019 05:46:00,0,2265.0,1930.0,0.852,11.062,1,1,0,1,0,0,0,0,0.0,0.0
1008,1985,26-09-2019 05:48:00,0,2400.0,2013.0,0.839,11.685,11,2,0,2,9,1,8,0,0.0,0.0
1008,1986,26-09-2019 05:50:00,0,2402.0,2023.0,0.842,11.705,55,5,1,4,50,11,39,0,0.0,0.0
1008,1987,26-09-2019 05:52:00,0,2412.0,1976.0,0.819,11.691,68,13,4,9,55,16,39,0,0.0,0.0
1008,1988,26-09-2019 05:54:00,0,2119.0,1913.0,0.902,10.467,154,20,7,13,134,86,48,0,0.0,0.0
1008,1989,26-09-2019 05:56:00,0,2157.0,1784.0,0.827,10.473,136,0,0,0,136,100,36,0,0.0,0.0
1008,1990,26-09-2019 05:58:00,0,2156.0,1756.0,0.814,10.439,236,123,84,39,113,79,34,15,0.0,0.0
1008,1991,26-09-2019 06:00:00,1,2491.0,2264.0,0.909,12.32,517,316,252,64,201,144,57,68,0.0,0.0
1008,1992,26-09-2019 06:02:00,1,2772.0,2367.0,0.854,13.544,401,203,158,45,198,148,50,63,0.0,0.0
1008,1993,26-09-2019 06:04:00,1,2731.0,2501.0,0.916,13.528,353,197,152,45,156,116,40,2,0.0,0.0
1008,1994,26-09-2019 06:06:00,1,2744.0,2465.0,0.898,13.542,340,150,120,30,190,141,49,4,0.0,0.01
1008,1995,26-09-2019 06:08:00,1,3139.0,2714.0,0.865,15.371,287,151,105,46,136,99,37,1,0.0,0.0
1008,1996,26-09-2019 06:10:00,1,3154.5,2656.0,0.8425,15.3685,14,13,8,5,1,1,0,0,0.0,0.0
1008,1997,26-09-2019 06:12:00,1,3170.0,2598.0,0.82,15.366,265,137,96,41,128,97,31,8,0.0,0.02
1008,1998,26-09-2019 06:14:00,1,2883.0,2562.0,0.889,14.195,414,237,184,53,177,137,40,34,0.11,0.0
1008,1999,26-09-2019 06:16:00,1,3161.0,2631.0,0.832,15.368,381,169,125,44,212,156,56,18,0.0,0.0
1008,2000,26-09-2019 06:18:00,1,2637.0,2290.0,0.868,12.927,103,2,1,1,101,87,14,0,0.0,0.0
1008,2001,26-09-2019 06:20:00,1,2922.0,2407.0,0.824,14.176,709,1,0,1,708,644,64,0,0.0,0.0
1008,2002,26-09-2019 06:22:00,1,2880.0,2510.0,0.872,14.126,491,233,165,68,258,193,65,8,0.0,0.0
1008,2003,26-09-2019 06:24:00,1,3021.0,2613.0,0.865,14.796,366,200,161,39,166,127,39,17,0.17,0.0
1008,2004,26-09-2019 06:26:00,1,3299.0,2679.0,0.812,15.966,620,320,265,55,300,226,74,8,0.0,0.0
1008,2005,26-09-2019 06:28:00,1,3150.0,2686.0,0.853,15.384,497,310,240,70,187,136,51,4,0.0,0.0
1008,2006,26-09-2019 06:30:00,1,3159.0,2669.0,0.845,15.401,283,8,2,6,275,223,52,0,0.0,0.0
1008,2007,26-09-2019 06:32:00,1,2874.0,2551.0,0.888,14.147,42,10,3,7,32,15,17,0,0.0,0.0
1008,2008,26-09-2019 06:34:00,1,2870.0,2578.0,0.898,14.163,10,3,1,2,7,3,4,0,0.0,0.0
1008,2009,26-09-2019 06:36:00,1,3026.0,2594.0,0.857,14.794,83,16,9,7,67,45,22,0,0.0,0.0
1008,2010,26-09-2019 06:38:00,1,3162.0,2622.0,0.829,15.36,99,54,20,34,45,27,18,0,0.0,0.0
1008,2011,26-09-2019 06:40:00,1,3294.0,2733.0,0.83,16.003,118,16,4,12,102,60,42,1,0.0,0.0
1008,2012,26-09-2019 06:42:00,1,2893.0,2484.0,0.858,14.149,93,7,1,6,86,63,23,0,0.0,0.0
1008,2013,26-09-2019 06:44:00,1,2721.0,2269.0,0.832,13.2335,0,0,0,0,0,0,0,0,0.0,0.0
1008,2014,26-09-2019 06:46:00,1,2549.0,2054.0,0.806,12.318,1,1,1,0,0,0,0,0,0.0,0.0
1008,2015,26-09-2019 06:48:00,1,2533.0,2065.0,0.815,12.266,2,1,1,0,1,1,0,0,0.0,0.0
1008,2016,26-09-2019 06:50:00,1,2524.0,2130.0,0.844,12.303,8,1,0,1,7,3,4,0,0.0,0.0
1008,2017,26-09-2019 06:52:00,1,2543.0,2080.0,0.818,12.322,2,1,0,1,1,0,1,0,0.0,0.0
1008,2018,26-09-2019 06:54:00,1,2262.0,1955.0,0.864,11.077,13,5,0,5,8,1,7,0,0.0,0.0
1008,2019,26-09-2019 06:56:00,1,2288.0,1854.0,0.81,11.067,17,1,0,1,16,2,14,0,0.0,0.0
1008,2020,26-09-2019 06:58:00,1,2308.0,1769.0,0.766,11.051,28,1,0,1,27,2,25,0,0.0,0.0
1008,2021,26-09-2019 07:00:00,1,2315.0,1756.0,0.759,11.067,24,0,0,0,24,2,22,0,0.0,0.0
1008,2022,26-09-2019 07:02:00,1,2310.0,1768.0,0.765,11.06,51,3,0,3,48,8,40,0,0.0,0.0
1008,2023,26-09-2019 07:04:00,1,2302.0,1780.0,0.773,11.042,45,1,0,1,44,0,44,0,0.0,0.0
1008,2024,26-09-2019 07:06:00,1,2313.0,1767.0,0.764,11.069,50,1,0,1,49,4,45,0,0.0,0.0
1008,2025,26-09-2019 07:08:00,1,2310.0,1792.0,0.776,11.086,79,10,4,6,69,29,40,0,0.0,0.0
1008,2026,26-09-2019 07:10:00,1,2308.0,1774.0,0.769,11.058,197,2,2,0,195,165,30,0,0.0,0.0
1008,2027,26-09-2019 07:12:00,1,2310.0,1806.0,0.782,11.099,67,13,8,5,54,38,16,0,0.0,0.0
1008,2028,26-09-2019 07:14:00,1,2283.0,1871.0,0.82,11.069,0,0,0,0,0,0,0,0,0.0,0.0
1008,2029,26-09-2019 07:16:00,1,2279.0,1870.0,0.821,11.049,0,0,0,0,0,0,0,0,0.0,0.0
1008,2030,26-09-2019 07:18:00,1,2341.5,1938.0,0.8275,11.3715,37,10,1,9,27,21,6,0,0.0,0.0
1008,2031,26-09-2019 07:20:00,1,2404.0,2006.0,0.834,11.694,66,28,0,28,38,13,25,0,0.0,0.0
1008,2032,26-09-2019 07:22:00,1,2401.0,2026.0,0.844,11.702,46,8,4,4,38,23,15,0,0.0,0.0
1008,2033,26-09-2019 07:24:00,1,2536.0,2085.0,0.822,12.301,233,129,92,37,104,69,35,3,0.0,0.0
1008,2034,26-09-2019 07:26:00,1,2300.0,1831.0,0.796,11.09,128,43,15,28,85,40,45,1,0.0,0.0
1008,2035,26-09-2019 07:28:00,1,2298.0,1830.0,0.796,11.082,59,12,3,9,47,13,34,0,0.0,0.0
1008,2036,26-09-2019 07:30:00,1,2292.0,1844.0,0.804,11.073,63,0,0,0,63,24,39,0,0.0,0.0
1008,2037,26-09-2019 07:32:00,1,2318.0,1759.0,0.759,11.081,69,3,1,2,66,28,38,0,0.0,0.0
1008,2038,26-09-2019 07:34:00,1,2307.0,1768.0,0.766,11.046,77,14,0,14,63,33,30,0,0.0,0.0
1008,2039,26-09-2019 07:36:00,1,2294.0,1852.0,0.807,11.088,59,7,3,4,52,21,31,0,0.0,0.0
1008,2040,26-09-2019 07:38:00,1,2283.0,1846.0,0.809,11.037,179,9,5,4,170,138,32,0,0.0,0.0
1008,2041,26-09-2019 07:40:00,1,2287.0,1858.0,0.812,11.069,172,0,0,0,172,152,20,0,0.0,0.0
1008,2042,26-09-2019 07:42:00,1,2295.0,1806.0,0.787,11.043,12,0,0,0,12,6,6,0,0.0,0.0
1008,2043,26-09-2019 07:44:00,1,2331.0,1687.0,0.724,11.054,1,0,0,0,1,0,1,0,0.0,0.0
1008,2044,26-09-2019 07:46:00,1,2052.0,1584.0,0.772,9.839,83,2,1,1,81,68,13,0,0.0,0.0
1008,2045,26-09-2019 07:48:00,1,2056.0,1572.0,0.764,9.84,72,17,8,9,55,38,17,0,0.0,0.0
1008,2046,26-09-2019 07:50:00,1,2329.0,1722.0,0.739,11.083,248,11,0,11,237,181,56,0,0.0,0.0
1008,2047,26-09-2019 07:52:00,1,2291.0,1856.0,0.811,11.0815,246,26,4,22,220,149,71,0,0.0,0.0
1008,2048,26-09-2019 07:54:00,1,2253.0,1990.0,0.883,11.08,236,18,4,14,218,160,58,0,0.0,0.0
1008,2049,26-09-2019 07:56:00,1,2514.0,2183.0,0.868,12.323,66,5,1,4,61,31,30,0,0.0,0.0
1008,2050,26-09-2019 07:58:00,1,2660.0,2226.0,0.837,12.946,28,0,0,0,28,13,15,0,0.0,0.0
1008,2051,26-09-2019 08:00:00,1,2364.0,2161.0,0.914,11.708,58,12,6,6,46,28,18,0,0.0,0.0
1008,2052,26-09-2019 08:02:00,1,2236.0,2053.0,0.918,11.083,36,0,0,0,36,2,34,0,0.0,0.0
1008,2053,26-09-2019 08:04:00,1,2258.0,1949.0,0.863,11.055,87,3,0,3,84,32,52,0,0.0,0.0
1008,2054,26-09-2019 08:06:00,1,2263.0,1966.0,0.869,11.092,19,1,0,1,18,3,15,0,0.0,0.0
1008,2055,26-09-2019 08:08:00,1,2253.0,1988.0,0.882,11.078,67,2,0,2,65,30,35,0,0.0,0.0
1008,2056,26-09-2019 08:10:00,1,2271.0,1923.0,0.847,11.078,275,0,0,0,275,240,35,0,0.0,0.0
1008,2057,26-09-2019 08:12:00,1,1984.0,1841.0,0.928,9.855,35,1,0,1,34,12,22,0,0.0,0.0
1008,2058,26-09-2019 08:14:00,1,2281.0,1898.0,0.832,11.09,50,1,0,1,49,15,34,0,0.0,0.0
1008,2059,26-09-2019 08:16:00,1,2265.0,1953.0,0.862,11.085,9,0,0,0,9,4,5,0,0.0,0.0
1008,2060,26-09-2019 08:18:00,1,2257.0,1951.0,0.864,11.052,25,19,1,18,6,1,5,0,0.0,0.0
1008,2061,26-09-2019 08:20:00,1,2255.0,1958.0,0.868,11.054,78,29,4,25,49,19,30,0,0.0,0.0
1008,2062,26-09-2019 08:22:00,1,1989.0,1826.0,0.918,9.86,29,15,1,14,14,6,8,0,0.0,0.0
1008,2063,26-09-2019 08:24:00,1,2022.0,1684.0,0.833,9.829,42,29,7,22,13,8,5,0,0.0,0.0
1008,2064,26-09-2019 08:26:00,1,2101.0,1689.5,0.805,10.148,139,44,21,23,95,59,36,0,0.0,0.0
1008,2065,26-09-2019 08:28:00,1,2180.0,1695.0,0.777,10.467,15,1,0,1,14,0,14,0,0.0,0.0
1008,2066,26-09-2019 08:30:00,1,2156.0,1747.0,0.81,10.429,22,0,0,0,22,3,19,0,0.0,0.0
1008,2067,26-09-2019 08:32:00,1,2427.0,1932.0,0.796,11.704,43,16,2,14,27,6,21,0,0.0,0.0
1008,2068,26-09-2019 08:34:00,1,2403.0,2020.0,0.841,11.703,35,31,0,31,4,1,3,0,0.0,0.0
1008,2069,26-09-2019 08:36:00,1,2417.0,1961.0,0.811,11.696,3,0,0,0,3,0,3,0,0.0,0.0
1008,2070,26-09-2019 08:38:00,1,2437.0,1902.0,0.781,11.708,62,12,4,8,50,33,17,0,0.0,0.0
1008,2071,26-09-2019 08:40:00,1,2432.0,1885.0,0.775,11.671,48,6,0,6,42,30,12,0,0.0,0.0
1008,2072,26-09-2019 08:42:00,1,2172.0,1715.0,0.789,10.456,191,2,0,2,189,135,54,0,0.0,0.0
1008,2073,26-09-2019 08:44:00,1,2070.0,1537.0,0.743,9.858,98,12,6,6,86,43,43,0,0.0,0.0
1008,2074,26-09-2019 08:46:00,1,2431.0,1880.0,0.773,11.661,147,37,22,15,110,63,47,1,0.0,0.0
1008,2075,26-09-2019 08:48:00,1,2455.0,1823.0,0.743,11.691,344,136,92,44,208,144,64,3,0.0,0.0
1008,2076,26-09-2019 08:50:00,1,2444.0,1845.0,0.755,11.672,278,88,62,26,190,136,54,11,0.0,0.0
1008,2077,26-09-2019 08:52:00,1,2162.0,1754.0,0.811,10.461,57,14,3,11,43,14,29,0,0.0,0.0
1008,2078,26-09-2019 08:54:00,1,2300.0,1798.0,0.782,11.052,72,18,6,12,54,21,33,0,0.0,0.0
1008,2079,26-09-2019 08:56:00,1,2390.0,2045.0,0.856,11.681,195,111,83,28,84,45,39,0,0.0,0.0
1008,2080,26-09-2019 08:58:00,1,2549.0,2035.0,0.798,12.298,134,38,16,22,96,52,44,0,0.0,0.0
1008,2081,26-09-2019 09:00:00,1,2616.5,2080.5,0.795,12.613,19,2,1,1,17,10,7,0,0.0,0.0
1008,2082,26-09-2019 09:02:00,1,2684.0,2126.0,0.792,12.928,9,0,0,0,9,5,4,0,0.0,0.0
1008,2083,26-09-2019 09:04:00,1,2253.0,1986.0,0.881,11.077,5,0,0,0,5,2,3,0,0.0,0.0
1008,2084,26-09-2019 09:06:00,1,2286.0,1868.0,0.817,11.075,8,0,0,0,8,4,4,0,0.0,0.0
1008,2085,26-09-2019 09:08:00,1,2293.0,1870.0,0.815,11.106,24,8,1,7,16,9,7,0,0.0,0.0
1008,2086,26-09-2019 09:10:00,1,2283.0,1889.0,0.827,11.088,27,27,0,27,0,0,0,0,0.0,0.0
1008,2087,26-09-2019 09:12:00,1,2297.0,1840.0,0.801,11.086,21,18,0,18,3,1,2,0,0.0,0.0
1008,2088,26-09-2019 09:14:00,1,2307.0,1782.0,0.773,11.062,0,0,0,0,0,0,0,0,0.0,0.0
1008,2089,26-09-2019 09:16:00,1,2029.0,1662.0,0.819,9.833,6,3,0,3,3,2,1,0,0.0,0.0
1008,2090,26-09-2019 09:18:00,1,2065.0,1553.0,0.752,9.856,10,0,0,0,10,8,2,0,0.0,0.0
1008,2091,26-09-2019 09:20:00,1,2070.0,1518.0,0.733,9.838,62,0,0,0,62,32,30,0,0.0,0.0
1008,2092,26-09-2019 09:22:00,1,2056.0,1550.0,0.754,9.817,68,0,0,0,68,29,39,0,0.0,0.0
1008,2093,26-09-2019 09:24:00,1,2171.0,1717.0,0.791,10.456,39,4,2,2,35,15,20,0,0.0,0.0
1008,2094,26-09-2019 09:26:00,1,2310.0,1774.0,0.768,11.066,17,0,0,0,17,0,17,0,0.0,0.0
1008,2095,26-09-2019 09:28:00,1,2019.0,1696.0,0.84,9.834,2,0,0,0,2,0,2,0,0.0,0.0
1008,2096,26-09-2019 09:30:00,1,2039.0,1641.0,0.805,9.85,9,0,0,0,9,0,9,0,0.0,0.0
1008,2097,26-09-2019 09:32:00,1,2068.0,1525.0,0.737,9.834,31,11,6,5,20,10,10,0,0.0,0.0
1008,2098,26-09-2019 09:34:00,1,2177.0,1691.0,0.7745,10.448,7,0,0,0,7,2,5,0,0.0,0.0
1008,2099,26-09-2019 09:36:00,1,2286.0,1857.0,0.812,11.062,12,2,0,2,10,4,6,0,0.0,0.0
1008,2100,26-09-2019 09:38:00,1,2276.0,1878.0,0.825,11.045,26,0,0,0,26,16,10,0,0.0,0.0
1008,2101,26-09-2019 09:40:00,1,2288.0,1876.0,0.82,11.093,170,36,15,21,134,79,55,0,0.0,0.0
1008,2102,26-09-2019 09:42:00,1,2293.0,1849.0,0.806,11.081,169,25,6,19,144,88,56,0,0.0,0.0
1008,2103,26-09-2019 09:44:00,1,2324.0,1729.0,0.744,11.071,59,17,7,10,42,26,16,0,0.0,0.0
1008,2104,26-09-2019 09:46:00,1,2328.0,1704.0,0.732,11.06,72,1,1,0,71,43,28,0,0.0,0.0
1008,2105,26-09-2019 09:48:00,1,2286.0,1847.0,0.808,11.051,60,4,1,3,56,25,31,0,0.0,0.0
1008,2106,26-09-2019 09:50:00,1,2300.0,1812.0,0.788,11.069,24,5,0,5,19,2,17,0,0.0,0.0
1008,2107,26-09-2019 09:52:00,1,2315.0,1755.0,0.758,11.065,63,0,0,0,63,42,21,0,0.0,0.0
1008,2108,26-09-2019 09:54:00,1,2172.0,1704.0,0.784,10.443,22,4,2,2,18,10,8,0,0.0,0.0
1008,2109,26-09-2019 09:56:00,1,2332.0,1699.0,0.728,11.067,187,57,34,23,130,86,44,16,0.0,0.0
1008,2110,26-09-2019 09:58:00,1,2427.0,1888.0,0.778,11.654,212,103,78,25,109,83,26,64,0.0,0.0
1008,2111,26-09-2019 10:00:00,1,2423.0,1907.0,0.787,11.657,305,156,114,42,149,104,45,20,0.0,0.0
1008,2112,26-09-2019 10:02:00,1,2426.0,1931.0,0.796,11.694,384,175,136,39,209,148,61,0,0.0,0.0
1008,2113,26-09-2019 10:04:00,1,2581.0,1931.0,0.748,12.307,500,268,204,64,232,174,58,3,0.0,0.0
1008,2114,26-09-2019 10:06:00,1,2287.0,1853.0,0.81,11.061,299,135,106,29,164,109,55,6,0.0,0.0
1008,2115,26-09-2019 10:08:00,1,2501.5,1931.0,0.775,11.9925,74,32,23,9,42,33,9,0,0.0,0.0
1008,2116,26-09-2019 10:10:00,1,2716.0,2009.0,0.74,12.924,310,144,109,35,166,127,39,1,0.0,0.0
1008,2117,26-09-2019 10:12:00,1,2720.0,1997.0,0.734,12.93,197,88,57,31,109,69,40,0,0.0,0.0
1008,2118,26-09-2019 10:14:00,1,2293.0,1834.0,0.8,11.065,167,19,4,15,148,80,68,0,0.0,0.0
1008,2119,26-09-2019 10:16:00,1,2331.0,1688.0,0.724,11.054,86,2,0,2,84,51,33,0,0.0,0.0
1008,2120,26-09-2019 10:18:00,1,2188.0,1649.0,0.754,10.446,7,0,0,0,7,0,7,0,0.0,0.0
1008,2121,26-09-2019 10:20:00,1,2052.0,1547.0,0.754,9.797,3,0,0,0,3,0,3,0,0.0,0.0
1008,2122,26-09-2019 10:22:00,1,2087.0,1449.0,0.694,9.829,6,1,0,1,5,1,4,0,0.0,0.0
1008,2123,26-09-2019 10:24:00,1,1794.0,1388.0,0.774,8.604,25,0,0,0,25,2,23,0,0.0,0.0
1008,2124,26-09-2019 10:26:00,1,2069.0,1505.0,0.728,9.819,8,0,0,0,8,0,8,0,0.0,0.0
1008,2125,26-09-2019 10:28:00,1,2024.0,1671.0,0.826,9.824,29,15,0,15,14,2,12,0,0.0,0.0
1008,2126,26-09-2019 10:30:00,1,2019.0,1693.0,0.838,9.83,2,0,0,0,2,0,2,0,0.0,0.0
1008,2127,26-09-2019 10:32:00,1,2053.0,1565.0,0.762,9.824,8,3,0,3,5,2,3,0,0.0,0.0
1008,2128,26-09-2019 10:34:00,1,1777.0,1452.0,0.817,8.61,2,2,0,2,0,0,0,0,0.0,0.0
1008,2129,26-09-2019 10:36:00,1,1775.0,1462.0,0.824,8.612,41,26,2,24,15,9,6,0,0.0,0.0
1008,2130,26-09-2019 10:38:00,1,2045.0,1606.0,0.785,9.837,23,5,3,2,18,9,9,0,0.0,0.0
1008,2131,26-09-2019 10:40:00,1,2302.0,1794.0,0.779,11.056,2,0,0,0,2,0,2,0,0.0,0.0
1008,2132,26-09-2019 10:42:00,1,2449.0,1836.0,0.751,11.6825,0,0,0,0,0,0,0,0,0.0,0.0
1008,2133,26-09-2019 10:44:00,1,2596.0,1878.0,0.723,12.309,0,0,0,0,0,0,0,0,0.0,0.0
1008,2134,26-09-2019 10:46:00,1,2316.0,1761.0,0.76,11.076,18,4,2,2,14,8,6,0,0.0,0.0
1008,2135,26-09-2019 10:48:00,1,2338.0,1662.0,0.711,11.053,23,6,6,0,17,9,8,0,0.0,0.0
1008,2136,26-09-2019 10:50:00,1,2348.0,1631.0,0.695,11.058,93,3,0,3,90,41,49,0,0.0,0.0
1008,2137,26-09-2019 10:52:00,1,2227.0,1491.0,0.669,10.426,50,4,2,2,46,14,32,0,0.0,0.0
1008,2138,26-09-2019 10:54:00,1,2232.0,1481.0,0.664,10.434,22,3,0,3,19,2,17,0,0.0,0.0
1008,2139,26-09-2019 10:56:00,1,2346.0,1616.0,0.689,11.035,18,0,0,0,18,0,18,0,0.0,0.0
1008,2140,26-09-2019 10:58:00,1,2338.0,1663.0,0.711,11.053,36,2,0,2,34,7,27,0,0.0,0.0
1008,2141,26-09-2019 11:00:00,1,2345.0,1656.0,0.706,11.074,26,3,1,2,23,4,19,0,0.0,0.0
1008,2142,26-09-2019 11:02:00,1,2368.0,1564.0,0.66,11.06,29,1,0,1,28,0,28,0,0.0,0.0
1008,2143,26-09-2019 11:04:00,1,2356.0,1559.0,0.662,11.01,34,11,6,5,23,0,23,0,0.0,0.0
1008,2144,26-09-2019 11:06:00,1,2362.0,1541.0,0.653,11.014,81,19,9,10,62,30,32,0,0.0,0.0
1008,2145,26-09-2019 11:08:00,1,2365.0,1573.0,0.665,11.059,33,6,2,4,27,4,23,0,0.0,0.0
1008,2146,26-09-2019 11:10:00,1,2354.0,1588.0,0.675,11.035,45,9,2,7,36,13,23,0,0.0,0.0
1008,2147,26-09-2019 11:12:00,1,2348.0,1604.0,0.683,11.026,63,16,8,8,47,15,32,0,0.0,0.0
1008,2148,26-09-2019 11:14:00,1,2218.0,1547.0,0.697,10.452,171,52,26,26,119,69,50,0,0.0,0.0
1008,2149,26-09-2019 11:16:00,1,2271.5,1641.5,0.722,10.768,124,30,2,28,94,56,38,0,0.0,0.0
1008,2150,26-09-2019 11:18:00,1,2325.0,1736.0,0.747,11.084,197,36,7,29,161,106,55,0,0.0,0.0
1008,2151,26-09-2019 11:20:00,1,2451.0,1818.0,0.742,11.672,81,12,1,11,69,44,25,0,0.0,0.0
1008,2152,26-09-2019 11:22:00,1,2590.0,1877.0,0.725,12.283,56,0,0,0,56,20,36,0,0.0,0.0
1008,2153,26-09-2019 11:24:00,1,2307.0,1800.0,0.78,11.08,28,0,0,0,28,4,24,0,0.0,0.0
1008,2154,26-09-2019 11:26:00,1,2332.0,1677.0,0.719,11.046,32,0,0,0,32,0,32,0,0.0,0.0
1008,2155,26-09-2019 11:28:00,1,2206.0,1578.0,0.715,10.438,173,15,2,13,158,114,44,0,0.0,0.0
1008,2156,26-09-2019 11:30:00,1,1952.0,1382.0,0.708,9.222,87,2,0,2,85,49,36,0,0.0,0.0
1008,2157,26-09-2019 11:32:00,1,1958.0,1352.0,0.691,9.211,53,0,0,0,53,25,28,0,0.0,0.0
1008,2158,26-09-2019 11:34:00,1,1941.0,1425.0,0.734,9.226,89,8,0,8,81,48,33,0,0.0,0.0
1008,2159,26-09-2019 11:36:00,1,2369.0,1536.0,0.648,11.037,105,15,6,9,90,48,42,0,0.0,0.0
1008,2160,26-09-2019 11:38:00,1,2335.0,1679.0,0.719,11.061,287,34,12,22,253,177,76,0,0.0,0.0
1008,2161,26-09-2019 11:40:00,1,2596.0,1857.0,0.715,12.283,263,98,65,33,165,113,52,11,0.0,0.0
1008,2162,26-09-2019 11:42:00,1,2597.0,1853.0,0.714,12.283,128,18,11,7,110,64,46,0,0.0,0.0
1008,2163,26-09-2019 11:44:00,1,2329.0,1697.0,0.728,11.056,31,8,4,4,23,2,21,0,0.0,0.0
1008,2164,26-09-2019 11:46:00,1,2334.0,1676.0,0.718,11.052,33,0,0,0,33,0,33,0,0.0,0.0
1008,2165,26-09-2019 11:48:00,1,2351.0,1614.0,0.687,11.05,59,0,0,0,59,25,34,0,0.0,0.0
1008,2166,26-09-2019 11:50:00,1,2147.0,1512.5,0.7065,10.135,91,9,5,4,82,45,37,0,0.0,0.0
1008,2167,26-09-2019 11:52:00,1,1943.0,1411.0,0.726,9.22,96,0,0,0,96,44,52,0,0.0,0.0
1008,2168,26-09-2019 11:54:00,1,1942.0,1399.0,0.721,9.2,43,4,1,3,39,4,35,0,0.0,0.0
1008,2169,26-09-2019 11:56:00,1,1929.0,1471.0,0.762,9.229,32,4,0,4,28,2,26,0,0.0,0.0
1008,2170,26-09-2019 11:58:00,1,1918.0,1496.0,0.78,9.215,402,12,0,12,390,352,38,0,0.0,0.0
1008,2171,26-09-2019 12:00:00,1,1918.0,1519.0,0.792,9.238,298,0,0,0,298,227,71,0,0.0,0.0
1008,2172,26-09-2019 12:02:00,1,1920.0,1511.0,0.787,9.239,198,22,13,9,176,116,60,0,0.0,0.0
1008,2173,26-09-2019 12:04:00,1,2209.0,1572.0,0.712,10.446,81,3,1,2,78,38,40,0,0.0,0.0
1008,2174,26-09-2019 12:06:00,1,2327.0,1702.0,0.731,11.054,86,4,0,4,82,37,45,0,0.0,0.0
1008,2175,26-09-2019 12:08:00,1,1914.0,1503.0,0.785,9.203,36,2,0,2,34,0,34,0,0.0,0.0
1008,2176,26-09-2019 12:10:00,1,1948.0,1396.0,0.716,9.222,43,3,1,2,40,2,38,0,0.0,0.0
1008,2177,26-09-2019 12:12:00,1,1798.0,1360.0,0.757,8.59,72,0,0,0,72,46,26,0,0.0,0.0
1008,2178,26-09-2019 12:14:00,1,1657.0,1325.0,0.8,7.996,127,0,0,0,127,105,22,0,0.0,0.0
1008,2179,26-09-2019 12:16:00,1,1949.0,1374.0,0.705,9.2,64,0,0,0,64,27,37,0,0.0,0.0
1008,2180,26-09-2019 12:18:00,1,1910.0,1522.0,0.797,9.21,76,0,0,0,76,34,42,0,0.0,0.0
1008,2181,26-09-2019 12:20:00,1,2204.0,1584.0,0.719,10.439,136,4,2,2,132,113,19,0,0.0,0.0
1008,2182,26-09-2019 12:22:00,1,2203.0,1584.0,0.719,10.433,8,2,0,2,6,1,5,0,0.0,0.0
1008,2183,26-09-2019 12:24:00,1,2270.0,1623.0,0.715,10.7415,41,16,6,10,25,12,13,0,0.0,0.0
1008,2184,26-09-2019 12:26:00,1,2337.0,1662.0,0.711,11.05,27,0,0,0,27,7,20,0,0.0,0.0
1008,2185,26-09-2019 12:28:00,1,2633.0,1714.0,0.651,12.272,23,2,1,1,21,10,11,0,0.0,0.0
1008,2186,26-09-2019 12:30:00,1,2490.0,1709.0,0.687,11.703,24,0,0,0,24,10,14,0,0.0,0.0
1008,2187,26-09-2019 12:32:00,1,2635.0,1728.0,0.656,12.297,27,0,0,0,27,14,13,0,0.0,0.0
1008,2188,26-09-2019 12:34:00,1,2627.0,1720.0,0.655,12.256,46,1,0,1,45,18,27,0,0.0,0.0
1008,2189,26-09-2019 12:36:00,1,2481.0,1699.0,0.685,11.655,141,64,48,16,77,54,23,0,0.0,0.0
1008,2190,26-09-2019 12:38:00,1,2350.0,1611.0,0.686,11.042,12,10,4,6,2,1,1,0,0.0,0.0
1008,2191,26-09-2019 12:40:00,1,2371.0,1518.0,0.64,11.025,147,25,6,19,122,80,42,0,0.0,0.0
1008,2192,26-09-2019 12:42:00,1,2365.0,1557.0,0.658,11.043,129,43,12,31,86,50,36,0,0.0,0.0
1008,2193,26-09-2019 12:44:00,1,2342.0,1643.0,0.702,11.046,120,57,30,27,63,33,30,0,0.0,0.0
1008,2194,26-09-2019 12:46:00,1,2341.0,1651.0,0.705,11.05,154,34,12,22,120,71,49,0,0.0,0.0
1008,2195,26-09-2019 12:48:00,1,2335.0,1684.0,0.721,11.064,208,57,25,32,151,92,59,0,0.0,0.0
1008,2196,26-09-2019 12:50:00,1,2613.0,1798.0,0.688,12.286,390,161,118,43,229,172,57,6,0.0,0.0
1008,2197,26-09-2019 12:52:00,1,2608.0,1821.0,0.698,12.293,584,309,243,66,275,208,67,4,0.0,0.0
1008,2198,26-09-2019 12:54:00,1,2583.0,1866.0,0.722,12.245,341,155,109,46,186,133,53,3,0.0,0.0
1008,2199,26-09-2019 12:56:00,1,2597.0,1875.0,0.722,12.31,469,259,196,63,210,159,51,5,0.0,0.0
1008,2200,26-09-2019 12:58:00,1,2617.0,1810.0,0.692,12.316,182,101,72,29,81,51,30,0,0.0,0.0
1008,2201,26-09-2019 13:00:00,1,2637.0,1745.0,0.662,12.322,216,98,68,30,118,89,29,5,0.0,0.0
1008,2202,26-09-2019 13:02:00,1,2603.0,1836.0,0.705,12.291,87,37,17,20,50,30,20,8,0.0,0.0
1008,2203,26-09-2019 13:04:00,1,2601.0,1856.0,0.714,12.306,315,124,89,35,191,131,60,3,0.0,0.0
1008,2204,26-09-2019 13:06:00,1,2599.0,1858.0,0.715,12.298,30,17,13,4,13,8,5,0,0.0,0.0
1008,2205,26-09-2019 13:08:00,1,2757.0,1810.0,0.656,12.868,34,20,9,11,14,5,9,0,0.0,0.0
1008,2206,26-09-2019 13:10:00,1,2632.0,1700.0,0.646,12.253,40,5,0,5,35,15,20,0,0.0,0.0
1008,2207,26-09-2019 13:12:00,1,2656.0,1633.0,0.615,12.272,50,15,5,10,35,15,20,0,0.0,0.0
1008,2208,26-09-2019 13:14:00,1,2621.0,1790.0,0.683,12.308,93,1,0,1,92,58,34,0,0.0,0.0
1008,2209,26-09-2019 13:16:00,1,3044.0,1899.0,0.624,14.096,149,30,6,24,119,73,46,0,0.0,0.0
1008,2210,26-09-2019 13:18:00,1,3048.0,1889.0,0.62,14.104,64,11,0,11,53,26,27,0,0.0,0.0
1008,2211,26-09-2019 13:20:00,1,2767.0,1775.0,0.642,12.868,39,0,0,0,39,26,13,0,0.0,0.0
1008,2212,26-09-2019 13:22:00,1,2623.0,1756.0,0.67,12.282,22,0,0,0,22,20,2,0,0.0,0.0
1008,2213,26-09-2019 13:24:00,1,2633.0,1715.0,0.651,12.273,51,0,0,0,51,29,22,0,0.0,0.0
1008,2214,26-09-2019 13:26:00,1,2646.0,1681.0,0.635,12.286,75,0,0,0,75,41,34,0,0.0,0.0
1008,2215,26-09-2019 13:28:00,1,2650.0,1644.0,0.62,12.263,31,0,0,0,31,20,11,0,0.0,0.0
1008,2216,26-09-2019 13:30:00,1,2657.0,1610.0,0.606,12.252,14,0,0,0,14,4,10,0,0.0,0.0
1008,2217,26-09-2019 13:32:00,1,2363.0,1567.5,0.6715,11.046,15,0,0,0,15,9,6,0,0.0,0.0
1008,2218,26-09-2019 13:34:00,1,2069.0,1525.0,0.737,9.84,10,0,0,0,10,5,5,0,0.0,0.0
1008,2219,26-09-2019 13:36:00,1,2062.0,1528.0,0.741,9.815,9,0,0,0,9,0,9,0,0.0,0.0
1008,2220,26-09-2019 13:38:00,1,2221.0,1533.0,0.69,10.449,85,25,16,9,60,39,21,0,0.0,0.0
1008,2221,26-09-2019 13:40:00,1,2358.0,1562.0,0.662,11.023,20,20,0,20,0,0,0,0,0.0,0.0
1008,2222,26-09-2019 13:42:00,1,2070.0,1502.0,0.725,9.821,274,7,1,6,267,241,26,0,0.0,0.0
1008,2223,26-09-2019 13:44:00,1,2068.0,1496.0,0.723,9.806,311,5,2,3,306,240,66,0,0.0,0.0
1008,2224,26-09-2019 13:46:00,1,2070.0,1523.0,0.736,9.842,13,7,4,3,6,4,2,0,0.0,0.0
1008,2225,26-09-2019 13:48:00,1,2368.0,1582.0,0.668,11.082,12,11,4,7,1,1,0,0,0.0,0.0
1008,2226,26-09-2019 13:50:00,1,2218.0,1532.0,0.691,10.435,4,4,0,4,0,0,0,0,0.0,0.0
1008,2227,26-09-2019 13:52:00,1,2081.0,1466.0,0.704,9.823,23,7,3,4,16,8,8,0,0.0,0.0
1008,2228,26-09-2019 13:54:00,1,2074.0,1476.0,0.712,9.804,0,0,0,0,0,0,0,0,0.0,0.0
1008,2229,26-09-2019 13:56:00,1,2079.0,1474.0,0.709,9.824,9,0,0,0,9,6,3,0,0.0,0.0
1008,2230,26-09-2019 13:58:00,1,2226.0,1500.0,0.674,10.433,5,0,0,0,5,2,3,0,0.0,0.0
1008,2231,26-09-2019 14:00:00,1,2074.0,1480.0,0.713,9.811,92,4,2,2,88,52,36,0,0.0,0.0
1008,2232,26-09-2019 14:02:00,1,2081.0,1465.0,0.704,9.821,99,0,0,0,99,63,36,0,0.0,0.0
1008,2233,26-09-2019 14:04:00,1,2089.0,1449.0,0.694,9.837,53,0,0,0,53,28,25,0,0.0,0.0
1008,2234,26-09-2019 14:06:00,1,2086.5,1455.0,0.6975,9.8325,51,0,0,0,51,22,29,0,0.0,0.0
1008,2235,26-09-2019 14:08:00,1,2084.0,1461.0,0.701,9.828,107,0,0,0,107,58,49,0,0.0,0.0
1008,2236,26-09-2019 14:10:00,1,2093.0,1426.0,0.681,9.826,121,2,1,1,119,84,35,0,0.0,0.0
1008,2237,26-09-2019 14:12:00,1,2110.0,1368.0,0.649,9.83,103,18,8,10,85,55,30,0,0.0,0.0
1008,2238,26-09-2019 14:14:00,1,2097.0,1414.0,0.674,9.83,16,0,0,0,16,6,10,0,0.0,0.0
1008,2239,26-09-2019 14:16:00,1,2086.0,1441.0,0.691,9.816,42,3,1,2,39,27,12,0,0.0,0.0
1008,2240,26-09-2019 14:18:00,1,2383.0,1499.0,0.629,11.051,71,0,0,0,71,44,27,0,0.0,0.0
1008,2241,26-09-2019 14:20:00,1,2084.0,1434.0,0.688,9.8,134,3,0,3,131,96,35,0,0.0,0.0
1008,2242,26-09-2019 14:22:00,1,2376.0,1510.0,0.635,11.034,23,0,0,0,23,2,21,0,0.0,0.0
1008,2243,26-09-2019 14:24:00,1,2383.0,1528.0,0.641,11.081,45,2,1,1,43,23,20,0,0.0,0.0
1008,2244,26-09-2019 14:26:00,1,2376.0,1508.0,0.634,11.032,34,0,0,0,34,15,19,0,0.0,0.0
1008,2245,26-09-2019 14:28:00,1,2374.0,1516.0,0.638,11.032,13,11,0,11,2,1,1,0,0.0,0.0
1008,2246,26-09-2019 14:30:00,1,2383.0,1505.0,0.632,11.058,10,8,1,7,2,0,2,0,0.0,0.0
1008,2247,26-09-2019 14:32:00,1,2394.0,1460.0,0.61,11.049,65,29,13,16,36,1,35,0,0.0,0.0
1008,2248,26-09-2019 14:34:00,1,2365.0,1559.0,0.659,11.046,14,3,0,3,11,0,11,0,0.0,0.0
1008,2249,26-09-2019 14:36:00,1,2388.0,1473.0,0.617,11.041,49,1,0,1,48,0,48,0,0.0,0.0
1008,2250,26-09-2019 14:38:00,1,2400.0,1422.0,0.592,11.031,35,0,0,0,35,0,35,0,0.0,0.0
1008,2251,26-09-2019 14:40:00,1,2320.0,1426.0,0.615,10.721,93,4,1,3,89,47,42,0,0.0,0.0
1008,2252,26-09-2019 14:42:00,1,2240.0,1430.0,0.638,10.411,77,0,0,0,77,43,34,0,0.0,0.0
1008,2253,26-09-2019 14:44:00,1,2243.0,1420.0,0.633,10.41,35,9,0,9,26,11,15,0,0.0,0.0
1008,2254,26-09-2019 14:46:00,1,2231.0,1483.0,0.665,10.432,11,3,0,3,8,2,6,0,0.0,0.0
1008,2255,26-09-2019 14:48:00,1,2231.0,1497.0,0.671,10.45,1,0,0,0,1,0,1,0,0.0,0.0
1008,2256,26-09-2019 14:50:00,1,2228.0,1507.0,0.676,10.449,0,0,0,0,0,0,0,0,0.0,0.0
1008,2257,26-09-2019 14:52:00,1,2222.0,1514.0,0.682,10.43,0,0,0,0,0,0,0,0,0.0,0.0
1008,2258,26-09-2019 14:54:00,1,2232.0,1473.0,0.66,10.426,69,19,10,9,50,35,15,0,0.0,0.0
1008,2259,26-09-2019 14:56:00,1,2215.0,1530.0,0.691,10.421,255,45,20,25,210,143,67,0,0.0,0.0
1008,2260,26-09-2019 14:58:00,1,2656.0,1660.0,0.625,12.303,128,22,11,11,106,75,31,0,0.0,0.0
1008,2261,26-09-2019 15:00:00,1,2647.0,1677.0,0.633,12.286,18,18,0,18,0,0,0,0,0.0,0.0
1008,2262,26-09-2019 15:02:00,1,2479.0,1682.0,0.679,11.629,13,7,3,4,6,1,5,0,0.0,0.0
1008,2263,26-09-2019 15:04:00,1,2488.0,1678.0,0.674,11.659,38,15,2,13,23,10,13,0,0.0,0.0
1008,2264,26-09-2019 15:06:00,1,2204.0,1615.0,0.733,10.474,48,28,0,28,20,1,19,0,0.0,0.0
1008,2265,26-09-2019 15:08:00,1,2205.0,1559.0,0.707,10.414,39,8,5,3,31,10,21,0,0.0,0.0
1008,2266,26-09-2019 15:10:00,1,2355.0,1597.0,0.678,11.046,27,6,0,6,21,2,19,0,0.0,0.0
1008,2267,26-09-2019 15:12:00,1,2351.0,1599.0,0.68,11.035,59,24,5,19,35,8,27,0,0.0,0.0
1008,2268,26-09-2019 15:14:00,1,2287.0,1568.5,0.686,10.748,64,3,1,2,61,25,36,0,0.0,0.0
1008,2269,26-09-2019 15:16:00,1,2223.0,1538.0,0.692,10.461,109,91,82,9,18,4,14,0,0.0,0.0
1008,2270,26-09-2019 15:18:00,1,2217.0,1521.0,0.686,10.419,57,0,0,0,57,36,21,0,0.0,0.0
1008,2271,26-09-2019 15:20:00,1,2076.0,1494.0,0.72,9.832,24,21,1,20,3,1,2,0,0.0,0.0
1008,2272,26-09-2019 15:22:00,1,2081.0,1470.0,0.707,9.827,110,0,0,0,110,65,45,0,0.0,0.0
1008,2273,26-09-2019 15:24:00,1,2107.0,1370.0,0.65,9.819,172,0,0,0,172,126,46,0,0.0,0.0
1008,2274,26-09-2019 15:26:00,1,1818.0,1278.0,0.703,8.577,95,6,1,5,89,50,39,0,0.0,0.0
1008,2275,26-09-2019 15:28:00,1,1830.0,1241.0,0.678,8.586,53,3,2,1,50,20,30,0,0.0,0.0
1008,2276,26-09-2019 15:30:00,1,1843.0,1218.0,0.661,8.612,35,12,0,12,23,5,18,0,0.0,0.0
1008,2277,26-09-2019 15:32:00,1,1834.0,1214.0,0.662,8.571,26,0,0,0,26,4,22,0,0.0,0.0
1008,2278,26-09-2019 15:34:00,1,1830.0,1254.0,0.685,8.598,55,19,12,7,36,12,24,0,0.0,0.0
1008,2279,26-09-2019 15:36:00,1,2069.0,1505.0,0.728,9.818,52,21,8,13,31,0,31,0,0.0,0.0
1008,2280,26-09-2019 15:38:00,1,2216.0,1518.0,0.685,10.411,35,4,1,3,31,5,26,0,0.0,0.0
1008,2281,26-09-2019 15:40:00,1,2226.0,1507.0,0.677,10.44,50,25,1,24,25,2,23,0,0.0,0.0
1008,2282,26-09-2019 15:42:00,1,2087.0,1455.0,0.697,9.832,45,14,2,12,31,9,22,0,0.0,0.0
1008,2283,26-09-2019 15:44:00,1,2079.0,1468.0,0.706,9.818,22,3,0,3,19,0,19,0,0.0,0.0
1008,2284,26-09-2019 15:46:00,1,2082.0,1460.0,0.701,9.82,42,21,7,14,21,4,17,0,0.0,0.0
1008,2285,26-09-2019 15:48:00,1,2001.0,1466.5,0.734,9.5085,36,21,8,13,15,6,9,0,0.0,0.0
1008,2286,26-09-2019 15:50:00,1,1920.0,1473.0,0.767,9.197,45,22,4,18,23,1,22,0,0.0,0.0
1008,2287,26-09-2019 15:52:00,1,1919.0,1499.0,0.781,9.219,40,23,4,19,17,3,14,0,0.0,0.0
1008,2288,26-09-2019 15:54:00,1,1928.0,1464.0,0.759,9.215,218,67,30,37,151,99,52,0,0.0,0.0
1008,2289,26-09-2019 15:56:00,1,2057.0,1567.0,0.762,9.841,230,56,24,32,174,116,58,2,0.0,0.0
1008,2290,26-09-2019 15:58:00,1,2331.0,1683.0,0.722,11.047,179,44,12,32,135,88,47,0,0.0,0.0
1008,2291,26-09-2019 16:00:00,1,2303.0,1782.0,0.774,11.047,83,30,10,20,53,36,17,0,0.0,0.0
1008,2292,26-09-2019 16:02:00,1,2309.0,1778.0,0.77,11.064,131,68,40,28,63,32,31,23,0.0,0.0
1008,2293,26-09-2019 16:04:00,1,2586.0,1903.0,0.736,12.297,72,50,23,27,22,3,19,38,0.0,0.0
1008,2294,26-09-2019 16:06:00,1,2718.0,1979.0,0.728,12.902,108,74,45,29,34,5,29,44,0.0,0.0
1008,2295,26-09-2019 16:08:00,1,2990.0,2123.0,0.71,14.132,78,46,13,33,32,2,30,36,0.0,0.0
1008,2296,26-09-2019 16:10:00,1,2974.0,2149.0,0.723,14.095,73,51,23,28,22,4,18,36,0.0,0.0
1008,2297,26-09-2019 16:12:00,1,2983.0,2172.0,0.728,14.159,214,132,101,31,82,66,16,35,0.0,0.0
1008,2298,26-09-2019 16:14:00,1,2835.0,2111.0,0.745,13.506,620,305,237,68,315,240,75,25,0.0,0.0
1008,2299,26-09-2019 16:16:00,1,2700.0,2078.0,0.77,12.939,50,34,14,20,16,6,10,0,0.0,0.0
1008,2300,26-09-2019 16:18:00,1,2580.0,1910.0,0.74,12.282,96,41,8,33,55,29,26,0,0.0,0.0
1008,2301,26-09-2019 16:20:00,1,2586.0,1906.0,0.737,12.3,104,21,7,14,83,51,32,0,0.0,0.0
1008,2302,26-09-2019 16:22:00,1,2642.5,1980.0,0.749,12.6045,135,52,34,18,83,56,27,0,0.0,0.0
1008,2303,26-09-2019 16:24:00,1,2699.0,2054.0,0.761,12.909,440,211,160,51,229,169,60,2,0.0,0.01
1008,2304,26-09-2019 16:26:00,1,2561.0,1972.0,0.77,12.275,9,8,0,8,1,1,0,0,0.0,0.0
1008,2305,26-09-2019 16:28:00,1,2317.0,1737.0,0.75,11.051,13,8,2,6,5,2,3,0,0.0,0.0
1008,2306,26-09-2019 16:30:00,1,2181.0,1669.0,0.765,10.439,20,16,1,15,4,4,0,0,0.0,0.0
1008,2307,26-09-2019 16:32:00,1,1888.0,1611.0,0.853,9.222,5,5,1,4,0,0,0,0,0.0,0.0
1008,2308,26-09-2019 16:34:00,1,1890.0,1612.0,0.853,9.232,0,0,0,0,0,0,0,0,0.0,0.0
1008,2309,26-09-2019 16:36:00,1,1889.0,1604.0,0.849,9.217,1,0,0,0,1,1,0,0,0.0,0.0
1008,2310,26-09-2019 16:38:00,1,1893.0,1599.0,0.845,9.228,7,0,0,0,7,1,6,0,0.0,0.0
1008,2311,26-09-2019 16:40:00,1,2035.0,1639.0,0.806,9.832,11,10,0,10,1,1,0,0,0.0,0.0
1008,2312,26-09-2019 16:42:00,1,2345.0,1663.0,0.709,11.08,0,0,0,0,0,0,0,0,0.0,0.0
1008,2313,26-09-2019 16:44:00,1,2184.0,1656.0,0.758,10.439,2,1,0,1,1,0,1,0,0.0,0.0
1008,2314,26-09-2019 16:46:00,1,2343.0,1665.0,0.71,11.076,29,12,5,7,17,11,6,0,0.0,0.0
1008,2315,26-09-2019 16:48:00,1,2341.0,1677.0,0.716,11.08,7,3,0,3,4,1,3,0,0.0,0.0
1008,2316,26-09-2019 16:50:00,1,2050.0,1602.0,0.781,9.853,4,1,0,1,3,2,1,0,0.0,0.0
1008,2317,26-09-2019 16:52:00,1,2052.0,1578.0,0.769,9.832,19,17,0,17,2,0,2,0,0.0,0.0
1008,2318,26-09-2019 16:54:00,1,2334.0,1684.0,0.721,11.06,46,25,15,10,21,14,7,0,0.0,0.0
1008,2319,26-09-2019 16:56:00,1,2322.0,1733.5,0.7465,11.0685,2,2,0,2,0,0,0,0,0.0,0.0
1008,2320,26-09-2019 16:58:00,1,2310.0,1783.0,0.772,11.077,6,4,2,2,2,0,2,0,0.0,0.0
1008,2321,26-09-2019 17:00:00,1,2300.0,1820.0,0.791,11.077,23,5,1,4,18,6,12,0,0.0,0.0
1008,2322,26-09-2019 17:02:00,1,2295.0,1818.0,0.792,11.055,12,1,0,1,11,3,8,0,0.0,0.0
1008,2323,26-09-2019 17:04:00,1,2308.0,1764.0,0.764,11.047,21,3,0,3,18,4,14,0,0.0,0.0
1008,2324,26-09-2019 17:06:00,1,2313.0,1761.0,0.761,11.064,14,0,0,0,14,7,7,0,0.0,0.0
1008,2325,26-09-2019 17:08:00,1,2324.0,1721.0,0.74,11.064,45,21,7,14,24,16,8,0,0.0,0.0
1008,2326,26-09-2019 17:10:00,1,2190.0,1630.0,0.744,10.435,110,48,16,32,62,33,29,0,0.0,0.0
1008,2327,26-09-2019 17:12:00,1,2320.0,1738.0,0.749,11.064,116,50,26,24,66,34,32,0,0.0,0.0
1008,2328,26-09-2019 17:14:00,1,2315.0,1760.0,0.76,11.071,239,97,54,43,142,93,49,0,0.0,0.0
1008,2329,26-09-2019 17:16:00,1,2279.0,1870.0,0.821,11.048,151,63,29,34,88,51,37,0,0.0,0.0
1008,2330,26-09-2019 17:18:00,1,2308.0,1803.0,0.781,11.09,3,0,0,0,3,0,3,0,0.0,0.0
1008,2331,26-09-2019 17:20:00,1,2307.0,1780.0,0.772,11.059,8,4,1,3,4,0,4,0,0.0,0.0
1008,2332,26-09-2019 17:22:00,1,2335.0,1693.0,0.725,11.073,71,34,20,14,37,21,16,3,0.0,0.0
1008,2333,26-09-2019 17:24:00,1,2315.0,1761.0,0.761,11.072,97,40,20,20,57,28,29,0,0.0,0.0
1008,2334,26-09-2019 17:26:00,1,2319.0,1746.0,0.753,11.068,25,9,4,5,16,7,9,0,0.0,0.0
1008,2335,26-09-2019 17:28:00,1,2336.0,1684.0,0.721,11.068,48,12,6,6,36,16,20,0,0.0,0.0
1008,2336,26-09-2019 17:30:00,1,2194.5,1631.0,0.745,10.452,3,0,0,0,3,0,3,0,0.0,0.0
1008,2337,26-09-2019 17:32:00,1,2053.0,1578.0,0.769,9.836,4,0,0,0,4,0,4,0,0.0,0.0
1008,2338,26-09-2019 17:34:00,1,2061.0,1535.0,0.745,9.819,1,0,0,0,1,0,1,0,0.0,0.0
1008,2339,26-09-2019 17:36:00,1,2209.0,1578.0,0.715,10.449,2,0,0,0,2,0,2,0,0.0,0.0
1008,2340,26-09-2019 17:38:00,1,2343.0,1632.0,0.696,11.04,1,0,0,0,1,0,1,0,0.0,0.0
1008,2341,26-09-2019 17:40:00,1,2349.0,1619.0,0.689,11.048,29,22,9,13,7,3,4,0,0.0,0.0
1008,2342,26-09-2019 17:42:00,1,2347.0,1623.0,0.691,11.046,147,85,46,39,62,37,25,0,0.0,0.0
1008,2343,26-09-2019 17:44:00,1,2617.0,1780.0,0.68,12.283,241,75,32,43,166,114,52,0,0.0,0.0
1008,2344,26-09-2019 17:46:00,1,2725.0,1935.0,0.71,12.878,166,48,15,33,118,69,49,0,0.0,0.0
1008,2345,26-09-2019 17:48:00,1,2700.0,2044.0,0.757,12.903,103,25,1,24,78,42,36,0,0.0,0.0
1008,2346,26-09-2019 17:50:00,1,2714.0,2016.0,0.743,12.925,98,35,16,19,63,33,30,0,0.0,0.0
1008,2347,26-09-2019 17:52:00,1,2731.0,1936.0,0.709,12.903,118,88,52,36,30,17,13,42,0.0,0.0
1008,2348,26-09-2019 17:54:00,1,2842.0,2084.0,0.733,13.506,87,61,35,26,26,11,15,44,0.0,0.0
1008,2349,26-09-2019 17:56:00,1,2997.0,2092.0,0.698,14.125,48,29,12,17,19,5,14,44,0.0,0.0
1008,2350,26-09-2019 17:58:00,1,2969.0,2197.0,0.74,14.131,67,43,16,27,24,0,24,41,0.0,0.04
1008,2351,26-09-2019 18:00:00,0,3238.0,2302.0,0.711,15.306,196,116,81,35,80,60,20,36,0.0,0.05
1008,2352,26-09-2019 18:02:00,0,2939.0,2308.0,0.785,14.137,509,269,209,60,240,185,55,39,0.0,0.0
1008,2353,26-09-2019 18:04:00,0,3138.0,2422.0,0.7725,15.0455,401,231,181,50,170,128,42,103,0.0,0.0
1008,2354,26-09-2019 18:06:00,0,3337.0,2536.0,0.76,15.954,210,101,63,38,109,76,33,21,0.0,0.0
1008,2355,26-09-2019 18:08:00,0,2989.0,2125.0,0.711,14.129,88,41,3,38,47,24,23,0,0.0,0.0
1008,2356,26-09-2019 18:10:00,0,2946.0,2272.0,0.771,14.124,74,19,7,12,55,30,25,0,0.0,0.0
1008,2357,26-09-2019 18:12:00,0,2702.0,2043.0,0.756,12.91,4,0,0,0,4,3,1,0,0.0,0.0
1008,2358,26-09-2019 18:14:00,0,2701.0,2021.0,0.748,12.882,47,22,8,14,25,13,12,0,0.0,0.0
1008,2359,26-09-2019 18:16:00,0,2682.0,2123.0,0.792,12.916,9,0,0,0,9,0,9,0,0.0,0.0
1008,2360,26-09-2019 18:18:00,0,2714.0,1998.0,0.736,12.907,11,1,1,0,10,0,10,0,0.0,0.0
1008,2361,26-09-2019 18:20:00,0,2710.0,2026.0,0.748,12.923,51,7,1,6,44,9,35,0,0.0,0.0
1008,2362,26-09-2019 18:22:00,0,2677.0,2123.0,0.793,12.899,23,6,0,6,17,2,15,0,0.0,0.0
1008,2363,26-09-2019 18:24:00,0,2830.0,2154.0,0.761,13.535,22,5,1,4,17,4,13,0,0.0,0.0
1008,2364,26-09-2019 18:26:00,0,2950.0,2276.0,0.772,14.144,16,12,1,11,4,4,0,0,0.0,0.0
1008,2365,26-09-2019 18:28:00,0,2937.0,2315.0,0.788,14.135,17,8,0,8,9,4,5,0,0.0,0.0
1008,2366,26-09-2019 18:30:00,0,2916.0,2406.0,0.825,14.155,18,10,2,8,8,3,5,0,0.0,0.0
1008,2367,26-09-2019 18:32:00,0,3295.0,2747.0,0.834,16.024,5,2,0,2,3,1,2,0,0.0,0.0
1008,2368,26-09-2019 18:34:00,0,3298.0,2704.0,0.82,15.987,5,4,1,3,1,0,1,0,0.0,0.0
1008,2369,26-09-2019 18:36:00,0,3323.0,2591.0,0.78,15.963,161,97,58,39,64,39,25,7,0.0,0.0
1008,2370,26-09-2019 18:38:00,0,3434.0,2759.5,0.803,16.585,560,338,285,53,222,171,51,74,0.03,0.0
1008,2371,26-09-2019 18:40:00,0,3545.0,2928.0,0.826,17.207,410,207,161,46,203,155,48,56,0.0,0.0
1008,2372,26-09-2019 18:42:00,0,3570.0,2880.0,0.807,17.255,174,114,72,42,60,48,12,9,0.0,0.0
1008,2373,26-09-2019 18:44:00,0,3563.0,2858.0,0.802,17.201,256,138,103,35,118,88,30,47,0.0,0.0
1008,2374,26-09-2019 18:46:00,0,3289.0,2700.0,0.821,15.949,181,93,57,36,88,64,24,42,0.0,0.0
1008,2375,26-09-2019 18:48:00,0,3418.0,2852.0,0.835,16.624,208,98,61,37,110,82,28,8,0.0,0.0
1008,2376,26-09-2019 18:50:00,0,3286.0,2759.0,0.84,16.002,235,79,48,31,156,99,57,10,0.0,0.0
1008,2377,26-09-2019 18:52:00,0,3188.0,2537.0,0.796,15.37,163,49,29,20,114,74,40,13,0.0,0.0
1008,2378,26-09-2019 18:54:00,0,3326.0,2585.0,0.777,15.967,232,81,54,27,151,112,39,8,0.0,0.0
1008,2379,26-09-2019 18:56:00,0,3299.0,2684.0,0.814,15.97,149,71,46,25,78,53,25,6,0.0,0.0
1008,2380,26-09-2019 18:58:00,0,3295.0,2680.0,0.813,15.952,142,100,73,27,42,27,15,7,0.0,0.0
1008,2381,26-09-2019 19:00:00,0,3320.0,2606.0,0.785,15.967,246,123,87,36,123,94,29,9,0.0,0.0
1008,2382,26-09-2019 19:02:00,0,3319.0,2643.0,0.796,16.005,85,3,2,1,82,29,53,0,0.0,0.0
1008,2383,26-09-2019 19:04:00,0,3050.0,2472.0,0.81,14.753,59,10,0,10,49,2,47,0,0.0,0.0
1008,2384,26-09-2019 19:06:00,0,2927.0,2371.0,0.81,14.157,87,74,47,27,13,5,8,0,0.0,0.0
1008,2385,26-09-2019 19:08:00,0,2657.0,2201.0,0.828,12.905,1,1,1,0,0,0,0,0,0.0,0.0
1008,2386,26-09-2019 19:10:00,0,2702.0,2027.0,0.75,12.891,25,25,10,15,0,0,0,0,0.0,0.0
1008,2387,26-09-2019 19:12:00,0,2586.0,1891.0,0.73,12.2825,14,14,5,9,0,0,0,0,0.0,0.0
1008,2388,26-09-2019 19:14:00,0,2470.0,1755.0,0.71,11.674,21,12,3,9,9,7,2,0,0.0,0.0
1008,2389,26-09-2019 19:16:00,0,2457.0,1802.0,0.733,11.676,32,5,2,3,27,22,5,0,0.0,0.0
1008,2390,26-09-2019 19:18:00,0,2849.0,2054.0,0.721,13.501,18,0,0,0,18,2,16,0,0.0,0.0
1008,2391,26-09-2019 19:20:00,0,2857.0,2045.0,0.716,13.522,42,4,1,3,38,4,34,0,0.0,0.0
1008,2392,26-09-2019 19:22:00,0,3149.0,2112.0,0.671,14.745,56,3,0,3,53,7,46,0,0.0,0.0
1008,2393,26-09-2019 19:24:00,0,3008.0,2080.0,0.692,14.155,51,3,1,2,48,5,43,0,0.0,0.0
1008,2394,26-09-2019 19:26:00,0,2890.0,1906.0,0.659,13.499,105,0,0,0,105,82,23,0,0.0,0.0
1008,2395,26-09-2019 19:28:00,0,2613.0,1765.0,0.675,12.248,119,30,14,16,89,48,41,0,0.0,0.0
1008,2396,26-09-2019 19:30:00,0,2875.0,1951.0,0.678,13.49,128,42,22,20,86,50,36,0,0.0,0.0
1008,2397,26-09-2019 19:32:00,0,3155.0,2050.0,0.65,14.7,381,206,159,47,175,129,46,21,0.0,0.0
1008,2398,26-09-2019 19:34:00,0,3126.0,2161.0,0.691,14.711,260,149,117,32,111,81,30,48,0.0,0.0
1008,2399,26-09-2019 19:36:00,0,3124.0,2197.0,0.703,14.741,40,22,0,22,18,4,14,0,0.0,0.0
1008,2400,26-09-2019 19:38:00,0,3146.0,2094.0,0.666,14.714,31,19,0,19,12,2,10,0,0.0,0.0
1008,2401,26-09-2019 19:40:00,0,2872.0,1974.0,0.687,13.502,32,1,0,1,31,5,26,0,0.0,0.0
1008,2402,26-09-2019 19:42:00,0,2758.0,1839.0,0.667,12.902,25,0,0,0,25,0,25,0,0.0,0.0
1008,2403,26-09-2019 19:44:00,0,2479.0,1732.0,0.699,11.687,23,2,0,2,21,9,12,0,0.0,0.0
1008,2404,26-09-2019 19:46:00,0,2484.5,1698.5,0.684,11.671,34,5,0,5,29,6,23,0,0.0,0.0
1008,2405,26-09-2019 19:48:00,0,2490.0,1665.0,0.669,11.655,86,5,3,2,81,48,33,0,0.0,0.0
1008,2406,26-09-2019 19:50:00,0,2765.0,1802.0,0.652,12.891,52,8,2,6,44,23,21,0,0.0,0.0
1008,2407,26-09-2019 19:52:00,0,2893.0,1904.0,0.658,13.507,184,72,32,40,112,84,28,1,0.0,0.0
1008,2408,26-09-2019 19:54:00,0,3155.0,2051.0,0.65,14.702,472,276,231,45,196,150,46,17,0.0,0.0
1008,2409,26-09-2019 19:56:00,0,3120.0,2204.0,0.706,14.732,182,83,66,17,99,78,21,5,0.0,0.0
1008,2410,26-09-2019 19:58:00,0,3164.0,2053.0,0.649,14.74,1,0,0,0,1,0,1,0,0.0,0.0
1008,2411,26-09-2019 20:00:00,0,2886.0,1920.0,0.665,13.497,9,9,2,7,0,0,0,0,0.0,0.0
1008,2412,26-09-2019 20:02:00,0,2758.0,1799.0,0.652,12.858,19,11,2,9,8,5,3,0,0.0,0.0
1008,2413,26-09-2019 20:04:00,0,2473.0,1726.0,0.698,11.655,46,12,3,9,34,8,26,0,0.0,0.0
1008,2414,26-09-2019 20:06:00,0,2481.0,1691.0,0.682,11.646,27,17,3,14,10,6,4,0,0.0,0.0
1008,2415,26-09-2019 20:08:00,0,2351.0,1618.0,0.688,11.054,31,17,8,9,14,5,9,0,0.0,0.0
1008,2416,26-09-2019 20:10:00,0,2496.0,1658.0,0.664,11.671,70,38,13,25,32,6,26,0,0.0,0.0
1008,2417,26-09-2019 20:12:00,0,2889.0,1927.0,0.667,13.517,53,38,9,29,15,5,10,0,0.0,0.0
1008,2418,26-09-2019 20:14:00,0,3172.0,1995.0,0.629,14.707,260,154,99,55,106,61,45,4,0.0,0.0
1008,2419,26-09-2019 20:16:00,0,3157.0,2053.0,0.65,14.713,48,25,16,9,23,14,9,2,0.0,0.0
1008,2420,26-09-2019 20:18:00,0,3162.0,2037.0,0.644,14.715,1,0,0,0,1,0,1,0,0.0,0.0
1008,2421,26-09-2019 20:20:00,0,2957.0,1943.5,0.658,13.803,2,0,0,0,2,2,0,0,0.0,0.0
1008,2422,26-09-2019 20:22:00,0,2752.0,1850.0,0.672,12.891,51,13,9,4,38,17,21,0,0.0,0.0
1008,2423,26-09-2019 20:24:00,0,2759.0,1814.0,0.657,12.88,130,3,1,2,127,93,34,0,0.0,0.0
1008,2424,26-09-2019 20:26:00,0,2771.0,1746.0,0.63,12.853,44,22,8,14,22,17,5,0,0.0,0.0
1008,2425,26-09-2019 20:28:00,0,2494.0,1688.0,0.677,11.697,42,13,7,6,29,20,9,0,0.0,0.0
1008,2426,26-09-2019 20:30:00,0,2741.0,1867.0,0.681,12.867,62,1,0,1,61,39,22,0,0.0,0.0
1008,2427,26-09-2019 20:32:00,0,2747.0,1845.0,0.672,12.868,205,5,0,5,200,171,29,0,0.0,0.0
1008,2428,26-09-2019 20:34:00,0,2764.0,1824.0,0.66,12.911,46,1,0,1,45,5,40,0,0.0,0.0
1008,2429,26-09-2019 20:36:00,0,2746.0,1859.0,0.677,12.877,51,5,0,5,46,3,43,0,0.0,0.0
1008,2430,26-09-2019 20:38:00,0,2762.0,1776.0,0.643,12.849,202,95,68,27,107,56,51,27,0.0,0.0
1008,2431,26-09-2019 20:40:00,0,3041.0,1928.0,0.634,14.119,415,228,178,50,187,146,41,32,0.0,0.0
1008,2432,26-09-2019 20:42:00,0,2764.0,1826.0,0.661,12.911,192,98,72,26,94,75,19,38,0.0,0.0
1008,2433,26-09-2019 20:44:00,0,3027.0,1978.0,0.654,14.116,239,130,94,36,109,85,24,31,0.0,0.0
1008,2434,26-09-2019 20:46:00,0,3028.0,1966.0,0.649,14.108,137,119,71,48,18,13,5,0,0.0,0.0
1008,2435,26-09-2019 20:48:00,0,3029.0,1977.0,0.653,14.125,212,149,108,41,63,47,16,12,0.0,0.0
1008,2436,26-09-2019 20:50:00,0,3009.0,2060.0,0.685,14.135,283,148,115,33,135,103,32,9,0.0,0.0
1008,2437,26-09-2019 20:52:00,0,2965.0,2218.0,0.748,14.139,89,15,2,13,74,35,39,0,0.0,0.0
1008,2438,26-09-2019 20:54:00,0,3193.5,2223.5,0.6995,15.0455,226,109,80,29,117,82,35,12,0.0,0.0
1008,2439,26-09-2019 20:56:00,0,3422.0,2229.0,0.651,15.952,224,106,72,34,118,69,49,12,0.05,0.0
1008,2440,26-09-2019 20:58:00,0,3275.0,2183.0,0.667,15.319,381,191,146,45,190,143,47,115,0.0,0.0
1008,2441,26-09-2019 21:00:00,0,3120.0,2184.0,0.7,14.712,225,146,102,44,79,53,26,95,0.0,0.0
1008,2442,26-09-2019 21:02:00,0,3273.0,2229.0,0.681,15.364,41,19,10,9,22,12,10,4,0.0,0.0
1008,2443,26-09-2019 21:04:00,0,3421.0,2242.0,0.655,15.961,0,0,0,0,0,0,0,0,0.0,0.0
1008,2444,26-09-2019 21:06:00,0,3419.0,2261.0,0.661,15.974,31,30,15,15,1,1,0,3,0.0,0.0
1008,2445,26-09-2019 21:08:00,0,3411.0,2283.0,0.669,15.966,249,77,43,34,172,135,37,5,0.0,0.0
1008,2446,26-09-2019 21:10:00,0,3390.0,2359.0,0.696,15.969,176,84,47,37,92,61,31,6,0.0,0.0
1008,2447,26-09-2019 21:12:00,0,3409.0,2267.0,0.665,15.943,272,109,78,31,163,111,52,8,0.0,0.0
1008,2448,26-09-2019 21:14:00,0,3417.0,2229.0,0.652,15.931,236,83,44,39,153,105,48,6,0.0,0.0
1008,2449,26-09-2019 21:16:00,0,3425.0,2258.0,0.66,15.994,89,74,30,44,15,2,13,2,0.0,0.0
1008,2450,26-09-2019 21:18:00,0,3430.0,2194.0,0.64,15.944,289,91,54,37,198,152,46,2,0.0,0.0
1008,2451,26-09-2019 21:20:00,0,3395.0,2349.0,0.692,15.979,233,120,70,50,113,64,49,0,0.0,0.0
1008,2452,26-09-2019 21:22:00,0,3407.0,2295.0,0.674,15.967,265,111,76,35,154,102,52,14,0.0,0.0
1008,2453,26-09-2019 21:24:00,0,3149.0,2085.0,0.662,14.715,165,88,53,35,77,46,31,10,0.0,0.0
1008,2454,26-09-2019 21:26:00,0,3144.0,2112.0,0.672,14.728,81,34,19,15,47,25,22,0,0.0,0.0
1008,2455,26-09-2019 21:28:00,0,3147.5,2107.5,0.6695,14.7355,114,45,21,24,69,46,23,0,0.0,0.0
1008,2456,26-09-2019 21:30:00,0,3151.0,2103.0,0.667,14.743,281,99,58,41,182,127,55,27,0.0,0.0
1008,2457,26-09-2019 21:32:00,0,3136.0,2123.0,0.677,14.708,165,105,70,35,60,48,12,35,0.0,0.0
1008,2458,26-09-2019 21:34:00,0,3131.0,2127.0,0.679,14.69,176,105,69,36,71,44,27,8,0.0,0.0
1008,2459,26-09-2019 21:36:00,0,3147.0,2149.0,0.683,14.78,181,117,79,38,64,46,18,19,0.0,0.0
1008,2460,26-09-2019 21:38:00,0,3147.0,2127.0,0.676,14.757,179,85,51,34,94,64,30,11,0.0,0.0
1008,2461,26-09-2019 21:40:00,0,3135.0,2131.0,0.68,14.711,108,35,9,26,73,46,27,0,0.0,0.0
1008,2462,26-09-2019 21:42:00,0,3148.0,2144.0,0.681,14.776,44,6,1,5,38,14,24,0,0.0,0.0
1008,2463,26-09-2019 21:44:00,0,3166.0,2030.0,0.641,14.722,66,0,0,0,66,33,33,0,0.0,0.0
1008,2464,26-09-2019 21:46:00,0,2741.0,1894.0,0.691,12.898,73,1,1,0,72,48,24,0,0.0,0.0
1008,2465,26-09-2019 21:48:00,0,2764.0,1798.0,0.65,12.882,15,0,0,0,15,5,10,0,0.0,0.0
1008,2466,26-09-2019 21:50:00,0,2624.0,1736.0,0.662,12.262,1,0,0,0,1,0,1,0,0.0,0.0
1008,2467,26-09-2019 21:52:00,0,2353.0,1598.0,0.679,11.041,6,0,0,0,6,0,6,0,0.0,0.0
1008,2468,26-09-2019 21:54:00,0,2238.0,1474.0,0.658,10.449,34,9,0,9,25,3,22,0,0.0,0.0
1008,2469,26-09-2019 21:56:00,0,2374.0,1528.0,0.644,11.045,32,0,0,0,32,17,15,0,0.0,0.0
1008,2470,26-09-2019 21:58:00,0,2374.0,1509.0,0.635,11.027,64,0,0,0,64,45,19,0,0.0,0.0
1008,2471,26-09-2019 22:00:00,0,2380.0,1506.0,0.633,11.045,16,3,0,3,13,8,5,0,0.0,0.0
1008,2472,26-09-2019 22:02:00,0,2239.5,1441.5,0.6445,10.42,239,0,0,0,239,214,25,0,0.0,0.0
1008,2473,26-09-2019 22:04:00,0,2099.0,1377.0,0.656,9.795,44,8,5,3,36,16,20,0,0.0,0.0
1008,2474,26-09-2019 22:06:00,0,2098.0,1410.0,0.672,9.826,50,12,0,12,38,15,23,0,0.0,0.0
1008,2475,26-09-2019 22:08:00,0,2105.0,1403.0,0.666,9.848,19,0,0,0,19,4,15,0,0.0,0.0
1008,2476,26-09-2019 22:10:00,0,2081.0,1479.0,0.711,9.836,6,0,0,0,6,2,4,0,0.0,0.0
1008,2477,26-09-2019 22:12:00,0,2071.0,1470.0,0.709,9.789,19,0,0,0,19,6,13,0,0.0,0.0
1008,2478,26-09-2019 22:14:00,0,2231.0,1493.0,0.669,10.442,21,0,0,0,21,9,12,0,0.0,0.0
1008,2479,26-09-2019 22:16:00,0,2375.0,1503.0,0.633,11.024,9,4,3,1,5,0,5,0,0.0,0.0
1008,2480,26-09-2019 22:18:00,0,2356.0,1590.0,0.675,11.044,0,0,0,0,0,0,0,0,0.0,0.0
1008,2481,26-09-2019 22:20:00,0,2348.0,1617.0,0.689,11.04,141,35,23,12,106,70,36,1,0.0,0.0
1008,2482,26-09-2019 22:22:00,0,2483.0,1683.0,0.678,11.648,272,142,106,36,130,100,30,6,0.0,0.0
1008,2483,26-09-2019 22:24:00,0,2742.0,1874.0,0.684,12.878,252,148,112,36,104,67,37,53,0.0,0.0
1008,2484,26-09-2019 22:26:00,0,3018.0,1993.0,0.66,14.1,215,97,75,22,118,91,27,7,0.0,0.0
1008,2485,26-09-2019 22:28:00,0,3121.0,2173.0,0.696,14.702,204,66,50,16,138,97,41,9,0.0,0.0
1008,2486,26-09-2019 22:30:00,0,3125.0,2175.0,0.696,14.722,185,112,70,42,73,39,34,4,0.0,0.0
1008,2487,26-09-2019 22:32:00,0,3135.0,2139.0,0.682,14.723,271,108,85,23,163,121,42,29,0.05,0.0
1008,2488,26-09-2019 22:34:00,0,3139.0,2130.0,0.679,14.727,259,138,97,41,121,88,33,26,0.0,0.0
1008,2489,26-09-2019 22:36:00,0,3359.5,2198.5,0.656,15.6715,410,229,192,37,181,133,48,83,0.01,0.0
1008,2490,26-09-2019 22:38:00,0,3580.0,2267.0,0.633,16.616,216,138,100,38,78,59,19,16,0.0,0.0
1008,2491,26-09-2019 22:40:00,0,3536.0,2383.0,0.674,16.573,369,241,191,50,128,103,25,35,0.0,0.0
1008,2492,26-09-2019 22:42:00,0,3964.0,2479.0,0.625,18.363,565,373,293,80,192,151,41,36,0.0,0.0
1008,2493,26-09-2019 22:44:00,0,3688.0,2429.0,0.658,17.222,466,314,236,78,152,121,31,36,0.0,0.0
1008,2494,26-09-2019 22:46:00,0,3955.0,2576.0,0.651,18.436,401,266,191,75,135,107,28,26,0.0,0.0
1008,2495,26-09-2019 22:48:00,0,3941.0,2556.0,0.649,18.357,390,278,223,55,112,83,29,39,0.0,0.0
1008,2496,26-09-2019 22:50:00,0,3948.0,2601.0,0.659,18.437,330,200,140,60,130,102,28,5,0.0,0.0
1008,2497,26-09-2019 22:52:00,0,3296.0,2154.0,0.653,15.37,110,106,58,48,4,2,2,14,0.0,0.0
1008,2498,26-09-2019 22:54:00,0,3422.0,2240.0,0.655,15.964,133,83,55,28,50,29,21,10,0.0,0.0
1008,2499,26-09-2019 22:56:00,0,3958.0,2496.0,0.631,18.36,201,167,113,54,34,17,17,2,0.0,0.0
1008,2500,26-09-2019 22:58:00,0,3811.0,2497.0,0.655,17.781,329,223,170,53,106,82,24,43,0.0,0.0
1008,2501,26-09-2019 23:00:00,0,3297.0,2119.0,0.643,15.336,206,141,95,46,65,48,17,3,0.0,0.0
1008,2502,26-09-2019 23:02:00,0,3563.0,2271.0,0.638,16.552,155,98,54,44,57,34,23,5,0.0,0.0
1008,2503,26-09-2019 23:04:00,0,3563.0,2318.0,0.651,16.606,41,12,4,8,29,10,19,0,0.0,0.0
1008,2504,26-09-2019 23:06:00,0,3544.0,2358.0,0.665,16.575,90,53,26,27,37,19,18,2,0.0,0.0
1008,2505,26-09-2019 23:08:00,0,3529.0,2405.0,0.682,16.568,21,7,5,2,14,8,6,0,0.0,0.0
1008,2506,26-09-2019 23:10:00,0,3481.5,2304.0,0.6615,16.2685,171,58,28,30,113,78,35,1,0.05,0.0
1008,2507,26-09-2019 23:12:00,0,3434.0,2203.0,0.641,15.969,141,48,27,21,93,65,28,0,0.0,0.0
1008,2508,26-09-2019 23:14:00,0,3433.0,2198.0,0.64,15.959,212,129,91,38,83,57,26,11,0.03,0.0
1008,2509,26-09-2019 23:16:00,0,3695.0,2365.0,0.64,17.178,206,82,53,29,124,80,44,11,0.11,0.0
1008,2510,26-09-2019 23:18:00,0,3707.0,2276.0,0.614,17.127,75,52,21,31,23,13,10,0,0.0,0.0
1008,2511,26-09-2019 23:20:00,0,3432.0,2210.0,0.644,15.971,293,205,157,48,88,60,28,17,0.0,0.0
1008,2512,26-09-2019 23:22:00,0,3708.0,2338.0,0.63,17.2,354,209,154,55,145,108,37,18,0.0,0.0
1008,2513,26-09-2019 23:24:00,0,3061.0,1849.0,0.604,14.109,204,115,69,46,89,67,22,6,0.0,0.0
1008,2514,26-09-2019 23:26:00,0,3438.0,2186.0,0.636,15.967,190,88,58,30,102,71,31,7,0.0,0.0
1008,2515,26-09-2019 23:28:00,0,3703.0,2312.0,0.624,17.151,212,97,75,22,115,82,33,13,0.0,0.0
1008,2516,26-09-2019 23:30:00,0,3695.0,2373.0,0.642,17.186,327,98,54,44,229,158,71,19,0.0,0.0
1008,2517,26-09-2019 23:32:00,0,3431.0,2184.0,0.637,15.936,410,227,176,51,183,131,52,26,0.0,0.0
1008,2518,26-09-2019 23:34:00,0,3702.0,2356.0,0.636,17.196,481,284,218,66,197,144,53,37,0.0,0.0
1008,2519,26-09-2019 23:36:00,0,3716.0,2280.0,0.614,17.165,349,257,191,66,92,47,45,25,0.0,0.0
1008,2520,26-09-2019 23:38:00,0,3705.0,2345.0,0.633,17.194,545,376,289,87,169,120,49,41,0.0,0.0
1008,2521,26-09-2019 23:40:00,0,3703.0,2344.0,0.633,17.186,492,366,287,79,126,91,35,46,0.0,0.0
1008,2522,26-09-2019 23:42:00,0,4122.0,2522.0,0.612,19.035,198,124,93,31,74,42,32,9,0.14,0.0
1008,2523,26-09-2019 23:44:00,0,3902.0,2476.5,0.636,18.1165,126,61,34,27,65,41,24,0,0.0,0.0
1008,2524,26-09-2019 23:46:00,0,3682.0,2431.0,0.66,17.198,119,35,18,17,84,54,30,2,0.0,0.0
1008,2525,26-09-2019 23:48:00,0,3401.0,2279.0,0.67,15.922,126,61,26,35,65,28,37,0,0.0,0.0
1008,2526,26-09-2019 23:50:00,0,3285.0,2184.0,0.665,15.36,161,114,61,53,47,22,25,2,0.0,0.0
1008,2527,26-09-2019 23:52:00,0,3412.0,2227.0,0.653,15.911,146,79,38,41,67,35,32,0,0.0,0.0
1008,2528,26-09-2019 23:54:00,0,3138.0,2155.0,0.687,14.752,152,107,63,44,45,21,24,2,0.0,0.0
1008,2529,26-09-2019 23:56:00,0,3429.0,2224.0,0.649,15.972,172,76,43,33,96,58,38,1,0.0,0.0
1008,2530,26-09-2019 23:58:00,0,3401.0,2303.0,0.677,15.949,194,122,89,33,72,51,21,8,0.0,0.0
1008,2531,27-09-2019 00:00:00,0,3401.0,2307.0,0.678,15.957,515,302,235,67,213,181,32,74,0.0,0.0
1008,2532,27-09-2019 00:02:00,0,3386.0,2376.0,0.702,15.971,396,268,195,73,128,91,37,21,0.0,0.0
1008,2533,27-09-2019 00:04:00,0,3392.0,2322.0,0.685,15.934,126,82,42,40,44,25,19,0,0.0,0.0
1008,2534,27-09-2019 00:06:00,0,3376.0,2387.0,0.707,15.944,205,97,50,47,108,70,38,0,0.0,0.0
1008,2535,27-09-2019 00:08:00,0,3269.0,2223.0,0.68,15.34,170,91,45,46,79,44,35,2,0.0,0.0
1008,2536,27-09-2019 00:10:00,0,3123.0,2181.0,0.698,14.72,227,87,57,30,140,101,39,0,0.0,0.0
1008,2537,27-09-2019 00:12:00,0,3271.0,2219.0,0.678,15.343,321,142,97,45,179,130,49,9,0.0,0.0
1008,2538,27-09-2019 00:14:00,0,3123.0,2181.0,0.698,14.722,336,169,132,37,167,120,47,20,0.0,0.0
1008,2539,27-09-2019 00:16:00,0,3257.0,2260.0,0.694,15.334,248,127,86,41,121,89,32,49,0.0,0.0
1008,2540,27-09-2019 00:18:00,0,3419.5,2241.5,0.6575,15.9545,292,140,100,40,152,105,47,4,0.0,0.0
1008,2541,27-09-2019 00:20:00,0,3582.0,2223.0,0.621,16.575,221,97,55,42,124,73,51,0,0.0,0.0
1008,2542,27-09-2019 00:22:00,0,3558.0,2266.0,0.637,16.53,226,128,93,35,98,67,31,13,0.0,0.0
1008,2543,27-09-2019 00:24:00,0,3422.0,2234.0,0.653,15.955,404,326,243,83,78,59,19,32,0.0,0.0
1008,2544,27-09-2019 00:26:00,0,3566.0,2292.0,0.643,16.587,263,135,96,39,128,90,38,5,0.03,0.0
1008,2545,27-09-2019 00:28:00,0,3575.0,2224.0,0.622,16.547,120,42,24,18,78,55,23,7,0.0,0.0
1008,2546,27-09-2019 00:30:00,0,3278.0,2190.0,0.668,15.343,289,82,44,38,207,134,73,9,0.0,0.0
1008,2547,27-09-2019 00:32:00,0,3280.0,2164.0,0.66,15.319,75,3,1,2,72,57,15,0,0.0,0.0
1008,2548,27-09-2019 00:34:00,0,3322.0,2052.0,0.618,15.362,5,0,0,0,5,3,2,0,0.0,0.0
1008,2549,27-09-2019 00:36:00,0,2881.0,1941.0,0.674,13.499,2,0,0,0,2,2,0,0,0.0,0.0
1008,2550,27-09-2019 00:38:00,0,2904.0,1859.0,0.64,13.5,10,3,0,3,7,0,7,0,0.0,0.0
1008,2551,27-09-2019 00:40:00,0,2904.0,1837.0,0.633,13.475,23,0,0,0,23,7,16,0,0.0,0.0
1008,2552,27-09-2019 00:42:00,0,2919.0,1772.0,0.607,13.461,104,28,13,15,76,48,28,0,0.0,0.0
1008,2553,27-09-2019 00:44:00,0,2476.0,1702.0,0.688,11.64,17,0,0,0,17,4,13,0,0.0,0.0
1008,2554,27-09-2019 00:46:00,0,2497.0,1655.0,0.663,11.672,17,1,0,1,16,2,14,0,0.0,0.0
1008,2555,27-09-2019 00:48:00,0,2509.0,1592.0,0.634,11.648,32,1,1,0,31,18,13,0,0.0,0.0
1008,2556,27-09-2019 00:50:00,0,2529.0,1517.0,0.6,11.644,5,0,0,0,5,0,5,0,0.0,0.0
1008,2557,27-09-2019 00:52:00,0,2315.0,1452.0,0.63,10.73,14,2,0,2,12,6,6,0,0.0,0.0
1008,2558,27-09-2019 00:54:00,0,2101.0,1387.0,0.66,9.816,0,0,0,0,0,0,0,0,0.0,0.0
1008,2559,27-09-2019 00:56:00,0,2111.0,1338.0,0.634,9.8,37,9,1,8,28,17,11,0,0.0,0.0
1008,2560,27-09-2019 00:58:00,0,2114.0,1329.0,0.629,9.803,25,2,1,1,23,6,17,0,0.0,0.0
1008,2561,27-09-2019 01:00:00,0,1979.0,1260.0,0.637,9.194,46,4,4,0,42,12,30,0,0.0,0.0
1008,2562,27-09-2019 01:02:00,0,1684.0,1199.0,0.712,7.961,63,20,14,6,43,22,21,0,0.0,0.0
1008,2563,27-09-2019 01:04:00,0,1839.0,1234.0,0.671,8.612,19,3,0,3,16,1,15,0,0.0,0.0
1008,2564,27-09-2019 01:06:00,0,1684.0,1235.0,0.733,8.005,18,3,0,3,15,2,13,0,0.0,0.0
1008,2565,27-09-2019 01:08:00,0,1692.0,1178.0,0.696,7.969,18,2,0,2,16,0,16,0,0.0,0.0
1008,2566,27-09-2019 01:10:00,0,1703.0,1130.0,0.664,7.96,17,1,0,1,16,0,16,0,0.0,0.0
1008,2567,27-09-2019 01:12:00,0,1717.0,1105.0,0.644,7.989,63,16,9,7,47,25,22,0,0.0,0.0
1008,2568,27-09-2019 01:14:00,0,1710.0,1119.0,0.654,7.979,23,0,0,0,23,5,18,0,0.0,0.0
1008,2569,27-09-2019 01:16:00,0,1709.0,1093.0,0.639,7.942,22,1,0,1,21,6,15,0,0.0,0.0
1008,2570,27-09-2019 01:18:00,0,1729.0,1065.0,0.616,7.994,15,0,0,0,15,2,13,0,0.0,0.0
1008,2571,27-09-2019 01:20:00,0,1577.0,1037.0,0.658,7.361,21,0,0,0,21,5,16,0,0.0,0.0
1008,2572,27-09-2019 01:22:00,0,1429.0,1008.0,0.706,6.746,49,0,0,0,49,17,32,0,0.0,0.0
1008,2573,27-09-2019 01:24:00,0,1435.0,987.0,0.688,6.746,10,0,0,0,10,0,10,0,0.0,0.0
1008,2574,27-09-2019 01:26:00,0,1439.5,972.0,0.6755,6.747,14,0,0,0,14,0,14,0,0.0,0.0
1008,2575,27-09-2019 01:28:00,0,1444.0,957.0,0.663,6.748,16,0,0,0,16,0,16,0,0.0,0.0
1008,2576,27-09-2019 01:30:00,0,1440.0,964.0,0.669,6.742,20,0,0,0,20,0,20,0,0.0,0.0
1008,2577,27-09-2019 01:32:00,0,1443.0,969.0,0.671,6.759,13,1,0,1,12,0,12,0,0.0,0.0
1008,2578,27-09-2019 01:34:00,0,1439.0,964.0,0.67,6.736,0,0,0,0,0,0,0,0,0.0,0.0
1008,2579,27-09-2019 01:36:00,0,1446.0,957.0,0.662,6.758,1,0,0,0,1,0,1,0,0.0,0.0
1008,2580,27-09-2019 01:38:00,0,1444.0,946.0,0.655,6.738,32,5,2,3,27,21,6,0,0.0,0.0
1008,2581,27-09-2019 01:40:00,0,1430.0,1015.0,0.71,6.759,172,84,50,34,88,45,43,0,0.0,0.0
1008,2582,27-09-2019 01:42:00,0,1829.0,1240.0,0.678,8.58,360,191,143,48,169,128,41,47,0.0,0.0
1008,2583,27-09-2019 01:44:00,0,2102.0,1390.0,0.661,9.821,225,132,95,37,93,59,34,70,0.0,0.0
1008,2584,27-09-2019 01:46:00,0,2359.0,1582.0,0.671,11.046,262,118,88,30,144,113,31,39,0.0,0.0
1008,2585,27-09-2019 01:48:00,0,3190.0,1947.0,0.61,14.723,73,21,6,15,52,31,21,0,0.0,0.0
1008,2586,27-09-2019 01:50:00,0,3174.0,2003.0,0.631,14.726,209,110,82,28,99,61,38,40,0.02,0.0
1008,2587,27-09-2019 01:52:00,0,3038.0,1903.0,0.626,14.076,214,122,91,31,92,69,23,18,0.0,0.0
1008,2588,27-09-2019 01:54:00,0,2767.0,1823.0,0.659,12.92,51,27,8,19,24,10,14,1,0.0,0.0
1008,2589,27-09-2019 01:56:00,0,3171.0,2003.0,0.632,14.712,203,95,55,40,108,61,47,6,0.0,0.0
1008,2590,27-09-2019 01:58:00,0,3163.0,2033.0,0.643,14.713,239,69,46,23,170,118,52,9,0.0,0.0
1008,2591,27-09-2019 02:00:00,0,3493.5,2244.0,0.6425,16.25,198,147,97,50,51,33,18,50,0.0,0.0
1008,2592,27-09-2019 02:02:00,0,3824.0,2455.0,0.642,17.787,230,86,64,22,144,101,43,29,0.0,0.0
1008,2593,27-09-2019 02:04:00,0,3145.0,2109.0,0.671,14.726,235,203,153,50,32,20,12,23,0.0,0.0
1008,2594,27-09-2019 02:06:00,0,3280.0,2132.0,0.65,15.285,304,180,121,59,124,89,35,11,0.0,0.0
1008,2595,27-09-2019 02:08:00,0,3159.0,2049.0,0.649,14.715,3,2,1,1,1,1,0,0,0.0,0.0
1008,2596,27-09-2019 02:10:00,0,3150.0,2107.0,0.669,14.747,155,46,33,13,109,71,38,0,0.0,0.0
1008,2597,27-09-2019 02:12:00,0,3158.0,2057.0,0.651,14.719,182,105,79,26,77,46,31,5,0.0,0.0
1008,2598,27-09-2019 02:14:00,0,3166.0,2054.0,0.649,14.75,111,58,30,28,53,29,24,1,0.0,0.0
1008,2599,27-09-2019 02:16:00,0,3143.0,2098.0,0.667,14.707,72,52,26,26,20,10,10,0,0.0,0.0
1008,2600,27-09-2019 02:18:00,0,3171.0,2023.0,0.638,14.734,117,63,24,39,54,30,24,0,0.0,0.0
1008,2601,27-09-2019 02:20:00,0,3042.0,1930.0,0.634,14.123,81,43,18,25,38,18,20,0,0.0,0.0
1008,2602,27-09-2019 02:22:00,0,3181.0,1959.0,0.616,14.702,162,118,87,31,44,34,10,11,0.0,0.0
1008,2603,27-09-2019 02:24:00,0,3189.0,1953.0,0.612,14.726,122,61,36,25,61,36,25,4,0.21,0.0
1008,2604,27-09-2019 02:26:00,0,3159.0,2053.0,0.65,14.72,361,181,125,56,180,137,43,13,0.03,0.0
1008,2605,27-09-2019 02:28:00,0,3038.0,1921.0,0.632,14.096,233,91,47,44,142,99,43,0,0.0,0.0
1008,2606,27-09-2019 02:30:00,0,2897.0,1877.0,0.648,13.494,198,144,93,51,54,37,17,8,0.0,0.0
1008,2607,27-09-2019 02:32:00,0,2751.0,1883.0,0.684,12.923,331,269,204,65,62,48,14,23,0.0,0.0
1008,2608,27-09-2019 02:34:00,0,2755.5,1845.5,0.6695,12.899,363,185,141,44,178,138,40,11,0.01,0.0
1008,2609,27-09-2019 02:36:00,0,2760.0,1808.0,0.655,12.875,129,75,36,39,54,33,21,0,0.0,0.0
1008,2610,27-09-2019 02:38:00,0,2900.0,1861.0,0.642,13.487,204,110,80,30,94,55,39,0,0.0,0.0
1008,2611,27-09-2019 02:40:00,0,3051.0,1887.0,0.618,14.112,118,68,41,27,50,27,23,0,0.0,0.0
1008,2612,27-09-2019 02:42:00,0,3050.0,1886.0,0.618,14.104,145,47,21,26,98,64,34,0,0.0,0.0
1008,2613,27-09-2019 02:44:00,0,2773.0,1808.0,0.652,12.93,39,0,0,0,39,2,37,0,0.0,0.0
1008,2614,27-09-2019 02:46:00,0,2794.0,1676.0,0.6,12.864,37,0,0,0,37,2,35,0,0.0,0.0
1008,2615,27-09-2019 02:48:00,0,2368.0,1561.0,0.659,11.06,31,3,1,2,28,6,22,0,0.0,0.0
1008,2616,27-09-2019 02:50:00,0,2394.0,1447.0,0.604,11.036,2,2,0,2,0,0,0,0,0.0,0.0
1008,2617,27-09-2019 02:52:00,0,2115.0,1342.0,0.635,9.818,1,1,0,1,0,0,0,0,0.0,0.0
1008,2618,27-09-2019 02:54:00,0,2132.0,1290.0,0.605,9.828,1,0,0,0,1,0,1,0,0.0,0.0
1008,2619,27-09-2019 02:56:00,0,2142.0,1248.0,0.583,9.823,4,2,0,2,2,1,1,0,0.0,0.0
1008,2620,27-09-2019 02:58:00,0,2142.0,1200.0,0.56,9.77,3,1,0,1,2,0,2,0,0.0,0.0
1008,2621,27-09-2019 03:00:00,0,2149.0,1211.0,0.564,9.811,24,0,0,0,24,2,22,0,0.0,0.0
1008,2622,27-09-2019 03:02:00,0,1846.0,1180.0,0.64,8.579,12,0,0,0,12,0,12,0,0.0,0.0
1008,2623,27-09-2019 03:04:00,0,1851.0,1157.0,0.625,8.574,3,0,0,0,3,0,3,0,0.0,0.0
1008,2624,27-09-2019 03:06:00,0,2006.0,1174.0,0.585,9.203,1,1,0,1,0,0,0,0,0.0,0.0
1008,2625,27-09-2019 03:08:00,0,1853.0,1162.5,0.631,8.588,3,0,0,0,3,0,3,0,0.0,0.0
1008,2626,27-09-2019 03:10:00,0,1700.0,1151.0,0.677,7.973,3,1,1,0,2,1,1,0,0.0,0.0
1008,2627,27-09-2019 03:12:00,0,1707.0,1125.0,0.659,7.97,5,3,0,3,2,1,1,0,0.0,0.0
1008,2628,27-09-2019 03:14:00,0,1717.0,1102.0,0.642,7.985,2,1,0,1,1,0,1,0,0.0,0.0
1008,2629,27-09-2019 03:16:00,0,1722.0,1063.0,0.617,7.962,2,0,0,0,2,0,2,0,0.0,0.0
1008,2630,27-09-2019 03:18:00,0,1727.0,1048.0,0.607,7.966,61,7,5,2,54,5,49,0,0.0,0.0
1008,2631,27-09-2019 03:20:00,0,1732.0,1042.0,0.602,7.978,38,0,0,0,38,2,36,0,0.0,0.0
1008,2632,27-09-2019 03:22:00,0,1734.0,1037.0,0.598,7.979,17,0,0,0,17,8,9,0,0.0,0.0
1008,2633,27-09-2019 03:24:00,0,1733.0,1025.0,0.591,7.961,0,0,0,0,0,0,0,0,0.0,0.0
1008,2634,27-09-2019 03:26:00,0,1743.0,1007.0,0.578,7.982,11,9,0,9,2,2,0,0,0.0,0.0
1008,2635,27-09-2019 03:28:00,0,1591.0,993.0,0.624,7.368,25,2,0,2,23,3,20,0,0.0,0.0
1008,2636,27-09-2019 03:30:00,0,1592.0,975.0,0.612,7.354,19,1,0,1,18,6,12,0,0.0,0.0
1008,2637,27-09-2019 03:32:00,0,1447.0,963.0,0.666,6.766,21,0,0,0,21,5,16,0,0.0,0.0
1008,2638,27-09-2019 03:34:00,0,1449.0,925.0,0.638,6.733,9,0,0,0,9,1,8,0,0.0,0.0
1008,2639,27-09-2019 03:36:00,0,1462.0,892.0,0.61,6.748,38,4,2,2,34,10,24,0,0.0,0.0
1008,2640,27-09-2019 03:38:00,0,1465.0,889.0,0.607,6.755,14,1,0,1,13,3,10,0,0.0,0.0
1008,2641,27-09-2019 03:40:00,0,1465.0,877.0,0.599,6.743,1,1,1,0,0,0,0,0,0.0,0.0
1008,2642,27-09-2019 03:42:00,0,1467.0,866.5,0.5905,6.7395,0,0,0,0,0,0,0,0,0.0,0.0
1008,2643,27-09-2019 03:44:00,0,1469.0,856.0,0.582,6.736,9,9,0,9,0,0,0,0,0.0,0.0
1008,2644,27-09-2019 03:46:00,0,1470.0,857.0,0.583,6.74,15,15,0,15,0,0,0,0,0.0,0.0
1008,2645,27-09-2019 03:48:00,0,1477.0,845.0,0.572,6.756,1,1,0,1,0,0,0,0,0.0,0.0
1008,2646,27-09-2019 03:50:00,0,1470.0,848.0,0.577,6.733,10,7,6,1,3,2,1,0,0.0,0.0
1008,2647,27-09-2019 03:52:00,0,1462.0,889.0,0.608,6.746,43,19,8,11,24,14,10,0,0.0,0.0
1008,2648,27-09-2019 03:54:00,0,1447.0,935.0,0.646,6.738,236,129,86,43,107,70,37,14,0.0,0.0
1008,2649,27-09-2019 03:56:00,0,1726.0,1048.0,0.607,7.963,155,80,35,45,75,50,25,0,0.0,0.0
1008,2650,27-09-2019 03:58:00,0,2146.0,1239.0,0.577,9.83,57,29,13,16,28,16,12,0,0.0,0.0
1008,2651,27-09-2019 04:00:00,0,2407.0,1410.0,0.586,11.044,122,37,21,16,85,50,35,0,0.0,0.0
1008,2652,27-09-2019 04:02:00,0,2367.0,1537.0,0.649,11.03,228,116,82,34,112,71,41,60,0.0,0.0
1008,2653,27-09-2019 04:04:00,0,2801.0,1657.0,0.592,12.87,131,49,32,17,82,49,33,0,0.0,0.0
1008,2654,27-09-2019 04:06:00,0,2938.0,1715.0,0.584,13.474,161,80,53,27,81,58,23,16,0.0,0.0
1008,2655,27-09-2019 04:08:00,0,3237.0,1766.0,0.545,14.709,128,93,64,29,35,27,8,7,0.0,0.0
1008,2656,27-09-2019 04:10:00,0,2798.0,1672.0,0.598,12.876,34,33,13,20,1,1,0,2,0.01,0.0
1008,2657,27-09-2019 04:12:00,0,3099.0,1708.0,0.551,14.101,260,128,94,34,132,94,38,32,0.0,0.0
1008,2658,27-09-2019 04:14:00,0,3225.0,1801.0,0.558,14.7,145,77,50,27,68,40,28,3,0.0,0.0
1008,2659,27-09-2019 04:16:00,0,3052.5,1884.5,0.6205,14.1135,141,113,76,37,28,16,12,3,0.0,0.0
1008,2660,27-09-2019 04:18:00,0,2880.0,1968.0,0.683,13.527,244,177,128,49,67,48,19,23,0.0,0.0
1008,2661,27-09-2019 04:20:00,0,2887.0,1910.0,0.662,13.489,306,192,137,55,114,73,41,46,0.06,0.0
1008,2662,27-09-2019 04:22:00,0,3075.0,1795.0,0.584,14.103,142,60,29,31,82,46,36,0,0.0,0.0
1008,2663,27-09-2019 04:24:00,0,3190.0,1951.0,0.612,14.729,161,49,31,18,112,72,40,0,0.0,0.0
1008,2664,27-09-2019 04:26:00,0,3196.0,1892.0,0.592,14.687,201,67,40,27,134,82,52,12,0.0,0.0
1008,2665,27-09-2019 04:28:00,0,3186.0,1942.0,0.61,14.704,161,89,63,26,72,40,32,22,0.0,0.0
1008,2666,27-09-2019 04:30:00,0,2933.0,1748.0,0.596,13.491,144,76,34,42,68,36,32,6,0.0,0.0
1008,2667,27-09-2019 04:32:00,0,3214.0,1839.0,0.572,14.702,95,76,45,31,19,14,5,4,0.0,0.0
1008,2668,27-09-2019 04:34:00,0,3068.0,1818.0,0.592,14.101,123,77,58,19,46,37,9,6,0.0,0.0
1008,2669,27-09-2019 04:36:00,0,3215.0,1834.0,0.571,14.699,103,40,26,14,63,33,30,0,0.0,0.0
1008,2670,27-09-2019 04:38:00,0,2936.0,1746.0,0.595,13.502,124,25,13,12,99,70,29,0,0.0,0.0
1008,2671,27-09-2019 04:40:00,0,2925.0,1785.0,0.61,13.501,608,324,252,72,284,209,75,2,0.0,0.0
1008,2672,27-09-2019 04:42:00,0,2938.0,1728.0,0.588,13.491,59,55,15,40,4,2,2,0,0.0,0.0
1008,2673,27-09-2019 04:44:00,0,2938.0,1713.0,0.583,13.473,0,0,0,0,0,0,0,0,0.0,0.0
1008,2674,27-09-2019 04:46:00,0,2666.0,1607.0,0.603,12.284,0,0,0,0,0,0,0,0,0.0,0.0
1008,2675,27-09-2019 04:48:00,0,2532.0,1514.0,0.598,11.654,0,0,0,0,0,0,0,0,0.0,0.0
1008,2676,27-09-2019 04:50:00,0,2395.0,1446.5,0.6045,11.039,17,1,1,0,16,0,16,0,0.0,0.0
1008,2677,27-09-2019 04:52:00,0,2258.0,1379.0,0.611,10.424,38,14,9,5,24,9,15,0,0.0,0.0
1008,2678,27-09-2019 04:54:00,0,1983.0,1255.0,0.633,9.202,1,1,0,1,0,0,0,0,0.0,0.0
1008,2679,27-09-2019 04:56:00,0,1994.0,1200.0,0.602,9.187,22,22,0,22,0,0,0,0,0.0,0.0
1008,2680,27-09-2019 04:58:00,0,2002.0,1171.0,0.585,9.184,4,4,0,4,0,0,0,0,0.0,0.0
1008,2681,27-09-2019 05:00:00,0,2015.0,1136.0,0.564,9.199,11,11,0,11,0,0,0,0,0.0,0.0
1008,2682,27-09-2019 05:02:00,0,1711.0,1111.0,0.649,7.972,3,2,0,2,1,0,1,0,0.0,0.0
1008,2683,27-09-2019 05:04:00,0,1716.0,1107.0,0.645,7.989,0,0,0,0,0,0,0,0,0.0,0.0
1008,2684,27-09-2019 05:06:00,0,1714.0,1100.0,0.642,7.971,18,18,0,18,0,0,0,0,0.0,0.0
1008,2685,27-09-2019 05:08:00,0,1723.0,1075.0,0.624,7.979,18,13,0,13,5,2,3,0,0.0,0.0
1008,2686,27-09-2019 05:10:00,0,1735.0,1018.0,0.587,7.963,74,37,25,12,37,11,26,0,0.0,0.0
1008,2687,27-09-2019 05:12:00,0,1707.0,1112.0,0.651,7.958,96,41,20,21,55,32,23,1,0.0,0.0
1008,2688,27-09-2019 05:14:00,0,1989.0,1232.0,0.619,9.201,32,21,14,7,11,7,4,0,0.0,0.0
1008,2689,27-09-2019 05:16:00,0,1980.0,1266.0,0.639,9.204,158,92,74,18,66,43,23,52,0.0,0.0
1008,2690,27-09-2019 05:18:00,0,1957.0,1354.0,0.692,9.212,199,130,98,32,69,50,19,9,0.0,0.0
1008,2691,27-09-2019 05:20:00,0,2096.0,1404.0,0.67,9.815,2,0,0,0,2,0,2,0,0.0,0.0
1008,2692,27-09-2019 05:22:00,0,1969.0,1312.0,0.666,9.212,4,1,1,0,3,1,2,0,0.0,0.0
1008,2693,27-09-2019 05:24:00,0,1979.5,1262.5,0.638,9.199,0,0,0,0,0,0,0,0,0.0,0.0
1008,2694,27-09-2019 05:26:00,0,1990.0,1213.0,0.61,9.186,0,0,0,0,0,0,0,0,0.0,0.0
1008,2695,27-09-2019 05:28:00,0,2000.0,1172.0,0.586,9.178,13,12,2,10,1,1,0,0,0.0,0.0
1008,2696,27-09-2019 05:30:00,0,1708.0,1134.0,0.664,7.987,12,11,0,11,1,1,0,0,0.0,0.0
1008,2697,27-09-2019 05:32:00,0,1714.0,1122.0,0.654,7.995,10,6,2,4,4,2,2,0,0.0,0.0
1008,2698,27-09-2019 05:34:00,0,1715.0,1092.0,0.637,7.967,12,0,0,0,12,1,11,0,0.0,0.0
1008,2699,27-09-2019 05:36:00,0,1731.0,1045.0,0.603,7.978,5,0,0,0,5,0,5,0,0.0,0.0
1008,2700,27-09-2019 05:38:00,0,1739.0,1010.0,0.581,7.97,1,0,0,0,1,0,1,0,0.0,0.0
1008,2701,27-09-2019 05:40:00,0,1745.0,981.0,0.562,7.962,5,2,1,1,3,0,3,0,0.0,0.0
1008,2702,27-09-2019 05:42:00,0,1752.0,954.0,0.544,7.959,1,0,0,0,1,0,1,0,0.0,0.0
1008,2703,27-09-2019 05:44:00,0,1754.0,935.0,0.533,7.948,18,13,3,10,5,3,2,0,0.0,0.0
1008,2704,27-09-2019 05:46:00,0,1749.0,956.0,0.546,7.951,0,0,0,0,0,0,0,0,0.0,0.0
1008,2705,27-09-2019 05:48:00,0,1749.0,945.0,0.54,7.94,0,0,0,0,0,0,0,0,0.0,0.0
1008,2706,27-09-2019 05:50:00,0,1603.0,930.0,0.58,7.347,0,0,0,0,0,0,0,0,0.0,0.0
1008,2707,27-09-2019 05:52:00,0,1611.0,909.0,0.565,7.355,0,0,0,0,0,0,0,0,0.0,0.0
1008,2708,27-09-2019 05:54:00,0,1610.0,924.0,0.574,7.365,3,1,0,1,2,1,1,0,0.0,0.0
1008,2709,27-09-2019 05:56:00,0,1603.0,936.0,0.584,7.352,2,0,0,0,2,0,2,0,0.0,0.0
1008,2710,27-09-2019 05:58:00,0,1457.0,909.0,0.6285,6.746,0,0,0,0,0,0,0,0,0.0,0.0
1008,2711,27-09-2019 06:00:00,1,1311.0,882.0,0.673,6.14,23,9,5,4,14,6,8,0,0.0,0.0
1008,2712,27-09-2019 06:02:00,1,1298.0,925.0,0.712,6.139,180,85,58,27,95,66,29,24,0.0,0.0
1008,2713,27-09-2019 06:04:00,1,1713.0,1098.0,0.641,7.963,62,55,19,36,7,1,6,0,0.0,0.0
1008,2714,27-09-2019 06:06:00,1,2116.0,1353.0,0.639,9.834,78,46,28,18,32,27,5,34,0.0,0.0
1008,2715,27-09-2019 06:08:00,1,2794.0,1698.0,0.608,12.89,52,38,16,22,14,6,8,33,0.0,0.0
1008,2716,27-09-2019 06:10:00,1,3464.0,2082.0,0.601,15.955,75,70,31,39,5,1,4,32,0.0,0.01
1008,2717,27-09-2019 06:12:00,1,3428.0,2237.0,0.652,15.983,62,56,19,37,6,1,5,31,0.01,0.0
1008,2718,27-09-2019 06:14:00,1,3552.0,2313.0,0.651,16.558,50,47,11,36,3,1,2,41,0.0,0.03
1008,2719,27-09-2019 06:16:00,1,3693.0,2402.0,0.65,17.21,71,61,27,34,10,1,9,38,0.0,0.09
1008,2720,27-09-2019 06:18:00,1,3673.0,2464.0,0.671,17.2,58,49,27,22,9,2,7,44,0.0,0.0
1008,2721,27-09-2019 06:20:00,1,3615.0,2654.0,0.734,17.181,72,50,17,33,22,0,22,34,0.0,0.16
1008,2722,27-09-2019 06:22:00,1,3640.0,2611.0,0.717,17.234,101,77,47,30,24,5,19,41,0.0,0.04
1008,2723,27-09-2019 06:24:00,1,3616.0,2661.0,0.736,17.193,37,34,13,21,3,2,1,67,0.0,0.02
1008,2724,27-09-2019 06:26:00,1,3621.0,2626.0,0.725,17.174,106,60,30,30,46,27,19,38,0.26,0.1
1008,2725,27-09-2019 06:28:00,1,3631.0,2627.0,0.723,17.216,65,45,21,24,20,11,9,59,0.0,0.04
1008,2726,27-09-2019 06:30:00,1,3581.0,2765.0,0.772,17.17,87,66,35,31,21,2,19,52,0.0,0.03
1008,2727,27-09-2019 06:32:00,1,3438.5,2706.0,0.7875,16.5445,49,30,12,18,19,13,6,5,0.12,0.26
1008,2728,27-09-2019 06:34:00,1,3296.0,2647.0,0.803,15.919,144,85,56,29,59,39,20,42,0.07,0.01
1008,2729,27-09-2019 06:36:00,1,3568.0,2858.0,0.801,17.222,107,87,45,42,20,4,16,53,0.0,0.02
1008,2730,27-09-2019 06:38:00,1,3543.0,2963.0,0.836,17.241,235,117,87,30,118,86,32,38,0.18,0.04
1008,2731,27-09-2019 06:40:00,1,3598.0,2731.0,0.759,17.202,65,49,23,26,16,1,15,40,0.0,0.04
1008,2732,27-09-2019 06:42:00,1,3541.0,2967.0,0.838,17.235,86,69,39,30,17,1,16,61,0.0,0.0
1008,2733,27-09-2019 06:44:00,1,3695.0,2961.0,0.801,17.837,85,69,35,34,16,3,13,49,0.0,0.01
1008,2734,27-09-2019 06:46:00,1,3981.0,3026.0,0.76,19.037,102,62,36,26,40,18,22,39,0.0,0.07
1008,2735,27-09-2019 06:48:00,1,3586.0,2770.0,0.772,17.195,210,121,86,35,89,62,27,28,0.27,0.05
1008,2736,27-09-2019 06:50:00,1,3552.0,2937.0,0.827,17.245,64,36,21,15,28,11,17,28,0.0,0.01
1008,2737,27-09-2019 06:52:00,1,3833.0,3002.0,0.783,18.427,97,67,48,19,30,4,26,54,0.0,0.0
1008,2738,27-09-2019 06:54:00,1,3559.0,2846.0,0.8,17.175,153,81,66,15,72,52,20,1,0.08,0.0
1008,2739,27-09-2019 06:56:00,1,3338.0,2563.0,0.768,15.991,0,0,0,0,0,0,0,0,0.0,0.0
1008,2740,27-09-2019 06:58:00,1,3322.0,2610.0,0.786,15.977,0,0,0,0,0,0,0,0,0.0,0.0
1008,2741,27-09-2019 07:00:00,1,3590.0,2711.0,0.755,17.147,211,93,65,28,118,88,30,31,0.0,0.0
1008,2742,27-09-2019 07:02:00,1,3969.0,3061.0,0.771,19.027,311,179,131,48,132,99,33,24,0.02,0.02
1008,2743,27-09-2019 07:04:00,1,3343.0,2550.0,0.763,15.994,456,223,184,39,233,176,57,4,0.04,0.0
1008,2744,27-09-2019 07:06:00,1,3231.5,2647.0,0.821,15.6625,654,304,248,56,350,264,86,6,0.0,0.0
1008,2745,27-09-2019 07:08:00,1,3120.0,2744.0,0.879,15.331,466,284,220,64,182,138,44,31,0.0,0.06
1008,2746,27-09-2019 07:10:00,1,3100.0,2867.0,0.925,15.387,399,248,192,56,151,100,51,3,0.04,0.0
1008,2747,27-09-2019 07:12:00,1,3128.0,2730.0,0.873,15.346,196,112,91,21,84,62,22,1,0.0,0.0
1008,2748,27-09-2019 07:14:00,1,2928.0,2370.0,0.81,14.16,10,6,1,5,4,2,2,0,0.0,0.0
1008,2749,27-09-2019 07:16:00,1,2938.0,2328.0,0.792,14.153,128,9,4,5,119,83,36,0,0.0,0.0
1008,2750,27-09-2019 07:18:00,1,2903.0,2467.0,0.85,14.17,95,36,21,15,59,42,17,0,0.0,0.0
1008,2751,27-09-2019 07:20:00,1,3037.0,2533.0,0.834,14.771,9,0,0,0,9,1,8,0,0.0,0.0
1008,2752,27-09-2019 07:22:00,1,2930.0,2333.0,0.796,14.127,10,5,2,3,5,0,5,0,0.0,0.0
1008,2753,27-09-2019 07:24:00,1,2946.0,2294.0,0.779,14.148,4,0,0,0,4,2,2,0,0.0,0.0
1008,2754,27-09-2019 07:26:00,1,2791.0,2278.0,0.816,13.52,4,2,1,1,2,0,2,0,0.0,0.0
1008,2755,27-09-2019 07:28:00,1,2650.0,2246.0,0.848,12.927,0,0,0,0,0,0,0,0,0.0,0.0
1008,2756,27-09-2019 07:30:00,1,2510.0,2178.0,0.868,12.302,0,0,0,0,0,0,0,0,0.0,0.0
1008,2757,27-09-2019 07:32:00,1,2533.0,2108.0,0.832,12.314,24,8,7,1,16,8,8,0,0.0,0.0
1008,2758,27-09-2019 07:34:00,1,2538.0,2074.0,0.817,12.297,147,47,16,31,100,56,44,0,0.0,0.0
1008,2759,27-09-2019 07:36:00,1,2501.0,2216.0,0.886,12.307,105,50,26,24,55,37,18,44,0.08,0.0
1008,2760,27-09-2019 07:38:00,1,2940.0,2302.0,0.783,14.133,55,29,16,13,26,4,22,71,0.0,0.0
1008,2761,27-09-2019 07:40:00,1,2913.5,2404.0,0.8255,14.142,52,42,18,24,10,3,7,52,0.0,0.0
1008,2762,27-09-2019 07:42:00,1,2887.0,2506.0,0.868,14.151,57,42,14,28,15,4,11,59,0.0,0.0
1008,2763,27-09-2019 07:44:00,1,3019.0,2579.0,0.854,14.749,93,53,34,19,40,30,10,20,0.0,0.0
1008,2764,27-09-2019 07:46:00,1,2497.0,2237.0,0.896,12.313,13,1,0,1,12,8,4,0,0.0,0.0
1008,2765,27-09-2019 07:48:00,1,2398.0,1998.0,0.833,11.662,1,0,0,0,1,0,1,0,0.0,0.0
1008,2766,27-09-2019 07:50:00,1,2292.0,1857.0,0.81,11.087,0,0,0,0,0,0,0,0,0.0,0.0
1008,2767,27-09-2019 07:52:00,1,2306.0,1782.0,0.773,11.06,1,0,0,0,1,0,1,0,0.0,0.0
1008,2768,27-09-2019 07:54:00,1,2299.0,1802.0,0.784,11.052,31,13,8,5,18,14,4,0,0.0,0.0
1008,2769,27-09-2019 07:56:00,1,2285.0,1862.0,0.815,11.063,2,0,0,0,2,1,1,0,0.0,0.0
1008,2770,27-09-2019 07:58:00,1,2265.0,1919.0,0.847,11.05,4,1,0,1,3,1,2,0,0.0,0.0
1008,2771,27-09-2019 08:00:00,1,2262.0,1953.0,0.863,11.075,4,1,0,1,3,0,3,0,0.0,0.0
1008,2772,27-09-2019 08:02:00,1,2279.0,1903.0,0.835,11.084,8,0,0,0,8,2,6,0,0.0,0.0
1008,2773,27-09-2019 08:04:00,1,2274.0,1877.0,0.826,11.039,0,0,0,0,0,0,0,0,0.0,0.0
1008,2774,27-09-2019 08:06:00,1,2286.0,1870.0,0.818,11.076,0,0,0,0,0,0,0,0,0.0,0.0
1008,2775,27-09-2019 08:08:00,1,2284.0,1869.0,0.818,11.068,0,0,0,0,0,0,0,0,0.0,0.0
1008,2776,27-09-2019 08:10:00,1,2275.0,1872.0,0.823,11.037,90,29,13,16,61,36,25,0,0.0,0.0
1008,2777,27-09-2019 08:12:00,1,2279.0,1896.0,0.832,11.077,7,1,0,1,6,1,5,0,0.0,0.0
1008,2778,27-09-2019 08:14:00,1,2283.0,1867.5,0.818,11.0625,0,0,0,0,0,0,0,0,0.0,0.0
1008,2779,27-09-2019 08:16:00,1,2287.0,1839.0,0.804,11.048,81,20,8,12,61,40,21,0,0.0,0.0
1008,2780,27-09-2019 08:18:00,1,2271.0,1913.0,0.843,11.064,7,0,0,0,7,6,1,0,0.0,0.0
1008,2781,27-09-2019 08:20:00,1,2279.0,1870.0,0.82,11.051,31,0,0,0,31,6,25,0,0.0,0.0
1008,2782,27-09-2019 08:22:00,1,2291.0,1830.0,0.799,11.052,30,0,0,0,30,20,10,0,0.0,0.0
1008,2783,27-09-2019 08:24:00,1,2311.0,1804.0,0.781,11.101,51,5,0,5,46,20,26,0,0.0,0.0
1008,2784,27-09-2019 08:26:00,1,2151.0,1773.0,0.824,10.439,22,9,5,4,13,4,9,0,0.0,0.0
1008,2785,27-09-2019 08:28:00,1,2299.0,1788.0,0.777,11.039,232,91,64,27,141,104,37,24,0.0,0.0
1008,2786,27-09-2019 08:30:00,1,2267.0,1935.0,0.854,11.073,48,41,10,31,7,0,7,64,0.0,0.0
1008,2787,27-09-2019 08:32:00,1,2513.0,2162.0,0.86,12.296,75,58,26,32,17,2,15,73,0.0,0.0
1008,2788,27-09-2019 08:34:00,1,2507.0,2215.0,0.883,12.331,78,60,26,34,18,4,14,77,0.0,0.0
1008,2789,27-09-2019 08:36:00,1,2908.0,2451.0,0.843,14.171,63,49,21,28,14,0,14,50,0.0,0.07
1008,2790,27-09-2019 08:38:00,1,2887.0,2518.0,0.872,14.162,48,39,20,19,9,1,8,59,0.0,0.04
1008,2791,27-09-2019 08:40:00,1,2915.0,2397.0,0.822,14.141,68,53,24,29,15,1,14,51,0.0,0.03
1008,2792,27-09-2019 08:42:00,1,3160.0,2631.0,0.832,15.364,47,39,15,24,8,2,6,38,0.0,0.03
1008,2793,27-09-2019 08:44:00,1,3113.0,2834.0,0.91,15.401,56,46,22,24,10,2,8,39,0.0,0.05
1008,2794,27-09-2019 08:46:00,1,3119.0,2782.0,0.892,15.367,125,68,39,29,57,35,22,34,0.24,0.05
1008,2795,27-09-2019 08:48:00,1,2964.5,2787.5,0.943,14.7655,237,147,102,45,90,61,29,13,0.0,0.0
1008,2796,27-09-2019 08:50:00,1,2810.0,2793.0,0.994,14.164,660,335,269,66,325,246,79,14,0.0,0.01
1008,2797,27-09-2019 08:52:00,1,2729.0,2517.0,0.923,13.539,63,56,31,25,7,3,4,45,0.0,0.01
1008,2798,27-09-2019 08:54:00,1,2961.0,2819.0,0.952,14.788,85,83,55,28,2,1,1,38,0.0,0.02
1008,2799,27-09-2019 08:56:00,1,2825.0,2738.0,0.969,14.163,41,39,18,21,2,1,1,38,0.0,0.05
1008,2800,27-09-2019 08:58:00,1,2821.0,2743.0,0.972,14.153,516,339,288,51,177,122,55,3,0.22,0.04
1008,2801,27-09-2019 09:00:00,1,2722.0,2540.0,0.933,13.536,689,329,273,56,360,279,81,4,0.03,0.0
1008,2802,27-09-2019 09:02:00,1,3180.0,3201.0,1.007,16.074,893,465,381,84,428,338,90,13,0.0,0.04
1008,2803,27-09-2019 09:04:00,1,2192.0,2218.0,1.012,11.09,397,248,200,48,149,113,36,13,0.0,0.02
1008,2804,27-09-2019 09:06:00,1,2797.0,2830.0,1.012,14.155,648,368,296,72,280,221,59,5,0.0,0.0
1008,2805,27-09-2019 09:08:00,1,2600.0,2451.0,0.943,12.958,617,49,24,25,568,497,71,0,0.0,0.0
1008,2806,27-09-2019 09:10:00,1,2609.0,2385.0,0.914,12.921,861,55,19,36,806,732,74,0,0.0,0.0
1008,2807,27-09-2019 09:12:00,1,2632.0,2332.0,0.886,12.95,151,31,9,22,120,107,13,0,0.0,0.0
1008,2808,27-09-2019 09:14:00,1,2593.0,2439.0,0.941,12.919,2,2,1,1,0,0,0,0,0.0,0.0
1008,2809,27-09-2019 09:16:00,1,2630.0,2338.0,0.889,12.95,0,0,0,0,0,0,0,0,0.0,0.0
1008,2810,27-09-2019 09:18:00,1,2194.0,2216.0,1.01,11.097,9,9,1,8,0,0,0,0,0.0,0.0
1008,2811,27-09-2019 09:20:00,1,2212.0,2147.0,0.971,11.092,17,7,2,5,10,9,1,0,0.0,0.0
1008,2812,27-09-2019 09:22:00,1,2374.5,2106.0,0.8925,11.687,0,0,0,0,0,0,0,0,0.0,0.0
1008,2813,27-09-2019 09:24:00,1,2537.0,2065.0,0.814,12.282,59,15,7,8,44,38,6,0,0.0,0.0
1008,2814,27-09-2019 09:26:00,1,2506.0,2169.0,0.866,12.274,521,0,0,0,521,485,36,0,0.0,0.0
1008,2815,27-09-2019 09:28:00,1,2502.0,2221.0,0.888,12.317,377,2,1,1,375,337,38,0,0.0,0.0
1008,2816,27-09-2019 09:30:00,1,2502.0,2229.0,0.891,12.326,267,5,1,4,262,244,18,0,0.0,0.0
1008,2817,27-09-2019 09:32:00,1,2511.0,2169.0,0.864,12.297,83,25,4,21,58,52,6,0,0.0,0.0
1008,2818,27-09-2019 09:34:00,1,2534.0,2108.0,0.832,12.318,297,3,0,3,294,253,41,0,0.0,0.0
1008,2819,27-09-2019 09:36:00,1,2533.0,2097.0,0.828,12.302,255,0,0,0,255,218,37,0,0.0,0.0
1008,2820,27-09-2019 09:38:00,1,2244.0,2023.0,0.901,11.08,233,3,0,3,230,190,40,0,0.0,0.0
1008,2821,27-09-2019 09:40:00,1,2249.0,2000.0,0.889,11.076,204,0,0,0,204,171,33,0,0.0,0.0
1008,2822,27-09-2019 09:42:00,1,2264.0,1951.0,0.862,11.082,351,58,38,20,293,249,44,4,0.0,0.0
1008,2823,27-09-2019 09:44:00,1,2263.0,1952.0,0.863,11.076,202,55,21,34,147,130,17,0,0.0,0.0
1008,2824,27-09-2019 09:46:00,1,2243.0,2017.0,0.899,11.072,285,20,3,17,265,229,36,0,0.0,0.0
1008,2825,27-09-2019 09:48:00,1,2534.0,2074.0,0.818,12.282,43,14,1,13,29,23,6,0,0.0,0.0
1008,2826,27-09-2019 09:50:00,1,2544.0,2071.0,0.814,12.317,7,2,1,1,5,2,3,0,0.0,0.0
1008,2827,27-09-2019 09:52:00,1,2248.0,1997.0,0.888,11.067,2,0,0,0,2,0,2,0,0.0,0.0
1008,2828,27-09-2019 09:54:00,1,2273.0,1943.0,0.855,11.108,135,44,32,12,91,81,10,1,0.0,0.0
1008,2829,27-09-2019 09:56:00,1,2277.0,1921.0,0.8435,11.0985,54,4,1,3,50,8,42,0,0.0,0.0
1008,2830,27-09-2019 09:58:00,1,2281.0,1899.0,0.832,11.089,35,0,0,0,35,0,35,0,0.0,0.0
1008,2831,27-09-2019 10:00:00,1,2282.0,1864.0,0.817,11.053,63,12,8,4,51,10,41,0,0.0,0.0
1008,2832,27-09-2019 10:02:00,1,2294.0,1837.0,0.801,11.07,51,0,0,0,51,12,39,0,0.0,0.0
1008,2833,27-09-2019 10:04:00,1,2287.0,1871.0,0.818,11.082,130,1,0,1,129,93,36,0,0.0,0.0
1008,2834,27-09-2019 10:06:00,1,2298.0,1814.0,0.789,11.064,79,2,0,2,77,36,41,0,0.0,0.0
1008,2835,27-09-2019 10:08:00,1,2297.0,1816.0,0.79,11.062,131,0,0,0,131,111,20,0,0.0,0.0
1008,2836,27-09-2019 10:10:00,1,2155.0,1765.0,0.819,10.444,43,0,0,0,43,7,36,0,0.0,0.0
1008,2837,27-09-2019 10:12:00,1,2167.0,1736.0,0.801,10.458,99,8,0,8,91,64,27,0,0.0,0.0
1008,2838,27-09-2019 10:14:00,1,2155.0,1784.0,0.828,10.467,42,1,0,1,41,5,36,0,0.0,0.0
1008,2839,27-09-2019 10:16:00,1,2007.0,1757.0,0.875,9.853,185,16,10,6,169,128,41,0,0.0,0.0
1008,2840,27-09-2019 10:18:00,1,2146.0,1801.0,0.839,10.45,181,5,0,5,176,144,32,0,0.0,0.0
1008,2841,27-09-2019 10:20:00,1,2149.0,1803.0,0.839,10.464,125,6,0,6,119,80,39,0,0.0,0.0
1008,2842,27-09-2019 10:22:00,1,2001.0,1772.0,0.885,9.844,67,12,2,10,55,19,36,0,0.0,0.0
1008,2843,27-09-2019 10:24:00,1,2146.0,1825.0,0.85,10.477,402,42,24,18,360,277,83,0,0.0,0.0
1008,2844,27-09-2019 10:26:00,1,2275.0,1900.0,0.835,11.065,420,1,0,1,419,360,59,0,0.0,0.0
1008,2845,27-09-2019 10:28:00,1,2287.0,1856.0,0.811,11.066,102,0,0,0,102,65,37,0,0.0,0.0
1008,2846,27-09-2019 10:30:00,1,1990.5,1813.0,0.928,9.85,102,0,0,0,102,43,59,0,0.0,0.0
1008,2847,27-09-2019 10:32:00,1,1694.0,1770.0,1.045,8.634,47,0,0,0,47,14,33,0,0.0,0.0
1008,2848,27-09-2019 10:34:00,1,1688.0,1782.0,1.056,8.624,174,55,43,12,119,81,38,2,0.0,0.0
1008,2849,27-09-2019 10:36:00,1,2126.0,1875.0,0.882,10.454,71,2,1,1,69,50,19,0,0.0,0.0
1008,2850,27-09-2019 10:38:00,1,1979.0,1861.0,0.94,9.859,114,7,0,7,107,60,47,0,0.0,0.0
1008,2851,27-09-2019 10:40:00,1,1691.0,1789.0,1.058,8.642,123,0,0,0,123,66,57,0,0.0,0.0
1008,2852,27-09-2019 10:42:00,1,1694.0,1772.0,1.046,8.635,76,0,0,0,76,35,41,0,0.0,0.0
1008,2853,27-09-2019 10:44:00,1,1695.0,1778.0,1.048,8.648,47,0,0,0,47,1,46,0,0.0,0.0
1008,2854,27-09-2019 10:46:00,1,1700.0,1744.0,1.026,8.628,93,9,3,6,84,38,46,0,0.0,0.0
1008,2855,27-09-2019 10:48:00,1,1692.0,1763.0,1.042,8.62,115,17,3,14,98,52,46,0,0.0,0.0
1008,2856,27-09-2019 10:50:00,1,1830.0,1832.0,1.001,9.24,63,4,2,2,59,15,44,0,0.0,0.0
1008,2857,27-09-2019 10:52:00,1,2117.0,1932.0,0.912,10.481,55,2,1,1,53,12,41,0,0.0,0.0
1008,2858,27-09-2019 10:54:00,1,1689.0,1786.0,1.057,8.631,91,30,18,12,61,28,33,0,0.0,0.0
1008,2859,27-09-2019 10:56:00,1,1970.0,1906.0,0.967,9.871,42,16,11,5,26,19,7,5,0.0,0.0
1008,2860,27-09-2019 10:58:00,1,1970.0,1899.0,0.964,9.865,106,45,23,22,61,18,43,62,0.0,0.0
1008,2861,27-09-2019 11:00:00,1,2366.0,2136.0,0.902,11.688,147,48,27,21,99,48,51,55,0.0,0.0
1008,2862,27-09-2019 11:02:00,1,2323.0,2320.0,0.999,11.719,115,53,21,32,62,22,40,51,0.0,0.01
1008,2863,27-09-2019 11:04:00,1,2593.0,2463.0,0.9545,12.943,90,38,11,27,52,2,50,47,0.0,0.01
1008,2864,27-09-2019 11:06:00,1,2863.0,2606.0,0.91,14.167,84,46,14,32,38,0,38,40,0.0,0.04
1008,2865,27-09-2019 11:08:00,1,3147.0,2708.0,0.86,15.398,111,54,30,24,57,8,49,50,0.0,0.06
1008,2866,27-09-2019 11:10:00,1,3134.0,2766.0,0.883,15.413,93,49,29,20,44,4,40,38,0.0,0.07
1008,2867,27-09-2019 11:12:00,1,3130.0,2730.0,0.872,15.356,119,78,48,30,41,9,32,54,0.0,0.0
1008,2868,27-09-2019 11:14:00,1,3100.0,2889.0,0.932,15.414,125,56,22,34,69,20,49,15,0.0,0.23
1008,2869,27-09-2019 11:16:00,1,3127.0,2793.0,0.893,15.412,352,150,114,36,202,139,63,14,0.27,0.0
1008,2870,27-09-2019 11:18:00,1,3162.0,2624.0,0.83,15.366,135,77,46,31,58,9,49,20,0.0,0.0
1008,2871,27-09-2019 11:20:00,1,3526.0,3043.0,0.863,17.263,177,77,52,25,100,49,51,35,0.06,0.0
1008,2872,27-09-2019 11:22:00,1,3527.0,2955.0,0.838,17.167,411,245,185,60,166,132,34,13,0.0,0.13
1008,2873,27-09-2019 11:24:00,1,3540.0,3001.0,0.848,17.269,336,228,174,54,108,72,36,24,0.0,0.0
1008,2874,27-09-2019 11:26:00,1,3554.0,2919.0,0.821,17.236,356,223,162,61,133,102,31,30,0.0,0.0
1008,2875,27-09-2019 11:28:00,1,3514.0,3010.0,0.857,17.178,105,93,54,39,12,4,8,32,0.0,0.0
1008,2876,27-09-2019 11:30:00,1,3562.0,2877.0,0.808,17.221,138,98,63,35,40,25,15,43,0.25,0.0
1008,2877,27-09-2019 11:32:00,1,3271.0,2809.0,0.859,15.999,593,270,207,63,323,245,78,9,0.0,0.0
1008,2878,27-09-2019 11:34:00,1,3050.0,2491.0,0.816,14.776,250,146,98,48,104,75,29,36,0.0,0.18
1008,2879,27-09-2019 11:36:00,1,3533.0,2993.0,0.847,17.234,265,119,99,20,146,110,36,1,0.0,0.0
1008,2880,27-09-2019 11:38:00,1,3182.5,2856.0,0.9035,15.701,142,13,2,11,129,99,30,0,0.0,0.0
1008,2881,27-09-2019 11:40:00,1,2832.0,2719.0,0.96,14.168,251,61,31,30,190,129,61,1,0.0,0.0
1008,2882,27-09-2019 11:42:00,1,2755.0,2437.0,0.885,13.554,58,25,7,18,33,12,21,0,0.0,0.0
1008,2883,27-09-2019 11:44:00,1,2883.0,2487.0,0.862,14.113,85,32,10,22,53,31,22,0,0.0,0.0
1008,2884,27-09-2019 11:46:00,1,2751.0,2449.0,0.89,13.55,68,8,2,6,60,13,47,0,0.0,0.0
1008,2885,27-09-2019 11:48:00,1,2625.0,2358.0,0.898,12.953,64,0,0,0,64,12,52,0,0.0,0.0
1008,2886,27-09-2019 11:50:00,1,2632.0,2340.0,0.889,12.959,41,4,0,4,37,20,17,0,0.0,0.0
1008,2887,27-09-2019 11:52:00,1,2643.0,2280.0,0.862,12.938,33,12,1,11,21,14,7,0,0.0,0.0
1008,2888,27-09-2019 11:54:00,1,2505.0,2216.0,0.885,12.322,8,4,0,4,4,1,3,0,0.0,0.0
1008,2889,27-09-2019 11:56:00,1,2203.0,2182.0,0.99,11.095,6,0,0,0,6,3,3,0,0.0,0.0
1008,2890,27-09-2019 11:58:00,1,2213.0,2144.0,0.969,11.093,4,1,0,1,3,1,2,0,0.0,0.0
1008,2891,27-09-2019 12:00:00,1,2218.0,2106.0,0.949,11.072,7,1,0,1,6,1,5,0,0.0,0.0
1008,2892,27-09-2019 12:02:00,1,2236.0,2083.0,0.932,11.117,33,23,12,11,10,3,7,0,0.0,0.0
1008,2893,27-09-2019 12:04:00,1,2516.0,2142.0,0.851,12.286,15,7,1,6,8,4,4,0,0.0,0.0
1008,2894,27-09-2019 12:06:00,1,2521.0,2129.0,0.845,12.288,3,0,0,0,3,1,2,0,0.0,0.0
1008,2895,27-09-2019 12:08:00,1,2374.0,2126.0,0.896,11.706,87,23,9,14,64,34,30,0,0.0,0.0
1008,2896,27-09-2019 12:10:00,1,2961.0,2236.0,0.755,14.144,19,6,0,6,13,4,9,0,0.0,0.0
1008,2897,27-09-2019 12:12:00,1,2599.0,2133.0,0.831,12.6015,49,21,15,6,28,17,11,0,0.0,0.0
1008,2898,27-09-2019 12:14:00,1,2237.0,2030.0,0.907,11.059,9,2,1,1,7,4,3,0,0.0,0.0
1008,2899,27-09-2019 12:16:00,1,2262.0,1979.0,0.875,11.105,16,0,0,0,16,1,15,0,0.0,0.0
1008,2900,27-09-2019 12:18:00,1,2267.0,1915.0,0.845,11.051,13,6,1,5,7,3,4,0,0.0,0.0
1008,2901,27-09-2019 12:20:00,1,2277.0,1908.0,0.838,11.082,37,36,29,7,1,1,0,0,0.0,0.0
1008,2902,27-09-2019 12:22:00,1,2280.0,1899.0,0.833,11.084,41,24,0,24,17,1,16,0,0.0,0.0
1008,2903,27-09-2019 12:24:00,1,2291.0,1842.0,0.804,11.064,50,27,10,17,23,1,22,0,0.0,0.0
1008,2904,27-09-2019 12:26:00,1,2282.0,1867.0,0.818,11.059,24,8,1,7,16,3,13,0,0.0,0.0
1008,2905,27-09-2019 12:28:00,1,2285.0,1842.0,0.806,11.043,3,0,0,0,3,1,2,0,0.0,0.0
1008,2906,27-09-2019 12:30:00,1,2142.0,1818.0,0.849,10.45,126,62,37,25,64,38,26,0,0.0,0.0
1008,2907,27-09-2019 12:32:00,1,2263.0,1953.0,0.863,11.08,145,55,23,32,90,61,29,0,0.0,0.0
1008,2908,27-09-2019 12:34:00,1,2541.0,2052.0,0.808,12.283,90,51,20,31,39,13,26,0,0.0,0.0
1008,2909,27-09-2019 12:36:00,1,2503.0,2209.0,0.882,12.308,51,31,9,22,20,3,17,0,0.0,0.0
1008,2910,27-09-2019 12:38:00,1,2771.0,2363.0,0.853,13.534,36,15,0,15,21,9,12,0,0.0,0.0
1008,2911,27-09-2019 12:40:00,1,2493.0,2242.0,0.9,12.304,49,4,0,4,45,35,10,0,0.0,0.0
1008,2912,27-09-2019 12:42:00,1,2503.0,2218.0,0.886,12.317,74,0,0,0,74,48,26,0,0.0,0.0
1008,2913,27-09-2019 12:44:00,1,2531.0,2108.0,0.833,12.307,155,58,47,11,97,67,30,1,0.0,0.0
1008,2914,27-09-2019 12:46:00,1,2445.0,2128.0,0.872,11.9895,15,1,1,0,14,7,7,0,0.0,0.0
1008,2915,27-09-2019 12:48:00,1,2359.0,2148.0,0.911,11.672,31,0,0,0,31,0,31,0,0.0,0.0
1008,2916,27-09-2019 12:50:00,1,2231.0,2086.0,0.935,11.101,34,7,4,3,27,7,20,0,0.0,0.0
1009,1,23-09-2019 11:40:00,1,3598.0,2719.0,0.756,17.185,125,59,41,18,66,50,16,5,0.01,0.01
1009,2,23-09-2019 11:42:00,1,3601.0,2687.0,0.746,17.165,30,17,6,11,13,2,11,0,0.02,0.0
1009,3,23-09-2019 11:44:00,1,3889.0,2844.0,0.731,18.474,167,92,65,27,75,57,18,7,0.0,0.0
1009,4,23-09-2019 11:46:00,1,3594.0,2683.0,0.746,17.133,72,45,25,20,27,9,18,0,0.0,0.0
1009,5,23-09-2019 11:48:00,1,3387.0,2595.0,0.766,16.219,56,40,16,24,16,5,11,0,0.0,0.0
1009,6,23-09-2019 11:50:00,1,3404.0,2535.0,0.745,16.22,16,11,7,4,5,2,3,0,0.0,0.0
1009,7,23-09-2019 11:52:00,1,2920.0,2212.0,0.757,13.955,0,0,0,0,0,0,0,0,0.0,0.0
1009,8,23-09-2019 11:54:00,1,2832.0,2130.5,0.752,13.517,1,0,0,0,1,1,0,0,0.0,0.0
1009,9,23-09-2019 11:56:00,1,2744.0,2049.0,0.747,13.079,0,0,0,0,0,0,0,0,0.0,0.0
1009,10,23-09-2019 11:58:00,1,2745.0,2006.0,0.731,13.035,0,0,0,0,0,0,0,0,0.0,0.0
1009,11,23-09-2019 12:00:00,1,2731.0,2033.0,0.744,13.013,0,0,0,0,0,0,0,0,0.0,0.0
1009,12,23-09-2019 12:02:00,1,2741.0,2028.0,0.74,13.046,1,0,0,0,1,0,1,0,0.0,0.01
1009,13,23-09-2019 12:04:00,1,2745.0,1995.0,0.727,13.025,0,0,0,0,0,0,0,0,0.0,0.0
1009,14,23-09-2019 12:06:00,1,2759.0,1986.0,0.72,13.071,13,7,1,6,6,0,6,0,0.0,0.0
1009,15,23-09-2019 12:08:00,1,2763.0,1985.0,0.718,13.086,9,9,1,8,0,0,0,0,0.0,0.0
1009,16,23-09-2019 12:10:00,1,2730.0,2063.0,0.756,13.04,5,5,0,5,0,0,0,0,0.0,0.0
1009,17,23-09-2019 12:12:00,1,2765.0,1985.0,0.718,13.094,4,1,0,1,3,0,3,0,0.0,0.0
1009,18,23-09-2019 12:14:00,1,2777.0,1925.0,0.693,13.073,3,1,0,1,2,0,2,0,0.0,0.0
1009,19,23-09-2019 12:16:00,1,2447.0,1847.0,0.755,11.686,6,6,0,6,0,0,0,0,0.0,0.0
1009,20,23-09-2019 12:18:00,1,2462.0,1858.0,0.755,11.76,8,4,0,4,4,2,2,0,0.0,0.0
1009,21,23-09-2019 12:20:00,1,2444.0,1830.0,0.749,11.657,3,0,0,0,3,0,3,0,0.0,0.0
1009,22,23-09-2019 12:22:00,1,2470.0,1802.0,0.73,11.727,5,0,0,0,5,0,5,0,0.0,0.0
1009,23,23-09-2019 12:24:00,1,2385.0,1718.0,0.72,11.298,14,9,3,6,5,1,4,0,0.0,0.0
1009,24,23-09-2019 12:26:00,1,2454.0,1819.0,0.741,11.682,6,2,0,2,4,1,3,0,0.0,0.0
1009,25,23-09-2019 12:28:00,1,2457.0,1809.0,0.7365,11.6825,1,0,0,0,1,0,1,0,0.0,0.0
1009,26,23-09-2019 12:30:00,1,2460.0,1799.0,0.732,11.683,0,0,0,0,0,0,0,0,0.0,0.0
1009,27,23-09-2019 12:32:00,1,2477.0,1815.0,0.733,11.768,1,0,0,0,1,0,1,0,0.0,0.01
1009,28,23-09-2019 12:34:00,1,2460.0,1832.0,0.745,11.721,0,0,0,0,0,0,0,0,0.0,0.0
1009,29,23-09-2019 12:36:00,1,2458.0,1810.0,0.736,11.689,3,1,0,1,2,0,2,0,0.0,0.0
1009,30,23-09-2019 12:38:00,1,2470.0,1810.0,0.733,11.737,0,0,0,0,0,0,0,0,0.0,0.0
1009,31,23-09-2019 12:40:00,1,2476.0,1766.0,0.713,11.712,0,0,0,0,0,0,0,0,0.0,0.0
1009,32,23-09-2019 12:42:00,1,2374.0,1724.0,0.726,11.261,52,36,19,17,16,5,11,0,0.0,0.0
1009,33,23-09-2019 12:44:00,1,2457.0,1874.0,0.763,11.754,61,35,25,10,26,18,8,8,0.0,0.0
1009,34,23-09-2019 12:46:00,1,2735.0,2081.0,0.761,13.081,51,18,4,14,33,4,29,0,0.0,0.08
1009,35,23-09-2019 12:48:00,1,2925.0,2187.0,0.748,13.947,154,105,66,39,49,24,25,8,0.0,0.0
1009,36,23-09-2019 12:50:00,1,2931.0,2216.0,0.756,14.0,160,61,44,17,99,66,33,13,0.0,0.0
1009,37,23-09-2019 12:52:00,1,2899.0,2293.0,0.791,13.962,80,51,31,20,29,10,19,0,0.0,0.0
1009,38,23-09-2019 12:54:00,1,2717.0,2119.0,0.78,13.052,25,21,8,13,4,2,2,0,0.0,0.0
1009,39,23-09-2019 12:56:00,1,2759.0,2024.0,0.734,13.113,31,19,3,16,12,4,8,0,0.0,0.0
1009,40,23-09-2019 12:58:00,1,2940.0,2182.0,0.742,14.0,52,32,9,23,20,0,20,0,0.0,0.0
1009,41,23-09-2019 13:00:00,1,2813.0,2182.0,0.776,13.5,23,10,4,6,13,0,13,0,0.0,0.0
1009,42,23-09-2019 13:02:00,1,2826.5,2119.5,0.75,13.484,10,5,1,4,5,0,5,0,0.0,0.0
1009,43,23-09-2019 13:04:00,1,2840.0,2057.0,0.724,13.468,64,53,21,32,11,3,8,0,0.0,0.0
1009,44,23-09-2019 13:06:00,1,2938.0,2184.0,0.743,13.993,14,11,3,8,3,0,3,0,0.0,0.0
1009,45,23-09-2019 13:08:00,1,2660.0,1963.0,0.738,12.655,1,1,0,1,0,0,0,0,0.0,0.0
1009,46,23-09-2019 13:10:00,1,2539.0,1884.0,0.742,12.091,0,0,0,0,0,0,0,0,0.0,0.0
1009,47,23-09-2019 13:12:00,1,2560.0,1862.0,0.727,12.148,4,0,0,0,4,0,4,0,0.0,0.0
1009,48,23-09-2019 13:14:00,1,2375.0,1732.0,0.729,11.276,5,0,0,0,5,0,5,0,0.0,0.0
1009,49,23-09-2019 13:16:00,1,2385.0,1721.0,0.721,11.304,3,0,0,0,3,0,3,0,0.0,0.0
1009,50,23-09-2019 13:18:00,1,2393.0,1685.0,0.704,11.297,0,0,0,0,0,0,0,0,0.0,0.0
1009,51,23-09-2019 13:20:00,1,2383.0,1698.0,0.713,11.268,6,1,0,1,5,0,5,0,0.0,0.0
1009,52,23-09-2019 13:22:00,1,2373.0,1708.0,0.72,11.241,1,0,0,0,1,0,1,0,0.0,0.0
1009,53,23-09-2019 13:24:00,1,2383.0,1701.0,0.714,11.272,0,0,0,0,0,0,0,0,0.0,0.0
1009,54,23-09-2019 13:26:00,1,2394.0,1681.0,0.702,11.295,3,2,1,1,1,0,1,0,0.0,0.0
1009,55,23-09-2019 13:28:00,1,2367.0,1702.0,0.719,11.21,2,0,0,0,2,0,2,0,0.0,0.0
1009,56,23-09-2019 13:30:00,1,2377.0,1676.0,0.705,11.219,3,1,0,1,2,0,2,0,0.0,0.0
1009,57,23-09-2019 13:32:00,1,2400.0,1655.0,0.69,11.288,0,0,0,0,0,0,0,0,0.0,0.0
1009,58,23-09-2019 13:34:00,1,2395.0,1625.0,0.678,11.237,30,21,9,12,9,3,6,0,0.0,0.0
1009,59,23-09-2019 13:36:00,1,2350.0,1601.5,0.6815,11.0325,1,1,0,1,0,0,0,0,0.0,0.0
1009,60,23-09-2019 13:38:00,1,2305.0,1578.0,0.685,10.828,0,0,0,0,0,0,0,0,0.0,0.0
1009,61,23-09-2019 13:40:00,1,2295.0,1585.0,0.691,10.797,7,7,3,4,0,0,0,0,0.0,0.0
1009,62,23-09-2019 13:42:00,1,2287.0,1593.0,0.697,10.777,0,0,0,0,0,0,0,0,0.0,0.0
1009,63,23-09-2019 13:44:00,1,2297.0,1596.0,0.695,10.817,12,8,3,5,4,2,2,0,0.0,0.0
1009,64,23-09-2019 13:46:00,1,2405.0,1627.0,0.676,11.277,12,9,4,5,3,2,1,0,0.0,0.0
1009,65,23-09-2019 13:48:00,1,2485.0,1720.0,0.692,11.696,0,0,0,0,0,0,0,0,0.0,0.0
1009,66,23-09-2019 13:50:00,1,2488.0,1727.0,0.694,11.716,9,6,4,2,3,0,3,0,0.0,0.0
1009,67,23-09-2019 13:52:00,1,2492.0,1729.0,0.694,11.735,3,3,1,2,0,0,0,0,0.0,0.0
1009,68,23-09-2019 13:54:00,1,2504.0,1691.0,0.675,11.738,6,1,0,1,5,1,4,0,0.0,0.0
1009,69,23-09-2019 13:56:00,1,2507.0,1685.0,0.672,11.743,6,0,0,0,6,0,6,0,0.0,0.0
1009,70,23-09-2019 13:58:00,1,2487.0,1689.0,0.679,11.668,0,0,0,0,0,0,0,0,0.0,0.0
1009,71,23-09-2019 14:00:00,1,2486.0,1728.0,0.695,11.708,2,0,0,0,2,0,2,0,0.0,0.0
1009,72,23-09-2019 14:02:00,1,2483.0,1746.0,0.703,11.718,13,9,5,4,4,2,2,0,0.0,0.0
1009,73,23-09-2019 14:04:00,1,2481.0,1764.0,0.711,11.73,1,1,0,1,0,0,0,0,0.0,0.0
1009,74,23-09-2019 14:06:00,1,2475.0,1769.0,0.715,11.711,0,0,0,0,0,0,0,0,0.0,0.0
1009,75,23-09-2019 14:08:00,1,2474.0,1764.0,0.713,11.701,0,0,0,0,0,0,0,0,0.0,0.0
1009,76,23-09-2019 14:10:00,1,2480.0,1742.5,0.7025,11.701,2,2,1,1,0,0,0,0,0.0,0.0
1009,77,23-09-2019 14:12:00,1,2486.0,1721.0,0.692,11.701,34,24,1,23,10,1,9,0,0.0,0.0
1009,78,23-09-2019 14:14:00,1,2482.0,1745.0,0.703,11.71,7,3,0,3,4,0,4,0,0.0,0.0
1009,79,23-09-2019 14:16:00,1,2487.0,1727.0,0.694,11.713,142,113,76,37,29,4,25,0,0.0,0.0
1009,80,23-09-2019 14:18:00,1,2688.0,1831.0,0.681,12.62,38,36,15,21,2,0,2,0,0.0,0.0
1009,81,23-09-2019 14:20:00,1,2464.0,1786.0,0.725,11.686,4,4,1,3,0,0,0,0,0.0,0.0
1009,82,23-09-2019 14:22:00,1,2396.0,1667.0,0.696,11.287,0,0,0,0,0,0,0,0,0.0,0.0
1009,83,23-09-2019 14:24:00,1,2309.0,1550.0,0.672,10.813,0,0,0,0,0,0,0,0,0.0,0.0
1009,84,23-09-2019 14:26:00,1,2288.0,1615.0,0.706,10.803,1,1,1,0,0,0,0,0,0.0,0.0
1009,85,23-09-2019 14:28:00,1,2284.0,1598.0,0.699,10.768,0,0,0,0,0,0,0,0,0.0,0.0
1009,86,23-09-2019 14:30:00,1,2309.0,1546.0,0.67,10.81,0,0,0,0,0,0,0,0,0.0,0.0
1009,87,23-09-2019 14:32:00,1,2302.0,1552.0,0.674,10.787,6,0,0,0,6,0,6,0,0.0,0.0
1009,88,23-09-2019 14:34:00,1,2097.0,1505.0,0.718,9.927,4,4,1,3,0,0,0,0,0.0,0.0
1009,89,23-09-2019 14:36:00,1,2093.0,1467.0,0.701,9.871,27,18,12,6,9,2,7,0,0.0,0.0
1009,90,23-09-2019 14:38:00,1,2317.0,1540.0,0.665,10.835,0,0,0,0,0,0,0,0,0.0,0.0
1009,91,23-09-2019 14:40:00,1,2314.0,1544.0,0.667,10.829,77,40,21,19,37,11,26,0,0.0,0.0
1009,92,23-09-2019 14:42:00,1,2475.0,1762.0,0.712,11.702,117,64,40,24,53,27,26,5,0.0,0.0
1009,93,23-09-2019 14:44:00,1,2492.5,1703.5,0.6835,11.7055,11,10,2,8,1,0,1,0,0.0,0.0
1009,94,23-09-2019 14:46:00,1,2510.0,1645.0,0.655,11.709,30,18,6,12,12,1,11,0,0.0,0.0
1009,95,23-09-2019 14:48:00,1,2477.0,1756.0,0.709,11.706,17,3,1,2,14,0,14,0,0.0,0.0
1009,96,23-09-2019 14:50:00,1,2489.0,1718.0,0.69,11.71,23,10,2,8,13,1,12,0,0.0,0.0
1009,97,23-09-2019 14:52:00,1,2483.0,1781.0,0.717,11.754,89,38,20,18,51,25,26,2,0.0,0.0
1009,98,23-09-2019 14:54:00,1,2949.0,2154.0,0.73,14.006,45,17,14,3,28,16,12,2,0.0,0.0
1009,99,23-09-2019 14:56:00,1,2559.0,1854.0,0.725,12.135,142,74,45,29,68,40,28,2,0.0,0.0
1009,100,23-09-2019 14:58:00,1,2952.0,2081.0,0.705,13.935,88,33,23,10,55,29,26,19,0.0,0.0
1009,101,23-09-2019 15:00:00,1,2691.0,1870.0,0.695,12.675,58,39,20,19,19,2,17,20,0.0,0.0
1009,102,23-09-2019 15:02:00,1,2678.0,1882.0,0.703,12.635,91,72,32,40,19,5,14,0,0.0,0.0
1009,103,23-09-2019 15:04:00,1,2649.0,1916.0,0.723,12.558,50,48,21,27,2,1,1,0,0.0,0.01
1009,104,23-09-2019 15:06:00,1,2686.0,1845.0,0.687,12.628,24,21,2,19,3,0,3,0,0.0,0.0
1009,105,23-09-2019 15:08:00,1,2504.0,1700.0,0.679,11.749,0,0,0,0,0,0,0,0,0.0,0.0
1009,106,23-09-2019 15:10:00,1,2488.0,1693.0,0.68,11.677,3,3,2,1,0,0,0,0,0.0,0.0
1009,107,23-09-2019 15:12:00,1,2493.0,1684.0,0.675,11.687,5,5,3,2,0,0,0,0,0.0,0.0
1009,108,23-09-2019 15:14:00,1,2497.0,1702.0,0.682,11.722,0,0,0,0,0,0,0,0,0.0,0.0
1009,109,23-09-2019 15:16:00,1,2475.0,1738.0,0.702,11.675,3,2,0,2,1,1,0,0,0.0,0.0
1009,110,23-09-2019 15:18:00,1,2436.5,1710.5,0.702,11.4935,0,0,0,0,0,0,0,0,0.0,0.0
1009,111,23-09-2019 15:20:00,1,2398.0,1683.0,0.702,11.312,6,3,0,3,3,0,3,0,0.0,0.0
1009,112,23-09-2019 15:22:00,1,2280.0,1635.0,0.717,10.792,19,11,7,4,8,0,8,0,0.0,0.0
1009,113,23-09-2019 15:24:00,1,2282.0,1650.0,0.723,10.818,1,0,0,0,1,0,1,0,0.0,0.0
1009,114,23-09-2019 15:26:00,1,2288.0,1629.0,0.712,10.82,1,0,0,0,1,0,1,0,0.0,0.0
1009,115,23-09-2019 15:28:00,1,2102.0,1502.0,0.715,9.945,0,0,0,0,0,0,0,0,0.0,0.0
1009,116,23-09-2019 15:30:00,1,1987.0,1464.0,0.737,9.45,0,0,0,0,0,0,0,0,0.0,0.0
1009,117,23-09-2019 15:32:00,1,2095.0,1472.0,0.703,9.884,0,0,0,0,0,0,0,0,0.0,0.0
1009,118,23-09-2019 15:34:00,1,2203.0,1514.0,0.687,10.357,0,0,0,0,0,0,0,0,0.0,0.0
1009,119,23-09-2019 15:36:00,1,2307.0,1546.0,0.67,10.801,0,0,0,0,0,0,0,0,0.0,0.0
1009,120,23-09-2019 15:38:00,1,2292.0,1547.0,0.675,10.745,0,0,0,0,0,0,0,0,0.0,0.0
1009,121,23-09-2019 15:40:00,1,2300.0,1571.0,0.683,10.802,11,5,3,2,6,2,4,0,0.0,0.0
1009,122,23-09-2019 15:42:00,1,2290.0,1648.0,0.72,10.847,1,0,0,0,1,0,1,0,0.0,0.0
1009,123,23-09-2019 15:44:00,1,2292.0,1637.0,0.714,10.842,0,0,0,0,0,0,0,0,0.0,0.0
1009,124,23-09-2019 15:46:00,1,2283.0,1606.0,0.703,10.775,0,0,0,0,0,0,0,0,0.0,0.0
1009,125,23-09-2019 15:48:00,1,2275.0,1655.0,0.727,10.797,0,0,0,0,0,0,0,0,0.0,0.0
1009,126,23-09-2019 15:50:00,1,2305.0,1591.0,0.69,10.843,0,0,0,0,0,0,0,0,0.0,0.0
1009,127,23-09-2019 15:52:00,1,2252.0,1558.0,0.6915,10.598,0,0,0,0,0,0,0,0,0.0,0.0
1009,128,23-09-2019 15:54:00,1,2199.0,1525.0,0.693,10.353,11,2,1,1,9,2,7,0,0.0,0.0
1009,129,23-09-2019 15:56:00,1,2299.0,1590.0,0.692,10.818,1,0,0,0,1,0,1,0,0.0,0.0
1009,130,23-09-2019 15:58:00,1,2292.0,1626.0,0.709,10.83,0,0,0,0,0,0,0,0,0.0,0.0
1009,131,23-09-2019 16:00:00,1,2278.0,1622.0,0.712,10.77,0,0,0,0,0,0,0,0,0.0,0.0
1009,132,23-09-2019 16:02:00,1,2295.0,1611.0,0.702,10.826,12,12,0,12,0,0,0,0,0.0,0.0
1009,133,23-09-2019 16:04:00,1,2308.0,1561.0,0.676,10.823,12,9,3,6,3,0,3,0,0.0,0.0
1009,134,23-09-2019 16:06:00,1,2308.0,1574.0,0.682,10.836,0,0,0,0,0,0,0,0,0.0,0.0
1009,135,23-09-2019 16:08:00,1,2093.0,1530.0,0.731,9.939,0,0,0,0,0,0,0,0,0.0,0.0
1009,136,23-09-2019 16:10:00,1,1973.0,1502.0,0.761,9.438,0,0,0,0,0,0,0,0,0.0,0.0
1009,137,23-09-2019 16:12:00,1,1981.0,1505.0,0.759,9.472,0,0,0,0,0,0,0,0,0.0,0.0
1009,138,23-09-2019 16:14:00,1,2096.0,1496.0,0.714,9.915,8,8,2,6,0,0,0,0,0.0,0.0
1009,139,23-09-2019 16:16:00,1,1991.0,1469.0,0.738,9.47,19,15,6,9,4,2,2,0,0.0,0.0
1009,140,23-09-2019 16:18:00,1,2193.0,1517.0,0.692,10.323,3,3,1,2,0,0,0,0,0.0,0.0
1009,141,23-09-2019 16:20:00,1,2307.0,1560.0,0.676,10.816,1,1,1,0,0,0,0,0,0.0,0.0
1009,142,23-09-2019 16:22:00,1,2298.0,1564.0,0.68,10.786,0,0,0,0,0,0,0,0,0.0,0.0
1009,143,23-09-2019 16:24:00,1,2299.0,1574.0,0.685,10.802,0,0,0,0,0,0,0,0,0.0,0.0
1009,144,23-09-2019 16:26:00,1,2248.5,1550.5,0.69,10.577,3,3,0,3,0,0,0,0,0.0,0.0
1009,145,23-09-2019 16:28:00,1,2198.0,1527.0,0.695,10.352,72,62,17,45,10,3,7,0,0.0,0.0
1009,146,23-09-2019 16:30:00,1,2292.0,1619.0,0.706,10.825,6,1,1,0,5,1,4,0,0.0,0.0
1009,147,23-09-2019 16:32:00,1,2290.0,1622.0,0.708,10.82,7,5,1,4,2,0,2,0,0.0,0.0
1009,148,23-09-2019 16:34:00,1,2285.0,1625.0,0.711,10.802,63,29,7,22,34,0,34,0,0.0,0.0
1009,149,23-09-2019 16:36:00,1,2393.0,1686.0,0.705,11.297,48,42,12,30,6,3,3,10,0.0,0.0
1009,150,23-09-2019 16:38:00,1,2461.0,1805.0,0.733,11.694,33,17,10,7,16,3,13,47,0.0,0.0
1009,151,23-09-2019 16:40:00,1,2743.0,1998.0,0.729,13.018,134,49,40,9,85,49,36,12,0.0,0.0
1009,152,23-09-2019 16:42:00,1,3124.0,2342.0,0.75,14.903,61,33,12,21,28,12,16,8,0.0,0.0
1009,153,23-09-2019 16:44:00,1,2642.0,2003.0,0.758,12.628,67,39,18,21,28,7,21,5,0.0,0.0
1009,154,23-09-2019 16:46:00,1,2968.0,2069.0,0.697,13.983,203,109,63,46,94,58,36,3,0.0,0.0
1009,155,23-09-2019 16:48:00,1,2568.0,1864.0,0.726,12.184,64,47,19,28,17,3,14,0,0.0,0.0
1009,156,23-09-2019 16:50:00,1,2455.0,1804.0,0.735,11.671,50,45,19,26,5,1,4,1,0.0,0.0
1009,157,23-09-2019 16:52:00,1,2501.0,1717.0,0.687,11.754,53,53,27,26,0,0,0,0,0.0,0.0
1009,158,23-09-2019 16:54:00,1,2490.0,1683.0,0.676,11.673,9,9,0,9,0,0,0,0,0.0,0.0
1009,159,23-09-2019 16:56:00,1,2670.0,1915.0,0.717,12.641,22,22,7,15,0,0,0,0,0.0,0.0
1009,160,23-09-2019 16:58:00,1,2385.0,1702.0,0.714,11.282,8,8,0,8,0,0,0,0,0.0,0.0
1009,161,23-09-2019 17:00:00,1,2294.0,1626.5,0.709,10.8385,24,24,0,24,0,0,0,0,0.0,0.0
1009,162,23-09-2019 17:02:00,1,2203.0,1551.0,0.704,10.395,15,15,0,15,0,0,0,0,0.0,0.0
1009,163,23-09-2019 17:04:00,1,2083.0,1536.0,0.737,9.907,2,2,1,1,0,0,0,0,0.0,0.0
1009,164,23-09-2019 17:06:00,1,2194.0,1569.0,0.715,10.383,1,1,1,0,0,0,0,0,0.0,0.0
1009,165,23-09-2019 17:08:00,1,2384.0,1700.0,0.713,11.276,2,2,0,2,0,0,0,0,0.0,0.0
1009,166,23-09-2019 17:10:00,1,2280.0,1661.0,0.729,10.822,1,1,0,1,0,0,0,0,0.0,0.0
1009,167,23-09-2019 17:12:00,1,2291.0,1626.0,0.71,10.827,0,0,0,0,0,0,0,0,0.0,0.0
1009,168,23-09-2019 17:14:00,1,2289.0,1617.0,0.706,10.811,17,17,3,14,0,0,0,0,0.0,0.0
1009,169,23-09-2019 17:16:00,1,2076.0,1545.0,0.745,9.889,12,9,4,5,3,0,3,0,0.0,0.0
1009,170,23-09-2019 17:18:00,1,1989.0,1462.0,0.735,9.455,6,6,5,1,0,0,0,0,0.0,0.0
1009,171,23-09-2019 17:20:00,1,1992.0,1470.0,0.738,9.477,0,0,0,0,0,0,0,0,0.0,0.0
1009,172,23-09-2019 17:22:00,1,1997.0,1447.0,0.724,9.472,0,0,0,0,0,0,0,0,0.0,0.0
1009,173,23-09-2019 17:24:00,1,1993.0,1428.0,0.716,9.432,1,1,1,0,0,0,0,0,0.0,0.0
1009,174,23-09-2019 17:26:00,1,1996.0,1415.0,0.709,9.432,0,0,0,0,0,0,0,0,0.0,0.0
1009,175,23-09-2019 17:28:00,1,1998.0,1448.0,0.724,9.476,0,0,0,0,0,0,0,0,0.0,0.0
1009,176,23-09-2019 17:30:00,1,1988.0,1468.0,0.739,9.458,2,2,1,1,0,0,0,0,0.0,0.0
1009,177,23-09-2019 17:32:00,1,1987.0,1481.0,0.746,9.469,0,0,0,0,0,0,0,0,0.0,0.0
1009,178,23-09-2019 17:34:00,1,1996.0,1443.0,0.7235,9.4615,0,0,0,0,0,0,0,0,0.0,0.0
1009,179,23-09-2019 17:36:00,1,2005.0,1405.0,0.701,9.454,0,0,0,0,0,0,0,0,0.0,0.0
1009,180,23-09-2019 17:38:00,1,1823.0,1255.0,0.688,8.57,11,11,3,8,0,0,0,0,0.0,0.0
1009,181,23-09-2019 17:40:00,1,1818.0,1276.0,0.702,8.576,0,0,0,0,0,0,0,0,0.0,0.0
1009,182,23-09-2019 17:42:00,1,1899.0,1352.0,0.712,8.979,1,1,0,1,0,0,0,0,0.0,0.0
1009,183,23-09-2019 17:44:00,1,2004.0,1389.0,0.693,9.435,3,3,0,3,0,0,0,0,0.0,0.0
1009,184,23-09-2019 17:46:00,1,2014.0,1394.0,0.692,9.481,10,9,3,6,1,0,1,0,0.0,0.0
1009,185,23-09-2019 17:48:00,1,2200.0,1543.0,0.702,10.377,0,0,0,0,0,0,0,0,0.0,0.0
1009,186,23-09-2019 17:50:00,1,2295.0,1561.0,0.68,10.772,2,2,1,1,0,0,0,0,0.0,0.0
1009,187,23-09-2019 17:52:00,1,2296.0,1586.0,0.691,10.802,0,0,0,0,0,0,0,0,0.0,0.0
1009,188,23-09-2019 17:54:00,1,2095.0,1512.0,0.722,9.93,12,12,0,12,0,0,0,0,0.0,0.0
1009,189,23-09-2019 17:56:00,1,2000.0,1417.0,0.709,9.452,3,1,0,1,2,0,2,0,0.0,0.0
1009,190,23-09-2019 17:58:00,1,1988.0,1459.0,0.734,9.447,11,6,0,6,5,0,5,0,0.0,0.0
1009,191,23-09-2019 18:00:00,0,1998.0,1434.0,0.718,9.459,7,0,0,0,7,0,7,0,0.0,0.0
1009,192,23-09-2019 18:02:00,0,1989.0,1484.0,0.746,9.479,2,0,0,0,2,0,2,0,0.0,0.0
1009,193,23-09-2019 18:04:00,0,2193.0,1537.0,0.701,10.344,7,0,0,0,7,0,7,0,0.0,0.0
1009,194,23-09-2019 18:06:00,0,1988.0,1449.0,0.729,9.438,3,0,0,0,3,0,3,0,0.0,0.0
1009,195,23-09-2019 18:08:00,0,1995.0,1442.5,0.7235,9.4575,5,0,0,0,5,0,5,0,0.0,0.0
1009,196,23-09-2019 18:10:00,0,2002.0,1436.0,0.718,9.477,1,0,0,0,1,0,1,0,0.0,0.0
1009,197,23-09-2019 18:12:00,0,2082.0,1510.0,0.725,9.876,129,72,54,18,57,37,20,10,0.0,0.0
1009,198,23-09-2019 18:14:00,0,2669.0,1903.0,0.713,12.624,143,96,64,32,47,17,30,26,0.0,0.0
1009,199,23-09-2019 18:16:00,0,3768.0,2874.0,0.763,18.03,208,97,75,22,111,73,38,38,0.0,0.0
1009,200,23-09-2019 18:18:00,0,2940.0,2223.0,0.756,14.043,60,44,17,27,16,0,16,5,0.0,0.0
1009,201,23-09-2019 18:20:00,0,3146.0,2271.0,0.722,14.909,75,41,18,23,34,3,31,20,0.0,0.15
1009,202,23-09-2019 18:22:00,0,3586.0,2684.0,0.748,17.101,281,157,125,32,124,82,42,57,0.0,0.0
1009,203,23-09-2019 18:24:00,0,3420.0,2511.0,0.734,16.256,146,82,64,18,64,39,25,22,0.0,0.0
1009,204,23-09-2019 18:26:00,0,3516.0,2597.0,0.739,16.729,81,39,27,12,42,28,14,17,0.0,0.0
1009,205,23-09-2019 18:28:00,0,3130.0,2315.0,0.739,14.897,28,19,10,9,9,3,6,0,0.0,0.0
1009,206,23-09-2019 18:30:00,0,3105.0,2355.0,0.758,14.84,70,47,22,25,23,8,15,10,0.0,0.0
1009,207,23-09-2019 18:32:00,0,2934.0,2177.0,0.742,13.972,74,52,15,37,22,5,17,2,0.0,0.0
1009,208,23-09-2019 18:34:00,0,3134.0,2292.0,0.731,14.887,75,53,29,24,22,3,19,0,0.0,0.21
1009,209,23-09-2019 18:36:00,0,3105.0,2384.0,0.768,14.873,155,93,66,27,62,36,26,13,0.0,0.0
1009,210,23-09-2019 18:38:00,0,3122.0,2261.0,0.724,14.807,106,65,51,14,41,24,17,44,0.0,0.0
1009,211,23-09-2019 18:40:00,0,2745.0,2045.0,0.745,13.078,141,67,54,13,74,43,31,36,0.0,0.0
1009,212,23-09-2019 18:42:00,0,2986.0,2227.5,0.746,14.231,61,42,24,18,19,5,14,1,0.0,0.0
1009,213,23-09-2019 18:44:00,0,3227.0,2410.0,0.747,15.384,60,54,21,33,6,2,4,3,0.0,0.0
1009,214,23-09-2019 18:46:00,0,3126.0,2256.0,0.722,14.814,109,63,39,24,46,28,18,10,0.0,0.0
1009,215,23-09-2019 18:48:00,0,2933.0,2172.0,0.741,13.963,46,19,12,7,27,7,20,3,0.0,0.0
1009,216,23-09-2019 18:50:00,0,2209.0,1509.0,0.683,10.376,100,46,31,15,54,21,33,25,0.0,0.0
1009,217,23-09-2019 18:52:00,0,3314.0,2434.0,0.734,15.753,92,61,41,20,31,16,15,38,0.0,0.8
1009,218,23-09-2019 18:54:00,0,3413.0,2480.0,0.727,16.193,200,125,96,29,75,44,31,42,0.0,0.0
1009,219,23-09-2019 18:56:00,0,3118.0,2323.0,0.745,14.858,47,25,8,17,22,7,15,4,0.0,0.0
1009,220,23-09-2019 18:58:00,0,2930.0,2186.0,0.746,13.966,37,16,2,14,21,2,19,2,0.0,0.0
1009,221,23-09-2019 19:00:00,0,3148.0,2251.0,0.715,14.896,42,28,8,20,14,4,10,0,0.0,0.0
1009,222,23-09-2019 19:02:00,0,3113.0,2368.0,0.761,14.886,66,28,10,18,38,7,31,4,0.0,0.0
1009,223,23-09-2019 19:04:00,0,3033.0,2209.0,0.728,14.397,30,8,2,6,22,0,22,0,0.0,0.0
1009,224,23-09-2019 19:06:00,0,3129.0,2300.0,0.735,14.877,96,56,41,15,40,10,30,13,0.0,0.0
1009,225,23-09-2019 19:08:00,0,3132.0,2310.0,0.738,14.899,175,104,84,20,71,51,20,30,0.0,0.0
1009,226,23-09-2019 19:10:00,0,3435.0,2439.0,0.71,16.235,68,38,25,13,30,14,16,4,0.0,0.0
1009,227,23-09-2019 19:12:00,0,2937.0,2118.0,0.721,13.918,175,105,86,19,70,42,28,11,0.0,0.0
1009,228,23-09-2019 19:14:00,0,2937.0,2133.0,0.726,13.935,34,25,12,13,9,3,6,10,0.0,0.0
1009,229,23-09-2019 19:16:00,0,2991.5,2155.5,0.7205,14.1745,81,45,32,13,36,9,27,7,0.0,0.0
1009,230,23-09-2019 19:18:00,0,3046.0,2178.0,0.715,14.414,7,1,1,0,6,0,6,0,0.0,0.0
1009,231,23-09-2019 19:20:00,0,2957.0,2104.0,0.712,13.98,3,2,0,2,1,0,1,0,0.0,0.0
1009,232,23-09-2019 19:22:00,0,2762.0,1948.0,0.705,13.041,4,4,1,3,0,0,0,0,0.0,0.0
1009,233,23-09-2019 19:24:00,0,2645.0,1948.0,0.736,12.58,1,1,1,0,0,0,0,0,0.0,0.0
1009,234,23-09-2019 19:26:00,0,2471.0,1778.0,0.72,11.706,9,0,0,0,9,0,9,0,0.0,0.0
1009,235,23-09-2019 19:28:00,0,2493.0,1711.0,0.686,11.717,17,15,8,7,2,0,2,0,0.0,0.0
1009,236,23-09-2019 19:30:00,0,2575.0,1838.0,0.714,12.182,100,71,46,25,29,10,19,7,0.0,0.0
1009,237,23-09-2019 19:32:00,0,2660.0,1968.0,0.74,12.66,91,60,36,24,31,16,15,25,0.0,0.0
1009,238,23-09-2019 19:34:00,0,2940.0,2134.0,0.726,13.945,20,9,4,5,11,1,10,57,0.0,0.0
1009,239,23-09-2019 19:36:00,0,2940.0,2179.0,0.741,13.997,212,140,111,29,72,53,19,34,0.0,0.0
1009,240,23-09-2019 19:38:00,0,2868.0,2020.0,0.704,13.538,105,77,58,19,28,15,13,15,0.0,0.0
1009,241,23-09-2019 19:40:00,0,2953.0,2085.0,0.706,13.944,57,38,16,22,19,7,12,19,0.0,0.0
1009,242,23-09-2019 19:42:00,0,2948.0,2149.0,0.729,13.995,96,41,25,16,55,23,32,53,0.0,0.0
1009,243,23-09-2019 19:44:00,0,3162.0,2174.0,0.688,14.866,63,22,7,15,41,2,39,45,0.0,0.0
1009,244,23-09-2019 19:46:00,0,3065.0,2173.0,0.709,14.483,87,60,44,16,27,9,18,23,0.0,0.0
1009,245,23-09-2019 19:48:00,0,3158.0,2201.0,0.697,14.879,57,38,15,23,19,1,18,1,0.0,0.0
1009,246,23-09-2019 19:50:00,0,3150.0,2220.0,0.705,14.87,84,48,24,24,36,10,26,23,0.0,0.0
1009,247,23-09-2019 19:52:00,0,3142.0,2239.0,0.713,14.861,206,136,105,31,70,35,35,56,0.0,0.0
1009,248,23-09-2019 19:54:00,0,3613.0,2639.0,0.73,17.157,178,110,72,38,68,41,27,29,0.0,0.0
1009,249,23-09-2019 19:56:00,0,3338.0,2392.0,0.717,15.801,113,73,52,21,40,12,28,30,0.0,0.0
1009,250,23-09-2019 19:58:00,0,3236.0,2318.0,0.716,15.316,55,21,14,7,34,0,34,60,0.0,0.0
1009,251,23-09-2019 20:00:00,0,3625.0,2585.0,0.713,17.144,56,17,4,13,39,0,39,53,0.0,0.0
1009,252,23-09-2019 20:02:00,0,3626.0,2527.0,0.697,17.085,141,77,48,29,64,28,36,52,0.0,0.0
1009,253,23-09-2019 20:04:00,0,3620.0,2568.0,0.709,17.107,52,26,13,13,26,3,23,40,0.0,0.0
1009,254,23-09-2019 20:06:00,0,3614.0,2635.0,0.729,17.158,108,51,32,19,57,23,34,62,0.0,0.0
1009,255,23-09-2019 20:08:00,0,3584.0,2778.0,0.775,17.195,78,40,19,21,38,3,35,63,0.0,0.0
1009,256,23-09-2019 20:10:00,0,3778.0,2871.0,0.76,18.065,270,146,110,36,124,90,34,54,0.0,0.0
1009,257,23-09-2019 20:12:00,0,3188.0,2424.0,0.76,15.244,200,99,78,21,101,69,32,33,0.0,0.0
1009,258,23-09-2019 20:14:00,0,3391.0,2557.0,0.754,16.191,46,19,7,12,27,3,24,1,0.0,0.0
1009,259,23-09-2019 20:16:00,0,3494.0,2648.0,0.758,16.701,87,42,21,21,45,1,44,73,0.0,0.0
1009,260,23-09-2019 20:18:00,0,3644.0,2946.0,0.809,17.62,153,71,55,16,82,40,42,43,0.0,0.0
1009,261,23-09-2019 20:20:00,0,3918.0,3165.0,0.808,18.941,228,165,127,38,63,41,22,20,0.0,0.0
1009,262,23-09-2019 20:22:00,0,3816.0,3165.0,0.829,18.54,305,185,142,43,120,82,38,74,0.0,0.0
1009,263,23-09-2019 20:24:00,0,3358.5,2743.0,0.8145,16.271,182,118,89,29,64,44,20,108,0.0,0.0
1009,264,23-09-2019 20:26:00,0,2901.0,2321.0,0.8,14.002,181,116,84,32,65,39,26,43,0.0,0.0
1009,265,23-09-2019 20:28:00,0,3538.0,2924.0,0.826,17.178,177,106,83,23,71,47,24,55,0.0,0.0
1009,266,23-09-2019 20:30:00,0,3363.0,2697.0,0.802,16.236,92,45,24,21,47,18,29,7,0.0,0.0
1009,267,23-09-2019 20:32:00,0,3516.0,3014.0,0.857,17.192,53,38,24,14,15,4,11,5,0.0,0.0
1009,268,23-09-2019 20:34:00,0,3610.0,3103.0,0.86,17.658,80,44,21,23,36,6,30,10,0.0,0.0
1009,269,23-09-2019 20:36:00,0,3490.0,3017.0,0.864,17.091,182,96,74,22,86,64,22,11,0.0,0.0
1009,270,23-09-2019 20:38:00,0,2868.0,2434.0,0.849,13.997,10,7,0,7,3,1,2,0,0.0,0.0
1009,271,23-09-2019 20:40:00,0,2813.0,2231.0,0.793,13.554,9,6,3,3,3,0,3,0,0.0,0.0
1009,272,23-09-2019 20:42:00,0,2699.0,2216.0,0.821,13.087,28,26,16,10,2,0,2,0,0.0,0.0
1009,273,23-09-2019 20:44:00,0,2583.0,2224.0,0.861,12.638,55,40,22,18,15,9,6,4,0.0,0.0
1009,274,23-09-2019 20:46:00,0,2856.0,2494.0,0.873,14.014,117,55,36,19,62,27,35,57,0.0,0.0
1009,275,23-09-2019 20:48:00,0,3221.0,2785.0,0.865,15.774,200,124,97,27,76,48,28,39,0.0,0.0
1009,276,23-09-2019 20:50:00,0,3330.0,2809.0,0.844,16.23,38,30,19,11,8,4,4,3,0.0,0.0
1009,277,23-09-2019 20:52:00,0,2832.0,2475.0,0.874,13.896,2,2,1,1,0,0,0,0,0.0,0.0
1009,278,23-09-2019 20:54:00,0,2854.0,2439.0,0.855,13.945,9,9,5,4,0,0,0,0,0.0,0.0
1009,279,23-09-2019 20:56:00,0,2773.0,2333.0,0.841,13.507,11,11,3,8,0,0,0,0,0.0,0.0
1009,280,23-09-2019 20:58:00,0,2858.5,2442.5,0.854,13.965,63,34,20,14,29,6,23,35,0.0,0.0
1009,281,23-09-2019 21:00:00,0,2944.0,2552.0,0.867,14.423,64,23,11,12,41,2,39,58,0.0,0.0
1009,282,23-09-2019 21:02:00,0,3017.0,2715.0,0.9,14.893,259,174,130,44,85,61,24,61,0.0,0.0
1009,283,23-09-2019 21:04:00,0,3305.0,2871.0,0.869,16.199,167,92,65,27,75,51,24,106,0.0,0.0
1009,284,23-09-2019 21:06:00,0,2923.0,2611.0,0.893,14.406,192,110,85,25,82,59,23,37,0.0,0.0
1009,285,23-09-2019 21:08:00,0,3763.0,3402.0,0.904,18.594,65,21,20,1,44,20,24,53,0.0,0.0
1009,286,23-09-2019 21:10:00,0,3285.0,2976.0,0.906,16.238,229,123,94,29,106,80,26,18,0.0,0.0
1009,287,23-09-2019 21:12:00,0,3024.0,2725.0,0.901,14.934,217,117,90,27,100,72,28,26,0.0,0.0
1009,288,23-09-2019 21:14:00,0,2836.0,2541.0,0.896,13.985,58,18,10,8,40,4,36,63,0.0,0.0
1009,289,23-09-2019 21:16:00,0,3491.0,3092.0,0.886,17.176,116,65,40,25,51,13,38,69,0.0,0.0
1009,290,23-09-2019 21:18:00,0,3561.0,3232.0,0.907,17.61,184,91,74,17,93,60,33,31,0.0,0.0
1009,291,23-09-2019 21:20:00,0,3828.0,3511.0,0.917,18.968,82,47,20,27,35,23,12,3,0.07,0.0
1009,292,23-09-2019 21:22:00,0,3901.0,3701.0,0.949,19.468,234,138,114,24,96,60,36,48,0.0,0.0
1009,293,23-09-2019 21:24:00,0,3486.0,3106.0,0.891,17.172,84,32,16,16,52,4,48,83,0.0,0.0
1009,294,23-09-2019 21:26:00,0,3731.0,3457.0,0.926,18.528,247,145,116,29,102,68,34,116,0.0,0.0
1009,295,23-09-2019 21:28:00,0,3462.0,3198.0,0.924,17.182,167,82,55,27,85,61,24,17,0.0,0.0
1009,296,23-09-2019 21:30:00,0,3282.0,3021.0,0.921,16.275,70,54,29,25,16,1,15,2,0.0,0.0
1009,297,23-09-2019 21:32:00,0,3290.0,2977.0,0.905,16.2585,68,44,28,16,24,1,23,3,0.0,0.0
1009,298,23-09-2019 21:34:00,0,3298.0,2933.0,0.889,16.242,132,68,53,15,64,34,30,35,0.0,0.0
1009,299,23-09-2019 21:36:00,0,3827.0,3514.0,0.918,18.97,120,81,60,21,39,24,15,72,0.0,0.0
1009,300,23-09-2019 21:38:00,0,3121.0,2828.0,0.906,15.426,171,98,68,30,73,50,23,60,0.02,0.0
1009,301,23-09-2019 21:40:00,0,2851.0,2469.0,0.866,13.968,69,37,24,13,32,15,17,10,0.0,0.0
1009,302,23-09-2019 21:42:00,0,2206.0,1918.0,0.869,10.816,278,157,113,44,121,78,43,12,0.0,0.0
1009,303,23-09-2019 21:44:00,0,3644.0,3323.0,0.912,18.036,316,142,104,38,174,120,54,72,0.0,0.0
1009,304,23-09-2019 21:46:00,0,3661.0,3301.0,0.902,18.08,127,60,35,25,67,2,65,89,0.0,0.0
1009,305,23-09-2019 21:48:00,0,3931.0,3484.0,0.886,19.346,88,38,22,16,50,0,50,76,0.0,0.0
1009,306,23-09-2019 21:50:00,0,3914.0,3651.0,0.933,19.463,121,52,36,16,69,22,47,69,0.0,0.0
1009,307,23-09-2019 21:52:00,0,3904.0,3622.0,0.928,19.392,104,52,29,23,52,2,50,69,0.0,0.0
1009,308,23-09-2019 21:54:00,0,3952.0,3513.0,0.889,19.459,103,45,28,17,58,11,47,75,0.0,0.0
1009,309,23-09-2019 21:56:00,0,3631.0,3366.0,0.927,18.031,239,98,69,29,141,101,40,42,0.35,0.0
1009,310,23-09-2019 21:58:00,0,3641.0,3373.0,0.926,18.08,204,99,76,23,105,80,25,104,0.0,0.0
1009,311,23-09-2019 22:00:00,0,3649.0,3424.0,0.938,18.167,106,44,23,21,62,0,62,74,0.0,0.0
1009,312,23-09-2019 22:02:00,0,3920.0,3577.0,0.913,19.404,68,23,13,10,45,2,43,71,0.0,0.0
1009,313,23-09-2019 22:04:00,0,4004.0,3677.0,0.918,19.847,124,57,31,26,67,12,55,71,0.0,0.0
1009,314,23-09-2019 22:06:00,0,3993.0,3680.5,0.9215,19.807,149,91,62,29,58,10,48,46,0.0,0.0
1009,315,23-09-2019 22:08:00,0,3982.0,3684.0,0.925,19.767,242,146,114,32,96,63,33,38,0.16,0.0
1009,316,23-09-2019 22:10:00,0,4455.0,4103.0,0.921,22.095,271,106,74,32,165,120,45,17,0.07,0.0
1009,317,23-09-2019 22:12:00,0,3988.0,3673.0,0.921,19.778,225,110,83,27,115,80,35,69,0.0,0.0
1009,318,23-09-2019 22:14:00,0,3660.0,3311.0,0.905,18.086,75,24,13,11,51,0,51,81,0.0,0.0
1009,319,23-09-2019 22:16:00,0,4094.0,3739.0,0.913,20.268,97,44,23,21,53,0,53,79,0.0,0.0
1009,320,23-09-2019 22:18:00,0,4093.0,3848.0,0.94,20.385,98,65,39,26,33,7,26,23,0.0,0.0
1009,321,23-09-2019 22:20:00,0,3907.0,3572.0,0.914,19.349,86,52,22,30,34,10,24,5,0.0,0.0
1009,322,23-09-2019 22:22:00,0,4003.0,3743.0,0.935,19.915,223,111,80,31,112,89,23,45,0.09,0.0
1009,323,23-09-2019 22:24:00,0,3647.0,3376.0,0.926,18.108,299,163,123,40,136,107,29,63,0.0,0.0
1009,324,23-09-2019 22:26:00,0,3936.0,3527.0,0.896,19.414,80,38,25,13,42,1,41,80,0.0,0.0
1009,325,23-09-2019 22:28:00,0,4170.0,3885.0,0.932,20.73,180,60,23,37,120,90,30,52,0.0,0.0
1009,326,23-09-2019 22:30:00,0,3916.0,3628.0,0.926,19.447,78,33,16,17,45,1,44,58,0.0,0.0
1009,327,23-09-2019 22:32:00,0,4185.0,3930.0,0.939,20.841,72,32,23,9,40,0,40,82,0.0,0.0
1009,328,23-09-2019 22:34:00,0,4368.0,3965.0,0.908,21.599,150,74,39,35,76,48,28,15,0.18,0.0
1009,329,23-09-2019 22:36:00,0,4004.0,3775.0,0.943,19.953,121,86,52,34,35,2,33,0,0.0,0.0
1009,330,23-09-2019 22:38:00,0,4003.0,3779.0,0.944,19.954,185,106,76,30,79,57,22,78,0.0,0.0
1009,331,23-09-2019 22:40:00,0,3433.5,3133.5,0.9065,16.995,28,24,10,14,4,1,3,1,0.0,0.0
1009,332,23-09-2019 22:42:00,0,2864.0,2488.0,0.869,14.036,8,8,5,3,0,0,0,0,0.0,0.0
1009,333,23-09-2019 22:44:00,0,2850.0,2509.0,0.88,14.008,3,2,0,2,1,1,0,0,0.0,0.0
1009,334,23-09-2019 22:46:00,0,2647.0,2381.0,0.9,13.066,7,7,3,4,0,0,0,0,0.0,0.0
1009,335,23-09-2019 22:48:00,0,2584.0,2219.0,0.859,12.637,37,29,21,8,8,2,6,7,0.0,0.0
1009,336,23-09-2019 22:50:00,0,3568.0,3256.0,0.913,17.661,194,98,63,35,96,73,23,27,0.0,0.0
1009,337,23-09-2019 22:52:00,0,3606.0,3471.0,0.963,18.049,216,140,106,34,76,55,21,79,0.0,0.0
1009,338,23-09-2019 22:54:00,0,3702.0,3543.0,0.957,18.509,163,71,55,16,92,57,35,63,0.0,0.0
1009,339,23-09-2019 22:56:00,0,3692.0,3547.0,0.961,18.472,105,38,25,13,67,19,48,71,0.0,0.0
1009,340,23-09-2019 22:58:00,0,3602.0,3498.0,0.971,18.063,91,43,22,21,48,0,48,70,0.0,0.0
1009,341,23-09-2019 23:00:00,0,3901.0,3694.0,0.947,19.457,83,35,17,18,48,0,48,73,0.0,0.0
1009,342,23-09-2019 23:02:00,0,3887.0,3762.0,0.968,19.478,110,45,23,22,65,38,27,25,0.27,0.0
1009,343,23-09-2019 23:04:00,0,4044.0,3992.0,0.987,20.352,368,172,129,43,196,144,52,97,0.0,0.0
1009,344,23-09-2019 23:06:00,0,3615.0,3432.0,0.949,18.044,161,74,53,21,87,35,52,83,0.0,0.0
1009,345,23-09-2019 23:08:00,0,3889.0,3706.0,0.953,19.424,68,30,16,14,38,1,37,71,0.0,0.0
1009,346,23-09-2019 23:10:00,0,4056.0,3957.0,0.976,20.359,69,29,12,17,40,2,38,75,0.0,0.0
1009,347,23-09-2019 23:12:00,0,4364.0,4107.0,0.941,21.743,142,70,39,31,72,39,33,43,0.13,0.0
1009,348,23-09-2019 23:14:00,0,4259.5,4033.0,0.947,21.2485,258,142,105,37,116,85,31,92,0.0,0.0
1009,349,23-09-2019 23:16:00,0,4155.0,3959.0,0.953,20.754,210,118,84,34,92,68,24,64,0.0,0.0
1009,350,23-09-2019 23:18:00,0,4044.0,3986.0,0.986,20.347,168,88,57,31,80,56,24,27,0.13,0.0
1009,351,23-09-2019 23:20:00,0,4061.0,3912.0,0.964,20.33,157,104,74,30,53,32,21,52,0.0,0.0
1009,352,23-09-2019 23:22:00,0,3964.0,3752.0,0.946,19.772,57,29,2,27,28,14,14,0,0.0,0.0
1009,353,23-09-2019 23:24:00,0,4519.0,4335.0,0.959,22.602,146,57,33,24,89,64,25,11,0.0,0.0
1009,354,23-09-2019 23:26:00,0,3892.0,3720.0,0.956,19.453,213,103,66,37,110,61,49,69,0.0,0.0
1009,355,23-09-2019 23:28:00,0,3872.0,3719.0,0.961,19.373,136,72,47,25,64,16,48,85,0.0,0.0
1009,356,23-09-2019 23:30:00,0,3880.0,3764.0,0.97,19.455,93,51,24,27,42,1,41,64,0.0,0.03
1009,357,23-09-2019 23:32:00,0,3862.0,3760.0,0.973,19.38,164,79,49,30,85,47,38,55,0.0,0.0
1009,358,23-09-2019 23:34:00,0,4039.0,3972.0,0.983,20.31,200,99,66,33,101,66,35,40,0.28,0.19
1009,359,23-09-2019 23:36:00,0,4258.0,4073.0,0.957,21.284,205,102,67,35,103,74,29,26,0.0,0.0
1009,360,23-09-2019 23:38:00,0,4316.0,4234.0,0.981,21.693,316,171,144,27,145,100,45,84,0.0,0.04
1009,361,23-09-2019 23:40:00,0,4073.0,3887.0,0.954,20.35,328,158,115,43,170,126,44,23,0.0,0.0
1009,362,23-09-2019 23:42:00,0,3414.0,3352.0,0.982,17.161,187,115,72,43,72,42,30,1,0.0,0.0
1009,363,23-09-2019 23:44:00,0,3422.0,3358.0,0.981,17.2,244,145,106,39,99,73,26,30,0.0,0.0
1009,364,23-09-2019 23:46:00,0,3441.0,3282.0,0.954,17.192,301,173,136,37,128,84,44,19,0.0,0.01
1009,365,23-09-2019 23:48:00,0,3109.5,2999.5,0.966,15.572,41,24,15,9,17,5,12,2,0.0,0.0
1009,366,23-09-2019 23:50:00,0,2778.0,2717.0,0.978,13.952,49,45,17,28,4,0,4,0,0.0,0.0
1009,367,23-09-2019 23:52:00,0,2840.0,2532.0,0.891,13.994,39,33,2,31,6,0,6,2,0.0,0.0
1009,368,23-09-2019 23:54:00,0,2815.0,2620.0,0.931,13.991,92,47,32,15,45,6,39,29,0.0,0.0
1009,369,23-09-2019 23:56:00,0,3448.0,3244.0,0.941,17.175,97,62,36,26,35,1,34,76,0.0,0.15
1009,370,23-09-2019 23:58:00,0,3794.0,3607.0,0.951,18.942,2,2,0,2,0,0,0,0,0.0,0.02
1009,371,24-09-2019 00:00:00,0,3531.0,3391.0,0.96,17.666,52,21,13,8,31,19,12,2,0.0,0.03
1009,372,24-09-2019 00:02:00,0,4332.0,4164.0,0.961,21.68,116,61,38,23,55,35,20,2,0.0,0.0
1009,373,24-09-2019 00:04:00,0,3239.0,3177.0,0.981,16.278,2,0,0,0,2,0,2,0,0.0,0.0
1009,374,24-09-2019 00:06:00,0,2945.0,2973.0,1.01,14.893,0,0,0,0,0,0,0,0,0.0,0.0
1009,375,24-09-2019 00:08:00,0,2778.0,2777.0,1.0,14.018,6,2,2,0,4,2,2,0,0.0,0.0
1009,376,24-09-2019 00:10:00,0,2810.0,2639.0,0.939,13.993,5,0,0,0,5,0,5,0,0.0,0.0
1009,377,24-09-2019 00:12:00,0,2512.0,2480.0,0.987,12.642,1,0,0,0,1,0,1,0,0.0,0.0
1009,378,24-09-2019 00:14:00,0,2548.0,2365.0,0.928,12.658,1,0,0,0,1,0,1,0,0.0,0.0
1009,379,24-09-2019 00:16:00,0,2353.0,2247.0,0.955,11.76,6,0,0,0,6,0,6,0,0.0,0.0
1009,380,24-09-2019 00:18:00,0,2382.0,2147.0,0.901,11.763,180,107,89,18,73,46,27,41,0.0,0.0
1009,381,24-09-2019 00:20:00,0,3259.0,3065.0,0.94,16.233,355,194,149,45,161,110,51,40,0.19,0.0
1009,382,24-09-2019 00:22:00,0,3465.0,3372.5,0.971,17.385,292,140,105,35,152,110,42,55,0.0,0.0
1009,383,24-09-2019 00:24:00,0,3671.0,3680.0,1.002,18.537,147,72,57,15,75,42,33,43,0.0,0.0
1009,384,24-09-2019 00:26:00,0,3571.0,3634.0,1.018,18.093,165,63,47,16,102,68,34,23,0.0,0.0
1009,385,24-09-2019 00:28:00,0,3158.0,3093.0,0.98,15.866,116,66,38,28,50,13,37,2,0.0,0.0
1009,386,24-09-2019 00:30:00,0,2803.0,2679.0,0.956,14.012,189,90,65,25,99,65,34,44,0.0,0.0
1009,387,24-09-2019 00:32:00,0,3265.0,3096.0,0.948,16.291,57,29,21,8,28,12,16,4,0.0,0.0
1009,388,24-09-2019 00:34:00,0,2962.0,2878.0,0.972,14.856,31,22,3,19,9,2,7,0,0.0,0.0
1009,389,24-09-2019 00:36:00,0,2888.0,2828.0,0.979,14.508,27,24,0,24,3,0,3,0,0.0,0.0
1009,390,24-09-2019 00:38:00,0,2760.0,2802.0,1.015,13.977,14,2,0,2,12,0,12,0,0.0,0.0
1009,391,24-09-2019 00:40:00,0,3147.0,3018.0,0.959,15.74,252,124,90,34,128,87,41,26,0.0,0.0
1009,392,24-09-2019 00:42:00,0,3256.0,3114.0,0.956,16.278,5,1,0,1,4,1,3,0,0.0,0.0
1009,393,24-09-2019 00:44:00,0,2980.0,2843.0,0.954,14.888,0,0,0,0,0,0,0,0,0.0,0.0
1009,394,24-09-2019 00:46:00,0,2611.0,2570.0,0.984,13.133,0,0,0,0,0,0,0,0,0.0,0.0
1009,395,24-09-2019 00:48:00,0,2431.0,2349.0,0.966,12.178,115,74,59,15,41,33,8,0,0.0,0.0
1009,396,24-09-2019 00:50:00,0,2340.0,2253.0,0.963,11.716,574,417,321,96,157,113,44,11,0.0,0.01
1009,397,24-09-2019 00:52:00,0,3400.0,3446.0,1.014,17.212,413,250,190,60,163,119,44,28,0.0,0.0
1009,398,24-09-2019 00:54:00,0,3604.0,3513.0,0.975,18.089,156,76,50,26,80,60,20,47,0.0,0.0
1009,399,24-09-2019 00:56:00,0,3600.0,3528.0,0.98,18.09,120,57,30,27,63,28,35,69,0.0,0.0
1009,400,24-09-2019 00:58:00,0,3596.0,3543.0,0.985,18.091,152,76,49,27,76,46,30,35,0.0,0.0
1009,401,24-09-2019 01:00:00,0,2966.0,2929.0,0.988,14.926,65,44,19,25,21,6,15,0,0.0,0.0
1009,402,24-09-2019 01:02:00,0,2791.0,2727.0,0.977,14.014,62,58,19,39,4,2,2,3,0.0,0.0
1009,403,24-09-2019 01:04:00,0,2877.0,2834.0,0.985,14.471,98,53,29,24,45,35,10,41,0.1,0.0
1009,404,24-09-2019 01:06:00,0,3568.0,3609.0,1.012,18.053,154,75,53,22,79,50,29,36,0.0,0.0
1009,405,24-09-2019 01:08:00,0,2974.0,2892.0,0.973,14.918,37,20,15,5,17,13,4,0,0.0,0.0
1009,406,24-09-2019 01:10:00,0,2798.0,2686.0,0.96,13.997,0,0,0,0,0,0,0,0,0.0,0.0
1009,407,24-09-2019 01:12:00,0,2516.0,2474.0,0.983,12.652,0,0,0,0,0,0,0,0,0.0,0.0
1009,408,24-09-2019 01:14:00,0,2331.0,2341.0,1.004,11.775,0,0,0,0,0,0,0,0,0.0,0.0
1009,409,24-09-2019 01:16:00,0,2334.0,2287.0,0.98,11.726,0,0,0,0,0,0,0,0,0.0,0.0
1009,410,24-09-2019 01:18:00,0,2347.0,2272.0,0.968,11.763,128,67,36,31,61,44,17,29,0.0,0.0
1009,411,24-09-2019 01:20:00,0,2987.0,2866.0,0.96,14.94,109,26,12,14,83,48,35,31,0.0,0.0
1009,412,24-09-2019 01:22:00,0,3261.0,3112.0,0.954,16.294,227,112,76,36,115,73,42,52,0.0,0.02
1009,413,24-09-2019 01:24:00,0,3418.0,3370.0,0.986,17.197,230,148,103,45,82,53,29,25,0.0,0.0
1009,414,24-09-2019 01:26:00,0,2945.0,2916.0,0.99,14.832,222,104,71,33,118,82,36,40,0.0,0.0
1009,415,24-09-2019 01:28:00,0,3341.0,3263.0,0.976,16.777,127,51,23,28,76,31,45,70,0.0,0.0
1009,416,24-09-2019 01:30:00,0,3059.5,3003.5,0.982,15.38,82,45,33,12,37,17,20,2,0.0,0.01
1009,417,24-09-2019 01:32:00,0,2778.0,2744.0,0.988,13.983,37,30,9,21,7,3,4,0,0.0,0.0
1009,418,24-09-2019 01:34:00,0,2818.0,2642.0,0.938,14.027,42,41,5,36,1,1,0,0,0.0,0.0
1009,419,24-09-2019 01:36:00,0,2790.0,2722.0,0.975,14.007,10,8,0,8,2,0,2,0,0.0,0.01
1009,420,24-09-2019 01:38:00,0,2811.0,2620.0,0.932,13.975,3,3,0,3,0,0,0,0,0.0,0.0
1009,421,24-09-2019 01:40:00,0,2509.0,2465.0,0.982,12.615,0,0,0,0,0,0,0,0,0.0,0.0
1009,422,24-09-2019 01:42:00,0,2431.0,2352.0,0.968,12.182,0,0,0,0,0,0,0,0,0.0,0.0
1009,423,24-09-2019 01:44:00,0,2356.0,2272.0,0.964,11.798,15,9,2,7,6,2,4,0,0.0,0.0
1009,424,24-09-2019 01:46:00,0,2346.0,2192.0,0.934,11.671,4,3,0,3,1,0,1,0,0.0,0.0
1009,425,24-09-2019 01:48:00,0,2371.0,2169.0,0.915,11.742,166,112,70,42,54,29,25,23,0.0,0.0
1009,426,24-09-2019 01:50:00,0,2543.0,2398.0,0.943,12.676,3,3,1,2,0,0,0,0,0.0,0.01
1009,427,24-09-2019 01:52:00,0,2357.0,2243.0,0.952,11.771,5,5,0,5,0,0,0,0,0.0,0.0
1009,428,24-09-2019 01:54:00,0,2183.0,2061.0,0.944,10.882,0,0,0,0,0,0,0,0,0.0,0.0
1009,429,24-09-2019 01:56:00,0,1879.0,1911.0,1.017,9.52,0,0,0,0,0,0,0,0,0.0,0.0
1009,430,24-09-2019 01:58:00,0,1872.0,1879.0,1.004,9.455,12,12,5,7,0,0,0,0,0.0,0.0
1009,431,24-09-2019 02:00:00,0,1899.0,1832.0,0.965,9.509,0,0,0,0,0,0,0,0,0.0,0.0
1009,432,24-09-2019 02:02:00,0,1877.0,1895.0,1.01,9.494,0,0,0,0,0,0,0,0,0.0,0.0
1009,433,24-09-2019 02:04:00,0,1872.5,1908.0,1.019,9.49,0,0,0,0,0,0,0,0,0.0,0.0
1009,434,24-09-2019 02:06:00,0,1868.0,1921.0,1.028,9.486,1,1,0,1,0,0,0,0,0.0,0.0
1009,435,24-09-2019 02:08:00,0,1888.0,1843.0,0.976,9.479,109,53,37,16,56,40,16,17,0.0,0.0
1009,436,24-09-2019 02:10:00,0,2770.0,2770.0,1.0,13.981,118,38,16,22,80,45,35,47,0.0,0.0
1009,437,24-09-2019 02:12:00,0,2968.0,2909.0,0.98,14.915,158,106,67,39,52,23,29,23,0.0,0.0
1009,438,24-09-2019 02:14:00,0,2888.0,2786.0,0.965,14.464,259,128,102,26,131,100,31,109,0.0,0.0
1009,439,24-09-2019 02:16:00,0,3249.0,3129.0,0.963,16.267,95,52,28,24,43,13,30,63,0.0,0.0
1009,440,24-09-2019 02:18:00,0,3240.0,3211.0,0.991,16.321,98,55,29,26,43,7,36,67,0.0,0.0
1009,441,24-09-2019 02:20:00,0,3404.0,3386.0,0.995,17.16,80,31,15,16,49,2,47,83,0.0,0.01
1009,442,24-09-2019 02:22:00,0,3583.0,3611.0,1.008,18.114,263,146,114,32,117,71,46,101,0.0,0.01
1009,443,24-09-2019 02:24:00,0,3610.0,3504.0,0.971,18.102,262,170,135,35,92,56,36,85,0.0,0.05
1009,444,24-09-2019 02:26:00,0,3146.0,3049.0,0.969,15.769,164,82,52,30,82,48,34,12,0.0,0.11
1009,445,24-09-2019 02:28:00,0,3853.0,3880.0,1.007,19.477,143,58,30,28,85,49,36,32,0.0,0.0
1009,446,24-09-2019 02:30:00,0,3449.0,3274.0,0.949,17.213,160,90,67,23,70,37,33,50,0.0,0.0
1009,447,24-09-2019 02:32:00,0,3674.0,3613.0,0.983,18.476,96,45,24,21,51,0,51,64,0.0,0.0
1009,448,24-09-2019 02:34:00,0,3778.0,3700.0,0.979,18.982,126,47,22,25,79,36,43,39,0.27,0.0
1009,449,24-09-2019 02:36:00,0,4656.0,4688.0,1.007,23.536,264,115,86,29,149,112,37,41,0.0,0.0
1009,450,24-09-2019 02:38:00,0,4219.0,4176.5,0.988,21.2475,147,75,42,33,72,35,37,62,0.0,0.0
1009,451,24-09-2019 02:40:00,0,3782.0,3665.0,0.969,18.959,104,71,40,31,33,9,24,57,0.0,0.0
1009,452,24-09-2019 02:42:00,0,3605.0,3523.0,0.977,18.104,49,29,15,14,20,2,18,1,0.0,0.0
1009,453,24-09-2019 02:44:00,0,3264.0,3105.0,0.951,16.299,62,48,32,16,14,3,11,2,0.0,0.0
1009,454,24-09-2019 02:46:00,0,3050.0,3000.0,0.984,15.337,78,64,40,24,14,0,14,0,0.0,0.0
1009,455,24-09-2019 02:48:00,0,2944.0,2961.0,1.006,14.877,55,38,24,14,17,2,15,0,0.0,0.0
1009,456,24-09-2019 02:50:00,0,2964.0,2953.0,0.997,14.947,447,317,252,65,130,78,52,31,0.0,0.0
1009,457,24-09-2019 02:52:00,0,2998.0,2793.0,0.932,14.904,536,283,224,59,253,180,73,27,0.0,0.0
1009,458,24-09-2019 02:54:00,0,3436.0,3313.0,0.964,17.205,253,142,109,33,111,86,25,66,0.0,0.0
1009,459,24-09-2019 02:56:00,0,2955.0,2987.0,1.011,14.948,64,40,23,17,24,7,17,0,0.0,0.0
1009,460,24-09-2019 02:58:00,0,2974.0,2904.0,0.977,14.933,2,1,0,1,1,0,1,0,0.0,0.0
1009,461,24-09-2019 03:00:00,0,2789.0,2737.0,0.981,14.02,0,0,0,0,0,0,0,0,0.0,0.0
1009,462,24-09-2019 03:02:00,0,2528.0,2465.0,0.975,12.69,2,1,0,1,1,0,1,0,0.0,0.0
1009,463,24-09-2019 03:04:00,0,2445.0,2283.0,0.933,12.162,1,0,0,0,1,0,1,0,0.0,0.0
1009,464,24-09-2019 03:06:00,0,2368.0,2157.0,0.911,11.717,4,2,1,1,2,0,2,0,0.0,0.0
1009,465,24-09-2019 03:08:00,0,2270.0,2077.0,0.915,11.245,51,28,14,14,23,4,19,0,0.0,0.0
1009,466,24-09-2019 03:10:00,0,2173.0,2067.0,0.951,10.85,154,95,69,26,59,34,25,23,0.0,0.0
1009,467,24-09-2019 03:12:00,0,2529.0,2428.5,0.959,12.6525,583,342,272,70,241,183,58,31,0.0,0.0
1009,468,24-09-2019 03:14:00,0,2885.0,2790.0,0.967,14.455,25,3,0,3,22,1,21,0,0.0,0.0
1009,469,24-09-2019 03:16:00,0,2539.0,2411.0,0.949,12.674,1,0,0,0,1,0,1,0,0.0,0.0
1009,470,24-09-2019 03:18:00,0,2379.0,2167.0,0.911,11.773,0,0,0,0,0,0,0,0,0.0,0.0
1009,471,24-09-2019 03:20:00,0,2194.0,1999.0,0.911,10.856,0,0,0,0,0,0,0,0,0.0,0.0
1009,472,24-09-2019 03:22:00,0,1882.0,1858.0,0.987,9.473,0,0,0,0,0,0,0,0,0.0,0.0
1009,473,24-09-2019 03:24:00,0,1916.0,1726.0,0.901,9.461,33,25,15,10,8,0,8,0,0.0,0.0
1009,474,24-09-2019 03:26:00,0,1738.0,1576.0,0.907,8.592,14,8,2,6,6,0,6,0,0.0,0.0
1009,475,24-09-2019 03:28:00,0,1729.0,1602.0,0.926,8.588,9,9,2,7,0,0,0,0,0.0,0.0
1009,476,24-09-2019 03:30:00,0,1729.0,1586.0,0.917,8.569,17,17,7,10,0,0,0,0,0.0,0.0
1009,477,24-09-2019 03:32:00,0,1741.0,1572.0,0.903,8.599,12,10,6,4,2,0,2,0,0.0,0.0
1009,478,24-09-2019 03:34:00,0,1900.0,1840.0,0.969,9.523,5,5,2,3,0,0,0,0,0.0,0.0
1009,479,24-09-2019 03:36:00,0,2189.0,2012.0,0.919,10.854,14,13,4,9,1,1,0,0,0.0,0.0
1009,480,24-09-2019 03:38:00,0,2190.0,2000.0,0.913,10.844,12,11,2,9,1,0,1,0,0.0,0.0
1009,481,24-09-2019 03:40:00,0,1898.0,1826.0,0.962,9.5,0,0,0,0,0,0,0,0,0.0,0.0
1009,482,24-09-2019 03:42:00,0,1733.0,1573.0,0.908,8.569,12,11,6,5,1,0,1,0,0.0,0.0
1009,483,24-09-2019 03:44:00,0,1814.0,1676.0,0.924,9.003,0,0,0,0,0,0,0,0,0.0,0.0
1009,484,24-09-2019 03:46:00,0,1949.5,1807.5,0.927,9.683,4,4,0,4,0,0,0,0,0.0,0.0
1009,485,24-09-2019 03:48:00,0,2085.0,1939.0,0.93,10.363,0,0,0,0,0,0,0,0,0.0,0.0
1009,486,24-09-2019 03:50:00,0,1885.0,1881.0,0.998,9.51,8,0,0,0,8,0,8,0,0.0,0.0
1009,487,24-09-2019 03:52:00,0,2167.0,2103.0,0.971,10.866,7,3,3,0,4,0,4,0,0.0,0.0
1009,488,24-09-2019 03:54:00,0,2280.0,2119.0,0.929,11.33,3,2,1,1,1,0,1,0,0.0,0.0
1009,489,24-09-2019 03:56:00,0,2186.0,2036.0,0.931,10.868,217,127,96,31,90,59,31,56,0.0,0.0
1009,490,24-09-2019 03:58:00,0,2628.0,2465.0,0.938,13.082,79,31,19,12,48,5,43,64,0.0,0.0
1009,491,24-09-2019 04:00:00,0,3003.0,2830.0,0.943,14.965,150,83,48,35,67,39,28,44,0.0,0.0
1009,492,24-09-2019 04:02:00,0,3204.0,2913.0,0.909,15.85,96,40,22,18,56,16,40,83,0.0,0.0
1009,493,24-09-2019 04:04:00,0,3296.0,2969.0,0.901,16.273,177,104,79,25,73,43,30,105,0.0,0.0
1009,494,24-09-2019 04:06:00,0,3287.0,3009.0,0.915,16.284,90,56,40,16,34,4,30,52,0.0,0.0
1009,495,24-09-2019 04:08:00,0,2533.0,2384.0,0.941,12.62,54,35,18,17,19,2,17,10,0.0,0.0
1009,496,24-09-2019 04:10:00,0,2400.0,2040.0,0.85,11.716,43,25,8,17,18,0,18,1,0.0,0.0
1009,497,24-09-2019 04:12:00,0,2393.0,2140.0,0.894,11.797,74,61,24,37,13,0,13,0,0.0,0.0
1009,498,24-09-2019 04:14:00,0,2562.0,2297.0,0.896,12.639,77,52,22,30,25,4,21,2,0.0,0.0
1009,499,24-09-2019 04:16:00,0,2632.0,2439.0,0.926,13.071,83,45,7,38,38,6,32,0,0.0,0.0
1009,500,24-09-2019 04:18:00,0,2831.0,2589.0,0.914,14.02,101,80,40,40,21,6,15,3,0.0,0.02
1009,501,24-09-2019 04:20:00,0,2836.0,2557.5,0.9015,14.006,165,88,64,24,77,53,24,47,0.0,0.0
1009,502,24-09-2019 04:22:00,0,2841.0,2526.0,0.889,13.992,42,21,8,13,21,0,21,3,0.0,0.0
1009,503,24-09-2019 04:24:00,0,3487.0,3148.0,0.903,17.223,29,26,11,15,3,0,3,1,0.0,0.0
1009,504,24-09-2019 04:26:00,0,3634.0,3385.0,0.931,18.064,14,9,5,4,5,2,3,0,0.0,0.0
1009,505,24-09-2019 04:28:00,0,3456.0,3197.0,0.925,17.158,2,2,1,1,0,0,0,0,0.0,0.0
1009,506,24-09-2019 04:30:00,0,3299.0,2963.0,0.898,16.28,0,0,0,0,0,0,0,0,0.0,0.0
1009,507,24-09-2019 04:32:00,0,3006.0,2782.0,0.925,14.924,0,0,0,0,0,0,0,0,0.0,0.0
1009,508,24-09-2019 04:34:00,0,2830.0,2561.0,0.905,13.987,664,408,333,75,256,190,66,18,0.0,0.0
1009,509,24-09-2019 04:36:00,0,2831.0,2524.0,0.891,13.95,108,44,22,22,64,17,47,72,0.0,0.0
1009,510,24-09-2019 04:38:00,0,2925.0,2662.0,0.91,14.471,200,127,85,42,73,45,28,41,0.0,0.0
1009,511,24-09-2019 04:40:00,0,2408.0,2021.0,0.839,11.726,67,53,28,25,14,5,9,6,0.0,0.0
1009,512,24-09-2019 04:42:00,0,2770.0,2386.0,0.861,13.556,55,32,9,23,23,3,20,1,0.0,0.0
1009,513,24-09-2019 04:44:00,0,3003.0,2783.0,0.927,14.912,23,19,1,18,4,0,4,0,0.0,0.0
1009,514,24-09-2019 04:46:00,0,2992.0,2814.0,0.941,14.902,1,0,0,0,1,0,1,0,0.0,0.0
1009,515,24-09-2019 04:48:00,0,3011.0,2740.0,0.91,14.898,10,1,0,1,9,0,9,0,0.0,0.0
1009,516,24-09-2019 04:50:00,0,3046.0,2651.0,0.87,14.937,3,3,1,2,0,0,0,0,0.0,0.0
1009,517,24-09-2019 04:52:00,0,2856.0,2435.0,0.853,13.947,1,1,0,1,0,0,0,0,0.0,0.0
1009,518,24-09-2019 04:54:00,0,2716.5,2339.5,0.862,13.293,126,95,75,20,31,19,12,4,0.0,0.0
1009,519,24-09-2019 04:56:00,0,2577.0,2244.0,0.871,12.639,452,221,172,49,231,174,57,13,0.0,0.0
1009,520,24-09-2019 04:58:00,0,2778.0,2350.0,0.846,13.549,177,86,69,17,91,62,29,3,0.0,0.0
1009,521,24-09-2019 05:00:00,0,2682.0,2274.0,0.848,13.085,3,0,0,0,3,0,3,0,0.0,0.0
1009,522,24-09-2019 05:02:00,0,2610.0,2136.0,0.819,12.648,2,0,0,0,2,0,2,0,0.0,0.0
1009,523,24-09-2019 05:04:00,0,2406.0,2004.0,0.833,11.701,21,8,6,2,13,1,12,0,0.0,0.0
1009,524,24-09-2019 05:06:00,0,2417.0,1956.0,0.809,11.69,2,0,0,0,2,1,1,0,0.0,0.0
1009,525,24-09-2019 05:08:00,0,2221.0,1877.0,0.845,10.831,0,0,0,0,0,0,0,0,0.0,0.0
1009,526,24-09-2019 05:10:00,0,2225.0,1821.0,0.818,10.784,0,0,0,0,0,0,0,0,0.0,0.0
1009,527,24-09-2019 05:12:00,0,2223.0,1818.0,0.818,10.773,3,2,0,2,1,0,1,0,0.0,0.0
1009,528,24-09-2019 05:14:00,0,2137.0,1764.0,0.825,10.374,4,2,0,2,2,0,2,0,0.0,0.0
1009,529,24-09-2019 05:16:00,0,2037.0,1721.0,0.845,9.931,7,4,0,4,3,0,3,0,0.0,0.0
1009,530,24-09-2019 05:18:00,0,2046.0,1703.0,0.832,9.947,4,3,0,3,1,0,1,0,0.0,0.0
1009,531,24-09-2019 05:20:00,0,1937.0,1665.0,0.859,9.476,4,4,0,4,0,0,0,0,0.0,0.0
1009,532,24-09-2019 05:22:00,0,1944.0,1631.0,0.839,9.465,27,19,9,10,8,5,3,0,0.0,0.0
1009,533,24-09-2019 05:24:00,0,1956.0,1620.0,0.828,9.5,9,9,3,6,0,0,0,0,0.0,0.0
1009,534,24-09-2019 05:26:00,0,1937.0,1660.0,0.857,9.47,9,9,0,9,0,0,0,0,0.0,0.0
1009,535,24-09-2019 05:28:00,0,1938.0,1656.0,0.8545,9.47,31,31,0,31,0,0,0,0,0.0,0.0
1009,536,24-09-2019 05:30:00,0,1939.0,1652.0,0.852,9.47,12,8,0,8,4,1,3,0,0.0,0.0
1009,537,24-09-2019 05:32:00,0,1939.0,1652.0,0.852,9.469,15,13,0,13,2,0,2,0,0.0,0.0
1009,538,24-09-2019 05:34:00,0,1931.0,1652.0,0.856,9.438,22,11,1,10,11,0,11,0,0.0,0.0
1009,539,24-09-2019 05:36:00,0,2054.0,1644.0,0.801,9.913,32,29,9,20,3,1,2,0,0.0,0.0
1009,540,24-09-2019 05:38:00,0,2466.0,1871.0,0.759,11.788,34,21,4,17,13,4,9,0,0.0,0.0
1009,541,24-09-2019 05:40:00,0,2620.0,2050.0,0.782,12.594,234,145,113,32,89,63,26,79,0.0,0.0
1009,542,24-09-2019 05:42:00,0,2886.0,2358.0,0.817,13.98,125,62,32,30,63,37,26,11,0.0,0.01
1009,543,24-09-2019 05:44:00,0,2867.0,2405.0,0.839,13.959,183,118,89,29,65,27,38,62,0.0,0.0
1009,544,24-09-2019 05:46:00,0,3086.0,2436.0,0.789,14.858,114,84,40,44,30,10,20,56,0.0,0.0
1009,545,24-09-2019 05:48:00,0,3053.0,2573.0,0.843,14.878,162,85,53,32,77,37,40,72,0.0,0.0
1009,546,24-09-2019 05:50:00,0,3155.0,2628.0,0.833,15.339,164,78,53,25,86,31,55,71,0.0,0.0
1009,547,24-09-2019 05:52:00,0,3365.0,2730.0,0.811,16.281,114,83,48,35,31,6,25,35,0.0,0.0
1009,548,24-09-2019 05:54:00,0,3147.0,2629.0,0.835,15.312,168,98,63,35,70,39,31,94,0.0,0.02
1009,549,24-09-2019 05:56:00,0,3524.0,2902.0,0.824,17.096,109,70,27,43,39,2,37,76,0.0,0.0
1009,550,24-09-2019 05:58:00,0,3549.0,2889.0,0.814,17.182,211,110,69,41,101,58,43,81,0.0,0.01
1009,551,24-09-2019 06:00:00,1,3438.0,2862.0,0.833,16.714,392,174,123,51,218,170,48,62,0.0,0.01
1009,552,24-09-2019 06:02:00,1,3490.0,2894.5,0.8295,16.9545,384,202,166,36,182,128,54,114,0.0,0.01
1009,553,24-09-2019 06:04:00,1,3542.0,2927.0,0.826,17.195,292,140,108,32,152,113,39,99,0.0,0.0
1009,554,24-09-2019 06:06:00,1,3688.0,3214.0,0.871,18.09,90,36,22,14,54,30,24,1,0.0,0.0
1009,555,24-09-2019 06:08:00,1,2887.0,2397.0,0.83,14.03,68,49,38,11,19,11,8,1,0.0,0.0
1009,556,24-09-2019 06:10:00,1,2412.0,2038.0,0.845,11.76,207,91,58,33,116,67,49,2,0.0,0.0
1009,557,24-09-2019 06:12:00,1,2786.0,2309.0,0.829,13.533,231,176,125,51,55,30,25,2,0.0,0.14
1009,558,24-09-2019 06:14:00,1,2889.0,2363.0,0.818,13.999,82,67,35,32,15,8,7,5,0.0,0.0
1009,559,24-09-2019 06:16:00,1,2411.0,2002.0,0.83,11.715,8,3,1,2,5,0,5,0,0.0,0.0
1009,560,24-09-2019 06:18:00,1,2332.0,1891.0,0.811,11.281,42,37,21,16,5,0,5,0,0.0,0.0
1009,561,24-09-2019 06:20:00,1,3433.0,2913.0,0.849,16.75,31,29,8,21,2,0,2,0,0.0,0.0
1009,562,24-09-2019 06:22:00,1,3485.0,3042.0,0.873,17.098,72,72,37,35,0,0,0,0,0.0,0.0
1009,563,24-09-2019 06:24:00,1,3531.0,2976.0,0.843,17.209,6,6,2,4,0,0,0,0,0.0,0.0
1009,564,24-09-2019 06:26:00,1,3131.0,2717.0,0.868,15.347,0,0,0,0,0,0,0,0,0.0,0.0
1009,565,24-09-2019 06:28:00,1,2953.0,2551.0,0.864,14.461,0,0,0,0,0,0,0,0,0.0,0.0
1009,566,24-09-2019 06:30:00,1,2868.0,2442.0,0.852,14.005,4,4,1,3,0,0,0,0,0.0,0.0
1009,567,24-09-2019 06:32:00,1,2884.0,2413.0,0.837,14.033,143,91,61,30,52,28,24,13,0.0,0.0
1009,568,24-09-2019 06:34:00,1,2862.0,2438.0,0.852,13.974,173,109,78,31,64,36,28,33,0.0,0.0
1009,569,24-09-2019 06:36:00,1,2539.0,2180.0,0.8595,12.4165,51,32,22,10,19,8,11,6,0.0,0.0
1009,570,24-09-2019 06:38:00,1,2216.0,1922.0,0.867,10.859,286,199,150,49,87,45,42,28,0.0,0.0
1009,571,24-09-2019 06:40:00,1,2605.0,2152.0,0.826,12.645,52,36,23,13,16,5,11,3,0.0,0.0
1009,572,24-09-2019 06:42:00,1,2393.0,2123.0,0.887,11.78,26,17,14,3,9,4,5,5,0.0,0.0
1009,573,24-09-2019 06:44:00,1,2505.0,2080.0,0.831,12.172,1,0,0,0,1,0,1,0,0.0,0.0
1009,574,24-09-2019 06:46:00,1,2413.0,1965.0,0.814,11.683,0,0,0,0,0,0,0,0,0.0,0.0
1009,575,24-09-2019 06:48:00,1,2416.0,2001.0,0.828,11.736,0,0,0,0,0,0,0,0,0.0,0.0
1009,576,24-09-2019 06:50:00,1,2520.0,2062.0,0.818,12.212,0,0,0,0,0,0,0,0,0.0,0.0
1009,577,24-09-2019 06:52:00,1,2433.0,1942.0,0.798,11.737,0,0,0,0,0,0,0,0,0.0,0.0
1009,578,24-09-2019 06:54:00,1,2227.0,1835.0,0.824,10.808,15,12,8,4,3,0,3,0,0.0,0.0
1009,579,24-09-2019 06:56:00,1,2242.0,1748.0,0.78,10.771,6,6,0,6,0,0,0,0,0.0,0.0
1009,580,24-09-2019 06:58:00,1,2256.0,1728.0,0.766,10.803,0,0,0,0,0,0,0,0,0.0,0.0
1009,581,24-09-2019 07:00:00,1,2160.0,1692.0,0.783,10.382,0,0,0,0,0,0,0,0,0.0,0.0
1009,582,24-09-2019 07:02:00,1,2048.0,1653.0,0.807,9.898,0,0,0,0,0,0,0,0,0.0,0.0
1009,583,24-09-2019 07:04:00,1,2061.0,1661.0,0.806,9.961,4,2,0,2,2,0,2,0,0.0,0.0
1009,584,24-09-2019 07:06:00,1,2054.0,1632.0,0.794,9.899,1,0,0,0,1,0,1,0,0.0,0.0
1009,585,24-09-2019 07:08:00,1,2060.0,1643.0,0.798,9.936,0,0,0,0,0,0,0,0,0.0,0.0
1009,586,24-09-2019 07:10:00,1,2008.0,1618.0,0.806,9.7035,2,1,0,1,1,0,1,0,0.0,0.0
1009,587,24-09-2019 07:12:00,1,1956.0,1593.0,0.814,9.471,0,0,0,0,0,0,0,0,0.0,0.0
1009,588,24-09-2019 07:14:00,1,2061.0,1623.0,0.787,9.918,0,0,0,0,0,0,0,0,0.0,0.0
1009,589,24-09-2019 07:16:00,1,2287.0,1655.0,0.724,10.846,0,0,0,0,0,0,0,0,0.0,0.0
1009,590,24-09-2019 07:18:00,1,2165.0,1648.0,0.761,10.354,0,0,0,0,0,0,0,0,0.0,0.0
1009,591,24-09-2019 07:20:00,1,2161.0,1644.0,0.761,10.335,0,0,0,0,0,0,0,0,0.0,0.0
1009,592,24-09-2019 07:22:00,1,2287.0,1645.0,0.719,10.834,0,0,0,0,0,0,0,0,0.0,0.0
1009,593,24-09-2019 07:24:00,1,2070.0,1599.0,0.773,9.925,7,2,0,2,5,0,5,0,0.0,0.0
1009,594,24-09-2019 07:26:00,1,2294.0,1652.0,0.72,10.867,42,10,5,5,32,0,32,1,0.0,0.0
1009,595,24-09-2019 07:28:00,1,2473.0,1798.0,0.727,11.734,32,15,8,7,17,0,17,0,0.0,0.0
1009,596,24-09-2019 07:30:00,1,2529.0,1933.0,0.764,12.105,17,10,3,7,7,0,7,1,0.0,0.0
1009,597,24-09-2019 07:32:00,1,2635.0,2057.0,0.781,12.659,103,70,41,29,33,6,27,22,0.0,0.0
1009,598,24-09-2019 07:34:00,1,2810.0,2177.0,0.775,13.484,81,45,25,20,36,16,20,57,0.0,0.0
1009,599,24-09-2019 07:36:00,1,2907.0,2207.0,0.759,13.898,79,29,12,17,50,4,46,67,0.0,0.0
1009,600,24-09-2019 07:38:00,1,2898.0,2309.0,0.797,13.975,75,38,12,26,37,4,33,59,0.0,0.0
1009,601,24-09-2019 07:40:00,1,3086.0,2475.0,0.802,14.9,97,53,26,27,44,0,44,76,0.0,0.0
1009,602,24-09-2019 07:42:00,1,3181.0,2561.0,0.805,15.37,99,50,24,26,49,2,47,74,0.0,0.0
1009,603,24-09-2019 07:44:00,1,3044.0,2409.0,0.7905,14.662,226,139,99,40,87,61,26,61,0.0,0.0
1009,604,24-09-2019 07:46:00,1,2907.0,2257.0,0.776,13.954,137,74,50,24,63,45,18,30,0.05,0.0
1009,605,24-09-2019 07:48:00,1,2436.0,1914.0,0.786,11.716,35,22,14,8,13,2,11,5,0.0,0.0
1009,606,24-09-2019 07:50:00,1,2161.0,1676.0,0.776,10.37,6,1,0,1,5,0,5,0,0.0,0.0
1009,607,24-09-2019 07:52:00,1,2275.0,1687.0,0.742,10.833,0,0,0,0,0,0,0,0,0.0,0.0
1009,608,24-09-2019 07:54:00,1,1966.0,1588.0,0.808,9.503,0,0,0,0,0,0,0,0,0.0,0.0
1009,609,24-09-2019 07:56:00,1,1952.0,1613.0,0.826,9.475,2,1,0,1,1,0,1,0,0.0,0.0
1009,610,24-09-2019 07:58:00,1,2064.0,1612.0,0.781,9.919,0,0,0,0,0,0,0,0,0.0,0.0
1009,611,24-09-2019 08:00:00,1,1974.0,1527.0,0.774,9.467,8,4,2,2,4,0,4,0,0.0,0.0
1009,612,24-09-2019 08:02:00,1,1774.0,1448.0,0.816,8.592,1,0,0,0,1,0,1,0,0.0,0.0
1009,613,24-09-2019 08:04:00,1,1781.0,1364.0,0.766,8.526,3,2,2,0,1,0,1,0,0.0,0.0
1009,614,24-09-2019 08:06:00,1,1810.0,1298.0,0.717,8.567,0,0,0,0,0,0,0,0,0.0,0.0
1009,615,24-09-2019 08:08:00,1,1791.0,1368.0,0.764,8.571,0,0,0,0,0,0,0,0,0.0,0.0
1009,616,24-09-2019 08:10:00,1,1959.0,1601.0,0.817,9.489,0,0,0,0,0,0,0,0,0.0,0.0
1009,617,24-09-2019 08:12:00,1,1863.0,1525.0,0.819,9.028,1,0,0,0,1,0,1,0,0.0,0.0
1009,618,24-09-2019 08:14:00,1,1755.0,1491.0,0.849,8.564,0,0,0,0,0,0,0,0,0.0,0.0
1009,619,24-09-2019 08:16:00,1,1768.0,1458.0,0.824,8.581,0,0,0,0,0,0,0,0,0.0,0.0
1009,620,24-09-2019 08:18:00,1,2058.5,1650.0,0.804,9.9385,0,0,0,0,0,0,0,0,0.0,0.0
1009,621,24-09-2019 08:20:00,1,2349.0,1842.0,0.784,11.296,0,0,0,0,0,0,0,0,0.0,0.0
1009,622,24-09-2019 08:22:00,1,2431.0,1905.0,0.784,11.686,0,0,0,0,0,0,0,0,0.0,0.0
1009,623,24-09-2019 08:24:00,1,2237.0,1816.0,0.812,10.824,0,0,0,0,0,0,0,0,0.0,0.0
1009,624,24-09-2019 08:26:00,1,2254.0,1732.0,0.768,10.797,0,0,0,0,0,0,0,0,0.0,0.0
1009,625,24-09-2019 08:28:00,1,1951.0,1615.0,0.828,9.474,2,0,0,0,2,0,2,0,0.0,0.0
1009,626,24-09-2019 08:30:00,1,1875.0,1496.0,0.798,9.042,0,0,0,0,0,0,0,0,0.0,0.0
1009,627,24-09-2019 08:32:00,1,1777.0,1425.0,0.802,8.58,0,0,0,0,0,0,0,0,0.0,0.0
1009,628,24-09-2019 08:34:00,1,1981.0,1502.0,0.758,9.47,0,0,0,0,0,0,0,0,0.0,0.0
1009,629,24-09-2019 08:36:00,1,2152.0,1649.0,0.766,10.307,0,0,0,0,0,0,0,0,0.0,0.0
1009,630,24-09-2019 08:38:00,1,2167.0,1684.0,0.777,10.402,0,0,0,0,0,0,0,0,0.0,0.0
1009,631,24-09-2019 08:40:00,1,2048.0,1641.0,0.801,9.887,0,0,0,0,0,0,0,0,0.0,0.0
1009,632,24-09-2019 08:42:00,1,1969.0,1565.0,0.795,9.492,7,5,1,4,2,0,2,0,0.0,0.0
1009,633,24-09-2019 08:44:00,1,1978.0,1493.0,0.755,9.445,43,21,10,11,22,4,18,0,0.0,0.0
1009,634,24-09-2019 08:46:00,1,2442.0,1970.0,0.807,11.803,131,79,50,29,52,15,37,36,0.0,0.0
1009,635,24-09-2019 08:48:00,1,2912.0,2271.0,0.78,13.987,141,80,51,29,61,39,22,60,0.0,0.0
1009,636,24-09-2019 08:50:00,1,2925.0,2245.0,0.767,14.012,79,45,25,20,34,0,34,47,0.0,0.0
1009,637,24-09-2019 08:52:00,1,3099.0,2406.5,0.776,14.8755,101,49,25,24,52,4,48,51,0.0,0.0
1009,638,24-09-2019 08:54:00,1,3273.0,2568.0,0.785,15.739,84,42,18,24,42,0,42,68,0.0,0.0
1009,639,24-09-2019 08:56:00,1,3364.0,2729.0,0.811,16.276,114,69,41,28,45,2,43,69,0.0,0.04
1009,640,24-09-2019 08:58:00,1,3448.0,2749.0,0.797,16.628,113,78,43,35,35,2,33,50,0.0,0.06
1009,641,24-09-2019 09:00:00,1,3546.0,2841.0,0.801,17.117,134,86,66,20,48,25,23,69,0.0,0.05
1009,642,24-09-2019 09:02:00,1,2237.0,1824.0,0.816,10.832,352,224,166,58,128,85,43,15,0.0,0.0
1009,643,24-09-2019 09:04:00,1,2918.0,2268.0,0.777,14.009,454,221,172,49,233,178,55,11,0.16,0.0
1009,644,24-09-2019 09:06:00,1,3326.0,2858.0,0.859,16.27,416,210,158,52,206,148,58,11,0.0,0.03
1009,645,24-09-2019 09:08:00,1,2234.0,1854.0,0.83,10.856,150,71,34,37,79,39,40,9,0.0,0.0
1009,646,24-09-2019 09:10:00,1,1961.0,1573.0,0.802,9.466,500,295,227,68,205,141,64,16,0.13,0.0
1009,647,24-09-2019 09:12:00,1,2435.0,1958.0,0.804,11.764,411,305,239,66,106,67,39,11,0.0,0.0
1009,648,24-09-2019 09:14:00,1,2966.0,2516.0,0.848,14.471,485,255,200,55,230,167,63,36,0.0,0.0
1009,649,24-09-2019 09:16:00,1,3317.0,2864.0,0.863,16.239,224,160,128,32,64,36,28,16,0.0,0.0
1009,650,24-09-2019 09:18:00,1,2861.0,2516.0,0.879,14.056,87,70,33,37,17,2,15,10,0.0,0.0
1009,651,24-09-2019 09:20:00,1,3041.0,2640.0,0.868,14.903,31,25,8,17,6,1,5,0,0.0,0.0
1009,652,24-09-2019 09:22:00,1,3340.0,2813.0,0.842,16.273,5,0,0,0,5,0,5,0,0.0,0.0
1009,653,24-09-2019 09:24:00,1,3237.0,2779.0,0.858,15.831,3,2,1,1,1,0,1,0,0.0,0.0
1009,654,24-09-2019 09:26:00,1,3053.0,2610.5,0.8545,14.9195,4,3,0,3,1,0,1,0,0.0,0.0
1009,655,24-09-2019 09:28:00,1,2869.0,2442.0,0.851,14.008,0,0,0,0,0,0,0,0,0.0,0.0
1009,656,24-09-2019 09:30:00,1,2667.0,2325.0,0.872,13.082,2,2,1,1,0,0,0,0,0.0,0.0
1009,657,24-09-2019 09:32:00,1,2601.0,2151.0,0.827,12.631,10,7,3,4,3,0,3,0,0.0,0.0
1009,658,24-09-2019 09:34:00,1,2416.0,1999.0,0.828,11.732,0,0,0,0,0,0,0,0,0.0,0.0
1009,659,24-09-2019 09:36:00,1,2420.0,1980.0,0.818,11.729,0,0,0,0,0,0,0,0,0.0,0.0
1009,660,24-09-2019 09:38:00,1,2208.0,1929.0,0.873,10.837,0,0,0,0,0,0,0,0,0.0,0.0
1009,661,24-09-2019 09:40:00,1,2222.0,1878.0,0.845,10.833,0,0,0,0,0,0,0,0,0.0,0.0
1009,662,24-09-2019 09:42:00,1,2233.0,1850.0,0.829,10.845,0,0,0,0,0,0,0,0,0.0,0.0
1009,663,24-09-2019 09:44:00,1,2126.0,1822.0,0.857,10.392,1,1,0,1,0,0,0,0,0.0,0.0
1009,664,24-09-2019 09:46:00,1,2026.0,1763.0,0.87,9.933,4,3,1,2,1,0,1,0,0.0,0.0
1009,665,24-09-2019 09:48:00,1,1915.0,1736.0,0.906,9.467,3,3,2,1,0,0,0,0,0.0,0.0
1009,666,24-09-2019 09:50:00,1,1928.0,1716.0,0.89,9.496,0,0,0,0,0,0,0,0,0.0,0.0
1009,667,24-09-2019 09:52:00,1,1931.0,1707.0,0.884,9.499,38,19,6,13,19,4,15,0,0.0,0.0
1009,668,24-09-2019 09:54:00,1,2228.0,1845.0,0.828,10.823,59,41,26,15,18,9,9,2,0.0,0.0
1009,669,24-09-2019 09:56:00,1,2408.0,2052.0,0.852,11.759,164,124,102,22,40,23,17,8,0.0,0.0
1009,670,24-09-2019 09:58:00,1,2403.0,2013.0,0.838,11.695,3,1,1,0,2,0,2,0,0.0,0.0
1009,671,24-09-2019 10:00:00,1,2314.0,1931.0,0.8345,11.255,0,0,0,0,0,0,0,0,0.0,0.0
1009,672,24-09-2019 10:02:00,1,2225.0,1849.0,0.831,10.815,10,9,5,4,1,0,1,0,0.0,0.0
1009,673,24-09-2019 10:04:00,1,2125.0,1825.0,0.859,10.394,0,0,0,0,0,0,0,0,0.0,0.0
1009,674,24-09-2019 10:06:00,1,2015.0,1771.0,0.879,9.901,0,0,0,0,0,0,0,0,0.0,0.0
1009,675,24-09-2019 10:08:00,1,1914.0,1750.0,0.914,9.48,0,0,0,0,0,0,0,0,0.0,0.0
1009,676,24-09-2019 10:10:00,1,1919.0,1728.0,0.9,9.475,1,1,0,1,0,0,0,0,0.0,0.0
1009,677,24-09-2019 10:12:00,1,1924.0,1711.0,0.89,9.474,0,0,0,0,0,0,0,0,0.0,0.0
1009,678,24-09-2019 10:14:00,1,2133.0,1792.0,0.84,10.387,13,13,1,12,0,0,0,0,0.0,0.0
1009,679,24-09-2019 10:16:00,1,2118.0,1795.0,0.848,10.333,14,14,6,8,0,0,0,0,0.0,0.0
1009,680,24-09-2019 10:18:00,1,2030.0,1742.0,0.858,9.929,0,0,0,0,0,0,0,0,0.0,0.0
1009,681,24-09-2019 10:20:00,1,1940.0,1673.0,0.862,9.495,18,17,0,17,1,0,1,0,0.0,0.0
1009,682,24-09-2019 10:22:00,1,1944.0,1652.0,0.85,9.488,16,16,3,13,0,0,0,0,0.0,0.0
1009,683,24-09-2019 10:24:00,1,1946.0,1641.0,0.844,9.483,4,3,2,1,1,0,1,0,0.0,0.0
1009,684,24-09-2019 10:26:00,1,1933.0,1688.0,0.873,9.484,1,1,0,1,0,0,0,0,0.0,0.0
1009,685,24-09-2019 10:28:00,1,1921.0,1727.0,0.899,9.482,4,4,0,4,0,0,0,0,0.0,0.0
1009,686,24-09-2019 10:30:00,1,1921.0,1730.0,0.901,9.484,9,9,0,9,0,0,0,0,0.0,0.0
1009,687,24-09-2019 10:32:00,1,1928.0,1715.0,0.89,9.493,32,9,3,6,23,12,11,0,0.0,0.0
1009,688,24-09-2019 10:34:00,1,1975.5,1722.0,0.8725,9.688,3,0,0,0,3,1,2,0,0.0,0.0
1009,689,24-09-2019 10:36:00,1,2023.0,1729.0,0.855,9.883,47,31,16,15,16,2,14,0,0.0,0.0
1009,690,24-09-2019 10:38:00,1,2224.0,1849.0,0.831,10.809,66,30,11,19,36,0,36,8,0.0,0.0
1009,691,24-09-2019 10:40:00,1,2420.0,2005.0,0.829,11.754,167,98,74,24,69,45,24,56,0.0,0.0
1009,692,24-09-2019 10:42:00,1,2385.0,2102.0,0.881,11.725,54,24,16,8,30,23,7,0,0.0,0.0
1009,693,24-09-2019 10:44:00,1,2603.0,2199.0,0.845,12.69,53,24,4,20,29,2,27,0,0.0,0.0
1009,694,24-09-2019 10:46:00,1,2602.0,2181.0,0.838,12.666,36,16,13,3,20,0,20,0,0.0,0.0
1009,695,24-09-2019 10:48:00,1,2596.0,2164.0,0.833,12.625,45,30,11,19,15,0,15,0,0.0,0.0
1009,696,24-09-2019 10:50:00,1,2404.0,2013.0,0.838,11.699,30,24,5,19,6,2,4,4,0.0,0.0
1009,697,24-09-2019 10:52:00,1,2495.0,2109.0,0.845,12.164,36,36,5,31,0,0,0,0,0.0,0.0
1009,698,24-09-2019 10:54:00,1,2402.0,2088.0,0.869,11.778,473,328,264,64,145,101,44,23,0.0,0.0
1009,699,24-09-2019 10:56:00,1,2485.0,2114.0,0.851,12.133,414,245,192,53,169,121,48,19,0.0,0.04
1009,700,24-09-2019 10:58:00,1,2581.0,2232.0,0.865,12.639,262,198,156,42,64,23,41,37,0.0,0.0
1009,701,24-09-2019 11:00:00,1,2589.0,2178.0,0.841,12.61,650,419,331,88,231,173,58,30,0.0,0.0
1009,702,24-09-2019 11:02:00,1,2518.0,2074.0,0.824,12.219,545,404,319,85,141,101,40,37,0.0,0.0
1009,703,24-09-2019 11:04:00,1,2589.0,2167.0,0.837,12.598,570,389,309,80,181,133,48,62,0.0,0.0
1009,704,24-09-2019 11:06:00,1,2700.0,2236.0,0.828,13.114,618,371,293,78,247,177,70,60,0.0,0.0
1009,705,24-09-2019 11:08:00,1,2693.0,2219.5,0.824,13.068,168,74,42,32,94,65,29,5,0.0,0.0
1009,706,24-09-2019 11:10:00,1,2686.0,2203.0,0.82,13.022,749,567,469,98,182,129,53,63,0.0,0.0
1009,707,24-09-2019 11:12:00,1,2614.0,2139.0,0.818,12.668,608,384,329,55,224,163,61,49,0.0,0.0
1009,708,24-09-2019 11:14:00,1,2711.0,2180.0,0.804,13.097,59,45,31,14,14,5,9,2,0.0,0.0
1009,709,24-09-2019 11:16:00,1,2706.0,2197.0,0.812,13.094,216,185,135,50,31,19,12,13,0.0,0.0
1009,710,24-09-2019 11:18:00,1,2716.0,2193.0,0.808,13.127,31,31,4,27,0,0,0,0,0.0,0.0
1009,711,24-09-2019 11:20:00,1,2598.0,2139.0,0.823,12.605,35,35,3,32,0,0,0,0,0.0,0.0
1009,712,24-09-2019 11:22:00,1,2608.0,2122.0,0.814,12.625,25,25,0,25,0,0,0,0,0.0,0.0
1009,713,24-09-2019 11:24:00,1,2424.0,1993.0,0.822,11.758,42,42,0,42,0,0,0,0,0.0,0.0
1009,714,24-09-2019 11:26:00,1,2449.0,1872.0,0.764,11.721,21,21,8,13,0,0,0,0,0.0,0.0
1009,715,24-09-2019 11:28:00,1,2249.0,1749.0,0.778,10.8,0,0,0,0,0,0,0,0,0.0,0.0
1009,716,24-09-2019 11:30:00,1,2169.0,1670.0,0.77,10.396,1,1,0,1,0,0,0,0,0.0,0.0
1009,717,24-09-2019 11:32:00,1,1950.0,1586.0,0.813,9.438,0,0,0,0,0,0,0,0,0.0,0.0
1009,718,24-09-2019 11:34:00,1,1985.0,1473.0,0.742,9.453,3,3,0,3,0,0,0,0,0.0,0.0
1009,719,24-09-2019 11:36:00,1,1764.0,1431.0,0.811,8.534,5,5,0,5,0,0,0,0,0.0,0.0
1009,720,24-09-2019 11:38:00,1,1776.0,1432.0,0.806,8.584,3,3,0,3,0,0,0,0,0.0,0.0
1009,721,24-09-2019 11:40:00,1,1993.0,1458.0,0.732,9.466,16,16,0,16,0,0,0,0,0.0,0.0
1009,722,24-09-2019 11:42:00,1,1993.0,1462.5,0.734,9.4715,10,10,0,10,0,0,0,0,0.0,0.0
1009,723,24-09-2019 11:44:00,1,1993.0,1467.0,0.736,9.477,3,2,0,2,1,0,1,0,0.0,0.0
1009,724,24-09-2019 11:46:00,1,1880.0,1456.0,0.775,9.018,1,1,0,1,0,0,0,0,0.0,0.0
1009,725,24-09-2019 11:48:00,1,1881.0,1435.0,0.763,9.0,1,1,0,1,0,0,0,0,0.0,0.0
1009,726,24-09-2019 11:50:00,1,1986.0,1494.0,0.752,9.48,0,0,0,0,0,0,0,0,0.0,0.0
1009,727,24-09-2019 11:52:00,1,1989.0,1493.0,0.751,9.488,23,22,11,11,1,0,1,0,0.0,0.0
1009,728,24-09-2019 11:54:00,1,1970.0,1562.0,0.793,9.491,0,0,0,0,0,0,0,0,0.0,0.0
1009,729,24-09-2019 11:56:00,1,1957.0,1579.0,0.807,9.46,8,8,2,6,0,0,0,0,0.0,0.0
1009,730,24-09-2019 11:58:00,1,1958.0,1563.0,0.799,9.444,5,5,1,4,0,0,0,0,0.0,0.0
1009,731,24-09-2019 12:00:00,1,1961.0,1559.0,0.795,9.452,3,3,0,3,0,0,0,0,0.0,0.0
1009,732,24-09-2019 12:02:00,1,1973.0,1529.0,0.775,9.468,5,5,1,4,0,0,0,0,0.0,0.0
1009,733,24-09-2019 12:04:00,1,1964.0,1564.0,0.797,9.469,0,0,0,0,0,0,0,0,0.0,0.0
1009,734,24-09-2019 12:06:00,1,1961.0,1563.0,0.797,9.456,3,3,1,2,0,0,0,0,0.0,0.0
1009,735,24-09-2019 12:08:00,1,1965.0,1532.0,0.78,9.439,8,8,0,8,0,0,0,0,0.0,0.0
1009,736,24-09-2019 12:10:00,1,1972.0,1515.0,0.768,9.447,15,14,8,6,1,0,1,0,0.0,0.0
1009,737,24-09-2019 12:12:00,1,2068.0,1596.0,0.772,9.915,2,2,1,1,0,0,0,0,0.0,0.0
1009,738,24-09-2019 12:14:00,1,2280.0,1666.0,0.731,10.828,0,0,0,0,0,0,0,0,0.0,0.0
1009,739,24-09-2019 12:16:00,1,2266.0,1709.5,0.7545,10.8215,182,126,89,37,56,37,19,1,0.0,0.0
1009,740,24-09-2019 12:18:00,1,2252.0,1753.0,0.778,10.815,480,298,232,66,182,162,20,15,0.0,0.0
1009,741,24-09-2019 12:20:00,1,2444.0,1849.0,0.757,11.678,56,23,4,19,33,0,33,0,0.0,0.0
1009,742,24-09-2019 12:22:00,1,2447.0,1885.0,0.77,11.729,159,17,2,15,142,131,11,10,0.0,0.0
1009,743,24-09-2019 12:24:00,1,2428.0,1922.0,0.792,11.694,225,77,43,34,148,129,19,0,0.0,0.0
1009,744,24-09-2019 12:26:00,1,2444.0,1909.0,0.781,11.743,89,59,33,26,30,26,4,0,0.0,0.0
1009,745,24-09-2019 12:28:00,1,2433.0,1907.0,0.784,11.696,140,30,7,23,110,96,14,1,0.0,0.0
1009,746,24-09-2019 12:30:00,1,2432.0,1908.0,0.785,11.695,19,4,0,4,15,13,2,0,0.0,0.0
1009,747,24-09-2019 12:32:00,1,2440.0,1941.0,0.796,11.762,13,9,1,8,4,2,2,0,0.0,0.0
1009,748,24-09-2019 12:34:00,1,2456.0,1831.0,0.745,11.705,0,0,0,0,0,0,0,0,0.0,0.0
1009,749,24-09-2019 12:36:00,1,2262.0,1738.0,0.768,10.838,222,3,2,1,219,206,13,0,0.0,0.0
1009,750,24-09-2019 12:38:00,1,2154.0,1655.0,0.768,10.319,3,2,0,2,1,0,1,0,0.0,0.0
1009,751,24-09-2019 12:40:00,1,2176.0,1640.0,0.754,10.389,7,6,2,4,1,0,1,0,0.0,0.0
1009,752,24-09-2019 12:42:00,1,2278.0,1658.0,0.728,10.813,15,9,0,9,6,5,1,0,0.0,0.0
1009,753,24-09-2019 12:44:00,1,2169.0,1643.0,0.758,10.364,2,1,1,0,1,0,1,0,0.0,0.0
1009,754,24-09-2019 12:46:00,1,2059.0,1594.0,0.774,9.878,113,18,1,17,95,85,10,0,0.0,0.0
1009,755,24-09-2019 12:48:00,1,1962.0,1543.0,0.786,9.439,1,0,0,0,1,0,1,0,0.0,0.0
1009,756,24-09-2019 12:50:00,1,1976.0,1518.5,0.7685,9.467,0,0,0,0,0,0,0,0,0.0,0.0
1009,757,24-09-2019 12:52:00,1,1990.0,1494.0,0.751,9.495,19,1,0,1,18,16,2,0,0.0,0.0
1009,758,24-09-2019 12:54:00,1,1978.0,1523.0,0.77,9.481,1,0,0,0,1,0,1,0,0.0,0.0
1009,759,24-09-2019 12:56:00,1,1976.0,1488.0,0.753,9.431,1,0,0,0,1,0,1,0,0.0,0.0
1009,760,24-09-2019 12:58:00,1,1986.0,1476.0,0.743,9.458,0,0,0,0,0,0,0,0,0.0,0.0
1009,761,24-09-2019 13:00:00,1,1991.0,1444.0,0.726,9.443,2,0,0,0,2,0,2,0,0.0,0.0
1009,762,24-09-2019 13:02:00,1,1888.0,1429.0,0.756,9.023,57,20,2,18,37,32,5,0,0.0,0.0
1009,763,24-09-2019 13:04:00,1,1960.0,1588.0,0.81,9.483,50,32,22,10,18,14,4,0,0.0,0.0
1009,764,24-09-2019 13:06:00,1,1961.0,1593.0,0.813,9.489,8,7,4,3,1,0,1,0,0.0,0.0
1009,765,24-09-2019 13:08:00,1,1958.0,1587.0,0.811,9.471,4,4,2,2,0,0,0,0,0.0,0.0
1009,766,24-09-2019 13:10:00,1,1970.0,1546.0,0.785,9.473,0,0,0,0,0,0,0,0,0.0,0.0
1009,767,24-09-2019 13:12:00,1,1976.0,1508.0,0.763,9.454,8,6,2,4,2,2,0,0,0.0,0.0
1009,768,24-09-2019 13:14:00,1,1987.0,1468.0,0.739,9.454,2,2,0,2,0,0,0,0,0.0,0.0
1009,769,24-09-2019 13:16:00,1,1990.0,1448.0,0.728,9.444,1,0,0,0,1,0,1,0,0.0,0.0
1009,770,24-09-2019 13:18:00,1,1890.0,1438.0,0.761,9.039,44,41,22,19,3,3,0,0,0.0,0.0
1009,771,24-09-2019 13:20:00,1,1997.0,1452.0,0.727,9.475,2,2,2,0,0,0,0,0,0.0,0.0
1009,772,24-09-2019 13:22:00,1,1986.0,1457.0,0.734,9.439,3,3,1,2,0,0,0,0,0.0,0.0
1009,773,24-09-2019 13:24:00,1,1986.5,1466.5,0.7385,9.451,15,12,8,4,3,2,1,0,0.0,0.0
1009,774,24-09-2019 13:26:00,1,1987.0,1476.0,0.743,9.463,35,11,9,2,24,21,3,0,0.0,0.0
1009,775,24-09-2019 13:28:00,1,1963.0,1559.0,0.794,9.461,1,0,0,0,1,0,1,0,0.0,0.0
1009,776,24-09-2019 13:30:00,1,1965.0,1545.0,0.786,9.455,3,0,0,0,3,2,1,0,0.0,0.0
1009,777,24-09-2019 13:32:00,1,1979.0,1506.0,0.761,9.464,49,28,3,25,21,17,4,0,0.0,0.0
1009,778,24-09-2019 13:34:00,1,1978.0,1527.0,0.772,9.485,40,38,0,38,2,0,2,0,0.0,0.0
1009,779,24-09-2019 13:36:00,1,1963.0,1563.0,0.796,9.463,44,38,8,30,6,4,2,0,0.0,0.0
1009,780,24-09-2019 13:38:00,1,1952.0,1576.0,0.807,9.437,40,33,9,24,7,6,1,0,0.0,0.0
1009,781,24-09-2019 13:40:00,1,2071.0,1580.0,0.763,9.91,31,26,2,24,5,4,1,0,0.0,0.0
1009,782,24-09-2019 13:42:00,1,1955.0,1572.0,0.804,9.445,198,34,0,34,164,145,19,0,0.0,0.0
1009,783,24-09-2019 13:44:00,1,2073.0,1581.0,0.763,9.919,43,27,8,19,16,12,4,0,0.0,0.0
1009,784,24-09-2019 13:46:00,1,1965.0,1568.0,0.798,9.477,14,5,1,4,9,6,3,0,0.0,0.0
1009,785,24-09-2019 13:48:00,1,2171.0,1627.0,0.749,10.353,2,0,0,0,2,0,2,0,0.0,0.0
1009,786,24-09-2019 13:50:00,1,2071.0,1604.0,0.774,9.936,7,1,0,1,6,6,0,0,0.0,0.0
1009,787,24-09-2019 13:52:00,1,1960.0,1547.0,0.789,9.435,32,8,1,7,24,21,3,0,0.0,0.0
1009,788,24-09-2019 13:54:00,1,1967.0,1534.0,0.78,9.447,48,0,0,0,48,41,7,0,0.0,0.0
1009,789,24-09-2019 13:56:00,1,1974.0,1531.0,0.776,9.471,169,0,0,0,169,151,18,0,0.0,0.0
1009,790,24-09-2019 13:58:00,1,1971.5,1533.5,0.778,9.4645,28,8,4,4,20,17,3,0,0.0,0.0
1009,791,24-09-2019 14:00:00,1,1969.0,1536.0,0.78,9.458,2,0,0,0,2,0,2,0,0.0,0.0
1009,792,24-09-2019 14:02:00,1,1973.0,1536.0,0.779,9.475,4,1,1,0,3,0,3,0,0.0,0.0
1009,793,24-09-2019 14:04:00,1,1968.0,1517.0,0.771,9.434,1,0,0,0,1,0,1,0,0.0,0.0
1009,794,24-09-2019 14:06:00,1,1970.0,1525.0,0.774,9.45,44,16,10,6,28,26,2,0,0.0,0.0
1009,795,24-09-2019 14:08:00,1,1973.0,1540.0,0.78,9.48,35,4,0,4,31,27,4,0,0.0,0.0
1009,796,24-09-2019 14:10:00,1,1971.0,1548.0,0.786,9.48,26,2,0,2,24,19,5,0,0.0,0.0
1009,797,24-09-2019 14:12:00,1,1976.0,1511.0,0.765,9.459,87,43,26,17,44,35,9,0,0.0,0.0
1009,798,24-09-2019 14:14:00,1,1959.0,1551.0,0.791,9.437,200,121,79,42,79,67,12,36,0.0,0.0
1009,799,24-09-2019 14:16:00,1,2053.0,1633.0,0.795,9.898,116,33,20,13,83,51,32,33,0.0,0.0
1009,800,24-09-2019 14:18:00,1,2258.0,1749.0,0.775,10.833,82,54,21,33,28,8,20,19,0.0,0.0
1009,801,24-09-2019 14:20:00,1,2453.0,1833.0,0.747,11.694,65,38,9,29,27,0,27,8,0.0,0.0
1009,802,24-09-2019 14:22:00,1,2458.0,1845.0,0.75,11.728,39,29,7,22,10,1,9,1,0.0,0.0
1009,803,24-09-2019 14:24:00,1,2454.0,1855.0,0.756,11.721,40,25,2,23,15,1,14,2,0.0,0.0
1009,804,24-09-2019 14:26:00,1,2447.0,1867.0,0.763,11.708,94,19,4,15,75,42,33,10,0.0,0.0
1009,805,24-09-2019 14:28:00,1,2449.0,1895.0,0.774,11.747,66,20,3,17,46,16,30,1,0.0,0.0
1009,806,24-09-2019 14:30:00,1,2452.0,1853.0,0.756,11.712,23,9,3,6,14,0,14,2,0.0,0.0
1009,807,24-09-2019 14:32:00,1,2452.0,1839.0,0.75,11.696,21,5,2,3,16,2,14,0,0.0,0.0
1009,808,24-09-2019 14:34:00,1,2452.0,1825.0,0.744,11.68,3,1,0,1,2,0,2,0,0.0,0.0
1009,809,24-09-2019 14:36:00,1,2265.0,1710.0,0.755,10.818,0,0,0,0,0,0,0,0,0.0,0.0
1009,810,24-09-2019 14:38:00,1,1957.0,1601.0,0.818,9.484,0,0,0,0,0,0,0,0,0.0,0.0
1009,811,24-09-2019 14:40:00,1,1972.0,1540.0,0.781,9.475,9,6,0,6,3,0,3,0,0.0,0.0
1009,812,24-09-2019 14:42:00,1,1983.0,1500.0,0.757,9.476,0,0,0,0,0,0,0,0,0.0,0.0
1009,813,24-09-2019 14:44:00,1,1995.0,1456.0,0.73,9.474,0,0,0,0,0,0,0,0,0.0,0.0
1009,814,24-09-2019 14:46:00,1,1891.0,1435.0,0.759,9.037,1,0,0,0,1,0,1,0,0.0,0.0
1009,815,24-09-2019 14:48:00,1,1782.0,1376.0,0.772,8.546,1,0,0,0,1,0,1,0,0.0,0.0
1009,816,24-09-2019 14:50:00,1,1784.0,1378.0,0.772,8.555,0,0,0,0,0,0,0,0,0.0,0.0
1009,817,24-09-2019 14:52:00,1,1785.0,1384.0,0.775,8.567,3,0,0,0,3,0,3,0,0.0,0.0
1009,818,24-09-2019 14:54:00,1,1890.0,1415.0,0.749,9.014,4,0,0,0,4,0,4,0,0.0,0.0
1009,819,24-09-2019 14:56:00,1,1992.0,1453.0,0.73,9.459,5,0,0,0,5,0,5,0,0.0,0.0
1009,820,24-09-2019 14:58:00,1,1998.0,1436.0,0.719,9.464,5,0,0,0,5,0,5,0,0.0,0.0
1009,821,24-09-2019 15:00:00,1,1902.0,1421.0,0.747,9.069,0,0,0,0,0,0,0,0,0.0,0.0
1009,822,24-09-2019 15:02:00,1,1891.0,1416.0,0.749,9.018,8,4,4,0,4,0,4,1,0.0,0.0
1009,823,24-09-2019 15:04:00,1,1998.0,1436.0,0.719,9.461,0,0,0,0,0,0,0,0,0.0,0.0
1009,824,24-09-2019 15:06:00,1,2034.0,1508.5,0.7415,9.684,1,1,0,1,0,0,0,0,0.0,0.0
1009,825,24-09-2019 15:08:00,1,2070.0,1581.0,0.764,9.907,0,0,0,0,0,0,0,0,0.0,0.0
1009,826,24-09-2019 15:10:00,1,2178.0,1626.0,0.747,10.381,0,0,0,0,0,0,0,0,0.0,0.0
1009,827,24-09-2019 15:12:00,1,2175.0,1632.0,0.75,10.376,12,9,5,4,3,0,3,0,0.0,0.0
1009,828,24-09-2019 15:14:00,1,2285.0,1651.0,0.723,10.831,3,1,1,0,2,0,2,0,0.0,0.0
1009,829,24-09-2019 15:16:00,1,2169.0,1604.0,0.739,10.322,2,1,1,0,1,0,1,0,0.0,0.0
1009,830,24-09-2019 15:18:00,1,1975.0,1569.0,0.794,9.518,2,0,0,0,2,0,2,0,0.0,0.0
1009,831,24-09-2019 15:20:00,1,1972.0,1495.0,0.758,9.425,4,2,1,1,2,0,2,0,0.0,0.0
1009,832,24-09-2019 15:22:00,1,1882.0,1414.0,0.751,8.982,1,0,0,0,1,0,1,0,0.0,0.0
1009,833,24-09-2019 15:24:00,1,1891.0,1409.0,0.745,9.01,0,0,0,0,0,0,0,0,0.0,0.0
1009,834,24-09-2019 15:26:00,1,1893.0,1408.0,0.744,9.016,0,0,0,0,0,0,0,0,0.0,0.0
1009,835,24-09-2019 15:28:00,1,1787.0,1399.0,0.783,8.589,4,2,0,2,2,0,2,1,0.0,0.0
1009,836,24-09-2019 15:30:00,1,1788.0,1353.0,0.756,8.544,63,38,25,13,25,2,23,6,0.0,0.0
1009,837,24-09-2019 15:32:00,1,1951.0,1608.0,0.825,9.466,0,0,0,0,0,0,0,0,0.0,0.0
1009,838,24-09-2019 15:34:00,1,2265.0,1711.0,0.755,10.819,3,1,1,0,2,0,2,1,0.0,0.0
1009,839,24-09-2019 15:36:00,1,2346.0,1809.0,0.771,11.245,100,55,32,23,45,9,36,6,0.0,0.0
1009,840,24-09-2019 15:38:00,1,2429.0,1928.0,0.794,11.704,171,91,67,24,80,36,44,49,0.0,0.0
1009,841,24-09-2019 15:40:00,1,2630.0,2046.0,0.779,12.628,104,63,36,27,41,4,37,54,0.0,0.0
1009,842,24-09-2019 15:42:00,1,2831.0,2164.0,0.764,13.552,99,56,26,30,43,2,41,55,0.0,0.0
1009,843,24-09-2019 15:44:00,1,3106.0,2460.0,0.792,14.96,71,29,12,17,42,2,40,46,0.0,0.0
1009,844,24-09-2019 15:46:00,1,3380.0,2668.0,0.789,16.272,90,45,14,31,45,0,45,56,0.0,0.0
1009,845,24-09-2019 15:48:00,1,3269.0,2642.0,0.808,15.805,120,77,41,36,43,14,29,42,0.0,0.06
1009,846,24-09-2019 15:50:00,1,2798.0,2245.0,0.803,13.509,479,295,231,64,184,128,56,58,0.0,0.05
1009,847,24-09-2019 15:52:00,1,2249.0,1757.0,0.781,10.808,629,409,329,80,220,152,68,22,0.0,0.0
1009,848,24-09-2019 15:54:00,1,2853.0,2472.0,0.867,13.977,192,95,67,28,97,60,37,28,0.11,0.0
1009,849,24-09-2019 15:56:00,1,1945.0,1625.0,0.836,9.461,24,22,1,21,2,0,2,1,0.0,0.0
1009,850,24-09-2019 15:58:00,1,1870.0,1490.0,0.797,9.019,53,51,22,29,2,0,2,0,0.0,0.0
1009,851,24-09-2019 16:00:00,1,2150.0,1710.0,0.796,10.363,6,6,1,5,0,0,0,0,0.0,0.0
1009,852,24-09-2019 16:02:00,1,2154.0,1729.0,0.803,10.401,33,27,10,17,6,0,6,0,0.0,0.0
1009,853,24-09-2019 16:04:00,1,2255.0,1795.0,0.796,10.874,1,1,0,1,0,0,0,0,0.0,0.0
1009,854,24-09-2019 16:06:00,1,2148.0,1724.0,0.803,10.371,0,0,0,0,0,0,0,0,0.0,0.0
1009,855,24-09-2019 16:08:00,1,2435.0,1933.0,0.794,11.734,9,6,4,2,3,1,2,0,0.0,0.0
1009,856,24-09-2019 16:10:00,1,2768.0,2371.0,0.856,13.532,6,6,0,6,0,0,0,0,0.0,0.0
1009,857,24-09-2019 16:12:00,1,2873.0,2416.0,0.841,13.995,5,5,0,5,0,0,0,0,0.0,0.0
1009,858,24-09-2019 16:14:00,1,2729.0,2328.5,0.854,13.3305,0,0,0,0,0,0,0,0,0.0,0.0
1009,859,24-09-2019 16:16:00,1,2585.0,2241.0,0.867,12.666,0,0,0,0,0,0,0,0,0.0,0.0
1009,860,24-09-2019 16:18:00,1,2593.0,2193.0,0.846,12.645,4,4,0,4,0,0,0,0,0.0,0.0
1009,861,24-09-2019 16:20:00,1,2480.0,2148.0,0.866,12.15,1,1,0,1,0,0,0,0,0.0,0.0
1009,862,24-09-2019 16:22:00,1,2494.0,2166.0,0.868,12.222,0,0,0,0,0,0,0,0,0.0,0.0
1009,863,24-09-2019 16:24:00,1,2384.0,2128.0,0.892,11.749,0,0,0,0,0,0,0,0,0.0,0.0
1009,864,24-09-2019 16:26:00,1,2389.0,2089.0,0.875,11.724,0,0,0,0,0,0,0,0,0.0,0.0
1009,865,24-09-2019 16:28:00,1,2393.0,2082.0,0.87,11.735,1,0,0,0,1,1,0,0,0.0,0.0
1009,866,24-09-2019 16:30:00,1,2403.0,2040.0,0.849,11.726,23,18,9,9,5,0,5,0,0.0,0.0
1009,867,24-09-2019 16:32:00,1,2390.0,2078.0,0.869,11.718,1,1,1,0,0,0,0,0,0.0,0.0
1009,868,24-09-2019 16:34:00,1,2395.0,2039.0,0.851,11.692,0,0,0,0,0,0,0,0,0.0,0.0
1009,869,24-09-2019 16:36:00,1,2420.0,2013.0,0.832,11.765,0,0,0,0,0,0,0,0,0.0,0.0
1009,870,24-09-2019 16:38:00,1,2421.0,1979.0,0.817,11.73,0,0,0,0,0,0,0,0,0.0,0.0
1009,871,24-09-2019 16:40:00,1,2315.0,1930.0,0.834,11.257,36,26,12,14,10,4,6,2,0.0,0.0
1009,872,24-09-2019 16:42:00,1,2397.0,2037.0,0.85,11.701,14,14,0,14,0,0,0,0,0.0,0.0
1009,873,24-09-2019 16:44:00,1,2310.0,1946.0,0.842,11.257,1,1,0,1,0,0,0,0,0.0,0.0
1009,874,24-09-2019 16:46:00,1,2208.0,1926.0,0.872,10.831,13,10,5,5,3,0,3,0,0.0,0.0
1009,875,24-09-2019 16:48:00,1,2216.5,1916.0,0.8645,10.853,1,1,0,1,0,0,0,0,0.0,0.0
1009,876,24-09-2019 16:50:00,1,2225.0,1906.0,0.857,10.875,3,2,0,2,1,0,1,0,0.0,0.0
1009,877,24-09-2019 16:52:00,1,2220.0,1876.0,0.845,10.825,1,0,0,0,1,0,1,0,0.0,0.0
1009,878,24-09-2019 16:54:00,1,2212.0,1884.0,0.852,10.799,0,0,0,0,0,0,0,0,0.0,0.0
1009,879,24-09-2019 16:56:00,1,2222.0,1862.0,0.838,10.816,14,13,5,8,1,0,1,0,0.0,0.0
1009,880,24-09-2019 16:58:00,1,2225.0,1836.0,0.825,10.798,2,0,0,0,2,0,2,0,0.0,0.0
1009,881,24-09-2019 17:00:00,1,2131.0,1811.0,0.85,10.403,6,2,1,1,4,0,4,0,0.0,0.0
1009,882,24-09-2019 17:02:00,1,2019.0,1796.0,0.889,9.942,21,0,0,0,21,0,21,0,0.0,0.0
1009,883,24-09-2019 17:04:00,1,2131.0,1816.0,0.852,10.407,47,29,8,21,18,3,15,0,0.0,0.0
1009,884,24-09-2019 17:06:00,1,2205.0,1935.0,0.878,10.828,13,13,0,13,0,0,0,0,0.0,0.0
1009,885,24-09-2019 17:08:00,1,2301.0,1963.0,0.853,11.238,68,49,17,32,19,2,17,4,0.0,0.0
1009,886,24-09-2019 17:10:00,1,2405.0,2033.0,0.845,11.725,46,44,16,28,2,1,1,0,0.0,0.0
1009,887,24-09-2019 17:12:00,1,2398.0,2108.0,0.879,11.782,114,85,54,31,29,8,21,20,0.0,0.0
1009,888,24-09-2019 17:14:00,1,2365.0,2154.0,0.911,11.704,168,97,75,22,71,51,20,95,0.0,0.0
1009,889,24-09-2019 17:16:00,1,2564.0,2309.0,0.901,12.658,72,38,26,12,34,10,24,5,0.0,0.0
1009,890,24-09-2019 17:18:00,1,2581.0,2192.0,0.849,12.597,70,42,23,19,28,0,28,2,0.0,0.0
1009,891,24-09-2019 17:20:00,1,2573.0,2274.0,0.884,12.654,66,44,18,26,22,3,19,3,0.0,0.0
1009,892,24-09-2019 17:22:00,1,2568.0,2294.5,0.8935,12.658,58,49,9,40,9,2,7,0,0.0,0.0
1009,893,24-09-2019 17:24:00,1,2563.0,2315.0,0.903,12.662,22,16,8,8,6,1,5,0,0.0,0.0
1009,894,24-09-2019 17:26:00,1,2592.0,2200.0,0.849,12.647,0,0,0,0,0,0,0,0,0.0,0.0
1009,895,24-09-2019 17:28:00,1,2391.0,2061.0,0.862,11.704,0,0,0,0,0,0,0,0,0.0,0.0
1009,896,24-09-2019 17:30:00,1,2419.0,1947.0,0.805,11.686,28,22,12,10,6,2,4,0,0.0,0.0
1009,897,24-09-2019 17:32:00,1,2218.0,1864.0,0.84,10.802,1,0,0,0,1,0,1,0,0.0,0.0
1009,898,24-09-2019 17:34:00,1,2213.0,1865.0,0.843,10.783,0,0,0,0,0,0,0,0,0.0,0.0
1009,899,24-09-2019 17:36:00,1,2246.0,1814.0,0.808,10.858,0,0,0,0,0,0,0,0,0.0,0.0
1009,900,24-09-2019 17:38:00,1,2222.0,1856.0,0.835,10.808,0,0,0,0,0,0,0,0,0.0,0.0
1009,901,24-09-2019 17:40:00,1,2235.0,1841.0,0.823,10.845,0,0,0,0,0,0,0,0,0.0,0.0
1009,902,24-09-2019 17:42:00,1,2238.0,1818.0,0.812,10.832,6,6,4,2,0,0,0,0,0.0,0.0
1009,903,24-09-2019 17:44:00,1,2251.0,1756.0,0.78,10.814,13,12,1,11,1,0,1,0,0.0,0.0
1009,904,24-09-2019 17:46:00,1,2258.0,1736.0,0.769,10.818,17,17,4,13,0,0,0,0,0.0,0.0
1009,905,24-09-2019 17:48:00,1,2264.0,1761.0,0.778,10.872,4,4,0,4,0,0,0,0,0.0,0.0
1009,906,24-09-2019 17:50:00,1,2248.0,1731.0,0.77,10.772,12,4,1,3,8,0,8,0,0.0,0.0
1009,907,24-09-2019 17:52:00,1,2254.0,1758.0,0.78,10.828,1,0,0,0,1,0,1,0,0.0,0.0
1009,908,24-09-2019 17:54:00,1,2245.0,1752.0,0.78,10.785,9,9,2,7,0,0,0,0,0.0,0.0
1009,909,24-09-2019 17:56:00,1,2245.5,1765.0,0.7855,10.802,3,2,0,2,1,0,1,0,0.0,0.0
1009,910,24-09-2019 17:58:00,1,2246.0,1778.0,0.791,10.819,93,70,36,34,23,5,18,0,0.0,0.0
1009,911,24-09-2019 18:00:00,0,2451.0,1853.0,0.756,11.708,41,29,13,16,12,1,11,0,0.0,0.0
1009,912,24-09-2019 18:02:00,0,2410.0,1981.0,0.822,11.687,223,171,126,45,52,21,31,45,0.0,0.0
1009,913,24-09-2019 18:04:00,0,2594.0,2154.0,0.83,12.607,94,47,21,26,47,0,47,70,0.0,0.0
1009,914,24-09-2019 18:06:00,0,2896.0,2321.0,0.802,13.979,96,54,25,29,42,2,40,71,0.0,0.01
1009,915,24-09-2019 18:08:00,0,3066.0,2535.0,0.827,14.887,131,80,43,37,51,6,45,68,0.0,0.0
1009,916,24-09-2019 18:10:00,0,3342.0,2789.0,0.835,16.256,240,134,102,32,106,54,52,59,0.1,0.13
1009,917,24-09-2019 18:12:00,0,2883.0,2381.0,0.826,13.994,372,205,170,35,167,129,38,121,0.0,0.0
1009,918,24-09-2019 18:14:00,0,2866.0,2375.0,0.829,13.92,200,102,73,29,98,58,40,97,0.0,0.0
1009,919,24-09-2019 18:16:00,0,1951.0,1604.0,0.822,9.461,128,111,69,42,17,4,13,16,0.0,0.0
1009,920,24-09-2019 18:18:00,0,1758.0,1455.0,0.828,8.537,140,123,70,53,17,1,16,3,0.0,0.0
1009,921,24-09-2019 18:20:00,0,1776.0,1419.0,0.799,8.567,85,58,30,28,27,8,19,1,0.0,0.0
1009,922,24-09-2019 18:22:00,0,2046.0,1644.0,0.803,9.881,93,72,40,32,21,9,12,10,0.0,0.0
1009,923,24-09-2019 18:24:00,0,3579.0,3206.0,0.896,17.649,213,105,74,31,108,83,25,53,0.01,0.01
1009,924,24-09-2019 18:26:00,0,3287.0,2996.0,0.911,16.266,224,107,72,35,117,78,39,79,0.06,0.0
1009,925,24-09-2019 18:28:00,0,3552.0,3276.0,0.922,17.621,296,143,101,42,153,109,44,66,0.0,0.0
1009,926,24-09-2019 18:30:00,0,2878.5,2605.5,0.9,14.226,70,45,22,23,25,17,8,23,0.0,0.0
1009,927,24-09-2019 18:32:00,0,2205.0,1935.0,0.878,10.831,13,7,4,3,6,1,5,2,0.0,0.0
1009,928,24-09-2019 18:34:00,0,2419.0,1964.0,0.812,11.705,213,2,1,1,211,180,31,0,0.0,0.0
1009,929,24-09-2019 18:36:00,0,3297.0,2889.0,0.876,16.189,245,3,0,3,242,215,27,0,0.0,0.0
1009,930,24-09-2019 18:38:00,0,3491.0,3035.0,0.869,17.114,16,5,2,3,11,5,6,0,0.0,0.0
1009,931,24-09-2019 18:40:00,0,3308.0,2949.0,0.891,16.298,121,12,8,4,109,96,13,0,0.0,0.01
1009,932,24-09-2019 18:42:00,0,2924.0,2657.0,0.909,14.461,23,1,0,1,22,18,4,0,0.0,0.0
1009,933,24-09-2019 18:44:00,0,2856.0,2460.0,0.861,13.975,29,4,0,4,25,21,4,0,0.0,0.0
1009,934,24-09-2019 18:46:00,0,2867.0,2477.0,0.864,14.038,348,115,79,36,233,187,46,28,0.0,0.0
1009,935,24-09-2019 18:48:00,0,2830.0,2605.0,0.92,14.035,110,58,31,27,52,7,45,84,0.0,0.0
1009,936,24-09-2019 18:50:00,0,3279.0,3024.0,0.922,16.265,92,47,20,27,45,0,45,66,0.0,0.0
1009,937,24-09-2019 18:52:00,0,3435.0,3207.0,0.934,17.086,113,66,39,27,47,4,43,65,0.0,0.16
1009,938,24-09-2019 18:54:00,0,3424.0,3313.0,0.968,17.157,84,46,24,22,38,0,38,69,0.0,0.02
1009,939,24-09-2019 18:56:00,0,3630.0,3393.0,0.935,18.057,192,100,72,28,92,56,36,25,0.23,0.1
1009,940,24-09-2019 18:58:00,0,2833.0,2596.0,0.916,14.036,217,118,88,30,99,69,30,50,0.0,0.0
1009,941,24-09-2019 19:00:00,0,2989.0,2854.0,0.955,14.936,57,27,17,10,30,15,15,43,0.0,0.0
1009,942,24-09-2019 19:02:00,0,2203.0,1933.0,0.878,10.819,40,26,9,17,14,1,13,8,0.0,0.0
1009,943,24-09-2019 19:04:00,0,2918.0,2677.0,0.91,14.461,115,52,35,17,63,41,22,31,0.0,0.02
1009,944,24-09-2019 19:06:00,0,3633.0,3421.0,0.942,18.103,264,118,89,29,146,107,39,57,0.0,0.0
1009,945,24-09-2019 19:08:00,0,2789.0,2686.0,0.963,13.962,65,41,24,17,24,8,16,0,0.0,0.0
1009,946,24-09-2019 19:10:00,0,2209.0,1938.0,0.877,10.848,18,0,0,0,18,0,18,0,0.0,0.0
1009,947,24-09-2019 19:12:00,0,1900.0,1793.0,0.944,9.472,1,1,0,1,0,0,0,0,0.0,0.0
1009,948,24-09-2019 19:14:00,0,1918.0,1753.0,0.914,9.498,22,15,4,11,7,1,6,0,0.0,0.0
1009,949,24-09-2019 19:16:00,0,1909.0,1759.0,0.921,9.47,21,13,1,12,8,5,3,0,0.0,0.0
1009,950,24-09-2019 19:18:00,0,2570.0,2293.0,0.892,12.666,15,6,0,6,9,3,6,0,0.0,0.0
1009,951,24-09-2019 19:20:00,0,2842.0,2558.0,0.9,14.029,37,14,10,4,23,3,20,0,0.0,0.01
1009,952,24-09-2019 19:22:00,0,2989.0,2804.0,0.938,14.881,2,0,0,0,2,0,2,0,0.0,0.0
1009,953,24-09-2019 19:24:00,0,2813.0,2593.0,0.922,13.955,21,14,5,9,7,1,6,0,0.0,0.0
1009,954,24-09-2019 19:26:00,0,3412.0,3297.0,0.966,17.092,103,57,38,19,46,9,37,63,0.0,0.0
1009,955,24-09-2019 19:28:00,0,3580.0,3576.0,0.999,18.063,77,41,21,20,36,2,34,77,0.0,0.11
1009,956,24-09-2019 19:30:00,0,3897.0,3731.0,0.957,19.485,70,25,16,9,45,27,18,22,0.22,0.08
1009,957,24-09-2019 19:32:00,0,3610.0,3480.0,0.964,18.077,286,178,130,48,108,72,36,45,0.05,0.02
1009,958,24-09-2019 19:34:00,0,2981.0,2883.0,0.967,14.938,89,62,29,33,27,6,21,3,0.0,0.0
1009,959,24-09-2019 19:36:00,0,2191.0,1958.0,0.894,10.802,32,27,8,19,5,0,5,2,0.0,0.0
1009,960,24-09-2019 19:38:00,0,2328.5,2088.0,0.8965,11.488,34,24,3,21,10,0,10,0,0.0,0.0
1009,961,24-09-2019 19:40:00,0,2466.0,2218.0,0.899,12.174,44,30,11,19,14,0,14,0,0.0,0.0
1009,962,24-09-2019 19:42:00,0,2914.0,2679.0,0.919,14.447,156,69,41,28,87,59,28,19,0.0,0.01
1009,963,24-09-2019 19:44:00,0,3848.0,3885.0,1.01,19.462,253,152,117,35,101,70,31,99,0.0,0.0
1009,964,24-09-2019 19:46:00,0,3255.0,3047.0,0.936,16.196,138,75,47,28,63,39,24,99,0.01,0.0
1009,965,24-09-2019 19:48:00,0,3430.0,3324.0,0.969,17.194,29,26,11,15,3,3,0,4,0.0,0.0
1009,966,24-09-2019 19:50:00,0,3244.0,3169.0,0.977,16.289,0,0,0,0,0,0,0,0,0.0,0.0
1009,967,24-09-2019 19:52:00,0,3457.0,3232.0,0.935,17.199,0,0,0,0,0,0,0,0,0.0,0.0
1009,968,24-09-2019 19:54:00,0,3513.0,3451.0,0.982,17.662,0,0,0,0,0,0,0,0,0.0,0.0
1009,969,24-09-2019 19:56:00,0,3392.0,3415.0,1.007,17.146,3,2,1,1,1,1,0,0,0.0,0.0
1009,970,24-09-2019 19:58:00,0,3403.0,3364.0,0.988,17.132,0,0,0,0,0,0,0,0,0.0,0.0
1009,971,24-09-2019 20:00:00,0,3443.0,3276.0,0.951,17.193,7,5,1,4,2,0,2,0,0.0,0.0
1009,972,24-09-2019 20:02:00,0,3252.0,3189.0,0.981,16.345,14,1,0,1,13,0,13,0,0.0,0.0
1009,973,24-09-2019 20:04:00,0,3154.0,3064.0,0.972,15.817,7,0,0,0,7,0,7,0,0.0,0.0
1009,974,24-09-2019 20:06:00,0,2962.0,2956.0,0.998,14.944,3,1,1,0,2,0,2,0,0.0,0.0
1009,975,24-09-2019 20:08:00,0,2890.0,2804.0,0.97,14.49,71,43,28,15,28,9,19,23,0.0,0.28
1009,976,24-09-2019 20:10:00,0,3232.0,3147.0,0.974,16.216,0,0,0,0,0,0,0,0,0.01,0.01
1009,977,24-09-2019 20:12:00,0,3225.5,3186.5,0.988,16.236,1,1,0,1,0,0,0,0,0.0,0.0
1009,978,24-09-2019 20:14:00,0,3219.0,3226.0,1.002,16.256,74,34,18,16,40,28,12,3,0.0,0.0
1009,979,24-09-2019 20:16:00,0,2945.0,2953.0,1.003,14.873,290,167,125,42,123,90,33,48,0.03,0.0
1009,980,24-09-2019 20:18:00,0,2816.0,2629.0,0.934,14.006,221,116,84,32,105,72,33,54,0.05,0.0
1009,981,24-09-2019 20:20:00,0,3438.0,3287.0,0.956,17.186,167,107,76,31,60,31,29,15,0.0,0.0
1009,982,24-09-2019 20:22:00,0,2376.0,2162.0,0.91,11.755,81,54,31,23,27,10,17,36,0.0,0.0
1009,983,24-09-2019 20:24:00,0,2797.0,2702.0,0.966,14.01,58,42,18,24,16,7,9,22,0.0,0.0
1009,984,24-09-2019 20:26:00,0,3411.0,3391.0,0.994,17.194,104,77,38,39,27,4,23,35,0.0,0.0
1009,985,24-09-2019 20:28:00,0,3581.0,3574.0,0.998,18.066,175,84,66,18,91,62,29,34,0.17,0.0
1009,986,24-09-2019 20:30:00,0,3227.0,3216.0,0.997,16.275,309,157,117,40,152,109,43,50,0.0,0.0
1009,987,24-09-2019 20:32:00,0,3605.0,3486.0,0.967,18.062,199,106,71,35,93,65,28,8,0.0,0.03
1009,988,24-09-2019 20:34:00,0,3412.0,3337.0,0.978,17.138,55,37,23,14,18,5,13,19,0.0,0.0
1009,989,24-09-2019 20:36:00,0,2986.0,2849.0,0.954,14.921,5,4,3,1,1,1,0,0,0.0,0.0
1009,990,24-09-2019 20:38:00,0,3250.0,3115.0,0.958,16.255,1,1,1,0,0,0,0,0,0.0,0.0
1009,991,24-09-2019 20:40:00,0,3258.0,3094.0,0.95,16.262,1,1,0,1,0,0,0,0,0.0,0.0
1009,992,24-09-2019 20:42:00,0,3155.0,3039.0,0.963,15.793,9,8,3,5,1,1,0,0,0.0,0.0
1009,993,24-09-2019 20:44:00,0,2978.0,2919.0,0.98,14.965,0,0,0,0,0,0,0,0,0.0,0.0
1009,994,24-09-2019 20:46:00,0,2885.0,2799.0,0.97,14.465,1,1,0,1,0,0,0,0,0.0,0.0
1009,995,24-09-2019 20:48:00,0,2792.0,2679.0,0.96,13.965,122,93,63,30,29,5,24,25,0.0,0.0
1009,996,24-09-2019 20:50:00,0,2769.0,2782.0,1.005,13.989,97,50,27,23,47,17,30,58,0.0,0.0
1009,997,24-09-2019 20:52:00,0,3497.0,3498.0,1.0,17.651,186,94,63,31,92,61,31,29,0.0,0.03
1009,998,24-09-2019 20:54:00,0,2795.0,2727.0,0.976,14.031,178,98,68,30,80,46,34,68,0.06,0.0
1009,999,24-09-2019 20:56:00,0,3155.0,3048.0,0.966,15.803,95,82,44,38,13,5,8,23,0.0,0.0
1009,1000,24-09-2019 20:58:00,0,2535.0,2391.0,0.943,12.635,105,60,29,31,45,18,27,5,0.0,0.0
1009,1001,24-09-2019 21:00:00,0,2725.0,2556.0,0.938,13.566,289,152,114,38,137,103,34,80,0.0,0.0
1009,1002,24-09-2019 21:02:00,0,3417.0,3300.0,0.966,17.117,162,87,42,45,75,33,42,55,0.0,0.07
1009,1003,24-09-2019 21:04:00,0,3454.0,3220.0,0.932,17.172,112,72,28,44,40,4,36,50,0.0,0.0
1009,1004,24-09-2019 21:06:00,0,3450.0,3266.0,0.947,17.208,91,38,8,30,53,0,53,66,0.0,0.0
1009,1005,24-09-2019 21:08:00,0,3526.0,3404.0,0.965,17.66,135,71,45,26,64,6,58,65,0.0,0.0
1009,1006,24-09-2019 21:10:00,0,3891.0,3717.0,0.955,19.444,127,71,40,31,56,0,56,58,0.0,0.0
1009,1007,24-09-2019 21:12:00,0,4249.0,4085.0,0.961,21.262,91,49,23,26,42,0,42,46,0.0,0.07
1009,1008,24-09-2019 21:14:00,0,4015.0,4027.0,1.003,20.275,116,57,31,26,59,22,37,36,0.13,0.06
1009,1009,24-09-2019 21:16:00,0,3853.0,3880.0,1.007,19.477,346,178,132,46,168,124,44,75,0.0,0.02
1009,1010,24-09-2019 21:18:00,0,2973.0,2889.0,0.972,14.914,189,120,93,27,69,39,30,22,0.0,0.0
1009,1011,24-09-2019 21:20:00,0,3421.0,3348.0,0.978,17.1865,212,99,77,22,113,89,24,53,0.02,0.0
1009,1012,24-09-2019 21:22:00,0,3869.0,3807.0,0.984,19.459,113,85,62,23,28,12,16,10,0.0,0.0
1009,1013,24-09-2019 21:24:00,0,2960.0,2935.0,0.992,14.91,9,7,6,1,2,1,1,0,0.0,0.0
1009,1014,24-09-2019 21:26:00,0,2881.0,2798.0,0.971,14.447,0,0,0,0,0,0,0,0,0.0,0.0
1009,1015,24-09-2019 21:28:00,0,2805.0,2609.0,0.93,13.941,16,11,7,4,5,2,3,0,0.0,0.0
1009,1016,24-09-2019 21:30:00,0,2508.0,2475.0,0.987,12.62,4,3,1,2,1,1,0,0,0.0,0.0
1009,1017,24-09-2019 21:32:00,0,2346.0,2265.0,0.965,11.75,6,6,2,4,0,0,0,0,0.0,0.0
1009,1018,24-09-2019 21:34:00,0,2384.0,2165.0,0.908,11.79,0,0,0,0,0,0,0,0,0.01,0.01
1009,1019,24-09-2019 21:36:00,0,2456.0,2326.0,0.947,12.254,35,21,11,10,14,3,11,0,0.0,0.0
1009,1020,24-09-2019 21:38:00,0,2565.0,2327.0,0.907,12.682,89,69,36,33,20,0,20,0,0.0,0.0
1009,1021,24-09-2019 21:40:00,0,2356.0,2256.0,0.958,11.781,92,77,33,44,15,0,15,2,0.0,0.0
1009,1022,24-09-2019 21:42:00,0,2807.0,2659.0,0.947,14.003,85,67,47,20,18,3,15,7,0.0,0.0
1009,1023,24-09-2019 21:44:00,0,3448.0,3301.0,0.957,17.24,110,56,17,39,54,0,54,73,0.0,0.0
1009,1024,24-09-2019 21:46:00,0,3846.0,3816.0,0.992,19.376,104,61,35,26,43,2,41,65,0.0,0.0
1009,1025,24-09-2019 21:48:00,0,4032.0,3984.0,0.988,20.298,137,93,50,43,44,4,40,51,0.0,0.05
1009,1026,24-09-2019 21:50:00,0,4332.0,4213.0,0.973,21.731,99,69,37,32,30,0,30,47,0.0,0.12
1009,1027,24-09-2019 21:52:00,0,4051.0,4028.0,0.994,20.419,157,81,55,26,76,33,43,29,0.28,0.04
1009,1028,24-09-2019 21:54:00,0,3825.5,3824.5,1.0,19.305,269,139,103,36,130,90,40,29,0.0,0.05
1009,1029,24-09-2019 21:56:00,0,3600.0,3621.0,1.006,18.191,309,149,103,46,160,121,39,108,0.0,0.0
1009,1030,24-09-2019 21:58:00,0,4073.0,3895.0,0.956,20.36,100,54,27,27,46,3,43,73,0.0,0.0
1009,1031,24-09-2019 22:00:00,0,4321.0,4200.0,0.972,21.673,94,53,32,21,41,0,41,57,0.0,0.1
1009,1032,24-09-2019 22:02:00,0,3977.0,3853.0,0.969,19.934,150,116,73,43,34,7,27,17,0.0,0.02
1009,1033,24-09-2019 22:04:00,0,2776.0,2735.0,0.985,13.964,132,69,49,20,63,35,28,9,0.04,0.0
1009,1034,24-09-2019 22:06:00,0,2988.0,2821.0,0.944,14.898,6,6,4,2,0,0,0,0,0.0,0.0
1009,1035,24-09-2019 22:08:00,0,2819.0,2626.0,0.932,14.015,1,0,0,0,1,1,0,0,0.0,0.0
1009,1036,24-09-2019 22:10:00,0,2727.0,2565.0,0.941,13.585,0,0,0,0,0,0,0,0,0.0,0.0
1009,1037,24-09-2019 22:12:00,0,2528.0,2439.0,0.965,12.661,4,4,3,1,0,0,0,0,0.0,0.0
1009,1038,24-09-2019 22:14:00,0,2831.0,2642.0,0.933,14.079,10,10,4,6,0,0,0,1,0.0,0.0
1009,1039,24-09-2019 22:16:00,0,2801.0,2657.0,0.949,13.979,9,6,2,4,3,1,2,0,0.0,0.0
1009,1040,24-09-2019 22:18:00,0,2812.0,2654.0,0.944,14.018,1,1,0,1,0,0,0,0,0.0,0.0
1009,1041,24-09-2019 22:20:00,0,2800.0,2658.0,0.949,13.974,0,0,0,0,0,0,0,0,0.0,0.0
1009,1042,24-09-2019 22:22:00,0,2805.0,2667.0,0.951,14.003,0,0,0,0,0,0,0,0,0.0,0.0
1009,1043,24-09-2019 22:24:00,0,2820.0,2571.0,0.912,13.956,21,15,9,6,6,0,6,0,0.0,0.0
1009,1044,24-09-2019 22:26:00,0,2822.0,2595.0,0.919,13.991,1,0,0,0,1,0,1,0,0.0,0.0
1009,1045,24-09-2019 22:28:00,0,2671.0,2538.0,0.952,13.334,13,3,1,2,10,0,10,0,0.0,0.0
1009,1046,24-09-2019 22:30:00,0,2520.0,2481.0,0.985,12.677,13,7,0,7,6,0,6,0,0.0,0.0
1009,1047,24-09-2019 22:32:00,0,2523.0,2477.0,0.982,12.683,458,316,236,80,142,95,47,27,0.02,0.08
1009,1048,24-09-2019 22:34:00,0,3433.0,3313.0,0.965,17.193,228,157,118,39,71,42,29,66,0.0,0.0
1009,1049,24-09-2019 22:36:00,0,3493.0,3494.0,1.0,17.629,254,132,90,42,122,79,43,72,0.0,0.0
1009,1050,24-09-2019 22:38:00,0,3573.0,3644.0,1.02,18.111,133,89,50,39,44,4,40,63,0.0,0.03
1009,1051,24-09-2019 22:40:00,0,3779.0,3713.0,0.983,18.998,101,46,30,16,55,20,35,58,0.18,0.02
1009,1052,24-09-2019 22:42:00,0,3404.0,3374.0,0.991,17.148,152,88,60,28,64,37,27,14,0.0,0.0
1009,1053,24-09-2019 22:44:00,0,2361.0,2232.0,0.945,11.774,117,86,49,37,31,3,28,17,0.0,0.0
1009,1054,24-09-2019 22:46:00,0,3004.0,2760.0,0.919,14.892,246,148,107,41,98,69,29,57,0.0,0.01
1009,1055,24-09-2019 22:48:00,0,3603.0,3478.0,0.965,18.044,205,81,62,19,124,94,30,39,0.0,0.02
1009,1056,24-09-2019 22:50:00,0,3239.0,3162.0,0.976,16.264,131,87,55,32,44,19,25,10,0.0,0.0
1009,1057,24-09-2019 22:52:00,0,3154.0,3089.0,0.979,15.846,199,119,85,34,80,56,24,31,0.0,0.0
1009,1058,24-09-2019 22:54:00,0,3226.0,3202.0,0.992,16.254,493,348,279,69,145,99,46,57,0.0,0.05
1009,1059,24-09-2019 22:56:00,0,4034.0,4019.0,0.996,20.342,327,200,159,41,127,94,33,25,0.0,0.0
1009,1060,24-09-2019 22:58:00,0,4031.0,4011.0,0.995,20.323,168,73,55,18,95,59,36,9,0.0,0.0
1009,1061,24-09-2019 23:00:00,0,3141.0,3093.0,0.985,15.8,59,41,28,13,18,5,13,46,0.0,0.0
1009,1062,24-09-2019 23:02:00,0,3360.5,3347.0,0.9955,16.946,88,42,27,15,46,9,37,55,0.0,0.0
1009,1063,24-09-2019 23:04:00,0,3580.0,3601.0,1.006,18.092,99,52,20,32,47,2,45,47,0.0,0.03
1009,1064,24-09-2019 23:06:00,0,3873.0,3773.0,0.974,19.436,86,37,17,20,49,0,49,46,0.0,0.0
1009,1065,24-09-2019 23:08:00,0,4037.0,4012.0,0.994,20.348,150,49,33,16,101,68,33,25,0.08,0.11
1009,1066,24-09-2019 23:10:00,0,3842.0,3783.0,0.985,19.327,250,132,98,34,118,81,37,72,0.05,0.0
1009,1067,24-09-2019 23:12:00,0,3408.0,3451.0,1.012,17.248,109,90,60,30,19,4,15,5,0.01,0.0
1009,1068,24-09-2019 23:14:00,0,2876.0,2812.0,0.978,14.446,57,39,18,21,18,5,13,3,0.0,0.01
1009,1069,24-09-2019 23:16:00,0,2984.0,2855.0,0.957,14.918,258,150,101,49,108,81,27,18,0.02,0.0
1009,1070,24-09-2019 23:18:00,0,3506.0,3406.0,0.971,17.585,136,66,45,21,70,46,24,26,0.0,0.01
1009,1071,24-09-2019 23:20:00,0,2966.0,2928.0,0.987,14.93,202,90,59,31,112,76,36,5,0.0,0.0
1009,1072,24-09-2019 23:22:00,0,3007.0,2823.0,0.939,14.972,606,423,329,94,183,137,46,19,0.0,0.0
1009,1073,24-09-2019 23:24:00,0,3604.0,3468.0,0.962,18.038,645,412,335,77,233,171,62,15,0.19,0.0
1009,1074,24-09-2019 23:26:00,0,3870.0,3769.0,0.974,19.42,361,231,173,58,130,79,51,57,0.0,0.0
1009,1075,24-09-2019 23:28:00,0,4042.0,4023.0,0.995,20.379,114,72,39,33,42,0,42,71,0.0,0.04
1009,1076,24-09-2019 23:30:00,0,3958.0,3890.0,0.983,19.899,95,34,17,17,61,25,36,42,0.0,0.09
1009,1077,24-09-2019 23:32:00,0,3587.0,3604.0,1.005,18.122,139,81,51,30,58,34,24,12,0.0,0.02
1009,1078,24-09-2019 23:34:00,0,2531.0,2479.0,0.98,12.715,49,36,18,18,13,2,11,0,0.0,0.0
1009,1079,24-09-2019 23:36:00,0,2441.0,2339.0,0.9575,12.205,47,39,15,24,8,1,7,0,0.0,0.0
1009,1080,24-09-2019 23:38:00,0,2351.0,2199.0,0.935,11.695,22,6,0,6,16,0,16,0,0.0,0.0
1009,1081,24-09-2019 23:40:00,0,2546.0,2342.0,0.92,12.625,42,33,10,23,9,0,9,0,0.0,0.0
1009,1082,24-09-2019 23:42:00,0,2641.0,2442.0,0.925,13.11,1,0,0,0,1,0,1,0,0.0,0.01
1009,1083,24-09-2019 23:44:00,0,3173.0,2998.0,0.945,15.821,1,0,0,0,1,0,1,0,0.0,0.0
1009,1084,24-09-2019 23:46:00,0,3059.0,2974.0,0.972,15.344,0,0,0,0,0,0,0,0,0.0,0.0
1009,1085,24-09-2019 23:48:00,0,2975.0,2859.0,0.961,14.887,185,154,120,34,31,7,24,3,0.0,0.0
1009,1086,24-09-2019 23:50:00,0,2971.0,2922.0,0.984,14.942,557,387,312,75,170,124,46,36,0.0,0.0
1009,1087,24-09-2019 23:52:00,0,3590.0,3624.0,1.01,18.155,489,432,353,79,57,21,36,62,0.0,0.0
1009,1088,24-09-2019 23:54:00,0,4041.0,3980.0,0.985,20.327,214,121,89,32,93,67,26,37,0.0,0.0
1009,1089,24-09-2019 23:56:00,0,3670.0,3719.0,1.013,18.577,450,333,270,63,117,77,40,26,0.0,0.02
1009,1090,24-09-2019 23:58:00,0,3594.0,3557.0,0.99,18.097,77,39,21,18,38,0,38,76,0.0,0.04
1009,1091,25-09-2019 00:00:00,0,4033.0,4019.0,0.996,20.341,65,29,15,14,36,0,36,77,0.0,0.04
1009,1092,25-09-2019 00:02:00,0,4022.0,4049.0,1.007,20.329,247,123,93,30,124,84,40,44,0.07,0.05
1009,1093,25-09-2019 00:04:00,0,3239.0,3187.0,0.984,16.291,647,429,360,69,218,169,49,51,0.01,0.0
1009,1094,25-09-2019 00:06:00,0,4040.0,3954.0,0.979,20.295,264,123,86,37,141,91,50,19,0.0,0.09
1009,1095,25-09-2019 00:08:00,0,4232.0,4161.0,0.983,21.28,291,135,97,38,156,121,35,82,0.01,0.0
1009,1096,25-09-2019 00:10:00,0,3507.0,3483.0,0.9955,17.6735,148,106,73,33,42,18,24,5,0.0,0.0
1009,1097,25-09-2019 00:12:00,0,2782.0,2805.0,1.008,14.067,447,290,228,62,157,113,44,24,0.0,0.0
1009,1098,25-09-2019 00:14:00,0,3410.0,3377.0,0.99,17.174,143,82,58,24,61,44,17,39,0.0,0.0
1009,1099,25-09-2019 00:16:00,0,2794.0,2742.0,0.981,14.044,32,29,8,21,3,0,3,5,0.0,0.0
1009,1100,25-09-2019 00:18:00,0,2798.0,2624.0,0.938,13.93,31,31,3,28,0,0,0,0,0.0,0.0
1009,1101,25-09-2019 00:20:00,0,2776.0,2735.0,0.985,13.964,38,35,11,24,3,0,3,1,0.0,0.0
1009,1102,25-09-2019 00:22:00,0,3601.0,3522.0,0.978,18.088,16,14,1,13,2,1,1,0,0.0,0.0
1009,1103,25-09-2019 00:24:00,0,3856.0,3852.0,0.999,19.456,1,1,0,1,0,0,0,0,0.0,0.0
1009,1104,25-09-2019 00:26:00,0,3597.0,3574.0,0.993,18.13,0,0,0,0,0,0,0,0,0.0,0.0
1009,1105,25-09-2019 00:28:00,0,3447.0,3264.0,0.947,17.196,0,0,0,0,0,0,0,0,0.02,0.0
1009,1106,25-09-2019 00:30:00,0,3163.0,3046.0,0.963,15.835,9,8,1,7,1,0,1,0,0.0,0.0
1009,1107,25-09-2019 00:32:00,0,2977.0,2929.0,0.984,14.972,28,26,5,21,2,1,1,0,0.0,0.0
1009,1108,25-09-2019 00:34:00,0,2982.0,2878.0,0.965,14.936,4,4,0,4,0,0,0,0,0.0,0.0
1009,1109,25-09-2019 00:36:00,0,2803.0,2701.0,0.964,14.033,0,0,0,0,0,0,0,0,0.0,0.0
1009,1110,25-09-2019 00:38:00,0,2607.0,2533.0,0.972,13.076,2,1,0,1,1,0,1,0,0.0,0.0
1009,1111,25-09-2019 00:40:00,0,2537.0,2406.0,0.949,12.658,7,5,0,5,2,1,1,0,0.0,0.0
1009,1112,25-09-2019 00:42:00,0,2424.0,2348.0,0.969,12.152,2,1,0,1,1,0,1,0,0.0,0.0
1009,1113,25-09-2019 00:44:00,0,2430.0,2355.5,0.9695,12.1835,12,9,1,8,3,0,3,0,0.0,0.0
1009,1114,25-09-2019 00:46:00,0,2436.0,2363.0,0.97,12.215,4,2,0,2,2,0,2,0,0.0,0.0
1009,1115,25-09-2019 00:48:00,0,2329.0,2317.0,0.995,11.741,6,6,0,6,0,0,0,0,0.0,0.0
1009,1116,25-09-2019 00:50:00,0,2326.0,2355.0,1.012,11.772,46,31,13,18,15,2,13,0,0.0,0.0
1009,1117,25-09-2019 00:52:00,0,2510.0,2516.0,1.002,12.675,321,211,172,39,110,74,36,22,0.0,0.0
1009,1118,25-09-2019 00:54:00,0,2771.0,2827.0,1.02,14.047,286,163,120,43,123,89,34,102,0.0,0.0
1009,1119,25-09-2019 00:56:00,0,2871.0,2868.0,0.999,14.488,70,39,25,14,31,7,24,64,0.0,0.0
1009,1120,25-09-2019 00:58:00,0,3216.0,3178.0,0.988,16.188,45,8,4,4,37,0,37,63,0.0,0.32
1009,1121,25-09-2019 01:00:00,0,3305.0,3270.0,0.989,16.643,89,43,34,9,46,33,13,5,0.0,0.0
1009,1122,25-09-2019 01:02:00,0,2962.0,2876.0,0.971,14.854,45,33,24,9,12,4,8,9,0.0,0.0
1009,1123,25-09-2019 01:04:00,0,2614.0,2573.0,0.984,13.149,16,11,5,6,5,0,5,0,0.0,0.02
1009,1124,25-09-2019 01:06:00,0,2356.0,2253.0,0.956,11.779,3,3,0,3,0,0,0,0,0.0,0.0
1009,1125,25-09-2019 01:08:00,0,2613.0,2563.0,0.981,13.132,19,14,3,11,5,0,5,0,0.0,0.0
1009,1126,25-09-2019 01:10:00,0,3258.0,3144.0,0.965,16.317,3,3,2,1,0,0,0,0,0.0,0.0
1009,1127,25-09-2019 01:12:00,0,3155.0,3109.0,0.985,15.872,46,36,26,10,10,2,8,4,0.0,0.0
1009,1128,25-09-2019 01:14:00,0,2943.0,2992.0,1.017,14.907,158,98,60,38,60,36,24,31,0.05,0.0
1009,1129,25-09-2019 01:16:00,0,2925.0,3005.0,1.028,14.85,62,27,13,14,35,25,10,5,0.17,0.0
1009,1130,25-09-2019 01:18:00,0,3089.5,3072.0,0.9965,15.5735,367,247,182,65,120,79,41,31,0.0,0.0
1009,1131,25-09-2019 01:20:00,0,3254.0,3139.0,0.965,16.297,474,280,240,40,194,148,46,55,0.0,0.0
1009,1132,25-09-2019 01:22:00,0,3221.0,3256.0,1.011,16.295,40,16,2,14,24,2,22,20,0.0,0.0
1009,1133,25-09-2019 01:24:00,0,3419.0,3331.0,0.974,17.159,51,26,9,17,25,2,23,5,0.0,0.0
1009,1134,25-09-2019 01:26:00,0,3430.0,3369.0,0.982,17.242,60,35,21,14,25,0,25,2,0.0,0.0
1009,1135,25-09-2019 01:28:00,0,3336.0,3237.0,0.97,16.727,0,0,0,0,0,0,0,0,0.0,0.0
1009,1136,25-09-2019 01:30:00,0,3046.0,3003.0,0.986,15.324,3,2,1,1,1,0,1,0,0.0,0.0
1009,1137,25-09-2019 01:32:00,0,2971.0,2850.0,0.959,14.862,19,19,0,19,0,0,0,0,0.0,0.0
1009,1138,25-09-2019 01:34:00,0,2767.0,2765.0,0.999,13.964,26,16,7,9,10,0,10,1,0.0,0.0
1009,1139,25-09-2019 01:36:00,0,2873.0,2798.0,0.974,14.416,94,71,51,20,23,10,13,6,0.0,0.0
1009,1140,25-09-2019 01:38:00,0,2957.0,2912.0,0.985,14.875,101,76,49,27,25,10,15,4,0.0,0.0
1009,1141,25-09-2019 01:40:00,0,3257.0,3112.0,0.955,16.28,517,413,339,74,104,61,43,26,0.0,0.0
1009,1142,25-09-2019 01:42:00,0,3453.0,3265.0,0.946,17.218,336,169,128,41,167,116,51,56,0.1,0.0
1009,1143,25-09-2019 01:44:00,0,3336.0,3268.0,0.98,16.76,611,338,256,82,273,197,76,16,0.06,0.0
1009,1144,25-09-2019 01:46:00,0,3223.0,3236.0,1.004,16.28,140,67,41,26,73,49,24,9,0.01,0.0
1009,1145,25-09-2019 01:48:00,0,3436.0,3298.0,0.96,17.189,506,356,285,71,150,99,51,30,0.0,0.01
1009,1146,25-09-2019 01:50:00,0,3225.0,3232.0,1.002,16.283,558,372,302,70,186,139,47,52,0.0,0.0
1009,1147,25-09-2019 01:52:00,0,3328.5,3259.5,0.98,16.7215,54,42,15,27,12,3,9,7,0.0,0.0
1009,1148,25-09-2019 01:54:00,0,3432.0,3287.0,0.958,17.16,13,11,2,9,2,2,0,0,0.0,0.0
1009,1149,25-09-2019 01:56:00,0,3438.0,3275.0,0.953,17.17,259,190,150,40,69,39,30,26,0.01,0.0
1009,1150,25-09-2019 01:58:00,0,3238.0,3196.0,0.987,16.294,43,18,13,5,25,3,22,6,0.0,0.0
1009,1151,25-09-2019 02:00:00,0,3347.0,3226.0,0.964,16.758,62,25,6,19,37,5,32,1,0.0,0.0
1009,1152,25-09-2019 02:02:00,0,3225.0,3194.0,0.99,16.244,72,67,27,40,5,2,3,14,0.0,0.0
1009,1153,25-09-2019 02:04:00,0,3236.0,3185.0,0.984,16.274,21,9,0,9,12,0,12,1,0.0,0.0
1009,1154,25-09-2019 02:06:00,0,3239.0,3150.0,0.972,16.25,58,51,27,24,7,2,5,4,0.0,0.0
1009,1155,25-09-2019 02:08:00,0,3264.0,3114.0,0.954,16.307,8,1,1,0,7,0,7,0,0.0,0.0
1009,1156,25-09-2019 02:10:00,0,3256.0,3077.0,0.945,16.235,2,0,0,0,2,0,2,0,0.0,0.0
1009,1157,25-09-2019 02:12:00,0,2974.0,2927.0,0.984,14.959,0,0,0,0,0,0,0,0,0.0,0.0
1009,1158,25-09-2019 02:14:00,0,2785.0,2703.0,0.971,13.965,14,4,1,3,10,0,10,0,0.0,0.0
1009,1159,25-09-2019 02:16:00,0,2721.0,2569.0,0.944,13.566,2,2,1,1,0,0,0,0,0.0,0.0
1009,1160,25-09-2019 02:18:00,0,2508.0,2504.0,0.998,12.656,23,20,1,19,3,0,3,0,0.0,0.0
1009,1161,25-09-2019 02:20:00,0,2513.0,2457.0,0.977,12.622,3,1,0,1,2,0,2,0,0.0,0.0
1009,1162,25-09-2019 02:22:00,0,2548.0,2377.0,0.933,12.672,20,18,10,8,2,0,2,0,0.0,0.0
1009,1163,25-09-2019 02:24:00,0,2556.0,2369.0,0.927,12.694,17,14,3,11,3,0,3,0,0.0,0.0
1009,1164,25-09-2019 02:26:00,0,2545.0,2376.0,0.934,12.6575,11,6,2,4,5,0,5,0,0.0,0.0
1009,1165,25-09-2019 02:28:00,0,2534.0,2383.0,0.941,12.621,0,0,0,0,0,0,0,0,0.0,0.0
1009,1166,25-09-2019 02:30:00,0,2335.0,2342.0,1.003,11.793,0,0,0,0,0,0,0,0,0.0,0.0
1009,1167,25-09-2019 02:32:00,0,2333.0,2295.0,0.984,11.732,1,0,0,0,1,0,1,0,0.0,0.0
1009,1168,25-09-2019 02:34:00,0,2342.0,2284.0,0.975,11.758,0,0,0,0,0,0,0,0,0.0,0.0
1009,1169,25-09-2019 02:36:00,0,2325.0,2328.0,1.001,11.739,2,1,1,0,1,0,1,0,0.0,0.0
1009,1170,25-09-2019 02:38:00,0,2330.0,2355.0,1.011,11.789,2,0,0,0,2,0,2,0,0.0,0.0
1009,1171,25-09-2019 02:40:00,0,2330.0,2347.0,1.008,11.779,0,0,0,0,0,0,0,0,0.0,0.0
1009,1172,25-09-2019 02:42:00,0,2436.0,2346.0,0.963,12.195,57,44,22,22,13,4,9,3,0.0,0.0
1009,1173,25-09-2019 02:44:00,0,2523.0,2480.0,0.983,12.684,54,40,19,21,14,0,14,5,0.0,0.0
1009,1174,25-09-2019 02:46:00,0,2706.0,2608.0,0.964,13.55,31,9,4,5,22,0,22,2,0.0,0.0
1009,1175,25-09-2019 02:48:00,0,2789.0,2703.0,0.969,13.98,52,49,24,25,3,0,3,2,0.0,0.0
1009,1176,25-09-2019 02:50:00,0,2783.0,2729.0,0.981,13.987,6,6,0,6,0,0,0,0,0.0,0.0
1009,1177,25-09-2019 02:52:00,0,2815.0,2666.0,0.947,14.041,7,7,0,7,0,0,0,0,0.0,0.0
1009,1178,25-09-2019 02:54:00,0,2602.0,2574.0,0.989,13.102,9,8,1,7,1,0,1,0,0.0,0.0
1009,1179,25-09-2019 02:56:00,0,2503.0,2528.0,1.01,12.658,0,0,0,0,0,0,0,0,0.0,0.0
1009,1180,25-09-2019 02:58:00,0,2529.0,2442.0,0.966,12.668,16,14,9,5,2,0,2,0,0.0,0.0
1009,1181,25-09-2019 03:00:00,0,2517.5,2471.0,0.982,12.654,54,41,20,21,13,6,7,0,0.0,0.0
1009,1182,25-09-2019 03:02:00,0,2506.0,2500.0,0.998,12.64,4,3,0,3,1,0,1,0,0.0,0.0
1009,1183,25-09-2019 03:04:00,0,2522.0,2450.0,0.971,12.649,7,6,3,3,1,0,1,0,0.0,0.0
1009,1184,25-09-2019 03:06:00,0,2430.0,2365.0,0.974,12.191,14,12,4,8,2,0,2,0,0.0,0.0
1009,1185,25-09-2019 03:08:00,0,2326.0,2331.0,1.002,11.743,6,1,0,1,5,0,5,0,0.0,0.0
1009,1186,25-09-2019 03:10:00,0,2321.0,2377.0,1.024,11.776,3,0,0,0,3,0,3,0,0.0,0.0
1009,1187,25-09-2019 03:12:00,0,2322.0,2360.0,1.016,11.762,2,0,0,0,2,0,2,0,0.0,0.0
1009,1188,25-09-2019 03:14:00,0,2329.0,2327.0,0.999,11.751,7,4,3,1,3,0,3,0,0.0,0.0
1009,1189,25-09-2019 03:16:00,0,2333.0,2345.0,1.005,11.788,0,0,0,0,0,0,0,0,0.0,0.0
1009,1190,25-09-2019 03:18:00,0,2329.0,2310.0,0.991,11.735,169,112,69,43,57,38,19,38,0.0,0.0
1009,1191,25-09-2019 03:20:00,0,2521.0,2461.0,0.976,12.657,169,118,82,36,51,36,15,46,0.0,0.0
1009,1192,25-09-2019 03:22:00,0,2707.0,2641.0,0.975,13.589,74,36,23,13,38,0,38,67,0.0,0.0
1009,1193,25-09-2019 03:24:00,0,2949.0,2999.0,1.017,14.938,85,33,14,19,52,0,52,83,0.0,0.01
1009,1194,25-09-2019 03:26:00,0,3209.0,3221.0,1.004,16.21,78,30,19,11,48,3,45,85,0.0,0.06
1009,1195,25-09-2019 03:28:00,0,3432.0,3309.0,0.964,17.188,246,132,100,32,114,67,47,109,0.01,0.08
1009,1196,25-09-2019 03:30:00,0,3420.0,3285.0,0.961,17.111,94,62,41,21,32,17,15,24,0.14,0.03
1009,1197,25-09-2019 03:32:00,0,2332.0,2291.0,0.983,11.723,460,245,194,51,215,170,45,17,0.0,0.0
1009,1198,25-09-2019 03:34:00,0,2891.5,2773.5,0.963,14.4625,745,353,280,73,392,307,85,34,0.0,0.0
1009,1199,25-09-2019 03:36:00,0,3451.0,3256.0,0.943,17.202,769,525,425,100,244,183,61,82,0.0,0.0
1009,1200,25-09-2019 03:38:00,0,3373.0,3480.0,1.032,17.142,178,100,65,35,78,54,24,15,0.0,0.0
1009,1201,25-09-2019 03:40:00,0,2895.0,2786.0,0.963,14.489,113,47,28,19,66,38,28,18,0.0,0.0
1009,1202,25-09-2019 03:42:00,0,3405.0,3428.0,1.007,17.21,315,164,121,43,151,119,32,6,0.0,0.0
1009,1203,25-09-2019 03:44:00,0,3764.0,3757.0,0.998,18.989,192,97,62,35,95,63,32,12,0.01,0.0
1009,1204,25-09-2019 03:46:00,0,2686.0,2618.0,0.975,13.483,308,190,147,43,118,71,47,60,0.01,0.0
1009,1205,25-09-2019 03:48:00,0,3427.0,3311.0,0.966,17.168,96,55,29,26,41,3,38,73,0.0,0.0
1009,1206,25-09-2019 03:50:00,0,3400.0,3445.0,1.013,17.21,116,55,34,21,61,38,23,41,0.0,0.04
1009,1207,25-09-2019 03:52:00,0,2950.0,2987.0,1.012,14.929,439,286,221,65,153,107,46,12,0.0,0.0
1009,1208,25-09-2019 03:54:00,0,2816.0,2628.0,0.933,14.006,461,242,190,52,219,154,65,21,0.0,0.0
1009,1209,25-09-2019 03:56:00,0,3252.0,3148.0,0.968,16.296,181,135,95,40,46,25,21,2,0.0,0.0
1009,1210,25-09-2019 03:58:00,0,3420.0,3341.0,0.977,17.173,459,270,219,51,189,148,41,22,0.0,0.0
1009,1211,25-09-2019 04:00:00,0,2959.0,2979.0,1.007,14.954,40,24,9,15,16,5,11,4,0.0,0.0
1009,1212,25-09-2019 04:02:00,0,3630.0,3479.0,0.958,18.153,29,19,2,17,10,2,8,1,0.0,0.0
1009,1213,25-09-2019 04:04:00,0,3585.0,3543.0,0.988,18.046,54,31,0,31,23,0,23,0,0.0,0.0
1009,1214,25-09-2019 04:06:00,0,3611.0,3463.0,0.959,18.059,57,31,9,22,26,2,24,1,0.01,0.02
1009,1215,25-09-2019 04:08:00,0,3525.5,3363.0,0.954,17.6125,29,20,1,19,9,0,9,0,0.0,0.0
1009,1216,25-09-2019 04:10:00,0,3440.0,3263.0,0.949,17.166,1,0,0,0,1,0,1,0,0.0,0.0
1009,1217,25-09-2019 04:12:00,0,3270.0,3080.0,0.942,16.294,0,0,0,0,0,0,0,0,0.0,0.0
1009,1218,25-09-2019 04:14:00,0,2976.0,2895.0,0.973,14.931,0,0,0,0,0,0,0,0,0.0,0.0
1009,1219,25-09-2019 04:16:00,0,2790.0,2737.0,0.981,14.024,24,14,4,10,10,0,10,0,0.0,0.0
1009,1220,25-09-2019 04:18:00,0,2822.0,2641.0,0.936,14.041,8,2,1,1,6,0,6,0,0.0,0.0
1009,1221,25-09-2019 04:20:00,0,2617.0,2521.0,0.964,13.102,5,5,0,5,0,0,0,0,0.0,0.0
1009,1222,25-09-2019 04:22:00,0,2551.0,2350.0,0.921,12.652,12,5,0,5,7,0,7,0,0.0,0.0
1009,1223,25-09-2019 04:24:00,0,2342.0,2282.0,0.975,11.755,28,28,0,28,0,0,0,0,0.0,0.0
1009,1224,25-09-2019 04:26:00,0,2352.0,2223.0,0.945,11.73,26,26,0,26,0,0,0,0,0.0,0.0
1009,1225,25-09-2019 04:28:00,0,2373.0,2172.0,0.915,11.756,20,13,2,11,7,0,7,0,0.0,0.0
1009,1226,25-09-2019 04:30:00,0,2371.0,2175.0,0.917,11.749,481,367,292,75,114,74,40,17,0.0,0.0
1009,1227,25-09-2019 04:32:00,0,2507.0,2500.0,0.997,12.645,482,331,271,60,151,102,49,53,0.0,0.0
1009,1228,25-09-2019 04:34:00,0,2981.0,2918.0,0.979,14.975,169,112,83,29,57,34,23,38,0.01,0.01
1009,1229,25-09-2019 04:36:00,0,2796.0,2740.0,0.98,14.05,28,21,4,17,7,0,7,0,0.0,0.0
1009,1230,25-09-2019 04:38:00,0,2778.0,2738.0,0.986,13.976,76,49,21,28,27,0,27,1,0.0,0.0
1009,1231,25-09-2019 04:40:00,0,2979.0,2850.0,0.957,14.894,75,59,31,28,16,0,16,0,0.0,0.0
1009,1232,25-09-2019 04:42:00,0,2977.0,2848.5,0.957,14.884,63,33,13,20,30,0,30,0,0.0,0.0
1009,1233,25-09-2019 04:44:00,0,2975.0,2847.0,0.957,14.874,386,269,205,64,117,80,37,24,0.0,0.0
1009,1234,25-09-2019 04:46:00,0,2969.0,2846.0,0.959,14.849,505,353,285,68,152,101,51,38,0.0,0.0
1009,1235,25-09-2019 04:48:00,0,2789.0,2750.0,0.986,14.034,295,156,119,37,139,105,34,79,0.0,0.0
1009,1236,25-09-2019 04:50:00,0,3046.0,3014.0,0.99,15.337,82,50,36,14,32,12,20,52,0.0,0.0
1009,1237,25-09-2019 04:52:00,0,3069.0,2958.0,0.964,15.366,53,14,3,11,39,6,33,24,0.0,0.0
1009,1238,25-09-2019 04:54:00,0,3061.0,2985.0,0.975,15.366,25,6,1,5,19,1,18,0,0.0,0.0
1009,1239,25-09-2019 04:56:00,0,2964.0,2936.0,0.99,14.928,3,2,1,1,1,0,1,0,0.0,0.0
1009,1240,25-09-2019 04:58:00,0,2975.0,2869.0,0.965,14.896,0,0,0,0,0,0,0,0,0.0,0.0
1009,1241,25-09-2019 05:00:00,0,2792.0,2699.0,0.967,13.988,1,1,1,0,0,0,0,0,0.0,0.0
1009,1242,25-09-2019 05:02:00,0,2830.0,2558.0,0.904,13.982,0,0,0,0,0,0,0,0,0.0,0.0
1009,1243,25-09-2019 05:04:00,0,2525.0,2427.0,0.961,12.633,0,0,0,0,0,0,0,0,0.0,0.0
1009,1244,25-09-2019 05:06:00,0,2562.0,2283.0,0.891,12.621,12,5,2,3,7,1,6,0,0.0,0.0
1009,1245,25-09-2019 05:08:00,0,2362.0,2170.0,0.919,11.71,0,0,0,0,0,0,0,0,0.0,0.0
1009,1246,25-09-2019 05:10:00,0,2380.0,2167.0,0.91,11.776,0,0,0,0,0,0,0,0,0.0,0.0
1009,1247,25-09-2019 05:12:00,0,2373.0,2153.0,0.907,11.735,11,11,1,10,0,0,0,0,0.0,0.0
1009,1248,25-09-2019 05:14:00,0,2383.0,2137.0,0.897,11.754,8,7,0,7,1,1,0,0,0.0,0.0
1009,1249,25-09-2019 05:16:00,0,2379.5,2124.0,0.893,11.726,9,1,0,1,8,0,8,0,0.0,0.0
1009,1250,25-09-2019 05:18:00,0,2376.0,2111.0,0.889,11.698,1,0,0,0,1,0,1,0,0.0,0.0
1009,1251,25-09-2019 05:20:00,0,2369.0,2134.0,0.901,11.697,4,0,0,0,4,0,4,0,0.0,0.0
1009,1252,25-09-2019 05:22:00,0,2367.0,2181.0,0.921,11.74,4,0,0,0,4,0,4,0,0.0,0.0
1009,1253,25-09-2019 05:24:00,0,2359.0,2185.0,0.926,11.712,8,0,0,0,8,0,8,0,0.0,0.0
1009,1254,25-09-2019 05:26:00,0,2373.0,2165.0,0.912,11.748,94,64,43,21,30,13,17,18,0.0,0.0
1009,1255,25-09-2019 05:28:00,0,2544.0,2397.0,0.942,12.676,197,96,74,22,101,56,45,95,0.0,0.0
1009,1256,25-09-2019 05:30:00,0,2716.0,2569.0,0.946,13.544,10,3,1,2,7,0,7,0,0.0,0.0
1009,1257,25-09-2019 05:32:00,0,2813.0,2609.0,0.927,13.973,44,24,5,19,20,4,16,9,0.0,0.0
1009,1258,25-09-2019 05:34:00,0,2797.0,2677.0,0.957,13.985,110,57,40,17,53,3,50,77,0.0,0.0
1009,1259,25-09-2019 05:36:00,0,2956.0,2908.0,0.984,14.867,81,36,19,17,45,2,43,70,0.0,0.0
1009,1260,25-09-2019 05:38:00,0,3281.0,3060.0,0.933,16.315,82,55,19,36,27,4,23,35,0.0,0.03
1009,1261,25-09-2019 05:40:00,0,3062.0,2977.0,0.972,15.359,250,125,91,34,125,94,31,89,0.0,0.01
1009,1262,25-09-2019 05:42:00,0,3444.0,3253.0,0.945,17.169,70,26,18,8,44,28,16,12,0.0,0.0
1009,1263,25-09-2019 05:44:00,0,2990.0,2812.0,0.941,14.894,266,205,162,43,61,34,27,4,0.0,0.01
1009,1264,25-09-2019 05:46:00,0,2840.0,2578.0,0.908,14.046,550,300,231,69,250,182,68,15,0.07,0.0
1009,1265,25-09-2019 05:48:00,0,2814.0,2667.0,0.948,14.038,349,220,164,56,129,86,43,11,0.0,0.0
1009,1266,25-09-2019 05:50:00,0,3077.5,2916.5,0.9475,15.354,670,417,343,74,253,188,65,53,0.0,0.0
1009,1267,25-09-2019 05:52:00,0,3341.0,3166.0,0.947,16.67,70,41,29,12,29,20,9,17,0.0,0.0
1009,1268,25-09-2019 05:54:00,0,2992.0,2826.0,0.945,14.919,84,40,14,26,44,1,43,19,0.0,0.0
1009,1269,25-09-2019 05:56:00,0,3255.0,3142.0,0.965,16.302,6,4,0,4,2,0,2,2,0.0,0.0
1009,1270,25-09-2019 05:58:00,0,3272.0,3061.0,0.935,16.28,2,0,0,0,2,0,2,0,0.0,0.0
1009,1271,25-09-2019 06:00:00,1,3077.0,2940.0,0.956,15.377,36,19,11,8,17,10,7,1,0.0,0.0
1009,1272,25-09-2019 06:02:00,1,2988.0,2867.0,0.96,14.946,225,88,62,26,137,100,37,32,0.0,0.0
1009,1273,25-09-2019 06:04:00,1,2987.0,2820.0,0.944,14.889,70,45,19,26,25,14,11,2,0.0,0.01
1009,1274,25-09-2019 06:06:00,1,2806.0,2646.0,0.943,13.984,237,148,117,31,89,62,27,21,0.0,0.01
1009,1275,25-09-2019 06:08:00,1,2814.0,2629.0,0.934,13.998,60,40,12,28,20,2,18,6,0.0,0.0
1009,1276,25-09-2019 06:10:00,1,2815.0,2657.0,0.944,14.033,38,19,1,18,19,0,19,2,0.0,0.0
1009,1277,25-09-2019 06:12:00,1,2824.0,2600.0,0.921,14.003,6,4,0,4,2,0,2,0,0.0,0.0
1009,1278,25-09-2019 06:14:00,1,2845.0,2530.0,0.889,14.012,5,5,1,4,0,0,0,0,0.0,0.0
1009,1279,25-09-2019 06:16:00,1,2538.0,2430.0,0.957,12.69,0,0,0,0,0,0,0,0,0.0,0.0
1009,1280,25-09-2019 06:18:00,1,2467.0,2254.0,0.914,12.217,0,0,0,0,0,0,0,0,0.0,0.0
1009,1281,25-09-2019 06:20:00,1,2373.0,2112.0,0.89,11.688,2,1,1,0,1,0,1,0,0.0,0.0
1009,1282,25-09-2019 06:22:00,1,2181.0,2006.0,0.92,10.814,14,8,6,2,6,2,4,0,0.0,0.0
1009,1283,25-09-2019 06:24:00,1,2192.5,1961.5,0.895,10.81,12,10,0,10,2,0,2,0,0.0,0.0
1009,1284,25-09-2019 06:26:00,1,2204.0,1917.0,0.87,10.806,0,0,0,0,0,0,0,0,0.0,0.0
1009,1285,25-09-2019 06:28:00,1,2206.0,1919.0,0.87,10.818,0,0,0,0,0,0,0,0,0.0,0.0
1009,1286,25-09-2019 06:30:00,1,2203.0,1944.0,0.883,10.834,0,0,0,0,0,0,0,0,0.0,0.0
1009,1287,25-09-2019 06:32:00,1,2195.0,1949.0,0.888,10.806,12,12,2,10,0,0,0,0,0.0,0.0
1009,1288,25-09-2019 06:34:00,1,2204.0,1974.0,0.895,10.87,2,2,0,2,0,0,0,0,0.0,0.0
1009,1289,25-09-2019 06:36:00,1,2304.0,2004.0,0.87,11.295,8,8,6,2,0,0,0,0,0.0,0.0
1009,1290,25-09-2019 06:38:00,1,2305.0,2003.0,0.869,11.299,0,0,0,0,0,0,0,0,0.0,0.0
1009,1291,25-09-2019 06:40:00,1,2296.0,1984.0,0.864,11.242,10,10,3,7,0,0,0,0,0.0,0.0
1009,1292,25-09-2019 06:42:00,1,2401.0,2008.0,0.836,11.683,4,4,3,1,0,0,0,0,0.0,0.0
1009,1293,25-09-2019 06:44:00,1,2416.0,2011.0,0.832,11.747,27,19,10,9,8,2,6,0,0.0,0.0
1009,1294,25-09-2019 06:46:00,1,2402.0,2025.0,0.843,11.705,40,30,2,28,10,0,10,0,0.0,0.0
1009,1295,25-09-2019 06:48:00,1,2378.0,2156.0,0.906,11.758,46,31,14,17,15,2,13,6,0.0,0.0
1009,1296,25-09-2019 06:50:00,1,2371.0,2150.0,0.907,11.723,5,0,0,0,5,0,5,0,0.0,0.0
1009,1297,25-09-2019 06:52:00,1,2394.0,2094.0,0.875,11.75,0,0,0,0,0,0,0,0,0.0,0.0
1009,1298,25-09-2019 06:54:00,1,2422.0,2009.0,0.83,11.765,2,0,0,0,2,0,2,0,0.0,0.0
1009,1299,25-09-2019 06:56:00,1,2194.0,1973.0,0.899,10.829,34,27,22,5,7,4,3,0,0.0,0.0
1009,1300,25-09-2019 06:58:00,1,2207.5,1930.0,0.8745,10.834,12,11,1,10,1,0,1,0,0.0,0.0
1009,1301,25-09-2019 07:00:00,1,2221.0,1887.0,0.85,10.839,11,9,1,8,2,0,2,0,0.0,0.0
1009,1302,25-09-2019 07:02:00,1,2212.0,1888.0,0.853,10.805,5,4,1,3,1,0,1,0,0.0,0.0
1009,1303,25-09-2019 07:04:00,1,2213.0,1878.0,0.849,10.801,13,13,0,13,0,0,0,0,0.0,0.0
1009,1304,25-09-2019 07:06:00,1,2233.0,1857.0,0.832,10.854,23,22,1,21,1,0,1,0,0.0,0.0
1009,1305,25-09-2019 07:08:00,1,2233.0,1858.0,0.832,10.856,13,12,6,6,1,0,1,0,0.0,0.0
1009,1306,25-09-2019 07:10:00,1,2207.0,1929.0,0.874,10.829,9,8,2,6,1,0,1,0,0.0,0.0
1009,1307,25-09-2019 07:12:00,1,2216.0,1906.0,0.86,10.839,0,0,0,0,0,0,0,0,0.0,0.0
1009,1308,25-09-2019 07:14:00,1,2216.0,1910.0,0.862,10.847,7,4,4,0,3,0,3,2,0.0,0.0
1009,1309,25-09-2019 07:16:00,1,2417.0,2014.0,0.833,11.752,13,9,6,3,4,1,3,2,0.0,0.0
1009,1310,25-09-2019 07:18:00,1,2395.0,2051.0,0.856,11.708,10,8,3,5,2,0,2,0,0.0,0.0
1009,1311,25-09-2019 07:20:00,1,2395.0,2064.0,0.862,11.721,11,11,1,10,0,0,0,0,0.0,0.0
1009,1312,25-09-2019 07:22:00,1,2411.0,2000.0,0.83,11.713,0,0,0,0,0,0,0,0,0.0,0.0
1009,1313,25-09-2019 07:24:00,1,2427.0,1982.0,0.817,11.756,2,1,0,1,1,0,1,0,0.0,0.0
1009,1314,25-09-2019 07:26:00,1,2421.0,1966.0,0.812,11.716,0,0,0,0,0,0,0,0,0.0,0.0
1009,1315,25-09-2019 07:28:00,1,2321.0,1945.0,0.838,11.299,30,24,18,6,6,3,3,2,0.0,0.0
1009,1316,25-09-2019 07:30:00,1,2315.0,1945.0,0.84,11.275,100,73,40,33,27,10,17,11,0.0,0.0
1009,1317,25-09-2019 07:32:00,1,2447.5,2091.0,0.8535,11.959,90,62,31,31,28,8,20,9,0.0,0.0
1009,1318,25-09-2019 07:34:00,1,2580.0,2237.0,0.867,12.643,116,106,63,43,10,2,8,28,0.0,0.0
1009,1319,25-09-2019 07:36:00,1,3018.0,2636.0,0.873,14.811,133,80,51,29,53,30,23,54,0.0,0.0
1009,1320,25-09-2019 07:38:00,1,2837.0,2532.0,0.892,13.982,83,41,20,21,42,5,37,56,0.0,0.0
1009,1321,25-09-2019 07:40:00,1,2849.0,2519.0,0.884,14.012,107,73,41,32,34,4,30,57,0.0,0.0
1009,1322,25-09-2019 07:42:00,1,3237.0,2772.0,0.856,15.824,80,40,21,19,40,3,37,55,0.0,0.09
1009,1323,25-09-2019 07:44:00,1,3335.0,2824.0,0.847,16.266,237,99,73,26,138,97,41,49,0.0,0.0
1009,1324,25-09-2019 07:46:00,1,3028.0,2766.0,0.913,14.994,111,81,50,31,30,8,22,36,0.0,0.0
1009,1325,25-09-2019 07:48:00,1,2391.0,2082.0,0.871,11.725,210,170,121,49,40,20,20,15,0.0,0.0
1009,1326,25-09-2019 07:50:00,1,2835.0,2551.0,0.9,13.994,165,113,78,35,52,38,14,14,0.0,0.0
1009,1327,25-09-2019 07:52:00,1,2593.0,2200.0,0.849,12.651,70,54,24,30,16,0,16,2,0.0,0.0
1009,1328,25-09-2019 07:54:00,1,3034.0,2703.0,0.891,14.945,24,23,12,11,1,1,0,0,0.0,0.0
1009,1329,25-09-2019 07:56:00,1,3023.0,2716.0,0.898,14.919,0,0,0,0,0,0,0,0,0.0,0.0
1009,1330,25-09-2019 07:58:00,1,3020.0,2716.0,0.899,14.906,0,0,0,0,0,0,0,0,0.0,0.0
1009,1331,25-09-2019 08:00:00,1,2934.0,2605.0,0.888,14.445,3,1,0,1,2,0,2,0,0.0,0.0
1009,1332,25-09-2019 08:02:00,1,2856.0,2457.0,0.861,13.972,1,0,0,0,1,0,1,0,0.0,0.0
1009,1333,25-09-2019 08:04:00,1,2570.0,2326.0,0.905,12.7,21,19,2,17,2,0,2,0,0.0,0.0
1009,1334,25-09-2019 08:06:00,1,2468.5,2227.0,0.902,12.191,1,1,1,0,0,0,0,0,0.0,0.0
1009,1335,25-09-2019 08:08:00,1,2367.0,2128.0,0.899,11.682,9,9,0,9,0,0,0,0,0.0,0.0
1009,1336,25-09-2019 08:10:00,1,2578.0,2205.0,0.855,12.6,11,7,1,6,4,0,4,0,0.0,0.0
1009,1337,25-09-2019 08:12:00,1,2579.0,2217.0,0.859,12.616,25,17,10,7,8,3,5,1,0.0,0.0
1009,1338,25-09-2019 08:14:00,1,2479.0,2203.0,0.889,12.205,9,9,1,8,0,0,0,0,0.0,0.0
1009,1339,25-09-2019 08:16:00,1,2373.0,2137.0,0.9,11.716,1,1,0,1,0,0,0,0,0.0,0.0
1009,1340,25-09-2019 08:18:00,1,2396.0,2075.0,0.866,11.736,0,0,0,0,0,0,0,0,0.0,0.0
1009,1341,25-09-2019 08:20:00,1,2201.0,1971.0,0.895,10.854,14,14,1,13,0,0,0,0,0.0,0.0
1009,1342,25-09-2019 08:22:00,1,2198.0,1968.0,0.895,10.837,17,16,0,16,1,0,1,0,0.0,0.0
1009,1343,25-09-2019 08:24:00,1,2201.0,1947.0,0.885,10.829,20,14,11,3,6,1,5,0,0.0,0.0
1009,1344,25-09-2019 08:26:00,1,2196.0,1953.0,0.889,10.814,5,5,1,4,0,0,0,0,0.0,0.0
1009,1345,25-09-2019 08:28:00,1,2206.0,1934.0,0.877,10.832,4,4,0,4,0,0,0,0,0.0,0.0
1009,1346,25-09-2019 08:30:00,1,2206.0,1924.0,0.872,10.823,6,6,0,6,0,0,0,0,0.0,0.0
1009,1347,25-09-2019 08:32:00,1,2207.0,1925.0,0.872,10.825,1,1,0,1,0,0,0,0,0.0,0.0
1009,1348,25-09-2019 08:34:00,1,2210.0,1952.0,0.883,10.87,3,3,0,3,0,0,0,0,0.0,0.0
1009,1349,25-09-2019 08:36:00,1,2214.0,1904.0,0.86,10.831,39,32,19,13,7,1,6,3,0.0,0.0
1009,1350,25-09-2019 08:38:00,1,2417.0,1988.0,0.823,11.722,36,31,15,16,5,1,4,0,0.0,0.0
1009,1351,25-09-2019 08:40:00,1,2497.0,2126.0,0.851,12.191,33,14,0,14,19,0,19,12,0.0,0.0
1009,1352,25-09-2019 08:42:00,1,2577.0,2264.0,0.879,12.66,130,88,54,34,42,14,28,35,0.0,0.0
1009,1353,25-09-2019 08:44:00,1,2766.0,2349.0,0.849,13.498,275,172,126,46,103,69,34,63,0.0,0.0
1009,1354,25-09-2019 08:46:00,1,2665.0,2368.0,0.888,13.122,66,38,24,14,28,9,19,2,0.0,0.0
1009,1355,25-09-2019 08:48:00,1,2863.0,2416.0,0.844,13.957,11,0,0,0,11,0,11,0,0.0,0.0
1009,1356,25-09-2019 08:50:00,1,2673.0,2300.0,0.86,13.08,0,0,0,0,0,0,0,0,0.0,0.0
1009,1357,25-09-2019 08:52:00,1,2598.0,2160.0,0.832,12.626,3,3,2,1,0,0,0,0,0.0,0.0
1009,1358,25-09-2019 08:54:00,1,2398.0,2088.0,0.871,11.761,7,7,0,7,0,0,0,0,0.0,0.0
1009,1359,25-09-2019 08:56:00,1,2423.0,1964.0,0.811,11.721,11,7,4,3,4,1,3,0,0.0,0.0
1009,1360,25-09-2019 08:58:00,1,2213.0,1919.0,0.867,10.844,14,10,6,4,4,1,3,0,0.0,0.0
1009,1361,25-09-2019 09:00:00,1,2232.0,1865.0,0.835,10.859,60,42,18,24,18,12,6,6,0.0,0.0
1009,1362,25-09-2019 09:02:00,1,2421.0,2005.0,0.828,11.761,58,43,17,26,15,0,15,5,0.0,0.0
1009,1363,25-09-2019 09:04:00,1,2506.0,2104.0,0.84,12.203,54,31,5,26,23,0,23,4,0.0,0.0
1009,1364,25-09-2019 09:06:00,1,2601.0,2182.0,0.839,12.663,86,52,29,23,34,4,30,48,0.0,0.0
1009,1365,25-09-2019 09:08:00,1,2669.0,2263.0,0.848,13.02,86,35,13,22,51,0,51,69,0.0,0.0
1009,1366,25-09-2019 09:10:00,1,2856.0,2475.0,0.867,13.993,119,72,42,30,47,2,45,68,0.0,0.0
1009,1367,25-09-2019 09:12:00,1,3060.0,2540.0,0.83,14.869,182,109,70,39,73,32,41,54,0.0,0.1
1009,1368,25-09-2019 09:14:00,1,2961.0,2507.0,0.847,14.442,618,364,295,69,254,184,70,27,0.02,0.0
1009,1369,25-09-2019 09:16:00,1,2862.0,2474.0,0.864,14.015,545,322,261,61,223,165,58,28,0.02,0.01
1009,1370,25-09-2019 09:18:00,1,2676.0,2323.0,0.868,13.114,237,205,160,45,32,7,25,2,0.0,0.0
1009,1371,25-09-2019 09:20:00,1,2605.0,2163.0,0.831,12.657,589,359,277,82,230,172,58,11,0.02,0.01
1009,1372,25-09-2019 09:22:00,1,3348.0,2781.0,0.831,16.271,127,57,43,14,70,46,24,4,0.0,0.0
1009,1373,25-09-2019 09:24:00,1,2836.0,2517.0,0.888,13.959,18,17,12,5,1,0,1,3,0.0,0.0
1009,1374,25-09-2019 09:26:00,1,2221.0,1889.0,0.851,10.842,23,17,5,12,6,1,5,0,0.0,0.0
1009,1375,25-09-2019 09:28:00,1,2402.0,2018.0,0.84,11.699,41,35,15,20,6,3,3,5,0.0,0.0
1009,1376,25-09-2019 09:30:00,1,3018.0,2727.0,0.903,14.909,10,9,1,8,1,0,1,0,0.0,0.01
1009,1377,25-09-2019 09:32:00,1,3012.0,2702.0,0.897,14.858,0,0,0,0,0,0,0,0,0.0,0.0
1009,1378,25-09-2019 09:34:00,1,2837.0,2521.0,0.889,13.968,3,3,0,3,0,0,0,0,0.0,0.0
1009,1379,25-09-2019 09:36:00,1,2775.0,2355.0,0.848,13.542,0,0,0,0,0,0,0,0,0.0,0.0
1009,1380,25-09-2019 09:38:00,1,2585.0,2224.0,0.86,12.648,21,15,7,8,6,1,5,0,0.0,0.0
1009,1381,25-09-2019 09:40:00,1,2384.0,2125.0,0.891,11.744,0,0,0,0,0,0,0,0,0.0,0.0
1009,1382,25-09-2019 09:42:00,1,2393.0,2067.0,0.864,11.717,0,0,0,0,0,0,0,0,0.0,0.0
1009,1383,25-09-2019 09:44:00,1,2413.0,2015.0,0.835,11.738,13,10,3,7,3,2,1,0,0.0,0.0
1009,1384,25-09-2019 09:46:00,1,2418.0,1995.0,0.825,11.735,5,5,0,5,0,0,0,0,0.0,0.01
1009,1385,25-09-2019 09:48:00,1,2359.0,1996.5,0.847,11.5055,0,0,0,0,0,0,0,0,0.0,0.0
1009,1386,25-09-2019 09:50:00,1,2300.0,1998.0,0.869,11.276,0,0,0,0,0,0,0,0,0.0,0.0
1009,1387,25-09-2019 09:52:00,1,2400.0,2057.0,0.857,11.733,0,0,0,0,0,0,0,0,0.0,0.0
1009,1388,25-09-2019 09:54:00,1,2303.0,1980.0,0.86,11.267,16,12,4,8,4,2,2,0,0.0,0.0
1009,1389,25-09-2019 09:56:00,1,2310.0,1995.0,0.864,11.31,0,0,0,0,0,0,0,0,0.0,0.0
1009,1390,25-09-2019 09:58:00,1,2402.0,1999.0,0.832,11.678,26,20,8,12,6,1,5,5,0.0,0.0
1009,1391,25-09-2019 10:00:00,1,2404.0,2073.0,0.862,11.766,2,2,0,2,0,0,0,0,0.0,0.0
1009,1392,25-09-2019 10:02:00,1,2418.0,2001.0,0.828,11.742,3,3,2,1,0,0,0,0,0.0,0.0
1009,1393,25-09-2019 10:04:00,1,2213.0,1938.0,0.876,10.867,7,7,3,4,0,0,0,0,0.0,0.0
1009,1394,25-09-2019 10:06:00,1,2211.0,1936.0,0.876,10.854,4,2,0,2,2,1,1,0,0.0,0.0
1009,1395,25-09-2019 10:08:00,1,2320.0,1938.0,0.835,11.287,15,14,0,14,1,0,1,0,0.0,0.0
1009,1396,25-09-2019 10:10:00,1,2219.0,1908.0,0.86,10.855,14,9,1,8,5,0,5,0,0.0,0.0
1009,1397,25-09-2019 10:12:00,1,2218.0,1870.0,0.843,10.81,7,7,0,7,0,0,0,0,0.0,0.0
1009,1398,25-09-2019 10:14:00,1,2234.0,1815.0,0.813,10.812,5,5,0,5,0,0,0,0,0.0,0.0
1009,1399,25-09-2019 10:16:00,1,2230.0,1825.0,0.818,10.805,3,3,1,2,0,0,0,0,0.0,0.0
1009,1400,25-09-2019 10:18:00,1,2231.0,1849.0,0.829,10.836,4,3,1,2,1,0,1,0,0.0,0.0
1009,1401,25-09-2019 10:20:00,1,2221.0,1862.0,0.839,10.811,0,0,0,0,0,0,0,0,0.0,0.0
1009,1402,25-09-2019 10:22:00,1,2230.5,1847.0,0.8285,10.832,13,13,3,10,0,0,0,0,0.0,0.0
1009,1403,25-09-2019 10:24:00,1,2240.0,1832.0,0.818,10.853,26,20,9,11,6,2,4,0,0.0,0.0
1009,1404,25-09-2019 10:26:00,1,2228.0,1865.0,0.837,10.845,5,5,0,5,0,0,0,0,0.0,0.0
1009,1405,25-09-2019 10:28:00,1,2230.0,1860.0,0.834,10.848,20,20,0,20,0,0,0,0,0.0,0.0
1009,1406,25-09-2019 10:30:00,1,2236.0,1837.0,0.821,10.843,0,0,0,0,0,0,0,0,0.0,0.0
1009,1407,25-09-2019 10:32:00,1,2235.0,1818.0,0.814,10.819,5,1,1,0,4,0,4,0,0.01,0.0
1009,1408,25-09-2019 10:34:00,1,2240.0,1837.0,0.82,10.861,18,0,0,0,18,0,18,0,0.0,0.0
1009,1409,25-09-2019 10:36:00,1,2242.0,1811.0,0.808,10.838,59,47,25,22,12,1,11,1,0.0,0.0
1009,1410,25-09-2019 10:38:00,1,2240.0,1821.0,0.813,10.843,86,76,40,36,10,0,10,12,0.0,0.0
1009,1411,25-09-2019 10:40:00,1,2439.0,1916.0,0.786,11.73,103,60,44,16,43,31,12,10,0.0,0.0
1009,1412,25-09-2019 10:42:00,1,2785.0,2331.0,0.837,13.552,127,56,39,17,71,41,30,54,0.0,0.0
1009,1413,25-09-2019 10:44:00,1,2700.0,2274.0,0.842,13.156,126,74,45,29,52,27,25,51,0.0,0.0
1009,1414,25-09-2019 10:46:00,1,3316.0,2862.0,0.863,16.234,178,113,84,29,65,41,24,63,0.0,0.0
1009,1415,25-09-2019 10:48:00,1,2597.0,2187.0,0.842,12.655,4,4,1,3,0,0,0,0,0.0,0.0
1009,1416,25-09-2019 10:50:00,1,2582.0,2234.0,0.865,12.645,5,4,0,4,1,0,1,0,0.0,0.0
1009,1417,25-09-2019 10:52:00,1,2669.0,2275.0,0.852,13.035,2,2,0,2,0,0,0,0,0.0,0.0
1009,1418,25-09-2019 10:54:00,1,2593.0,2184.0,0.842,12.633,12,10,6,4,2,1,1,0,0.0,0.0
1009,1419,25-09-2019 10:56:00,1,2505.5,2098.0,0.837,12.194,16,16,4,12,0,0,0,0,0.0,0.0
1009,1420,25-09-2019 10:58:00,1,2418.0,2012.0,0.832,11.755,23,23,2,21,0,0,0,0,0.0,0.0
1009,1421,25-09-2019 11:00:00,1,2325.0,1932.0,0.831,11.298,22,18,7,11,4,1,3,0,0.0,0.0
1009,1422,25-09-2019 11:02:00,1,2220.0,1868.0,0.841,10.815,0,0,0,0,0,0,0,0,0.0,0.0
1009,1423,25-09-2019 11:04:00,1,2239.0,1856.0,0.829,10.876,0,0,0,0,0,0,0,0,0.0,0.0
1009,1424,25-09-2019 11:06:00,1,2033.0,1737.0,0.855,9.932,5,5,4,1,0,0,0,0,0.0,0.0
1009,1425,25-09-2019 11:08:00,1,2252.0,1782.0,0.791,10.847,1,1,0,1,0,0,0,0,0.0,0.0
1009,1426,25-09-2019 11:10:00,1,2252.0,1774.0,0.788,10.838,3,3,1,2,0,0,0,0,0.0,0.0
1009,1427,25-09-2019 11:12:00,1,2031.0,1718.0,0.846,9.903,0,0,0,0,0,0,0,0,0.0,0.0
1009,1428,25-09-2019 11:14:00,1,2037.0,1693.0,0.831,9.9,5,5,2,3,0,0,0,0,0.0,0.0
1009,1429,25-09-2019 11:16:00,1,2046.0,1707.0,0.834,9.953,19,14,12,2,5,1,4,0,0.0,0.0
1009,1430,25-09-2019 11:18:00,1,2142.0,1702.0,0.794,10.326,2,1,0,1,1,1,0,0,0.0,0.0
1009,1431,25-09-2019 11:20:00,1,2150.0,1728.0,0.804,10.386,0,0,0,0,0,0,0,0,0.0,0.01
1009,1432,25-09-2019 11:22:00,1,2246.0,1734.0,0.772,10.769,0,0,0,0,0,0,0,0,0.0,0.0
1009,1433,25-09-2019 11:24:00,1,2256.0,1749.0,0.775,10.826,8,8,3,5,0,0,0,0,0.0,0.0
1009,1434,25-09-2019 11:26:00,1,2253.0,1737.0,0.771,10.801,1,1,0,1,0,0,0,0,0.0,0.0
1009,1435,25-09-2019 11:28:00,1,2249.0,1734.0,0.771,10.781,7,7,6,1,0,0,0,0,0.0,0.0
1009,1436,25-09-2019 11:30:00,1,2256.0,1737.5,0.7705,10.8125,121,106,70,36,15,0,15,0,0.0,0.0
1009,1437,25-09-2019 11:32:00,1,2263.0,1741.0,0.77,10.844,125,109,58,51,16,0,16,12,0.0,0.0
1009,1438,25-09-2019 11:34:00,1,2447.0,1888.0,0.771,11.732,79,62,42,20,17,5,12,12,0.0,0.0
1009,1439,25-09-2019 11:36:00,1,2604.0,2135.0,0.82,12.624,98,54,30,24,44,9,35,61,0.0,0.0
1009,1440,25-09-2019 11:38:00,1,2624.0,2078.0,0.792,12.639,112,69,33,36,43,2,41,53,0.0,0.0
1009,1441,25-09-2019 11:40:00,1,2972.0,2490.0,0.838,14.465,81,60,37,23,21,2,19,47,0.0,0.12
1009,1442,25-09-2019 11:42:00,1,3054.0,2541.0,0.832,14.847,83,50,21,29,33,3,30,56,0.0,0.08
1009,1443,25-09-2019 11:44:00,1,2873.0,2432.0,0.847,14.011,621,406,331,75,215,159,56,33,0.22,0.01
1009,1444,25-09-2019 11:46:00,1,2603.0,2123.0,0.815,12.607,677,507,416,91,170,118,52,34,0.0,0.04
1009,1445,25-09-2019 11:48:00,1,3336.0,2836.0,0.85,16.283,497,233,186,47,264,211,53,21,0.0,0.0
1009,1446,25-09-2019 11:50:00,1,2668.0,2320.0,0.869,13.079,422,293,242,51,129,79,50,11,0.0,0.0
1009,1447,25-09-2019 11:52:00,1,2780.0,2349.0,0.845,13.555,694,438,356,82,256,190,66,30,0.0,0.0
1009,1448,25-09-2019 11:54:00,1,3013.0,2750.0,0.912,14.916,600,346,290,56,254,195,59,35,0.0,0.0
1009,1449,25-09-2019 11:56:00,1,3334.0,2853.0,0.856,16.294,460,201,148,53,259,196,63,53,0.0,0.0
1009,1450,25-09-2019 11:58:00,1,3323.0,2866.0,0.862,16.267,444,321,246,75,123,74,49,15,0.0,0.0
1009,1451,25-09-2019 12:00:00,1,3221.0,2835.0,0.88,15.83,539,374,305,69,165,112,53,21,0.0,0.0
1009,1452,25-09-2019 12:02:00,1,3207.0,2848.0,0.888,15.789,462,311,249,62,151,94,57,27,0.0,0.0
1009,1453,25-09-2019 12:04:00,1,3114.0,2783.0,0.894,15.351,451,293,223,70,158,108,50,22,0.0,0.0
1009,1454,25-09-2019 12:06:00,1,3021.0,2718.0,0.9,14.913,141,95,73,22,46,25,21,60,0.0,0.0
1009,1455,25-09-2019 12:08:00,1,2815.0,2621.0,0.931,13.993,33,20,12,8,13,1,12,14,0.0,0.0
1009,1456,25-09-2019 12:10:00,1,3019.0,2734.0,0.905,14.922,60,57,30,27,3,1,2,0,0.0,0.0
1009,1457,25-09-2019 12:12:00,1,3016.0,2740.0,0.909,14.915,50,41,18,23,9,3,6,2,0.0,0.0
1009,1458,25-09-2019 12:14:00,1,3025.0,2700.0,0.893,14.908,12,12,0,12,0,0,0,0,0.0,0.0
1009,1459,25-09-2019 12:16:00,1,2826.0,2602.0,0.921,14.016,0,0,0,0,0,0,0,0,0.0,0.0
1009,1460,25-09-2019 12:18:00,1,2546.0,2347.0,0.922,12.629,0,0,0,0,0,0,0,0,0.0,0.0
1009,1461,25-09-2019 12:20:00,1,2363.0,2193.0,0.928,11.738,0,0,0,0,0,0,0,0,0.0,0.0
1009,1462,25-09-2019 12:22:00,1,2394.0,2079.0,0.868,11.734,7,2,0,2,5,1,4,0,0.0,0.0
1009,1463,25-09-2019 12:24:00,1,2381.0,2117.0,0.889,11.727,4,0,0,0,4,0,4,0,0.0,0.0
1009,1464,25-09-2019 12:26:00,1,2367.0,2161.0,0.913,11.717,0,0,0,0,0,0,0,0,0.0,0.0
1009,1465,25-09-2019 12:28:00,1,2367.0,2150.0,0.908,11.707,0,0,0,0,0,0,0,0,0.0,0.0
1009,1466,25-09-2019 12:30:00,1,2378.0,2158.0,0.908,11.757,1,1,0,1,0,0,0,0,0.0,0.0
1009,1467,25-09-2019 12:32:00,1,2385.0,2122.0,0.889,11.747,0,0,0,0,0,0,0,0,0.0,0.0
1009,1468,25-09-2019 12:34:00,1,2383.0,2083.0,0.874,11.696,5,5,0,5,0,0,0,1,0.0,0.0
1009,1469,25-09-2019 12:36:00,1,2394.0,2083.0,0.87,11.738,0,0,0,0,0,0,0,0,0.0,0.0
1009,1470,25-09-2019 12:38:00,1,2341.5,2053.5,0.877,11.499,39,30,12,18,9,0,9,1,0.02,0.0
1009,1471,25-09-2019 12:40:00,1,2289.0,2024.0,0.884,11.26,5,5,2,3,0,0,0,0,0.0,0.0
1009,1472,25-09-2019 12:42:00,1,2297.0,2037.0,0.887,11.306,4,4,1,3,0,0,0,0,0.0,0.0
1009,1473,25-09-2019 12:44:00,1,2191.0,1979.0,0.903,10.825,0,0,0,0,0,0,0,0,0.0,0.0
1009,1474,25-09-2019 12:46:00,1,2205.0,1940.0,0.88,10.837,1,1,1,0,0,0,0,0,0.01,0.0
1009,1475,25-09-2019 12:48:00,1,2211.0,1931.0,0.873,10.85,0,0,0,0,0,0,0,0,0.0,0.0
1009,1476,25-09-2019 12:50:00,1,2217.0,1876.0,0.847,10.811,30,24,15,9,6,2,4,1,0.0,0.0
1009,1477,25-09-2019 12:52:00,1,2117.0,1864.0,0.88,10.404,0,0,0,0,0,0,0,0,0.0,0.0
1009,1478,25-09-2019 12:54:00,1,2120.0,1874.0,0.884,10.429,0,0,0,0,0,0,0,0,0.0,0.0
1009,1479,25-09-2019 12:56:00,1,2212.0,1883.0,0.851,10.802,22,14,9,5,8,3,5,0,0.0,0.0
1009,1480,25-09-2019 12:58:00,1,2208.0,1921.0,0.87,10.826,7,7,2,5,0,0,0,0,0.0,0.0
1009,1481,25-09-2019 13:00:00,1,2198.0,1923.0,0.875,10.79,6,6,2,4,0,0,0,0,0.0,0.0
1009,1482,25-09-2019 13:02:00,1,2213.0,1898.0,0.858,10.822,3,2,1,1,1,1,0,0,0.0,0.0
1009,1483,25-09-2019 13:04:00,1,2219.0,1891.0,0.852,10.837,1,0,0,0,1,0,1,0,0.0,0.0
1009,1484,25-09-2019 13:06:00,1,2226.0,1883.0,0.846,10.855,0,0,0,0,0,0,0,0,0.0,0.0
1009,1485,25-09-2019 13:08:00,1,2214.0,1907.0,0.861,10.834,0,0,0,0,0,0,0,0,0.0,0.0
1009,1486,25-09-2019 13:10:00,1,2206.0,1920.0,0.87,10.819,0,0,0,0,0,0,0,0,0.0,0.0
1009,1487,25-09-2019 13:12:00,1,2214.0,1887.5,0.8525,10.8125,0,0,0,0,0,0,0,0,0.0,0.0
1009,1488,25-09-2019 13:14:00,1,2222.0,1855.0,0.835,10.806,3,1,0,1,2,0,2,0,0.0,0.0
1009,1489,25-09-2019 13:16:00,1,2228.0,1853.0,0.832,10.828,1,0,0,0,1,0,1,0,0.0,0.0
1009,1490,25-09-2019 13:18:00,1,2220.0,1829.0,0.824,10.77,1,0,0,0,1,0,1,0,0.0,0.0
1009,1491,25-09-2019 13:20:00,1,2134.0,1807.0,0.847,10.408,2,0,0,0,2,0,2,0,0.0,0.0
1009,1492,25-09-2019 13:22:00,1,2134.0,1810.0,0.848,10.411,4,2,1,1,2,0,2,0,0.0,0.0
1009,1493,25-09-2019 13:24:00,1,2212.0,1883.0,0.851,10.801,56,49,34,15,7,2,5,7,0.0,0.0
1009,1494,25-09-2019 13:26:00,1,2202.0,1917.0,0.871,10.798,126,93,59,34,33,11,22,21,0.0,0.0
1009,1495,25-09-2019 13:28:00,1,2592.0,2224.0,0.858,12.676,93,57,36,21,36,5,31,60,0.0,0.0
1009,1496,25-09-2019 13:30:00,1,2583.0,2246.0,0.869,12.665,93,50,27,23,43,2,41,72,0.0,0.0
1009,1497,25-09-2019 13:32:00,1,2868.0,2441.0,0.851,14.003,116,77,44,33,39,10,29,31,0.0,0.08
1009,1498,25-09-2019 13:34:00,1,2306.0,2012.0,0.872,11.312,58,37,20,17,21,3,18,19,0.0,0.0
1009,1499,25-09-2019 13:36:00,1,2023.0,1751.0,0.866,9.908,615,293,237,56,322,246,76,15,0.04,0.0
1009,1500,25-09-2019 13:38:00,1,2659.0,2376.0,0.894,13.106,611,429,346,83,182,133,49,67,0.0,0.0
1009,1501,25-09-2019 13:40:00,1,2832.0,2565.0,0.906,13.998,765,514,436,78,251,189,62,59,0.0,0.0
1009,1502,25-09-2019 13:42:00,1,2912.0,2654.0,0.911,14.411,195,120,79,41,75,45,30,9,0.0,0.0
1009,1503,25-09-2019 13:44:00,1,3005.0,2724.0,0.907,14.856,351,261,207,54,90,51,39,21,0.0,0.0
1009,1504,25-09-2019 13:46:00,1,2957.0,2693.5,0.911,14.6335,500,314,254,60,186,137,49,46,0.07,0.0
1009,1505,25-09-2019 13:48:00,1,2909.0,2663.0,0.915,14.411,106,80,53,27,26,9,17,7,0.0,0.0
1009,1506,25-09-2019 13:50:00,1,3026.0,2721.0,0.899,14.937,253,200,138,62,53,24,29,3,0.0,0.0
1009,1507,25-09-2019 13:52:00,1,2917.0,2671.0,0.916,14.451,65,36,14,22,29,6,23,4,0.0,0.0
1009,1508,25-09-2019 13:54:00,1,2907.0,2655.0,0.913,14.394,33,11,0,11,22,0,22,0,0.0,0.0
1009,1509,25-09-2019 13:56:00,1,2920.0,2673.0,0.915,14.465,27,17,7,10,10,2,8,1,0.0,0.0
1009,1510,25-09-2019 13:58:00,1,2931.0,2679.0,0.914,14.515,24,22,3,19,2,2,0,0,0.0,0.0
1009,1511,25-09-2019 14:00:00,1,2811.0,2574.0,0.916,13.925,19,18,4,14,1,0,1,1,0.0,0.0
1009,1512,25-09-2019 14:02:00,1,2835.0,2560.0,0.903,14.003,10,10,0,10,0,0,0,0,0.01,0.0
1009,1513,25-09-2019 14:04:00,1,2744.0,2457.0,0.896,13.532,0,0,0,0,0,0,0,0,0.0,0.0
1009,1514,25-09-2019 14:06:00,1,2553.0,2306.0,0.903,12.614,0,0,0,0,0,0,0,0,0.0,0.0
1009,1515,25-09-2019 14:08:00,1,2363.0,2175.0,0.92,11.719,53,33,18,15,20,2,18,1,0.0,0.0
1009,1516,25-09-2019 14:10:00,1,2377.0,2144.0,0.902,11.741,0,0,0,0,0,0,0,0,0.0,0.0
1009,1517,25-09-2019 14:12:00,1,2401.0,2032.0,0.846,11.71,1,0,0,0,1,0,1,0,0.0,0.0
1009,1518,25-09-2019 14:14:00,1,2214.0,1924.0,0.869,10.852,21,16,8,8,5,0,5,0,0.0,0.0
1009,1519,25-09-2019 14:16:00,1,2116.0,1856.0,0.877,10.391,0,0,0,0,0,0,0,0,0.0,0.0
1009,1520,25-09-2019 14:18:00,1,2113.0,1860.0,0.88,10.382,17,17,14,3,0,0,0,0,0.0,0.0
1009,1521,25-09-2019 14:20:00,1,2159.5,1885.5,0.873,10.595,465,465,408,57,0,0,0,0,0.0,0.0
1009,1522,25-09-2019 14:22:00,1,2206.0,1911.0,0.866,10.808,9,7,2,5,2,0,2,0,0.0,0.0
1009,1523,25-09-2019 14:24:00,1,2218.0,1869.0,0.843,10.807,21,18,1,17,3,0,3,0,0.0,0.0
1009,1524,25-09-2019 14:26:00,1,2225.0,1887.0,0.848,10.857,18,18,1,17,0,0,0,0,0.0,0.0
1009,1525,25-09-2019 14:28:00,1,2234.0,1848.0,0.827,10.85,0,0,0,0,0,0,0,0,0.0,0.0
1009,1526,25-09-2019 14:30:00,1,2123.0,1802.0,0.849,10.36,6,6,3,3,0,0,0,0,0.0,0.0
1009,1527,25-09-2019 14:32:00,1,2035.0,1769.0,0.869,9.976,0,0,0,0,0,0,0,0,0.0,0.0
1009,1528,25-09-2019 14:34:00,1,1919.0,1754.0,0.914,9.503,0,0,0,0,0,0,0,0,0.01,0.0
1009,1529,25-09-2019 14:36:00,1,1911.0,1728.0,0.904,9.442,0,0,0,0,0,0,0,0,0.0,0.0
1009,1530,25-09-2019 14:38:00,1,2020.0,1749.0,0.866,9.897,0,0,0,0,0,0,0,0,0.0,0.0
1009,1531,25-09-2019 14:40:00,1,1919.0,1721.0,0.897,9.467,24,19,8,11,5,0,5,0,0.0,0.0
1009,1532,25-09-2019 14:42:00,1,1921.0,1732.0,0.901,9.487,3,2,0,2,1,0,1,0,0.0,0.0
1009,1533,25-09-2019 14:44:00,1,2138.0,1797.0,0.841,10.415,12,11,0,11,1,0,1,0,0.0,0.0
1009,1534,25-09-2019 14:46:00,1,2239.0,1783.0,0.796,10.796,3,2,0,2,1,0,1,0,0.0,0.0
1009,1535,25-09-2019 14:48:00,1,2239.0,1821.0,0.813,10.838,1,0,0,0,1,0,1,0,0.0,0.0
1009,1536,25-09-2019 14:50:00,1,2247.0,1814.0,0.807,10.861,0,0,0,0,0,0,0,0,0.0,0.0
1009,1537,25-09-2019 14:52:00,1,2240.0,1784.0,0.797,10.802,3,3,0,3,0,0,0,0,0.01,0.0
1009,1538,25-09-2019 14:54:00,1,2234.5,1812.5,0.8115,10.811,5,3,1,2,2,0,2,0,0.0,0.0
1009,1539,25-09-2019 14:56:00,1,2229.0,1841.0,0.826,10.82,2,1,0,1,1,0,1,0,0.0,0.0
1009,1540,25-09-2019 14:58:00,1,2225.0,1810.0,0.814,10.769,0,0,0,0,0,0,0,0,0.0,0.0
1009,1541,25-09-2019 15:00:00,1,2229.0,1801.0,0.808,10.777,84,55,29,26,29,3,26,34,0.0,0.0
1009,1542,25-09-2019 15:02:00,1,2423.0,1969.0,0.813,11.726,93,51,25,26,42,0,42,52,0.0,0.0
1009,1543,25-09-2019 15:04:00,1,2677.0,2311.0,0.863,13.106,105,60,32,28,45,4,41,74,0.0,0.02
1009,1544,25-09-2019 15:06:00,1,2862.0,2448.0,0.855,13.988,102,50,21,29,52,0,52,71,0.0,0.01
1009,1545,25-09-2019 15:08:00,1,2944.0,2592.0,0.88,14.471,79,43,17,26,36,6,30,68,0.0,0.0
1009,1546,25-09-2019 15:10:00,1,2865.0,2427.0,0.847,13.974,137,73,46,27,64,39,25,7,0.13,0.06
1009,1547,25-09-2019 15:12:00,1,1915.0,1784.0,0.932,9.519,39,36,8,28,3,1,2,1,0.0,0.0
1009,1548,25-09-2019 15:14:00,1,2030.0,1746.0,0.86,9.932,36,34,0,34,2,1,1,0,0.0,0.03
1009,1549,25-09-2019 15:16:00,1,2758.0,2406.0,0.872,13.528,27,19,3,16,8,3,5,1,0.0,0.0
1009,1550,25-09-2019 15:18:00,1,2858.0,2472.0,0.865,13.997,67,61,29,32,6,1,5,0,0.0,0.0
1009,1551,25-09-2019 15:20:00,1,2765.0,2449.0,0.886,13.607,42,38,18,20,4,1,3,0,0.0,0.0
1009,1552,25-09-2019 15:22:00,1,2817.0,2594.0,0.921,13.971,7,7,0,7,0,0,0,0,0.0,0.0
1009,1553,25-09-2019 15:24:00,1,2831.0,2554.0,0.902,13.981,8,8,0,8,0,0,0,0,0.0,0.0
1009,1554,25-09-2019 15:26:00,1,2854.0,2530.0,0.886,14.045,19,19,7,12,0,0,0,0,0.0,0.0
1009,1555,25-09-2019 15:28:00,1,2698.0,2455.0,0.911,13.348,0,0,0,0,0,0,0,0,0.0,0.0
1009,1556,25-09-2019 15:30:00,1,2542.0,2380.0,0.936,12.651,0,0,0,0,0,0,0,0,0.0,0.0
1009,1557,25-09-2019 15:32:00,1,2570.0,2257.0,0.878,12.623,0,0,0,0,0,0,0,0,0.0,0.0
1009,1558,25-09-2019 15:34:00,1,2368.0,2142.0,0.904,11.702,8,8,5,3,0,0,0,0,0.0,0.0
1009,1559,25-09-2019 15:36:00,1,2396.0,2080.0,0.868,11.743,0,0,0,0,0,0,0,0,0.0,0.0
1009,1560,25-09-2019 15:38:00,1,2181.0,2000.0,0.917,10.807,4,4,0,4,0,0,0,0,0.0,0.0
1009,1561,25-09-2019 15:40:00,1,2179.0,2001.0,0.918,10.801,23,18,6,12,5,3,2,0,0.0,0.0
1009,1562,25-09-2019 15:42:00,1,2376.0,2171.0,0.914,11.765,10,2,1,1,8,1,7,0,0.0,0.0
1009,1563,25-09-2019 15:44:00,1,2366.0,2199.0,0.929,11.755,2,0,0,0,2,0,2,0,0.0,0.0
1009,1564,25-09-2019 15:46:00,1,2373.0,2166.0,0.913,11.749,2,1,0,1,1,0,1,0,0.0,0.0
1009,1565,25-09-2019 15:48:00,1,2382.0,2149.0,0.902,11.763,0,0,0,0,0,0,0,0,0.0,0.0
1009,1566,25-09-2019 15:50:00,1,2392.0,2102.0,0.879,11.75,1,1,0,1,0,0,0,0,0.0,0.0
1009,1567,25-09-2019 15:52:00,1,2398.0,2086.0,0.87,11.759,16,13,8,5,3,0,3,0,0.0,0.0
1009,1568,25-09-2019 15:54:00,1,2398.0,2097.0,0.875,11.769,3,3,1,2,0,0,0,0,0.0,0.0
1009,1569,25-09-2019 15:56:00,1,2388.0,2062.0,0.863,11.692,1,1,0,1,0,0,0,0,0.0,0.0
1009,1570,25-09-2019 15:58:00,1,2399.0,2052.0,0.856,11.723,5,5,0,5,0,0,0,0,0.0,0.0
1009,1571,25-09-2019 16:00:00,1,2398.0,2064.0,0.861,11.732,2,2,0,2,0,0,0,0,0.0,0.0
1009,1572,25-09-2019 16:02:00,1,2397.0,2061.5,0.8605,11.7255,4,4,0,4,0,0,0,0,0.0,0.0
1009,1573,25-09-2019 16:04:00,1,2396.0,2059.0,0.86,11.719,102,67,40,27,35,7,28,30,0.0,0.0
1009,1574,25-09-2019 16:06:00,1,2369.0,2203.0,0.93,11.773,69,31,16,15,38,2,36,58,0.0,0.0
1009,1575,25-09-2019 16:08:00,1,2653.0,2416.0,0.911,13.128,56,21,9,12,35,2,33,57,0.0,0.04
1009,1576,25-09-2019 16:10:00,1,2640.0,2459.0,0.931,13.123,235,125,96,29,110,81,29,57,0.0,0.01
1009,1577,25-09-2019 16:12:00,1,2209.0,1921.0,0.87,10.831,40,28,16,12,12,0,12,1,0.0,0.01
1009,1578,25-09-2019 16:14:00,1,2408.0,2024.0,0.841,11.729,153,151,122,29,2,0,2,1,0.0,0.01
1009,1579,25-09-2019 16:16:00,1,2541.0,2385.0,0.939,12.651,28,26,11,15,2,1,1,0,0.0,0.0
1009,1580,25-09-2019 16:18:00,1,2839.0,2560.0,0.902,14.018,30,23,8,15,7,2,5,1,0.0,0.0
1009,1581,25-09-2019 16:20:00,1,2812.0,2686.0,0.955,14.053,23,14,0,14,9,0,9,0,0.0,0.0
1009,1582,25-09-2019 16:22:00,1,2914.0,2726.0,0.935,14.498,28,26,0,26,2,1,1,1,0.0,0.0
1009,1583,25-09-2019 16:24:00,1,3014.0,2763.0,0.917,14.933,62,52,37,15,10,2,8,1,0.0,0.0
1009,1584,25-09-2019 16:26:00,1,3006.0,2764.0,0.92,14.904,18,18,0,18,0,0,0,0,0.0,0.0
1009,1585,25-09-2019 16:28:00,1,2810.0,2640.0,0.939,13.995,27,27,0,27,0,0,0,0,0.0,0.0
1009,1586,25-09-2019 16:30:00,1,2743.0,2482.0,0.905,13.556,1,1,0,1,0,0,0,0,0.0,0.0
1009,1587,25-09-2019 16:32:00,1,2545.0,2357.0,0.926,12.635,0,0,0,0,0,0,0,0,0.0,0.0
1009,1588,25-09-2019 16:34:00,1,2455.0,2268.0,0.924,12.183,12,6,3,3,6,3,3,0,0.0,0.0
1009,1589,25-09-2019 16:36:00,1,2405.0,2218.5,0.9225,11.9325,0,0,0,0,0,0,0,0,0.0,0.0
1009,1590,25-09-2019 16:38:00,1,2355.0,2169.0,0.921,11.682,0,0,0,0,0,0,0,0,0.0,0.0
1009,1591,25-09-2019 16:40:00,1,2382.0,2150.0,0.903,11.764,0,0,0,0,0,0,0,0,0.0,0.0
1009,1592,25-09-2019 16:42:00,1,2381.0,2109.0,0.886,11.715,0,0,0,0,0,0,0,0,0.0,0.0
1009,1593,25-09-2019 16:44:00,1,2392.0,2073.0,0.866,11.721,72,51,36,15,21,3,18,27,0.0,0.0
1009,1594,25-09-2019 16:46:00,1,2368.0,2189.0,0.924,11.754,105,60,22,38,45,1,44,72,0.0,0.0
1009,1595,25-09-2019 16:48:00,1,2853.0,2512.0,0.881,14.02,95,50,26,24,45,1,44,62,0.0,0.0
1009,1596,25-09-2019 16:50:00,1,2835.0,2572.0,0.907,14.017,79,40,15,25,39,2,37,60,0.0,0.0
1009,1597,25-09-2019 16:52:00,1,2835.0,2577.0,0.909,14.021,98,43,19,24,55,27,28,50,0.0,0.0
1009,1598,25-09-2019 16:54:00,1,2842.0,2531.0,0.891,13.998,145,24,10,14,121,85,36,26,0.0,0.15
1009,1599,25-09-2019 16:56:00,1,2821.0,2585.0,0.916,13.977,161,75,54,21,86,49,37,36,0.02,0.02
1009,1600,25-09-2019 16:58:00,1,2174.0,2006.0,0.923,10.787,507,332,262,70,175,124,51,14,0.0,0.03
1009,1601,25-09-2019 17:00:00,1,2461.0,2255.0,0.916,12.193,849,622,519,103,227,156,71,35,0.0,0.0
1009,1602,25-09-2019 17:02:00,1,2391.0,2113.0,0.884,11.761,584,362,292,70,222,171,51,11,0.07,0.09
1009,1603,25-09-2019 17:04:00,1,2821.0,2603.0,0.923,13.996,185,102,70,32,83,52,31,12,0.0,0.0
1009,1604,25-09-2019 17:06:00,1,1914.0,1709.0,0.893,9.435,72,54,24,30,18,5,13,3,0.0,0.0
1009,1605,25-09-2019 17:08:00,1,1739.0,1544.0,0.888,8.562,9,9,5,4,0,0,0,0,0.0,0.0
1009,1606,25-09-2019 17:10:00,1,1758.5,1488.5,0.847,8.5765,2,1,0,1,1,1,0,0,0.0,0.0
1009,1607,25-09-2019 17:12:00,1,1778.0,1433.0,0.806,8.591,0,0,0,0,0,0,0,0,0.0,0.0
1009,1608,25-09-2019 17:14:00,1,1780.0,1405.0,0.789,8.569,2,0,0,0,2,0,2,0,0.0,0.0
1009,1609,25-09-2019 17:16:00,1,1766.0,1456.0,0.824,8.572,0,0,0,0,0,0,0,0,0.0,0.0
1009,1610,25-09-2019 17:18:00,1,1949.0,1616.0,0.829,9.467,10,1,0,1,9,0,9,0,0.0,0.0
1009,1611,25-09-2019 17:20:00,1,2386.0,2141.0,0.897,11.77,14,5,2,3,9,3,6,0,0.0,0.0
1009,1612,25-09-2019 17:22:00,1,3003.0,2824.0,0.941,14.958,13,12,5,7,1,0,1,0,0.0,0.0
1009,1613,25-09-2019 17:24:00,1,3263.0,3138.0,0.962,16.328,43,21,9,12,22,1,21,0,0.03,0.0
1009,1614,25-09-2019 17:26:00,1,3250.0,3121.0,0.96,16.262,3,1,0,1,2,0,2,0,0.0,0.0
1009,1615,25-09-2019 17:28:00,1,2961.0,2964.0,1.001,14.946,3,0,0,0,3,0,3,0,0.0,0.0
1009,1616,25-09-2019 17:30:00,1,2888.0,2795.0,0.968,14.472,12,9,7,2,3,1,2,0,0.0,0.0
1009,1617,25-09-2019 17:32:00,1,2779.0,2787.0,1.003,14.034,0,0,0,0,0,0,0,0,0.0,0.0
1009,1618,25-09-2019 17:34:00,1,2802.0,2672.0,0.954,13.997,2,2,1,1,0,0,0,0,0.0,0.0
1009,1619,25-09-2019 17:36:00,1,2710.0,2594.0,0.957,13.548,0,0,0,0,0,0,0,0,0.0,0.0
1009,1620,25-09-2019 17:38:00,1,2817.0,2648.0,0.94,14.029,0,0,0,0,0,0,0,0,0.0,0.0
1009,1621,25-09-2019 17:40:00,1,2821.0,2625.0,0.931,14.021,0,0,0,0,0,0,0,0,0.0,0.0
1009,1622,25-09-2019 17:42:00,1,2824.0,2601.0,0.921,14.007,3,3,1,2,0,0,0,0,0.0,0.0
1009,1623,25-09-2019 17:44:00,1,2726.0,2566.5,0.9425,13.582,0,0,0,0,0,0,0,0,0.0,0.0
1009,1624,25-09-2019 17:46:00,1,2628.0,2532.0,0.964,13.157,0,0,0,0,0,0,0,0,0.0,0.0
1009,1625,25-09-2019 17:48:00,1,2517.0,2441.0,0.97,12.617,8,3,1,2,5,3,2,0,0.0,0.0
1009,1626,25-09-2019 17:50:00,1,2542.0,2404.0,0.946,12.678,26,21,7,14,5,0,5,0,0.0,0.0
1009,1627,25-09-2019 17:52:00,1,2544.0,2385.0,0.938,12.663,27,27,0,27,0,0,0,6,0.0,0.0
1009,1628,25-09-2019 17:54:00,1,2617.0,2498.0,0.954,13.075,45,30,4,26,15,2,13,2,0.0,0.0
1009,1629,25-09-2019 17:56:00,1,2817.0,2617.0,0.929,13.996,53,27,6,21,26,2,24,4,0.0,0.0
1009,1630,25-09-2019 17:58:00,1,2802.0,2681.0,0.957,14.01,46,40,14,26,6,0,6,3,0.0,0.0
1009,1631,25-09-2019 18:00:00,0,2776.0,2733.0,0.984,13.965,278,176,119,57,102,72,30,31,0.0,0.0
1009,1632,25-09-2019 18:02:00,0,2772.0,2757.0,0.995,13.973,259,102,74,28,157,114,43,100,0.0,0.0
1009,1633,25-09-2019 18:04:00,0,2792.0,2683.0,0.961,13.972,130,61,40,21,69,36,33,68,0.0,0.0
1009,1634,25-09-2019 18:06:00,0,2982.0,2872.0,0.963,14.929,122,88,48,40,34,16,18,52,0.0,0.0
1009,1635,25-09-2019 18:08:00,0,3191.0,2920.0,0.915,15.805,197,132,104,28,65,42,23,62,0.0,0.01
1009,1636,25-09-2019 18:10:00,0,2969.0,2897.0,0.976,14.905,187,98,68,30,89,56,33,101,0.0,0.0
1009,1637,25-09-2019 18:12:00,0,2393.0,2112.0,0.883,11.766,223,111,78,33,112,71,41,56,0.03,0.0
1009,1638,25-09-2019 18:14:00,0,2621.0,2451.0,0.935,13.04,95,54,34,20,41,18,23,28,0.0,0.0
1009,1639,25-09-2019 18:16:00,0,3281.0,2970.0,0.905,16.215,77,32,18,14,45,31,14,15,0.0,0.0
1009,1640,25-09-2019 18:18:00,0,2749.5,2439.0,0.8825,13.533,68,53,26,27,15,6,9,2,0.0,0.0
1009,1641,25-09-2019 18:20:00,0,2218.0,1908.0,0.86,10.851,104,72,33,39,32,0,32,2,0.0,0.0
1009,1642,25-09-2019 18:22:00,0,2759.0,2450.0,0.888,13.582,69,39,16,23,30,2,28,4,0.0,0.0
1009,1643,25-09-2019 18:24:00,0,3448.0,3205.0,0.93,17.135,90,55,32,23,35,2,33,14,0.0,0.0
1009,1644,25-09-2019 18:26:00,0,3444.0,3269.0,0.949,17.186,186,102,72,30,84,44,40,68,0.0,0.0
1009,1645,25-09-2019 18:28:00,0,3280.0,3047.0,0.929,16.295,96,35,16,19,61,37,24,29,0.0,0.0
1009,1646,25-09-2019 18:30:00,0,3446.0,3175.0,0.921,17.093,135,84,56,28,51,19,32,63,0.0,0.02
1009,1647,25-09-2019 18:32:00,0,3427.0,3325.0,0.97,17.183,146,89,55,34,57,24,33,61,0.0,0.09
1009,1648,25-09-2019 18:34:00,0,3630.0,3423.0,0.943,18.092,56,29,18,11,27,2,25,45,0.0,0.09
1009,1649,25-09-2019 18:36:00,0,3624.0,3408.0,0.94,18.05,102,45,29,16,57,35,22,3,0.16,0.06
1009,1650,25-09-2019 18:38:00,0,2988.0,2806.0,0.939,14.881,41,23,9,14,18,4,14,2,0.0,0.0
1009,1651,25-09-2019 18:40:00,0,2451.0,2268.0,0.925,12.17,3,2,0,2,1,0,1,0,0.0,0.0
1009,1652,25-09-2019 18:42:00,0,2370.0,2192.0,0.925,11.766,7,5,2,3,2,0,2,0,0.0,0.0
1009,1653,25-09-2019 18:44:00,0,2377.0,2123.0,0.893,11.717,32,22,16,6,10,4,6,0,0.0,0.0
1009,1654,25-09-2019 18:46:00,0,2407.0,2082.0,0.865,11.79,10,0,0,0,10,0,10,0,0.0,0.01
1009,1655,25-09-2019 18:48:00,0,2198.0,1957.0,0.891,10.825,9,4,1,3,5,0,5,0,0.0,0.0
1009,1656,25-09-2019 18:50:00,0,2219.0,1877.0,0.846,10.823,3,1,0,1,2,0,2,0,0.0,0.0
1009,1657,25-09-2019 18:52:00,0,2221.0,1880.0,0.8465,10.834,14,7,2,5,7,0,7,0,0.0,0.0
1009,1658,25-09-2019 18:54:00,0,2223.0,1883.0,0.847,10.845,6,6,1,5,0,0,0,0,0.0,0.0
1009,1659,25-09-2019 18:56:00,0,2213.0,1935.0,0.875,10.861,3,3,1,2,0,0,0,0,0.0,0.0
1009,1660,25-09-2019 18:58:00,0,2290.0,2024.0,0.884,11.263,26,21,16,5,5,0,5,3,0.0,0.0
1009,1661,25-09-2019 19:00:00,0,2980.0,2813.0,0.944,14.857,125,81,52,29,44,21,23,53,0.0,0.03
1009,1662,25-09-2019 19:02:00,0,3385.0,3421.0,1.011,17.125,29,12,10,2,17,14,3,11,0.0,0.4
1009,1663,25-09-2019 19:04:00,0,2387.0,2145.0,0.898,11.78,224,98,74,24,126,95,31,15,0.03,0.0
1009,1664,25-09-2019 19:06:00,0,3405.0,3388.0,0.995,17.164,306,161,117,44,145,110,35,112,0.07,0.02
1009,1665,25-09-2019 19:08:00,0,3582.0,3630.0,1.013,18.132,286,131,97,34,155,107,48,73,0.0,0.0
1009,1666,25-09-2019 19:10:00,0,4047.0,4030.0,0.996,20.407,108,58,45,13,50,38,12,128,0.0,0.0
1009,1667,25-09-2019 19:12:00,0,3319.0,3229.0,0.973,16.653,26,19,10,9,7,3,4,1,0.0,0.0
1009,1668,25-09-2019 19:14:00,0,2782.0,2726.0,0.98,13.98,222,107,78,29,115,72,43,65,0.02,0.0
1009,1669,25-09-2019 19:16:00,0,3672.0,3685.0,1.003,18.548,163,80,59,21,83,59,24,61,0.0,0.0
1009,1670,25-09-2019 19:18:00,0,4036.0,4006.0,0.993,20.338,253,135,108,27,118,85,33,65,0.04,0.0
1009,1671,25-09-2019 19:20:00,0,3847.0,3892.0,1.012,19.465,110,76,63,13,34,21,13,20,0.0,0.0
1009,1672,25-09-2019 19:22:00,0,3388.0,3502.0,1.034,17.225,3,0,0,0,3,0,3,0,0.0,0.0
1009,1673,25-09-2019 19:24:00,0,2870.0,2821.0,0.983,14.43,36,23,13,10,13,4,9,0,0.0,0.0
1009,1674,25-09-2019 19:26:00,0,2922.5,2824.5,0.967,14.641,13,4,3,1,9,3,6,0,0.0,0.0
1009,1675,25-09-2019 19:28:00,0,2975.0,2828.0,0.951,14.852,25,5,1,4,20,1,19,1,0.0,0.0
1009,1676,25-09-2019 19:30:00,0,4040.0,3942.0,0.976,20.282,200,91,63,28,109,70,39,15,0.06,0.0
1009,1677,25-09-2019 19:32:00,0,4119.0,4126.0,1.002,20.797,91,56,32,24,35,16,19,67,0.02,0.0
1009,1678,25-09-2019 19:34:00,0,3865.0,3816.0,0.987,19.451,345,270,219,51,75,58,17,29,0.0,0.0
1009,1679,25-09-2019 19:36:00,0,3762.0,3754.0,0.998,18.978,207,119,88,31,88,63,25,25,0.06,0.0
1009,1680,25-09-2019 19:38:00,0,2967.0,2900.0,0.977,14.901,66,44,20,24,22,6,16,3,0.0,0.0
1009,1681,25-09-2019 19:40:00,0,3067.0,2987.0,0.974,15.389,280,111,78,33,169,119,50,15,0.05,0.0
1009,1682,25-09-2019 19:42:00,0,3476.0,3492.0,1.005,17.561,52,37,25,12,15,9,6,8,0.0,0.0
1009,1683,25-09-2019 19:44:00,0,2766.0,2853.0,1.032,14.055,56,45,16,29,11,4,7,3,0.0,0.0
1009,1684,25-09-2019 19:46:00,0,2801.0,2648.0,0.945,13.968,102,89,43,46,13,2,11,2,0.0,0.0
1009,1685,25-09-2019 19:48:00,0,3600.0,3532.0,0.981,18.095,202,109,72,37,93,70,23,70,0.01,0.0
1009,1686,25-09-2019 19:50:00,0,3997.0,4129.0,1.033,20.317,91,57,42,15,34,22,12,21,0.0,0.0
1009,1687,25-09-2019 19:52:00,0,3238.0,3158.0,0.975,16.254,29,9,4,5,20,9,11,0,0.0,0.0
1009,1688,25-09-2019 19:54:00,0,2773.0,2829.0,1.02,14.059,0,0,0,0,0,0,0,0,0.0,0.0
1009,1689,25-09-2019 19:56:00,0,2495.0,2557.0,1.025,12.66,0,0,0,0,0,0,0,0,0.0,0.0
1009,1690,25-09-2019 19:58:00,0,2527.0,2444.0,0.967,12.661,1,0,0,0,1,1,0,0,0.0,0.0
1009,1691,25-09-2019 20:00:00,0,2533.0,2418.0,0.9545,12.656,5,0,0,0,5,0,5,0,0.0,0.0
1009,1692,25-09-2019 20:02:00,0,2539.0,2392.0,0.942,12.651,2,0,0,0,2,0,2,0,0.0,0.0
1009,1693,25-09-2019 20:04:00,0,2542.0,2394.0,0.942,12.664,6,1,1,0,5,0,5,0,0.0,0.0
1009,1694,25-09-2019 20:06:00,0,2607.0,2536.0,0.973,13.077,61,49,28,21,12,4,8,0,0.0,0.0
1009,1695,25-09-2019 20:08:00,0,3397.0,3443.0,1.014,17.198,107,92,52,40,15,0,15,2,0.0,0.0
1009,1696,25-09-2019 20:10:00,0,3578.0,3545.0,0.991,18.021,73,35,11,24,38,2,36,0,0.0,0.0
1009,1697,25-09-2019 20:12:00,0,3476.0,3525.0,1.014,17.597,224,141,106,35,83,48,35,71,0.0,0.0
1009,1698,25-09-2019 20:14:00,0,3500.0,3514.0,1.004,17.68,83,39,10,29,44,4,40,79,0.0,0.0
1009,1699,25-09-2019 20:16:00,0,3600.0,3528.0,0.98,18.088,114,81,40,41,33,17,16,51,0.0,0.0
1009,1700,25-09-2019 20:18:00,0,3412.0,3423.0,1.003,17.234,200,105,76,29,95,55,40,94,0.0,0.02
1009,1701,25-09-2019 20:20:00,0,3572.0,3644.0,1.02,18.107,273,150,108,42,123,95,28,72,0.09,0.02
1009,1702,25-09-2019 20:22:00,0,3399.0,3433.0,1.01,17.191,134,98,55,43,36,10,26,61,0.0,0.0
1009,1703,25-09-2019 20:24:00,0,3586.0,3570.0,0.995,18.08,143,83,57,26,60,15,45,90,0.0,0.08
1009,1704,25-09-2019 20:26:00,0,3576.0,3606.0,1.009,18.081,249,135,102,33,114,75,39,92,0.08,0.0
1009,1705,25-09-2019 20:28:00,0,3491.0,3456.0,0.99,17.58,53,28,23,5,25,20,5,30,0.0,0.0
1009,1706,25-09-2019 20:30:00,0,2332.0,2296.0,0.985,11.729,32,26,9,17,6,5,1,0,0.0,0.0
1009,1707,25-09-2019 20:32:00,0,2361.0,2199.0,0.931,11.738,6,6,0,6,0,0,0,0,0.0,0.0
1009,1708,25-09-2019 20:34:00,0,2364.0,2193.5,0.9275,11.744,12,12,6,6,0,0,0,0,0.0,0.0
1009,1709,25-09-2019 20:36:00,0,2367.0,2188.0,0.924,11.75,12,3,0,3,9,1,8,0,0.0,0.0
1009,1710,25-09-2019 20:38:00,0,2367.0,2244.0,0.948,11.809,4,1,0,1,3,0,3,0,0.0,0.0
1009,1711,25-09-2019 20:40:00,0,2430.0,2315.0,0.953,12.136,115,45,26,19,70,34,36,32,0.0,0.0
1009,1712,25-09-2019 20:42:00,0,3442.0,3233.0,0.939,17.14,116,87,46,41,29,5,24,52,0.0,0.0
1009,1713,25-09-2019 20:44:00,0,3586.0,3571.0,0.996,18.083,130,82,47,35,48,18,30,62,0.0,0.0
1009,1714,25-09-2019 20:46:00,0,3875.0,3803.0,0.982,19.476,204,99,71,28,105,72,33,51,0.06,0.09
1009,1715,25-09-2019 20:48:00,0,3046.0,3003.0,0.986,15.326,18,13,6,7,5,1,4,1,0.0,0.0
1009,1716,25-09-2019 20:50:00,0,2523.0,2438.0,0.966,12.638,67,49,24,25,18,2,16,4,0.0,0.0
1009,1717,25-09-2019 20:52:00,0,2359.0,2226.0,0.943,11.758,195,120,92,28,75,50,25,75,0.0,0.0
1009,1718,25-09-2019 20:54:00,0,4346.0,4218.0,0.971,21.793,148,95,70,25,53,32,21,59,0.0,0.0
1009,1719,25-09-2019 20:56:00,0,4034.0,4051.0,1.004,20.379,96,72,45,27,24,2,22,42,0.0,0.12
1009,1720,25-09-2019 20:58:00,0,4035.0,3947.0,0.978,20.268,118,68,50,18,50,25,25,34,0.07,0.05
1009,1721,25-09-2019 21:00:00,0,3860.0,3839.0,0.995,19.457,370,198,148,50,172,127,45,94,0.02,0.03
1009,1722,25-09-2019 21:02:00,0,4393.0,4345.0,0.989,22.118,234,130,95,35,104,69,35,67,0.0,0.0
1009,1723,25-09-2019 21:04:00,0,3760.0,3712.0,0.987,18.925,160,93,60,33,67,33,34,70,0.0,0.0
1009,1724,25-09-2019 21:06:00,0,4333.0,4212.0,0.972,21.735,124,81,53,28,43,8,35,53,0.0,0.0
1009,1725,25-09-2019 21:08:00,0,4323.0,4231.0,0.9785,21.717,273,127,101,26,146,105,41,43,0.03,0.08
1009,1726,25-09-2019 21:10:00,0,4313.0,4250.0,0.985,21.699,217,86,51,35,131,90,41,15,0.04,0.0
1009,1727,25-09-2019 21:12:00,0,4324.0,4255.0,0.984,21.747,239,152,110,42,87,62,25,78,0.0,0.0
1009,1728,25-09-2019 21:14:00,0,3257.0,3075.0,0.944,16.236,202,109,86,23,93,60,33,41,0.0,0.0
1009,1729,25-09-2019 21:16:00,0,2621.0,2532.0,0.966,13.13,67,42,24,18,25,9,16,2,0.0,0.0
1009,1730,25-09-2019 21:18:00,0,2453.0,2319.0,0.946,12.231,70,39,20,19,31,6,25,11,0.0,0.0
1009,1731,25-09-2019 21:20:00,0,2720.0,2518.0,0.926,13.502,197,98,67,31,99,68,31,48,0.0,0.0
1009,1732,25-09-2019 21:22:00,0,3584.0,3559.0,0.993,18.061,50,32,17,15,18,4,14,0,0.0,0.0
1009,1733,25-09-2019 21:24:00,0,3258.0,3117.0,0.957,16.288,32,21,11,10,11,4,7,0,0.0,0.0
1009,1734,25-09-2019 21:26:00,0,3265.0,3045.0,0.932,16.236,4,3,0,3,1,0,1,0,0.0,0.0
1009,1735,25-09-2019 21:28:00,0,3158.0,3026.0,0.958,15.791,2,2,0,2,0,0,0,0,0.0,0.0
1009,1736,25-09-2019 21:30:00,0,2952.0,2975.0,1.008,14.925,0,0,0,0,0,0,0,0,0.0,0.0
1009,1737,25-09-2019 21:32:00,0,2970.0,2942.0,0.991,14.958,8,5,2,3,3,0,3,0,0.0,0.0
1009,1738,25-09-2019 21:34:00,0,3424.0,3291.0,0.961,17.136,2,2,0,2,0,0,0,0,0.0,0.0
1009,1739,25-09-2019 21:36:00,0,3767.0,3753.0,0.996,18.995,4,3,0,3,1,0,1,0,0.0,0.0
1009,1740,25-09-2019 21:38:00,0,3589.0,3580.0,0.997,18.104,15,11,6,5,4,2,2,0,0.0,0.0
1009,1741,25-09-2019 21:40:00,0,3368.0,3464.0,1.029,17.105,1,1,1,0,0,0,0,0,0.0,0.0
1009,1742,25-09-2019 21:42:00,0,3198.5,3268.0,1.0215,16.2195,0,0,0,0,0,0,0,0,0.0,0.0
1009,1743,25-09-2019 21:44:00,0,3029.0,3072.0,1.014,15.334,22,10,5,5,12,0,12,1,0.0,0.0
1009,1744,25-09-2019 21:46:00,0,2961.0,2964.0,1.001,14.947,151,78,44,34,73,41,32,40,0.0,0.0
1009,1745,25-09-2019 21:48:00,0,3054.0,3038.0,0.995,15.397,109,61,30,31,48,4,44,73,0.0,0.0
1009,1746,25-09-2019 21:50:00,0,3399.0,3385.0,0.996,17.14,114,69,34,35,45,10,35,76,0.0,0.0
1009,1747,25-09-2019 21:52:00,0,3495.0,3501.0,1.002,17.644,138,77,46,31,61,29,32,58,0.14,0.18
1009,1748,25-09-2019 21:54:00,0,3582.0,3598.0,1.004,18.094,250,140,100,40,110,68,42,50,0.0,0.03
1009,1749,25-09-2019 21:56:00,0,3377.0,3406.0,1.009,17.077,313,154,126,28,159,123,36,115,0.0,0.0
1009,1750,25-09-2019 21:58:00,0,3425.0,3322.0,0.97,17.173,95,70,43,27,25,1,24,67,0.0,0.0
1009,1751,25-09-2019 22:00:00,0,3561.0,3645.0,1.023,18.065,203,147,115,32,56,28,28,96,0.0,0.01
1009,1752,25-09-2019 22:02:00,0,3417.0,3312.0,0.969,17.128,276,109,88,21,167,122,45,82,0.08,0.01
1009,1753,25-09-2019 22:04:00,0,3859.0,3799.0,0.984,19.412,214,100,68,32,114,50,64,80,0.0,0.0
1009,1754,25-09-2019 22:06:00,0,3870.0,3747.0,0.968,19.398,180,107,72,35,73,43,30,56,0.1,0.1
1009,1755,25-09-2019 22:08:00,0,4335.0,4223.0,0.974,21.756,280,135,95,40,145,100,45,44,0.0,0.0
1009,1756,25-09-2019 22:10:00,0,3431.0,3327.0,0.97,17.2,155,89,61,28,66,46,20,66,0.0,0.0
1009,1757,25-09-2019 22:12:00,0,3759.0,3693.0,0.983,18.898,106,56,26,30,50,6,44,66,0.0,0.0
1009,1758,25-09-2019 22:14:00,0,3778.0,3691.0,0.977,18.973,130,67,42,25,63,23,40,60,0.15,0.14
1009,1759,25-09-2019 22:16:00,0,3155.0,3065.0,0.97,15.8245,85,52,32,20,33,10,23,6,0.0,0.0
1009,1760,25-09-2019 22:18:00,0,2532.0,2439.0,0.963,12.676,176,107,84,23,69,44,25,83,0.0,0.02
1009,1761,25-09-2019 22:20:00,0,2622.0,2551.0,0.973,13.155,21,21,6,15,0,0,0,0,0.0,0.0
1009,1762,25-09-2019 22:22:00,0,2516.0,2488.0,0.989,12.667,155,87,55,32,68,45,23,15,0.0,0.0
1009,1763,25-09-2019 22:24:00,0,3507.0,3416.0,0.974,17.6,344,174,133,41,170,130,40,46,0.0,0.01
1009,1764,25-09-2019 22:26:00,0,3406.0,3386.0,0.994,17.169,492,215,148,67,277,210,67,29,0.0,0.0
1009,1765,25-09-2019 22:28:00,0,2634.0,2459.0,0.934,13.1,500,201,148,53,299,234,65,31,0.0,0.0
1009,1766,25-09-2019 22:30:00,0,3538.0,3334.0,0.942,17.632,884,504,406,98,380,290,90,25,0.0,0.02
1009,1767,25-09-2019 22:32:00,0,4473.0,4413.0,0.986,22.509,86,45,23,22,41,1,40,69,0.0,0.03
1009,1768,25-09-2019 22:34:00,0,4463.0,4563.0,1.022,22.636,153,96,55,41,57,25,32,54,0.0,0.03
1009,1769,25-09-2019 22:36:00,0,4640.0,4734.0,1.02,23.523,269,138,101,37,131,91,40,21,0.0,0.01
1009,1770,25-09-2019 22:38:00,0,3576.0,3556.0,0.994,18.028,110,63,35,28,47,13,34,2,0.0,0.0
1009,1771,25-09-2019 22:40:00,0,2956.0,2889.0,0.977,14.845,263,203,156,47,60,26,34,4,0.0,0.0
1009,1772,25-09-2019 22:42:00,0,3277.0,3075.0,0.938,16.317,818,442,360,82,376,295,81,76,0.04,0.0
1009,1773,25-09-2019 22:44:00,0,4400.0,4373.0,0.994,22.175,989,600,497,103,389,301,88,36,0.0,0.02
1009,1774,25-09-2019 22:46:00,0,4668.0,4640.0,0.994,23.529,114,58,38,20,56,18,38,91,0.0,0.03
1009,1775,25-09-2019 22:48:00,0,4315.0,4306.0,0.998,21.766,82,42,21,21,40,0,40,73,0.01,0.13
1009,1776,25-09-2019 22:50:00,0,4388.0,4426.5,1.0085,22.1885,116,55,39,16,61,44,17,26,0.09,0.0
1009,1777,25-09-2019 22:52:00,0,4461.0,4547.0,1.019,22.611,363,193,151,42,170,120,50,31,0.07,0.0
1009,1778,25-09-2019 22:54:00,0,2976.0,2880.0,0.968,14.913,90,76,42,34,14,0,14,1,0.0,0.0
1009,1779,25-09-2019 22:56:00,0,2340.0,2249.0,0.961,11.709,58,29,9,20,29,0,29,0,0.0,0.0
1009,1780,25-09-2019 22:58:00,0,2530.0,2440.0,0.965,12.667,51,29,11,18,22,0,22,0,0.0,0.0
1009,1781,25-09-2019 23:00:00,0,2639.0,2442.0,0.925,13.102,68,54,17,37,14,0,14,0,0.0,0.0
1009,1782,25-09-2019 23:02:00,0,3351.0,3165.0,0.945,16.705,208,160,122,38,48,25,23,0,0.0,0.0
1009,1783,25-09-2019 23:04:00,0,4469.0,4541.0,1.016,22.633,780,464,386,78,316,239,77,17,0.0,0.0
1009,1784,25-09-2019 23:06:00,0,4493.0,4461.0,0.993,22.639,747,455,375,80,292,226,66,25,0.01,0.02
1009,1785,25-09-2019 23:08:00,0,4475.0,4430.0,0.99,22.535,1154,614,515,99,540,427,113,48,0.0,0.0
1009,1786,25-09-2019 23:10:00,0,4291.0,4325.0,1.008,21.693,449,250,196,54,199,147,52,64,0.04,0.0
1009,1787,25-09-2019 23:12:00,0,4038.0,4019.0,0.995,20.357,72,43,22,21,29,9,20,2,0.01,0.0
1009,1788,25-09-2019 23:14:00,0,4031.0,4025.0,0.999,20.336,94,85,49,36,9,0,9,2,0.0,0.0
1009,1789,25-09-2019 23:16:00,0,4038.0,4027.0,0.997,20.369,0,0,0,0,0,0,0,0,0.02,0.0
1009,1790,25-09-2019 23:18:00,0,3849.0,3872.0,1.006,19.45,1,1,0,1,0,0,0,0,0.0,0.0
1009,1791,25-09-2019 23:20:00,0,3662.0,3710.0,1.013,18.534,0,0,0,0,0,0,0,0,0.0,0.0
1009,1792,25-09-2019 23:22:00,0,3604.0,3501.0,0.971,18.076,4,4,0,4,0,0,0,0,0.0,0.0
1009,1793,25-09-2019 23:24:00,0,3419.5,3324.0,0.972,17.1525,8,8,0,8,0,0,0,0,0.0,0.0
1009,1794,25-09-2019 23:26:00,0,3235.0,3147.0,0.973,16.229,8,7,5,2,1,0,1,0,0.0,0.0
1009,1795,25-09-2019 23:28:00,0,3042.0,3039.0,0.999,15.349,0,0,0,0,0,0,0,0,0.0,0.0
1009,1796,25-09-2019 23:30:00,0,2965.0,2944.0,0.993,14.943,10,9,4,5,1,0,1,0,0.0,0.0
1009,1797,25-09-2019 23:32:00,0,2977.0,2886.0,0.969,14.925,6,5,4,1,1,0,1,0,0.0,0.0
1009,1798,25-09-2019 23:34:00,0,2769.0,2784.0,1.005,13.992,23,17,9,8,6,2,4,2,0.0,0.0
1009,1799,25-09-2019 23:36:00,0,2795.0,2731.0,0.977,14.035,19,14,6,8,5,0,5,0,0.0,0.0
1009,1800,25-09-2019 23:38:00,0,2804.0,2645.0,0.943,13.977,1,1,1,0,0,0,0,0,0.0,0.0
1009,1801,25-09-2019 23:40:00,0,2698.0,2624.0,0.972,13.535,0,0,0,0,0,0,0,0,0.0,0.0
1009,1802,25-09-2019 23:42:00,0,2491.0,2572.0,1.033,12.66,0,0,0,0,0,0,0,0,0.0,0.0
1009,1803,25-09-2019 23:44:00,0,2502.0,2544.0,1.017,12.675,0,0,0,0,0,0,0,0,0.0,0.0
1009,1804,25-09-2019 23:46:00,0,2516.0,2453.0,0.975,12.627,2,2,1,1,0,0,0,0,0.0,0.0
1009,1805,25-09-2019 23:48:00,0,2430.0,2407.0,0.991,12.238,0,0,0,0,0,0,0,0,0.0,0.0
1009,1806,25-09-2019 23:50:00,0,2423.0,2391.0,0.987,12.195,0,0,0,0,0,0,0,0,0.0,0.0
1009,1807,25-09-2019 23:52:00,0,2511.0,2514.0,1.001,12.676,21,19,11,8,2,2,0,0,0.0,0.0
1009,1808,25-09-2019 23:54:00,0,2492.0,2576.0,1.034,12.669,193,104,60,44,89,59,30,35,0.0,0.21
1009,1809,25-09-2019 23:56:00,0,2589.0,2641.0,1.02,13.124,5,5,3,2,0,0,0,0,0.0,0.0
1009,1810,25-09-2019 23:58:00,0,2765.5,2824.0,1.021,14.0215,21,14,5,9,7,3,4,0,0.0,0.0
1009,1811,26-09-2019 00:00:00,0,2942.0,3007.0,1.022,14.919,248,120,85,35,128,85,43,30,0.0,0.01
1009,1812,26-09-2019 00:02:00,0,2948.0,3008.0,1.02,14.945,385,202,153,49,183,134,49,86,0.04,0.0
1009,1813,26-09-2019 00:04:00,0,3031.0,3129.0,1.032,15.407,527,245,196,49,282,210,72,65,0.0,0.04
1009,1814,26-09-2019 00:06:00,0,3413.0,3357.0,0.983,17.164,284,124,92,32,160,118,42,52,0.05,0.0
1009,1815,26-09-2019 00:08:00,0,3382.0,3517.0,1.04,17.22,207,100,67,33,107,80,27,45,0.04,0.0
1009,1816,26-09-2019 00:10:00,0,3024.0,3145.0,1.04,15.395,180,110,81,29,70,41,29,86,0.0,0.0
1009,1817,26-09-2019 00:12:00,0,3255.0,3160.0,0.971,16.323,214,99,69,30,115,71,44,8,0.1,0.0
1009,1818,26-09-2019 00:14:00,0,2793.0,2736.0,0.98,14.032,258,125,88,37,133,88,45,32,0.0,0.0
1009,1819,26-09-2019 00:16:00,0,3425.0,3321.0,0.97,17.17,398,201,166,35,197,153,44,124,0.0,0.0
1009,1820,26-09-2019 00:18:00,0,3393.0,3454.0,1.018,17.191,45,24,13,11,21,3,18,0,0.0,0.0
1009,1821,26-09-2019 00:20:00,0,3384.0,3468.0,1.025,17.17,52,24,11,13,28,0,28,2,0.0,0.0
1009,1822,26-09-2019 00:22:00,0,3583.0,3579.0,0.999,18.078,51,39,20,19,12,2,10,0,0.0,0.0
1009,1823,26-09-2019 00:24:00,0,3592.0,3523.0,0.981,18.053,43,19,5,14,24,0,24,0,0.0,0.0
1009,1824,26-09-2019 00:26:00,0,3391.0,3490.0,1.029,17.223,53,35,14,21,18,0,18,0,0.0,0.0
1009,1825,26-09-2019 00:28:00,0,3401.0,3438.0,1.011,17.207,58,52,25,27,6,0,6,0,0.0,0.0
1009,1826,26-09-2019 00:30:00,0,3412.0,3379.0,0.99,17.183,734,419,335,84,315,232,83,15,0.0,0.0
1009,1827,26-09-2019 00:32:00,0,3425.0,3325.5,0.971,17.176,865,610,502,108,255,186,69,69,0.0,0.03
1009,1828,26-09-2019 00:34:00,0,3438.0,3272.0,0.952,17.169,845,546,451,95,299,230,69,35,0.0,0.0
1009,1829,26-09-2019 00:36:00,0,3393.0,3399.0,1.002,17.133,71,18,12,6,53,8,45,0,0.0,0.0
1009,1830,26-09-2019 00:38:00,0,3403.0,3380.0,0.993,17.148,217,134,99,35,83,46,37,14,0.0,0.0
1009,1831,26-09-2019 00:40:00,0,3440.0,3311.0,0.962,17.219,0,0,0,0,0,0,0,0,0.0,0.0
1009,1832,26-09-2019 00:42:00,0,3222.0,3185.0,0.988,16.221,0,0,0,0,0,0,0,0,0.0,0.0
1009,1833,26-09-2019 00:44:00,0,3163.0,3042.0,0.962,15.83,0,0,0,0,0,0,0,0,0.0,0.0
1009,1834,26-09-2019 00:46:00,0,2973.0,2887.0,0.971,14.91,0,0,0,0,0,0,0,0,0.0,0.0
1009,1835,26-09-2019 00:48:00,0,2778.0,2777.0,1.0,14.017,0,0,0,0,0,0,0,0,0.0,0.0
1009,1836,26-09-2019 00:50:00,0,2803.0,2671.0,0.953,14.001,1,1,0,1,0,0,0,0,0.0,0.0
1009,1837,26-09-2019 00:52:00,0,2715.0,2592.0,0.955,13.568,9,6,1,5,3,2,1,0,0.0,0.0
1009,1838,26-09-2019 00:54:00,0,2497.0,2527.0,1.012,12.635,5,5,1,4,0,0,0,0,0.0,0.0
1009,1839,26-09-2019 00:56:00,0,2529.0,2440.0,0.965,12.666,22,22,0,22,0,0,0,0,0.0,0.0
1009,1840,26-09-2019 00:58:00,0,2318.0,2346.0,1.012,11.73,0,0,0,0,0,0,0,0,0.0,0.0
1009,1841,26-09-2019 01:00:00,0,2325.0,2294.0,0.987,11.699,14,8,4,4,6,0,6,0,0.0,0.0
1009,1842,26-09-2019 01:02:00,0,2328.0,2352.0,1.011,11.775,20,0,0,0,20,0,20,0,0.0,0.0
1009,1843,26-09-2019 01:04:00,0,2322.0,2360.0,1.016,11.763,31,12,4,8,19,8,11,0,0.0,0.0
1009,1844,26-09-2019 01:06:00,0,2325.5,2349.0,1.01,11.7625,0,0,0,0,0,0,0,0,0.0,0.0
1009,1845,26-09-2019 01:08:00,0,2329.0,2338.0,1.004,11.762,1,0,0,0,1,0,1,0,0.0,0.0
1009,1846,26-09-2019 01:10:00,0,2336.0,2270.0,0.972,11.716,13,5,1,4,8,0,8,0,0.0,0.0
1009,1847,26-09-2019 01:12:00,0,2331.0,2291.0,0.983,11.722,1,0,0,0,1,0,1,0,0.0,0.0
1009,1848,26-09-2019 01:14:00,0,2336.0,2290.0,0.98,11.74,1,0,0,0,1,0,1,0,0.0,0.0
1009,1849,26-09-2019 01:16:00,0,2335.0,2309.0,0.989,11.754,6,2,0,2,4,0,4,0,0.0,0.0
1009,1850,26-09-2019 01:18:00,0,2329.0,2335.0,1.002,11.762,0,0,0,0,0,0,0,0,0.0,0.0
1009,1851,26-09-2019 01:20:00,0,2330.0,2319.0,0.995,11.747,35,6,2,4,29,19,10,0,0.0,0.0
1009,1852,26-09-2019 01:22:00,0,2324.0,2353.0,1.013,11.761,0,0,0,0,0,0,0,0,0.0,0.0
1009,1853,26-09-2019 01:24:00,0,2317.0,2341.0,1.01,11.721,0,0,0,0,0,0,0,0,0.0,0.0
1009,1854,26-09-2019 01:26:00,0,2308.0,2353.0,1.019,11.696,36,3,0,3,33,20,13,0,0.0,0.0
1009,1855,26-09-2019 01:28:00,0,2328.0,2335.0,1.003,11.757,130,62,45,17,68,48,20,15,0.0,0.0
1009,1856,26-09-2019 01:30:00,0,2422.0,2442.0,1.008,12.245,127,88,45,43,39,13,26,63,0.0,0.0
1009,1857,26-09-2019 01:32:00,0,2807.0,2714.0,0.967,14.063,145,100,61,39,45,11,34,58,0.0,0.0
1009,1858,26-09-2019 01:34:00,0,2977.0,2891.0,0.971,14.928,87,67,33,34,20,6,14,47,0.0,0.14
1009,1859,26-09-2019 01:36:00,0,2948.0,3028.0,1.027,14.966,124,70,47,23,54,26,28,39,0.0,0.01
1009,1860,26-09-2019 01:38:00,0,2775.0,2729.0,0.983,13.956,247,128,94,34,119,87,32,88,0.0,0.01
1009,1861,26-09-2019 01:40:00,0,3092.0,3037.0,0.982,15.546,729,377,315,62,352,276,76,69,0.0,0.02
1009,1862,26-09-2019 01:42:00,0,3409.0,3345.0,0.981,17.136,500,236,193,43,264,200,64,54,0.03,0.0
1009,1863,26-09-2019 01:44:00,0,3404.0,3393.0,0.997,17.167,492,227,174,53,265,203,62,58,0.0,0.0
1009,1864,26-09-2019 01:46:00,0,3254.0,3152.0,0.969,16.31,115,69,37,32,46,6,40,68,0.0,0.03
1009,1865,26-09-2019 01:48:00,0,3494.0,3505.0,1.003,17.645,147,92,65,27,55,35,20,13,0.12,0.05
1009,1866,26-09-2019 01:50:00,0,2786.0,2742.0,0.984,14.012,59,28,4,24,31,17,14,3,0.0,0.01
1009,1867,26-09-2019 01:52:00,0,2779.0,2735.0,0.984,13.977,23,19,6,13,4,0,4,3,0.0,0.0
1009,1868,26-09-2019 01:54:00,0,3404.0,3437.0,1.01,17.217,8,6,4,2,2,1,1,1,0.0,0.0
1009,1869,26-09-2019 01:56:00,0,3579.0,3511.0,0.981,17.989,6,1,1,0,5,0,5,0,0.0,0.0
1009,1870,26-09-2019 01:58:00,0,3382.0,3451.0,1.02,17.147,0,0,0,0,0,0,0,0,0.0,0.0
1009,1871,26-09-2019 02:00:00,0,3399.0,3386.0,0.996,17.141,0,0,0,0,0,0,0,0,0.0,0.0
1009,1872,26-09-2019 02:02:00,0,3331.0,3249.0,0.975,16.723,6,4,1,3,2,0,2,0,0.0,0.0
1009,1873,26-09-2019 02:04:00,0,3261.0,3123.0,0.958,16.305,0,0,0,0,0,0,0,0,0.0,0.0
1009,1874,26-09-2019 02:06:00,0,2957.0,2979.0,1.008,14.947,2,1,0,1,1,0,1,0,0.0,0.0
1009,1875,26-09-2019 02:08:00,0,2989.0,2871.0,0.961,14.956,1,0,0,0,1,0,1,0,0.0,0.0
1009,1876,26-09-2019 02:10:00,0,2780.0,2742.0,0.987,13.987,0,0,0,0,0,0,0,0,0.0,0.0
1009,1877,26-09-2019 02:12:00,0,2803.0,2640.0,0.942,13.966,88,53,27,26,35,8,27,2,0.0,0.0
1009,1878,26-09-2019 02:14:00,0,2786.0,2719.0,0.9765,13.986,39,33,7,26,6,0,6,3,0.0,0.0
1009,1879,26-09-2019 02:16:00,0,2769.0,2798.0,1.011,14.006,26,25,8,17,1,0,1,2,0.0,0.0
1009,1880,26-09-2019 02:18:00,0,2862.0,2812.0,0.983,14.392,262,134,92,42,128,82,46,41,0.0,0.0
1009,1881,26-09-2019 02:20:00,0,2779.0,2767.0,0.996,14.011,511,302,241,61,209,151,58,62,0.0,0.0
1009,1882,26-09-2019 02:22:00,0,2969.0,2935.0,0.988,14.947,417,211,156,55,206,139,67,37,0.0,0.0
1009,1883,26-09-2019 02:24:00,0,2988.0,2862.0,0.958,14.942,190,107,69,38,83,61,22,42,0.03,0.0
1009,1884,26-09-2019 02:26:00,0,2972.0,2871.0,0.966,14.889,892,498,409,89,394,322,72,93,0.0,0.0
1009,1885,26-09-2019 02:28:00,0,2949.0,2943.0,0.998,14.876,965,610,505,105,355,273,82,121,0.0,0.0
1009,1886,26-09-2019 02:30:00,0,3240.0,3159.0,0.975,16.265,470,236,185,51,234,185,49,78,0.02,0.0
1009,1887,26-09-2019 02:32:00,0,3246.0,3096.0,0.954,16.215,282,143,97,46,139,105,34,51,0.0,0.0
1009,1888,26-09-2019 02:34:00,0,3427.0,3347.0,0.977,17.207,229,96,69,27,133,84,49,33,0.0,0.01
1009,1889,26-09-2019 02:36:00,0,3061.0,3008.0,0.983,15.39,463,275,206,69,188,140,48,4,0.0,0.0
1009,1890,26-09-2019 02:38:00,0,3448.0,3276.0,0.95,17.212,901,526,432,94,375,289,86,57,0.0,0.02
1009,1891,26-09-2019 02:40:00,0,3352.0,3198.0,0.954,16.747,202,109,76,33,93,64,29,29,0.0,0.04
1009,1892,26-09-2019 02:42:00,0,3073.0,2979.0,0.97,15.406,90,63,39,24,27,14,13,2,0.0,0.0
1009,1893,26-09-2019 02:44:00,0,3443.0,3240.0,0.941,17.154,487,264,206,58,223,165,58,84,0.0,0.0
1009,1894,26-09-2019 02:46:00,0,3454.0,3237.0,0.937,17.193,57,39,17,22,18,4,14,5,0.0,0.0
1009,1895,26-09-2019 02:48:00,0,3346.0,3184.0,0.952,16.709,55,43,13,30,12,0,12,1,0.0,0.0
1009,1896,26-09-2019 02:50:00,0,3238.0,3131.0,0.967,16.225,69,48,15,33,21,5,16,3,0.0,0.0
1009,1897,26-09-2019 02:52:00,0,3246.0,3144.0,0.968,16.271,23,13,1,12,10,1,9,0,0.0,0.0
1009,1898,26-09-2019 02:54:00,0,3266.0,3033.0,0.929,16.226,11,10,4,6,1,1,0,0,0.0,0.0
1009,1899,26-09-2019 02:56:00,0,2996.0,2793.0,0.932,14.895,5,5,2,3,0,0,0,0,0.0,0.0
1009,1900,26-09-2019 02:58:00,0,2820.0,2595.0,0.92,13.986,9,8,4,4,1,0,1,0,0.0,0.0
1009,1901,26-09-2019 03:00:00,0,2736.0,2501.0,0.914,13.548,20,20,0,20,0,0,0,0,0.0,0.0
1009,1902,26-09-2019 03:02:00,0,2526.0,2426.0,0.96,12.638,5,5,0,5,0,0,0,0,0.0,0.0
1009,1903,26-09-2019 03:04:00,0,2452.0,2286.0,0.932,12.191,39,25,13,12,14,1,13,0,0.0,0.0
1009,1904,26-09-2019 03:06:00,0,2337.0,2254.0,0.965,11.702,1,1,0,1,0,0,0,0,0.0,0.0
1009,1905,26-09-2019 03:08:00,0,2366.0,2162.0,0.914,11.717,0,0,0,0,0,0,0,0,0.0,0.0
1009,1906,26-09-2019 03:10:00,0,2274.0,2083.0,0.916,11.265,1,1,0,1,0,0,0,0,0.0,0.0
1009,1907,26-09-2019 03:12:00,0,2170.0,2022.0,0.932,10.788,1,0,0,0,1,0,1,0,0.0,0.0
1009,1908,26-09-2019 03:14:00,0,2182.0,2031.0,0.931,10.845,0,0,0,0,0,0,0,0,0.0,0.0
1009,1909,26-09-2019 03:16:00,0,2193.0,2000.0,0.912,10.852,11,9,3,6,2,1,1,0,0.0,0.0
1009,1910,26-09-2019 03:18:00,0,2394.0,2094.0,0.875,11.752,0,0,0,0,0,0,0,0,0.0,0.0
1009,1911,26-09-2019 03:20:00,0,2386.0,2096.0,0.878,11.723,6,5,1,4,1,0,1,0,0.0,0.0
1009,1912,26-09-2019 03:22:00,0,2383.0,2109.5,0.885,11.726,3,3,0,3,0,0,0,0,0.0,0.0
1009,1913,26-09-2019 03:24:00,0,2380.0,2123.0,0.892,11.729,22,10,6,4,12,7,5,0,0.0,0.0
1009,1914,26-09-2019 03:26:00,0,2368.0,2219.0,0.937,11.787,0,0,0,0,0,0,0,0,0.0,0.0
1009,1915,26-09-2019 03:28:00,0,2356.0,2202.0,0.935,11.72,2,1,1,0,1,0,1,0,0.0,0.0
1009,1916,26-09-2019 03:30:00,0,2555.0,2331.0,0.912,12.648,1,1,1,0,0,0,0,0,0.0,0.0
1009,1917,26-09-2019 03:32:00,0,2550.0,2326.0,0.912,12.622,0,0,0,0,0,0,0,0,0.0,0.0
1009,1918,26-09-2019 03:34:00,0,2352.0,2232.0,0.949,11.739,0,0,0,0,0,0,0,0,0.0,0.0
1009,1919,26-09-2019 03:36:00,0,2385.0,2108.0,0.884,11.729,19,16,2,14,3,1,2,0,0.0,0.0
1009,1920,26-09-2019 03:38:00,0,2282.0,2075.0,0.909,11.287,23,23,0,23,0,0,0,0,0.0,0.0
1009,1921,26-09-2019 03:40:00,0,2402.0,2081.0,0.866,11.769,51,35,10,25,16,2,14,4,0.0,0.0
1009,1922,26-09-2019 03:42:00,0,2468.0,2255.0,0.914,12.219,56,45,18,27,11,1,10,8,0.0,0.0
1009,1923,26-09-2019 03:44:00,0,2838.0,2513.0,0.885,13.965,61,51,26,25,10,0,10,1,0.0,0.0
1009,1924,26-09-2019 03:46:00,0,2826.0,2608.0,0.923,14.02,39,13,4,9,26,1,25,2,0.0,0.0
1009,1925,26-09-2019 03:48:00,0,2812.0,2679.0,0.953,14.044,185,101,62,39,84,60,24,26,0.0,0.0
1009,1926,26-09-2019 03:50:00,0,2949.0,2926.0,0.992,14.857,212,89,58,31,123,107,16,68,0.0,0.0
1009,1927,26-09-2019 03:52:00,0,3003.0,2780.0,0.925,14.911,245,89,50,39,156,140,16,76,0.0,0.0
1009,1928,26-09-2019 03:54:00,0,3181.0,2971.0,0.934,15.823,222,64,29,35,158,151,7,77,0.0,0.0
1009,1929,26-09-2019 03:56:00,0,3324.0,3108.5,0.935,16.5385,275,83,44,39,192,177,15,60,0.0,0.0
1009,1930,26-09-2019 03:58:00,0,3467.0,3246.0,0.936,17.254,220,61,31,30,159,158,1,69,0.0,0.05
1009,1931,26-09-2019 04:00:00,0,3440.0,3253.0,0.946,17.155,254,91,66,25,163,143,20,48,0.08,0.04
1009,1932,26-09-2019 04:02:00,0,3467.0,3196.0,0.922,17.198,205,112,77,35,93,70,23,24,0.0,0.12
1009,1933,26-09-2019 04:04:00,0,2887.0,2794.0,0.968,14.469,242,112,81,31,130,98,32,80,0.01,0.0
1009,1934,26-09-2019 04:06:00,0,3602.0,3517.0,0.976,18.085,188,95,67,28,93,65,28,6,0.13,0.0
1009,1935,26-09-2019 04:08:00,0,2831.0,2531.0,0.894,13.955,563,387,321,66,176,121,55,23,0.01,0.0
1009,1936,26-09-2019 04:10:00,0,3466.0,3205.0,0.925,17.206,302,156,121,35,146,104,42,113,0.0,0.0
1009,1937,26-09-2019 04:12:00,0,2982.0,2837.0,0.951,14.89,345,209,166,43,136,93,43,7,0.0,0.0
1009,1938,26-09-2019 04:14:00,0,3470.0,3182.0,0.917,17.194,308,171,139,32,137,99,38,94,0.0,0.0
1009,1939,26-09-2019 04:16:00,0,3440.0,3262.0,0.948,17.165,94,37,22,15,57,22,35,56,0.0,0.0
1009,1940,26-09-2019 04:18:00,0,3438.0,3295.0,0.958,17.194,175,92,57,35,83,40,43,57,0.0,0.0
1009,1941,26-09-2019 04:20:00,0,3018.0,2754.0,0.912,14.94,239,152,118,34,87,60,27,17,0.0,0.0
1009,1942,26-09-2019 04:22:00,0,2755.0,2451.0,0.89,13.569,785,481,394,87,304,232,72,53,0.0,0.0
1009,1943,26-09-2019 04:24:00,0,3464.0,3148.0,0.909,17.135,846,611,521,90,235,170,65,124,0.0,0.0
1009,1944,26-09-2019 04:26:00,0,3488.0,3177.0,0.911,17.261,472,286,227,59,186,139,47,21,0.01,0.0
1009,1945,26-09-2019 04:28:00,0,3434.0,3306.0,0.963,17.191,193,94,68,26,99,71,28,16,0.08,0.0
1009,1946,26-09-2019 04:30:00,0,3360.5,3164.0,0.941,16.743,32,8,5,3,24,0,24,4,0.0,0.0
1009,1947,26-09-2019 04:32:00,0,3287.0,3022.0,0.919,16.295,55,39,19,20,16,3,13,5,0.0,0.0
1009,1948,26-09-2019 04:34:00,0,3465.0,3177.0,0.917,17.169,40,30,8,22,10,2,8,3,0.0,0.0
1009,1949,26-09-2019 04:36:00,0,3451.0,3198.0,0.927,17.137,28,27,0,27,1,0,1,0,0.0,0.0
1009,1950,26-09-2019 04:38:00,0,3470.0,3159.0,0.91,17.167,20,18,5,13,2,1,1,0,0.0,0.0
1009,1951,26-09-2019 04:40:00,0,3280.0,2996.0,0.913,16.239,0,0,0,0,0,0,0,0,0.0,0.0
1009,1952,26-09-2019 04:42:00,0,2914.0,2716.0,0.932,14.486,8,8,5,3,0,0,0,0,0.0,0.0
1009,1953,26-09-2019 04:44:00,0,2852.0,2529.0,0.887,14.035,1,1,0,1,0,0,0,0,0.0,0.0
1009,1954,26-09-2019 04:46:00,0,2548.0,2380.0,0.934,12.674,0,0,0,0,0,0,0,0,0.0,0.0
1009,1955,26-09-2019 04:48:00,0,2569.0,2259.0,0.879,12.623,11,11,6,5,0,0,0,0,0.0,0.0
1009,1956,26-09-2019 04:50:00,0,2358.0,2194.0,0.93,11.721,1,1,0,1,0,0,0,0,0.0,0.0
1009,1957,26-09-2019 04:52:00,0,2383.0,2129.0,0.893,11.745,52,38,20,18,14,6,8,1,0.01,0.0
1009,1958,26-09-2019 04:54:00,0,2357.0,2192.0,0.93,11.715,11,8,3,5,3,2,1,0,0.0,0.0
1009,1959,26-09-2019 04:56:00,0,2547.0,2359.0,0.926,12.649,71,58,35,23,13,4,9,10,0.0,0.0
1009,1960,26-09-2019 04:58:00,0,2741.0,2521.0,0.92,13.592,49,30,10,20,19,1,18,20,0.0,0.0
1009,1961,26-09-2019 05:00:00,0,2840.0,2551.0,0.898,14.013,72,58,36,22,14,2,12,16,0.0,0.0
1009,1962,26-09-2019 05:02:00,0,2842.0,2568.0,0.903,14.041,194,119,85,34,75,43,32,91,0.0,0.0
1009,1963,26-09-2019 05:04:00,0,2739.5,2520.5,0.9205,13.584,15,7,0,7,8,3,5,0,0.0,0.0
1009,1964,26-09-2019 05:06:00,0,2637.0,2473.0,0.938,13.127,9,7,4,3,2,1,1,0,0.0,0.0
1009,1965,26-09-2019 05:08:00,0,2531.0,2384.0,0.942,12.612,12,10,5,5,2,0,2,1,0.0,0.0
1009,1966,26-09-2019 05:10:00,0,2555.0,2306.0,0.902,12.619,18,12,6,6,6,5,1,0,0.0,0.0
1009,1967,26-09-2019 05:12:00,0,2576.0,2248.0,0.873,12.64,23,19,9,10,4,1,3,7,0.0,0.0
1009,1968,26-09-2019 05:14:00,0,2581.0,2239.0,0.868,12.647,213,106,80,26,107,69,38,43,0.0,0.0
1009,1969,26-09-2019 05:16:00,0,2850.0,2457.0,0.862,13.951,87,47,16,31,40,0,40,65,0.0,0.0
1009,1970,26-09-2019 05:18:00,0,3025.0,2751.0,0.909,14.966,66,31,8,23,35,5,30,65,0.0,0.03
1009,1971,26-09-2019 05:20:00,0,3280.0,3022.0,0.921,16.268,93,52,25,27,41,7,34,66,0.0,0.11
1009,1972,26-09-2019 05:22:00,0,3376.0,3101.0,0.918,16.733,208,126,94,32,82,45,37,45,0.11,0.04
1009,1973,26-09-2019 05:24:00,0,2834.0,2524.0,0.891,13.96,28,11,6,5,17,5,12,9,0.0,0.0
1009,1974,26-09-2019 05:26:00,0,2569.0,2312.0,0.9,12.681,0,0,0,0,0,0,0,0,0.0,0.0
1009,1975,26-09-2019 05:28:00,0,2815.0,2647.0,0.94,14.023,1,1,1,0,0,0,0,0,0.0,0.0
1009,1976,26-09-2019 05:30:00,0,2979.0,2825.0,0.948,14.867,4,4,3,1,0,0,0,0,0.0,0.0
1009,1977,26-09-2019 05:32:00,0,2978.0,2823.0,0.948,14.857,1,1,0,1,0,0,0,0,0.0,0.0
1009,1978,26-09-2019 05:34:00,0,3000.0,2745.0,0.915,14.86,2,2,0,2,0,0,0,0,0.0,0.0
1009,1979,26-09-2019 05:36:00,0,2806.0,2668.0,0.951,14.011,0,0,0,0,0,0,0,0,0.0,0.0
1009,1980,26-09-2019 05:38:00,0,2667.0,2546.0,0.955,13.327,0,0,0,0,0,0,0,0,0.0,0.0
1009,1981,26-09-2019 05:40:00,0,2528.0,2424.0,0.959,12.643,22,22,9,13,0,0,0,0,0.0,0.0
1009,1982,26-09-2019 05:42:00,0,2547.0,2389.0,0.938,12.679,0,0,0,0,0,0,0,0,0.0,0.0
1009,1983,26-09-2019 05:44:00,0,2557.0,2330.0,0.911,12.656,0,0,0,0,0,0,0,0,0.0,0.01
1009,1984,26-09-2019 05:46:00,0,2354.0,2254.0,0.958,11.768,17,15,4,11,2,1,1,0,0.0,0.0
1009,1985,26-09-2019 05:48:00,0,2460.0,2291.0,0.931,12.229,1,0,0,0,1,0,1,0,0.0,0.0
1009,1986,26-09-2019 05:50:00,0,2547.0,2310.0,0.907,12.593,0,0,0,0,0,0,0,0,0.0,0.0
1009,1987,26-09-2019 05:52:00,0,2556.0,2306.0,0.902,12.624,3,0,0,0,3,2,1,0,0.0,0.0
1009,1988,26-09-2019 05:54:00,0,2562.0,2302.0,0.899,12.643,0,0,0,0,0,0,0,0,0.0,0.0
1009,1989,26-09-2019 05:56:00,0,2454.0,2278.0,0.928,12.19,3,1,1,0,2,1,1,0,0.0,0.0
1009,1990,26-09-2019 05:58:00,0,2450.0,2252.0,0.919,12.147,11,8,5,3,3,0,3,0,0.0,0.0
1009,1991,26-09-2019 06:00:00,1,2550.0,2337.0,0.916,12.636,20,6,4,2,14,6,8,0,0.0,0.0
1009,1992,26-09-2019 06:02:00,1,2559.0,2333.0,0.912,12.667,7,0,0,0,7,0,7,0,0.0,0.0
1009,1993,26-09-2019 06:04:00,1,2560.0,2309.0,0.902,12.644,3,0,0,0,3,0,3,0,0.0,0.0
1009,1994,26-09-2019 06:06:00,1,2450.0,2243.0,0.916,12.136,0,0,0,0,0,0,0,0,0.0,0.0
1009,1995,26-09-2019 06:08:00,1,2369.0,2192.0,0.925,11.759,5,0,0,0,5,0,5,0,0.0,0.0
1009,1996,26-09-2019 06:10:00,1,2366.0,2140.0,0.904,11.691,2,0,0,0,2,0,2,0,0.0,0.0
1009,1997,26-09-2019 06:12:00,1,2375.5,2139.5,0.9005,11.7275,0,0,0,0,0,0,0,0,0.0,0.0
1009,1998,26-09-2019 06:14:00,1,2385.0,2139.0,0.897,11.764,0,0,0,0,0,0,0,0,0.0,0.0
1009,1999,26-09-2019 06:16:00,1,2393.0,2113.0,0.883,11.766,75,41,21,20,34,8,26,19,0.0,0.0
1009,2000,26-09-2019 06:18:00,1,2557.0,2304.0,0.901,12.625,46,21,9,12,25,6,19,2,0.0,0.0
1009,2001,26-09-2019 06:20:00,1,2526.0,2408.0,0.953,12.617,29,16,11,5,13,2,11,5,0.0,0.0
1009,2002,26-09-2019 06:22:00,1,2740.0,2458.0,0.897,13.518,127,109,78,31,18,9,9,6,0.0,0.0
1009,2003,26-09-2019 06:24:00,1,2821.0,2579.0,0.914,13.971,39,37,13,24,2,0,2,0,0.0,0.0
1009,2004,26-09-2019 06:26:00,1,2836.0,2547.0,0.898,13.995,0,0,0,0,0,0,0,0,0.0,0.0
1009,2005,26-09-2019 06:28:00,1,2836.0,2554.0,0.901,14.002,53,48,25,23,5,2,3,7,0.0,0.0
1009,2006,26-09-2019 06:30:00,1,2842.0,2526.0,0.889,13.994,3,1,0,1,2,0,2,0,0.0,0.0
1009,2007,26-09-2019 06:32:00,1,2645.0,2442.0,0.923,13.123,1,0,0,0,1,0,1,0,0.0,0.0
1009,2008,26-09-2019 06:34:00,1,2553.0,2350.0,0.92,12.661,4,2,1,1,2,0,2,0,0.0,0.0
1009,2009,26-09-2019 06:36:00,1,2465.0,2244.0,0.91,12.196,6,6,0,6,0,0,0,0,0.0,0.0
1009,2010,26-09-2019 06:38:00,1,2373.0,2172.0,0.915,11.755,28,21,10,11,7,4,3,0,0.0,0.0
1009,2011,26-09-2019 06:40:00,1,2379.0,2135.0,0.897,11.738,5,5,2,3,0,0,0,0,0.0,0.0
1009,2012,26-09-2019 06:42:00,1,2281.0,2052.0,0.9,11.258,10,10,1,9,0,0,0,0,0.0,0.0
1009,2013,26-09-2019 06:44:00,1,2410.0,2052.0,0.852,11.767,0,0,0,0,0,0,0,0,0.0,0.0
1009,2014,26-09-2019 06:46:00,1,2409.5,2047.5,0.85,11.76,4,3,0,3,1,0,1,0,0.0,0.0
1009,2015,26-09-2019 06:48:00,1,2409.0,2043.0,0.848,11.753,47,33,19,14,14,5,9,0,0.0,0.0
1009,2016,26-09-2019 06:50:00,1,2378.0,2162.0,0.909,11.764,0,0,0,0,0,0,0,0,0.0,0.0
1009,2017,26-09-2019 06:52:00,1,2376.0,2140.0,0.9,11.732,2,2,1,1,0,0,0,0,0.0,0.0
1009,2018,26-09-2019 06:54:00,1,2397.0,2123.0,0.886,11.793,0,0,0,0,0,0,0,0,0.0,0.0
1009,2019,26-09-2019 06:56:00,1,2400.0,2043.0,0.851,11.716,4,4,0,4,0,0,0,0,0.0,0.0
1009,2020,26-09-2019 06:58:00,1,2395.0,2046.0,0.854,11.702,3,3,0,3,0,0,0,0,0.0,0.0
1009,2021,26-09-2019 07:00:00,1,2295.0,2017.0,0.879,11.276,7,6,1,5,1,0,1,0,0.0,0.0
1009,2022,26-09-2019 07:02:00,1,2296.0,2013.0,0.877,11.275,5,3,1,2,2,0,2,0,0.0,0.0
1009,2023,26-09-2019 07:04:00,1,2202.0,1971.0,0.895,10.858,1,0,0,0,1,0,1,0,0.0,0.0
1009,2024,26-09-2019 07:06:00,1,2208.0,1953.0,0.885,10.862,82,42,27,15,40,0,40,6,0.0,0.0
1009,2025,26-09-2019 07:08:00,1,2392.0,2102.0,0.879,11.751,58,43,20,23,15,0,15,27,0.0,0.0
1009,2026,26-09-2019 07:10:00,1,2563.0,2315.0,0.903,12.662,46,26,14,12,20,6,14,8,0.0,0.0
1009,2027,26-09-2019 07:12:00,1,2857.0,2459.0,0.861,13.979,15,1,1,0,14,1,13,0,0.0,0.0
1009,2028,26-09-2019 07:14:00,1,2822.0,2607.0,0.924,14.005,171,106,76,30,65,42,23,69,0.0,0.0
1009,2029,26-09-2019 07:16:00,1,3021.0,2709.0,0.897,14.902,195,105,75,30,90,61,29,49,0.0,0.0
1009,2030,26-09-2019 07:18:00,1,2812.0,2626.0,0.934,13.986,274,151,115,36,123,90,33,81,0.0,0.0
1009,2031,26-09-2019 07:20:00,1,3056.5,2754.0,0.9035,15.0915,78,40,16,24,38,3,35,62,0.0,0.0
1009,2032,26-09-2019 07:22:00,1,3301.0,2882.0,0.873,16.197,159,90,57,33,69,38,31,48,0.0,0.11
1009,2033,26-09-2019 07:24:00,1,2926.0,2656.0,0.908,14.468,69,42,26,16,27,3,24,23,0.0,0.0
1009,2034,26-09-2019 07:26:00,1,2816.0,2575.0,0.914,13.944,77,54,29,25,23,4,19,18,0.0,0.0
1009,2035,26-09-2019 07:28:00,1,3307.0,2921.0,0.883,16.262,18,13,9,4,5,0,5,11,0.0,0.0
1009,2036,26-09-2019 07:30:00,1,3289.0,2992.0,0.91,16.269,635,378,303,75,257,198,59,8,0.0,0.0
1009,2037,26-09-2019 07:32:00,1,3295.0,2916.0,0.885,16.21,638,369,292,77,269,196,73,43,0.01,0.0
1009,2038,26-09-2019 07:34:00,1,3302.0,2939.0,0.89,16.265,353,147,107,40,206,143,63,34,0.0,0.0
1009,2039,26-09-2019 07:36:00,1,3487.0,3106.0,0.891,17.176,292,148,118,30,144,107,37,68,0.0,0.0
1009,2040,26-09-2019 07:38:00,1,3296.0,2931.0,0.889,16.233,70,42,22,20,28,3,25,1,0.0,0.0
1009,2041,26-09-2019 07:40:00,1,2996.0,2813.0,0.939,14.92,11,8,0,8,3,0,3,0,0.0,0.0
1009,2042,26-09-2019 07:42:00,1,3000.0,2778.0,0.926,14.895,0,0,0,0,0,0,0,0,0.0,0.0
1009,2043,26-09-2019 07:44:00,1,2836.0,2567.0,0.905,14.017,6,6,3,3,0,0,0,0,0.0,0.0
1009,2044,26-09-2019 07:46:00,1,2655.0,2365.0,0.891,13.081,0,0,0,0,0,0,0,0,0.0,0.0
1009,2045,26-09-2019 07:48:00,1,2575.0,2255.0,0.876,12.642,1,1,0,1,0,0,0,0,0.0,0.0
1009,2046,26-09-2019 07:50:00,1,2370.0,2123.0,0.896,11.688,5,5,2,3,0,0,0,0,0.0,0.0
1009,2047,26-09-2019 07:52:00,1,2399.0,2056.0,0.857,11.728,0,0,0,0,0,0,0,0,0.0,0.0
1009,2048,26-09-2019 07:54:00,1,2350.5,2027.5,0.863,11.505,27,27,4,23,0,0,0,0,0.0,0.0
1009,2049,26-09-2019 07:56:00,1,2302.0,1999.0,0.869,11.282,31,31,0,31,0,0,0,0,0.0,0.0
1009,2050,26-09-2019 07:58:00,1,2196.0,1959.0,0.892,10.823,7,7,3,4,0,0,0,0,0.0,0.0
1009,2051,26-09-2019 08:00:00,1,2222.0,1931.0,0.869,10.891,12,12,1,11,0,0,0,0,0.0,0.0
1009,2052,26-09-2019 08:02:00,1,2205.0,1921.0,0.871,10.814,3,3,0,3,0,0,0,0,0.0,0.0
1009,2053,26-09-2019 08:04:00,1,2210.0,1906.0,0.862,10.818,5,5,0,5,0,0,0,0,0.0,0.0
1009,2054,26-09-2019 08:06:00,1,2226.0,1878.0,0.843,10.85,3,3,0,3,0,0,0,0,0.0,0.0
1009,2055,26-09-2019 08:08:00,1,2235.0,1854.0,0.83,10.859,10,10,6,4,0,0,0,0,0.0,0.0
1009,2056,26-09-2019 08:10:00,1,2206.0,1940.0,0.879,10.84,0,0,0,0,0,0,0,0,0.0,0.0
1009,2057,26-09-2019 08:12:00,1,2418.0,1966.0,0.813,11.705,25,20,12,8,5,3,2,1,0.0,0.0
1009,2058,26-09-2019 08:14:00,1,2425.0,1969.0,0.812,11.734,54,44,26,18,10,6,4,2,0.0,0.0
1009,2059,26-09-2019 08:16:00,1,2404.0,2011.0,0.837,11.697,0,0,0,0,0,0,0,0,0.0,0.0
1009,2060,26-09-2019 08:18:00,1,2432.0,1951.0,0.802,11.743,0,0,0,0,0,0,0,0,0.0,0.0
1009,2061,26-09-2019 08:20:00,1,2222.0,1884.0,0.848,10.839,0,0,0,0,0,0,0,0,0.0,0.0
1009,2062,26-09-2019 08:22:00,1,2238.0,1836.0,0.82,10.848,5,5,4,1,0,0,0,0,0.0,0.0
1009,2063,26-09-2019 08:24:00,1,2249.0,1795.0,0.798,10.849,3,3,2,1,0,0,0,0,0.0,0.0
1009,2064,26-09-2019 08:26:00,1,2254.0,1772.0,0.786,10.842,2,2,0,2,0,0,0,0,0.0,0.0
1009,2065,26-09-2019 08:28:00,1,2200.5,1748.5,0.795,10.6055,11,11,7,4,0,0,0,0,0.0,0.0
1009,2066,26-09-2019 08:30:00,1,2147.0,1725.0,0.804,10.369,10,10,7,3,0,0,0,0,0.0,0.0
1009,2067,26-09-2019 08:32:00,1,2047.0,1709.0,0.835,9.957,8,5,0,5,3,1,2,0,0.0,0.0
1009,2068,26-09-2019 08:34:00,1,2238.0,1791.0,0.8,10.801,3,1,0,1,2,0,2,0,0.0,0.0
1009,2069,26-09-2019 08:36:00,1,2228.0,1844.0,0.828,10.819,10,4,2,2,6,0,6,0,0.0,0.0
1009,2070,26-09-2019 08:38:00,1,2439.0,1873.0,0.768,11.684,7,4,3,1,3,2,1,0,0.0,0.0
1009,2071,26-09-2019 08:40:00,1,2439.0,1917.0,0.786,11.732,120,108,68,40,12,5,7,22,0.0,0.0
1009,2072,26-09-2019 08:42:00,1,2606.0,2154.0,0.827,12.651,174,92,56,36,82,51,31,47,0.0,0.0
1009,2073,26-09-2019 08:44:00,1,2875.0,2414.0,0.84,14.001,228,128,99,29,100,64,36,46,0.01,0.0
1009,2074,26-09-2019 08:46:00,1,2865.0,2428.0,0.847,13.975,215,129,98,31,86,55,31,48,0.0,0.0
1009,2075,26-09-2019 08:48:00,1,2960.0,2474.0,0.836,14.402,270,116,81,35,154,120,34,51,0.0,0.0
1009,2076,26-09-2019 08:50:00,1,2875.0,2408.0,0.837,13.995,132,98,58,40,34,22,12,7,0.0,0.0
1009,2077,26-09-2019 08:52:00,1,2973.0,2481.0,0.834,14.459,575,204,131,73,371,294,77,30,0.0,0.0
1009,2078,26-09-2019 08:54:00,1,2957.0,2494.0,0.843,14.412,584,251,184,67,333,254,79,8,0.0,0.0
1009,2079,26-09-2019 08:56:00,1,2953.0,2493.0,0.844,14.394,556,343,271,72,213,165,48,36,0.0,0.0
1009,2080,26-09-2019 08:58:00,1,3066.0,2550.0,0.832,14.904,272,130,95,35,142,106,36,10,0.0,0.0
1009,2081,26-09-2019 09:00:00,1,2959.0,2530.0,0.855,14.458,512,300,242,58,212,155,57,28,0.01,0.0
1009,2082,26-09-2019 09:02:00,1,2912.5,2474.5,0.8495,14.2145,820,440,350,90,380,302,78,25,0.0,0.0
1009,2083,26-09-2019 09:04:00,1,2866.0,2419.0,0.844,13.971,156,68,33,35,88,47,41,60,0.0,0.03
1009,2084,26-09-2019 09:06:00,1,3055.0,2596.0,0.85,14.911,130,73,33,40,57,23,34,54,0.0,0.0
1009,2085,26-09-2019 09:08:00,1,3039.0,2654.0,0.873,14.911,117,63,26,37,54,24,30,69,0.0,0.0
1009,2086,26-09-2019 09:10:00,1,3030.0,2644.0,0.872,14.866,83,47,24,23,36,7,29,47,0.0,0.11
1009,2087,26-09-2019 09:12:00,1,3036.0,2660.0,0.876,14.908,127,91,56,35,36,13,23,41,0.0,0.07
1009,2088,26-09-2019 09:14:00,1,2783.0,2334.0,0.839,13.551,43,28,8,20,15,2,13,4,0.0,0.0
1009,2089,26-09-2019 09:16:00,1,2407.0,2002.0,0.832,11.7,73,53,23,30,20,0,20,1,0.0,0.0
1009,2090,26-09-2019 09:18:00,1,3069.0,2549.0,0.831,14.916,84,71,33,38,13,0,13,4,0.0,0.0
1009,2091,26-09-2019 09:20:00,1,3310.0,2889.0,0.873,16.239,14,0,0,0,14,0,14,0,0.0,0.0
1009,2092,26-09-2019 09:22:00,1,3327.0,2822.0,0.848,16.235,8,1,0,1,7,0,7,0,0.0,0.0
1009,2093,26-09-2019 09:24:00,1,3020.0,2744.0,0.909,14.935,5,2,0,2,3,0,3,0,0.0,0.01
1009,2094,26-09-2019 09:26:00,1,2950.0,2577.0,0.874,14.477,3,1,0,1,2,0,2,0,0.0,0.0
1009,2095,26-09-2019 09:28:00,1,2863.0,2470.0,0.863,14.015,6,0,0,0,6,0,6,0,0.0,0.0
1009,2096,26-09-2019 09:30:00,1,2672.0,2335.0,0.874,13.113,8,1,1,0,7,0,7,0,0.0,0.0
1009,2097,26-09-2019 09:32:00,1,2575.0,2253.0,0.875,12.641,7,0,0,0,7,0,7,0,0.0,0.0
1009,2098,26-09-2019 09:34:00,1,2365.0,2158.0,0.912,11.707,7,0,0,0,7,0,7,0,0.0,0.0
1009,2099,26-09-2019 09:36:00,1,2387.5,2096.5,0.878,11.7275,8,0,0,0,8,0,8,0,0.0,0.0
1009,2100,26-09-2019 09:38:00,1,2410.0,2035.0,0.844,11.748,6,0,0,0,6,0,6,0,0.0,0.0
1009,2101,26-09-2019 09:40:00,1,2195.0,1994.0,0.908,10.858,30,25,11,14,5,0,5,1,0.0,0.0
1009,2102,26-09-2019 09:42:00,1,2374.0,2168.0,0.913,11.752,216,135,98,37,81,51,30,25,0.06,0.0
1009,2103,26-09-2019 09:44:00,1,2733.0,2511.0,0.919,13.548,315,157,107,50,158,114,44,32,0.04,0.0
1009,2104,26-09-2019 09:46:00,1,2853.0,2498.0,0.875,14.008,14,9,1,8,5,0,5,0,0.0,0.0
1009,2105,26-09-2019 09:48:00,1,2649.0,2436.0,0.92,13.132,25,8,0,8,17,0,17,0,0.02,0.02
1009,2106,26-09-2019 09:50:00,1,2561.0,2325.0,0.908,12.664,9,6,2,4,3,0,3,0,0.0,0.0
1009,2107,26-09-2019 09:52:00,1,2353.0,2217.0,0.942,11.724,113,65,31,34,48,24,24,6,0.0,0.0
1009,2108,26-09-2019 09:54:00,1,2351.0,2232.0,0.95,11.734,0,0,0,0,0,0,0,0,0.0,0.0
1009,2109,26-09-2019 09:56:00,1,2366.0,2217.0,0.937,11.778,1,1,0,1,0,0,0,0,0.0,0.0
1009,2110,26-09-2019 09:58:00,1,2385.0,2157.0,0.904,11.787,0,0,0,0,0,0,0,0,0.0,0.0
1009,2111,26-09-2019 10:00:00,1,2395.0,2111.0,0.881,11.774,0,0,0,0,0,0,0,0,0.0,0.0
1009,2112,26-09-2019 10:02:00,1,2396.0,2063.0,0.861,11.726,19,18,2,16,1,0,1,0,0.0,0.0
1009,2113,26-09-2019 10:04:00,1,2383.0,2092.0,0.878,11.707,3,0,0,0,3,1,2,0,0.01,0.0
1009,2114,26-09-2019 10:06:00,1,2293.0,2035.0,0.888,11.287,4,2,0,2,2,0,2,0,0.0,0.0
1009,2115,26-09-2019 10:08:00,1,2399.0,2075.0,0.865,11.751,0,0,0,0,0,0,0,0,0.0,0.0
1009,2116,26-09-2019 10:10:00,1,2400.0,2080.5,0.867,11.7615,0,0,0,0,0,0,0,0,0.0,0.0
1009,2117,26-09-2019 10:12:00,1,2401.0,2086.0,0.869,11.772,0,0,0,0,0,0,0,0,0.0,0.0
1009,2118,26-09-2019 10:14:00,1,2398.0,2052.0,0.856,11.719,0,0,0,0,0,0,0,0,0.0,0.0
1009,2119,26-09-2019 10:16:00,1,2401.0,2045.0,0.852,11.725,28,18,2,16,10,3,7,3,0.0,0.0
1009,2120,26-09-2019 10:18:00,1,2583.0,2199.0,0.851,12.61,53,32,4,28,21,4,17,3,0.0,0.0
1009,2121,26-09-2019 10:20:00,1,2579.0,2249.0,0.872,12.652,42,14,2,12,28,12,16,3,0.0,0.0
1009,2122,26-09-2019 10:22:00,1,2656.0,2390.0,0.9,13.11,19,18,4,14,1,0,1,7,0.0,0.0
1009,2123,26-09-2019 10:24:00,1,2631.0,2396.0,0.911,13.018,5,0,0,0,5,1,4,0,0.0,0.0
1009,2124,26-09-2019 10:26:00,1,2577.0,2281.0,0.885,12.678,2,0,0,0,2,0,2,0,0.0,0.0
1009,2125,26-09-2019 10:28:00,1,2378.0,2155.0,0.906,11.755,0,0,0,0,0,0,0,0,0.0,0.0
1009,2126,26-09-2019 10:30:00,1,2408.0,2041.0,0.848,11.746,2,0,0,0,2,0,2,0,0.0,0.0
1009,2127,26-09-2019 10:32:00,1,2210.0,1941.0,0.878,10.855,8,4,0,4,4,1,3,0,0.0,0.0
1009,2128,26-09-2019 10:34:00,1,2219.0,1849.0,0.833,10.788,2,0,0,0,2,1,1,0,0.0,0.0
1009,2129,26-09-2019 10:36:00,1,2021.0,1792.0,0.886,9.948,22,21,0,21,1,0,1,0,0.0,0.0
1009,2130,26-09-2019 10:38:00,1,1913.0,1758.0,0.919,9.483,5,3,0,3,2,1,1,0,0.0,0.0
1009,2131,26-09-2019 10:40:00,1,1925.0,1727.0,0.897,9.498,47,35,2,33,12,0,12,0,0.0,0.0
1009,2132,26-09-2019 10:42:00,1,2232.0,1859.0,0.833,10.854,19,7,1,6,12,0,12,0,0.0,0.0
1009,2133,26-09-2019 10:44:00,1,2231.0,1861.0,0.834,10.852,3,0,0,0,3,1,2,0,0.0,0.0
1009,2134,26-09-2019 10:46:00,1,2230.0,1863.0,0.835,10.85,4,0,0,0,4,0,4,0,0.0,0.0
1009,2135,26-09-2019 10:48:00,1,2222.0,1895.0,0.853,10.855,2,0,0,0,2,0,2,0,0.0,0.0
1009,2136,26-09-2019 10:50:00,1,2205.0,1899.0,0.861,10.792,0,0,0,0,0,0,0,0,0.0,0.0
1009,2137,26-09-2019 10:52:00,1,2211.0,1925.0,0.871,10.841,0,0,0,0,0,0,0,0,0.0,0.0
1009,2138,26-09-2019 10:54:00,1,2221.0,1917.0,0.863,10.873,0,0,0,0,0,0,0,0,0.0,0.0
1009,2139,26-09-2019 10:56:00,1,2208.0,1892.0,0.857,10.793,0,0,0,0,0,0,0,0,0.0,0.0
1009,2140,26-09-2019 10:58:00,1,2329.0,1890.0,0.811,11.269,147,93,58,35,54,28,26,26,0.0,0.0
1009,2141,26-09-2019 11:00:00,1,2571.0,2214.0,0.861,12.582,96,52,21,31,44,14,30,53,0.0,0.0
1009,2142,26-09-2019 11:02:00,1,2864.0,2464.0,0.861,14.012,117,69,34,35,48,6,42,48,0.0,0.04
1009,2143,26-09-2019 11:04:00,1,3046.0,2584.0,0.849,14.862,81,51,24,27,30,1,29,69,0.0,0.12
1009,2144,26-09-2019 11:06:00,1,3335.0,2812.0,0.843,16.253,65,14,8,6,51,16,35,0,0.14,0.03
1009,2145,26-09-2019 11:08:00,1,3100.0,2792.0,0.901,15.303,486,250,199,51,236,180,56,38,0.0,0.0
1009,2146,26-09-2019 11:10:00,1,3039.0,2640.0,0.868,14.898,716,429,349,80,287,208,79,73,0.0,0.0
1009,2147,26-09-2019 11:12:00,1,3472.0,3175.0,0.914,17.192,328,124,84,40,204,151,53,78,0.08,0.0
1009,2148,26-09-2019 11:14:00,1,2990.0,2843.0,0.951,14.93,335,130,102,28,205,145,60,75,0.0,0.01
1009,2149,26-09-2019 11:16:00,1,3001.0,2811.0,0.937,14.935,503,326,269,57,177,112,65,19,0.0,0.0
1009,2150,26-09-2019 11:18:00,1,3105.0,2840.5,0.916,15.3775,562,281,221,60,281,215,66,12,0.0,0.0
1009,2151,26-09-2019 11:20:00,1,3209.0,2870.0,0.895,15.82,395,156,118,38,239,178,61,7,0.0,0.08
1009,2152,26-09-2019 11:22:00,1,2984.0,2828.0,0.948,14.886,140,96,51,45,44,26,18,3,0.0,0.0
1009,2153,26-09-2019 11:24:00,1,3309.0,2928.0,0.885,16.278,62,57,17,40,5,2,3,0,0.0,0.0
1009,2154,26-09-2019 11:26:00,1,3293.0,2958.0,0.898,16.249,45,39,9,30,6,2,4,0,0.0,0.0
1009,2155,26-09-2019 11:28:00,1,3297.0,2953.0,0.896,16.259,440,280,220,60,160,118,42,7,0.0,0.0
1009,2156,26-09-2019 11:30:00,1,3191.0,2935.0,0.92,15.823,280,165,132,33,115,76,39,17,0.0,0.0
1009,2157,26-09-2019 11:32:00,1,3076.0,2877.0,0.935,15.304,35,30,5,25,5,0,5,0,0.0,0.0
1009,2158,26-09-2019 11:34:00,1,2979.0,2853.0,0.958,14.895,15,6,0,6,9,0,9,0,0.0,0.0
1009,2159,26-09-2019 11:36:00,1,3013.0,2747.0,0.912,14.914,0,0,0,0,0,0,0,0,0.0,0.0
1009,2160,26-09-2019 11:38:00,1,2830.0,2594.0,0.917,14.02,0,0,0,0,0,0,0,0,0.0,0.0
1009,2161,26-09-2019 11:40:00,1,2631.0,2435.0,0.925,13.061,0,0,0,0,0,0,0,0,0.0,0.0
1009,2162,26-09-2019 11:42:00,1,2565.0,2323.0,0.906,12.676,4,2,0,2,2,0,2,0,0.0,0.0
1009,2163,26-09-2019 11:44:00,1,2348.0,2226.0,0.948,11.716,24,20,15,5,4,1,3,0,0.0,0.0
1009,2164,26-09-2019 11:46:00,1,2380.0,2157.0,0.906,11.763,6,6,4,2,0,0,0,0,0.0,0.0
1009,2165,26-09-2019 11:48:00,1,2394.0,2121.0,0.886,11.781,2,2,0,2,0,0,0,0,0.0,0.0
1009,2166,26-09-2019 11:50:00,1,2398.0,2085.0,0.869,11.758,1,1,0,1,0,0,0,0,0.0,0.0
1009,2167,26-09-2019 11:52:00,1,2375.5,2139.0,0.9005,11.7275,0,0,0,0,0,0,0,0,0.0,0.0
1009,2168,26-09-2019 11:54:00,1,2353.0,2193.0,0.932,11.697,45,32,18,14,13,8,5,0,0.0,0.0
1009,2169,26-09-2019 11:56:00,1,2467.0,2225.0,0.902,12.185,3,3,1,2,0,0,0,0,0.0,0.0
1009,2170,26-09-2019 11:58:00,1,2376.0,2178.0,0.917,11.771,0,0,0,0,0,0,0,0,0.0,0.0
1009,2171,26-09-2019 12:00:00,1,2391.0,2117.0,0.886,11.763,7,6,0,6,1,1,0,0,0.0,0.0
1009,2172,26-09-2019 12:02:00,1,2404.0,2070.0,0.861,11.765,0,0,0,0,0,0,0,0,0.0,0.0
1009,2173,26-09-2019 12:04:00,1,2189.0,2010.0,0.918,10.851,8,5,2,3,3,0,3,0,0.0,0.0
1009,2174,26-09-2019 12:06:00,1,2189.0,1996.0,0.912,10.834,6,4,2,2,2,0,2,0,0.0,0.0
1009,2175,26-09-2019 12:08:00,1,2302.0,2023.0,0.879,11.308,0,0,0,0,0,0,0,0,0.0,0.0
1009,2176,26-09-2019 12:10:00,1,2397.0,2031.0,0.847,11.694,33,30,12,18,3,2,1,1,0.0,0.0
1009,2177,26-09-2019 12:12:00,1,2367.0,2198.0,0.928,11.76,21,20,6,14,1,0,1,0,0.0,0.0
1009,2178,26-09-2019 12:14:00,1,2553.0,2329.0,0.912,12.637,14,10,4,6,4,1,3,1,0.0,0.0
1009,2179,26-09-2019 12:16:00,1,2547.0,2321.0,0.911,12.605,17,16,2,14,1,0,1,0,0.0,0.0
1009,2180,26-09-2019 12:18:00,1,2548.0,2358.0,0.925,12.65,74,52,22,30,22,12,10,3,0.0,0.0
1009,2181,26-09-2019 12:20:00,1,2754.0,2460.0,0.893,13.574,0,0,0,0,0,0,0,0,0.0,0.0
1009,2182,26-09-2019 12:22:00,1,2539.0,2402.0,0.946,12.664,0,0,0,0,0,0,0,0,0.0,0.0
1009,2183,26-09-2019 12:24:00,1,2571.0,2269.0,0.883,12.64,2,2,1,1,0,0,0,0,0.0,0.0
1009,2184,26-09-2019 12:26:00,1,2485.5,2177.5,0.876,12.2035,7,7,0,7,0,0,0,0,0.0,0.0
1009,2185,26-09-2019 12:28:00,1,2400.0,2086.0,0.869,11.767,1,1,0,1,0,0,0,0,0.0,0.0
1009,2186,26-09-2019 12:30:00,1,2393.0,2075.0,0.867,11.727,0,0,0,0,0,0,0,0,0.0,0.0
1009,2187,26-09-2019 12:32:00,1,2405.0,2017.0,0.839,11.708,0,0,0,0,0,0,0,0,0.0,0.0
1009,2188,26-09-2019 12:34:00,1,2418.0,2001.0,0.828,11.741,96,49,36,13,47,36,11,4,0.0,0.0
1009,2189,26-09-2019 12:36:00,1,2388.0,2087.0,0.874,11.718,10,10,0,10,0,0,0,0,0.0,0.0
1009,2190,26-09-2019 12:38:00,1,2387.0,2136.0,0.895,11.769,0,0,0,0,0,0,0,0,0.0,0.0
1009,2191,26-09-2019 12:40:00,1,2390.0,2104.0,0.88,11.747,0,0,0,0,0,0,0,0,0.0,0.0
1009,2192,26-09-2019 12:42:00,1,2390.0,2085.0,0.872,11.725,10,5,0,5,5,1,4,0,0.0,0.0
1009,2193,26-09-2019 12:44:00,1,2504.0,2107.0,0.841,12.198,25,15,9,6,10,5,5,0,0.0,0.0
1009,2194,26-09-2019 12:46:00,1,2396.0,2088.0,0.871,11.753,8,8,0,8,0,0,0,0,0.0,0.0
1009,2195,26-09-2019 12:48:00,1,2409.0,2025.0,0.841,11.733,3,3,1,2,0,0,0,0,0.0,0.0
1009,2196,26-09-2019 12:50:00,1,2424.0,1975.0,0.815,11.739,0,0,0,0,0,0,0,0,0.0,0.0
1009,2197,26-09-2019 12:52:00,1,2329.0,1888.0,0.81,11.268,4,4,1,3,0,0,0,0,0.0,0.0
1009,2198,26-09-2019 12:54:00,1,2436.0,1904.0,0.781,11.707,1,1,1,0,0,0,0,0,0.0,0.0
1009,2199,26-09-2019 12:56:00,1,2433.0,1929.0,0.793,11.722,0,0,0,0,0,0,0,0,0.0,0.0
1009,2200,26-09-2019 12:58:00,1,2341.0,1889.0,0.807,11.316,3,1,1,0,2,0,2,0,0.0,0.0
1009,2201,26-09-2019 13:00:00,1,2287.5,1865.0,0.8155,11.078,0,0,0,0,0,0,0,0,0.0,0.0
1009,2202,26-09-2019 13:02:00,1,2234.0,1841.0,0.824,10.84,5,3,0,3,2,0,2,0,0.0,0.0
1009,2203,26-09-2019 13:04:00,1,2237.0,1835.0,0.82,10.847,0,0,0,0,0,0,0,0,0.0,0.0
1009,2204,26-09-2019 13:06:00,1,2230.0,1797.0,0.806,10.778,0,0,0,0,0,0,0,0,0.0,0.0
1009,2205,26-09-2019 13:08:00,1,2252.0,1774.0,0.788,10.838,0,0,0,0,0,0,0,0,0.0,0.0
1009,2206,26-09-2019 13:10:00,1,2136.0,1758.0,0.823,10.362,174,101,70,31,73,47,26,4,0.0,0.0
1009,2207,26-09-2019 13:12:00,1,2420.0,1925.0,0.796,11.667,0,0,0,0,0,0,0,0,0.0,0.0
1009,2208,26-09-2019 13:14:00,1,2423.0,1932.0,0.797,11.685,1,1,1,0,0,0,0,0,0.0,0.0
1009,2209,26-09-2019 13:16:00,1,2321.0,1916.0,0.825,11.266,20,0,0,0,20,1,19,0,0.0,0.0
1009,2210,26-09-2019 13:18:00,1,2220.0,1872.0,0.843,10.821,12,0,0,0,12,0,12,0,0.0,0.0
1009,2211,26-09-2019 13:20:00,1,2224.0,1841.0,0.828,10.803,0,0,0,0,0,0,0,0,0.0,0.0
1009,2212,26-09-2019 13:22:00,1,2254.0,1769.0,0.785,10.838,2,1,0,1,1,0,1,0,0.0,0.0
1009,2213,26-09-2019 13:24:00,1,2156.0,1720.0,0.798,10.398,82,71,34,37,11,1,10,1,0.0,0.0
1009,2214,26-09-2019 13:26:00,1,2422.0,1957.0,0.808,11.711,114,88,49,39,26,14,12,2,0.0,0.0
1009,2215,26-09-2019 13:28:00,1,2608.0,2127.0,0.815,12.63,57,6,3,3,51,45,6,0,0.0,0.0
1009,2216,26-09-2019 13:30:00,1,2583.0,2238.0,0.867,12.654,32,4,2,2,28,26,2,0,0.0,0.0
1009,2217,26-09-2019 13:32:00,1,2580.0,2248.0,0.871,12.654,128,22,8,14,106,95,11,3,0.0,0.0
1009,2218,26-09-2019 13:34:00,1,2727.0,2316.5,0.8505,13.3095,77,11,0,11,66,61,5,0,0.0,0.0
1009,2219,26-09-2019 13:36:00,1,2874.0,2385.0,0.83,13.965,171,108,71,37,63,59,4,40,0.0,0.0
1009,2220,26-09-2019 13:38:00,1,2844.0,2484.0,0.874,13.954,216,55,24,31,161,155,6,62,0.0,0.0
1009,2221,26-09-2019 13:40:00,1,3018.0,2677.0,0.887,14.856,139,36,18,18,103,101,2,72,0.0,0.09
1009,2222,26-09-2019 13:42:00,1,3335.0,2855.0,0.856,16.302,407,158,120,38,249,211,38,50,0.09,0.01
1009,2223,26-09-2019 13:44:00,1,2838.0,2526.0,0.89,13.978,843,529,448,81,314,237,77,90,0.0,0.0
1009,2224,26-09-2019 13:46:00,1,3025.0,2687.0,0.888,14.893,708,437,360,77,271,201,70,60,0.0,0.03
1009,2225,26-09-2019 13:48:00,1,3230.0,2760.0,0.854,15.783,763,456,375,81,307,233,74,36,0.02,0.0
1009,2226,26-09-2019 13:50:00,1,3239.0,2788.0,0.861,15.85,595,454,366,88,141,95,46,52,0.01,0.0
1009,2227,26-09-2019 13:52:00,1,3235.0,2787.0,0.862,15.831,490,290,235,55,200,140,60,36,0.0,0.0
1009,2228,26-09-2019 13:54:00,1,3023.0,2693.0,0.891,14.891,344,212,163,49,132,87,45,19,0.0,0.0
1009,2229,26-09-2019 13:56:00,1,3114.0,2760.0,0.886,15.324,43,35,20,15,8,2,6,0,0.0,0.0
1009,2230,26-09-2019 13:58:00,1,3003.0,2726.0,0.908,14.851,12,7,0,7,5,0,5,0,0.0,0.0
1009,2231,26-09-2019 14:00:00,1,3124.0,2741.0,0.878,15.342,3,0,0,0,3,0,3,0,0.0,0.0
1009,2232,26-09-2019 14:02:00,1,3030.0,2670.0,0.881,14.894,1,0,0,0,1,0,1,0,0.0,0.0
1009,2233,26-09-2019 14:04:00,1,2844.0,2527.0,0.889,14.003,19,13,8,5,6,1,5,0,0.0,0.0
1009,2234,26-09-2019 14:06:00,1,2860.0,2467.0,0.863,14.001,30,30,4,26,0,0,0,0,0.0,0.0
1009,2235,26-09-2019 14:08:00,1,2871.5,2432.0,0.8475,14.0065,29,20,4,16,9,1,8,0,0.0,0.0
1009,2236,26-09-2019 14:10:00,1,2883.0,2397.0,0.832,14.012,0,0,0,0,0,0,0,0,0.0,0.0
1009,2237,26-09-2019 14:12:00,1,2565.0,2321.0,0.905,12.676,0,0,0,0,0,0,0,0,0.0,0.0
1009,2238,26-09-2019 14:14:00,1,2589.0,2206.0,0.852,12.643,0,0,0,0,0,0,0,0,0.0,0.0
1009,2239,26-09-2019 14:16:00,1,2386.0,2114.0,0.886,11.743,0,0,0,0,0,0,0,0,0.0,0.0
1009,2240,26-09-2019 14:18:00,1,2396.0,2032.0,0.848,11.691,0,0,0,0,0,0,0,0,0.0,0.0
1009,2241,26-09-2019 14:20:00,1,2403.0,1990.0,0.828,11.672,0,0,0,0,0,0,0,0,0.0,0.0
1009,2242,26-09-2019 14:22:00,1,2199.0,1938.0,0.881,10.808,0,0,0,0,0,0,0,0,0.0,0.0
1009,2243,26-09-2019 14:24:00,1,2212.0,1909.0,0.863,10.827,32,27,14,13,5,0,5,0,0.0,0.0
1009,2244,26-09-2019 14:26:00,1,2219.0,1874.0,0.844,10.819,4,4,1,3,0,0,0,0,0.0,0.0
1009,2245,26-09-2019 14:28:00,1,2212.0,1900.0,0.859,10.819,2,2,0,2,0,0,0,0,0.0,0.0
1009,2246,26-09-2019 14:30:00,1,2216.0,1896.0,0.855,10.831,12,8,2,6,4,0,4,0,0.0,0.0
1009,2247,26-09-2019 14:32:00,1,2222.0,1884.0,0.848,10.84,4,0,0,0,4,0,4,0,0.0,0.0
1009,2248,26-09-2019 14:34:00,1,2435.0,1967.0,0.808,11.772,7,6,0,6,1,0,1,0,0.0,0.0
1009,2249,26-09-2019 14:36:00,1,2414.0,1992.0,0.825,11.716,19,19,0,19,0,0,0,0,0.0,0.0
1009,2250,26-09-2019 14:38:00,1,2408.0,2016.0,0.837,11.719,75,42,29,13,33,22,11,5,0.0,0.0
1009,2251,26-09-2019 14:40:00,1,2383.0,2072.0,0.869,11.682,114,66,42,24,48,16,32,59,0.0,0.27
1009,2252,26-09-2019 14:42:00,1,2483.0,2128.0,0.857,12.1395,2,0,0,0,2,0,2,0,0.0,0.03
1009,2253,26-09-2019 14:44:00,1,2583.0,2184.0,0.845,12.597,4,0,0,0,4,0,4,0,0.0,0.01
1009,2254,26-09-2019 14:46:00,1,2569.0,2276.0,0.886,12.642,110,53,44,9,57,31,26,5,0.0,0.0
1009,2255,26-09-2019 14:48:00,1,2871.0,2438.0,0.849,14.012,132,88,57,31,44,24,20,5,0.0,0.0
1009,2256,26-09-2019 14:50:00,1,2835.0,2572.0,0.907,14.017,209,118,95,23,91,72,19,5,0.05,0.01
1009,2257,26-09-2019 14:52:00,1,2834.0,2594.0,0.915,14.037,30,27,3,24,3,1,2,2,0.0,0.0
1009,2258,26-09-2019 14:54:00,1,2798.0,2643.0,0.945,13.948,104,59,35,24,45,15,30,11,0.02,0.0
1009,2259,26-09-2019 14:56:00,1,3001.0,2768.0,0.922,14.886,581,359,294,65,222,168,54,18,0.09,0.0
1009,2260,26-09-2019 14:58:00,1,3006.0,2749.0,0.914,14.887,615,375,301,74,240,178,62,46,0.01,0.01
1009,2261,26-09-2019 15:00:00,1,2988.0,2785.0,0.932,14.856,323,242,182,60,81,51,30,14,0.0,0.0
1009,2262,26-09-2019 15:02:00,1,2981.0,2849.0,0.956,14.897,591,412,333,79,179,117,62,21,0.04,0.0
1009,2263,26-09-2019 15:04:00,1,2984.0,2898.0,0.971,14.967,377,265,210,55,112,76,36,24,0.01,0.0
1009,2264,26-09-2019 15:06:00,1,2977.0,2905.0,0.976,14.947,79,57,21,36,22,4,18,1,0.0,0.0
1009,2265,26-09-2019 15:08:00,1,2968.0,2883.0,0.971,14.885,40,9,5,4,31,0,31,3,0.0,0.0
1009,2266,26-09-2019 15:10:00,1,2968.0,2861.0,0.964,14.861,0,0,0,0,0,0,0,0,0.0,0.0
1009,2267,26-09-2019 15:12:00,1,2800.0,2699.0,0.964,14.02,0,0,0,0,0,0,0,0,0.0,0.0
1009,2268,26-09-2019 15:14:00,1,2816.0,2577.0,0.915,13.948,1,1,0,1,0,0,0,0,0.0,0.0
1009,2269,26-09-2019 15:16:00,1,2673.5,2502.0,0.937,13.3035,0,0,0,0,0,0,0,0,0.0,0.0
1009,2270,26-09-2019 15:18:00,1,2531.0,2427.0,0.959,12.659,0,0,0,0,0,0,0,0,0.0,0.0
1009,2271,26-09-2019 15:20:00,1,2554.0,2338.0,0.915,12.652,0,0,0,0,0,0,0,0,0.0,0.0
1009,2272,26-09-2019 15:22:00,1,2353.0,2240.0,0.952,11.751,26,16,7,9,10,2,8,0,0.0,0.0
1009,2273,26-09-2019 15:24:00,1,2355.0,2165.0,0.919,11.674,3,3,0,3,0,0,0,0,0.0,0.0
1009,2274,26-09-2019 15:26:00,1,2365.0,2209.0,0.934,11.764,6,6,0,6,0,0,0,0,0.0,0.0
1009,2275,26-09-2019 15:28:00,1,2367.0,2217.0,0.936,11.781,10,9,2,7,1,0,1,0,0.0,0.0
1009,2276,26-09-2019 15:30:00,1,2349.0,2229.0,0.949,11.723,1,1,0,1,0,0,0,0,0.01,0.01
1009,2277,26-09-2019 15:32:00,1,2340.0,2257.0,0.965,11.718,2,1,0,1,1,0,1,0,0.0,0.0
1009,2278,26-09-2019 15:34:00,1,2333.0,2301.0,0.986,11.74,0,0,0,0,0,0,0,0,0.0,0.0
1009,2279,26-09-2019 15:36:00,1,2341.0,2311.0,0.987,11.78,1,0,0,0,1,0,1,0,0.0,0.0
1009,2280,26-09-2019 15:38:00,1,2338.0,2271.0,0.971,11.725,0,0,0,0,0,0,0,0,0.0,0.0
1009,2281,26-09-2019 15:40:00,1,2351.0,2269.0,0.965,11.773,0,0,0,0,0,0,0,0,0.0,0.0
1009,2282,26-09-2019 15:42:00,1,2334.0,2295.0,0.983,11.737,1,1,1,0,0,0,0,0,0.0,0.0
1009,2283,26-09-2019 15:44:00,1,2446.0,2307.0,0.943,12.191,4,2,0,2,2,0,2,0,0.0,0.0
1009,2284,26-09-2019 15:46:00,1,2552.0,2356.0,0.923,12.662,2,0,0,0,2,1,1,0,0.0,0.0
1009,2285,26-09-2019 15:48:00,1,2547.0,2365.0,0.928,12.655,5,5,3,2,0,0,0,0,0.0,0.0
1009,2286,26-09-2019 15:50:00,1,2549.0,2329.5,0.9135,12.623,0,0,0,0,0,0,0,0,0.0,0.0
1009,2287,26-09-2019 15:52:00,1,2551.0,2294.0,0.899,12.591,16,15,5,10,1,1,0,0,0.0,0.0
1009,2288,26-09-2019 15:54:00,1,2552.0,2294.0,0.899,12.596,1,1,0,1,0,0,0,0,0.0,0.0
1009,2289,26-09-2019 15:56:00,1,2554.0,2323.0,0.91,12.634,1,1,0,1,0,0,0,0,0.0,0.0
1009,2290,26-09-2019 15:58:00,1,2450.0,2312.0,0.944,12.211,3,3,0,3,0,0,0,0,0.0,0.0
1009,2291,26-09-2019 16:00:00,1,2556.0,2315.0,0.906,12.634,5,5,2,3,0,0,0,0,0.0,0.0
1009,2292,26-09-2019 16:02:00,1,2555.0,2367.0,0.927,12.685,95,18,9,9,77,55,22,5,0.0,0.0
1009,2293,26-09-2019 16:04:00,1,2531.0,2441.0,0.965,12.674,38,2,0,2,36,0,36,0,0.0,0.0
1009,2294,26-09-2019 16:06:00,1,2549.0,2375.0,0.932,12.673,159,55,40,15,104,65,39,19,0.0,0.0
1009,2295,26-09-2019 16:08:00,1,2562.0,2332.0,0.91,12.674,22,15,5,10,7,2,5,0,0.0,0.0
1009,2296,26-09-2019 16:10:00,1,2560.0,2344.0,0.916,12.682,1,1,0,1,0,0,0,0,0.0,0.0
1009,2297,26-09-2019 16:12:00,1,2450.0,2287.0,0.933,12.187,2,2,0,2,0,0,0,0,0.0,0.0
1009,2298,26-09-2019 16:14:00,1,2357.0,2195.0,0.931,11.717,1,1,0,1,0,0,0,0,0.0,0.0
1009,2299,26-09-2019 16:16:00,1,2378.0,2145.0,0.902,11.746,20,2,0,2,18,0,18,0,0.0,0.0
1009,2300,26-09-2019 16:18:00,1,2283.0,2107.0,0.923,11.326,2,0,0,0,2,0,2,0,0.0,0.0
1009,2301,26-09-2019 16:20:00,1,2398.0,2096.0,0.874,11.77,7,3,0,3,4,0,4,0,0.0,0.0
1009,2302,26-09-2019 16:22:00,1,2392.0,2091.0,0.874,11.738,0,0,0,0,0,0,0,0,0.0,0.0
1009,2303,26-09-2019 16:24:00,1,2387.5,2098.5,0.879,11.73,8,8,3,5,0,0,0,0,0.0,0.0
1009,2304,26-09-2019 16:26:00,1,2383.0,2106.0,0.884,11.722,0,0,0,0,0,0,0,0,0.0,0.0
1009,2305,26-09-2019 16:28:00,1,2296.0,2022.0,0.881,11.286,7,7,2,5,0,0,0,0,0.0,0.0
1009,2306,26-09-2019 16:30:00,1,2186.0,2011.0,0.92,10.838,6,3,1,2,3,0,3,0,0.0,0.0
1009,2307,26-09-2019 16:32:00,1,2285.0,2063.0,0.903,11.289,0,0,0,0,0,0,0,0,0.0,0.0
1009,2308,26-09-2019 16:34:00,1,2384.0,2106.0,0.884,11.725,0,0,0,0,0,0,0,0,0.0,0.0
1009,2309,26-09-2019 16:36:00,1,2380.0,2120.0,0.891,11.723,5,2,1,1,3,0,3,0,0.0,0.0
1009,2310,26-09-2019 16:38:00,1,2376.0,2166.0,0.912,11.759,5,0,0,0,5,0,5,0,0.0,0.0
1009,2311,26-09-2019 16:40:00,1,2374.0,2168.0,0.913,11.753,5,0,0,0,5,0,5,0,0.0,0.0
1009,2312,26-09-2019 16:42:00,1,2365.0,2195.0,0.928,11.75,29,12,4,8,17,7,10,0,0.0,0.0
1009,2313,26-09-2019 16:44:00,1,2582.0,2253.0,0.873,12.668,105,85,48,37,20,0,20,1,0.0,0.0
1009,2314,26-09-2019 16:46:00,1,2549.0,2382.0,0.934,12.682,72,64,22,42,8,0,8,0,0.0,0.0
1009,2315,26-09-2019 16:48:00,1,2745.0,2469.0,0.899,13.551,67,67,38,29,0,0,0,0,0.0,0.0
1009,2316,26-09-2019 16:50:00,1,2839.0,2539.0,0.894,13.997,0,0,0,0,0,0,0,0,0.0,0.0
1009,2317,26-09-2019 16:52:00,1,2838.0,2542.0,0.896,13.998,45,17,3,14,28,12,16,1,0.0,0.0
1009,2318,26-09-2019 16:54:00,1,2819.0,2597.0,0.921,13.984,140,92,63,29,48,18,30,1,0.0,0.0
1009,2319,26-09-2019 16:56:00,1,2930.0,2668.0,0.911,14.497,163,88,56,32,75,42,33,0,0.0,0.0
1009,2320,26-09-2019 16:58:00,1,2976.5,2695.0,0.9055,14.711,178,108,78,30,70,40,30,15,0.0,0.0
1009,2321,26-09-2019 17:00:00,1,3023.0,2722.0,0.9,14.925,169,58,28,30,111,64,47,62,0.01,0.01
1009,2322,26-09-2019 17:02:00,1,3005.0,2736.0,0.911,14.869,141,48,22,26,93,54,39,48,0.08,0.05
1009,2323,26-09-2019 17:04:00,1,2823.0,2632.0,0.932,14.036,257,165,122,43,92,59,33,50,0.0,0.01
1009,2324,26-09-2019 17:06:00,1,2854.0,2480.0,0.869,13.99,48,30,8,22,18,2,16,0,0.0,0.0
1009,2325,26-09-2019 17:08:00,1,3108.0,2838.0,0.913,15.386,54,36,5,31,18,0,18,1,0.0,0.02
1009,2326,26-09-2019 17:10:00,1,3285.0,2953.0,0.899,16.214,78,55,16,39,23,2,21,0,0.0,0.0
1009,2327,26-09-2019 17:12:00,1,3298.0,2934.0,0.89,16.243,35,23,4,19,12,0,12,0,0.0,0.0
1009,2328,26-09-2019 17:14:00,1,3308.0,2909.0,0.88,16.253,0,0,0,0,0,0,0,0,0.0,0.0
1009,2329,26-09-2019 17:16:00,1,2996.0,2778.0,0.927,14.879,0,0,0,0,0,0,0,0,0.0,0.0
1009,2330,26-09-2019 17:18:00,1,2915.0,2645.0,0.907,14.415,0,0,0,0,0,0,0,0,0.0,0.0
1009,2331,26-09-2019 17:20:00,1,2848.0,2526.0,0.887,14.016,0,0,0,0,0,0,0,0,0.0,0.0
1009,2332,26-09-2019 17:22:00,1,2756.0,2437.0,0.884,13.555,23,17,11,6,6,0,6,0,0.0,0.0
1009,2333,26-09-2019 17:24:00,1,2659.0,2392.0,0.9,13.123,2,0,0,0,2,0,2,0,0.0,0.0
1009,2334,26-09-2019 17:26:00,1,2868.0,2464.0,0.859,14.028,2,0,0,0,2,0,2,0,0.0,0.0
1009,2335,26-09-2019 17:28:00,1,2757.0,2431.0,0.882,13.555,0,0,0,0,0,0,0,0,0.0,0.0
1009,2336,26-09-2019 17:30:00,1,2657.0,2393.0,0.901,13.117,2,0,0,0,2,0,2,0,0.0,0.0
1009,2337,26-09-2019 17:32:00,1,2748.5,2466.5,0.8975,13.5585,95,59,40,19,36,1,35,36,0.0,0.01
1009,2338,26-09-2019 17:34:00,1,2840.0,2540.0,0.894,14.0,85,37,16,21,48,2,46,62,0.0,0.04
1009,2339,26-09-2019 17:36:00,1,3007.0,2749.0,0.914,14.892,148,65,50,15,83,38,45,53,0.23,0.06
1009,2340,26-09-2019 17:38:00,1,3198.0,2958.0,0.925,15.873,213,118,80,38,95,54,41,66,0.0,0.01
1009,2341,26-09-2019 17:40:00,1,2553.0,2283.0,0.894,12.588,47,19,5,14,28,2,26,1,0.0,0.02
1009,2342,26-09-2019 17:42:00,1,2844.0,2469.0,0.868,13.94,6,3,2,1,3,0,3,0,0.0,0.0
1009,2343,26-09-2019 17:44:00,1,2920.0,2630.0,0.901,14.416,0,0,0,0,0,0,0,0,0.0,0.0
1009,2344,26-09-2019 17:46:00,1,3028.0,2712.0,0.896,14.931,20,20,1,19,0,0,0,0,0.0,0.0
1009,2345,26-09-2019 17:48:00,1,2911.0,2665.0,0.915,14.422,15,10,7,3,5,0,5,0,0.0,0.0
1009,2346,26-09-2019 17:50:00,1,2806.0,2630.0,0.938,13.967,16,16,2,14,0,0,0,0,0.0,0.0
1009,2347,26-09-2019 17:52:00,1,2828.0,2613.0,0.924,14.034,1,1,1,0,0,0,0,0,0.0,0.01
1009,2348,26-09-2019 17:54:00,1,2851.0,2525.0,0.886,14.028,0,0,0,0,0,0,0,0,0.0,0.0
1009,2349,26-09-2019 17:56:00,1,2858.0,2447.0,0.856,13.968,9,9,2,7,0,0,0,0,0.0,0.0
1009,2350,26-09-2019 17:58:00,1,2743.0,2474.0,0.902,13.546,3,3,2,1,0,0,0,0,0.0,0.0
1009,2351,26-09-2019 18:00:00,0,2850.0,2499.0,0.877,13.994,31,24,14,10,7,4,3,2,0.0,0.0
1009,2352,26-09-2019 18:02:00,0,3003.0,2749.0,0.915,14.877,501,269,208,61,232,171,61,25,0.0,0.0
1009,2353,26-09-2019 18:04:00,0,3281.0,3016.0,0.919,16.266,271,200,147,53,71,42,29,20,0.0,0.0
1009,2354,26-09-2019 18:06:00,0,3384.5,3063.5,0.9055,16.727,128,113,81,32,15,0,15,7,0.0,0.0
1009,2355,26-09-2019 18:08:00,0,3488.0,3111.0,0.892,17.188,111,98,62,36,13,0,13,0,0.0,0.0
1009,2356,26-09-2019 18:10:00,0,3474.0,3145.0,0.905,17.17,96,77,48,29,19,0,19,4,0.0,0.0
1009,2357,26-09-2019 18:12:00,0,3440.0,3264.0,0.949,17.165,204,133,85,48,71,48,23,33,0.0,0.0
1009,2358,26-09-2019 18:14:00,0,3925.0,3652.0,0.931,19.507,515,384,331,53,131,99,32,32,0.0,0.0
1009,2359,26-09-2019 18:16:00,0,3644.0,3356.0,0.921,18.071,278,173,134,39,105,84,21,18,0.0,0.0
1009,2360,26-09-2019 18:18:00,0,3632.0,3374.0,0.929,18.044,252,150,117,33,102,76,26,46,0.0,0.0
1009,2361,26-09-2019 18:20:00,0,3645.0,3305.0,0.907,18.02,417,238,185,53,179,137,42,87,0.0,0.0
1009,2362,26-09-2019 18:22:00,0,3823.0,3457.0,0.904,18.891,566,337,263,74,229,181,48,20,0.0,0.0
1009,2363,26-09-2019 18:24:00,0,3954.0,3482.0,0.881,19.432,471,250,186,64,221,168,53,14,0.0,0.0
1009,2364,26-09-2019 18:26:00,0,3848.0,3432.0,0.892,18.963,374,238,180,58,136,94,42,28,0.0,0.0
1009,2365,26-09-2019 18:28:00,0,3656.0,3330.0,0.911,18.091,278,129,83,46,149,103,46,3,0.0,0.0
1009,2366,26-09-2019 18:30:00,0,3684.0,3206.0,0.87,18.065,190,123,87,36,67,43,24,5,0.0,0.0
1009,2367,26-09-2019 18:32:00,0,3334.0,2835.0,0.85,16.276,287,162,115,47,125,92,33,30,0.0,0.0
1009,2368,26-09-2019 18:34:00,0,3500.0,3049.0,0.871,17.167,183,129,102,27,54,35,19,17,0.0,0.0
1009,2369,26-09-2019 18:36:00,0,3334.0,2786.0,0.836,16.221,265,183,138,45,82,64,18,23,0.0,0.0
1009,2370,26-09-2019 18:38:00,0,3485.0,3117.0,0.894,17.181,40,27,6,21,13,0,13,3,0.0,0.0
1009,2371,26-09-2019 18:40:00,0,3579.0,3188.5,0.891,17.63,97,66,30,36,31,11,20,29,0.0,0.0
1009,2372,26-09-2019 18:42:00,0,3673.0,3260.0,0.888,18.079,78,56,39,17,22,19,3,19,0.0,0.0
1009,2373,26-09-2019 18:44:00,0,3674.0,3131.0,0.852,17.943,1,1,1,0,0,0,0,0,0.0,0.0
1009,2374,26-09-2019 18:46:00,0,3491.0,2992.0,0.857,17.069,3,2,0,2,1,0,1,0,0.0,0.0
1009,2375,26-09-2019 18:48:00,0,3326.0,2862.0,0.861,16.274,80,72,37,35,8,2,6,1,0.0,0.0
1009,2376,26-09-2019 18:50:00,0,3320.0,2807.0,0.845,16.189,48,29,11,18,19,0,19,0,0.0,0.0
1009,2377,26-09-2019 18:52:00,0,3425.0,2867.0,0.837,16.669,367,171,139,32,196,140,56,17,0.0,0.0
1009,2378,26-09-2019 18:54:00,0,3438.0,2865.0,0.833,16.718,246,171,122,49,75,52,23,15,0.0,0.0
1009,2379,26-09-2019 18:56:00,0,3528.0,2920.0,0.828,17.134,469,295,229,66,174,132,42,58,0.0,0.0
1009,2380,26-09-2019 18:58:00,0,3510.0,3010.0,0.857,17.162,576,332,250,82,244,184,60,27,0.0,0.0
1009,2381,26-09-2019 19:00:00,0,3709.0,3113.0,0.839,18.059,435,312,230,82,123,85,38,22,0.0,0.0
1009,2382,26-09-2019 19:02:00,0,3715.0,3127.0,0.842,18.1,388,210,164,46,178,128,50,35,0.0,0.0
1009,2383,26-09-2019 19:04:00,0,3527.0,2942.0,0.834,17.155,285,222,176,46,63,26,37,43,0.0,0.0
1009,2384,26-09-2019 19:06:00,0,3719.0,3079.0,0.828,18.062,322,250,175,75,72,41,31,17,0.0,0.0
1009,2385,26-09-2019 19:08:00,0,3541.0,2868.0,0.81,17.126,255,129,92,37,126,88,38,38,0.0,0.0
1009,2386,26-09-2019 19:10:00,0,3574.0,2756.0,0.771,17.133,110,55,26,29,55,29,26,4,0.0,0.0
1009,2387,26-09-2019 19:12:00,0,3735.0,2988.0,0.8,18.024,459,258,193,65,201,154,47,54,0.0,0.0
1009,2388,26-09-2019 19:14:00,0,3737.0,2960.0,0.792,18.0005,27,19,10,9,8,4,4,0,0.0,0.0
1009,2389,26-09-2019 19:16:00,0,3739.0,2932.0,0.784,17.977,157,86,54,32,71,48,23,9,0.0,0.0
1009,2390,26-09-2019 19:18:00,0,3361.0,2681.0,0.798,16.209,239,151,97,54,88,60,28,15,0.0,0.0
1009,2391,26-09-2019 19:20:00,0,3523.0,2849.0,0.809,17.037,345,140,97,43,205,151,54,6,0.0,0.0
1009,2392,26-09-2019 19:22:00,0,3562.0,2815.0,0.79,17.152,291,181,134,47,110,75,35,81,0.0,0.0
1009,2393,26-09-2019 19:24:00,0,3647.0,2899.0,0.795,17.578,305,168,123,45,137,101,36,55,0.0,0.0
1009,2394,26-09-2019 19:26:00,0,3753.0,2904.0,0.774,18.003,271,243,177,66,28,0,28,9,0.0,0.0
1009,2395,26-09-2019 19:28:00,0,3741.0,3000.0,0.802,18.062,256,128,95,33,128,83,45,2,0.0,0.0
1009,2396,26-09-2019 19:30:00,0,3750.0,2926.0,0.78,18.016,207,141,101,40,66,40,26,25,0.0,0.0
1009,2397,26-09-2019 19:32:00,0,3578.0,2729.0,0.763,17.119,91,66,14,52,25,0,25,10,0.0,0.0
1009,2398,26-09-2019 19:34:00,0,3765.0,2963.0,0.787,18.116,51,22,8,14,29,0,29,0,0.0,0.0
1009,2399,26-09-2019 19:36:00,0,3748.0,2921.0,0.779,18.002,84,76,43,33,8,0,8,5,0.0,0.0
1009,2400,26-09-2019 19:38:00,0,3768.0,2861.0,0.759,18.013,385,227,172,55,158,108,50,28,0.0,0.0
1009,2401,26-09-2019 19:40:00,0,3590.0,2712.0,0.755,17.147,386,235,169,66,151,102,49,13,0.0,0.0
1009,2402,26-09-2019 19:42:00,0,3772.0,2856.0,0.757,18.025,360,137,82,55,223,161,62,1,0.0,0.0
1009,2403,26-09-2019 19:44:00,0,3688.0,2769.0,0.751,17.598,429,188,132,56,241,186,55,5,0.0,0.0
1009,2404,26-09-2019 19:46:00,0,3553.0,2762.0,0.777,17.058,144,75,35,40,69,37,32,3,0.0,0.0
1009,2405,26-09-2019 19:48:00,0,3425.0,2649.5,0.7735,16.428,304,112,74,38,192,142,50,7,0.0,0.0
1009,2406,26-09-2019 19:50:00,0,3297.0,2537.0,0.77,15.798,97,52,26,26,45,29,16,0,0.0,0.0
1009,2407,26-09-2019 19:52:00,0,3460.0,2737.0,0.791,16.664,284,100,62,38,184,129,55,7,0.0,0.0
1009,2408,26-09-2019 19:54:00,0,3488.0,2674.0,0.767,16.704,133,58,46,12,75,60,15,31,0.0,0.0
1009,2409,26-09-2019 19:56:00,0,3455.0,2747.0,0.795,16.656,218,95,46,49,123,70,53,32,0.0,0.0
1009,2410,26-09-2019 19:58:00,0,3456.0,2778.0,0.804,16.692,200,73,31,42,127,80,47,0,0.0,0.0
1009,2411,26-09-2019 20:00:00,0,3468.0,2654.0,0.765,16.602,396,216,163,53,180,132,48,74,0.0,0.0
1009,2412,26-09-2019 20:02:00,0,3566.0,2783.0,0.78,17.133,435,215,146,69,220,165,55,7,0.0,0.0
1009,2413,26-09-2019 20:04:00,0,3671.0,2861.0,0.779,17.633,520,301,229,72,219,166,53,5,0.0,0.0
1009,2414,26-09-2019 20:06:00,0,3669.0,2804.0,0.764,17.559,121,47,25,22,74,44,30,0,0.0,0.0
1009,2415,26-09-2019 20:08:00,0,3471.0,2763.0,0.796,16.735,229,145,106,39,84,59,25,15,0.0,0.0
1009,2416,26-09-2019 20:10:00,0,3033.0,2254.0,0.743,14.448,378,171,125,46,207,164,43,48,0.0,0.0
1009,2417,26-09-2019 20:12:00,0,3582.0,2748.0,0.767,17.156,144,83,57,26,61,45,16,59,0.0,0.0
1009,2418,26-09-2019 20:14:00,0,3501.0,2605.0,0.744,16.68,299,230,167,63,69,37,32,14,0.0,0.0
1009,2419,26-09-2019 20:16:00,0,3657.0,2871.0,0.785,17.586,435,241,173,68,194,127,67,5,0.0,0.0
1009,2420,26-09-2019 20:18:00,0,3748.0,2915.0,0.778,17.997,372,204,144,60,168,124,44,2,0.0,0.0
1009,2421,26-09-2019 20:20:00,0,3664.0,2777.0,0.758,17.513,175,71,38,33,104,58,46,1,0.0,0.0
1009,2422,26-09-2019 20:22:00,0,3616.5,2784.5,0.77,17.334,192,79,51,28,113,79,34,4,0.0,0.0
1009,2423,26-09-2019 20:24:00,0,3569.0,2792.0,0.782,17.155,294,147,97,50,147,93,54,21,0.0,0.0
1009,2424,26-09-2019 20:26:00,0,3377.0,2648.0,0.784,16.239,290,157,108,49,133,98,35,15,0.0,0.0
1009,2425,26-09-2019 20:28:00,0,3296.0,2560.0,0.777,15.82,171,103,58,45,68,32,36,35,0.0,0.0
1009,2426,26-09-2019 20:30:00,0,3402.0,2511.0,0.738,16.183,287,141,104,37,146,113,33,30,0.0,0.0
1009,2427,26-09-2019 20:32:00,0,3558.0,2825.0,0.794,17.147,154,104,75,29,50,23,27,8,0.0,0.0
1009,2428,26-09-2019 20:34:00,0,2894.0,2338.0,0.808,13.992,241,163,119,44,78,44,34,6,0.0,0.0
1009,2429,26-09-2019 20:36:00,0,3371.0,2697.0,0.8,16.266,170,69,41,28,101,62,39,0,0.0,0.0
1009,2430,26-09-2019 20:38:00,0,3399.0,2520.0,0.741,16.185,187,48,29,19,139,96,43,2,0.0,0.0
1009,2431,26-09-2019 20:40:00,0,3569.0,2758.0,0.773,17.117,190,28,10,18,162,101,61,0,0.0,0.0
1009,2432,26-09-2019 20:42:00,0,3466.0,2718.0,0.784,16.666,284,139,85,54,145,105,40,2,0.0,0.0
1009,2433,26-09-2019 20:44:00,0,3400.0,2526.0,0.743,16.193,201,113,69,44,88,58,30,10,0.0,0.0
1009,2434,26-09-2019 20:46:00,0,2905.0,2289.0,0.788,13.98,251,94,65,29,157,113,44,54,0.0,0.0
1009,2435,26-09-2019 20:48:00,0,3399.0,2575.0,0.758,16.241,281,157,106,51,124,85,39,5,0.0,0.0
1009,2436,26-09-2019 20:50:00,0,3562.0,2812.0,0.789,17.147,213,99,54,45,114,77,37,9,0.0,0.0
1009,2437,26-09-2019 20:52:00,0,3300.0,2519.0,0.763,15.791,159,82,49,33,77,41,36,1,0.0,0.0
1009,2438,26-09-2019 20:54:00,0,3362.0,2646.0,0.787,16.175,246,120,88,32,126,88,38,46,0.0,0.0
1009,2439,26-09-2019 20:56:00,0,3473.0,2676.0,0.771,16.6455,363,206,151,55,157,109,48,122,0.01,0.0
1009,2440,26-09-2019 20:58:00,0,3584.0,2706.0,0.755,17.116,363,228,166,62,135,95,40,33,0.0,0.0
1009,2441,26-09-2019 21:00:00,0,3590.0,2728.0,0.76,17.166,160,75,38,37,85,58,27,10,0.0,0.0
1009,2442,26-09-2019 21:02:00,0,3575.0,2756.0,0.771,17.137,101,57,29,28,44,30,14,0,0.04,0.0
1009,2443,26-09-2019 21:04:00,0,3393.0,2523.0,0.744,16.162,94,55,12,43,39,15,24,1,0.0,0.0
1009,2444,26-09-2019 21:06:00,0,3309.0,2505.0,0.757,15.81,281,177,129,48,104,76,28,66,0.0,0.0
1009,2445,26-09-2019 21:08:00,0,3482.0,2688.0,0.772,16.696,261,107,79,28,154,112,42,74,0.04,0.0
1009,2446,26-09-2019 21:10:00,0,3386.0,2657.0,0.785,16.281,206,106,78,28,100,74,26,26,0.0,0.0
1009,2447,26-09-2019 21:12:00,0,3380.0,2657.0,0.786,16.259,262,112,78,34,150,106,44,11,0.0,0.0
1009,2448,26-09-2019 21:14:00,0,3219.0,2357.0,0.732,15.292,224,109,66,43,115,76,39,1,0.0,0.0
1009,2449,26-09-2019 21:16:00,0,3418.0,2543.0,0.744,16.282,199,81,43,38,118,79,39,1,0.0,0.0
1009,2450,26-09-2019 21:18:00,0,3115.0,2341.0,0.752,14.867,250,126,92,34,124,80,44,24,0.0,0.0
1009,2451,26-09-2019 21:20:00,0,2903.0,2290.0,0.789,13.975,136,116,77,39,20,10,10,50,0.0,0.0
1009,2452,26-09-2019 21:22:00,0,3111.0,2363.0,0.76,14.873,90,87,53,34,3,0,3,1,0.0,0.0
1009,2453,26-09-2019 21:24:00,0,3396.0,2549.0,0.751,16.202,222,121,83,38,101,76,25,12,0.0,0.0
1009,2454,26-09-2019 21:26:00,0,3371.0,2645.0,0.785,16.211,413,251,190,61,162,114,48,3,0.0,0.0
1009,2455,26-09-2019 21:28:00,0,3578.0,2742.0,0.766,17.135,432,337,258,79,95,69,26,26,0.0,0.0
1009,2456,26-09-2019 21:30:00,0,3626.0,2756.5,0.76,17.3385,422,295,219,76,127,85,42,13,0.03,0.0
1009,2457,26-09-2019 21:32:00,0,3674.0,2771.0,0.754,17.542,416,333,249,84,83,58,25,22,0.0,0.0
1009,2458,26-09-2019 21:34:00,0,3677.0,2763.0,0.751,17.546,252,155,115,40,97,64,33,2,0.0,0.0
1009,2459,26-09-2019 21:36:00,0,3331.0,2384.0,0.716,15.766,65,52,34,18,13,3,10,1,0.0,0.0
1009,2460,26-09-2019 21:38:00,0,3503.0,2533.0,0.723,16.607,162,92,45,47,70,47,23,2,0.0,0.0
1009,2461,26-09-2019 21:40:00,0,3701.0,2722.0,0.735,17.596,124,89,48,41,35,9,26,0,0.0,0.0
1009,2462,26-09-2019 21:42:00,0,3510.0,2561.0,0.73,16.664,320,260,194,66,60,42,18,12,0.01,0.0
1009,2463,26-09-2019 21:44:00,0,3515.0,2537.0,0.722,16.658,233,154,110,44,79,56,23,14,0.0,0.0
1009,2464,26-09-2019 21:46:00,0,3439.0,2430.0,0.707,16.241,327,122,86,36,205,152,53,23,0.02,0.0
1009,2465,26-09-2019 21:48:00,0,3335.0,2387.0,0.716,15.782,423,80,42,38,343,238,105,0,0.0,0.0
1009,2466,26-09-2019 21:50:00,0,3330.0,2379.0,0.714,15.756,236,159,109,50,77,51,26,19,0.0,0.0
1009,2467,26-09-2019 21:52:00,0,3535.0,2521.0,0.713,16.721,434,315,233,82,119,77,42,1,0.0,0.0
1009,2468,26-09-2019 21:54:00,0,3508.0,2609.0,0.744,16.712,292,201,151,50,91,55,36,7,0.06,0.0
1009,2469,26-09-2019 21:56:00,0,3522.0,2550.0,0.724,16.703,154,81,52,29,73,48,25,28,0.02,0.0
1009,2470,26-09-2019 21:58:00,0,3522.0,2509.0,0.712,16.657,484,270,199,71,214,159,55,21,0.03,0.0
1009,2471,26-09-2019 22:00:00,0,3509.0,2568.0,0.732,16.671,286,242,178,64,44,28,16,2,0.0,0.0
1009,2472,26-09-2019 22:02:00,0,3535.0,2507.0,0.709,16.703,244,72,44,28,172,108,64,4,0.0,0.0
1009,2473,26-09-2019 22:04:00,0,3439.0,2425.5,0.705,16.2345,56,13,4,9,43,20,23,0,0.0,0.0
1009,2474,26-09-2019 22:06:00,0,3343.0,2344.0,0.701,15.766,82,26,9,17,56,30,26,0,0.0,0.0
1009,2475,26-09-2019 22:08:00,0,3346.0,2373.0,0.709,15.811,61,52,19,33,9,5,4,0,0.0,0.0
1009,2476,26-09-2019 22:10:00,0,3348.0,2361.0,0.705,15.805,383,194,145,49,189,140,49,87,0.0,0.0
1009,2477,26-09-2019 22:12:00,0,3517.0,2544.0,0.723,16.674,403,327,246,81,76,48,28,6,0.0,0.0
1009,2478,26-09-2019 22:14:00,0,3598.0,2670.0,0.742,17.134,279,247,190,57,32,16,16,2,0.0,0.0
1009,2479,26-09-2019 22:16:00,0,3590.0,2664.0,0.742,17.096,462,305,224,81,157,114,43,3,0.0,0.0
1009,2480,26-09-2019 22:18:00,0,3695.0,2728.0,0.738,17.579,403,302,238,64,101,70,31,16,0.0,0.0
1009,2481,26-09-2019 22:20:00,0,3691.0,2700.0,0.732,17.532,445,316,241,75,129,93,36,2,0.0,0.0
1009,2482,26-09-2019 22:22:00,0,3698.0,2674.0,0.723,17.531,125,101,62,39,24,10,14,2,0.0,0.0
1009,2483,26-09-2019 22:24:00,0,3510.0,2514.0,0.716,16.614,96,86,48,38,10,1,9,3,0.0,0.0
1009,2484,26-09-2019 22:26:00,0,3528.0,2513.0,0.712,16.682,272,141,94,47,131,92,39,60,0.0,0.0
1009,2485,26-09-2019 22:28:00,0,3536.0,2478.0,0.701,16.676,115,64,44,20,51,26,25,0,0.0,0.0
1009,2486,26-09-2019 22:30:00,0,3498.0,2551.0,0.729,16.607,31,14,7,7,17,5,12,0,0.0,0.0
1009,2487,26-09-2019 22:32:00,0,3607.0,2616.0,0.725,17.108,293,183,137,46,110,80,30,122,0.0,0.0
1009,2488,26-09-2019 22:34:00,0,3531.0,2457.0,0.696,16.633,304,261,196,65,43,27,16,8,0.0,0.0
1009,2489,26-09-2019 22:36:00,0,3512.0,2541.0,0.723,16.65,396,322,246,76,74,47,27,2,0.0,0.0
1009,2490,26-09-2019 22:38:00,0,3379.5,2428.0,0.718,16.0045,74,36,24,12,38,6,32,0,0.0,0.0
1009,2491,26-09-2019 22:40:00,0,3247.0,2315.0,0.713,15.359,57,46,23,23,11,5,6,0,0.0,0.0
1009,2492,26-09-2019 22:42:00,0,3434.0,2441.0,0.711,16.232,231,127,94,33,104,76,28,40,0.0,0.0
1009,2493,26-09-2019 22:44:00,0,3432.0,2492.0,0.726,16.282,16,5,4,1,11,2,9,0,0.0,0.0
1009,2494,26-09-2019 22:46:00,0,3430.0,2459.0,0.717,16.238,144,62,28,34,82,55,27,1,0.0,0.0
1009,2495,26-09-2019 22:48:00,0,3321.0,2393.0,0.721,15.735,447,253,193,60,194,140,54,40,0.0,0.0
1009,2496,26-09-2019 22:50:00,0,3413.0,2518.0,0.738,16.237,336,295,218,77,41,20,21,2,0.0,0.0
1009,2497,26-09-2019 22:52:00,0,3402.0,2559.0,0.752,16.236,386,204,149,55,182,130,52,9,0.0,0.0
1009,2498,26-09-2019 22:54:00,0,3419.0,2531.0,0.74,16.275,457,328,259,69,129,89,40,19,0.0,0.0
1009,2499,26-09-2019 22:56:00,0,3211.0,2373.0,0.739,15.278,311,117,78,39,194,133,61,14,0.11,0.0
1009,2500,26-09-2019 22:58:00,0,3324.0,2367.0,0.712,15.719,379,201,153,48,178,112,66,83,0.04,0.0
1009,2501,26-09-2019 23:00:00,0,3444.0,2423.0,0.704,16.251,316,260,194,66,56,31,25,2,0.0,0.0
1009,2502,26-09-2019 23:02:00,0,3438.0,2401.0,0.698,16.206,118,66,40,26,52,26,26,3,0.0,0.0
1009,2503,26-09-2019 23:04:00,0,3231.0,2353.0,0.728,15.336,169,76,44,32,93,53,40,4,0.0,0.0
1009,2504,26-09-2019 23:06:00,0,3440.0,2411.0,0.701,16.224,74,25,19,6,49,24,25,3,0.0,0.0
1009,2505,26-09-2019 23:08:00,0,3230.0,2329.0,0.721,15.308,31,19,5,14,12,0,12,0,0.0,0.0
1009,2506,26-09-2019 23:10:00,0,3038.0,2183.0,0.719,14.388,3,3,2,1,0,0,0,0,0.0,0.0
1009,2507,26-09-2019 23:12:00,0,2993.0,2157.0,0.721,14.1805,49,40,33,7,9,3,6,7,0.0,0.0
1009,2508,26-09-2019 23:14:00,0,2948.0,2131.0,0.723,13.973,0,0,0,0,0,0,0,0,0.0,0.0
1009,2509,26-09-2019 23:16:00,0,2854.0,2027.0,0.71,13.488,0,0,0,0,0,0,0,0,0.02,0.0
1009,2510,26-09-2019 23:18:00,0,2770.0,1927.0,0.696,13.046,0,0,0,0,0,0,0,0,0.0,0.0
1009,2511,26-09-2019 23:20:00,0,2680.0,1847.0,0.689,12.605,24,22,14,8,2,0,2,0,0.0,0.0
1009,2512,26-09-2019 23:22:00,0,2484.0,1768.0,0.712,11.743,0,0,0,0,0,0,0,0,0.0,0.0
1009,2513,26-09-2019 23:24:00,0,2492.0,1715.0,0.688,11.719,2,2,0,2,0,0,0,0,0.0,0.0
1009,2514,26-09-2019 23:26:00,0,2276.0,1655.0,0.727,10.802,1,1,1,0,0,0,0,0,0.0,0.0
1009,2515,26-09-2019 23:28:00,0,2300.0,1591.0,0.692,10.824,1,1,0,1,0,0,0,0,0.0,0.0
1009,2516,26-09-2019 23:30:00,0,2312.0,1547.0,0.669,10.825,2,2,0,2,0,0,0,0,0.0,0.0
1009,2517,26-09-2019 23:32:00,0,2096.0,1497.0,0.714,9.917,6,6,0,6,0,0,0,0,0.0,0.0
1009,2518,26-09-2019 23:34:00,0,2109.0,1460.0,0.693,9.925,3,3,0,3,0,0,0,0,0.0,0.0
1009,2519,26-09-2019 23:36:00,0,2108.0,1452.0,0.689,9.913,0,0,0,0,0,0,0,0,0.0,0.0
1009,2520,26-09-2019 23:38:00,0,1994.0,1412.0,0.708,9.42,1,1,0,1,0,0,0,0,0.0,0.0
1009,2521,26-09-2019 23:40:00,0,2006.0,1400.0,0.698,9.453,5,1,0,1,4,0,4,0,0.0,0.0
1009,2522,26-09-2019 23:42:00,0,1895.0,1383.0,0.73,8.998,5,4,0,4,1,0,1,0,0.0,0.0
1009,2523,26-09-2019 23:44:00,0,1905.0,1367.0,0.717,9.018,3,0,0,0,3,0,3,0,0.0,0.0
1009,2524,26-09-2019 23:46:00,0,1904.0,1369.5,0.719,9.0165,1,0,0,0,1,0,1,0,0.0,0.0
1009,2525,26-09-2019 23:48:00,0,1903.0,1372.0,0.721,9.015,0,0,0,0,0,0,0,0,0.0,0.0
1009,2526,26-09-2019 23:50:00,0,2006.0,1373.0,0.684,9.425,0,0,0,0,0,0,0,0,0.0,0.0
1009,2527,26-09-2019 23:52:00,0,2111.0,1422.0,0.674,9.891,57,49,28,21,8,0,8,2,0.0,0.0
1009,2528,26-09-2019 23:54:00,0,2206.0,1508.0,0.684,10.363,334,235,188,47,99,64,35,25,0.0,0.0
1009,2529,26-09-2019 23:56:00,0,2463.0,1805.0,0.733,11.703,312,169,124,45,143,110,33,14,0.0,0.0
1009,2530,26-09-2019 23:58:00,0,2787.0,1901.0,0.682,13.085,405,285,225,60,120,75,45,48,0.0,0.0
1009,2531,27-09-2019 00:00:00,0,3148.0,2233.0,0.709,14.877,355,244,185,59,111,78,33,48,0.0,0.0
1009,2532,27-09-2019 00:02:00,0,2942.0,2127.0,0.723,13.948,230,140,102,38,90,62,28,53,0.0,0.0
1009,2533,27-09-2019 00:04:00,0,3029.0,2185.0,0.721,14.352,255,95,61,34,160,93,67,38,0.0,0.0
1009,2534,27-09-2019 00:06:00,0,3254.0,2244.0,0.69,15.307,326,203,155,48,123,86,37,61,0.0,0.0
1009,2535,27-09-2019 00:08:00,0,3434.0,2436.0,0.709,16.229,358,134,90,44,224,153,71,6,0.08,0.0
1009,2536,27-09-2019 00:10:00,0,3233.0,2322.0,0.718,15.309,224,112,77,35,112,75,37,78,0.0,0.0
1009,2537,27-09-2019 00:12:00,0,3410.0,2515.0,0.737,16.221,132,15,10,5,117,45,72,9,0.0,0.0
1009,2538,27-09-2019 00:14:00,0,3434.0,2411.0,0.702,16.2,209,120,92,28,89,62,27,49,0.0,0.0
1009,2539,27-09-2019 00:16:00,0,3454.0,2417.0,0.7,16.284,304,121,77,44,183,131,52,4,0.0,0.0
1009,2540,27-09-2019 00:18:00,0,3250.0,2254.0,0.693,15.3,257,108,69,39,149,118,31,6,0.0,0.0
1009,2541,27-09-2019 00:20:00,0,3337.5,2356.5,0.7055,15.7585,300,184,135,49,116,88,28,161,0.0,0.0
1009,2542,27-09-2019 00:22:00,0,3425.0,2459.0,0.718,16.217,403,341,255,86,62,39,23,3,0.0,0.0
1009,2543,27-09-2019 00:24:00,0,3402.0,2530.0,0.744,16.204,208,151,110,41,57,37,20,0,0.0,0.0
1009,2544,27-09-2019 00:26:00,0,3323.0,2397.0,0.721,15.747,275,170,122,48,105,62,43,25,0.0,0.0
1009,2545,27-09-2019 00:28:00,0,3381.0,2539.0,0.751,16.131,405,277,210,67,128,93,35,57,0.02,0.0
1009,2546,27-09-2019 00:30:00,0,3423.0,2498.0,0.73,16.25,78,44,25,19,34,15,19,0,0.0,0.0
1009,2547,27-09-2019 00:32:00,0,3417.0,2510.0,0.735,16.242,234,136,100,36,98,59,39,2,0.0,0.0
1009,2548,27-09-2019 00:34:00,0,3239.0,2327.0,0.719,15.337,198,105,68,37,93,66,27,29,0.0,0.0
1009,2549,27-09-2019 00:36:00,0,3441.0,2446.0,0.711,16.266,267,170,130,40,97,73,24,107,0.01,0.0
1009,2550,27-09-2019 00:38:00,0,3415.0,2526.0,0.74,16.254,311,230,171,59,81,58,23,1,0.01,0.0
1009,2551,27-09-2019 00:40:00,0,3232.0,2307.0,0.714,15.289,39,28,17,11,11,7,4,5,0.0,0.0
1009,2552,27-09-2019 00:42:00,0,3446.0,2426.0,0.704,16.263,57,57,21,36,0,0,0,9,0.0,0.0
1009,2553,27-09-2019 00:44:00,0,3418.0,2487.0,0.728,16.22,20,19,10,9,1,0,1,2,0.0,0.0
1009,2554,27-09-2019 00:46:00,0,3332.0,2400.0,0.72,15.786,0,0,0,0,0,0,0,0,0.0,0.0
1009,2555,27-09-2019 00:48:00,0,3256.0,2274.0,0.698,15.349,0,0,0,0,0,0,0,0,0.0,0.0
1009,2556,27-09-2019 00:50:00,0,2940.0,2127.0,0.724,13.938,0,0,0,0,0,0,0,0,0.0,0.0
1009,2557,27-09-2019 00:52:00,0,2753.0,2008.0,0.729,13.07,0,0,0,0,0,0,0,0,0.0,0.0
1009,2558,27-09-2019 00:54:00,0,2666.0,1897.0,0.7105,12.605,0,0,0,0,0,0,0,0,0.0,0.0
1009,2559,27-09-2019 00:56:00,0,2579.0,1786.0,0.692,12.14,0,0,0,0,0,0,0,0,0.0,0.0
1009,2560,27-09-2019 00:58:00,0,2598.0,1711.0,0.659,12.132,0,0,0,0,0,0,0,0,0.0,0.0
1009,2561,27-09-2019 01:00:00,0,2395.0,1623.0,0.678,11.233,0,0,0,0,0,0,0,0,0.0,0.0
1009,2562,27-09-2019 01:02:00,0,2416.0,1564.0,0.648,11.252,24,21,11,10,3,0,3,0,0.0,0.0
1009,2563,27-09-2019 01:04:00,0,2424.0,1562.0,0.644,11.279,0,0,0,0,0,0,0,0,0.0,0.0
1009,2564,27-09-2019 01:06:00,0,2202.0,1504.0,0.683,10.34,0,0,0,0,0,0,0,0,0.0,0.0
1009,2565,27-09-2019 01:08:00,0,2212.0,1454.0,0.657,10.326,2,1,0,1,1,0,1,0,0.0,0.0
1009,2566,27-09-2019 01:10:00,0,2013.0,1404.0,0.698,9.485,0,0,0,0,0,0,0,0,0.0,0.0
1009,2567,27-09-2019 01:12:00,0,1911.0,1357.0,0.71,9.032,1,1,0,1,0,0,0,0,0.0,0.0
1009,2568,27-09-2019 01:14:00,0,1923.0,1309.0,0.681,9.026,0,0,0,0,0,0,0,0,0.0,0.0
1009,2569,27-09-2019 01:16:00,0,1929.0,1271.0,0.659,9.009,130,100,61,39,30,14,16,6,0.0,0.0
1009,2570,27-09-2019 01:18:00,0,1885.0,1422.0,0.754,9.003,340,181,132,49,159,101,58,29,0.01,0.0
1009,2571,27-09-2019 01:20:00,0,2215.0,1486.0,0.671,10.374,206,122,76,46,84,51,33,1,0.0,0.0
1009,2572,27-09-2019 01:22:00,0,2217.0,1479.0,0.667,10.372,203,116,83,33,87,67,20,23,0.04,0.0
1009,2573,27-09-2019 01:24:00,0,2871.0,1994.0,0.694,13.521,134,48,26,22,86,52,34,4,0.0,0.0
1009,2574,27-09-2019 01:26:00,0,2312.0,1564.0,0.676,10.843,267,123,92,31,144,92,52,32,0.0,0.0
1009,2575,27-09-2019 01:28:00,0,2447.5,1654.5,0.6755,11.4755,180,104,70,34,76,49,27,27,0.0,0.0
1009,2576,27-09-2019 01:30:00,0,2583.0,1745.0,0.675,12.108,196,47,23,24,149,105,44,0,0.0,0.0
1009,2577,27-09-2019 01:32:00,0,2384.0,1688.0,0.708,11.264,205,155,119,36,50,25,25,15,0.0,0.0
1009,2578,27-09-2019 01:34:00,0,2578.0,1828.0,0.709,12.181,115,84,50,34,31,14,17,47,0.0,0.0
1009,2579,27-09-2019 01:36:00,0,2775.0,1932.0,0.696,13.072,209,95,58,37,114,90,24,99,0.0,0.0
1009,2580,27-09-2019 01:38:00,0,2854.0,2008.0,0.704,13.468,76,68,29,39,8,0,8,0,0.0,0.0
1009,2581,27-09-2019 01:40:00,0,2855.0,1984.0,0.695,13.444,182,47,19,28,135,98,37,0,0.0,0.0
1009,2582,27-09-2019 01:42:00,0,2958.0,2058.0,0.696,13.934,461,288,220,68,173,118,55,57,0.0,0.0
1009,2583,27-09-2019 01:44:00,0,3051.0,2146.0,0.703,14.396,233,195,143,52,38,17,21,0,0.0,0.0
1009,2584,27-09-2019 01:46:00,0,3059.0,2081.0,0.68,14.356,88,77,48,29,11,0,11,1,0.0,0.0
1009,2585,27-09-2019 01:48:00,0,3064.0,2136.0,0.697,14.438,185,73,45,28,112,74,38,34,0.0,0.0
1009,2586,27-09-2019 01:50:00,0,3080.0,2100.0,0.682,14.461,170,78,51,27,92,54,38,1,0.0,0.0
1009,2587,27-09-2019 01:52:00,0,3061.0,2120.0,0.692,14.409,247,118,88,30,129,93,36,6,0.0,0.0
1009,2588,27-09-2019 01:54:00,0,3264.0,2209.0,0.677,15.307,38,7,2,5,31,18,13,1,0.0,0.0
1009,2589,27-09-2019 01:56:00,0,3051.0,2175.0,0.713,14.428,284,226,168,58,58,39,19,1,0.0,0.0
1009,2590,27-09-2019 01:58:00,0,3064.0,2152.0,0.702,14.455,181,89,60,29,92,58,34,12,0.01,0.0
1009,2591,27-09-2019 02:00:00,0,2890.0,1932.0,0.668,13.524,144,53,27,26,91,54,37,0,0.0,0.0
1009,2592,27-09-2019 02:02:00,0,2929.5,2011.5,0.686,13.7675,318,234,184,50,84,53,31,10,0.0,0.0
1009,2593,27-09-2019 02:04:00,0,2969.0,2091.0,0.704,14.011,396,263,208,55,133,86,47,12,0.0,0.0
1009,2594,27-09-2019 02:06:00,0,2948.0,2047.0,0.694,13.882,321,194,142,52,127,91,36,20,0.0,0.0
1009,2595,27-09-2019 02:08:00,0,2750.0,2020.0,0.735,13.071,42,29,8,21,13,1,12,7,0.0,0.0
1009,2596,27-09-2019 02:10:00,0,2859.0,2027.0,0.709,13.511,19,13,0,13,6,3,3,2,0.02,0.0
1009,2597,27-09-2019 02:12:00,0,2764.0,1981.0,0.717,13.086,2,0,0,0,2,1,1,0,0.0,0.0
1009,2598,27-09-2019 02:14:00,0,2678.0,1869.0,0.698,12.621,2,0,0,0,2,0,2,0,0.0,0.0
1009,2599,27-09-2019 02:16:00,0,2481.0,1770.0,0.714,11.735,1,0,0,0,1,0,1,0,0.0,0.0
1009,2600,27-09-2019 02:18:00,0,2391.0,1676.0,0.701,11.274,1,0,0,0,1,0,1,0,0.0,0.0
1009,2601,27-09-2019 02:20:00,0,2300.0,1591.0,0.692,10.824,1,0,0,0,1,0,1,0,0.0,0.0
1009,2602,27-09-2019 02:22:00,0,2190.0,1508.0,0.689,10.298,0,0,0,0,0,0,0,0,0.0,0.0
1009,2603,27-09-2019 02:24:00,0,2111.0,1449.0,0.686,9.922,14,9,4,5,5,1,4,0,0.0,0.0
1009,2604,27-09-2019 02:26:00,0,2003.0,1401.0,0.7,9.443,1,0,0,0,1,1,0,0,0.0,0.0
1009,2605,27-09-2019 02:28:00,0,1905.0,1380.0,0.725,9.034,3,1,0,1,2,1,1,0,0.0,0.0
1009,2606,27-09-2019 02:30:00,0,1791.0,1331.0,0.743,8.53,5,4,0,4,1,1,0,0,0.0,0.0
1009,2607,27-09-2019 02:32:00,0,1805.0,1294.0,0.717,8.545,0,0,0,0,0,0,0,0,0.0,0.0
1009,2608,27-09-2019 02:34:00,0,1814.0,1271.0,0.7,8.556,1,0,0,0,1,0,1,0,0.0,0.0
1009,2609,27-09-2019 02:36:00,0,1766.5,1233.0,0.6975,8.326,5,1,0,1,4,2,2,0,0.0,0.0
1009,2610,27-09-2019 02:38:00,0,1719.0,1195.0,0.695,8.096,2,1,0,1,1,0,1,0,0.0,0.0
1009,2611,27-09-2019 02:40:00,0,1731.0,1165.0,0.673,8.109,2,0,0,0,2,1,1,0,0.0,0.0
1009,2612,27-09-2019 02:42:00,0,1737.0,1148.0,0.661,8.117,7,3,0,3,4,1,3,0,0.0,0.0
1009,2613,27-09-2019 02:44:00,0,1738.0,1127.0,0.648,8.094,3,1,0,1,2,1,1,0,0.0,0.0
1009,2614,27-09-2019 02:46:00,0,1743.0,1113.0,0.639,8.101,3,0,0,0,3,2,1,0,0.0,0.0
1009,2615,27-09-2019 02:48:00,0,1746.0,1097.0,0.629,8.094,18,8,2,6,10,5,5,2,0.0,0.0
1009,2616,27-09-2019 02:50:00,0,1753.0,1098.0,0.627,8.122,18,7,3,4,11,4,7,0,0.0,0.0
1009,2617,27-09-2019 02:52:00,0,1736.0,1136.0,0.655,8.098,0,0,0,0,0,0,0,0,0.0,0.0
1009,2618,27-09-2019 02:54:00,0,1748.0,1115.0,0.638,8.123,1,0,0,0,1,0,1,0,0.0,0.0
1009,2619,27-09-2019 02:56:00,0,1750.0,1094.0,0.625,8.107,0,0,0,0,0,0,0,0,0.0,0.0
1009,2620,27-09-2019 02:58:00,0,1639.0,1064.0,0.649,7.637,0,0,0,0,0,0,0,0,0.0,0.0
1009,2621,27-09-2019 03:00:00,0,1529.0,1046.0,0.684,7.182,0,0,0,0,0,0,0,0,0.0,0.0
1009,2622,27-09-2019 03:02:00,0,1544.0,1032.0,0.668,7.225,0,0,0,0,0,0,0,0,0.0,0.0
1009,2623,27-09-2019 03:04:00,0,1543.0,1004.0,0.651,7.191,21,5,2,3,16,0,16,0,0.0,0.0
1009,2624,27-09-2019 03:06:00,0,1550.0,1028.0,0.663,7.247,34,24,15,9,10,0,10,1,0.0,0.0
1009,2625,27-09-2019 03:08:00,0,1533.0,1033.0,0.674,7.183,0,0,0,0,0,0,0,0,0.0,0.0
1009,2626,27-09-2019 03:10:00,0,1482.5,1014.0,0.6845,6.963,1,0,0,0,1,0,1,0,0.0,0.0
1009,2627,27-09-2019 03:12:00,0,1432.0,995.0,0.695,6.743,0,0,0,0,0,0,0,0,0.0,0.0
1009,2628,27-09-2019 03:14:00,0,1438.0,974.0,0.677,6.746,0,0,0,0,0,0,0,0,0.0,0.0
1009,2629,27-09-2019 03:16:00,0,1441.0,994.0,0.69,6.777,0,0,0,0,0,0,0,0,0.0,0.0
1009,2630,27-09-2019 03:18:00,0,1439.0,989.0,0.687,6.763,0,0,0,0,0,0,0,0,0.0,0.0
1009,2631,27-09-2019 03:20:00,0,1443.0,983.0,0.681,6.774,3,3,1,2,0,0,0,0,0.0,0.0
1009,2632,27-09-2019 03:22:00,0,1437.0,969.0,0.674,6.735,1,1,0,1,0,0,0,0,0.0,0.0
1009,2633,27-09-2019 03:24:00,0,1446.0,962.0,0.665,6.764,0,0,0,0,0,0,0,0,0.0,0.0
1009,2634,27-09-2019 03:26:00,0,1443.0,942.0,0.653,6.727,8,4,0,4,4,0,4,0,0.0,0.0
1009,2635,27-09-2019 03:28:00,0,1445.0,946.0,0.655,6.743,39,25,10,15,14,0,14,1,0.0,0.0
1009,2636,27-09-2019 03:30:00,0,1423.0,1039.0,0.73,6.759,363,182,133,49,181,137,44,58,0.0,0.0
1009,2637,27-09-2019 03:32:00,0,1602.0,1231.0,0.768,7.676,118,84,54,30,34,16,18,2,0.0,0.0
1009,2638,27-09-2019 03:34:00,0,1699.0,1250.0,0.735,8.079,73,62,29,33,11,0,11,7,0.0,0.0
1009,2639,27-09-2019 03:36:00,0,2102.0,1463.0,0.696,9.902,38,35,13,22,3,0,3,1,0.0,0.0
1009,2640,27-09-2019 03:38:00,0,2273.0,1645.0,0.724,10.778,130,67,42,25,63,48,15,6,0.0,0.0
1009,2641,27-09-2019 03:40:00,0,2765.0,1964.0,0.71,13.07,93,55,47,8,38,29,9,6,0.0,0.0
1009,2642,27-09-2019 03:42:00,0,2457.0,1804.0,0.734,11.677,281,153,109,44,128,86,42,55,0.0,0.0
1009,2643,27-09-2019 03:44:00,0,2574.5,1826.0,0.71,12.1655,179,67,31,36,112,63,49,5,0.0,0.0
1009,2644,27-09-2019 03:46:00,0,2692.0,1848.0,0.686,12.654,229,54,18,36,175,86,89,0,0.0,0.0
1009,2645,27-09-2019 03:48:00,0,2704.0,1754.0,0.649,12.596,393,216,162,54,177,137,40,69,0.0,0.0
1009,2646,27-09-2019 03:50:00,0,2984.0,1996.0,0.669,13.968,367,195,146,49,172,119,53,120,0.0,0.0
1009,2647,27-09-2019 03:52:00,0,3170.0,2152.0,0.679,14.874,261,183,131,52,78,57,21,1,0.0,0.0
1009,2648,27-09-2019 03:54:00,0,2956.0,2092.0,0.708,13.964,201,86,60,26,115,76,39,19,0.0,0.0
1009,2649,27-09-2019 03:56:00,0,3051.0,2126.0,0.697,14.375,30,3,2,1,27,9,18,1,0.0,0.0
1009,2650,27-09-2019 03:58:00,0,2985.0,1995.0,0.668,13.972,113,53,26,27,60,31,29,0,0.0,0.0
1009,2651,27-09-2019 04:00:00,0,2776.0,1912.0,0.689,13.055,161,95,65,30,66,38,28,19,0.0,0.0
1009,2652,27-09-2019 04:02:00,0,2970.0,2057.0,0.692,13.978,272,184,140,44,88,59,29,72,0.0,0.0
1009,2653,27-09-2019 04:04:00,0,3066.0,2116.0,0.69,14.423,280,214,156,58,66,32,34,5,0.0,0.0
1009,2654,27-09-2019 04:06:00,0,2969.0,2055.0,0.692,13.972,90,65,37,28,25,11,14,4,0.0,0.0
1009,2655,27-09-2019 04:08:00,0,2959.0,2064.0,0.697,13.943,65,57,24,33,8,0,8,9,0.0,0.0
1009,2656,27-09-2019 04:10:00,0,2957.0,2041.0,0.69,13.91,1,1,1,0,0,0,0,0,0.0,0.0
1009,2657,27-09-2019 04:12:00,0,3007.0,1953.0,0.65,14.01,6,6,2,4,0,0,0,0,0.0,0.0
1009,2658,27-09-2019 04:14:00,0,2685.0,1842.0,0.686,12.621,1,1,1,0,0,0,0,0,0.0,0.0
1009,2659,27-09-2019 04:16:00,0,2712.0,1744.0,0.643,12.615,0,0,0,0,0,0,0,0,0.0,0.0
1009,2660,27-09-2019 04:18:00,0,2560.5,1650.0,0.6445,11.9155,1,1,1,0,0,0,0,0,0.0,0.0
1009,2661,27-09-2019 04:20:00,0,2409.0,1556.0,0.646,11.216,4,4,0,4,0,0,0,0,0.0,0.0
1009,2662,27-09-2019 04:22:00,0,2322.0,1499.0,0.645,10.809,41,41,0,41,0,0,0,0,0.0,0.0
1009,2663,27-09-2019 04:24:00,0,2229.0,1435.0,0.644,10.371,6,6,1,5,0,0,0,0,0.0,0.0
1009,2664,27-09-2019 04:26:00,0,2008.0,1371.0,0.683,9.43,4,4,2,2,0,0,0,0,0.0,0.0
1009,2665,27-09-2019 04:28:00,0,2028.0,1327.0,0.654,9.46,0,0,0,0,0,0,0,0,0.0,0.0
1009,2666,27-09-2019 04:30:00,0,2040.0,1277.0,0.626,9.45,0,0,0,0,0,0,0,0,0.0,0.0
1009,2667,27-09-2019 04:32:00,0,1817.0,1231.0,0.677,8.524,0,0,0,0,0,0,0,0,0.0,0.0
1009,2668,27-09-2019 04:34:00,0,1841.0,1209.0,0.657,8.591,6,5,3,2,1,0,1,0,0.0,0.0
1009,2669,27-09-2019 04:36:00,0,1833.0,1204.0,0.656,8.557,2,0,0,0,2,0,2,0,0.0,0.0
1009,2670,27-09-2019 04:38:00,0,1850.0,1172.0,0.633,8.588,0,0,0,0,0,0,0,0,0.0,0.0
1009,2671,27-09-2019 04:40:00,0,1845.0,1135.0,0.615,8.525,0,0,0,0,0,0,0,0,0.0,0.0
1009,2672,27-09-2019 04:42:00,0,1749.0,1104.0,0.631,8.115,12,12,7,5,0,0,0,0,0.0,0.0
1009,2673,27-09-2019 04:44:00,0,1750.0,1101.0,0.629,8.115,6,5,1,4,1,0,1,0,0.0,0.0
1009,2674,27-09-2019 04:46:00,0,1643.0,1071.0,0.652,7.659,7,7,2,5,0,0,0,0,0.0,0.0
1009,2675,27-09-2019 04:48:00,0,1648.0,1048.0,0.636,7.654,1,1,1,0,0,0,0,0,0.0,0.0
1009,2676,27-09-2019 04:50:00,0,1658.0,1031.0,0.622,7.674,3,3,1,2,0,0,0,0,0.01,0.0
1009,2677,27-09-2019 04:52:00,0,1662.0,1017.0,0.612,7.675,6,6,3,3,0,0,0,0,0.0,0.0
1009,2678,27-09-2019 04:54:00,0,1666.0,1003.0,0.602,7.676,5,5,1,4,0,0,0,0,0.0,0.0
1009,2679,27-09-2019 04:56:00,0,1660.0,1013.0,0.61,7.661,1,0,0,0,1,0,1,0,0.0,0.0
1009,2680,27-09-2019 04:58:00,0,1658.0,1009.0,0.608,7.651,165,140,106,34,25,16,9,18,0.0,0.0
1009,2681,27-09-2019 05:00:00,0,1734.0,1138.0,0.657,8.092,293,174,130,44,119,91,28,145,0.0,0.0
1009,2682,27-09-2019 05:02:00,0,2011.0,1369.0,0.681,9.439,221,142,106,36,79,55,24,12,0.0,0.0
1009,2683,27-09-2019 05:04:00,0,2020.0,1368.0,0.677,9.474,33,27,8,19,6,0,6,0,0.0,0.0
1009,2684,27-09-2019 05:06:00,0,2208.0,1470.0,0.666,10.329,214,112,77,35,102,74,28,76,0.0,0.0
1009,2685,27-09-2019 05:08:00,0,2498.0,1669.0,0.668,11.692,216,69,48,21,147,103,44,7,0.0,0.0
1009,2686,27-09-2019 05:10:00,0,2512.0,1603.0,0.638,11.672,292,74,32,42,218,161,57,0,0.0,0.0
1009,2687,27-09-2019 05:12:00,0,2690.0,1767.0,0.657,12.557,159,52,25,27,107,78,29,2,0.0,0.0
1009,2688,27-09-2019 05:14:00,0,2699.0,1829.0,0.678,12.659,324,211,149,62,113,85,28,62,0.0,0.0
1009,2689,27-09-2019 05:16:00,0,2691.0,1809.0,0.672,12.605,184,140,100,40,44,13,31,17,0.0,0.0
1009,2690,27-09-2019 05:18:00,0,2678.0,1828.0,0.683,12.577,92,77,38,39,15,0,15,18,0.0,0.0
1009,2691,27-09-2019 05:20:00,0,2687.0,1843.0,0.686,12.627,7,6,4,2,1,0,1,0,0.0,0.0
1009,2692,27-09-2019 05:22:00,0,2702.0,1760.0,0.651,12.597,0,0,0,0,0,0,0,0,0.0,0.0
1009,2693,27-09-2019 05:24:00,0,2501.0,1690.0,0.675,11.727,0,0,0,0,0,0,0,0,0.0,0.0
1009,2694,27-09-2019 05:26:00,0,2404.5,1599.0,0.6645,11.2455,0,0,0,0,0,0,0,0,0.0,0.0
1009,2695,27-09-2019 05:28:00,0,2308.0,1508.0,0.654,10.764,6,6,3,3,0,0,0,0,0.0,0.0
1009,2696,27-09-2019 05:30:00,0,2334.0,1464.0,0.627,10.816,0,0,0,0,0,0,0,0,0.0,0.0
1009,2697,27-09-2019 05:32:00,0,2008.0,1392.0,0.693,9.455,0,0,0,0,0,0,0,0,0.0,0.0
1009,2698,27-09-2019 05:34:00,0,2024.0,1337.0,0.66,9.455,10,7,4,3,3,0,3,0,0.0,0.0
1009,2699,27-09-2019 05:36:00,0,2036.0,1310.0,0.643,9.473,0,0,0,0,0,0,0,0,0.0,0.0
1009,2700,27-09-2019 05:38:00,0,1927.0,1263.0,0.656,8.992,0,0,0,0,0,0,0,0,0.0,0.0
1009,2701,27-09-2019 05:40:00,0,1826.0,1215.0,0.666,8.54,0,0,0,0,0,0,0,0,0.0,0.0
1009,2702,27-09-2019 05:42:00,0,1845.0,1178.0,0.638,8.574,0,0,0,0,0,0,0,0,0.0,0.0
1009,2703,27-09-2019 05:44:00,0,1854.0,1150.0,0.62,8.578,0,0,0,0,0,0,0,0,0.0,0.0
1009,2704,27-09-2019 05:46:00,0,1859.0,1110.0,0.597,8.555,0,0,0,0,0,0,0,0,0.0,0.0
1009,2705,27-09-2019 05:48:00,0,1636.0,1081.0,0.66,7.644,0,0,0,0,0,0,0,0,0.0,0.0
1009,2706,27-09-2019 05:50:00,0,1654.0,1049.0,0.635,7.677,2,0,0,0,2,0,2,0,0.0,0.0
1009,2707,27-09-2019 05:52:00,0,1652.0,1036.0,0.627,7.655,0,0,0,0,0,0,0,0,0.0,0.0
1009,2708,27-09-2019 05:54:00,0,1660.0,1023.0,0.616,7.672,0,0,0,0,0,0,0,0,0.0,0.0
1009,2709,27-09-2019 05:56:00,0,1652.0,1007.0,0.61,7.624,0,0,0,0,0,0,0,0,0.0,0.0
1009,2710,27-09-2019 05:58:00,0,1665.0,992.0,0.596,7.66,1,0,0,0,1,0,1,0,0.0,0.0
1009,2711,27-09-2019 06:00:00,1,1662.0,990.5,0.596,7.6455,20,11,5,6,9,3,6,0,0.0,0.0
1009,2712,27-09-2019 06:02:00,1,1659.0,989.0,0.596,7.631,172,90,49,41,82,61,21,44,0.0,0.0
1009,2713,27-09-2019 06:04:00,1,1817.0,1281.0,0.705,8.576,112,40,21,19,72,22,50,53,0.0,0.0
1009,2714,27-09-2019 06:06:00,1,2501.0,1674.0,0.669,11.709,118,64,41,23,54,6,48,65,0.0,0.0
1009,2715,27-09-2019 06:08:00,1,2793.0,1868.0,0.669,13.072,176,92,59,33,84,40,44,68,0.0,0.0
1009,2716,27-09-2019 06:10:00,1,3069.0,2102.0,0.685,14.42,128,82,49,33,46,2,44,70,0.0,0.04
1009,2717,27-09-2019 06:12:00,1,3431.0,2444.0,0.712,16.225,127,68,33,35,59,14,45,70,0.0,0.05
1009,2718,27-09-2019 06:14:00,1,3593.0,2611.0,0.727,17.049,97,50,29,21,47,4,43,79,0.0,0.11
1009,2719,27-09-2019 06:16:00,1,3583.0,2742.0,0.765,17.152,107,62,31,31,45,2,43,63,0.0,0.0
1009,2720,27-09-2019 06:18:00,1,3779.0,2871.0,0.76,18.066,199,67,34,33,132,75,57,43,0.31,0.05
1009,2721,27-09-2019 06:20:00,1,3545.0,2855.0,0.805,17.128,253,110,68,42,143,102,41,70,0.0,0.0
1009,2722,27-09-2019 06:22:00,1,3754.0,2952.0,0.786,18.057,91,42,21,21,49,4,45,63,0.0,0.05
1009,2723,27-09-2019 06:24:00,1,3726.0,3005.0,0.806,18.008,112,71,41,30,41,2,39,65,0.0,0.0
1009,2724,27-09-2019 06:26:00,1,3725.0,3029.0,0.813,18.031,210,70,52,18,140,96,44,48,0.31,0.1
1009,2725,27-09-2019 06:28:00,1,3702.0,3073.0,0.83,17.99,153,68,40,28,85,55,30,33,0.15,0.04
1009,2726,27-09-2019 06:30:00,1,3832.0,3120.0,0.814,18.553,114,61,32,29,53,0,53,69,0.0,0.0
1009,2727,27-09-2019 06:32:00,1,3972.0,3324.0,0.837,19.328,130,64,43,21,66,26,40,56,0.01,0.05
1009,2728,27-09-2019 06:34:00,1,3984.0,3336.0,0.8375,19.389,129,59,31,28,70,29,41,62,0.06,0.03
1009,2729,27-09-2019 06:36:00,1,3996.0,3348.0,0.838,19.45,192,100,59,41,92,45,47,43,0.24,0.09
1009,2730,27-09-2019 06:38:00,1,3780.0,3181.0,0.841,18.416,169,85,49,36,84,45,39,62,0.0,0.13
1009,2731,27-09-2019 06:40:00,1,4083.0,3434.0,0.841,19.889,81,42,23,19,39,3,36,54,0.0,0.02
1009,2732,27-09-2019 06:42:00,1,4265.0,3579.0,0.839,20.767,145,65,40,25,80,46,34,27,0.1,0.01
1009,2733,27-09-2019 06:44:00,1,3966.0,3377.0,0.852,19.364,267,139,103,36,128,92,36,69,0.04,0.0
1009,2734,27-09-2019 06:46:00,1,4173.0,3469.0,0.831,20.281,120,44,29,15,76,45,31,38,0.03,0.12
1009,2735,27-09-2019 06:48:00,1,3976.0,3331.0,0.838,19.353,72,44,21,23,28,2,26,29,0.0,0.0
1009,2736,27-09-2019 06:50:00,1,3970.0,3374.0,0.85,19.378,109,48,38,10,61,29,32,40,0.13,0.0
1009,2737,27-09-2019 06:52:00,1,3516.0,2984.0,0.849,17.156,391,231,177,54,160,111,49,41,0.0,0.0
1009,2738,27-09-2019 06:54:00,1,3946.0,3449.0,0.874,19.367,93,65,32,33,28,7,21,49,0.0,0.04
1009,2739,27-09-2019 06:56:00,1,4136.0,3634.0,0.879,20.319,53,32,16,16,21,4,17,41,0.0,0.08
1009,2740,27-09-2019 06:58:00,1,3860.0,3388.0,0.878,18.958,95,59,41,18,36,21,15,7,0.04,0.0
1009,2741,27-09-2019 07:00:00,1,2693.0,2249.0,0.835,13.101,20,6,3,3,14,0,14,3,0.0,0.0
1009,2742,27-09-2019 07:02:00,1,2588.0,2173.0,0.84,12.601,8,5,1,4,3,0,3,0,0.01,0.02
1009,2743,27-09-2019 07:04:00,1,2593.0,2188.0,0.844,12.64,0,0,0,0,0,0,0,0,0.0,0.0
1009,2744,27-09-2019 07:06:00,1,2607.0,2112.0,0.81,12.608,0,0,0,0,0,0,0,0,0.0,0.0
1009,2745,27-09-2019 07:08:00,1,2751.0,2196.5,0.799,13.2705,0,0,0,0,0,0,0,0,0.0,0.0
1009,2746,27-09-2019 07:10:00,1,2895.0,2281.0,0.788,13.933,24,12,7,5,12,5,7,0,0.0,0.0
1009,2747,27-09-2019 07:12:00,1,3526.0,2971.0,0.842,17.184,0,0,0,0,0,0,0,0,0.0,0.0
1009,2748,27-09-2019 07:14:00,1,3471.0,3132.0,0.902,17.144,2,1,0,1,1,0,1,0,0.02,0.0
1009,2749,27-09-2019 07:16:00,1,3471.0,3091.0,0.891,17.098,0,0,0,0,0,0,0,0,0.0,0.01
1009,2750,27-09-2019 07:18:00,1,3495.0,3086.0,0.883,17.189,12,9,6,3,3,1,2,1,0.0,0.0
1009,2751,27-09-2019 07:20:00,1,3495.0,3043.0,0.87,17.141,11,7,4,3,4,1,3,0,0.0,0.0
1009,2752,27-09-2019 07:22:00,1,3293.0,2925.0,0.888,16.212,11,10,8,2,1,0,1,0,0.0,0.0
1009,2753,27-09-2019 07:24:00,1,3102.0,2811.0,0.906,15.333,36,34,10,24,2,0,2,0,0.0,0.0
1009,2754,27-09-2019 07:26:00,1,3016.0,2763.0,0.916,14.943,3,3,0,3,0,0,0,0,0.0,0.0
1009,2755,27-09-2019 07:28:00,1,2914.0,2635.0,0.904,14.398,2,2,0,2,0,0,0,0,0.0,0.0
1009,2756,27-09-2019 07:30:00,1,2843.0,2546.0,0.896,14.018,8,7,2,5,1,0,1,0,0.0,0.0
1009,2757,27-09-2019 07:32:00,1,2846.0,2499.0,0.878,13.981,0,0,0,0,0,0,0,0,0.0,0.0
1009,2758,27-09-2019 07:34:00,1,2851.0,2434.0,0.854,13.927,1,1,0,1,0,0,0,0,0.0,0.0
1009,2759,27-09-2019 07:36:00,1,2657.0,2383.0,0.897,13.107,0,0,0,0,0,0,0,0,0.0,0.0
1009,2760,27-09-2019 07:38:00,1,2548.0,2358.0,0.926,12.65,5,5,3,2,0,0,0,0,0.0,0.0
1009,2761,27-09-2019 07:40:00,1,2555.0,2304.0,0.901,12.618,24,18,7,11,6,0,6,0,0.0,0.0
1009,2762,27-09-2019 07:42:00,1,2561.5,2276.5,0.8885,12.612,0,0,0,0,0,0,0,0,0.0,0.0
1009,2763,27-09-2019 07:44:00,1,2568.0,2249.0,0.876,12.606,2,0,0,0,2,0,2,0,0.0,0.0
1009,2764,27-09-2019 07:46:00,1,2363.0,2185.0,0.925,11.73,23,5,2,3,18,0,18,0,0.0,0.0
1009,2765,27-09-2019 07:48:00,1,2380.0,2169.0,0.911,11.779,95,79,49,30,16,2,14,4,0.0,0.0
1009,2766,27-09-2019 07:50:00,1,2567.0,2269.0,0.884,12.624,94,85,48,37,9,0,9,4,0.0,0.0
1009,2767,27-09-2019 07:52:00,1,2645.0,2444.0,0.924,13.125,108,63,39,24,45,33,12,13,0.24,0.0
1009,2768,27-09-2019 07:54:00,1,2840.0,2564.0,0.903,14.029,99,47,24,23,52,9,43,68,0.0,0.02
1009,2769,27-09-2019 07:56:00,1,2977.0,2832.0,0.951,14.866,93,53,25,28,40,2,38,76,0.0,0.02
1009,2770,27-09-2019 07:58:00,1,3303.0,2958.0,0.895,16.29,104,46,22,24,58,35,23,35,0.0,0.1
1009,2771,27-09-2019 08:00:00,1,3088.0,2896.0,0.938,15.374,149,70,35,35,79,48,31,52,0.02,0.06
1009,2772,27-09-2019 08:02:00,1,3275.0,3027.0,0.924,16.256,50,44,11,33,6,2,4,51,0.01,0.03
1009,2773,27-09-2019 08:04:00,1,3377.0,3127.0,0.926,16.769,132,55,26,29,77,48,29,36,0.1,0.04
1009,2774,27-09-2019 08:06:00,1,3074.0,2931.0,0.954,15.354,37,24,22,2,13,11,2,6,0.04,0.0
1009,2775,27-09-2019 08:08:00,1,2846.0,2483.0,0.872,13.96,5,3,0,3,2,0,2,0,0.0,0.0
1009,2776,27-09-2019 08:10:00,1,3000.0,2820.0,0.94,14.94,0,0,0,0,0,0,0,0,0.0,0.01
1009,2777,27-09-2019 08:12:00,1,3271.0,3043.0,0.93,16.258,0,0,0,0,0,0,0,0,0.0,0.0
1009,2778,27-09-2019 08:14:00,1,3290.0,2996.0,0.91,16.281,116,56,37,19,60,38,22,26,0.05,0.03
1009,2779,27-09-2019 08:16:00,1,3293.0,2984.5,0.906,16.2795,37,25,9,16,12,3,9,15,0.0,0.19
1009,2780,27-09-2019 08:18:00,1,3296.0,2973.0,0.902,16.278,65,44,23,21,21,16,5,5,0.0,0.0
1009,2781,27-09-2019 08:20:00,1,3269.0,3033.0,0.928,16.237,292,152,119,33,140,92,48,32,0.1,0.0
1009,2782,27-09-2019 08:22:00,1,3284.0,3016.0,0.918,16.28,58,29,17,12,29,18,11,5,0.04,0.06
1009,2783,27-09-2019 08:24:00,1,3171.0,2999.0,0.946,15.814,212,143,99,44,69,34,35,6,0.06,0.11
1009,2784,27-09-2019 08:26:00,1,3271.0,3070.0,0.939,16.285,657,315,249,66,342,257,85,21,0.0,0.14
1009,2785,27-09-2019 08:28:00,1,3449.0,3200.0,0.928,17.132,547,322,250,72,225,152,73,22,0.04,0.0
1009,2786,27-09-2019 08:30:00,1,3451.0,3170.0,0.919,17.107,935,556,456,100,379,286,93,66,0.05,0.0
1009,2787,27-09-2019 08:32:00,1,3248.0,3128.0,0.963,16.26,37,30,18,12,7,1,6,0,0.0,0.0
1009,2788,27-09-2019 08:34:00,1,3448.0,3206.0,0.93,17.133,19,14,7,7,5,1,4,0,0.0,0.0
1009,2789,27-09-2019 08:36:00,1,3467.0,3180.0,0.917,17.18,34,13,2,11,21,0,21,1,0.0,0.0
1009,2790,27-09-2019 08:38:00,1,3260.0,3118.0,0.957,16.296,10,9,3,6,1,0,1,0,0.0,0.0
1009,2791,27-09-2019 08:40:00,1,3285.0,3038.0,0.925,16.308,3,3,0,3,0,0,0,0,0.0,0.0
1009,2792,27-09-2019 08:42:00,1,2964.0,2873.0,0.969,14.857,0,0,0,0,0,0,0,0,0.0,0.0
1009,2793,27-09-2019 08:44:00,1,2898.0,2750.0,0.949,14.461,0,0,0,0,0,0,0,0,0.0,0.0
1009,2794,27-09-2019 08:46:00,1,2817.0,2603.0,0.924,13.981,4,3,1,2,1,0,1,0,0.0,0.0
1009,2795,27-09-2019 08:48:00,1,2728.0,2490.0,0.913,13.505,0,0,0,0,0,0,0,0,0.0,0.0
1009,2796,27-09-2019 08:50:00,1,2650.0,2385.5,0.9,13.081,0,0,0,0,0,0,0,0,0.0,0.0
1009,2797,27-09-2019 08:52:00,1,2572.0,2281.0,0.887,12.657,0,0,0,0,0,0,0,0,0.0,0.0
1009,2798,27-09-2019 08:54:00,1,2448.0,2265.0,0.925,12.152,9,0,0,0,9,0,9,0,0.0,0.0
1009,2799,27-09-2019 08:56:00,1,2369.0,2190.0,0.924,11.759,2,0,0,0,2,0,2,0,0.0,0.0
1009,2800,27-09-2019 08:58:00,1,2358.0,2167.0,0.919,11.689,0,0,0,0,0,0,0,0,0.0,0.0
1009,2801,27-09-2019 09:00:00,1,2386.0,2121.0,0.889,11.747,5,0,0,0,5,0,5,0,0.0,0.0
1009,2802,27-09-2019 09:02:00,1,2287.0,2063.0,0.902,11.295,0,0,0,0,0,0,0,0,0.0,0.0
1009,2803,27-09-2019 09:04:00,1,2184.0,2010.0,0.92,10.832,39,11,8,3,28,18,10,3,0.0,0.0
1009,2804,27-09-2019 09:06:00,1,2179.0,2051.0,0.941,10.855,57,26,18,8,31,12,19,22,0.0,0.0
1009,2805,27-09-2019 09:08:00,1,2368.0,2223.0,0.939,11.789,46,26,4,22,20,2,18,9,0.0,0.0
1009,2806,27-09-2019 09:10:00,1,2440.0,2313.0,0.948,12.173,41,19,13,6,22,17,5,0,0.01,0.0
1009,2807,27-09-2019 09:12:00,1,2339.0,2313.0,0.989,11.776,1,0,0,0,1,1,0,0,0.0,0.0
1009,2808,27-09-2019 09:14:00,1,2337.0,2263.0,0.968,11.715,2,2,1,1,0,0,0,0,0.0,0.0
1009,2809,27-09-2019 09:16:00,1,2351.0,2258.0,0.96,11.763,0,0,0,0,0,0,0,0,0.0,0.0
1009,2810,27-09-2019 09:18:00,1,2361.0,2180.0,0.923,11.715,0,0,0,0,0,0,0,0,0.0,0.0
1009,2811,27-09-2019 09:20:00,1,2266.0,2110.0,0.931,11.263,15,12,6,6,3,1,2,0,0.0,0.0
1009,2812,27-09-2019 09:22:00,1,2368.0,2140.0,0.904,11.7,10,10,0,10,0,0,0,0,0.0,0.0
1009,2813,27-09-2019 09:24:00,1,2269.5,2096.5,0.925,11.2625,2,2,0,2,0,0,0,0,0.0,0.0
1009,2814,27-09-2019 09:26:00,1,2171.0,2053.0,0.946,10.825,0,0,0,0,0,0,0,0,0.0,0.0
1009,2815,27-09-2019 09:28:00,1,2176.0,2038.0,0.936,10.831,88,36,24,12,52,34,18,0,0.01,0.0
1009,2816,27-09-2019 09:30:00,1,2162.0,2089.0,0.966,10.829,4,2,0,2,2,0,2,0,0.0,0.0
1009,2817,27-09-2019 09:32:00,1,2276.0,2124.0,0.933,11.32,5,1,1,0,4,0,4,0,0.0,0.0
1009,2818,27-09-2019 09:34:00,1,2162.0,2105.0,0.973,10.85,0,0,0,0,0,0,0,0,0.0,0.0
1009,2819,27-09-2019 09:36:00,1,2159.0,2059.0,0.953,10.785,18,14,6,8,4,0,4,3,0.0,0.0
1009,2820,27-09-2019 09:38:00,1,2178.0,2054.0,0.943,10.854,75,41,25,16,34,23,11,1,0.0,0.0
1009,2821,27-09-2019 09:40:00,1,2263.0,2123.0,0.938,11.268,10,4,3,1,6,0,6,0,0.0,0.0
1009,2822,27-09-2019 09:42:00,1,2267.0,2119.0,0.935,11.277,28,26,21,5,2,0,2,0,0.0,0.0
1009,2823,27-09-2019 09:44:00,1,2271.0,2113.0,0.931,11.286,11,11,0,11,0,0,0,0,0.0,0.0
1009,2824,27-09-2019 09:46:00,1,2267.0,2115.0,0.933,11.275,1,1,0,1,0,0,0,0,0.0,0.0
1009,2825,27-09-2019 09:48:00,1,2158.0,2104.0,0.975,10.83,9,9,2,7,0,0,0,0,0.0,0.0
1009,2826,27-09-2019 09:50:00,1,2164.0,2078.0,0.96,10.827,169,107,69,38,62,31,31,66,0.02,0.0
1009,2827,27-09-2019 09:52:00,1,2342.0,2300.0,0.982,11.775,126,72,30,42,54,28,26,41,0.0,0.0
1009,2828,27-09-2019 09:54:00,1,2521.0,2478.0,0.983,12.677,105,50,29,21,55,11,44,61,0.0,0.0
1009,2829,27-09-2019 09:56:00,1,2820.0,2638.0,0.935,14.031,183,83,52,31,100,54,46,61,0.07,0.0
1009,2830,27-09-2019 09:58:00,1,2800.0,2673.5,0.955,13.9905,210,115,78,37,95,57,38,74,0.0,0.0
1009,2831,27-09-2019 10:00:00,1,2780.0,2709.0,0.975,13.95,116,71,39,32,45,8,37,74,0.0,0.0
1009,2832,27-09-2019 10:02:00,1,3071.0,2938.0,0.957,15.352,119,80,52,28,39,4,35,49,0.0,0.0
1009,2833,27-09-2019 10:04:00,1,3256.0,3152.0,0.968,16.317,179,66,36,30,113,78,35,33,0.14,0.0
1009,2834,27-09-2019 10:06:00,1,2792.0,2702.0,0.968,13.991,123,97,53,44,26,8,18,0,0.0,0.0
1009,2835,27-09-2019 10:08:00,1,2360.0,2230.0,0.945,11.768,100,63,31,32,37,19,18,4,0.0,0.0
1009,2836,27-09-2019 10:10:00,1,3000.0,2763.0,0.921,14.878,102,87,42,45,15,7,8,12,0.0,0.0
1009,2837,27-09-2019 10:12:00,1,3175.0,2986.0,0.941,15.814,147,92,58,34,55,28,27,64,0.08,0.0
1009,2838,27-09-2019 10:14:00,1,3426.0,3353.0,0.979,17.211,107,57,33,24,50,10,40,47,0.0,0.0
1009,2839,27-09-2019 10:16:00,1,3411.0,3343.0,0.98,17.139,141,49,27,22,92,37,55,47,0.1,0.0
1009,2840,27-09-2019 10:18:00,1,3597.0,3547.0,0.986,18.101,96,43,35,8,53,26,27,14,0.05,0.09
1009,2841,27-09-2019 10:20:00,1,2722.0,2521.0,0.926,13.516,58,44,22,22,14,6,8,1,0.0,0.01
1009,2842,27-09-2019 10:22:00,1,2383.0,2136.0,0.896,11.755,84,79,39,40,5,2,3,1,0.0,0.01
1009,2843,27-09-2019 10:24:00,1,2858.0,2468.0,0.863,13.993,26,21,8,13,5,2,3,0,0.0,0.0
1009,2844,27-09-2019 10:26:00,1,2747.0,2443.0,0.889,13.528,0,0,0,0,0,0,0,0,0.0,0.0
1009,2845,27-09-2019 10:28:00,1,2972.0,2875.0,0.967,14.892,28,21,12,9,7,3,4,0,0.0,0.0
1009,2846,27-09-2019 10:30:00,1,2976.0,2913.0,0.979,14.951,3,0,0,0,3,0,3,0,0.0,0.0
1009,2847,27-09-2019 10:32:00,1,3119.5,2980.0,0.9565,15.59,8,5,2,3,3,1,2,0,0.0,0.0
1009,2848,27-09-2019 10:34:00,1,3263.0,3047.0,0.934,16.229,2,0,0,0,2,1,1,0,0.0,0.0
1009,2849,27-09-2019 10:36:00,1,2970.0,2898.0,0.976,14.911,3,0,0,0,3,0,3,0,0.0,0.0
1009,2850,27-09-2019 10:38:00,1,2977.0,2868.0,0.963,14.905,1,0,0,0,1,0,1,0,0.0,0.0
1009,2851,27-09-2019 10:40:00,1,2998.0,2799.0,0.933,14.912,4,0,0,0,4,0,4,0,0.0,0.0
1009,2852,27-09-2019 10:42:00,1,2807.0,2696.0,0.96,14.043,1,1,1,0,0,0,0,0,0.0,0.0
1009,2853,27-09-2019 10:44:00,1,2833.0,2580.0,0.911,14.02,83,51,30,21,32,19,13,5,0.0,0.0
1009,2854,27-09-2019 10:46:00,1,2818.0,2607.0,0.925,13.988,55,50,25,25,5,2,3,0,0.0,0.0
1009,2855,27-09-2019 10:48:00,1,2837.0,2555.0,0.901,14.008,1,1,0,1,0,0,0,0,0.0,0.0
1009,2856,27-09-2019 10:50:00,1,2513.0,2443.0,0.972,12.606,0,0,0,0,0,0,0,0,0.0,0.0
1009,2857,27-09-2019 10:52:00,1,2540.0,2351.0,0.926,12.613,7,6,4,2,1,1,0,0,0.0,0.0
1009,2858,27-09-2019 10:54:00,1,2541.0,2387.0,0.94,12.652,1,0,0,0,1,0,1,0,0.0,0.0
1009,2859,27-09-2019 10:56:00,1,2453.0,2323.0,0.947,12.236,1,0,0,0,1,0,1,0,0.0,0.0
1009,2860,27-09-2019 10:58:00,1,2345.0,2273.0,0.969,11.754,8,7,4,3,1,0,1,0,0.0,0.0
1009,2861,27-09-2019 11:00:00,1,2359.0,2212.0,0.938,11.742,15,13,10,3,2,1,1,0,0.0,0.0
1009,2862,27-09-2019 11:02:00,1,2365.0,2133.0,0.902,11.682,1,0,0,0,1,1,0,0,0.0,0.0
1009,2863,27-09-2019 11:04:00,1,2393.0,2109.0,0.881,11.764,4,0,0,0,4,0,4,0,0.0,0.0
1009,2864,27-09-2019 11:06:00,1,2287.0,2069.0,0.9055,11.3015,1,0,0,0,1,0,1,0,0.0,0.0
1009,2865,27-09-2019 11:08:00,1,2181.0,2029.0,0.93,10.839,1,0,0,0,1,0,1,0,0.0,0.0
1009,2866,27-09-2019 11:10:00,1,2178.0,2019.0,0.927,10.818,171,93,66,27,78,43,35,44,0.0,0.0
1009,2867,27-09-2019 11:12:00,1,2339.0,2274.0,0.972,11.731,99,56,27,29,43,11,32,63,0.0,0.0
1009,2868,27-09-2019 11:14:00,1,2618.0,2513.0,0.96,13.097,96,52,24,28,44,10,34,66,0.0,0.05
1009,2869,27-09-2019 11:16:00,1,2787.0,2760.0,0.991,14.035,72,40,25,15,32,7,25,43,0.0,0.04
1009,2870,27-09-2019 11:18:00,1,2988.0,2868.0,0.96,14.948,83,46,26,20,37,2,35,62,0.0,0.1
1009,2871,27-09-2019 11:20:00,1,3057.0,2992.0,0.979,15.357,50,32,19,13,18,2,16,35,0.0,0.16
1009,2872,27-09-2019 11:22:00,1,2955.0,2956.0,1.0,14.915,103,52,39,13,51,35,16,6,0.15,0.0
1009,2873,27-09-2019 11:24:00,1,2561.0,2327.0,0.908,12.666,61,39,4,35,22,2,20,4,0.0,0.0
1009,2874,27-09-2019 11:26:00,1,2642.0,2452.0,0.928,13.123,767,468,389,79,299,221,78,82,0.0,0.0
1009,2875,27-09-2019 11:28:00,1,3234.0,3159.0,0.977,16.24,761,448,368,80,313,232,81,41,0.16,0.0
1009,2876,27-09-2019 11:30:00,1,3344.0,3198.0,0.956,16.716,921,546,439,107,375,288,87,47,0.0,0.0
1009,2877,27-09-2019 11:32:00,1,3420.0,3298.0,0.965,17.125,509,305,243,62,204,154,50,32,0.0,0.16
1009,2878,27-09-2019 11:34:00,1,3439.0,3265.0,0.95,17.164,572,409,330,79,163,111,52,85,0.0,0.0
1009,2879,27-09-2019 11:36:00,1,3420.0,3372.0,0.986,17.209,123,69,40,29,54,17,37,55,0.0,0.0
1009,2880,27-09-2019 11:38:00,1,3447.0,3259.0,0.945,17.189,170,92,58,34,78,37,41,4,0.0,0.0
1009,2881,27-09-2019 11:40:00,1,3431.5,3315.0,0.966,17.189,739,455,369,86,284,215,69,56,0.02,0.0
1009,2882,27-09-2019 11:42:00,1,3416.0,3371.0,0.987,17.189,578,327,270,57,251,200,51,52,0.01,0.0
1009,2883,27-09-2019 11:44:00,1,3415.0,3297.0,0.966,17.104,548,377,313,64,171,130,41,79,0.0,0.0
1009,2884,27-09-2019 11:46:00,1,3585.0,3551.0,0.991,18.055,44,44,22,22,0,0,0,52,0.02,0.0
1009,2885,27-09-2019 11:48:00,1,3581.0,3555.0,0.993,18.044,212,150,109,41,62,48,14,43,0.14,0.0
1009,2886,27-09-2019 11:50:00,1,3274.0,3097.0,0.946,16.328,706,492,399,93,214,163,51,58,0.0,0.01
1009,2887,27-09-2019 11:52:00,1,3619.0,3467.0,0.958,18.095,244,164,128,36,80,50,30,16,0.0,0.0
1009,2888,27-09-2019 11:54:00,1,3427.0,3308.0,0.965,17.165,38,0,0,0,38,0,38,4,0.0,0.0
1009,2889,27-09-2019 11:56:00,1,3607.0,3511.0,0.973,18.098,57,0,0,0,57,15,42,1,0.0,0.0
1009,2890,27-09-2019 11:58:00,1,3589.0,3519.0,0.981,18.035,23,0,0,0,23,20,3,0,0.0,0.0
1009,2891,27-09-2019 12:00:00,1,3628.0,3406.0,0.939,18.066,5,0,0,0,5,5,0,0,0.0,0.0
1009,2892,27-09-2019 12:02:00,1,3434.0,3249.0,0.946,17.128,2,0,0,0,2,1,1,0,0.0,0.0
1009,2893,27-09-2019 12:04:00,1,3253.0,3090.0,0.95,16.236,0,0,0,0,0,0,0,0,0.0,0.0
1009,2894,27-09-2019 12:06:00,1,3286.0,2975.0,0.905,16.24,9,0,0,0,9,8,1,0,0.0,0.0
1009,2895,27-09-2019 12:08:00,1,3079.0,2911.0,0.945,15.352,5,0,0,0,5,3,2,0,0.0,0.0
1009,2896,27-09-2019 12:10:00,1,2986.0,2796.0,0.936,14.86,0,0,0,0,0,0,0,0,0.0,0.0
1009,2897,27-09-2019 12:12:00,1,2903.0,2719.0,0.937,14.446,0,0,0,0,0,0,0,0,0.0,0.0
1009,2898,27-09-2019 12:14:00,1,2873.0,2615.5,0.9105,14.215,1,0,0,0,1,1,0,0,0.0,0.0
1009,2899,27-09-2019 12:16:00,1,2843.0,2512.0,0.884,13.984,5,0,0,0,5,4,1,0,0.0,0.0
1009,2900,27-09-2019 12:18:00,1,2642.0,2485.0,0.941,13.16,5,0,0,0,5,4,1,0,0.0,0.0
1009,2901,27-09-2019 12:20:00,1,2533.0,2401.0,0.948,12.639,0,0,0,0,0,0,0,0,0.0,0.0
1009,2902,27-09-2019 12:22:00,1,2542.0,2366.0,0.931,12.634,0,0,0,0,0,0,0,0,0.0,0.0
1009,2903,27-09-2019 12:24:00,1,2550.0,2329.0,0.914,12.626,0,0,0,0,0,0,0,0,0.0,0.0
1009,2904,27-09-2019 12:26:00,1,2448.0,2295.0,0.937,12.185,3,0,0,0,3,2,1,0,0.0,0.0
1009,2905,27-09-2019 12:28:00,1,2343.0,2245.0,0.958,11.717,21,0,0,0,21,18,3,6,0.0,0.0
1009,2906,27-09-2019 12:30:00,1,2348.0,2222.0,0.946,11.71,0,0,0,0,0,0,0,0,0.0,0.0
1009,2907,27-09-2019 12:32:00,1,2361.0,2181.0,0.924,11.715,0,0,0,0,0,0,0,0,0.0,0.0
1009,2908,27-09-2019 12:34:00,1,2378.0,2163.0,0.909,11.764,155,5,1,4,150,136,14,0,0.0,0.0
1009,2909,27-09-2019 12:36:00,1,2456.0,2301.0,0.937,12.226,147,2,1,1,145,131,14,0,0.0,0.0
1009,2910,27-09-2019 12:38:00,1,2523.0,2446.0,0.969,12.65,189,15,2,13,174,155,19,6,0.0,0.0
1009,2911,27-09-2019 12:40:00,1,2736.0,2525.0,0.923,13.575,175,30,7,23,145,132,13,8,0.0,0.0
1009,2912,27-09-2019 12:42:00,1,2803.0,2656.0,0.947,13.986,1,0,0,0,1,0,1,0,0.0,0.0
1009,2913,27-09-2019 12:44:00,1,2740.0,2516.0,0.918,13.581,2,0,0,0,2,2,0,0,0.0,0.0
1009,2914,27-09-2019 12:46:00,1,2542.0,2391.0,0.941,12.663,2,0,0,0,2,0,2,0,0.0,0.0
1009,2915,27-09-2019 12:48:00,1,2452.5,2305.5,0.94,12.215,2,0,0,0,2,0,2,0,0.0,0.0
1009,2916,27-09-2019 12:50:00,1,2363.0,2220.0,0.939,11.767,8,0,0,0,8,4,4,0,0.0,0.0
1010,1,23-09-2019 11:40:00,1,4175.0,3103.0,0.743,19.886,193,39,16,23,154,99,55,1,0.0,0.0
1010,2,23-09-2019 11:42:00,1,4712.0,3422.0,0.726,22.357,142,12,3,9,130,67,63,0,0.0,0.0
1010,3,23-09-2019 11:44:00,1,4193.0,3037.0,0.724,19.884,230,53,22,31,177,128,49,20,0.0,0.0
1010,4,23-09-2019 11:46:00,1,4069.0,3001.0,0.738,19.356,182,44,17,27,138,88,50,4,0.0,0.0
1010,5,23-09-2019 11:48:00,1,4170.0,3115.0,0.747,19.878,149,29,8,21,120,72,48,0,0.0,0.0
1010,6,23-09-2019 11:50:00,1,4073.0,3057.0,0.751,19.433,192,30,5,25,162,99,63,10,0.01,0.0
1010,7,23-09-2019 11:52:00,1,3839.0,2919.0,0.761,18.356,274,113,66,47,161,103,58,25,0.0,0.0
1010,8,23-09-2019 11:54:00,1,4591.0,3395.0,0.739,21.85,414,225,174,51,189,132,57,49,0.0,0.0
1010,9,23-09-2019 11:56:00,1,4214.0,3175.0,0.7545,20.1195,759,376,299,77,383,306,77,2,0.0,0.0
1010,10,23-09-2019 11:58:00,1,3837.0,2955.0,0.77,18.389,857,472,396,76,385,309,76,25,0.0,0.0
1010,11,23-09-2019 12:00:00,1,4083.0,2998.0,0.734,19.406,665,354,285,69,311,240,71,18,0.0,0.0
1010,12,23-09-2019 12:02:00,1,4362.0,3359.0,0.77,20.908,218,51,35,16,167,106,61,7,0.0,0.0
1010,13,23-09-2019 12:04:00,1,3858.0,2853.0,0.739,18.36,145,9,1,8,136,77,59,0,0.0,0.0
1010,14,23-09-2019 12:06:00,1,3855.0,2920.0,0.757,18.422,153,26,1,25,127,72,55,0,0.0,0.0
1010,15,23-09-2019 12:08:00,1,3657.0,2710.0,0.741,17.408,122,43,9,34,79,50,29,0,0.0,0.0
1010,16,23-09-2019 12:10:00,1,3605.0,2820.0,0.782,17.325,54,1,0,1,53,26,27,0,0.0,0.0
1010,17,23-09-2019 12:12:00,1,3639.0,2789.0,0.766,17.425,44,0,0,0,44,0,44,0,0.0,0.0
1010,18,23-09-2019 12:14:00,1,3543.0,2671.0,0.754,16.918,51,0,0,0,51,6,45,0,0.0,0.0
1010,19,23-09-2019 12:16:00,1,3110.0,2382.0,0.766,14.89,149,0,0,0,149,97,52,0,0.0,0.0
1010,20,23-09-2019 12:18:00,1,3120.0,2393.0,0.767,14.944,78,4,1,3,74,31,43,0,0.0,0.0
1010,21,23-09-2019 12:20:00,1,3150.0,2300.0,0.73,14.959,224,48,23,25,176,109,67,13,0.0,0.0
1010,22,23-09-2019 12:22:00,1,3836.0,2923.0,0.762,18.35,380,210,164,46,170,116,54,36,0.0,0.0
1010,23,23-09-2019 12:24:00,1,3834.0,2928.0,0.764,18.346,266,125,89,36,141,93,48,76,0.0,0.0
1010,24,23-09-2019 12:26:00,1,3633.0,2775.0,0.764,17.385,109,26,18,8,83,44,39,31,0.0,0.0
1010,25,23-09-2019 12:28:00,1,3326.0,2569.0,0.772,15.947,54,2,0,2,52,7,45,0,0.0,0.0
1010,26,23-09-2019 12:30:00,1,3217.5,2481.0,0.771,15.424,47,1,0,1,46,4,42,0,0.0,0.0
1010,27,23-09-2019 12:32:00,1,3109.0,2393.0,0.77,14.901,40,5,0,5,35,0,35,0,0.0,0.0
1010,28,23-09-2019 12:34:00,1,3034.0,2260.0,0.745,14.456,137,29,16,13,108,60,48,3,0.0,0.0
1010,29,23-09-2019 12:36:00,1,3233.0,2369.0,0.733,15.36,293,124,88,36,169,116,53,3,0.0,0.0
1010,30,23-09-2019 12:38:00,1,3350.0,2450.0,0.731,15.914,236,113,82,31,123,84,39,20,0.0,0.0
1010,31,23-09-2019 12:40:00,1,3010.0,2276.0,0.756,14.378,425,177,132,45,248,184,64,6,0.0,0.0
1010,32,23-09-2019 12:42:00,1,2921.0,2192.0,0.75,13.937,696,362,293,69,334,269,65,31,0.0,0.0
1010,33,23-09-2019 12:44:00,1,3141.0,2304.0,0.733,14.927,174,81,61,20,93,57,36,42,0.0,0.0
1010,34,23-09-2019 12:46:00,1,3339.0,2451.0,0.734,15.868,106,12,4,8,94,50,44,0,0.0,0.0
1010,35,23-09-2019 12:48:00,1,3351.0,2432.0,0.726,15.897,78,19,2,17,59,20,39,0,0.0,0.0
1010,36,23-09-2019 12:50:00,1,3226.0,2430.0,0.753,15.402,43,0,0,0,43,0,43,0,0.0,0.0
1010,37,23-09-2019 12:52:00,1,3348.0,2475.0,0.739,15.933,47,0,0,0,47,12,35,0,0.0,0.0
1010,38,23-09-2019 12:54:00,1,3115.0,2347.0,0.753,14.871,57,0,0,0,57,11,46,0,0.0,0.0
1010,39,23-09-2019 12:56:00,1,2792.0,2214.0,0.793,13.452,44,0,0,0,44,2,42,0,0.0,0.0
1010,40,23-09-2019 12:58:00,1,2811.0,2125.0,0.756,13.429,53,0,0,0,53,4,49,0,0.0,0.0
1010,41,23-09-2019 13:00:00,1,2593.0,2015.0,0.777,12.446,37,0,0,0,37,2,35,0,0.0,0.0
1010,42,23-09-2019 13:02:00,1,2603.0,1965.0,0.755,12.432,76,6,3,3,70,22,48,0,0.0,0.0
1010,43,23-09-2019 13:04:00,1,2596.0,1981.5,0.7635,12.422,32,0,0,0,32,2,30,0,0.0,0.0
1010,44,23-09-2019 13:06:00,1,2589.0,1998.0,0.772,12.412,52,0,0,0,52,0,52,0,0.0,0.0
1010,45,23-09-2019 13:08:00,1,2616.0,1923.0,0.735,12.438,51,0,0,0,51,5,46,0,0.0,0.0
1010,46,23-09-2019 13:10:00,1,2615.0,1902.0,0.727,12.409,37,0,0,0,37,0,37,0,0.0,0.0
1010,47,23-09-2019 13:12:00,1,2504.0,1834.0,0.732,11.897,54,1,1,0,53,10,43,0,0.0,0.0
1010,48,23-09-2019 13:14:00,1,2515.0,1843.0,0.733,11.952,59,7,1,6,52,9,43,0,0.0,0.0
1010,49,23-09-2019 13:16:00,1,2630.0,1859.0,0.707,12.422,44,2,0,2,42,2,40,0,0.0,0.0
1010,50,23-09-2019 13:18:00,1,2501.0,1832.0,0.732,11.884,51,1,0,1,50,1,49,0,0.0,0.0
1010,51,23-09-2019 13:20:00,1,2516.0,1836.0,0.73,11.947,179,0,0,0,179,120,59,0,0.0,0.0
1010,52,23-09-2019 13:22:00,1,2621.0,1860.0,0.71,12.387,52,1,0,1,51,14,37,0,0.0,0.0
1010,53,23-09-2019 13:24:00,1,2617.0,1923.0,0.735,12.441,87,11,4,7,76,28,48,0,0.0,0.0
1010,54,23-09-2019 13:26:00,1,2631.0,1875.0,0.713,12.444,52,0,0,0,52,7,45,0,0.0,0.0
1010,55,23-09-2019 13:28:00,1,2615.0,1893.0,0.724,12.397,57,3,0,3,54,17,37,0,0.0,0.0
1010,56,23-09-2019 13:30:00,1,2612.0,1906.0,0.73,12.404,43,2,0,2,41,4,37,0,0.0,0.0
1010,57,23-09-2019 13:32:00,1,2619.0,1898.0,0.725,12.42,39,2,0,2,37,0,37,0,0.0,0.0
1010,58,23-09-2019 13:34:00,1,2613.0,1875.0,0.717,12.373,36,0,0,0,36,0,36,0,0.0,0.0
1010,59,23-09-2019 13:36:00,1,2611.0,1915.0,0.733,12.41,51,13,0,13,38,2,36,0,0.0,0.0
1010,60,23-09-2019 13:38:00,1,2679.0,1882.0,0.703,12.6405,34,0,0,0,34,0,34,0,0.0,0.0
1010,61,23-09-2019 13:40:00,1,2747.0,1849.0,0.673,12.871,40,1,0,1,39,0,39,0,0.0,0.0
1010,62,23-09-2019 13:42:00,1,2758.0,1857.0,0.673,12.922,47,2,0,2,45,4,41,0,0.0,0.0
1010,63,23-09-2019 13:44:00,1,2628.0,1847.0,0.703,12.398,35,0,0,0,35,0,35,0,0.0,0.0
1010,64,23-09-2019 13:46:00,1,2632.0,1849.0,0.703,12.416,39,0,0,0,39,0,39,0,0.0,0.0
1010,65,23-09-2019 13:48:00,1,2401.0,1800.0,0.75,11.453,65,6,2,4,59,18,41,0,0.0,0.0
1010,66,23-09-2019 13:50:00,1,2632.0,1824.0,0.693,12.39,48,0,0,0,48,4,44,0,0.0,0.0
1010,67,23-09-2019 13:52:00,1,2743.0,1894.0,0.69,12.905,62,13,0,13,49,4,45,0,0.0,0.0
1010,68,23-09-2019 13:54:00,1,2740.0,1880.0,0.686,12.88,55,5,0,5,50,4,46,0,0.0,0.0
1010,69,23-09-2019 13:56:00,1,2634.0,1847.0,0.701,12.424,38,2,0,2,36,0,36,0,0.0,0.0
1010,70,23-09-2019 13:58:00,1,2513.0,1806.0,0.719,11.9,261,105,79,26,156,106,50,11,0.0,0.0
1010,71,23-09-2019 14:00:00,1,2941.0,2087.0,0.71,13.898,172,65,46,19,107,75,32,83,0.0,0.0
1010,72,23-09-2019 14:02:00,1,3248.0,2349.0,0.723,15.399,110,30,2,28,80,38,42,0,0.0,0.0
1010,73,23-09-2019 14:04:00,1,3252.0,2335.0,0.718,15.4,133,37,16,21,96,52,44,5,0.0,0.0
1010,74,23-09-2019 14:06:00,1,3259.0,2366.0,0.726,15.46,170,6,1,5,164,99,65,0,0.0,0.0
1010,75,23-09-2019 14:08:00,1,3011.0,2282.0,0.758,14.392,167,29,15,14,138,86,52,0,0.0,0.0
1010,76,23-09-2019 14:10:00,1,3024.0,2295.0,0.759,14.457,259,96,58,38,163,113,50,30,0.0,0.0
1010,77,23-09-2019 14:12:00,1,3182.0,2364.0,0.7435,15.1565,464,236,177,59,228,173,55,6,0.0,0.0
1010,78,23-09-2019 14:14:00,1,3340.0,2433.0,0.728,15.856,630,401,323,78,229,165,64,0,0.0,0.0
1010,79,23-09-2019 14:16:00,1,4433.0,3165.0,0.714,20.971,152,91,59,32,61,24,37,40,0.0,0.0
1010,80,23-09-2019 14:18:00,1,4076.0,3009.0,0.738,19.39,278,168,121,47,110,73,37,71,0.0,0.0
1010,81,23-09-2019 14:20:00,1,3040.0,2178.0,0.716,14.391,158,10,0,10,148,111,37,0,0.0,0.0
1010,82,23-09-2019 14:22:00,1,2825.0,2015.0,0.713,13.362,0,0,0,0,0,0,0,0,0.0,0.0
1010,83,23-09-2019 14:24:00,1,2855.0,1957.0,0.686,13.415,1,1,0,1,0,0,0,0,0.0,0.0
1010,84,23-09-2019 14:26:00,1,2633.0,1853.0,0.704,12.427,0,0,0,0,0,0,0,0,0.0,0.0
1010,85,23-09-2019 14:28:00,1,2526.0,1800.0,0.712,11.947,8,5,0,5,3,1,2,0,0.0,0.0
1010,86,23-09-2019 14:30:00,1,2531.0,1769.0,0.699,11.931,0,0,0,0,0,0,0,0,0.0,0.0
1010,87,23-09-2019 14:32:00,1,2528.0,1748.0,0.692,11.895,5,4,0,4,1,0,1,0,0.0,0.0
1010,88,23-09-2019 14:34:00,1,2540.0,1744.0,0.687,11.94,2,2,0,2,0,0,0,0,0.0,0.0
1010,89,23-09-2019 14:36:00,1,2514.0,1802.0,0.717,11.9,0,0,0,0,0,0,0,0,0.0,0.0
1010,90,23-09-2019 14:38:00,1,2498.0,1883.0,0.754,11.927,8,5,0,5,3,2,1,0,0.0,0.0
1010,91,23-09-2019 14:40:00,1,2515.0,1833.0,0.729,11.939,2,2,0,2,0,0,0,0,0.0,0.0
1010,92,23-09-2019 14:42:00,1,2527.0,1796.0,0.711,11.946,0,0,0,0,0,0,0,0,0.0,0.0
1010,93,23-09-2019 14:44:00,1,2538.0,1781.0,0.702,11.972,0,0,0,0,0,0,0,0,0.0,0.0
1010,94,23-09-2019 14:46:00,1,2518.5,1831.5,0.7275,11.95,15,3,0,3,12,1,11,0,0.0,0.0
1010,95,23-09-2019 14:48:00,1,2499.0,1882.0,0.753,11.928,8,1,0,1,7,0,7,0,0.0,0.0
1010,96,23-09-2019 14:50:00,1,2735.0,1949.0,0.713,12.932,27,5,2,3,22,6,16,0,0.0,0.0
1010,97,23-09-2019 14:52:00,1,2518.0,1828.0,0.726,11.944,2,0,0,0,2,0,2,0,0.0,0.0
1010,98,23-09-2019 14:54:00,1,2531.0,1780.0,0.703,11.942,0,0,0,0,0,0,0,0,0.0,0.0
1010,99,23-09-2019 14:56:00,1,2518.0,1787.0,0.709,11.901,12,0,0,0,12,1,11,0,0.0,0.0
1010,100,23-09-2019 14:58:00,1,2527.0,1793.0,0.709,11.941,36,4,0,4,32,4,28,0,0.0,0.0
1010,101,23-09-2019 15:00:00,1,2506.0,1862.0,0.743,11.937,41,0,0,0,41,0,41,0,0.0,0.0
1010,102,23-09-2019 15:02:00,1,2490.0,1884.0,0.757,11.898,39,0,0,0,39,2,37,0,0.0,0.0
1010,103,23-09-2019 15:04:00,1,2598.0,1938.0,0.746,12.381,37,0,0,0,37,0,37,0,0.0,0.0
1010,104,23-09-2019 15:06:00,1,2537.0,1756.0,0.692,11.941,59,5,3,2,54,5,49,0,0.0,0.0
1010,105,23-09-2019 15:08:00,1,2533.0,1750.0,0.691,11.92,41,1,0,1,40,0,40,0,0.0,0.0
1010,106,23-09-2019 15:10:00,1,2517.0,1823.0,0.724,11.937,42,0,0,0,42,0,42,0,0.0,0.0
1010,107,23-09-2019 15:12:00,1,2511.0,1866.0,0.743,11.958,32,0,0,0,32,0,32,0,0.0,0.0
1010,108,23-09-2019 15:14:00,1,2720.0,1919.0,0.706,12.842,40,11,4,7,29,6,23,0,0.0,0.0
1010,109,23-09-2019 15:16:00,1,2835.0,2040.0,0.719,13.429,5,4,1,3,1,0,1,0,0.0,0.0
1010,110,23-09-2019 15:18:00,1,2817.0,2088.0,0.741,13.411,0,0,0,0,0,0,0,0,0.0,0.0
1010,111,23-09-2019 15:20:00,1,2875.0,2116.0,0.736,13.6715,3,2,0,2,1,0,1,0,0.0,0.0
1010,112,23-09-2019 15:22:00,1,2933.0,2144.0,0.731,13.932,1,1,0,1,0,0,0,0,0.0,0.0
1010,113,23-09-2019 15:24:00,1,2916.0,2145.0,0.736,13.863,0,0,0,0,0,0,0,0,0.0,0.0
1010,114,23-09-2019 15:26:00,1,2622.0,1928.0,0.735,12.465,8,0,0,0,8,1,7,0,0.0,0.0
1010,115,23-09-2019 15:28:00,1,2657.0,1733.0,0.652,12.389,38,19,8,11,19,5,14,0,0.0,0.0
1010,116,23-09-2019 15:30:00,1,2428.0,1661.0,0.684,11.405,67,22,11,11,45,14,31,6,0.0,0.0
1010,117,23-09-2019 15:32:00,1,2631.0,1904.0,0.724,12.476,4,0,0,0,4,0,4,0,0.0,0.0
1010,118,23-09-2019 15:34:00,1,2729.0,1942.0,0.712,12.901,0,0,0,0,0,0,0,0,0.0,0.0
1010,119,23-09-2019 15:36:00,1,2732.0,1947.0,0.713,12.92,0,0,0,0,0,0,0,0,0.0,0.0
1010,120,23-09-2019 15:38:00,1,2736.0,1954.0,0.714,12.943,25,4,3,1,21,7,14,0,0.0,0.0
1010,121,23-09-2019 15:40:00,1,2844.0,1981.0,0.696,13.4,39,0,0,0,39,2,37,0,0.0,0.0
1010,122,23-09-2019 15:42:00,1,2949.0,2046.0,0.694,13.887,40,5,2,3,35,4,31,0,0.0,0.0
1010,123,23-09-2019 15:44:00,1,2940.0,2123.0,0.722,13.936,0,0,0,0,0,0,0,0,0.0,0.0
1010,124,23-09-2019 15:46:00,1,2918.0,2151.0,0.737,13.877,30,0,0,0,30,0,30,0,0.0,0.0
1010,125,23-09-2019 15:48:00,1,2962.0,2024.0,0.683,13.912,50,8,1,7,42,2,40,0,0.0,0.0
1010,126,23-09-2019 15:50:00,1,2630.0,1844.0,0.701,12.406,38,0,0,0,38,0,38,0,0.0,0.0
1010,127,23-09-2019 15:52:00,1,2736.0,1897.0,0.693,12.881,39,1,1,0,38,0,38,0,0.0,0.0
1010,128,23-09-2019 15:54:00,1,2732.5,1909.0,0.6985,12.88,32,0,0,0,32,0,32,0,0.0,0.0
1010,129,23-09-2019 15:56:00,1,2729.0,1921.0,0.704,12.879,34,1,0,1,33,0,33,0,0.0,0.0
1010,130,23-09-2019 15:58:00,1,2854.0,1960.0,0.687,13.415,36,0,0,0,36,0,36,0,0.0,0.0
1010,131,23-09-2019 16:00:00,1,2858.0,1957.0,0.685,13.429,75,21,13,8,54,16,38,0,0.0,0.0
1010,132,23-09-2019 16:02:00,1,2849.0,1963.0,0.689,13.399,92,23,2,21,69,39,30,0,0.0,0.0
1010,133,23-09-2019 16:04:00,1,3058.0,2162.0,0.707,14.441,74,34,3,31,40,23,17,0,0.0,0.0
1010,134,23-09-2019 16:06:00,1,2919.0,2124.0,0.728,13.852,244,119,79,40,125,80,45,15,0.0,0.0
1010,135,23-09-2019 16:08:00,1,3365.0,2409.0,0.716,15.924,28,21,2,19,7,0,7,0,0.0,0.0
1010,136,23-09-2019 16:10:00,1,2923.0,2143.0,0.733,13.891,77,34,8,26,43,11,32,0,0.0,0.0
1010,137,23-09-2019 16:12:00,1,2931.0,2174.0,0.742,13.957,91,24,13,11,67,27,40,0,0.0,0.0
1010,138,23-09-2019 16:14:00,1,3172.0,2227.0,0.702,14.962,122,7,3,4,115,54,61,0,0.0,0.0
1010,139,23-09-2019 16:16:00,1,2941.0,2110.0,0.718,13.923,91,3,0,3,88,39,49,0,0.0,0.0
1010,140,23-09-2019 16:18:00,1,3126.0,2365.0,0.757,14.934,22,0,0,0,22,11,11,0,0.0,0.0
1010,141,23-09-2019 16:20:00,1,3133.0,2285.0,0.729,14.873,5,0,0,0,5,4,1,0,0.01,0.0
1010,142,23-09-2019 16:22:00,1,3141.0,2238.0,0.713,14.852,0,0,0,0,0,0,0,0,0.0,0.0
1010,143,23-09-2019 16:24:00,1,2954.0,2098.0,0.71,13.96,57,11,3,8,46,6,40,0,0.0,0.0
1010,144,23-09-2019 16:26:00,1,2613.0,1892.0,0.724,12.39,48,2,0,2,46,0,46,0,0.0,0.0
1010,145,23-09-2019 16:28:00,1,2626.0,1874.5,0.714,12.422,37,2,0,2,35,0,35,0,0.0,0.0
1010,146,23-09-2019 16:30:00,1,2639.0,1857.0,0.704,12.454,49,7,2,5,42,2,40,0,0.0,0.0
1010,147,23-09-2019 16:32:00,1,2636.0,1850.0,0.702,12.434,47,3,0,3,44,0,44,0,0.0,0.0
1010,148,23-09-2019 16:34:00,1,2614.0,1916.0,0.733,12.42,43,2,0,2,41,0,41,0,0.0,0.0
1010,149,23-09-2019 16:36:00,1,2725.0,1940.0,0.712,12.886,31,0,0,0,31,0,31,0,0.0,0.0
1010,150,23-09-2019 16:38:00,1,2642.0,1827.0,0.691,12.434,26,0,0,0,26,0,26,0,0.0,0.0
1010,151,23-09-2019 16:40:00,1,2539.0,1730.0,0.681,11.921,12,2,0,2,10,0,10,0,0.0,0.0
1010,152,23-09-2019 16:42:00,1,2662.0,1751.0,0.658,12.43,8,1,0,1,7,3,4,0,0.0,0.0
1010,153,23-09-2019 16:44:00,1,2641.0,1803.0,0.683,12.401,1,1,0,1,0,0,0,0,0.0,0.0
1010,154,23-09-2019 16:46:00,1,2622.0,1884.0,0.718,12.417,0,0,0,0,0,0,0,0,0.0,0.0
1010,155,23-09-2019 16:48:00,1,2610.0,1929.0,0.739,12.419,21,3,0,3,18,1,17,0,0.0,0.0
1010,156,23-09-2019 16:50:00,1,2732.0,1938.0,0.709,12.912,17,0,0,0,17,0,17,0,0.0,0.0
1010,157,23-09-2019 16:52:00,1,2661.0,1787.0,0.672,12.462,38,1,0,1,37,2,35,0,0.0,0.0
1010,158,23-09-2019 16:54:00,1,2641.0,1793.0,0.679,12.391,21,5,4,1,16,8,8,0,0.0,0.0
1010,159,23-09-2019 16:56:00,1,2644.0,1785.0,0.675,12.397,36,0,0,0,36,0,36,0,0.0,0.0
1010,160,23-09-2019 16:58:00,1,2647.0,1812.0,0.685,12.438,48,1,0,1,47,0,47,0,0.0,0.0
1010,161,23-09-2019 17:00:00,1,2633.0,1855.0,0.704,12.429,38,0,0,0,38,0,38,0,0.0,0.0
1010,162,23-09-2019 17:02:00,1,2740.0,1914.0,0.6985,12.916,44,8,0,8,36,2,34,0,0.0,0.0
1010,163,23-09-2019 17:04:00,1,2847.0,1973.0,0.693,13.403,42,4,0,4,38,0,38,0,0.01,0.0
1010,164,23-09-2019 17:06:00,1,2959.0,2017.0,0.682,13.891,44,1,0,1,43,0,43,0,0.0,0.0
1010,165,23-09-2019 17:08:00,1,2825.0,1979.0,0.701,13.321,200,82,61,21,118,70,48,3,0.0,0.0
1010,166,23-09-2019 17:10:00,1,3145.0,2288.0,0.727,14.925,39,10,1,9,29,4,25,0,0.0,0.0
1010,167,23-09-2019 17:12:00,1,3133.0,2307.0,0.736,14.897,16,13,1,12,3,0,3,0,0.0,0.0
1010,168,23-09-2019 17:14:00,1,3153.0,2278.0,0.722,14.945,4,1,0,1,3,0,3,0,0.0,0.0
1010,169,23-09-2019 17:16:00,1,2732.0,1904.0,0.697,12.873,43,4,0,4,39,2,37,0,0.0,0.0
1010,170,23-09-2019 17:18:00,1,2624.0,1863.0,0.71,12.4,44,0,0,0,44,0,44,0,0.0,0.0
1010,171,23-09-2019 17:20:00,1,2632.0,1842.0,0.7,12.412,37,0,0,0,37,0,37,0,0.0,0.0
1010,172,23-09-2019 17:22:00,1,2641.0,1844.0,0.698,12.448,41,0,0,0,41,0,41,0,0.0,0.0
1010,173,23-09-2019 17:24:00,1,2639.0,1835.0,0.695,12.43,32,0,0,0,32,0,32,0,0.0,0.0
1010,174,23-09-2019 17:26:00,1,2630.0,1795.0,0.682,12.35,31,1,0,1,30,0,30,0,0.0,0.0
1010,175,23-09-2019 17:28:00,1,2639.0,1837.0,0.696,12.433,42,0,0,0,42,0,42,0,0.0,0.0
1010,176,23-09-2019 17:30:00,1,2634.0,1831.0,0.695,12.406,38,2,0,2,36,0,36,0,0.0,0.0
1010,177,23-09-2019 17:32:00,1,2625.0,1885.0,0.718,12.429,35,0,0,0,35,10,25,0,0.0,0.0
1010,178,23-09-2019 17:34:00,1,2739.0,1936.0,0.707,12.934,49,2,0,2,47,10,37,0,0.0,0.0
1010,179,23-09-2019 17:36:00,1,2594.5,1770.0,0.681,12.1825,50,1,0,1,49,4,45,0,0.0,0.0
1010,180,23-09-2019 17:38:00,1,2450.0,1604.0,0.655,11.431,51,2,0,2,49,7,42,0,0.0,0.0
1010,181,23-09-2019 17:40:00,1,2446.0,1601.0,0.655,11.41,28,4,0,4,24,2,22,0,0.0,0.0
1010,182,23-09-2019 17:42:00,1,2448.0,1646.0,0.673,11.467,0,0,0,0,0,0,0,0,0.0,0.0
1010,183,23-09-2019 17:44:00,1,2429.0,1669.0,0.687,11.417,55,6,3,3,49,27,22,2,0.0,0.0
1010,184,23-09-2019 17:46:00,1,2437.0,1625.0,0.667,11.404,86,28,15,13,58,26,32,12,0.0,0.0
1010,185,23-09-2019 17:48:00,1,2869.0,1908.0,0.665,13.418,355,184,146,38,171,127,44,89,0.0,0.0
1010,186,23-09-2019 17:50:00,1,4297.0,3095.0,0.72,20.356,243,129,96,33,114,78,36,54,0.0,0.0
1010,187,23-09-2019 17:52:00,1,4707.0,3398.0,0.722,22.306,177,89,61,28,88,56,32,58,0.0,0.0
1010,188,23-09-2019 17:54:00,1,4594.0,3330.0,0.725,21.788,291,154,121,33,137,94,43,63,0.0,0.0
1010,189,23-09-2019 17:56:00,1,4504.0,3309.0,0.735,21.408,132,72,48,24,60,33,27,64,0.0,0.0
1010,190,23-09-2019 17:58:00,1,3971.0,2876.0,0.724,18.833,288,147,101,46,141,83,58,66,0.0,0.0
1010,191,23-09-2019 18:00:00,0,4178.0,3076.0,0.736,19.868,117,56,36,20,61,25,36,50,0.0,0.0
1010,192,23-09-2019 18:02:00,0,3971.0,2921.0,0.736,18.88,232,133,96,37,99,54,45,43,0.0,0.0
1010,193,23-09-2019 18:04:00,0,4265.0,3223.0,0.756,20.372,128,49,21,28,79,34,45,23,0.01,0.01
1010,194,23-09-2019 18:06:00,0,4402.0,3215.0,0.73,20.906,242,129,91,38,113,67,46,45,0.0,0.0
1010,195,23-09-2019 18:08:00,0,3759.0,2799.0,0.745,17.909,419,227,177,50,192,136,56,107,0.0,0.0
1010,196,23-09-2019 18:10:00,0,3603.5,2653.0,0.736,17.1345,282,146,112,34,136,101,35,87,0.0,0.0
1010,197,23-09-2019 18:12:00,0,3448.0,2507.0,0.727,16.36,169,70,37,33,99,48,51,33,0.0,0.0
1010,198,23-09-2019 18:14:00,0,4695.0,3529.0,0.752,22.406,230,96,56,40,134,88,46,64,0.0,0.0
1010,199,23-09-2019 18:16:00,0,4642.0,3605.0,0.777,22.28,265,158,117,41,107,72,35,57,0.0,0.01
1010,200,23-09-2019 18:18:00,0,4638.0,3618.0,0.78,22.279,206,116,81,35,90,64,26,96,0.0,0.02
1010,201,23-09-2019 18:20:00,0,4656.0,3661.0,0.786,22.399,469,223,174,49,246,188,58,161,0.0,0.0
1010,202,23-09-2019 18:22:00,0,3518.0,2669.0,0.759,16.818,319,107,76,31,212,154,58,131,0.0,0.0
1010,203,23-09-2019 18:24:00,0,4978.0,3894.0,0.782,23.923,257,70,40,30,187,134,53,49,0.0,0.0
1010,204,23-09-2019 18:26:00,0,4909.0,4092.0,0.834,23.87,238,104,70,34,134,81,53,62,0.0,0.03
1010,205,23-09-2019 18:28:00,0,3612.0,2859.0,0.791,17.398,144,35,8,27,109,58,51,13,0.0,0.0
1010,206,23-09-2019 18:30:00,0,3093.0,2467.0,0.798,14.916,146,32,11,21,114,65,49,1,0.0,0.0
1010,207,23-09-2019 18:32:00,0,3115.0,2388.0,0.766,14.919,251,21,6,15,230,161,69,0,0.0,0.0
1010,208,23-09-2019 18:34:00,0,3106.0,2467.0,0.794,14.968,147,44,22,22,103,61,42,0,0.0,0.02
1010,209,23-09-2019 18:36:00,0,3190.0,2531.0,0.793,15.371,158,61,29,32,97,48,49,0,0.0,0.0
1010,210,23-09-2019 18:38:00,0,3418.0,2694.0,0.788,16.451,62,9,3,6,53,19,34,0,0.0,0.01
1010,211,23-09-2019 18:40:00,0,3582.0,2957.0,0.825,17.387,31,0,0,0,31,0,31,0,0.0,0.0
1010,212,23-09-2019 18:42:00,0,3614.0,2849.0,0.788,17.394,36,0,0,0,36,0,36,0,0.0,0.0
1010,213,23-09-2019 18:44:00,0,3910.5,3177.5,0.8105,18.9265,176,74,60,14,102,61,41,4,0.0,0.01
1010,214,23-09-2019 18:46:00,0,4207.0,3506.0,0.833,20.459,402,220,175,45,182,135,47,78,0.0,0.0
1010,215,23-09-2019 18:48:00,0,3811.0,3132.0,0.822,18.482,259,121,90,31,138,97,41,86,0.03,0.0
1010,216,23-09-2019 18:50:00,0,4800.0,3972.0,0.828,23.309,325,169,125,44,156,104,52,90,0.0,0.0
1010,217,23-09-2019 18:52:00,0,4920.0,4065.0,0.826,23.885,169,67,28,39,102,59,43,64,0.0,0.0
1010,218,23-09-2019 18:54:00,0,5424.0,4537.0,0.836,26.394,268,93,66,27,175,127,48,109,0.0,0.0
1010,219,23-09-2019 18:56:00,0,4722.0,3843.0,0.814,22.862,230,84,60,24,146,104,42,124,0.0,0.0
1010,220,23-09-2019 18:58:00,0,4902.0,4098.0,0.836,23.851,315,150,117,33,165,122,43,133,0.01,0.03
1010,221,23-09-2019 19:00:00,0,4787.0,4000.0,0.836,23.29,395,155,109,46,240,214,26,65,0.0,0.0
1010,222,23-09-2019 19:02:00,0,5104.0,4298.0,0.842,24.868,230,59,33,26,171,153,18,39,0.0,0.0
1010,223,23-09-2019 19:04:00,0,4668.0,3968.0,0.85,22.784,225,55,36,19,170,143,27,74,0.0,0.01
1010,224,23-09-2019 19:06:00,0,4900.0,4237.0,0.865,23.996,373,128,87,41,245,213,32,94,0.0,0.02
1010,225,23-09-2019 19:08:00,0,4490.0,3775.0,0.841,21.871,383,137,96,41,246,215,31,64,0.16,0.03
1010,226,23-09-2019 19:10:00,0,3800.0,3143.0,0.827,18.452,285,75,39,36,210,151,59,1,0.0,0.0
1010,227,23-09-2019 19:12:00,0,3388.0,2759.0,0.814,16.402,183,61,29,32,122,74,48,0,0.0,0.0
1010,228,23-09-2019 19:14:00,0,3066.0,2505.0,0.817,14.854,158,27,7,20,131,96,35,0,0.0,0.0
1010,229,23-09-2019 19:16:00,0,3079.0,2550.0,0.828,14.956,255,53,24,29,202,138,64,0,0.0,0.0
1010,230,23-09-2019 19:18:00,0,3996.5,3302.0,0.8265,19.404,378,136,102,34,242,189,53,66,0.0,0.0
1010,231,23-09-2019 19:20:00,0,4914.0,4054.0,0.825,23.852,269,53,32,21,216,171,45,64,0.01,0.02
1010,232,23-09-2019 19:22:00,0,4412.0,3675.0,0.833,21.452,67,10,4,6,57,19,38,0,0.0,0.0
1010,233,23-09-2019 19:24:00,0,3901.0,3187.0,0.817,18.9,360,59,34,25,301,233,68,0,0.0,0.0
1010,234,23-09-2019 19:26:00,0,3370.0,2831.0,0.84,16.411,432,200,157,43,232,187,45,111,0.0,0.0
1010,235,23-09-2019 19:28:00,0,4468.0,3872.0,0.867,21.89,382,169,134,35,213,190,23,127,0.0,0.0
1010,236,23-09-2019 19:30:00,0,4868.0,4216.0,0.866,23.848,345,101,67,34,244,223,21,45,0.0,0.0
1010,237,23-09-2019 19:32:00,0,5394.0,4614.0,0.855,26.362,250,59,30,29,191,184,7,49,0.0,0.01
1010,238,23-09-2019 19:34:00,0,5357.0,4707.0,0.879,26.318,231,52,28,24,179,166,13,48,0.0,0.04
1010,239,23-09-2019 19:36:00,0,5156.0,4623.0,0.897,25.435,386,128,95,33,258,227,31,72,0.08,0.03
1010,240,23-09-2019 19:38:00,0,4564.0,3996.0,0.876,22.408,508,191,147,44,317,282,35,130,0.0,0.04
1010,241,23-09-2019 19:40:00,0,4358.0,3832.0,0.879,21.412,342,154,119,35,188,174,14,195,0.0,0.0
1010,242,23-09-2019 19:42:00,0,5245.0,4650.0,0.886,25.814,445,156,123,33,289,259,30,22,0.1,0.0
1010,243,23-09-2019 19:44:00,0,4183.0,3581.0,0.856,20.444,261,91,65,26,170,159,11,51,0.01,0.0
1010,244,23-09-2019 19:46:00,0,5285.0,4618.0,0.874,25.935,267,49,33,16,218,205,13,56,0.0,0.0
1010,245,23-09-2019 19:48:00,0,5255.0,4632.0,0.881,25.834,281,35,21,14,246,233,13,46,0.0,0.0
1010,246,23-09-2019 19:50:00,0,5376.0,4691.0,0.873,26.377,251,56,24,32,195,187,8,50,0.0,0.06
1010,247,23-09-2019 19:52:00,0,4481.5,3820.5,0.8475,21.888,206,35,30,5,171,153,18,36,0.0,0.0
1010,248,23-09-2019 19:54:00,0,3587.0,2950.0,0.822,17.399,339,59,23,36,280,247,33,0,0.0,0.0
1010,249,23-09-2019 19:56:00,0,3377.0,2831.0,0.838,16.441,217,22,2,20,195,179,16,0,0.0,0.0
1010,250,23-09-2019 19:58:00,0,3057.0,2579.0,0.843,14.9,270,39,11,28,231,216,15,0,0.0,0.0
1010,251,23-09-2019 20:00:00,0,3063.0,2622.0,0.856,14.972,233,20,6,14,213,196,17,0,0.0,0.01
1010,252,23-09-2019 20:02:00,0,3582.0,2954.0,0.825,17.383,14,0,0,0,14,13,1,0,0.0,0.0
1010,253,23-09-2019 20:04:00,0,3554.0,3042.0,0.856,17.373,9,4,1,3,5,4,1,0,0.0,0.0
1010,254,23-09-2019 20:06:00,0,3551.0,3098.0,0.872,17.42,25,5,0,5,20,18,2,0,0.0,0.01
1010,255,23-09-2019 20:08:00,0,3550.0,3104.0,0.874,17.424,33,1,0,1,32,30,2,0,0.01,0.0
1010,256,23-09-2019 20:10:00,0,3442.0,2995.0,0.87,16.877,3,3,0,3,0,0,0,0,0.0,0.0
1010,257,23-09-2019 20:12:00,0,3373.0,2869.0,0.851,16.466,361,146,91,55,215,197,18,19,0.04,0.0
1010,258,23-09-2019 20:14:00,0,4137.0,3709.0,0.897,20.406,439,189,146,43,250,226,24,117,0.0,0.0
1010,259,23-09-2019 20:16:00,0,3637.0,3281.0,0.902,17.962,229,85,57,28,144,134,10,116,0.0,0.0
1010,260,23-09-2019 20:18:00,0,5417.0,4953.0,0.914,26.828,301,106,65,41,195,181,14,75,0.0,0.0
1010,261,23-09-2019 20:20:00,0,5106.0,4747.0,0.93,25.375,219,37,11,26,182,176,6,34,0.0,0.06
1010,262,23-09-2019 20:22:00,0,5335.0,4917.0,0.922,26.462,257,34,12,22,223,215,8,43,0.0,0.06
1010,263,23-09-2019 20:24:00,0,4818.0,4346.0,0.902,23.796,318,131,94,37,187,166,21,77,0.14,0.02
1010,264,23-09-2019 20:26:00,0,4165.5,3766.0,0.9045,20.583,361,198,154,44,163,140,23,141,0.01,0.0
1010,265,23-09-2019 20:28:00,0,3513.0,3186.0,0.907,17.37,450,202,158,44,248,196,52,113,0.0,0.0
1010,266,23-09-2019 20:30:00,0,3627.0,3285.0,0.906,17.929,560,252,197,55,308,236,72,85,0.0,0.0
1010,267,23-09-2019 20:32:00,0,3914.0,3558.0,0.909,19.361,304,128,88,40,176,125,51,64,0.0,0.0
1010,268,23-09-2019 20:34:00,0,4812.0,4508.0,0.937,23.948,210,105,75,30,105,65,40,42,0.04,0.0
1010,269,23-09-2019 20:36:00,0,3832.0,3376.0,0.881,18.837,288,122,90,32,166,112,54,52,0.0,0.01
1010,270,23-09-2019 20:38:00,0,5095.0,4713.0,0.925,25.294,146,28,12,16,118,80,38,26,0.0,0.05
1010,271,23-09-2019 20:40:00,0,5332.0,4873.0,0.914,26.403,288,25,3,22,263,197,66,42,0.0,0.0
1010,272,23-09-2019 20:42:00,0,4682.0,4382.0,0.936,23.299,280,115,82,33,165,113,52,80,0.15,0.08
1010,273,23-09-2019 20:44:00,0,4216.0,3925.0,0.931,20.956,320,142,103,39,178,126,52,72,0.0,0.0
1010,274,23-09-2019 20:46:00,0,4614.0,4287.0,0.929,22.927,199,22,9,13,177,112,65,30,0.0,0.04
1010,275,23-09-2019 20:48:00,0,4995.0,4731.0,0.947,24.918,212,18,2,16,194,129,65,23,0.0,0.07
1010,276,23-09-2019 20:50:00,0,5072.0,4839.0,0.954,25.341,381,156,113,43,225,158,67,59,0.14,0.02
1010,277,23-09-2019 20:52:00,0,4993.0,4667.0,0.935,24.84,402,192,146,46,210,162,48,84,0.0,0.01
1010,278,23-09-2019 20:54:00,0,3926.0,3622.0,0.923,19.477,133,46,19,27,87,51,36,2,0.0,0.01
1010,279,23-09-2019 20:56:00,0,3323.0,3033.0,0.913,16.448,213,69,36,33,144,95,49,0,0.0,0.0
1010,280,23-09-2019 20:58:00,0,3247.0,2842.0,0.875,15.941,115,2,1,1,113,71,42,0,0.0,0.0
1010,281,23-09-2019 21:00:00,0,3139.0,2766.5,0.8815,15.4315,142,21,8,13,121,72,49,0,0.0,0.0
1010,282,23-09-2019 21:02:00,0,3031.0,2691.0,0.888,14.922,124,41,12,29,83,53,30,3,0.0,0.0
1010,283,23-09-2019 21:04:00,0,3545.0,3082.0,0.869,17.38,25,4,2,2,21,7,14,0,0.0,0.0
1010,284,23-09-2019 21:06:00,0,3540.0,3186.0,0.9,17.473,44,18,1,17,26,4,22,0,0.0,0.0
1010,285,23-09-2019 21:08:00,0,3541.0,3126.0,0.883,17.411,46,12,2,10,34,9,25,0,0.0,0.0
1010,286,23-09-2019 21:10:00,0,3321.0,3016.0,0.908,16.422,39,7,2,5,32,6,26,0,0.0,0.0
1010,287,23-09-2019 21:12:00,0,3334.0,2998.0,0.899,16.455,27,1,0,1,26,0,26,0,0.0,0.0
1010,288,23-09-2019 21:14:00,0,3318.0,2990.0,0.901,16.384,27,5,0,5,22,2,20,0,0.0,0.0
1010,289,23-09-2019 21:16:00,0,3110.0,2879.0,0.926,15.441,37,3,0,3,34,9,25,0,0.0,0.0
1010,290,23-09-2019 21:18:00,0,3117.0,2873.0,0.922,15.461,24,0,0,0,24,0,24,0,0.0,0.0
1010,291,23-09-2019 21:20:00,0,2986.0,2861.0,0.958,14.934,26,0,0,0,26,8,18,0,0.0,0.0
1010,292,23-09-2019 21:22:00,0,3124.0,2865.0,0.917,15.479,39,8,2,6,31,5,26,0,0.0,0.0
1010,293,23-09-2019 21:24:00,0,2999.0,2795.0,0.932,14.91,32,4,0,4,28,2,26,0,0.0,0.0
1010,294,23-09-2019 21:26:00,0,3017.0,2786.0,0.924,14.97,33,0,0,0,33,6,27,0,0.0,0.0
1010,295,23-09-2019 21:28:00,0,3027.0,2761.0,0.912,14.983,265,129,82,47,136,91,45,78,0.0,0.0
1010,296,23-09-2019 21:30:00,0,4298.0,4108.0,0.956,21.484,225,113,74,39,112,77,35,12,0.0,0.0
1010,297,23-09-2019 21:32:00,0,3522.0,3219.0,0.914,17.441,326,179,127,52,147,105,42,80,0.03,0.0
1010,298,23-09-2019 21:34:00,0,4387.0,4152.5,0.941,21.883,101,42,16,26,59,29,30,28,0.0,0.01
1010,299,23-09-2019 21:36:00,0,5252.0,5086.0,0.968,26.325,90,24,19,5,66,34,32,14,0.0,0.27
1010,300,23-09-2019 21:38:00,0,3416.0,3170.0,0.928,16.968,27,0,0,0,27,2,25,0,0.0,0.0
1010,301,23-09-2019 21:40:00,0,3223.0,2922.0,0.907,15.934,65,26,23,3,39,20,19,43,0.0,0.01
1010,302,23-09-2019 21:42:00,0,4812.0,4494.0,0.934,23.934,229,117,86,31,112,80,32,98,0.06,0.02
1010,303,23-09-2019 21:44:00,0,4480.0,4198.0,0.937,22.297,260,138,103,35,122,99,23,133,0.05,0.0
1010,304,23-09-2019 21:46:00,0,4898.0,4606.0,0.94,24.397,210,119,89,30,91,73,18,17,0.09,0.0
1010,305,23-09-2019 21:48:00,0,3960.0,3890.0,0.982,19.907,330,188,143,45,142,108,34,67,0.01,0.0
1010,306,23-09-2019 21:50:00,0,4861.0,4717.0,0.97,24.376,131,64,31,33,67,33,34,83,0.0,0.0
1010,307,23-09-2019 21:52:00,0,4878.0,4681.0,0.959,24.402,283,149,112,37,134,95,39,76,0.0,0.02
1010,308,23-09-2019 21:54:00,0,4779.0,4600.0,0.962,23.923,139,83,56,27,56,36,20,101,0.0,0.0
1010,309,23-09-2019 21:56:00,0,4772.0,4683.0,0.981,23.987,159,88,56,32,71,42,29,82,0.0,0.0
1010,310,23-09-2019 21:58:00,0,4794.0,4518.0,0.943,23.889,165,66,41,25,99,54,45,34,0.06,0.0
1010,311,23-09-2019 22:00:00,0,3528.0,3196.0,0.906,17.44,157,26,10,16,131,89,42,0,0.0,0.0
1010,312,23-09-2019 22:02:00,0,2929.0,2692.0,0.919,14.521,158,80,40,40,78,52,26,76,0.0,0.01
1010,313,23-09-2019 22:04:00,0,3801.0,3516.0,0.925,18.87,271,129,88,41,142,110,32,89,0.05,0.01
1010,314,23-09-2019 22:06:00,0,4830.0,4485.0,0.929,23.997,206,120,75,45,86,56,30,30,0.01,0.0
1010,315,23-09-2019 22:08:00,0,4651.0,4394.5,0.9455,23.1915,307,167,124,43,140,97,43,46,0.0,0.0
1010,316,23-09-2019 22:10:00,0,4472.0,4304.0,0.962,22.386,158,58,25,33,100,45,55,66,0.01,0.0
1010,317,23-09-2019 22:12:00,0,4294.0,4084.0,0.951,21.439,141,61,39,22,80,52,28,54,0.0,0.0
1010,318,23-09-2019 22:14:00,0,3014.0,2807.0,0.931,14.981,144,27,4,23,117,76,41,0,0.0,0.0
1010,319,23-09-2019 22:16:00,0,2807.0,2559.0,0.912,13.894,117,13,0,13,104,65,39,0,0.0,0.0
1010,320,23-09-2019 22:18:00,0,2829.0,2565.0,0.907,13.986,146,12,3,9,134,91,43,0,0.0,0.0
1010,321,23-09-2019 22:20:00,0,3119.0,2845.0,0.912,15.437,55,5,0,5,50,19,31,0,0.0,0.0
1010,322,23-09-2019 22:22:00,0,3236.0,2919.0,0.902,15.982,27,5,2,3,22,0,22,0,0.0,0.0
1010,323,23-09-2019 22:24:00,0,3243.0,2871.0,0.885,15.957,23,4,1,3,19,0,19,0,0.0,0.0
1010,324,23-09-2019 22:26:00,0,3233.0,2885.0,0.892,15.932,33,14,2,12,19,0,19,0,0.0,0.0
1010,325,23-09-2019 22:28:00,0,3336.0,2906.0,0.871,16.362,35,9,1,8,26,7,19,0,0.0,0.0
1010,326,23-09-2019 22:30:00,0,3120.0,2872.0,0.921,15.473,32,5,1,4,27,6,21,0,0.0,0.0
1010,327,23-09-2019 22:32:00,0,2982.0,2835.0,0.951,14.888,24,0,0,0,24,0,24,0,0.01,0.01
1010,328,23-09-2019 22:34:00,0,3033.0,2722.0,0.897,14.964,29,5,3,2,24,4,20,0,0.0,0.0
1010,329,23-09-2019 22:36:00,0,2915.0,2651.0,0.909,14.42,46,2,0,2,44,20,24,0,0.0,0.0
1010,330,23-09-2019 22:38:00,0,2806.0,2634.0,0.939,13.97,254,133,102,31,121,71,50,91,0.0,0.0
1010,331,23-09-2019 22:40:00,0,4496.0,4276.0,0.951,22.449,119,55,33,22,64,44,20,114,0.0,0.0
1010,332,23-09-2019 22:42:00,0,3947.5,3714.0,0.9395,19.6645,158,81,64,17,77,54,23,102,0.0,0.0
1010,333,23-09-2019 22:44:00,0,3399.0,3152.0,0.928,16.88,198,90,71,19,108,78,30,142,0.0,0.0
1010,334,23-09-2019 22:46:00,0,4510.0,4277.0,0.948,22.503,268,135,97,38,133,91,42,136,0.0,0.0
1010,335,23-09-2019 22:48:00,0,4970.0,4775.0,0.961,24.869,201,123,78,45,78,37,41,83,0.0,0.0
1010,336,23-09-2019 22:50:00,0,4961.0,4808.0,0.969,24.867,295,157,103,54,138,85,53,83,0.0,0.0
1010,337,23-09-2019 22:52:00,0,4804.0,4505.0,0.938,23.915,234,130,84,46,104,62,42,58,0.0,0.0
1010,338,23-09-2019 22:54:00,0,4778.0,4606.0,0.964,23.924,245,109,71,38,136,81,55,78,0.0,0.0
1010,339,23-09-2019 22:56:00,0,4800.0,4565.0,0.951,23.964,185,74,39,35,111,63,48,40,0.0,0.0
1010,340,23-09-2019 22:58:00,0,4878.0,4750.0,0.974,24.479,215,66,34,32,149,87,62,52,0.0,0.0
1010,341,23-09-2019 23:00:00,0,4768.0,4616.0,0.968,23.898,134,52,35,17,82,46,36,49,0.0,0.0
1010,342,23-09-2019 23:02:00,0,4953.0,4880.0,0.985,24.919,162,60,30,30,102,57,45,51,0.0,0.03
1010,343,23-09-2019 23:04:00,0,4072.0,3936.0,0.967,20.403,394,173,132,41,221,162,59,25,0.1,0.03
1010,344,23-09-2019 23:06:00,0,3972.0,3836.0,0.966,19.896,232,100,73,27,132,92,40,120,0.03,0.0
1010,345,23-09-2019 23:08:00,0,4387.0,4212.0,0.96,21.948,316,180,126,54,136,80,56,52,0.0,0.0
1010,346,23-09-2019 23:10:00,0,4467.0,4308.0,0.964,22.371,193,81,47,34,112,77,35,79,0.0,0.0
1010,347,23-09-2019 23:12:00,0,4111.0,3828.0,0.931,20.437,298,132,86,46,166,126,40,69,0.0,0.0
1010,348,23-09-2019 23:14:00,0,4769.0,4603.0,0.965,23.886,184,65,26,39,119,84,35,26,0.08,0.0
1010,349,23-09-2019 23:16:00,0,4133.5,3947.5,0.953,20.655,212,116,76,40,96,55,41,79,0.0,0.02
1010,350,23-09-2019 23:18:00,0,3498.0,3292.0,0.941,17.424,255,136,100,36,119,70,49,48,0.0,0.04
1010,351,23-09-2019 23:20:00,0,4590.0,4380.0,0.954,22.932,201,80,42,38,121,76,45,50,0.01,0.0
1010,352,23-09-2019 23:22:00,0,4786.0,4610.0,0.963,23.96,196,104,52,52,92,41,51,52,0.0,0.0
1010,353,23-09-2019 23:24:00,0,4479.0,4345.0,0.97,22.458,245,150,106,44,95,53,42,41,0.0,0.0
1010,354,23-09-2019 23:26:00,0,4008.0,3697.0,0.923,19.885,244,120,86,34,124,92,32,41,0.07,0.03
1010,355,23-09-2019 23:28:00,0,3838.0,3461.0,0.902,18.955,125,70,44,26,55,34,21,85,0.0,0.0
1010,356,23-09-2019 23:30:00,0,4490.0,4311.0,0.96,22.464,144,73,42,31,71,35,36,49,0.02,0.0
1010,357,23-09-2019 23:32:00,0,4750.0,4634.0,0.976,23.843,132,63,31,32,69,22,47,52,0.0,0.04
1010,358,23-09-2019 23:34:00,0,4518.0,4184.0,0.926,22.433,202,101,76,25,101,64,37,58,0.04,0.0
1010,359,23-09-2019 23:36:00,0,4304.0,4090.0,0.95,21.486,168,116,85,31,52,32,20,58,0.0,0.01
1010,360,23-09-2019 23:38:00,0,3801.0,3601.0,0.947,18.961,223,123,100,23,100,80,20,198,0.01,0.0
1010,361,23-09-2019 23:40:00,0,3923.0,3528.0,0.899,19.363,447,194,160,34,253,211,42,154,0.04,0.0
1010,362,23-09-2019 23:42:00,0,4513.0,4219.0,0.935,22.451,347,153,114,39,194,168,26,161,0.01,0.0
1010,363,23-09-2019 23:44:00,0,3301.0,3063.0,0.928,16.398,262,95,66,29,167,142,25,57,0.01,0.01
1010,364,23-09-2019 23:46:00,0,4287.0,4142.0,0.966,21.475,405,243,194,49,162,126,36,197,0.0,0.02
1010,365,23-09-2019 23:48:00,0,3921.0,3599.0,0.918,19.431,290,199,159,40,91,66,25,159,0.0,0.0
1010,366,23-09-2019 23:50:00,0,4614.5,4320.5,0.934,22.9635,373,204,153,51,169,121,48,104,0.0,0.0
1010,367,23-09-2019 23:52:00,0,5308.0,5042.0,0.95,26.496,358,198,151,47,160,129,31,116,0.0,0.0
1010,368,23-09-2019 23:54:00,0,4484.0,4340.0,0.968,22.471,256,127,100,27,129,91,38,78,0.0,0.0
1010,369,23-09-2019 23:56:00,0,5688.0,5521.0,0.971,28.522,154,89,59,30,65,30,35,66,0.0,0.0
1010,370,23-09-2019 23:58:00,0,4816.0,4463.0,0.927,23.916,251,135,103,32,116,96,20,183,0.0,0.0
1010,371,24-09-2019 00:00:00,0,3923.0,3601.0,0.918,19.445,304,145,111,34,159,122,37,84,0.0,0.02
1010,372,24-09-2019 00:02:00,0,4775.0,4542.0,0.951,23.84,170,91,50,41,79,41,38,55,0.0,0.0
1010,373,24-09-2019 00:04:00,0,5031.0,4667.0,0.928,24.991,33,26,16,10,7,4,3,108,0.0,0.0
1010,374,24-09-2019 00:06:00,0,3342.0,2962.0,0.886,16.445,4,3,1,2,1,1,0,76,0.02,0.03
1010,375,24-09-2019 00:08:00,0,3793.0,3515.0,0.927,18.838,120,54,34,20,66,43,23,72,0.08,0.0
1010,376,24-09-2019 00:10:00,0,4814.0,4552.0,0.946,24.005,179,101,63,38,78,41,37,69,0.0,0.0
1010,377,24-09-2019 00:12:00,0,4792.0,4596.0,0.959,23.97,208,132,90,42,76,48,28,61,0.0,0.0
1010,378,24-09-2019 00:14:00,0,4480.0,4208.0,0.939,22.31,168,78,35,43,90,39,51,62,0.01,0.0
1010,379,24-09-2019 00:16:00,0,4846.0,4414.0,0.911,23.981,153,79,36,43,74,36,38,49,0.0,0.02
1010,380,24-09-2019 00:18:00,0,4793.0,4514.0,0.942,23.882,230,101,71,30,129,81,48,23,0.06,0.02
1010,381,24-09-2019 00:20:00,0,3329.0,3065.0,0.921,16.51,213,74,39,35,139,86,53,0,0.0,0.01
1010,382,24-09-2019 00:22:00,0,3009.0,2799.0,0.93,14.955,185,56,24,32,129,78,51,5,0.0,0.0
1010,383,24-09-2019 00:24:00,0,3016.0,2743.5,0.9095,14.92,76,17,1,16,59,30,29,0,0.0,0.01
1010,384,24-09-2019 00:26:00,0,3023.0,2688.0,0.889,14.885,34,16,0,16,18,4,14,0,0.0,0.0
1010,385,24-09-2019 00:28:00,0,3041.0,2698.0,0.887,14.969,27,9,4,5,18,4,14,0,0.0,0.0
1010,386,24-09-2019 00:30:00,0,3055.0,2561.0,0.838,14.873,37,6,2,4,31,10,21,0,0.0,0.0
1010,387,24-09-2019 00:32:00,0,3061.0,2581.0,0.843,14.92,60,8,7,1,52,32,20,0,0.0,0.0
1010,388,24-09-2019 00:34:00,0,3070.0,2582.0,0.841,14.956,65,9,5,4,56,29,27,0,0.0,0.0
1010,389,24-09-2019 00:36:00,0,3061.0,2599.0,0.849,14.939,57,9,4,5,48,14,34,0,0.0,0.0
1010,390,24-09-2019 00:38:00,0,3043.0,2653.0,0.872,14.926,33,4,1,3,29,6,23,0,0.0,0.0
1010,391,24-09-2019 00:40:00,0,2940.0,2585.0,0.879,14.448,203,103,86,17,100,77,23,36,0.0,0.0
1010,392,24-09-2019 00:42:00,0,4402.0,4119.0,0.936,21.903,206,99,78,21,107,82,25,107,0.0,0.0
1010,393,24-09-2019 00:44:00,0,4301.0,4039.0,0.939,21.418,239,149,111,38,90,67,23,136,0.0,0.0
1010,394,24-09-2019 00:46:00,0,3928.0,3608.0,0.919,19.47,200,79,49,30,121,84,37,33,0.0,0.0
1010,395,24-09-2019 00:48:00,0,3044.0,2649.0,0.87,14.925,202,75,41,34,127,87,40,7,0.0,0.0
1010,396,24-09-2019 00:50:00,0,4308.0,3961.0,0.92,21.358,140,76,46,30,64,37,27,116,0.0,0.01
1010,397,24-09-2019 00:52:00,0,4797.0,4598.0,0.959,23.992,122,59,24,35,63,33,30,103,0.0,0.0
1010,398,24-09-2019 00:54:00,0,3726.0,3412.0,0.916,18.457,398,222,167,55,176,134,42,32,0.0,0.0
1010,399,24-09-2019 00:56:00,0,4602.0,4341.0,0.943,22.939,165,77,34,43,88,36,52,62,0.0,0.0
1010,400,24-09-2019 00:58:00,0,4548.0,4300.0,0.9455,22.68,110,55,17,38,55,24,31,43,0.0,0.0
1010,401,24-09-2019 01:00:00,0,4494.0,4259.0,0.948,22.421,118,49,23,26,69,38,31,49,0.0,0.0
1010,402,24-09-2019 01:02:00,0,3503.0,3233.0,0.923,17.381,214,65,50,15,149,107,42,104,0.0,0.01
1010,403,24-09-2019 01:04:00,0,4807.0,4378.0,0.911,23.786,184,96,56,40,88,49,39,47,0.0,0.04
1010,404,24-09-2019 01:06:00,0,4788.0,4493.0,0.938,23.841,175,85,48,37,90,44,46,57,0.0,0.0
1010,405,24-09-2019 01:08:00,0,4817.0,4385.0,0.91,23.835,356,176,119,57,180,119,61,44,0.0,0.04
1010,406,24-09-2019 01:10:00,0,4410.0,4129.0,0.936,21.947,232,147,110,37,85,60,25,145,0.02,0.01
1010,407,24-09-2019 01:12:00,0,3807.0,3513.0,0.923,18.891,263,147,112,35,116,90,26,130,0.02,0.0
1010,408,24-09-2019 01:14:00,0,4820.0,4413.0,0.916,23.876,184,88,48,40,96,54,42,87,0.0,0.0
1010,409,24-09-2019 01:16:00,0,4927.0,4550.0,0.924,24.45,85,32,13,19,53,28,25,68,0.0,0.02
1010,410,24-09-2019 01:18:00,0,3943.0,3492.0,0.886,19.402,184,94,69,25,90,59,31,115,0.06,0.0
1010,411,24-09-2019 01:20:00,0,4327.0,3970.0,0.918,21.442,155,61,29,32,94,44,50,69,0.0,0.0
1010,412,24-09-2019 01:22:00,0,4824.0,4433.0,0.919,23.914,204,111,60,51,93,51,42,46,0.0,0.04
1010,413,24-09-2019 01:24:00,0,4430.0,4062.0,0.917,21.952,343,145,111,34,198,144,54,54,0.15,0.0
1010,414,24-09-2019 01:26:00,0,4505.0,4221.0,0.937,22.422,254,152,119,33,102,75,27,136,0.01,0.01
1010,415,24-09-2019 01:28:00,0,4718.0,4341.0,0.92,23.394,225,87,47,40,138,82,56,87,0.0,0.0
1010,416,24-09-2019 01:30:00,0,4414.0,4134.0,0.937,21.967,337,140,101,39,197,139,58,16,0.01,0.02
1010,417,24-09-2019 01:32:00,0,3615.5,3344.5,0.922,17.947,139,50,31,19,89,49,40,0,0.0,0.0
1010,418,24-09-2019 01:34:00,0,2817.0,2555.0,0.907,13.927,140,29,2,27,111,65,46,6,0.0,0.0
1010,419,24-09-2019 01:36:00,0,2817.0,2514.0,0.892,13.882,113,23,2,21,90,38,52,1,0.0,0.0
1010,420,24-09-2019 01:38:00,0,2824.0,2502.0,0.886,13.898,121,41,14,27,80,44,36,0,0.0,0.0
1010,421,24-09-2019 01:40:00,0,3063.0,2594.0,0.847,14.941,82,18,5,13,64,34,30,0,0.0,0.0
1010,422,24-09-2019 01:42:00,0,3035.0,2693.0,0.887,14.941,134,56,30,26,78,47,31,0,0.0,0.0
1010,423,24-09-2019 01:44:00,0,3142.0,2775.0,0.883,15.451,72,20,6,14,52,17,35,0,0.0,0.0
1010,424,24-09-2019 01:46:00,0,3016.0,2693.0,0.893,14.865,34,1,0,1,33,0,33,0,0.0,0.0
1010,425,24-09-2019 01:48:00,0,3042.0,2605.0,0.856,14.869,32,0,0,0,32,0,32,0,0.0,0.0
1010,426,24-09-2019 01:50:00,0,3056.0,2616.0,0.856,14.939,34,6,1,5,28,0,28,0,0.0,0.0
1010,427,24-09-2019 01:52:00,0,2833.0,2522.0,0.89,13.955,29,0,0,0,29,0,29,0,0.0,0.0
1010,428,24-09-2019 01:54:00,0,2865.0,2411.0,0.841,13.959,82,28,16,12,54,21,33,0,0.0,0.0
1010,429,24-09-2019 01:56:00,0,2956.0,2529.0,0.855,14.445,48,9,4,5,39,7,32,0,0.0,0.0
1010,430,24-09-2019 01:58:00,0,2865.0,2348.0,0.82,13.887,52,2,0,2,50,19,31,0,0.0,0.0
1010,431,24-09-2019 02:00:00,0,2629.0,2260.0,0.86,12.859,386,216,183,33,170,131,39,93,0.0,0.0
1010,432,24-09-2019 02:02:00,0,4789.0,4492.0,0.938,23.842,261,127,105,22,134,108,26,129,0.0,0.0
1010,433,24-09-2019 02:04:00,0,4804.0,4479.0,0.932,23.885,337,169,138,31,168,135,33,129,0.0,0.0
1010,434,24-09-2019 02:06:00,0,4709.5,4392.5,0.9325,23.417,213,85,59,26,128,94,34,125,0.01,0.0
1010,435,24-09-2019 02:08:00,0,4615.0,4306.0,0.933,22.949,281,139,109,30,142,107,35,159,0.0,0.0
1010,436,24-09-2019 02:10:00,0,4512.0,4191.0,0.929,22.417,178,80,39,41,98,53,45,59,0.0,0.02
1010,437,24-09-2019 02:12:00,0,4856.0,4332.0,0.892,23.93,167,66,31,35,101,49,52,80,0.0,0.0
1010,438,24-09-2019 02:14:00,0,4856.0,4296.0,0.885,23.89,156,60,23,37,96,50,46,62,0.0,0.0
1010,439,24-09-2019 02:16:00,0,4853.0,4334.0,0.893,23.918,145,55,22,33,90,39,51,57,0.0,0.0
1010,440,24-09-2019 02:18:00,0,4524.0,4136.0,0.914,22.404,169,78,38,40,91,45,46,81,0.0,0.0
1010,441,24-09-2019 02:20:00,0,4756.0,4202.0,0.883,23.392,169,116,71,45,53,27,26,58,0.0,0.09
1010,442,24-09-2019 02:22:00,0,4134.0,3744.0,0.905,20.434,337,192,137,55,145,105,40,46,0.0,0.02
1010,443,24-09-2019 02:24:00,0,3928.0,3552.0,0.904,19.41,166,85,59,26,81,49,32,79,0.0,0.0
1010,444,24-09-2019 02:26:00,0,4569.0,4001.0,0.876,22.432,378,168,123,45,210,151,59,23,0.06,0.11
1010,445,24-09-2019 02:28:00,0,4348.0,3813.0,0.877,21.351,178,95,72,23,83,61,22,89,0.0,0.0
1010,446,24-09-2019 02:30:00,0,3370.0,2884.0,0.856,16.47,170,75,32,43,95,58,37,0,0.0,0.0
1010,447,24-09-2019 02:32:00,0,4247.0,3746.0,0.882,20.879,464,266,214,52,198,141,57,20,0.01,0.0
1010,448,24-09-2019 02:34:00,0,5004.0,4601.0,0.919,24.81,252,148,112,36,104,71,33,116,0.0,0.0
1010,449,24-09-2019 02:36:00,0,4345.0,3887.0,0.895,21.422,134,74,32,42,60,17,43,67,0.0,0.0
1010,450,24-09-2019 02:38:00,0,4506.0,4182.0,0.928,22.384,92,52,24,28,40,13,27,49,0.0,0.0
1010,451,24-09-2019 02:40:00,0,4529.5,4118.0,0.909,22.405,120,77,49,28,43,20,23,38,0.0,0.05
1010,452,24-09-2019 02:42:00,0,4553.0,4054.0,0.89,22.426,108,70,37,33,38,19,19,47,0.0,0.09
1010,453,24-09-2019 02:44:00,0,4546.0,4034.0,0.887,22.377,177,105,67,38,72,48,24,58,0.16,0.03
1010,454,24-09-2019 02:46:00,0,4380.0,3844.0,0.878,21.512,479,266,216,50,213,161,52,30,0.0,0.03
1010,455,24-09-2019 02:48:00,0,3530.0,3109.0,0.881,17.349,151,38,24,14,113,73,40,4,0.0,0.0
1010,456,24-09-2019 02:50:00,0,2864.0,2421.0,0.845,13.965,125,25,7,18,100,60,40,0,0.0,0.0
1010,457,24-09-2019 02:52:00,0,2888.0,2315.0,0.801,13.943,103,32,1,31,71,29,42,0,0.0,0.0
1010,458,24-09-2019 02:54:00,0,2867.0,2445.0,0.853,14.002,44,9,1,8,35,15,20,0,0.0,0.0
1010,459,24-09-2019 02:56:00,0,2834.0,2442.0,0.862,13.868,32,6,2,4,26,11,15,0,0.0,0.0
1010,460,24-09-2019 02:58:00,0,2962.0,2524.0,0.852,14.467,12,0,0,0,12,3,9,0,0.0,0.0
1010,461,24-09-2019 03:00:00,0,3085.0,2510.0,0.814,14.935,35,6,1,5,29,18,11,0,0.0,0.0
1010,462,24-09-2019 03:02:00,0,3038.0,2715.0,0.894,14.976,10,0,0,0,10,0,10,0,0.0,0.0
1010,463,24-09-2019 03:04:00,0,3059.0,2667.0,0.872,15.004,17,0,0,0,17,1,16,0,0.0,0.0
1010,464,24-09-2019 03:06:00,0,2831.0,2502.0,0.884,13.923,59,14,7,7,45,24,21,0,0.0,0.0
1010,465,24-09-2019 03:08:00,0,2854.0,2394.0,0.839,13.897,11,0,0,0,11,0,11,0,0.0,0.0
1010,466,24-09-2019 03:10:00,0,2531.0,2225.0,0.879,12.436,15,0,0,0,15,0,15,0,0.0,0.0
1010,467,24-09-2019 03:12:00,0,2556.0,2157.0,0.844,12.461,27,4,1,3,23,4,19,0,0.0,0.0
1010,468,24-09-2019 03:14:00,0,2544.5,2189.0,0.8605,12.4495,10,0,0,0,10,0,10,0,0.0,0.0
1010,469,24-09-2019 03:16:00,0,2533.0,2221.0,0.877,12.438,19,0,0,0,19,0,19,0,0.0,0.0
1010,470,24-09-2019 03:18:00,0,2639.0,2274.0,0.862,12.915,22,2,1,1,20,0,20,0,0.0,0.0
1010,471,24-09-2019 03:20:00,0,2873.0,2392.0,0.833,13.968,17,4,0,4,13,0,13,0,0.0,0.0
1010,472,24-09-2019 03:22:00,0,2949.0,2529.0,0.858,14.421,5,0,0,0,5,0,5,0,0.0,0.0
1010,473,24-09-2019 03:24:00,0,3051.0,2646.0,0.867,14.951,35,5,0,5,30,11,19,0,0.0,0.0
1010,474,24-09-2019 03:26:00,0,3361.0,2861.0,0.851,16.412,10,0,0,0,10,0,10,0,0.0,0.0
1010,475,24-09-2019 03:28:00,0,3326.0,2969.0,0.893,16.392,15,0,0,0,15,3,12,0,0.0,0.0
1010,476,24-09-2019 03:30:00,0,3518.0,3230.0,0.918,17.437,32,1,0,1,31,6,25,0,0.0,0.0
1010,477,24-09-2019 03:32:00,0,4288.0,4079.0,0.951,21.409,15,2,0,2,13,2,11,0,0.0,0.0
1010,478,24-09-2019 03:34:00,0,4294.0,4154.0,0.968,21.516,54,15,5,10,39,21,18,0,0.0,0.0
1010,479,24-09-2019 03:36:00,0,4296.0,3963.0,0.922,21.313,22,1,0,1,21,8,13,0,0.0,0.0
1010,480,24-09-2019 03:38:00,0,4211.0,3952.0,0.939,20.967,43,3,1,2,40,14,26,0,0.0,0.0
1010,481,24-09-2019 03:40:00,0,4188.0,3969.0,0.948,20.893,52,8,0,8,44,21,23,0,0.0,0.0
1010,482,24-09-2019 03:42:00,0,4091.0,3928.0,0.96,20.465,50,11,0,11,39,16,23,0,0.0,0.0
1010,483,24-09-2019 03:44:00,0,3946.0,3878.0,0.983,19.839,50,1,1,0,49,18,31,0,0.0,0.0
1010,484,24-09-2019 03:46:00,0,3993.0,3844.0,0.963,19.99,40,9,3,6,31,11,20,0,0.0,0.0
1010,485,24-09-2019 03:48:00,0,3997.5,3804.0,0.952,19.963,51,19,2,17,32,13,19,0,0.0,0.0
1010,486,24-09-2019 03:50:00,0,4002.0,3764.0,0.941,19.936,150,49,19,30,101,62,39,6,0.0,0.0
1010,487,24-09-2019 03:52:00,0,3952.0,3877.0,0.981,19.863,211,102,73,29,109,72,37,66,0.0,0.0
1010,488,24-09-2019 03:54:00,0,4011.0,3834.0,0.956,20.049,120,78,43,35,42,28,14,35,0.0,0.0
1010,489,24-09-2019 03:56:00,0,4006.0,3686.0,0.92,19.863,659,328,257,71,331,255,76,9,0.0,0.0
1010,490,24-09-2019 03:58:00,0,4008.0,3721.0,0.928,19.911,516,287,236,51,229,185,44,67,0.0,0.04
1010,491,24-09-2019 04:00:00,0,3792.0,3628.0,0.957,18.957,379,183,133,50,196,141,55,46,0.0,0.0
1010,492,24-09-2019 04:02:00,0,3985.0,3766.0,0.945,19.869,87,49,26,23,38,13,25,40,0.0,0.0
1010,493,24-09-2019 04:04:00,0,4079.0,3877.0,0.951,20.362,114,64,33,31,50,23,27,64,0.0,0.05
1010,494,24-09-2019 04:06:00,0,4339.0,3953.0,0.911,21.473,43,27,18,9,16,10,6,53,0.0,0.06
1010,495,24-09-2019 04:08:00,0,3895.0,3631.0,0.932,19.365,343,177,132,45,166,120,46,37,0.14,0.02
1010,496,24-09-2019 04:10:00,0,3817.0,3463.0,0.907,18.874,80,14,4,10,66,31,35,0,0.0,0.0
1010,497,24-09-2019 04:12:00,0,2817.0,2609.0,0.926,13.989,128,20,3,17,108,56,52,0,0.0,0.0
1010,498,24-09-2019 04:14:00,0,2923.0,2570.0,0.879,14.363,82,16,2,14,66,30,36,0,0.0,0.0
1010,499,24-09-2019 04:16:00,0,3374.0,2874.0,0.852,16.477,13,0,0,0,13,3,10,0,0.0,0.0
1010,500,24-09-2019 04:18:00,0,3039.0,2626.0,0.864,14.88,11,0,0,0,11,0,11,0,0.0,0.0
1010,501,24-09-2019 04:20:00,0,2957.0,2548.0,0.862,14.472,29,5,3,2,24,9,15,0,0.0,0.0
1010,502,24-09-2019 04:22:00,0,3105.0,2683.0,0.864,15.2045,69,0,0,0,69,52,17,0,0.0,0.0
1010,503,24-09-2019 04:24:00,0,3253.0,2818.0,0.866,15.937,23,4,0,4,19,6,13,0,0.0,0.0
1010,504,24-09-2019 04:26:00,0,3825.0,3517.0,0.92,18.962,20,1,0,1,19,4,15,0,0.0,0.0
1010,505,24-09-2019 04:28:00,0,4016.0,3703.0,0.922,19.921,7,0,0,0,7,0,7,0,0.0,0.0
1010,506,24-09-2019 04:30:00,0,3777.0,3642.0,0.964,18.912,19,1,0,1,18,5,13,0,0.0,0.01
1010,507,24-09-2019 04:32:00,0,3726.0,3438.0,0.923,18.486,19,2,0,2,17,0,17,0,0.0,0.0
1010,508,24-09-2019 04:34:00,0,3513.0,3201.0,0.911,17.384,0,0,0,0,0,0,0,0,0.0,0.0
1010,509,24-09-2019 04:36:00,0,3317.0,3075.0,0.927,16.474,5,0,0,0,5,0,5,0,0.0,0.0
1010,510,24-09-2019 04:38:00,0,3322.0,3026.0,0.911,16.438,58,11,6,5,47,11,36,0,0.0,0.0
1010,511,24-09-2019 04:40:00,0,3292.0,3124.0,0.949,16.429,24,0,0,0,24,0,24,0,0.0,0.0
1010,512,24-09-2019 04:42:00,0,3296.0,3130.0,0.949,16.453,29,0,0,0,29,7,22,0,0.0,0.0
1010,513,24-09-2019 04:44:00,0,3297.0,3108.0,0.943,16.431,59,0,0,0,59,24,35,0,0.0,0.0
1010,514,24-09-2019 04:46:00,0,3294.0,3075.0,0.933,16.381,33,0,0,0,33,8,25,0,0.0,0.0
1010,515,24-09-2019 04:48:00,0,3314.0,3084.0,0.931,16.471,20,0,0,0,20,0,20,0,0.0,0.0
1010,516,24-09-2019 04:50:00,0,3307.0,3068.0,0.928,16.426,59,29,2,27,30,6,24,0,0.0,0.0
1010,517,24-09-2019 04:52:00,0,3335.0,2951.0,0.885,16.408,167,82,55,27,85,55,30,37,0.0,0.0
1010,518,24-09-2019 04:54:00,0,3524.0,3194.0,0.906,17.42,195,119,100,19,76,56,20,95,0.0,0.0
1010,519,24-09-2019 04:56:00,0,3515.5,3260.0,0.9275,17.4595,143,72,37,35,71,39,32,44,0.0,0.0
1010,520,24-09-2019 04:58:00,0,3507.0,3326.0,0.949,17.499,126,26,12,14,100,66,34,2,0.0,0.0
1010,521,24-09-2019 05:00:00,0,3719.0,3398.0,0.914,18.414,99,32,6,26,67,38,29,0,0.0,0.0
1010,522,24-09-2019 05:02:00,0,3812.0,3486.0,0.914,18.879,347,179,131,48,168,118,50,9,0.0,0.0
1010,523,24-09-2019 05:04:00,0,3829.0,3467.0,0.905,18.926,141,37,27,10,104,70,34,0,0.0,0.0
1010,524,24-09-2019 05:06:00,0,3718.0,3384.0,0.91,18.397,105,6,3,3,99,88,11,0,0.0,0.0
1010,525,24-09-2019 05:08:00,0,3547.0,3165.0,0.892,17.48,15,3,2,1,12,6,6,0,0.0,0.0
1010,526,24-09-2019 05:10:00,0,3314.0,2998.0,0.905,16.377,28,0,0,0,28,13,15,0,0.0,0.0
1010,527,24-09-2019 05:12:00,0,3242.0,2914.0,0.899,16.001,25,3,1,2,22,10,12,0,0.0,0.0
1010,528,24-09-2019 05:14:00,0,2984.0,2814.0,0.943,14.871,15,0,0,0,15,0,15,0,0.0,0.0
1010,529,24-09-2019 05:16:00,0,3033.0,2750.0,0.907,14.997,11,0,0,0,11,0,11,0,0.0,0.0
1010,530,24-09-2019 05:18:00,0,3045.0,2648.0,0.87,14.931,70,3,2,1,67,31,36,0,0.0,0.0
1010,531,24-09-2019 05:20:00,0,3036.0,2662.0,0.877,14.908,92,7,0,7,85,50,35,0,0.0,0.0
1010,532,24-09-2019 05:22:00,0,3028.0,2708.0,0.894,14.929,42,1,0,1,41,6,35,0,0.0,0.0
1010,533,24-09-2019 05:24:00,0,3018.0,2701.0,0.895,14.883,43,0,0,0,43,13,30,0,0.0,0.0
1010,534,24-09-2019 05:26:00,0,3035.0,2706.0,0.892,14.955,66,28,25,3,38,19,19,1,0.0,0.0
1010,535,24-09-2019 05:28:00,0,3058.0,2601.0,0.851,14.929,144,65,30,35,79,37,42,54,0.0,0.0
1010,536,24-09-2019 05:30:00,0,3282.0,2907.5,0.884,16.15,108,60,30,30,48,12,36,64,0.0,0.04
1010,537,24-09-2019 05:32:00,0,3506.0,3214.0,0.917,17.371,198,126,83,43,72,39,33,101,0.0,0.04
1010,538,24-09-2019 05:34:00,0,3623.0,3351.0,0.925,17.984,428,251,191,60,177,130,47,53,0.0,0.0
1010,539,24-09-2019 05:36:00,0,3343.0,2925.0,0.875,16.408,49,10,2,8,39,17,22,1,0.0,0.0
1010,540,24-09-2019 05:38:00,0,3053.0,2679.0,0.878,14.995,88,8,2,6,80,38,42,0,0.0,0.0
1010,541,24-09-2019 05:40:00,0,3348.0,2929.0,0.875,16.435,94,19,6,13,75,39,36,0,0.0,0.0
1010,542,24-09-2019 05:42:00,0,3504.0,3224.0,0.92,17.375,120,39,22,17,81,41,40,22,0.0,0.0
1010,543,24-09-2019 05:44:00,0,3827.0,3458.0,0.904,18.907,166,74,63,11,92,59,33,4,0.08,0.0
1010,544,24-09-2019 05:46:00,0,3529.0,3170.0,0.898,17.416,12,0,0,0,12,4,8,0,0.0,0.0
1010,545,24-09-2019 05:48:00,0,3525.0,3215.0,0.912,17.448,9,0,0,0,9,3,6,0,0.0,0.0
1010,546,24-09-2019 05:50:00,0,3520.0,3168.0,0.9,17.378,13,0,0,0,13,1,12,0,0.0,0.0
1010,547,24-09-2019 05:52:00,0,3557.0,3117.0,0.876,17.465,4,0,0,0,4,1,3,0,0.01,0.0
1010,548,24-09-2019 05:54:00,0,3316.0,3023.0,0.912,16.412,34,6,4,2,28,0,28,0,0.0,0.0
1010,549,24-09-2019 05:56:00,0,3349.0,2935.0,0.876,16.445,11,2,0,2,9,0,9,0,0.0,0.01
1010,550,24-09-2019 05:58:00,0,3120.0,2799.0,0.897,15.393,32,8,4,4,24,2,22,1,0.0,0.0
1010,551,24-09-2019 06:00:00,1,3018.0,2770.0,0.918,14.96,90,29,15,14,61,19,42,0,0.0,0.0
1010,552,24-09-2019 06:02:00,1,3119.0,2804.0,0.899,15.394,177,94,60,34,83,57,26,63,0.0,0.0
1010,553,24-09-2019 06:04:00,1,3430.0,3059.0,0.8925,16.9005,254,118,86,32,136,98,38,76,0.0,0.0
1010,554,24-09-2019 06:06:00,1,3741.0,3314.0,0.886,18.407,140,75,51,24,65,23,42,122,0.0,0.0
1010,555,24-09-2019 06:08:00,1,3832.0,3469.0,0.905,18.939,85,38,28,10,47,23,24,24,0.0,0.41
1010,556,24-09-2019 06:10:00,1,3237.0,2802.0,0.866,15.856,52,27,0,27,25,10,15,0,0.0,0.0
1010,557,24-09-2019 06:12:00,1,3645.0,3234.0,0.887,17.94,65,15,0,15,50,26,24,0,0.0,0.0
1010,558,24-09-2019 06:14:00,1,4055.0,3607.0,0.89,19.97,136,85,59,26,51,35,16,32,0.0,0.01
1010,559,24-09-2019 06:16:00,1,4000.0,3726.0,0.932,19.884,78,48,38,10,30,24,6,114,0.0,0.0
1010,560,24-09-2019 06:18:00,1,4005.0,3757.0,0.938,19.937,298,163,125,38,135,100,35,19,0.15,0.01
1010,561,24-09-2019 06:20:00,1,4014.0,3606.0,0.898,19.808,339,232,177,55,107,77,30,50,0.0,0.0
1010,562,24-09-2019 06:22:00,1,4030.0,3717.0,0.922,19.994,82,39,34,5,43,28,15,29,0.0,0.0
1010,563,24-09-2019 06:24:00,1,4018.0,3660.0,0.911,19.882,107,49,28,21,58,40,18,80,0.01,0.0
1010,564,24-09-2019 06:26:00,1,4018.0,3726.0,0.927,19.954,325,155,114,41,170,128,42,0,0.12,0.0
1010,565,24-09-2019 06:28:00,1,4108.0,3776.0,0.919,20.367,275,153,114,39,122,83,39,23,0.0,0.0
1010,566,24-09-2019 06:30:00,1,4008.0,3754.0,0.937,19.949,118,54,34,20,64,39,25,9,0.0,0.0
1010,567,24-09-2019 06:32:00,1,3828.0,3441.0,0.899,18.891,121,52,31,21,69,34,35,2,0.01,0.0
1010,568,24-09-2019 06:34:00,1,4017.0,3682.0,0.917,19.902,284,136,97,39,148,108,40,8,0.0,0.0
1010,569,24-09-2019 06:36:00,1,4033.0,3664.0,0.909,19.946,60,30,6,24,30,13,17,0,0.0,0.0
1010,570,24-09-2019 06:38:00,1,4044.0,3621.0,0.8955,19.942,349,226,166,60,123,82,41,10,0.0,0.0
1010,571,24-09-2019 06:40:00,1,4055.0,3578.0,0.882,19.938,132,72,46,26,60,38,22,37,0.0,0.0
1010,572,24-09-2019 06:42:00,1,3933.0,3557.0,0.905,19.433,92,28,12,16,64,21,43,1,0.0,0.0
1010,573,24-09-2019 06:44:00,1,3814.0,3486.0,0.914,18.884,50,7,3,4,43,0,43,0,0.0,0.0
1010,574,24-09-2019 06:46:00,1,3815.0,3487.0,0.914,18.892,121,39,16,23,82,47,35,0,0.0,0.0
1010,575,24-09-2019 06:48:00,1,3826.0,3516.0,0.919,18.968,88,30,2,28,58,22,36,0,0.0,0.0
1010,576,24-09-2019 06:50:00,1,3814.0,3468.0,0.909,18.866,28,0,0,0,28,8,20,0,0.0,0.0
1010,577,24-09-2019 06:52:00,1,3869.0,3324.0,0.859,18.925,9,0,0,0,9,0,9,0,0.0,0.0
1010,578,24-09-2019 06:54:00,1,3541.0,3141.0,0.887,17.431,10,0,0,0,10,0,10,0,0.0,0.0
1010,579,24-09-2019 06:56:00,1,3327.0,2978.0,0.895,16.406,5,0,0,0,5,0,5,0,0.0,0.0
1010,580,24-09-2019 06:58:00,1,3239.0,2843.0,0.878,15.907,11,0,0,0,11,0,11,0,0.0,0.0
1010,581,24-09-2019 07:00:00,1,3028.0,2720.0,0.898,14.943,67,23,9,14,44,18,26,0,0.01,0.0
1010,582,24-09-2019 07:02:00,1,3137.0,2823.0,0.9,15.486,16,2,0,2,14,0,14,0,0.0,0.0
1010,583,24-09-2019 07:04:00,1,3000.0,2785.0,0.929,14.903,1,0,0,0,1,0,1,0,0.0,0.0
1010,584,24-09-2019 07:06:00,1,3037.0,2702.0,0.89,14.956,0,0,0,0,0,0,0,0,0.0,0.0
1010,585,24-09-2019 07:08:00,1,3057.0,2649.0,0.866,14.978,0,0,0,0,0,0,0,0,0.0,0.0
1010,586,24-09-2019 07:10:00,1,3043.0,2645.0,0.869,14.916,29,11,7,4,18,6,12,0,0.0,0.0
1010,587,24-09-2019 07:12:00,1,3044.5,2649.5,0.87,14.928,20,0,0,0,20,0,20,0,0.0,0.0
1010,588,24-09-2019 07:14:00,1,3046.0,2654.0,0.871,14.94,37,0,0,0,37,0,37,0,0.0,0.0
1010,589,24-09-2019 07:16:00,1,3059.0,2612.0,0.854,14.944,18,0,0,0,18,0,18,0,0.0,0.0
1010,590,24-09-2019 07:18:00,1,2933.0,2559.0,0.873,14.391,34,8,0,8,26,4,22,0,0.0,0.0
1010,591,24-09-2019 07:20:00,1,2828.0,2521.0,0.891,13.932,17,0,0,0,17,0,17,0,0.0,0.0
1010,592,24-09-2019 07:22:00,1,2821.0,2522.0,0.894,13.907,12,0,0,0,12,2,10,0,0.0,0.0
1010,593,24-09-2019 07:24:00,1,2840.0,2533.0,0.892,13.994,17,0,0,0,17,0,17,0,0.0,0.0
1010,594,24-09-2019 07:26:00,1,2844.0,2470.0,0.868,13.941,0,0,0,0,0,0,0,0,0.0,0.0
1010,595,24-09-2019 07:28:00,1,2856.0,2449.0,0.858,13.964,11,1,1,0,10,8,2,0,0.0,0.0
1010,596,24-09-2019 07:30:00,1,2835.0,2452.0,0.865,13.884,14,6,3,3,8,5,3,0,0.0,0.0
1010,597,24-09-2019 07:32:00,1,2860.0,2412.0,0.843,13.94,24,4,0,4,20,1,19,0,0.0,0.0
1010,598,24-09-2019 07:34:00,1,2869.0,2386.0,0.831,13.946,19,2,0,2,17,0,17,0,0.0,0.0
1010,599,24-09-2019 07:36:00,1,2729.0,2369.0,0.868,13.377,22,1,0,1,21,0,21,0,0.0,0.0
1010,600,24-09-2019 07:38:00,1,2869.0,2398.0,0.836,13.958,29,3,0,3,26,4,22,0,0.0,0.0
1010,601,24-09-2019 07:40:00,1,2836.0,2483.0,0.875,13.924,16,0,0,0,16,0,16,0,0.0,0.0
1010,602,24-09-2019 07:42:00,1,2836.0,2529.0,0.892,13.974,65,20,11,9,45,21,24,0,0.0,0.0
1010,603,24-09-2019 07:44:00,1,3054.0,2601.0,0.851,14.914,258,137,108,29,121,85,36,28,0.0,0.0
1010,604,24-09-2019 07:46:00,1,3092.5,2698.5,0.872,15.172,120,59,26,33,61,30,31,0,0.0,0.0
1010,605,24-09-2019 07:48:00,1,3131.0,2796.0,0.893,15.43,80,15,2,13,65,30,35,0,0.0,0.0
1010,606,24-09-2019 07:50:00,1,3363.0,2899.0,0.862,16.459,98,35,3,32,63,31,32,0,0.0,0.0
1010,607,24-09-2019 07:52:00,1,3362.0,2879.0,0.856,16.435,45,15,2,13,30,7,23,0,0.0,0.0
1010,608,24-09-2019 07:54:00,1,3138.0,2789.0,0.889,15.45,53,16,6,10,37,20,17,0,0.0,0.0
1010,609,24-09-2019 07:56:00,1,3021.0,2713.0,0.898,14.907,2,2,1,1,0,0,0,0,0.0,0.0
1010,610,24-09-2019 07:58:00,1,2818.0,2537.0,0.9,13.913,0,0,0,0,0,0,0,0,0.0,0.0
1010,611,24-09-2019 08:00:00,1,2855.0,2428.0,0.85,13.937,0,0,0,0,0,0,0,0,0.0,0.0
1010,612,24-09-2019 08:02:00,1,2869.0,2358.0,0.822,13.913,0,0,0,0,0,0,0,0,0.0,0.0
1010,613,24-09-2019 08:04:00,1,2874.0,2340.0,0.814,13.915,0,0,0,0,0,0,0,0,0.0,0.0
1010,614,24-09-2019 08:06:00,1,2752.0,2330.0,0.847,13.422,3,1,1,0,2,2,0,0,0.0,0.0
1010,615,24-09-2019 08:08:00,1,2759.0,2310.0,0.837,13.43,1,0,0,0,1,0,1,0,0.0,0.0
1010,616,24-09-2019 08:10:00,1,2880.0,2316.0,0.804,13.911,0,0,0,0,0,0,0,0,0.0,0.0
1010,617,24-09-2019 08:12:00,1,2779.0,2280.0,0.82,13.474,16,0,0,0,16,0,16,0,0.0,0.0
1010,618,24-09-2019 08:14:00,1,2657.0,2213.0,0.833,12.92,51,17,9,8,34,10,24,0,0.0,0.0
1010,619,24-09-2019 08:16:00,1,2769.0,2258.0,0.816,13.41,12,3,0,3,9,0,9,0,0.01,0.0
1010,620,24-09-2019 08:18:00,1,2875.0,2368.0,0.824,13.948,40,1,0,1,39,0,39,0,0.0,0.0
1010,621,24-09-2019 08:20:00,1,2886.5,2325.0,0.806,13.9465,48,10,5,5,38,4,34,0,0.0,0.0
1010,622,24-09-2019 08:22:00,1,2898.0,2282.0,0.788,13.945,38,4,1,3,34,1,33,0,0.0,0.0
1010,623,24-09-2019 08:24:00,1,2880.0,2295.0,0.797,13.89,37,6,2,4,31,4,27,0,0.0,0.0
1010,624,24-09-2019 08:26:00,1,2888.0,2335.0,0.809,13.966,18,1,0,1,17,4,13,0,0.0,0.0
1010,625,24-09-2019 08:28:00,1,2875.0,2372.0,0.825,13.952,17,7,0,7,10,0,10,0,0.0,0.0
1010,626,24-09-2019 08:30:00,1,2880.0,2368.0,0.822,13.968,15,2,0,2,13,2,11,0,0.0,0.0
1010,627,24-09-2019 08:32:00,1,2872.0,2395.0,0.834,13.967,25,5,0,5,20,4,16,0,0.0,0.0
1010,628,24-09-2019 08:34:00,1,2851.0,2418.0,0.848,13.912,17,3,0,3,14,0,14,0,0.0,0.0
1010,629,24-09-2019 08:36:00,1,2869.0,2392.0,0.834,13.953,44,2,0,2,42,12,30,0,0.0,0.0
1010,630,24-09-2019 08:38:00,1,2875.0,2338.0,0.813,13.917,138,73,44,29,65,37,28,11,0.0,0.0
1010,631,24-09-2019 08:40:00,1,3160.0,2736.0,0.866,15.48,304,206,171,35,98,70,28,50,0.0,0.0
1010,632,24-09-2019 08:42:00,1,3038.0,2642.0,0.87,14.895,107,80,50,30,27,16,11,90,0.0,0.0
1010,633,24-09-2019 08:44:00,1,3277.0,2741.0,0.836,15.946,65,24,11,13,41,7,34,0,0.0,0.0
1010,634,24-09-2019 08:46:00,1,3372.0,2795.0,0.829,16.379,225,111,89,22,114,78,36,3,0.0,0.0
1010,635,24-09-2019 08:48:00,1,3394.0,2780.0,0.819,16.452,861,493,390,103,368,275,93,2,0.0,0.0
1010,636,24-09-2019 08:50:00,1,3391.0,2786.0,0.821,16.446,926,536,444,92,390,311,79,3,0.0,0.0
1010,637,24-09-2019 08:52:00,1,3453.0,2934.0,0.85,16.855,397,154,124,30,243,181,62,2,0.0,0.0
1010,638,24-09-2019 08:54:00,1,3509.0,2983.0,0.85,17.1285,305,175,144,31,130,97,33,54,0.0,0.0
1010,639,24-09-2019 08:56:00,1,3565.0,3032.0,0.85,17.402,162,63,51,12,99,58,41,0,0.0,0.0
1010,640,24-09-2019 08:58:00,1,3538.0,3105.0,0.878,17.376,64,20,8,12,44,16,28,0,0.0,0.0
1010,641,24-09-2019 09:00:00,1,3579.0,3013.0,0.842,17.436,434,209,160,49,225,169,56,2,0.0,0.0
1010,642,24-09-2019 09:02:00,1,3587.0,2981.0,0.831,17.434,391,224,173,51,167,127,40,0,0.0,0.0
1010,643,24-09-2019 09:04:00,1,3580.0,2977.0,0.832,17.4,254,142,110,32,112,79,33,34,0.0,0.07
1010,644,24-09-2019 09:06:00,1,3359.0,2893.0,0.861,16.436,330,206,167,39,124,85,39,30,0.0,0.0
1010,645,24-09-2019 09:08:00,1,3343.0,2878.0,0.861,16.357,719,404,326,78,315,231,84,14,0.0,0.0
1010,646,24-09-2019 09:10:00,1,3370.0,2893.0,0.858,16.481,401,224,170,54,177,130,47,1,0.0,0.0
1010,647,24-09-2019 09:12:00,1,3475.0,2935.0,0.845,16.943,724,374,293,81,350,272,78,0,0.0,0.0
1010,648,24-09-2019 09:14:00,1,3587.0,2954.0,0.823,17.405,279,144,105,39,135,106,29,38,0.0,0.0
1010,649,24-09-2019 09:16:00,1,3479.0,2915.0,0.838,16.935,304,125,87,38,179,133,46,34,0.0,0.0
1010,650,24-09-2019 09:18:00,1,3354.0,2912.0,0.868,16.44,29,7,4,3,22,3,19,2,0.0,0.0
1010,651,24-09-2019 09:20:00,1,3354.0,2897.0,0.864,16.421,65,11,5,6,54,17,37,3,0.0,0.0
1010,652,24-09-2019 09:22:00,1,3580.0,2962.0,0.827,17.386,49,20,6,14,29,10,19,0,0.0,0.0
1010,653,24-09-2019 09:24:00,1,3356.0,2894.0,0.862,16.426,14,0,0,0,14,0,14,0,0.0,0.0
1010,654,24-09-2019 09:26:00,1,3254.0,2689.0,0.826,15.798,39,3,0,3,36,9,27,0,0.0,0.0
1010,655,24-09-2019 09:28:00,1,3050.5,2563.5,0.841,14.8585,29,1,1,0,28,2,26,0,0.0,0.0
1010,656,24-09-2019 09:30:00,1,2847.0,2438.0,0.856,13.919,37,10,7,3,27,4,23,0,0.0,0.0
1010,657,24-09-2019 09:32:00,1,2877.0,2351.0,0.817,13.939,33,2,0,2,31,4,27,0,0.0,0.0
1010,658,24-09-2019 09:34:00,1,2886.0,2323.0,0.805,13.944,15,0,0,0,15,1,14,0,0.0,0.0
1010,659,24-09-2019 09:36:00,1,2880.0,2298.0,0.798,13.89,41,5,0,5,36,8,28,0,0.0,0.0
1010,660,24-09-2019 09:38:00,1,2887.0,2271.0,0.787,13.89,37,3,0,3,34,11,23,0,0.0,0.0
1010,661,24-09-2019 09:40:00,1,2919.0,2249.0,0.771,13.991,54,0,0,0,54,15,39,0,0.0,0.0
1010,662,24-09-2019 09:42:00,1,2787.0,2145.0,0.77,13.357,47,5,0,5,42,19,23,0,0.0,0.0
1010,663,24-09-2019 09:44:00,1,2687.0,2126.0,0.791,12.94,67,10,0,10,57,33,24,0,0.0,0.0
1010,664,24-09-2019 09:46:00,1,2800.0,2146.0,0.767,13.406,44,8,7,1,36,8,28,0,0.0,0.0
1010,665,24-09-2019 09:48:00,1,2683.0,2126.0,0.792,12.927,39,4,2,2,35,0,35,0,0.0,0.0
1010,666,24-09-2019 09:50:00,1,2800.0,2125.0,0.759,13.386,9,0,0,0,9,2,7,0,0.0,0.0
1010,667,24-09-2019 09:52:00,1,2809.0,2139.0,0.761,13.435,46,19,7,12,27,13,14,0,0.0,0.0
1010,668,24-09-2019 09:54:00,1,2912.0,2209.0,0.759,13.918,38,18,0,18,20,0,20,0,0.0,0.0
1010,669,24-09-2019 09:56:00,1,2919.0,2187.0,0.749,13.924,43,5,2,3,38,11,27,0,0.0,0.0
1010,670,24-09-2019 09:58:00,1,2921.0,2163.0,0.74,13.903,40,8,4,4,32,11,21,0,0.0,0.0
1010,671,24-09-2019 10:00:00,1,2909.0,2239.0,0.77,13.943,17,1,0,1,16,0,16,0,0.0,0.0
1010,672,24-09-2019 10:02:00,1,2910.0,2224.0,0.7645,13.9285,9,1,0,1,8,1,7,0,0.0,0.0
1010,673,24-09-2019 10:04:00,1,2911.0,2209.0,0.759,13.914,43,15,9,6,28,7,21,0,0.0,0.0
1010,674,24-09-2019 10:06:00,1,2901.0,2271.0,0.783,13.946,72,24,11,13,48,22,26,0,0.0,0.0
1010,675,24-09-2019 10:08:00,1,3110.0,2397.0,0.771,14.908,118,48,30,18,70,32,38,0,0.0,0.0
1010,676,24-09-2019 10:10:00,1,3083.0,2467.0,0.8,14.878,298,153,104,49,145,98,47,10,0.0,0.0
1010,677,24-09-2019 10:12:00,1,3089.0,2489.0,0.806,14.926,360,164,115,49,196,130,66,10,0.0,0.0
1010,678,24-09-2019 10:14:00,1,3084.0,2545.0,0.825,14.969,503,269,204,65,234,176,58,5,0.0,0.0
1010,679,24-09-2019 10:16:00,1,3065.0,2535.0,0.827,14.884,310,159,111,48,151,104,47,8,0.0,0.0
1010,680,24-09-2019 10:18:00,1,3058.0,2570.0,0.84,14.895,687,360,284,76,327,256,71,0,0.01,0.0
1010,681,24-09-2019 10:20:00,1,3186.0,2576.0,0.809,15.405,544,290,218,72,254,203,51,0,0.0,0.0
1010,682,24-09-2019 10:22:00,1,3199.0,2570.0,0.804,15.449,441,240,192,48,201,157,44,38,0.0,0.0
1010,683,24-09-2019 10:24:00,1,3179.0,2575.0,0.81,15.374,344,125,95,30,219,167,52,10,0.0,0.0
1010,684,24-09-2019 10:26:00,1,3301.0,2604.0,0.789,15.888,125,73,33,40,52,19,33,0,0.0,0.0
1010,685,24-09-2019 10:28:00,1,3327.0,2590.0,0.778,15.977,71,38,2,36,33,0,33,0,0.0,0.0
1010,686,24-09-2019 10:30:00,1,3079.0,2556.0,0.83,14.963,24,12,0,12,12,0,12,0,0.0,0.0
1010,687,24-09-2019 10:32:00,1,3066.0,2540.0,0.829,14.891,4,1,1,0,3,0,3,0,0.0,0.0
1010,688,24-09-2019 10:34:00,1,3107.0,2458.0,0.791,14.962,5,0,0,0,5,1,4,0,0.0,0.0
1010,689,24-09-2019 10:36:00,1,3008.0,2339.0,0.777,14.441,0,0,0,0,0,0,0,0,0.0,0.0
1010,690,24-09-2019 10:38:00,1,2909.0,2220.0,0.763,13.92,0,0,0,0,0,0,0,0,0.0,0.0
1010,691,24-09-2019 10:40:00,1,2817.0,2115.0,0.751,13.442,0,0,0,0,0,0,0,0,0.0,0.0
1010,692,24-09-2019 10:42:00,1,2817.0,2116.0,0.751,13.443,0,0,0,0,0,0,0,0,0.0,0.0
1010,693,24-09-2019 10:44:00,1,2814.0,2083.0,0.74,13.394,0,0,0,0,0,0,0,0,0.0,0.0
1010,694,24-09-2019 10:46:00,1,2946.0,2088.0,0.709,13.922,8,3,2,1,5,0,5,0,0.0,0.0
1010,695,24-09-2019 10:48:00,1,2951.0,2092.0,0.709,13.943,224,127,86,41,97,52,45,11,0.0,0.0
1010,696,24-09-2019 10:50:00,1,3129.0,2324.0,0.743,14.902,200,114,84,30,86,64,22,67,0.0,0.0
1010,697,24-09-2019 10:52:00,1,3211.0,2492.0,0.776,15.412,24,24,9,15,0,0,0,0,0.0,0.0
1010,698,24-09-2019 10:54:00,1,3087.0,2471.0,0.8,14.898,0,0,0,0,0,0,0,0,0.0,0.0
1010,699,24-09-2019 10:56:00,1,3103.0,2402.0,0.774,14.887,1,1,0,1,0,0,0,0,0.0,0.0
1010,700,24-09-2019 10:58:00,1,3015.0,2310.0,0.766,14.438,7,0,0,0,7,1,6,0,0.0,0.0
1010,701,24-09-2019 11:00:00,1,2904.0,2198.0,0.757,13.877,24,3,1,2,21,6,15,0,0.0,0.0
1010,702,24-09-2019 11:02:00,1,2948.0,2116.0,0.718,13.959,17,12,4,8,5,2,3,0,0.0,0.0
1010,703,24-09-2019 11:04:00,1,2938.0,2101.0,0.715,13.903,0,0,0,0,0,0,0,0,0.0,0.0
1010,704,24-09-2019 11:06:00,1,2911.0,2232.0,0.767,13.942,0,0,0,0,0,0,0,0,0.0,0.0
1010,705,24-09-2019 11:08:00,1,2912.0,2159.0,0.741,13.865,0,0,0,0,0,0,0,0,0.0,0.0
1010,706,24-09-2019 11:10:00,1,2926.5,2130.0,0.7275,13.8905,0,0,0,0,0,0,0,0,0.0,0.0
1010,707,24-09-2019 11:12:00,1,2941.0,2101.0,0.714,13.916,5,5,3,2,0,0,0,0,0.0,0.0
1010,708,24-09-2019 11:14:00,1,2819.0,2070.0,0.734,13.399,0,0,0,0,0,0,0,0,0.0,0.0
1010,709,24-09-2019 11:16:00,1,2932.0,2091.0,0.713,13.869,0,0,0,0,0,0,0,0,0.0,0.0
1010,710,24-09-2019 11:18:00,1,2947.0,2082.0,0.706,13.918,22,14,7,7,8,4,4,0,0.0,0.0
1010,711,24-09-2019 11:20:00,1,2950.0,2060.0,0.698,13.903,8,8,0,8,0,0,0,0,0.0,0.0
1010,712,24-09-2019 11:22:00,1,2720.0,2003.0,0.737,12.934,17,17,0,17,0,0,0,0,0.0,0.0
1010,713,24-09-2019 11:24:00,1,2722.0,1981.0,0.728,12.919,17,16,0,16,1,0,1,0,0.0,0.0
1010,714,24-09-2019 11:26:00,1,2613.0,1942.0,0.743,12.445,6,6,0,6,0,0,0,0,0.0,0.0
1010,715,24-09-2019 11:28:00,1,2620.0,1879.0,0.717,12.405,1,1,0,1,0,0,0,0,0.0,0.0
1010,716,24-09-2019 11:30:00,1,2628.0,1868.0,0.711,12.423,10,7,2,5,3,1,2,0,0.0,0.0
1010,717,24-09-2019 11:32:00,1,2616.0,1897.0,0.725,12.407,3,3,2,1,0,0,0,0,0.0,0.0
1010,718,24-09-2019 11:34:00,1,2627.0,1916.0,0.729,12.472,27,19,10,9,8,5,3,0,0.0,0.0
1010,719,24-09-2019 11:36:00,1,2601.0,1943.0,0.747,12.401,1,1,0,1,0,0,0,0,0.0,0.0
1010,720,24-09-2019 11:38:00,1,2709.0,2028.0,0.749,12.918,1,1,0,1,0,0,0,0,0.0,0.0
1010,721,24-09-2019 11:40:00,1,2705.0,2033.0,0.752,12.907,3,3,1,2,0,0,0,0,0.0,0.0
1010,722,24-09-2019 11:42:00,1,2593.0,1992.0,0.768,12.421,8,8,4,4,0,0,0,0,0.0,0.0
1010,723,24-09-2019 11:44:00,1,2597.5,1961.5,0.755,12.406,15,12,0,12,3,1,2,0,0.0,0.0
1010,724,24-09-2019 11:46:00,1,2602.0,1931.0,0.742,12.391,0,0,0,0,0,0,0,0,0.0,0.0
1010,725,24-09-2019 11:48:00,1,2597.0,1990.0,0.766,12.436,0,0,0,0,0,0,0,0,0.0,0.0
1010,726,24-09-2019 11:50:00,1,2920.0,2207.0,0.756,13.95,0,0,0,0,0,0,0,0,0.0,0.0
1010,727,24-09-2019 11:52:00,1,2921.0,2168.0,0.742,13.908,0,0,0,0,0,0,0,0,0.0,0.0
1010,728,24-09-2019 11:54:00,1,2940.0,2141.0,0.728,13.955,20,9,5,4,11,7,4,0,0.0,0.0
1010,729,24-09-2019 11:56:00,1,2925.0,2137.0,0.731,13.893,13,5,2,3,8,6,2,0,0.0,0.0
1010,730,24-09-2019 11:58:00,1,2929.0,2121.0,0.724,13.887,2,2,0,2,0,0,0,0,0.0,0.0
1010,731,24-09-2019 12:00:00,1,2932.0,2117.0,0.722,13.894,35,0,0,0,35,1,34,0,0.0,0.0
1010,732,24-09-2019 12:02:00,1,2697.0,2049.0,0.76,12.897,22,4,0,4,18,2,16,0,0.0,0.0
1010,733,24-09-2019 12:04:00,1,2598.0,1959.0,0.754,12.404,1,1,0,1,0,0,0,0,0.0,0.0
1010,734,24-09-2019 12:06:00,1,2612.0,1911.0,0.732,12.407,0,0,0,0,0,0,0,0,0.0,0.0
1010,735,24-09-2019 12:08:00,1,2627.0,1857.0,0.707,12.406,17,7,2,5,10,6,4,0,0.0,0.0
1010,736,24-09-2019 12:10:00,1,2636.0,1872.0,0.71,12.459,3,2,0,2,1,0,1,0,0.0,0.0
1010,737,24-09-2019 12:12:00,1,2592.0,1982.0,0.765,12.406,0,0,0,0,0,0,0,0,0.0,0.0
1010,738,24-09-2019 12:14:00,1,2834.0,2049.0,0.723,13.434,4,4,0,4,0,0,0,0,0.0,0.0
1010,739,24-09-2019 12:16:00,1,2711.0,2041.0,0.753,12.942,1,1,0,1,0,0,0,0,0.0,0.0
1010,740,24-09-2019 12:18:00,1,2661.0,1988.5,0.7475,12.687,0,0,0,0,0,0,0,0,0.0,0.0
1010,741,24-09-2019 12:20:00,1,2611.0,1936.0,0.742,12.432,1,1,0,1,0,0,0,0,0.0,0.0
1010,742,24-09-2019 12:22:00,1,2628.0,1863.0,0.709,12.419,2,2,0,2,0,0,0,0,0.0,0.0
1010,743,24-09-2019 12:24:00,1,2627.0,1907.0,0.726,12.463,3,3,0,3,0,0,0,0,0.0,0.0
1010,744,24-09-2019 12:26:00,1,2614.0,1899.0,0.727,12.402,3,2,0,2,1,0,1,0,0.0,0.0
1010,745,24-09-2019 12:28:00,1,2623.0,1895.0,0.722,12.433,4,3,0,3,1,0,1,0,0.0,0.0
1010,746,24-09-2019 12:30:00,1,2620.0,1876.0,0.716,12.4,0,0,0,0,0,0,0,0,0.0,0.0
1010,747,24-09-2019 12:32:00,1,2632.0,1845.0,0.701,12.414,0,0,0,0,0,0,0,0,0.0,0.0
1010,748,24-09-2019 12:34:00,1,2394.0,1794.0,0.749,11.42,97,32,5,27,65,41,24,2,0.0,0.0
1010,749,24-09-2019 12:36:00,1,2594.0,2025.0,0.78,12.463,155,65,38,27,90,58,32,27,0.0,0.0
1010,750,24-09-2019 12:38:00,1,3116.0,2371.0,0.761,14.903,105,32,7,25,73,37,36,40,0.0,0.0
1010,751,24-09-2019 12:40:00,1,3439.0,2598.0,0.755,16.427,140,74,47,27,66,36,30,87,0.0,0.0
1010,752,24-09-2019 12:42:00,1,3710.0,2902.0,0.782,17.829,230,135,107,28,95,69,26,105,0.03,0.0
1010,753,24-09-2019 12:44:00,1,3532.0,2724.0,0.771,16.932,264,132,98,34,132,82,50,81,0.01,0.0
1010,754,24-09-2019 12:46:00,1,3599.0,2875.0,0.799,17.364,302,160,117,43,142,99,43,33,0.0,0.01
1010,755,24-09-2019 12:48:00,1,3115.0,2438.0,0.783,14.974,83,22,6,16,61,31,30,1,0.0,0.0
1010,756,24-09-2019 12:50:00,1,2581.0,2022.0,0.783,12.407,85,19,0,19,66,27,39,0,0.0,0.0
1010,757,24-09-2019 12:52:00,1,2951.5,2290.0,0.7765,14.164,53,13,6,7,40,13,27,0,0.0,0.0
1010,758,24-09-2019 12:54:00,1,3322.0,2558.0,0.77,15.921,76,22,3,19,54,24,30,0,0.01,0.0
1010,759,24-09-2019 12:56:00,1,3492.0,2797.0,0.801,16.854,59,34,0,34,25,2,23,0,0.0,0.0
1010,760,24-09-2019 12:58:00,1,3585.0,2951.0,0.823,17.394,63,22,0,22,41,4,37,0,0.0,0.0
1010,761,24-09-2019 13:00:00,1,3488.0,2839.0,0.814,16.886,5,1,0,1,4,2,2,0,0.0,0.0
1010,762,24-09-2019 13:02:00,1,3371.0,2822.0,0.837,16.408,0,0,0,0,0,0,0,0,0.0,0.0
1010,763,24-09-2019 13:04:00,1,3395.0,2762.0,0.814,16.436,0,0,0,0,0,0,0,0,0.0,0.0
1010,764,24-09-2019 13:06:00,1,3289.0,2699.0,0.821,15.947,15,5,1,4,10,6,4,0,0.0,0.0
1010,765,24-09-2019 13:08:00,1,3062.0,2573.0,0.84,14.911,29,16,4,12,13,5,8,0,0.0,0.0
1010,766,24-09-2019 13:10:00,1,2970.0,2458.0,0.827,14.424,2,1,0,1,1,0,1,0,0.0,0.0
1010,767,24-09-2019 13:12:00,1,2848.0,2418.0,0.849,13.9,3,1,0,1,2,0,2,0,0.0,0.0
1010,768,24-09-2019 13:14:00,1,2856.0,2421.0,0.848,13.934,4,4,0,4,0,0,0,0,0.0,0.0
1010,769,24-09-2019 13:16:00,1,2856.0,2439.0,0.854,13.954,51,27,6,21,24,8,16,0,0.0,0.0
1010,770,24-09-2019 13:18:00,1,2845.0,2466.0,0.867,13.939,17,0,0,0,17,0,17,0,0.0,0.0
1010,771,24-09-2019 13:20:00,1,3061.0,2555.0,0.835,14.889,34,10,1,9,24,2,22,0,0.0,0.0
1010,772,24-09-2019 13:22:00,1,3060.0,2552.0,0.834,14.882,28,5,0,5,23,4,19,0,0.01,0.0
1010,773,24-09-2019 13:24:00,1,3066.0,2518.0,0.821,14.869,61,10,3,7,51,16,35,0,0.0,0.0
1010,774,24-09-2019 13:26:00,1,3069.5,2503.5,0.8155,14.866,13,0,0,0,13,0,13,0,0.0,0.0
1010,775,24-09-2019 13:28:00,1,3073.0,2489.0,0.81,14.863,34,0,0,0,34,12,22,0,0.0,0.0
1010,776,24-09-2019 13:30:00,1,2990.0,2425.0,0.811,14.466,40,0,0,0,40,23,17,0,0.0,0.0
1010,777,24-09-2019 13:32:00,1,2871.0,2382.0,0.83,13.947,42,0,0,0,42,9,33,0,0.0,0.01
1010,778,24-09-2019 13:34:00,1,3093.0,2453.0,0.793,14.902,23,0,0,0,23,11,12,0,0.0,0.0
1010,779,24-09-2019 13:36:00,1,3076.0,2527.0,0.822,14.917,17,0,0,0,17,4,13,0,0.0,0.0
1010,780,24-09-2019 13:38:00,1,3094.0,2507.0,0.811,14.965,131,0,0,0,131,73,58,0,0.0,0.0
1010,781,24-09-2019 13:40:00,1,3084.0,2464.0,0.799,14.879,143,0,0,0,143,91,52,0,0.0,0.0
1010,782,24-09-2019 13:42:00,1,3105.0,2414.0,0.778,14.906,116,0,0,0,116,75,41,0,0.0,0.0
1010,783,24-09-2019 13:44:00,1,2997.0,2379.0,0.794,14.444,170,34,15,19,136,109,27,0,0.0,0.0
1010,784,24-09-2019 13:46:00,1,3095.0,2446.0,0.791,14.902,114,42,12,30,72,40,32,0,0.0,0.0
1010,785,24-09-2019 13:48:00,1,3198.0,2600.0,0.813,15.48,132,80,58,22,52,30,22,46,0.0,0.0
1010,786,24-09-2019 13:50:00,1,3187.0,2611.0,0.819,15.449,426,226,176,50,200,139,61,51,0.02,0.0
1010,787,24-09-2019 13:52:00,1,3404.0,2675.0,0.786,16.374,489,256,189,67,233,185,48,10,0.01,0.05
1010,788,24-09-2019 13:54:00,1,3618.0,2866.0,0.792,17.428,117,68,45,23,49,29,20,12,0.01,0.0
1010,789,24-09-2019 13:56:00,1,3381.0,2776.0,0.821,16.395,145,84,65,19,61,36,25,56,0.0,0.0
1010,790,24-09-2019 13:58:00,1,3408.0,2726.0,0.8,16.446,513,276,213,63,237,172,65,2,0.0,0.0
1010,791,24-09-2019 14:00:00,1,3405.5,2721.0,0.799,16.4305,104,51,33,18,53,31,22,0,0.01,0.0
1010,792,24-09-2019 14:02:00,1,3403.0,2716.0,0.798,16.415,352,207,153,54,145,98,47,10,0.05,0.0
1010,793,24-09-2019 14:04:00,1,3180.0,2600.0,0.818,15.406,44,10,4,6,34,12,22,0,0.0,0.0
1010,794,24-09-2019 14:06:00,1,3421.0,2670.0,0.78,16.437,84,4,0,4,80,44,36,0,0.0,0.0
1010,795,24-09-2019 14:08:00,1,3395.0,2746.0,0.809,16.419,62,43,18,25,19,4,15,0,0.0,0.0
1010,796,24-09-2019 14:10:00,1,3383.0,2761.0,0.816,16.386,134,72,42,30,62,32,30,0,0.0,0.0
1010,797,24-09-2019 14:12:00,1,3401.0,2711.0,0.797,16.404,33,14,1,13,19,0,19,0,0.0,0.0
1010,798,24-09-2019 14:14:00,1,3417.0,2703.0,0.791,16.457,44,2,1,1,42,19,23,0,0.0,0.0
1010,799,24-09-2019 14:16:00,1,3301.0,2600.0,0.788,15.887,37,7,3,4,30,3,27,0,0.0,0.0
1010,800,24-09-2019 14:18:00,1,3088.0,2500.0,0.81,14.933,14,0,0,0,14,2,12,0,0.0,0.0
1010,801,24-09-2019 14:20:00,1,3104.0,2437.0,0.785,14.929,40,6,2,4,34,14,20,0,0.0,0.0
1010,802,24-09-2019 14:22:00,1,3134.0,2333.0,0.745,14.932,13,0,0,0,13,3,10,0,0.01,0.0
1010,803,24-09-2019 14:24:00,1,3008.0,2287.0,0.76,14.383,65,24,16,8,41,14,27,0,0.0,0.0
1010,804,24-09-2019 14:26:00,1,3130.0,2335.0,0.746,14.917,40,10,4,6,30,10,20,0,0.0,0.0
1010,805,24-09-2019 14:28:00,1,3116.0,2370.0,0.761,14.902,35,3,3,0,32,0,32,0,0.0,0.0
1010,806,24-09-2019 14:30:00,1,3120.0,2364.0,0.758,14.911,37,14,6,8,23,0,23,0,0.0,0.0
1010,807,24-09-2019 14:32:00,1,3111.0,2383.0,0.766,14.898,16,16,0,16,0,0,0,0,0.0,0.0
1010,808,24-09-2019 14:34:00,1,3118.0,2343.5,0.7515,14.8815,36,17,14,3,19,10,9,0,0.0,0.0
1010,809,24-09-2019 14:36:00,1,3125.0,2304.0,0.737,14.865,29,0,0,0,29,9,20,0,0.0,0.0
1010,810,24-09-2019 14:38:00,1,3141.0,2295.0,0.731,14.918,27,0,0,0,27,9,18,0,0.0,0.0
1010,811,24-09-2019 14:40:00,1,3133.0,2326.0,0.743,14.92,32,0,0,0,32,3,29,0,0.0,0.0
1010,812,24-09-2019 14:42:00,1,3141.0,2269.0,0.722,14.888,37,2,0,2,35,12,23,0,0.0,0.0
1010,813,24-09-2019 14:44:00,1,3021.0,2254.0,0.746,14.4,19,0,0,0,19,0,19,0,0.0,0.0
1010,814,24-09-2019 14:46:00,1,2910.0,2210.0,0.759,13.912,104,37,26,11,67,38,29,0,0.0,0.0
1010,815,24-09-2019 14:48:00,1,2900.0,2199.0,0.759,13.86,0,0,0,0,0,0,0,0,0.0,0.0
1010,816,24-09-2019 14:50:00,1,2911.0,2197.0,0.755,13.903,11,3,2,1,8,0,8,0,0.0,0.0
1010,817,24-09-2019 14:52:00,1,2921.0,2170.0,0.743,13.914,16,1,1,0,15,2,13,0,0.01,0.0
1010,818,24-09-2019 14:54:00,1,2917.0,2187.0,0.75,13.916,17,7,1,6,10,3,7,0,0.0,0.0
1010,819,24-09-2019 14:56:00,1,2925.0,2147.0,0.734,13.901,4,1,0,1,3,1,2,0,0.0,0.0
1010,820,24-09-2019 14:58:00,1,2950.0,2091.0,0.709,13.938,20,7,4,3,13,4,9,0,0.0,0.0
1010,821,24-09-2019 15:00:00,1,2962.0,2078.0,0.701,13.972,21,1,1,0,20,4,16,0,0.0,0.0
1010,822,24-09-2019 15:02:00,1,2937.0,2088.0,0.711,13.883,18,1,0,1,17,2,15,0,0.0,0.0
1010,823,24-09-2019 15:04:00,1,2942.0,2084.0,0.708,13.899,39,17,1,16,22,1,21,0,0.0,0.0
1010,824,24-09-2019 15:06:00,1,2943.0,2089.0,0.71,13.91,54,22,13,9,32,15,17,0,0.0,0.0
1010,825,24-09-2019 15:08:00,1,2948.0,2087.5,0.708,13.9285,2,0,0,0,2,0,2,0,0.0,0.0
1010,826,24-09-2019 15:10:00,1,2953.0,2086.0,0.706,13.947,25,0,0,0,25,8,17,0,0.0,0.0
1010,827,24-09-2019 15:12:00,1,2937.0,2094.0,0.713,13.891,16,0,0,0,16,0,16,0,0.0,0.0
1010,828,24-09-2019 15:14:00,1,2941.0,2074.0,0.705,13.886,32,6,3,3,26,6,20,0,0.0,0.0
1010,829,24-09-2019 15:16:00,1,2941.0,2087.0,0.71,13.9,43,3,1,2,40,15,25,0,0.0,0.0
1010,830,24-09-2019 15:18:00,1,2946.0,2112.0,0.717,13.948,85,18,0,18,67,35,32,0,0.0,0.0
1010,831,24-09-2019 15:20:00,1,2932.0,2118.0,0.722,13.898,47,10,4,6,37,15,22,0,0.0,0.0
1010,832,24-09-2019 15:22:00,1,2941.0,2114.0,0.719,13.927,20,0,0,0,20,2,18,0,0.01,0.0
1010,833,24-09-2019 15:24:00,1,2956.0,2078.0,0.703,13.946,112,46,37,9,66,35,31,1,0.0,0.0
1010,834,24-09-2019 15:26:00,1,2946.0,2081.0,0.706,13.911,221,103,73,30,118,66,52,54,0.0,0.0
1010,835,24-09-2019 15:28:00,1,3128.0,2348.0,0.751,14.923,127,48,19,29,79,31,48,50,0.0,0.0
1010,836,24-09-2019 15:30:00,1,3457.0,2544.0,0.736,16.437,348,182,133,49,166,116,50,88,0.0,0.0
1010,837,24-09-2019 15:32:00,1,3450.0,2563.0,0.743,16.43,257,121,86,35,136,74,62,38,0.0,0.0
1010,838,24-09-2019 15:34:00,1,3428.0,2573.0,0.751,16.357,134,60,25,35,74,26,48,67,0.0,0.0
1010,839,24-09-2019 15:36:00,1,3632.0,2791.0,0.768,17.4,505,273,210,63,232,164,68,36,0.0,0.01
1010,840,24-09-2019 15:38:00,1,3396.0,2710.0,0.798,16.38,683,378,303,75,305,237,68,0,0.0,0.0
1010,841,24-09-2019 15:40:00,1,3416.0,2700.0,0.79,16.449,454,244,194,50,210,156,54,11,0.0,0.05
1010,842,24-09-2019 15:42:00,1,3250.0,2593.5,0.798,15.677,454,227,166,61,227,160,67,1,0.0,0.0
1010,843,24-09-2019 15:44:00,1,3084.0,2487.0,0.806,14.905,596,310,241,69,286,232,54,29,0.05,0.0
1010,844,24-09-2019 15:46:00,1,3614.0,2911.0,0.805,17.464,54,36,21,15,18,10,8,93,0.1,0.0
1010,845,24-09-2019 15:48:00,1,3791.0,3104.0,0.819,18.373,243,132,96,36,111,75,36,69,0.0,0.0
1010,846,24-09-2019 15:50:00,1,3367.0,2843.0,0.844,16.416,264,124,87,37,140,83,57,80,0.0,0.0
1010,847,24-09-2019 15:52:00,1,3794.0,3117.0,0.822,18.4,151,61,25,36,90,39,51,57,0.0,0.0
1010,848,24-09-2019 15:54:00,1,3914.0,3203.0,0.818,18.966,503,243,179,64,260,185,75,44,0.0,0.01
1010,849,24-09-2019 15:56:00,1,3550.0,3082.0,0.868,17.4,323,155,119,36,168,127,41,0,0.0,0.02
1010,850,24-09-2019 15:58:00,1,3068.0,2594.0,0.845,14.959,90,21,2,19,69,30,39,0,0.0,0.0
1010,851,24-09-2019 16:00:00,1,2861.0,2415.0,0.844,13.946,83,21,7,14,62,21,41,0,0.0,0.0
1010,852,24-09-2019 16:02:00,1,2870.0,2318.0,0.808,13.875,95,43,16,27,52,21,31,0,0.0,0.0
1010,853,24-09-2019 16:04:00,1,2980.0,2437.0,0.818,14.441,92,72,37,35,20,4,16,0,0.0,0.0
1010,854,24-09-2019 16:06:00,1,3070.0,2549.0,0.83,14.916,101,42,14,28,59,32,27,0,0.0,0.0
1010,855,24-09-2019 16:08:00,1,3783.0,3159.0,0.835,18.403,81,39,18,21,42,18,24,0,0.0,0.0
1010,856,24-09-2019 16:10:00,1,3463.0,2902.0,0.838,16.856,16,0,0,0,16,2,14,0,0.0,0.0
1010,857,24-09-2019 16:12:00,1,3363.0,2865.0,0.852,16.422,15,0,0,0,15,0,15,0,0.0,0.0
1010,858,24-09-2019 16:14:00,1,3369.0,2857.0,0.848,16.436,38,6,1,5,32,11,21,0,0.0,0.0
1010,859,24-09-2019 16:16:00,1,3376.5,2827.0,0.837,16.433,16,1,0,1,15,3,12,0,0.0,0.0
1010,860,24-09-2019 16:18:00,1,3384.0,2797.0,0.826,16.43,13,0,0,0,13,0,13,0,0.0,0.0
1010,861,24-09-2019 16:20:00,1,3364.0,2839.0,0.844,16.398,13,0,0,0,13,0,13,0,0.0,0.0
1010,862,24-09-2019 16:22:00,1,3342.0,2858.0,0.855,16.334,17,2,0,2,15,2,13,0,0.0,0.0
1010,863,24-09-2019 16:24:00,1,3365.0,2818.0,0.837,16.379,21,9,3,6,12,0,12,0,0.0,0.0
1010,864,24-09-2019 16:26:00,1,3379.0,2828.0,0.837,16.447,14,3,0,3,11,2,9,0,0.0,0.0
1010,865,24-09-2019 16:28:00,1,3266.0,2763.0,0.846,15.926,53,22,3,19,31,11,20,0,0.0,0.0
1010,866,24-09-2019 16:30:00,1,3266.0,2746.0,0.841,15.906,17,0,0,0,17,5,12,0,0.0,0.0
1010,867,24-09-2019 16:32:00,1,3151.0,2687.0,0.853,15.388,32,5,2,3,27,8,19,0,0.0,0.0
1010,868,24-09-2019 16:34:00,1,3038.0,2637.0,0.868,14.891,21,0,0,0,21,3,18,0,0.0,0.0
1010,869,24-09-2019 16:36:00,1,3075.0,2565.0,0.834,14.956,52,18,11,7,34,16,18,0,0.0,0.0
1010,870,24-09-2019 16:38:00,1,3069.0,2559.0,0.834,14.925,13,0,0,0,13,0,13,0,0.0,0.0
1010,871,24-09-2019 16:40:00,1,3071.0,2531.0,0.824,14.9,20,0,0,0,20,4,16,0,0.0,0.0
1010,872,24-09-2019 16:42:00,1,3077.0,2556.0,0.831,14.955,15,0,0,0,15,2,13,0,0.0,0.0
1010,873,24-09-2019 16:44:00,1,3078.0,2575.0,0.837,14.979,26,0,0,0,26,4,22,0,0.0,0.0
1010,874,24-09-2019 16:46:00,1,3074.0,2524.0,0.821,14.904,8,0,0,0,8,0,8,0,0.0,0.0
1010,875,24-09-2019 16:48:00,1,3092.0,2505.0,0.81,14.954,40,15,13,2,25,10,15,0,0.0,0.0
1010,876,24-09-2019 16:50:00,1,3099.0,2472.0,0.7975,14.946,15,0,0,0,15,2,13,0,0.0,0.0
1010,877,24-09-2019 16:52:00,1,3106.0,2439.0,0.785,14.938,19,3,1,2,16,2,14,0,0.0,0.0
1010,878,24-09-2019 16:54:00,1,3091.0,2475.0,0.801,14.917,23,2,0,2,21,6,15,0,0.0,0.0
1010,879,24-09-2019 16:56:00,1,3108.0,2454.0,0.789,14.964,34,5,0,5,29,9,20,0,0.0,0.0
1010,880,24-09-2019 16:58:00,1,3115.0,2401.0,0.771,14.931,29,4,2,2,25,11,14,0,0.0,0.0
1010,881,24-09-2019 17:00:00,1,2995.0,2363.0,0.789,14.415,19,0,0,0,19,0,19,0,0.0,0.0
1010,882,24-09-2019 17:02:00,1,2893.0,2278.0,0.788,13.921,11,0,0,0,11,0,11,0,0.0,0.0
1010,883,24-09-2019 17:04:00,1,2922.0,2226.0,0.762,13.977,141,43,17,26,98,52,46,2,0.0,0.0
1010,884,24-09-2019 17:06:00,1,3098.0,2396.0,0.773,14.861,124,60,32,28,64,23,41,1,0.0,0.0
1010,885,24-09-2019 17:08:00,1,3080.0,2560.0,0.831,14.969,230,112,62,50,118,73,45,15,0.0,0.0
1010,886,24-09-2019 17:10:00,1,3182.0,2595.0,0.815,15.41,198,97,63,34,101,58,43,62,0.0,0.0
1010,887,24-09-2019 17:12:00,1,3278.0,2674.0,0.816,15.876,51,20,10,10,31,4,27,0,0.0,0.0
1010,888,24-09-2019 17:14:00,1,2874.0,2351.0,0.818,13.925,44,9,4,5,35,12,23,0,0.0,0.0
1010,889,24-09-2019 17:16:00,1,3117.0,2394.0,0.768,14.931,1,0,0,0,1,0,1,0,0.0,0.0
1010,890,24-09-2019 17:18:00,1,3107.0,2429.0,0.782,14.932,93,37,10,27,56,30,26,0,0.0,0.0
1010,891,24-09-2019 17:20:00,1,3074.0,2537.0,0.825,14.922,77,1,1,0,76,48,28,0,0.0,0.0
1010,892,24-09-2019 17:22:00,1,3086.0,2532.0,0.82,14.961,175,76,42,34,99,58,41,0,0.0,0.0
1010,893,24-09-2019 17:24:00,1,3197.0,2568.5,0.804,15.439,77,11,4,7,66,29,37,0,0.0,0.0
1010,894,24-09-2019 17:26:00,1,3308.0,2605.0,0.788,15.917,21,4,0,4,17,2,15,0,0.0,0.0
1010,895,24-09-2019 17:28:00,1,3094.0,2471.0,0.799,14.928,22,1,0,1,21,2,19,0,0.0,0.0
1010,896,24-09-2019 17:30:00,1,2877.0,2344.0,0.814,13.932,20,2,0,2,18,0,18,0,0.0,0.0
1010,897,24-09-2019 17:32:00,1,2904.0,2238.0,0.771,13.922,15,0,0,0,15,0,15,0,0.0,0.0
1010,898,24-09-2019 17:34:00,1,2929.0,2176.0,0.743,13.951,31,2,0,2,29,14,15,0,0.0,0.0
1010,899,24-09-2019 17:36:00,1,2926.0,2163.0,0.739,13.922,54,17,0,17,37,16,21,0,0.0,0.0
1010,900,24-09-2019 17:38:00,1,2917.0,2173.0,0.745,13.9,17,0,0,0,17,0,17,0,0.0,0.0
1010,901,24-09-2019 17:40:00,1,2919.0,2171.0,0.744,13.904,18,0,0,0,18,0,18,0,0.0,0.0
1010,902,24-09-2019 17:42:00,1,2930.0,2135.0,0.729,13.907,23,2,1,1,21,2,19,0,0.0,0.0
1010,903,24-09-2019 17:44:00,1,2934.0,2111.0,0.72,13.897,272,100,59,41,172,103,69,33,0.0,0.0
1010,904,24-09-2019 17:46:00,1,3099.0,2461.0,0.794,14.935,141,72,36,36,69,36,33,62,0.0,0.01
1010,905,24-09-2019 17:48:00,1,3643.0,2749.0,0.754,17.399,182,105,66,39,77,33,44,83,0.0,0.0
1010,906,24-09-2019 17:50:00,1,3709.0,2943.0,0.793,17.874,138,79,40,39,59,28,31,51,0.0,0.08
1010,907,24-09-2019 17:52:00,1,3708.0,2973.0,0.802,17.9,502,306,244,62,196,141,55,22,0.04,0.04
1010,908,24-09-2019 17:54:00,1,3512.0,2791.0,0.795,16.926,284,189,156,33,95,66,29,148,0.0,0.0
1010,909,24-09-2019 17:56:00,1,3925.0,3138.0,0.799,18.939,134,80,63,17,54,44,10,79,0.0,0.0
1010,910,24-09-2019 17:58:00,1,3919.0,3129.0,0.798,18.9055,135,69,47,22,66,35,31,99,0.0,0.0
1010,911,24-09-2019 18:00:00,0,3913.0,3120.0,0.797,18.872,206,99,68,31,107,77,30,65,0.0,0.02
1010,912,24-09-2019 18:02:00,0,3887.0,3190.0,0.821,18.846,394,205,156,49,189,143,46,21,0.0,0.01
1010,913,24-09-2019 18:04:00,0,3072.0,2515.0,0.819,14.888,134,48,20,28,86,44,42,0,0.0,0.0
1010,914,24-09-2019 18:06:00,0,2907.0,2203.0,0.758,13.892,49,23,7,16,26,14,12,0,0.0,0.0
1010,915,24-09-2019 18:08:00,0,3192.0,2609.0,0.817,15.466,25,7,1,6,18,8,10,0,0.0,0.0
1010,916,24-09-2019 18:10:00,0,3082.0,2499.0,0.811,14.912,16,2,0,2,14,2,12,0,0.0,0.01
1010,917,24-09-2019 18:12:00,0,3395.0,2739.0,0.807,16.41,37,12,7,5,25,10,15,0,0.0,0.01
1010,918,24-09-2019 18:14:00,0,3589.0,2938.0,0.819,17.393,28,5,0,5,23,11,12,0,0.0,0.0
1010,919,24-09-2019 18:16:00,0,3367.0,2888.0,0.858,16.466,19,0,0,0,19,7,12,0,0.0,0.0
1010,920,24-09-2019 18:18:00,0,3359.0,2833.0,0.843,16.37,13,4,1,3,9,5,4,0,0.0,0.0
1010,921,24-09-2019 18:20:00,0,3355.0,2858.0,0.852,16.383,45,28,17,11,17,9,8,0,0.0,0.0
1010,922,24-09-2019 18:22:00,0,3579.0,2988.0,0.835,17.408,100,39,22,17,61,37,24,1,0.0,0.0
1010,923,24-09-2019 18:24:00,0,3861.0,3319.0,0.86,18.886,114,39,12,27,75,41,34,0,0.0,0.0
1010,924,24-09-2019 18:26:00,0,4034.0,3625.0,0.899,19.907,86,27,4,23,59,32,27,1,0.0,0.0
1010,925,24-09-2019 18:28:00,0,4239.0,3792.0,0.895,20.898,272,158,118,40,114,86,28,47,0.0,0.0
1010,926,24-09-2019 18:30:00,0,4023.0,3688.0,0.917,19.934,85,48,35,13,37,19,18,11,0.0,0.0
1010,927,24-09-2019 18:32:00,0,4284.0,3865.0,0.903,21.1575,274,179,143,36,95,63,32,135,0.0,0.0
1010,928,24-09-2019 18:34:00,0,4545.0,4042.0,0.889,22.381,106,57,35,22,49,37,12,89,0.0,0.0
1010,929,24-09-2019 18:36:00,0,4050.0,3565.0,0.88,19.904,493,304,252,52,189,147,42,191,0.0,0.01
1010,930,24-09-2019 18:38:00,0,4336.0,3848.0,0.887,21.345,412,282,235,47,130,104,26,222,0.0,0.0
1010,931,24-09-2019 18:40:00,0,4555.0,4042.0,0.887,22.42,393,247,193,54,146,109,37,155,0.0,0.0
1010,932,24-09-2019 18:42:00,0,4540.0,4083.0,0.899,22.409,171,117,75,42,54,23,31,76,0.0,0.0
1010,933,24-09-2019 18:44:00,0,4768.0,4148.0,0.87,23.379,161,93,49,44,68,26,42,60,0.0,0.08
1010,934,24-09-2019 18:46:00,0,4526.0,4096.0,0.905,22.368,8,2,1,1,6,4,2,44,0.0,0.0
1010,935,24-09-2019 18:48:00,0,3861.0,3363.0,0.871,18.934,204,124,86,38,80,64,16,106,0.0,0.0
1010,936,24-09-2019 18:50:00,0,4353.0,3840.0,0.882,21.401,109,80,67,13,29,24,5,168,0.0,0.0
1010,937,24-09-2019 18:52:00,0,4252.0,3694.0,0.869,20.844,419,216,158,58,203,152,51,81,0.06,0.0
1010,938,24-09-2019 18:54:00,0,4459.0,3923.0,0.88,21.913,280,196,150,46,84,60,24,146,0.0,0.0
1010,939,24-09-2019 18:56:00,0,4555.0,3943.0,0.866,22.312,125,74,38,36,51,16,35,59,0.0,0.01
1010,940,24-09-2019 18:58:00,0,4881.0,4242.0,0.869,23.929,176,94,60,34,82,35,47,66,0.0,0.07
1010,941,24-09-2019 19:00:00,0,4863.0,4281.0,0.88,23.898,36,22,11,11,14,7,7,58,0.0,0.03
1010,942,24-09-2019 19:02:00,0,3561.0,3074.0,0.863,17.434,23,17,14,3,6,3,3,94,0.0,0.0
1010,943,24-09-2019 19:04:00,0,4564.0,4008.0,0.878,22.417,421,235,191,44,186,144,42,109,0.0,0.0
1010,944,24-09-2019 19:06:00,0,4552.0,4032.0,0.8855,22.398,266,145,116,29,121,92,29,160,0.12,0.0
1010,945,24-09-2019 19:08:00,0,4540.0,4056.0,0.893,22.379,177,94,60,34,83,38,45,72,0.01,0.0
1010,946,24-09-2019 19:10:00,0,4826.0,4388.0,0.909,23.873,131,60,33,27,71,32,39,47,0.0,0.07
1010,947,24-09-2019 19:12:00,0,4846.0,4391.0,0.906,23.954,115,58,38,20,57,22,35,53,0.0,0.06
1010,948,24-09-2019 19:14:00,0,4418.0,4067.0,0.921,21.908,26,21,16,5,5,3,2,51,0.0,0.01
1010,949,24-09-2019 19:16:00,0,3565.0,3034.0,0.851,17.408,184,71,46,25,113,68,45,5,0.0,0.01
1010,950,24-09-2019 19:18:00,0,3541.0,3123.0,0.882,17.41,98,67,26,41,31,16,15,0,0.0,0.0
1010,951,24-09-2019 19:20:00,0,3526.0,3161.0,0.897,17.39,73,26,4,22,47,14,33,0,0.01,0.01
1010,952,24-09-2019 19:22:00,0,3958.0,3417.0,0.863,19.376,75,22,4,18,53,32,21,0,0.0,0.0
1010,953,24-09-2019 19:24:00,0,4035.0,3629.0,0.899,19.915,165,79,44,35,86,48,38,1,0.0,0.0
1010,954,24-09-2019 19:26:00,0,4526.0,4108.0,0.908,22.379,115,34,16,18,81,45,36,0,0.0,0.0
1010,955,24-09-2019 19:28:00,0,4626.0,4191.0,0.906,22.869,103,32,3,29,71,37,34,1,0.0,0.0
1010,956,24-09-2019 19:30:00,0,4829.0,4339.0,0.898,23.832,159,82,53,29,77,48,29,32,0.11,0.0
1010,957,24-09-2019 19:32:00,0,4797.0,4567.0,0.952,23.957,8,5,3,2,3,3,0,48,0.0,0.01
1010,958,24-09-2019 19:34:00,0,4543.0,4070.0,0.896,22.405,116,67,52,15,49,34,15,53,0.0,0.01
1010,959,24-09-2019 19:36:00,0,4845.0,4388.0,0.906,23.948,339,232,177,55,107,84,23,60,0.0,0.0
1010,960,24-09-2019 19:38:00,0,4829.0,4395.0,0.91,23.893,263,151,114,37,112,79,33,114,0.0,0.0
1010,961,24-09-2019 19:40:00,0,4810.5,4446.5,0.9245,23.876,112,53,29,24,59,31,28,91,0.0,0.04
1010,962,24-09-2019 19:42:00,0,4792.0,4498.0,0.939,23.859,61,30,21,9,31,12,19,64,0.0,0.29
1010,963,24-09-2019 19:44:00,0,4806.0,4434.0,0.923,23.844,110,69,59,10,41,23,18,86,0.0,0.0
1010,964,24-09-2019 19:46:00,0,4509.0,4199.0,0.931,22.414,278,173,131,42,105,80,25,149,0.0,0.0
1010,965,24-09-2019 19:48:00,0,4843.0,4426.0,0.914,23.982,372,193,142,51,179,137,42,140,0.15,0.0
1010,966,24-09-2019 19:50:00,0,4796.0,4472.0,0.932,23.846,346,201,166,35,145,122,23,111,0.0,0.0
1010,967,24-09-2019 19:52:00,0,4515.0,4176.0,0.925,22.414,245,124,103,21,121,86,35,136,0.0,0.0
1010,968,24-09-2019 19:54:00,0,4048.0,3614.0,0.893,19.95,58,26,7,19,32,17,15,28,0.0,0.0
1010,969,24-09-2019 19:56:00,0,3522.0,3204.0,0.91,17.422,72,42,12,30,30,11,19,30,0.0,0.0
1010,970,24-09-2019 19:58:00,0,4032.0,3588.0,0.89,19.856,121,47,27,20,74,40,34,26,0.0,0.0
1010,971,24-09-2019 20:00:00,0,4812.0,4531.0,0.942,23.975,106,58,20,38,48,18,30,29,0.0,0.0
1010,972,24-09-2019 20:02:00,0,4799.0,4455.0,0.928,23.84,274,163,115,48,111,77,34,77,0.01,0.0
1010,973,24-09-2019 20:04:00,0,4717.0,4355.0,0.923,23.404,18,1,1,0,17,3,14,0,0.0,0.0
1010,974,24-09-2019 20:06:00,0,4481.0,4285.0,0.956,22.398,123,59,46,13,64,45,19,50,0.0,0.21
1010,975,24-09-2019 20:08:00,0,4302.0,4026.0,0.936,21.407,334,192,156,36,142,114,28,94,0.07,0.0
1010,976,24-09-2019 20:10:00,0,4325.0,4012.0,0.928,21.484,222,117,86,31,105,73,32,69,0.07,0.0
1010,977,24-09-2019 20:12:00,0,4590.0,4369.0,0.952,22.921,297,173,147,26,124,95,29,180,0.0,0.0
1010,978,24-09-2019 20:14:00,0,4550.5,4268.0,0.938,22.6545,283,185,153,32,98,77,21,129,0.0,0.0
1010,979,24-09-2019 20:16:00,0,4511.0,4167.0,0.924,22.388,226,126,86,40,100,83,17,56,0.11,0.0
1010,980,24-09-2019 20:18:00,0,4834.0,4391.0,0.908,23.906,259,129,101,28,130,94,36,91,0.0,0.0
1010,981,24-09-2019 20:20:00,0,4036.0,3625.0,0.898,19.914,99,44,22,22,55,29,26,2,0.0,0.0
1010,982,24-09-2019 20:22:00,0,4115.0,3760.0,0.914,20.377,153,46,22,24,107,68,39,4,0.0,0.0
1010,983,24-09-2019 20:24:00,0,4529.0,4067.0,0.898,22.346,172,55,25,30,117,75,42,1,0.0,0.0
1010,984,24-09-2019 20:26:00,0,4488.0,4257.0,0.948,22.396,128,57,32,25,71,43,28,12,0.0,0.0
1010,985,24-09-2019 20:28:00,0,4720.0,4340.0,0.92,23.401,141,82,47,35,59,31,28,76,0.0,0.0
1010,986,24-09-2019 20:30:00,0,4508.0,4214.0,0.935,22.428,155,88,59,29,67,25,42,84,0.01,0.0
1010,987,24-09-2019 20:32:00,0,4798.0,4482.0,0.934,23.867,185,124,86,38,61,30,31,75,0.0,0.0
1010,988,24-09-2019 20:34:00,0,4783.0,4570.0,0.955,23.905,316,209,156,53,107,85,22,65,0.08,0.0
1010,989,24-09-2019 20:36:00,0,4412.0,4093.0,0.928,21.916,337,181,132,49,156,113,43,107,0.0,0.0
1010,990,24-09-2019 20:38:00,0,4489.0,4253.0,0.947,22.395,140,75,36,39,65,26,39,90,0.0,0.0
1010,991,24-09-2019 20:40:00,0,4323.0,3954.0,0.915,21.41,115,63,46,17,52,35,17,39,0.0,0.0
1010,992,24-09-2019 20:42:00,0,4236.0,3836.0,0.905,20.936,197,134,87,47,63,28,35,90,0.0,0.0
1010,993,24-09-2019 20:44:00,0,4793.0,4574.0,0.954,23.947,146,90,57,33,56,27,29,55,0.0,0.0
1010,994,24-09-2019 20:46:00,0,5009.0,4644.0,0.927,24.878,77,43,31,12,34,24,10,46,0.07,0.0
1010,995,24-09-2019 20:48:00,0,4708.5,4376.0,0.9295,23.396,200,117,85,32,83,51,32,130,0.0,0.0
1010,996,24-09-2019 20:50:00,0,4408.0,4108.0,0.932,21.914,285,175,131,44,110,83,27,42,0.01,0.0
1010,997,24-09-2019 20:52:00,0,4803.0,4468.0,0.93,23.871,145,72,50,22,73,43,30,60,0.0,0.0
1010,998,24-09-2019 20:54:00,0,3816.0,3489.0,0.914,18.898,155,54,23,31,101,63,38,0,0.0,0.0
1010,999,24-09-2019 20:56:00,0,4031.0,3638.0,0.902,19.909,301,167,125,42,134,95,39,69,0.0,0.02
1010,1000,24-09-2019 20:58:00,0,4623.0,4284.0,0.927,22.958,183,103,59,44,80,20,60,98,0.0,0.0
1010,1001,24-09-2019 21:00:00,0,4775.0,4551.0,0.953,23.852,157,90,63,27,67,34,33,78,0.0,0.0
1010,1002,24-09-2019 21:02:00,0,4318.0,3963.0,0.918,21.4,324,204,164,40,120,78,42,137,0.06,0.0
1010,1003,24-09-2019 21:04:00,0,4608.0,4282.0,0.929,22.896,201,122,81,41,79,43,36,86,0.01,0.0
1010,1004,24-09-2019 21:06:00,0,4801.0,4553.0,0.948,23.958,341,196,155,41,145,103,42,139,0.0,0.02
1010,1005,24-09-2019 21:08:00,0,4314.0,3984.0,0.924,21.406,404,215,150,65,189,132,57,39,0.0,0.0
1010,1006,24-09-2019 21:10:00,0,4814.0,4467.0,0.928,23.912,210,119,67,52,91,41,50,81,0.01,0.0
1010,1007,24-09-2019 21:12:00,0,4798.0,4504.0,0.939,23.892,295,177,129,48,118,73,45,117,0.0,0.0
1010,1008,24-09-2019 21:14:00,0,4294.0,4028.0,0.938,21.377,368,235,193,42,133,106,27,122,0.05,0.0
1010,1009,24-09-2019 21:16:00,0,3515.0,3221.0,0.916,17.417,154,66,40,26,88,51,37,11,0.01,0.0
1010,1010,24-09-2019 21:18:00,0,3039.0,2700.0,0.889,14.963,162,61,29,32,101,58,43,0,0.0,0.0
1010,1011,24-09-2019 21:20:00,0,3052.0,2628.0,0.861,14.935,119,52,34,18,67,35,32,0,0.0,0.0
1010,1012,24-09-2019 21:22:00,0,3554.5,3098.0,0.8705,17.435,146,64,33,31,82,47,35,0,0.0,0.0
1010,1013,24-09-2019 21:24:00,0,4057.0,3568.0,0.88,19.935,171,56,24,32,115,67,48,0,0.0,0.0
1010,1014,24-09-2019 21:26:00,0,4319.0,3958.0,0.916,21.399,249,128,98,30,121,92,29,81,0.0,0.0
1010,1015,24-09-2019 21:28:00,0,4606.0,4305.0,0.934,22.914,97,47,22,25,50,24,26,34,0.0,0.02
1010,1016,24-09-2019 21:30:00,0,4786.0,4566.0,0.954,23.912,128,60,33,27,68,36,32,79,0.0,0.0
1010,1017,24-09-2019 21:32:00,0,5080.0,4833.0,0.951,25.367,132,65,27,38,67,24,43,89,0.01,0.0
1010,1018,24-09-2019 21:34:00,0,4987.0,4714.0,0.945,24.866,136,68,34,34,68,27,41,74,0.0,0.0
1010,1019,24-09-2019 21:36:00,0,4994.0,4701.0,0.941,24.88,159,68,40,28,91,40,51,61,0.0,0.01
1010,1020,24-09-2019 21:38:00,0,4890.0,4588.0,0.938,24.346,250,156,112,44,94,38,56,111,0.0,0.01
1010,1021,24-09-2019 21:40:00,0,4806.0,4473.0,0.931,23.888,152,95,64,31,57,26,31,63,0.0,0.07
1010,1022,24-09-2019 21:42:00,0,4810.0,4510.0,0.938,23.946,366,219,163,56,147,89,58,109,0.0,0.0
1010,1023,24-09-2019 21:44:00,0,4832.0,4489.0,0.929,24.008,358,221,173,48,137,105,32,95,0.06,0.06
1010,1024,24-09-2019 21:46:00,0,4526.0,4134.0,0.913,22.411,251,134,109,25,117,89,28,165,0.0,0.0
1010,1025,24-09-2019 21:48:00,0,4809.0,4469.0,0.929,23.893,277,130,99,31,147,103,44,85,0.05,0.0
1010,1026,24-09-2019 21:50:00,0,4515.0,4158.0,0.921,22.394,308,178,144,34,130,90,40,159,0.01,0.03
1010,1027,24-09-2019 21:52:00,0,5005.0,4667.0,0.933,24.886,150,60,40,20,90,56,34,45,0.01,0.0
1010,1028,24-09-2019 21:54:00,0,3556.0,3069.0,0.863,17.409,84,14,9,5,70,34,36,3,0.0,0.0
1010,1029,24-09-2019 21:56:00,0,4165.5,3855.0,0.9175,20.681,241,132,102,30,109,78,31,45,0.0,0.0
1010,1030,24-09-2019 21:58:00,0,4775.0,4641.0,0.972,23.953,389,245,181,64,144,97,47,91,0.0,0.02
1010,1031,24-09-2019 22:00:00,0,5115.0,4769.0,0.933,25.431,253,142,112,30,111,73,38,77,0.0,0.0
1010,1032,24-09-2019 22:02:00,0,4979.0,4750.0,0.954,24.876,232,141,101,40,91,56,35,94,0.0,0.0
1010,1033,24-09-2019 22:04:00,0,5085.0,4883.0,0.96,25.439,264,169,128,41,95,60,35,72,0.0,0.07
1010,1034,24-09-2019 22:06:00,0,4811.0,4480.0,0.931,23.915,255,164,119,45,91,58,33,97,0.0,0.0
1010,1035,24-09-2019 22:08:00,0,4599.0,4387.0,0.954,22.977,268,152,118,34,116,71,45,99,0.0,0.01
1010,1036,24-09-2019 22:10:00,0,4571.0,4407.0,0.964,22.888,425,244,188,56,181,129,52,65,0.07,0.0
1010,1037,24-09-2019 22:12:00,0,4589.0,4361.0,0.95,22.909,253,143,112,31,110,88,22,162,0.01,0.01
1010,1038,24-09-2019 22:14:00,0,4211.0,3881.0,0.922,20.888,319,198,152,46,121,78,43,109,0.01,0.0
1010,1039,24-09-2019 22:16:00,0,4796.0,4484.0,0.935,23.861,238,150,110,40,88,52,36,90,0.0,0.0
1010,1040,24-09-2019 22:18:00,0,4258.0,4114.0,0.966,21.331,309,196,167,29,113,84,29,95,0.08,0.04
1010,1041,24-09-2019 22:20:00,0,3836.0,3471.0,0.905,18.956,64,31,16,15,33,24,9,3,0.0,0.0
1010,1042,24-09-2019 22:22:00,0,3117.0,2814.0,0.903,15.395,256,112,68,44,144,91,53,7,0.0,0.0
1010,1043,24-09-2019 22:24:00,0,3356.0,2929.0,0.873,16.466,150,67,32,35,83,52,31,0,0.0,0.0
1010,1044,24-09-2019 22:26:00,0,3350.0,2925.0,0.873,16.438,150,56,33,23,94,55,39,1,0.0,0.0
1010,1045,24-09-2019 22:28:00,0,4227.0,3875.0,0.917,20.944,185,76,42,34,109,65,44,0,0.0,0.0
1010,1046,24-09-2019 22:30:00,0,4116.0,3796.5,0.9225,20.4195,36,19,1,18,17,0,17,0,0.0,0.0
1010,1047,24-09-2019 22:32:00,0,4005.0,3718.0,0.928,19.895,34,16,4,12,18,6,12,0,0.0,0.0
1010,1048,24-09-2019 22:34:00,0,3676.0,3585.0,0.975,18.452,64,50,21,29,14,3,11,0,0.0,0.0
1010,1049,24-09-2019 22:36:00,0,3677.0,3528.0,0.959,18.391,58,26,8,18,32,20,12,0,0.0,0.0
1010,1050,24-09-2019 22:38:00,0,3678.0,3534.0,0.961,18.404,214,117,75,42,97,67,30,17,0.0,0.0
1010,1051,24-09-2019 22:40:00,0,4175.0,4088.0,0.979,20.973,218,126,90,36,92,59,33,91,0.0,0.0
1010,1052,24-09-2019 22:42:00,0,4494.0,4277.0,0.952,22.442,272,171,142,29,101,84,17,116,0.0,0.0
1010,1053,24-09-2019 22:44:00,0,4170.0,4057.0,0.973,20.922,266,168,131,37,98,67,31,145,0.0,0.0
1010,1054,24-09-2019 22:46:00,0,4482.0,4284.0,0.956,22.402,247,148,111,37,99,50,49,132,0.0,0.0
1010,1055,24-09-2019 22:48:00,0,4441.0,4380.0,0.986,22.347,236,144,99,45,92,57,35,107,0.0,0.0
1010,1056,24-09-2019 22:50:00,0,4456.0,4452.0,0.999,22.483,135,68,31,37,67,35,32,70,0.0,0.0
1010,1057,24-09-2019 22:52:00,0,4569.0,4429.0,0.969,22.904,163,51,18,33,112,41,71,41,0.01,0.0
1010,1058,24-09-2019 22:54:00,0,4458.0,4387.0,0.984,22.421,97,37,15,22,60,29,31,67,0.0,0.01
1010,1059,24-09-2019 22:56:00,0,3483.0,3315.0,0.952,17.394,249,138,114,24,111,91,20,68,0.0,0.0
1010,1060,24-09-2019 22:58:00,0,4189.0,4009.0,0.957,20.941,170,77,40,37,93,55,38,66,0.0,0.0
1010,1061,24-09-2019 23:00:00,0,4477.0,4374.0,0.977,22.481,137,47,22,25,90,47,43,48,0.0,0.05
1010,1062,24-09-2019 23:02:00,0,4463.0,4361.0,0.977,22.411,73,37,22,15,36,20,16,52,0.0,0.03
1010,1063,24-09-2019 23:04:00,0,4259.0,4196.5,0.986,21.425,333,156,115,41,177,128,49,32,0.0,0.0
1010,1064,24-09-2019 23:06:00,0,4055.0,4032.0,0.995,20.439,357,200,152,48,157,126,31,75,0.1,0.05
1010,1065,24-09-2019 23:08:00,0,3781.0,3644.0,0.964,18.932,247,122,79,43,125,76,49,88,0.0,0.0
1010,1066,24-09-2019 23:10:00,0,4495.0,4265.0,0.949,22.433,153,69,37,32,84,40,44,62,0.0,0.0
1010,1067,24-09-2019 23:12:00,0,4579.0,4407.0,0.963,22.919,114,55,27,28,59,28,31,53,0.0,0.03
1010,1068,24-09-2019 23:14:00,0,4472.0,4339.0,0.97,22.421,155,76,35,41,79,36,43,45,0.0,0.06
1010,1069,24-09-2019 23:16:00,0,4704.0,4448.0,0.946,23.456,103,55,31,24,48,24,24,55,0.0,0.02
1010,1070,24-09-2019 23:18:00,0,3996.0,3777.0,0.945,19.925,340,166,126,40,174,133,41,51,0.04,0.05
1010,1071,24-09-2019 23:20:00,0,3799.0,3554.0,0.936,18.903,341,198,160,38,143,120,23,152,0.05,0.0
1010,1072,24-09-2019 23:22:00,0,4017.0,3700.0,0.921,19.924,360,209,159,50,151,111,40,114,0.0,0.0
1010,1073,24-09-2019 23:24:00,0,3774.0,3627.0,0.961,18.885,220,79,60,19,141,89,52,14,0.01,0.0
1010,1074,24-09-2019 23:26:00,0,3213.0,2971.0,0.925,15.95,215,106,69,37,109,75,34,55,0.07,0.0
1010,1075,24-09-2019 23:28:00,0,4683.0,4550.0,0.972,23.488,149,74,35,39,75,35,40,52,0.0,0.0
1010,1076,24-09-2019 23:30:00,0,5007.0,4679.0,0.935,24.907,151,60,36,24,91,59,32,36,0.0,0.0
1010,1077,24-09-2019 23:32:00,0,5004.0,4710.0,0.941,24.931,128,41,20,21,87,42,45,37,0.0,0.01
1010,1078,24-09-2019 23:34:00,0,4600.0,4348.0,0.945,22.938,92,52,33,19,40,23,17,66,0.0,0.03
1010,1079,24-09-2019 23:36:00,0,4210.0,3946.0,0.937,20.954,334,195,145,50,139,92,47,6,0.0,0.07
1010,1080,24-09-2019 23:38:00,0,4091.0,3899.5,0.9535,20.4345,375,183,147,36,192,147,45,6,0.0,0.0
1010,1081,24-09-2019 23:40:00,0,3972.0,3853.0,0.97,19.915,215,123,94,29,92,64,28,31,0.0,0.0
1010,1082,24-09-2019 23:42:00,0,4464.0,4341.0,0.973,22.393,358,243,201,42,115,83,32,131,0.0,0.0
1010,1083,24-09-2019 23:44:00,0,4495.0,4289.0,0.954,22.46,106,58,29,29,48,20,28,36,0.0,0.0
1010,1084,24-09-2019 23:46:00,0,4780.0,4574.0,0.957,23.896,174,80,37,43,94,45,49,54,0.01,0.0
1010,1085,24-09-2019 23:48:00,0,4646.0,4520.0,0.973,23.31,173,41,19,22,132,87,45,37,0.0,0.04
1010,1086,24-09-2019 23:50:00,0,4783.0,4640.0,0.97,23.984,241,135,98,37,106,68,38,49,0.2,0.03
1010,1087,24-09-2019 23:52:00,0,4285.0,4127.0,0.963,21.449,446,264,211,53,182,145,37,159,0.03,0.0
1010,1088,24-09-2019 23:54:00,0,4115.0,3797.0,0.923,20.416,401,224,178,46,177,137,40,107,0.0,0.0
1010,1089,24-09-2019 23:56:00,0,4200.0,3936.0,0.937,20.904,547,250,196,54,297,238,59,0,0.0,0.0
1010,1090,24-09-2019 23:58:00,0,4223.0,3888.0,0.921,20.944,389,265,210,55,124,83,41,46,0.0,0.0
1010,1091,25-09-2019 00:00:00,0,4718.0,4371.0,0.926,23.428,204,62,33,29,142,82,60,39,0.0,0.0
1010,1092,25-09-2019 00:02:00,0,4653.0,4554.0,0.979,23.374,160,53,25,28,107,57,50,45,0.0,0.01
1010,1093,25-09-2019 00:04:00,0,4666.0,4537.0,0.972,23.408,167,48,25,23,119,66,53,38,0.0,0.05
1010,1094,25-09-2019 00:06:00,0,4665.0,4605.0,0.987,23.476,183,75,53,22,108,59,49,34,0.0,0.04
1010,1095,25-09-2019 00:08:00,0,4009.0,3720.0,0.928,19.913,150,58,27,31,92,53,39,0,0.0,0.0
1010,1096,25-09-2019 00:10:00,0,3528.0,3194.0,0.905,17.437,242,95,46,49,147,92,55,0,0.0,0.01
1010,1097,25-09-2019 00:12:00,0,3377.5,3034.5,0.898,16.668,105,49,18,31,56,27,29,0,0.0,0.0
1010,1098,25-09-2019 00:14:00,0,3227.0,2875.0,0.891,15.899,170,72,36,36,98,59,39,2,0.0,0.01
1010,1099,25-09-2019 00:16:00,0,3221.0,2981.0,0.925,15.99,35,4,3,1,31,7,24,0,0.0,0.0
1010,1100,25-09-2019 00:18:00,0,3007.0,2794.0,0.929,14.941,20,1,1,0,19,4,15,0,0.0,0.0
1010,1101,25-09-2019 00:20:00,0,3015.0,2733.0,0.906,14.906,18,0,0,0,18,0,18,0,0.0,0.0
1010,1102,25-09-2019 00:22:00,0,3042.0,2653.0,0.872,14.924,53,6,4,2,47,17,30,0,0.0,0.0
1010,1103,25-09-2019 00:24:00,0,2818.0,2576.0,0.914,13.955,26,7,2,5,19,5,14,0,0.0,0.0
1010,1104,25-09-2019 00:26:00,0,2927.0,2614.0,0.893,14.425,75,17,10,7,58,26,32,0,0.0,0.0
1010,1105,25-09-2019 00:28:00,0,3199.0,3004.0,0.939,15.928,15,0,0,0,15,0,15,0,0.0,0.0
1010,1106,25-09-2019 00:30:00,0,3490.0,3346.0,0.959,17.455,15,5,0,5,10,0,10,0,0.0,0.0
1010,1107,25-09-2019 00:32:00,0,3708.0,3454.0,0.931,18.434,20,6,2,4,14,2,12,0,0.0,0.0
1010,1108,25-09-2019 00:34:00,0,3692.0,3471.0,0.94,18.391,16,0,0,0,16,3,13,0,0.0,0.0
1010,1109,25-09-2019 00:36:00,0,3708.0,3420.0,0.922,18.394,80,23,15,8,57,33,24,0,0.0,0.0
1010,1110,25-09-2019 00:38:00,0,3692.0,3516.0,0.952,18.44,17,7,4,3,10,2,8,0,0.0,0.0
1010,1111,25-09-2019 00:40:00,0,3674.0,3553.0,0.967,18.408,29,12,8,4,17,4,13,0,0.0,0.0
1010,1112,25-09-2019 00:42:00,0,3885.0,3759.0,0.968,19.47,33,8,5,3,25,11,14,0,0.0,0.0
1010,1113,25-09-2019 00:44:00,0,3957.0,3934.0,0.994,19.945,17,0,0,0,17,0,17,0,0.0,0.0
1010,1114,25-09-2019 00:46:00,0,3952.5,3953.0,1.0,19.9475,47,12,5,7,35,17,18,0,0.0,0.02
1010,1115,25-09-2019 00:48:00,0,3948.0,3972.0,1.006,19.95,15,0,0,0,15,4,11,0,0.0,0.0
1010,1116,25-09-2019 00:50:00,0,3970.0,3865.0,0.974,19.922,26,1,0,1,25,8,17,0,0.0,0.0
1010,1117,25-09-2019 00:52:00,0,3864.0,3769.0,0.975,19.399,19,0,0,0,19,0,19,0,0.0,0.0
1010,1118,25-09-2019 00:54:00,0,3662.0,3643.0,0.995,18.46,176,84,55,29,92,60,32,17,0.0,0.0
1010,1119,25-09-2019 00:56:00,0,3744.0,3739.0,0.999,18.891,225,137,110,27,88,71,17,127,0.0,0.0
1010,1120,25-09-2019 00:58:00,0,3863.0,3815.0,0.987,19.443,205,118,93,25,87,71,16,92,0.0,0.0
1010,1121,25-09-2019 01:00:00,0,3931.0,4013.0,1.021,19.931,311,194,161,33,117,86,31,109,0.0,0.0
1010,1122,25-09-2019 01:02:00,0,3942.0,3987.0,1.011,19.945,217,97,75,22,120,83,37,59,0.0,0.0
1010,1123,25-09-2019 01:04:00,0,3943.0,3974.0,1.008,19.935,13,12,9,3,1,1,0,33,0.0,0.0
1010,1124,25-09-2019 01:06:00,0,3650.0,3637.0,0.996,18.406,129,39,14,25,90,40,50,30,0.0,0.0
1010,1125,25-09-2019 01:08:00,0,3937.0,3956.0,1.005,19.891,136,62,33,29,74,30,44,75,0.0,0.01
1010,1126,25-09-2019 01:10:00,0,4170.0,4089.0,0.981,20.955,164,60,34,26,104,54,50,51,0.0,0.03
1010,1127,25-09-2019 01:12:00,0,4178.0,4047.0,0.969,20.941,107,44,21,23,63,29,34,69,0.0,0.05
1010,1128,25-09-2019 01:14:00,0,4054.0,4038.0,0.996,20.442,364,182,149,33,182,139,43,36,0.15,0.01
1010,1129,25-09-2019 01:16:00,0,3503.0,3277.0,0.935,17.429,622,312,238,74,310,250,60,28,0.0,0.0
1010,1130,25-09-2019 01:18:00,0,3475.0,3351.0,0.964,17.402,329,219,170,49,110,87,23,151,0.0,0.0
1010,1131,25-09-2019 01:20:00,0,3819.0,3717.0,0.9725,19.1625,220,107,77,30,113,84,29,33,0.0,0.0
1010,1132,25-09-2019 01:22:00,0,4163.0,4083.0,0.981,20.923,177,60,29,31,117,72,45,28,0.0,0.03
1010,1133,25-09-2019 01:24:00,0,4442.0,4419.0,0.995,22.393,154,56,22,34,98,56,42,32,0.0,0.0
1010,1134,25-09-2019 01:26:00,0,4499.0,4239.0,0.942,22.419,131,65,45,20,66,43,23,51,0.1,0.06
1010,1135,25-09-2019 01:28:00,0,3401.0,3186.0,0.937,16.928,125,57,29,28,68,36,32,0,0.0,0.01
1010,1136,25-09-2019 01:30:00,0,3528.0,3188.0,0.904,17.43,116,20,2,18,96,53,43,0,0.0,0.0
1010,1137,25-09-2019 01:32:00,0,3496.0,3309.0,0.946,17.44,90,30,15,15,60,31,29,0,0.0,0.0
1010,1138,25-09-2019 01:34:00,0,3231.0,2879.0,0.891,15.919,15,7,4,3,8,0,8,0,0.0,0.0
1010,1139,25-09-2019 01:36:00,0,3193.0,3047.0,0.954,15.955,14,3,0,3,11,0,11,0,0.0,0.0
1010,1140,25-09-2019 01:38:00,0,3413.0,3163.0,0.927,16.95,15,1,0,1,14,2,12,0,0.0,0.0
1010,1141,25-09-2019 01:40:00,0,3410.0,3138.0,0.92,16.912,23,11,8,3,12,3,9,0,0.0,0.02
1010,1142,25-09-2019 01:42:00,0,3479.0,3366.0,0.968,17.433,19,10,2,8,9,1,8,0,0.0,0.0
1010,1143,25-09-2019 01:44:00,0,3691.0,3456.0,0.936,18.369,26,2,0,2,24,8,16,0,0.0,0.0
1010,1144,25-09-2019 01:46:00,0,3566.0,3433.0,0.963,17.849,61,26,14,12,35,17,18,0,0.0,0.0
1010,1145,25-09-2019 01:48:00,0,3703.0,3470.0,0.937,18.43,26,12,1,11,14,0,14,0,0.0,0.0
1010,1146,25-09-2019 01:50:00,0,3667.0,3543.0,0.966,18.37,13,2,1,1,11,3,8,0,0.0,0.0
1010,1147,25-09-2019 01:52:00,0,3678.0,3570.0,0.971,18.444,15,3,1,2,12,0,12,0,0.0,0.0
1010,1148,25-09-2019 01:54:00,0,3655.0,3657.0,1.001,18.4495,41,11,9,2,30,7,23,0,0.0,0.0
1010,1149,25-09-2019 01:56:00,0,3632.0,3744.0,1.031,18.455,24,5,2,3,19,1,18,0,0.0,0.0
1010,1150,25-09-2019 01:58:00,0,3648.0,3670.0,1.006,18.437,86,0,0,0,86,60,26,0,0.0,0.0
1010,1151,25-09-2019 02:00:00,0,3660.0,3620.0,0.989,18.427,11,0,0,0,11,0,11,0,0.0,0.0
1010,1152,25-09-2019 02:02:00,0,3692.0,3515.0,0.952,18.439,11,0,0,0,11,2,9,0,0.0,0.0
1010,1153,25-09-2019 02:04:00,0,3690.0,3517.0,0.953,18.433,33,8,2,6,25,8,17,0,0.0,0.0
1010,1154,25-09-2019 02:06:00,0,3454.0,3452.0,1.0,17.429,38,2,0,2,36,17,19,0,0.0,0.0
1010,1155,25-09-2019 02:08:00,0,3485.0,3355.0,0.963,17.445,64,27,15,12,37,19,18,0,0.0,0.0
1010,1156,25-09-2019 02:10:00,0,3369.0,3282.0,0.974,16.908,13,2,0,2,11,1,10,0,0.0,0.0
1010,1157,25-09-2019 02:12:00,0,3154.0,3171.0,1.006,15.937,19,10,5,5,9,0,9,0,0.0,0.0
1010,1158,25-09-2019 02:14:00,0,3164.0,3121.0,0.986,15.92,25,11,3,8,14,2,12,0,0.0,0.0
1010,1159,25-09-2019 02:16:00,0,3167.0,3127.0,0.988,15.939,24,8,0,8,16,5,11,0,0.01,0.0
1010,1160,25-09-2019 02:18:00,0,3173.0,3087.0,0.973,15.921,15,2,0,2,13,0,13,0,0.0,0.0
1010,1161,25-09-2019 02:20:00,0,3200.0,2991.0,0.934,15.921,55,12,8,4,43,19,24,0,0.0,0.0
1010,1162,25-09-2019 02:22:00,0,3069.0,2982.0,0.971,15.393,12,4,3,1,8,3,5,0,0.0,0.0
1010,1163,25-09-2019 02:24:00,0,3092.0,2979.0,0.963,15.481,24,7,3,4,17,11,6,0,0.0,0.0
1010,1164,25-09-2019 02:26:00,0,3201.0,2989.0,0.934,15.922,60,26,10,16,34,17,17,0,0.0,0.0
1010,1165,25-09-2019 02:28:00,0,3411.5,3140.5,0.9215,16.9185,166,64,35,29,102,55,47,2,0.0,0.0
1010,1166,25-09-2019 02:30:00,0,3622.0,3292.0,0.909,17.915,190,100,69,31,90,60,30,82,0.0,0.0
1010,1167,25-09-2019 02:32:00,0,3571.0,3490.0,0.977,17.934,138,74,57,17,64,48,16,66,0.0,0.0
1010,1168,25-09-2019 02:34:00,0,3582.0,3481.0,0.972,17.965,92,56,35,21,36,12,24,65,0.0,0.0
1010,1169,25-09-2019 02:36:00,0,3597.0,3424.0,0.952,17.961,173,100,54,46,73,27,46,80,0.0,0.0
1010,1170,25-09-2019 02:38:00,0,3886.0,3700.0,0.952,19.406,179,95,56,39,84,50,34,67,0.0,0.04
1010,1171,25-09-2019 02:40:00,0,3875.0,3749.0,0.968,19.418,349,203,158,45,146,117,29,74,0.06,0.04
1010,1172,25-09-2019 02:42:00,0,3691.0,3498.0,0.948,18.414,162,99,68,31,63,36,27,79,0.01,0.23
1010,1173,25-09-2019 02:44:00,0,4100.0,3880.0,0.946,20.45,21,13,2,11,8,0,8,0,0.0,0.01
1010,1174,25-09-2019 02:46:00,0,4075.0,3948.0,0.969,20.428,20,0,0,0,20,0,20,0,0.0,0.0
1010,1175,25-09-2019 02:48:00,0,4188.0,4032.0,0.963,20.966,154,115,83,32,39,25,14,42,0.0,0.0
1010,1176,25-09-2019 02:50:00,0,4198.0,3966.0,0.945,20.929,430,224,178,46,206,159,47,14,0.18,0.0
1010,1177,25-09-2019 02:52:00,0,3593.0,3440.0,0.958,17.965,302,136,103,33,166,125,41,0,0.0,0.0
1010,1178,25-09-2019 02:54:00,0,4128.0,3790.0,0.918,20.459,672,375,297,78,297,230,67,8,0.0,0.0
1010,1179,25-09-2019 02:56:00,0,4310.0,4002.0,0.928,21.413,73,18,14,4,55,33,22,0,0.0,0.0
1010,1180,25-09-2019 02:58:00,0,4314.0,4036.0,0.936,21.464,259,113,87,26,146,101,45,66,0.0,0.0
1010,1181,25-09-2019 03:00:00,0,4288.0,4119.0,0.961,21.454,345,186,141,45,159,117,42,65,0.0,0.01
1010,1182,25-09-2019 03:02:00,0,4090.5,3907.0,0.955,20.4415,202,118,83,35,84,52,32,113,0.0,0.0
1010,1183,25-09-2019 03:04:00,0,3893.0,3695.0,0.949,19.429,406,178,128,50,228,180,48,34,0.0,0.0
1010,1184,25-09-2019 03:06:00,0,4102.0,3846.0,0.938,20.419,511,260,195,65,251,186,65,0,0.0,0.01
1010,1185,25-09-2019 03:08:00,0,4082.0,3945.0,0.966,20.449,422,239,184,55,183,142,41,40,0.0,0.03
1010,1186,25-09-2019 03:10:00,0,4285.0,4062.0,0.948,21.379,147,91,56,35,56,22,34,74,0.0,0.05
1010,1187,25-09-2019 03:12:00,0,4287.0,4066.0,0.949,21.392,299,151,113,38,148,104,44,42,0.11,0.01
1010,1188,25-09-2019 03:14:00,0,3778.0,3664.0,0.97,18.939,131,56,22,34,75,42,33,0,0.0,0.0
1010,1189,25-09-2019 03:16:00,0,3288.0,3138.0,0.954,16.429,92,4,1,3,88,52,36,0,0.0,0.0
1010,1190,25-09-2019 03:18:00,0,3717.0,3403.0,0.916,18.412,104,5,0,5,99,60,39,0,0.0,0.0
1010,1191,25-09-2019 03:20:00,0,4104.0,3841.0,0.936,20.422,162,56,23,33,106,64,42,0,0.0,0.0
1010,1192,25-09-2019 03:22:00,0,4099.0,3897.0,0.951,20.466,74,28,7,21,46,24,22,0,0.0,0.0
1010,1193,25-09-2019 03:24:00,0,4089.0,3882.0,0.949,20.407,184,91,44,47,93,47,46,0,0.0,0.0
1010,1194,25-09-2019 03:26:00,0,4304.0,3995.0,0.928,21.381,50,23,5,18,27,8,19,0,0.0,0.0
1010,1195,25-09-2019 03:28:00,0,4093.0,3858.0,0.943,20.397,22,6,2,4,16,0,16,0,0.0,0.0
1010,1196,25-09-2019 03:30:00,0,3895.0,3711.0,0.953,19.456,26,11,4,7,15,4,11,1,0.0,0.01
1010,1197,25-09-2019 03:32:00,0,3809.0,3519.0,0.924,18.902,23,1,0,1,22,0,22,0,0.0,0.0
1010,1198,25-09-2019 03:34:00,0,3620.0,3285.0,0.907,17.9,156,68,31,37,88,53,35,0,0.0,0.0
1010,1199,25-09-2019 03:36:00,0,3603.5,3359.0,0.932,17.9175,191,119,94,25,72,56,16,88,0.0,0.0
1010,1200,25-09-2019 03:38:00,0,3587.0,3433.0,0.957,17.935,386,221,176,45,165,126,39,79,0.0,0.0
1010,1201,25-09-2019 03:40:00,0,3604.0,3354.0,0.931,17.911,327,152,105,47,175,122,53,0,0.0,0.0
1010,1202,25-09-2019 03:42:00,0,3887.0,3745.0,0.963,19.462,543,334,268,66,209,152,57,5,0.0,0.0
1010,1203,25-09-2019 03:44:00,0,3695.0,3469.0,0.939,18.401,323,177,132,45,146,104,42,57,0.0,0.0
1010,1204,25-09-2019 03:46:00,0,3771.0,3645.0,0.967,18.891,216,122,87,35,94,63,31,63,0.0,0.05
1010,1205,25-09-2019 03:48:00,0,3820.0,3523.0,0.922,18.952,429,238,190,48,191,127,64,16,0.0,0.0
1010,1206,25-09-2019 03:50:00,0,3117.0,2846.0,0.913,15.434,89,45,13,32,44,13,31,0,0.0,0.0
1010,1207,25-09-2019 03:52:00,0,3596.0,3390.0,0.943,17.921,94,36,21,15,58,22,36,0,0.0,0.0
1010,1208,25-09-2019 03:54:00,0,3797.0,3571.0,0.941,18.912,85,28,10,18,57,27,30,0,0.0,0.0
1010,1209,25-09-2019 03:56:00,0,4017.0,3727.0,0.928,19.954,86,29,13,16,57,33,24,0,0.0,0.0
1010,1210,25-09-2019 03:58:00,0,3782.0,3654.0,0.966,18.947,15,0,0,0,15,0,15,0,0.0,0.0
1010,1211,25-09-2019 04:00:00,0,3691.0,3476.0,0.942,18.39,18,0,0,0,18,2,16,0,0.0,0.0
1010,1212,25-09-2019 04:02:00,0,3604.0,3386.0,0.939,17.947,15,0,0,0,15,2,13,0,0.0,0.0
1010,1213,25-09-2019 04:04:00,0,3620.0,3284.0,0.907,17.897,38,0,0,0,38,0,38,0,0.0,0.0
1010,1214,25-09-2019 04:06:00,0,3645.0,3266.0,0.896,17.977,15,0,0,0,15,2,13,10,0.0,0.0
1010,1215,25-09-2019 04:08:00,0,3499.0,3221.0,0.92,17.352,11,0,0,0,11,0,11,25,0.0,0.01
1010,1216,25-09-2019 04:10:00,0,3337.5,3154.5,0.946,16.642,21,5,0,5,16,3,13,26,0.0,0.0
1010,1217,25-09-2019 04:12:00,0,3176.0,3088.0,0.972,15.932,32,0,0,0,32,0,32,26,0.0,0.0
1010,1218,25-09-2019 04:14:00,0,3179.0,3091.0,0.972,15.948,15,0,0,0,15,0,15,27,0.0,0.0
1010,1219,25-09-2019 04:16:00,0,3195.0,3045.0,0.953,15.958,14,1,0,1,13,0,13,28,0.0,0.0
1010,1220,25-09-2019 04:18:00,0,3208.0,3007.0,0.937,15.969,44,12,9,3,32,13,19,36,0.0,0.0
1010,1221,25-09-2019 04:20:00,0,3191.0,2986.0,0.936,15.878,26,9,7,2,17,2,15,29,0.0,0.0
1010,1222,25-09-2019 04:22:00,0,3092.0,2949.0,0.954,15.448,36,16,10,6,20,5,15,32,0.0,0.0
1010,1223,25-09-2019 04:24:00,0,3196.0,2993.0,0.936,15.908,8,1,0,1,7,0,7,23,0.0,0.0
1010,1224,25-09-2019 04:26:00,0,3200.0,2996.0,0.936,15.926,9,0,0,0,9,0,9,35,0.0,0.0
1010,1225,25-09-2019 04:28:00,0,3199.0,2977.0,0.931,15.899,9,0,0,0,9,0,9,25,0.0,0.0
1010,1226,25-09-2019 04:30:00,0,3199.0,2985.0,0.933,15.908,10,2,0,2,8,2,6,35,0.0,0.0
1010,1227,25-09-2019 04:32:00,0,3202.0,3002.0,0.938,15.938,26,2,1,1,24,10,14,32,0.0,0.0
1010,1228,25-09-2019 04:34:00,0,3202.0,3030.0,0.946,15.97,43,3,1,2,40,30,10,27,0.0,0.0
1010,1229,25-09-2019 04:36:00,0,3209.0,2994.0,0.933,15.958,75,46,18,28,29,13,16,32,0.0,0.0
1010,1230,25-09-2019 04:38:00,0,3186.0,3086.0,0.969,15.969,202,116,69,47,86,48,38,33,0.0,0.0
1010,1231,25-09-2019 04:40:00,0,3386.0,3205.0,0.947,16.887,226,146,109,37,80,56,24,98,0.0,0.0
1010,1232,25-09-2019 04:42:00,0,3279.0,3178.0,0.969,16.438,120,73,52,21,47,22,25,82,0.0,0.0
1010,1233,25-09-2019 04:44:00,0,3291.5,3141.5,0.9545,16.447,195,121,92,29,74,46,28,114,0.0,0.0
1010,1234,25-09-2019 04:46:00,0,3304.0,3105.0,0.94,16.456,277,145,111,34,132,86,46,53,0.07,0.0
1010,1235,25-09-2019 04:48:00,0,3225.0,2958.0,0.917,15.981,85,45,19,26,40,17,23,34,0.0,0.0
1010,1236,25-09-2019 04:50:00,0,3298.0,3092.0,0.938,16.415,96,19,7,12,77,40,37,27,0.0,0.0
1010,1237,25-09-2019 04:52:00,0,3634.0,3283.0,0.904,17.951,14,0,0,0,14,5,9,20,0.0,0.0
1010,1238,25-09-2019 04:54:00,0,3519.0,3248.0,0.923,17.463,12,0,0,0,12,4,8,30,0.0,0.0
1010,1239,25-09-2019 04:56:00,0,3290.0,3141.0,0.955,16.44,15,0,0,0,15,5,10,28,0.0,0.03
1010,1240,25-09-2019 04:58:00,0,3334.0,3000.0,0.9,16.456,37,9,0,9,28,13,15,28,0.0,0.0
1010,1241,25-09-2019 05:00:00,0,3112.0,2863.0,0.92,15.431,40,19,0,19,21,6,15,29,0.0,0.0
1010,1242,25-09-2019 05:02:00,0,3018.0,2757.0,0.914,14.944,41,7,0,7,34,17,17,43,0.0,0.0
1010,1243,25-09-2019 05:04:00,0,3116.0,2828.0,0.908,15.407,59,1,0,1,58,28,30,26,0.0,0.0
1010,1244,25-09-2019 05:06:00,0,3108.0,2870.0,0.923,15.423,30,5,0,5,25,7,18,24,0.0,0.0
1010,1245,25-09-2019 05:08:00,0,3115.0,2904.0,0.932,15.488,42,8,1,7,34,17,17,35,0.0,0.0
1010,1246,25-09-2019 05:10:00,0,3109.0,2859.0,0.919,15.416,18,0,0,0,18,3,15,33,0.0,0.0
1010,1247,25-09-2019 05:12:00,0,3130.0,2841.0,0.907,15.479,23,6,1,5,17,3,14,31,0.0,0.0
1010,1248,25-09-2019 05:14:00,0,3114.0,2857.0,0.918,15.431,15,0,0,0,15,2,13,25,0.0,0.0
1010,1249,25-09-2019 05:16:00,0,3122.0,2828.0,0.906,15.432,185,87,48,39,98,61,37,88,0.0,0.0
1010,1250,25-09-2019 05:18:00,0,3218.5,2927.0,0.9095,15.922,237,158,122,36,79,57,22,125,0.0,0.0
1010,1251,25-09-2019 05:20:00,0,3315.0,3026.0,0.913,16.412,149,87,49,38,62,31,31,78,0.0,0.0
1010,1252,25-09-2019 05:22:00,0,3619.0,3350.0,0.926,17.969,190,119,85,34,71,55,16,82,0.0,0.04
1010,1253,25-09-2019 05:24:00,0,4122.0,3756.0,0.911,20.401,276,154,122,32,122,85,37,91,0.1,0.0
1010,1254,25-09-2019 05:26:00,0,3627.0,3311.0,0.913,17.956,351,210,172,38,141,108,33,88,0.0,0.0
1010,1255,25-09-2019 05:28:00,0,3652.0,3218.0,0.881,17.952,230,153,107,46,77,50,27,31,0.0,0.0
1010,1256,25-09-2019 05:30:00,0,3624.0,3293.0,0.909,17.925,217,102,74,28,115,82,33,61,0.0,0.0
1010,1257,25-09-2019 05:32:00,0,3809.0,3522.0,0.925,18.905,158,89,49,40,69,26,43,71,0.0,0.0
1010,1258,25-09-2019 05:34:00,0,3804.0,3541.0,0.931,18.909,115,56,22,34,59,28,31,56,0.0,0.0
1010,1259,25-09-2019 05:36:00,0,3779.0,3580.0,0.947,18.852,513,260,199,61,253,193,60,14,0.0,0.0
1010,1260,25-09-2019 05:38:00,0,3847.0,3440.0,0.894,18.967,553,300,247,53,253,204,49,53,0.0,0.0
1010,1261,25-09-2019 05:40:00,0,3617.0,3331.0,0.921,17.938,420,297,241,56,123,101,22,196,0.0,0.0
1010,1262,25-09-2019 05:42:00,0,3805.0,3567.0,0.938,18.941,251,145,114,31,106,80,26,158,0.0,0.0
1010,1263,25-09-2019 05:44:00,0,4151.0,3642.0,0.877,20.385,127,59,30,29,68,26,42,102,0.0,0.0
1010,1264,25-09-2019 05:46:00,0,4325.0,3903.0,0.902,21.363,224,98,68,30,126,83,43,43,0.0,0.0
1010,1265,25-09-2019 05:48:00,0,3326.0,2987.0,0.898,16.411,172,53,23,30,119,100,19,0,0.0,0.0
1010,1266,25-09-2019 05:50:00,0,3453.0,3030.0,0.878,16.959,114,41,18,23,73,41,32,1,0.0,0.0
1010,1267,25-09-2019 05:52:00,0,3663.5,3179.0,0.8685,17.954,191,91,47,44,100,58,42,0,0.0,0.0
1010,1268,25-09-2019 05:54:00,0,3874.0,3328.0,0.859,18.949,46,22,11,11,24,7,17,0,0.0,0.0
1010,1269,25-09-2019 05:56:00,0,3631.0,3265.0,0.899,17.92,18,0,0,0,18,0,18,0,0.0,0.0
1010,1270,25-09-2019 05:58:00,0,3652.0,3184.0,0.872,17.913,30,16,1,15,14,0,14,0,0.0,0.0
1010,1271,25-09-2019 06:00:00,1,3659.0,3176.0,0.868,17.931,35,8,3,5,27,4,23,0,0.0,0.0
1010,1272,25-09-2019 06:02:00,1,3651.0,3200.0,0.876,17.928,66,33,13,20,33,19,14,0,0.0,0.0
1010,1273,25-09-2019 06:04:00,1,3637.0,3231.0,0.888,17.907,193,96,58,38,97,59,38,17,0.0,0.0
1010,1274,25-09-2019 06:06:00,1,3656.0,3181.0,0.87,17.928,215,134,102,32,81,60,21,39,0.0,0.0
1010,1275,25-09-2019 06:08:00,1,3661.0,3142.0,0.858,17.903,34,22,13,9,12,7,5,65,0.0,0.0
1010,1276,25-09-2019 06:10:00,1,3643.0,3212.0,0.881,17.911,271,132,101,31,139,95,44,38,0.0,0.01
1010,1277,25-09-2019 06:12:00,1,3645.0,3235.0,0.888,17.941,627,343,289,54,284,226,58,1,0.0,0.1
1010,1278,25-09-2019 06:14:00,1,3638.0,3197.0,0.879,17.872,109,51,27,24,58,30,28,52,0.0,0.0
1010,1279,25-09-2019 06:16:00,1,3893.0,3273.0,0.841,18.961,238,112,79,33,126,79,47,34,0.0,0.0
1010,1280,25-09-2019 06:18:00,1,3181.0,2619.0,0.823,15.433,78,2,0,2,76,46,30,8,0.0,0.0
1010,1281,25-09-2019 06:20:00,1,3403.0,2734.0,0.804,16.433,78,10,4,6,68,28,40,6,0.0,0.0
1010,1282,25-09-2019 06:22:00,1,3353.0,2903.0,0.866,16.425,29,12,2,10,17,10,7,9,0.0,0.0
1010,1283,25-09-2019 06:24:00,1,3461.0,2938.0,0.849,16.891,242,86,50,36,156,104,52,7,0.0,0.0
1010,1284,25-09-2019 06:26:00,1,3509.0,2988.5,0.852,17.1345,791,458,373,85,333,254,79,16,0.0,0.0
1010,1285,25-09-2019 06:28:00,1,3557.0,3039.0,0.855,17.378,759,432,347,85,327,244,83,12,0.0,0.0
1010,1286,25-09-2019 06:30:00,1,3568.0,3044.0,0.853,17.427,51,13,4,9,38,5,33,6,0.0,0.0
1010,1287,25-09-2019 06:32:00,1,3557.0,3122.0,0.878,17.47,25,9,3,6,16,4,12,0,0.0,0.0
1010,1288,25-09-2019 06:34:00,1,3547.0,3131.0,0.883,17.44,58,31,3,28,27,8,19,0,0.0,0.0
1010,1289,25-09-2019 06:36:00,1,3570.0,3055.0,0.856,17.448,38,2,2,0,36,9,27,0,0.0,0.0
1010,1290,25-09-2019 06:38:00,1,3224.0,2920.0,0.906,15.936,13,0,0,0,13,0,13,0,0.0,0.0
1010,1291,25-09-2019 06:40:00,1,3271.0,2765.0,0.845,15.949,14,0,0,0,14,0,14,0,0.0,0.0
1010,1292,25-09-2019 06:42:00,1,3060.0,2631.0,0.86,14.967,7,0,0,0,7,0,7,0,0.0,0.0
1010,1293,25-09-2019 06:44:00,1,2958.0,2511.0,0.849,14.434,16,3,1,2,13,0,13,0,0.0,0.0
1010,1294,25-09-2019 06:46:00,1,2736.0,2418.0,0.884,13.455,39,4,3,1,35,12,23,0,0.0,0.0
1010,1295,25-09-2019 06:48:00,1,2723.0,2450.0,0.9,13.441,16,5,1,4,11,2,9,0,0.0,0.0
1010,1296,25-09-2019 06:50:00,1,2842.0,2469.0,0.869,13.932,35,13,0,13,22,2,20,0,0.0,0.0
1010,1297,25-09-2019 06:52:00,1,2968.0,2468.0,0.832,14.425,23,6,0,6,17,0,17,0,0.0,0.0
1010,1298,25-09-2019 06:54:00,1,3086.0,2483.0,0.805,14.909,10,1,0,1,9,0,9,0,0.0,0.0
1010,1299,25-09-2019 06:56:00,1,2974.0,2446.0,0.823,14.428,24,0,0,0,24,0,24,0,0.0,0.0
1010,1300,25-09-2019 06:58:00,1,2740.0,2382.0,0.869,13.434,23,2,0,2,21,6,15,0,0.0,0.0
1010,1301,25-09-2019 07:00:00,1,2744.5,2354.0,0.8575,13.4195,9,0,0,0,9,0,9,0,0.0,0.0
1010,1302,25-09-2019 07:02:00,1,2749.0,2326.0,0.846,13.405,12,0,0,0,12,0,12,0,0.0,0.0
1010,1303,25-09-2019 07:04:00,1,2763.0,2295.0,0.831,13.427,42,10,4,6,32,14,18,0,0.0,0.0
1010,1304,25-09-2019 07:06:00,1,2749.0,2338.0,0.851,13.42,9,0,0,0,9,0,9,0,0.0,0.0
1010,1305,25-09-2019 07:08:00,1,2765.0,2310.0,0.835,13.452,28,0,0,0,28,14,14,0,0.0,0.0
1010,1306,25-09-2019 07:10:00,1,2761.0,2257.0,0.817,13.378,30,2,1,1,28,15,13,0,0.0,0.0
1010,1307,25-09-2019 07:12:00,1,2781.0,2256.0,0.811,13.457,21,0,0,0,21,0,21,0,0.0,0.0
1010,1308,25-09-2019 07:14:00,1,2783.0,2230.0,0.801,13.434,18,0,0,0,18,3,15,0,0.0,0.0
1010,1309,25-09-2019 07:16:00,1,2787.0,2220.0,0.796,13.439,49,6,4,2,43,22,21,0,0.0,0.0
1010,1310,25-09-2019 07:18:00,1,2789.0,2192.0,0.786,13.417,33,10,7,3,23,9,14,0,0.0,0.0
1010,1311,25-09-2019 07:20:00,1,2682.0,2158.0,0.805,12.956,16,0,0,0,16,0,16,0,0.0,0.0
1010,1312,25-09-2019 07:22:00,1,2689.0,2109.0,0.784,12.927,12,0,0,0,12,0,12,0,0.0,0.0
1010,1313,25-09-2019 07:24:00,1,2568.0,2087.0,0.813,12.428,24,2,0,2,22,2,20,0,0.0,0.0
1010,1314,25-09-2019 07:26:00,1,2563.0,2054.0,0.801,12.374,45,9,5,4,36,15,21,0,0.0,0.0
1010,1315,25-09-2019 07:28:00,1,2565.0,2092.0,0.815,12.423,20,0,0,0,20,5,15,0,0.0,0.0
1010,1316,25-09-2019 07:30:00,1,2562.0,2079.0,0.812,12.397,16,0,0,0,16,2,14,0,0.0,0.0
1010,1317,25-09-2019 07:32:00,1,2571.0,2103.0,0.818,12.457,57,6,4,2,51,27,24,0,0.0,0.0
1010,1318,25-09-2019 07:34:00,1,2740.5,2166.5,0.792,13.196,62,9,5,4,53,19,34,0,0.0,0.0
1010,1319,25-09-2019 07:36:00,1,2910.0,2230.0,0.766,13.935,86,17,11,6,69,40,29,0,0.0,0.0
1010,1320,25-09-2019 07:38:00,1,2882.0,2296.0,0.797,13.898,108,24,11,13,84,46,38,0,0.0,0.0
1010,1321,25-09-2019 07:40:00,1,3109.0,2378.0,0.765,14.884,51,9,4,5,42,17,25,0,0.0,0.0
1010,1322,25-09-2019 07:42:00,1,3105.0,2395.0,0.771,14.886,77,17,6,11,60,26,34,0,0.0,0.0
1010,1323,25-09-2019 07:44:00,1,3220.0,2461.0,0.764,15.413,33,10,0,10,23,7,16,0,0.0,0.0
1010,1324,25-09-2019 07:46:00,1,2874.0,2353.0,0.819,13.927,15,0,0,0,15,0,15,0,0.0,0.0
1010,1325,25-09-2019 07:48:00,1,2899.0,2201.0,0.759,13.857,25,0,0,0,25,6,19,0,0.0,0.0
1010,1326,25-09-2019 07:50:00,1,2681.0,2117.0,0.79,12.909,33,0,0,0,33,21,12,0,0.0,0.0
1010,1327,25-09-2019 07:52:00,1,2696.0,2041.0,0.757,12.881,19,0,0,0,19,2,17,0,0.0,0.0
1010,1328,25-09-2019 07:54:00,1,2730.0,1999.0,0.732,12.972,30,1,0,1,29,15,14,0,0.0,0.0
1010,1329,25-09-2019 07:56:00,1,2715.0,1989.0,0.733,12.901,37,0,0,0,37,13,24,0,0.0,0.0
1010,1330,25-09-2019 07:58:00,1,2730.0,1991.0,0.729,12.962,13,0,0,0,13,1,12,0,0.0,0.0
1010,1331,25-09-2019 08:00:00,1,2726.0,1962.0,0.72,12.915,34,4,1,3,30,13,17,0,0.0,0.0
1010,1332,25-09-2019 08:02:00,1,2713.0,1989.0,0.733,12.892,21,1,0,1,20,0,20,0,0.0,0.0
1010,1333,25-09-2019 08:04:00,1,2718.0,1981.0,0.729,12.901,13,0,0,0,13,0,13,0,0.0,0.0
1010,1334,25-09-2019 08:06:00,1,2717.0,1992.0,0.733,12.912,47,14,9,5,33,8,25,0,0.0,0.0
1010,1335,25-09-2019 08:08:00,1,2710.0,2031.0,0.7495,12.9265,34,0,0,0,34,15,19,0,0.0,0.0
1010,1336,25-09-2019 08:10:00,1,2703.0,2070.0,0.766,12.941,28,0,0,0,28,6,22,0,0.0,0.0
1010,1337,25-09-2019 08:12:00,1,2701.0,2061.0,0.763,12.922,68,13,5,8,55,28,27,0,0.0,0.0
1010,1338,25-09-2019 08:14:00,1,2695.0,2086.0,0.774,12.927,24,0,0,0,24,2,22,0,0.0,0.0
1010,1339,25-09-2019 08:16:00,1,2817.0,2096.0,0.744,13.421,16,0,0,0,16,0,16,0,0.0,0.0
1010,1340,25-09-2019 08:18:00,1,2827.0,2099.0,0.742,13.464,25,0,0,0,25,4,21,0,0.0,0.0
1010,1341,25-09-2019 08:20:00,1,2692.0,2058.0,0.765,12.887,37,0,0,0,37,9,28,0,0.0,0.0
1010,1342,25-09-2019 08:22:00,1,2723.0,2013.0,0.739,12.96,21,0,0,0,21,0,21,0,0.0,0.0
1010,1343,25-09-2019 08:24:00,1,2725.0,1941.0,0.712,12.885,23,0,0,0,23,3,20,0,0.0,0.0
1010,1344,25-09-2019 08:26:00,1,2745.0,1897.0,0.691,12.916,70,0,0,0,70,48,22,0,0.0,0.0
1010,1345,25-09-2019 08:28:00,1,2626.0,1859.0,0.708,12.406,69,0,0,0,69,32,37,0,0.0,0.0
1010,1346,25-09-2019 08:30:00,1,2518.0,1843.0,0.732,11.961,39,0,0,0,39,11,28,0,0.0,0.0
1010,1347,25-09-2019 08:32:00,1,2626.0,1861.0,0.709,12.407,20,1,0,1,19,6,13,0,0.0,0.0
1010,1348,25-09-2019 08:34:00,1,2742.0,1926.0,0.703,12.936,18,0,0,0,18,0,18,0,0.0,0.0
1010,1349,25-09-2019 08:36:00,1,2706.0,1995.0,0.737,12.872,19,0,0,0,19,0,19,0,0.0,0.0
1010,1350,25-09-2019 08:38:00,1,2707.0,2019.0,0.746,12.901,42,11,3,8,31,13,18,0,0.0,0.0
1010,1351,25-09-2019 08:40:00,1,2705.0,2057.0,0.761,12.935,26,0,0,0,26,6,20,0,0.0,0.0
1010,1352,25-09-2019 08:42:00,1,2698.0,2056.5,0.7625,12.907,47,8,6,2,39,14,25,0,0.0,0.0
1010,1353,25-09-2019 08:44:00,1,2691.0,2056.0,0.764,12.879,28,0,0,0,28,0,28,0,0.0,0.0
1010,1354,25-09-2019 08:46:00,1,2711.0,2061.0,0.76,12.962,18,3,1,2,15,4,11,0,0.0,0.0
1010,1355,25-09-2019 08:48:00,1,2708.0,2055.0,0.759,12.943,18,2,0,2,16,0,16,0,0.0,0.0
1010,1356,25-09-2019 08:50:00,1,2709.0,2034.0,0.751,12.925,18,1,0,1,17,0,17,0,0.0,0.0
1010,1357,25-09-2019 08:52:00,1,2697.0,2039.0,0.756,12.886,19,0,0,0,19,0,19,0,0.0,0.0
1010,1358,25-09-2019 08:54:00,1,2715.0,2025.0,0.746,12.938,81,39,33,6,42,22,20,0,0.0,0.0
1010,1359,25-09-2019 08:56:00,1,2696.0,2040.0,0.757,12.882,104,46,37,9,58,35,23,0,0.0,0.0
1010,1360,25-09-2019 08:58:00,1,2919.0,2179.0,0.747,13.914,42,5,1,4,37,16,21,0,0.0,0.0
1010,1361,25-09-2019 09:00:00,1,2904.0,2243.0,0.772,13.926,54,7,4,3,47,5,42,0,0.0,0.0
1010,1362,25-09-2019 09:02:00,1,2894.0,2272.0,0.785,13.918,91,21,2,19,70,30,40,0,0.0,0.0
1010,1363,25-09-2019 09:04:00,1,2889.0,2281.0,0.79,13.908,63,13,4,9,50,21,29,0,0.0,0.0
1010,1364,25-09-2019 09:06:00,1,2899.0,2242.0,0.773,13.903,16,0,0,0,16,2,14,0,0.0,0.0
1010,1365,25-09-2019 09:08:00,1,2810.0,2131.0,0.758,13.43,20,0,0,0,20,4,16,0,0.0,0.0
1010,1366,25-09-2019 09:10:00,1,2709.0,2028.0,0.749,12.919,15,0,0,0,15,0,15,0,0.0,0.0
1010,1367,25-09-2019 09:12:00,1,2611.0,1935.0,0.741,12.431,34,0,0,0,34,3,31,0,0.0,0.0
1010,1368,25-09-2019 09:14:00,1,2382.0,1830.0,0.769,11.41,38,3,0,3,35,18,17,0,0.0,0.0
1010,1369,25-09-2019 09:16:00,1,2385.5,1840.5,0.772,11.4365,16,0,0,0,16,5,11,0,0.0,0.0
1010,1370,25-09-2019 09:18:00,1,2389.0,1851.0,0.775,11.463,17,0,0,0,17,2,15,0,0.0,0.0
1010,1371,25-09-2019 09:20:00,1,2511.0,1871.0,0.745,11.963,21,0,0,0,21,0,21,0,0.0,0.0
1010,1372,25-09-2019 09:22:00,1,2628.0,1883.0,0.717,12.438,10,0,0,0,10,0,10,0,0.0,0.0
1010,1373,25-09-2019 09:24:00,1,2624.0,1884.0,0.718,12.423,10,0,0,0,10,0,10,0,0.0,0.0
1010,1374,25-09-2019 09:26:00,1,2748.0,1906.0,0.694,12.936,25,6,1,5,19,4,15,0,0.0,0.0
1010,1375,25-09-2019 09:28:00,1,2732.0,1951.0,0.714,12.924,62,1,0,1,61,49,12,0,0.0,0.0
1010,1376,25-09-2019 09:30:00,1,2730.0,1956.0,0.717,12.923,73,12,5,7,61,34,27,0,0.0,0.0
1010,1377,25-09-2019 09:32:00,1,2733.0,1973.0,0.722,12.952,33,0,0,0,33,16,17,0,0.0,0.0
1010,1378,25-09-2019 09:34:00,1,2731.0,1929.0,0.707,12.897,31,2,1,1,29,13,16,0,0.0,0.0
1010,1379,25-09-2019 09:36:00,1,2746.0,1920.0,0.699,12.947,26,0,0,0,26,10,16,0,0.0,0.0
1010,1380,25-09-2019 09:38:00,1,2731.0,1923.0,0.704,12.89,11,0,0,0,11,0,11,0,0.0,0.0
1010,1381,25-09-2019 09:40:00,1,2742.0,1914.0,0.698,12.925,47,7,2,5,40,22,18,0,0.0,0.0
1010,1382,25-09-2019 09:42:00,1,2728.0,1939.0,0.711,12.895,18,1,0,1,17,7,10,0,0.0,0.0
1010,1383,25-09-2019 09:44:00,1,2744.0,1938.0,0.707,12.957,15,0,0,0,15,0,15,0,0.0,0.0
1010,1384,25-09-2019 09:46:00,1,2738.0,1889.0,0.69,12.879,7,0,0,0,7,0,7,0,0.0,0.0
1010,1385,25-09-2019 09:48:00,1,2630.0,1862.0,0.708,12.424,41,4,0,4,37,17,20,0,0.0,0.0
1010,1386,25-09-2019 09:50:00,1,2687.0,1880.0,0.7,12.669,25,0,0,0,25,2,23,0,0.0,0.0
1010,1387,25-09-2019 09:52:00,1,2744.0,1898.0,0.692,12.914,45,2,0,2,43,21,22,0,0.0,0.0
1010,1388,25-09-2019 09:54:00,1,2740.0,1899.0,0.693,12.9,31,0,0,0,31,15,16,0,0.0,0.0
1010,1389,25-09-2019 09:56:00,1,2726.0,1997.0,0.732,12.953,11,0,0,0,11,2,9,0,0.0,0.0
1010,1390,25-09-2019 09:58:00,1,2719.0,1991.0,0.732,12.92,20,0,0,0,20,2,18,0,0.0,0.0
1010,1391,25-09-2019 10:00:00,1,2727.0,1976.0,0.724,12.933,63,14,7,7,49,21,28,0,0.0,0.0
1010,1392,25-09-2019 10:02:00,1,2930.0,2106.0,0.719,13.876,68,24,5,19,44,18,26,0,0.0,0.0
1010,1393,25-09-2019 10:04:00,1,2908.0,2237.0,0.769,13.933,95,15,3,12,80,45,35,0,0.0,0.0
1010,1394,25-09-2019 10:06:00,1,3231.0,2403.0,0.744,15.391,194,103,78,25,91,59,32,61,0.0,0.0
1010,1395,25-09-2019 10:08:00,1,3439.0,2586.0,0.752,16.414,174,106,86,20,68,49,19,84,0.0,0.0
1010,1396,25-09-2019 10:10:00,1,3321.0,2519.0,0.759,15.876,255,124,91,33,131,87,44,25,0.0,0.0
1010,1397,25-09-2019 10:12:00,1,3434.0,2624.0,0.764,16.437,896,473,380,93,423,339,84,30,0.0,0.0
1010,1398,25-09-2019 10:14:00,1,3440.0,2587.0,0.752,16.419,602,322,255,67,280,218,62,36,0.0,0.0
1010,1399,25-09-2019 10:16:00,1,3430.0,2654.0,0.774,16.455,596,326,252,74,270,200,70,23,0.0,0.0
1010,1400,25-09-2019 10:18:00,1,3413.0,2675.0,0.784,16.411,485,242,198,44,243,184,59,47,0.0,0.0
1010,1401,25-09-2019 10:20:00,1,3421.0,2639.0,0.771,16.402,240,118,91,27,122,82,40,35,0.0,0.0
1010,1402,25-09-2019 10:22:00,1,3409.0,2640.0,0.774,16.355,263,116,70,46,147,96,51,20,0.0,0.0
1010,1403,25-09-2019 10:24:00,1,3307.5,2559.5,0.7735,15.865,612,308,237,71,304,229,75,22,0.0,0.0
1010,1404,25-09-2019 10:26:00,1,3206.0,2479.0,0.773,15.375,905,452,373,79,453,364,89,31,0.0,0.0
1010,1405,25-09-2019 10:28:00,1,3323.0,2562.0,0.771,15.93,552,265,214,51,287,209,78,30,0.0,0.0
1010,1406,25-09-2019 10:30:00,1,3318.0,2557.0,0.771,15.904,485,202,147,55,283,224,59,24,0.0,0.0
1010,1407,25-09-2019 10:32:00,1,3423.0,2644.0,0.772,16.415,121,83,65,18,38,29,9,95,0.0,0.0
1010,1408,25-09-2019 10:34:00,1,3416.0,2687.0,0.786,16.435,76,47,40,7,29,25,4,113,0.0,0.0
1010,1409,25-09-2019 10:36:00,1,3430.0,2605.0,0.759,16.4,159,82,54,28,77,43,34,65,0.0,0.0
1010,1410,25-09-2019 10:38:00,1,3417.0,2644.0,0.774,16.392,119,36,15,21,83,42,41,41,0.0,0.0
1010,1411,25-09-2019 10:40:00,1,3524.0,2745.0,0.779,16.922,712,407,324,83,305,239,66,26,0.0,0.0
1010,1412,25-09-2019 10:42:00,1,3210.0,2516.0,0.784,15.431,495,273,218,55,222,165,57,4,0.0,0.0
1010,1413,25-09-2019 10:44:00,1,2905.0,2205.0,0.759,13.887,130,34,5,29,96,47,49,0,0.0,0.0
1010,1414,25-09-2019 10:46:00,1,2922.0,2187.0,0.749,13.933,155,24,2,22,131,78,53,0,0.0,0.0
1010,1415,25-09-2019 10:48:00,1,3235.0,2375.0,0.734,15.377,167,70,38,32,97,73,24,0,0.0,0.0
1010,1416,25-09-2019 10:50:00,1,3426.0,2616.0,0.764,16.395,140,67,29,38,73,27,46,0,0.0,0.0
1010,1417,25-09-2019 10:52:00,1,3407.0,2672.0,0.784,16.383,4,3,1,2,1,0,1,0,0.0,0.0
1010,1418,25-09-2019 10:54:00,1,3428.0,2658.0,0.775,16.45,1,1,0,1,0,0,0,0,0.0,0.0
1010,1419,25-09-2019 10:56:00,1,3171.0,2590.0,0.817,15.361,12,5,0,5,7,2,5,1,0.0,0.0
1010,1420,25-09-2019 10:58:00,1,3020.5,2464.0,0.816,14.6295,10,7,4,3,3,0,3,0,0.0,0.0
1010,1421,25-09-2019 11:00:00,1,2870.0,2338.0,0.815,13.898,1,0,0,0,1,0,1,0,0.0,0.0
1010,1422,25-09-2019 11:02:00,1,2875.0,2329.0,0.81,13.906,2,2,1,1,0,0,0,0,0.0,0.0
1010,1423,25-09-2019 11:04:00,1,2878.0,2333.0,0.811,13.923,8,8,0,8,0,0,0,0,0.0,0.0
1010,1424,25-09-2019 11:06:00,1,2884.0,2336.0,0.81,13.95,18,14,6,8,4,0,4,0,0.0,0.0
1010,1425,25-09-2019 11:08:00,1,2986.0,2382.0,0.798,14.401,1,0,0,0,1,0,1,0,0.0,0.0
1010,1426,25-09-2019 11:10:00,1,3229.0,2439.0,0.755,15.424,1,1,1,0,0,0,0,0,0.0,0.0
1010,1427,25-09-2019 11:12:00,1,3113.0,2415.0,0.776,14.94,0,0,0,0,0,0,0,0,0.0,0.0
1010,1428,25-09-2019 11:14:00,1,2994.0,2364.0,0.79,14.415,38,18,9,9,20,10,10,0,0.0,0.0
1010,1429,25-09-2019 11:16:00,1,3116.0,2393.0,0.768,14.926,88,9,0,9,79,65,14,0,0.0,0.0
1010,1430,25-09-2019 11:18:00,1,2999.0,2350.0,0.783,14.417,43,4,0,4,39,13,26,0,0.0,0.0
1010,1431,25-09-2019 11:20:00,1,2892.0,2296.0,0.794,13.936,35,0,0,0,35,0,35,1,0.0,0.0
1010,1432,25-09-2019 11:22:00,1,2887.0,2305.0,0.799,13.928,40,11,0,11,29,0,29,0,0.0,0.0
1010,1433,25-09-2019 11:24:00,1,2900.0,2292.0,0.79,13.965,75,37,19,18,38,16,22,0,0.0,0.0
1010,1434,25-09-2019 11:26:00,1,3009.0,2340.0,0.778,14.446,1,1,0,1,0,0,0,0,0.0,0.0
1010,1435,25-09-2019 11:28:00,1,2884.0,2304.0,0.799,13.915,3,2,1,1,1,0,1,0,0.0,0.0
1010,1436,25-09-2019 11:30:00,1,2898.0,2264.0,0.781,13.925,0,0,0,0,0,0,0,0,0.0,0.0
1010,1437,25-09-2019 11:32:00,1,2971.0,2215.0,0.7465,14.1585,0,0,0,0,0,0,0,0,0.0,0.0
1010,1438,25-09-2019 11:34:00,1,3044.0,2166.0,0.712,14.392,38,17,12,5,21,16,5,0,0.0,0.0
1010,1439,25-09-2019 11:36:00,1,3057.0,2145.0,0.702,14.422,3,0,0,0,3,2,1,0,0.0,0.0
1010,1440,25-09-2019 11:38:00,1,2928.0,2095.0,0.715,13.858,2,0,0,0,2,0,2,0,0.0,0.0
1010,1441,25-09-2019 11:40:00,1,2941.0,2106.0,0.716,13.92,1,0,0,0,1,0,1,0,0.0,0.0
1010,1442,25-09-2019 11:42:00,1,2835.0,2001.0,0.706,13.385,14,4,2,2,10,3,7,0,0.0,0.0
1010,1443,25-09-2019 11:44:00,1,2850.0,1966.0,0.69,13.408,4,3,0,3,1,0,1,0,0.0,0.0
1010,1444,25-09-2019 11:46:00,1,2841.0,1975.0,0.695,13.382,5,5,0,5,0,0,0,0,0.0,0.0
1010,1445,25-09-2019 11:48:00,1,2852.0,2000.0,0.701,13.452,0,0,0,0,0,0,0,0,0.0,0.0
1010,1446,25-09-2019 11:50:00,1,2839.0,2006.0,0.706,13.408,0,0,0,0,0,0,0,0,0.0,0.0
1010,1447,25-09-2019 11:52:00,1,2845.0,2003.0,0.704,13.426,0,0,0,0,0,0,0,0,0.0,0.0
1010,1448,25-09-2019 11:54:00,1,2847.0,2014.0,0.707,13.447,0,0,0,0,0,0,0,0,0.0,0.0
1010,1449,25-09-2019 11:56:00,1,2858.0,1950.0,0.682,13.419,50,44,29,15,6,3,3,0,0.0,0.0
1010,1450,25-09-2019 11:58:00,1,2836.0,2010.0,0.708,13.401,26,26,2,24,0,0,0,0,0.0,0.0
1010,1451,25-09-2019 12:00:00,1,2854.0,1996.0,0.699,13.454,60,44,25,19,16,4,12,1,0.0,0.0
1010,1452,25-09-2019 12:02:00,1,2928.0,2125.0,0.726,13.89,2,2,0,2,0,0,0,0,0.0,0.0
1010,1453,25-09-2019 12:04:00,1,3052.0,2152.0,0.705,14.407,3,1,0,1,2,0,2,0,0.0,0.0
1010,1454,25-09-2019 12:06:00,1,2928.5,2118.0,0.724,13.8835,6,0,0,0,6,0,6,0,0.0,0.0
1010,1455,25-09-2019 12:08:00,1,2805.0,2084.0,0.743,13.36,0,0,0,0,0,0,0,0,0.0,0.0
1010,1456,25-09-2019 12:10:00,1,2828.0,2069.0,0.732,13.432,10,7,0,7,3,1,2,0,0.0,0.0
1010,1457,25-09-2019 12:12:00,1,2828.0,2054.0,0.726,13.418,29,3,0,3,26,1,25,0,0.0,0.0
1010,1458,25-09-2019 12:14:00,1,2836.0,2044.0,0.721,13.435,15,2,0,2,13,0,13,0,0.0,0.0
1010,1459,25-09-2019 12:16:00,1,2841.0,2010.0,0.708,13.418,12,6,2,4,6,0,6,0,0.0,0.0
1010,1460,25-09-2019 12:18:00,1,2840.0,1994.0,0.702,13.397,169,76,29,47,93,63,30,0,0.0,0.0
1010,1461,25-09-2019 12:20:00,1,3044.0,2214.0,0.727,14.444,247,89,46,43,158,126,32,2,0.0,0.0
1010,1462,25-09-2019 12:22:00,1,3004.0,2288.0,0.761,14.371,157,110,77,33,47,33,14,73,0.0,0.0
1010,1463,25-09-2019 12:24:00,1,3330.0,2474.0,0.743,15.861,12,10,7,3,2,1,1,61,0.0,0.0
1010,1464,25-09-2019 12:26:00,1,3559.0,2618.0,0.735,16.923,255,120,93,27,135,90,45,23,0.0,0.0
1010,1465,25-09-2019 12:28:00,1,3562.0,2605.0,0.731,16.918,659,355,281,74,304,227,77,14,0.0,0.0
1010,1466,25-09-2019 12:30:00,1,3561.0,2567.0,0.721,16.873,166,40,16,24,126,63,63,70,0.0,0.0
1010,1467,25-09-2019 12:32:00,1,3558.0,2645.0,0.743,16.946,179,56,23,33,123,66,57,36,0.0,0.0
1010,1468,25-09-2019 12:34:00,1,3521.0,2734.0,0.776,16.902,638,286,214,72,352,276,76,27,0.0,0.0
1010,1469,25-09-2019 12:36:00,1,3323.0,2560.0,0.77,15.926,998,482,392,90,516,406,110,3,0.0,0.04
1010,1470,25-09-2019 12:38:00,1,3626.0,2772.0,0.764,17.356,559,320,254,66,239,177,62,51,0.0,0.0
1010,1471,25-09-2019 12:40:00,1,3570.5,2764.5,0.774,17.1295,608,323,251,72,285,207,78,4,0.0,0.0
1010,1472,25-09-2019 12:42:00,1,3515.0,2757.0,0.784,16.903,284,146,115,31,138,97,41,94,0.0,0.0
1010,1473,25-09-2019 12:44:00,1,3628.0,2818.0,0.777,17.415,256,109,66,43,147,101,46,40,0.04,0.0
1010,1474,25-09-2019 12:46:00,1,3525.0,2695.0,0.764,16.873,177,64,33,31,113,61,52,31,0.0,0.0
1010,1475,25-09-2019 12:48:00,1,2797.0,2191.0,0.783,13.446,74,20,11,9,54,13,41,17,0.0,0.0
1010,1476,25-09-2019 12:50:00,1,2843.0,2026.0,0.713,13.446,99,13,5,8,86,33,53,48,0.0,0.0
1010,1477,25-09-2019 12:52:00,1,3340.0,2448.0,0.733,15.869,112,32,14,18,80,46,34,32,0.0,0.0
1010,1478,25-09-2019 12:54:00,1,3510.0,2754.0,0.785,16.879,139,58,23,35,81,39,42,14,0.0,0.0
1010,1479,25-09-2019 12:56:00,1,3831.0,3028.0,0.79,18.447,139,39,17,22,100,48,52,8,0.0,0.0
1010,1480,25-09-2019 12:58:00,1,3798.0,3083.0,0.812,18.377,59,13,5,8,46,19,27,13,0.0,0.0
1010,1481,25-09-2019 13:00:00,1,3824.0,3037.0,0.794,18.429,29,1,0,1,28,0,28,12,0.0,0.0
1010,1482,25-09-2019 13:02:00,1,3837.0,2945.0,0.768,18.378,31,4,2,2,27,2,25,10,0.0,0.0
1010,1483,25-09-2019 13:04:00,1,3485.0,2871.0,0.824,16.911,34,2,0,2,32,2,30,12,0.0,0.0
1010,1484,25-09-2019 13:06:00,1,3512.0,2815.0,0.802,16.954,25,0,0,0,25,0,25,7,0.0,0.0
1010,1485,25-09-2019 13:08:00,1,3506.0,2831.0,0.807,16.948,27,0,0,0,27,0,27,13,0.0,0.0
1010,1486,25-09-2019 13:10:00,1,3513.0,2765.0,0.787,16.905,31,1,0,1,30,0,30,3,0.0,0.0
1010,1487,25-09-2019 13:12:00,1,3529.0,2717.0,0.77,16.912,56,8,4,4,48,19,29,9,0.0,0.0
1010,1488,25-09-2019 13:14:00,1,3540.5,2683.5,0.758,16.92,79,10,2,8,69,36,33,6,0.0,0.0
1010,1489,25-09-2019 13:16:00,1,3552.0,2650.0,0.746,16.928,34,1,0,1,33,18,15,7,0.0,0.0
1010,1490,25-09-2019 13:18:00,1,3549.0,2611.0,0.736,16.875,70,15,10,5,55,16,39,4,0.0,0.0
1010,1491,25-09-2019 13:20:00,1,3326.0,2552.0,0.767,15.929,38,8,2,6,30,6,24,4,0.0,0.0
1010,1492,25-09-2019 13:22:00,1,3339.0,2514.0,0.753,15.941,24,0,0,0,24,0,24,6,0.0,0.0
1010,1493,25-09-2019 13:24:00,1,3121.0,2341.0,0.75,14.888,39,2,2,0,37,5,32,8,0.0,0.0
1010,1494,25-09-2019 13:26:00,1,3035.0,2252.0,0.742,14.453,29,8,2,6,21,4,17,4,0.0,0.0
1010,1495,25-09-2019 13:28:00,1,3045.0,2212.0,0.727,14.446,30,2,0,2,28,0,28,1,0.0,0.0
1010,1496,25-09-2019 13:30:00,1,3014.0,2245.0,0.745,14.36,33,0,0,0,33,3,30,5,0.0,0.0
1010,1497,25-09-2019 13:32:00,1,3016.0,2303.0,0.764,14.433,80,20,9,11,60,33,27,4,0.0,0.0
1010,1498,25-09-2019 13:34:00,1,3018.0,2294.0,0.76,14.431,30,2,0,2,28,0,28,2,0.0,0.0
1010,1499,25-09-2019 13:36:00,1,3136.0,2309.0,0.736,14.914,92,2,0,2,90,55,35,2,0.0,0.0
1010,1500,25-09-2019 13:38:00,1,3025.0,2271.0,0.751,14.433,28,1,0,1,27,0,27,4,0.0,0.0
1010,1501,25-09-2019 13:40:00,1,3014.0,2240.0,0.743,14.354,49,10,8,2,39,7,32,5,0.0,0.0
1010,1502,25-09-2019 13:42:00,1,3044.0,2219.0,0.729,14.45,34,8,3,5,26,2,24,4,0.0,0.0
1010,1503,25-09-2019 13:44:00,1,3039.0,2180.0,0.718,14.387,33,7,0,7,26,0,26,1,0.0,0.0
1010,1504,25-09-2019 13:46:00,1,3060.0,2140.0,0.699,14.425,47,12,2,10,35,5,30,2,0.0,0.0
1010,1505,25-09-2019 13:48:00,1,3056.0,2144.5,0.7015,14.414,58,0,0,0,58,28,30,3,0.0,0.0
1010,1506,25-09-2019 13:50:00,1,3052.0,2149.0,0.704,14.403,122,42,22,20,80,47,33,0,0.0,0.0
1010,1507,25-09-2019 13:52:00,1,3059.0,2137.0,0.698,14.419,87,23,10,13,64,30,34,2,0.0,0.0
1010,1508,25-09-2019 13:54:00,1,3045.0,2208.0,0.725,14.442,56,5,3,2,51,2,49,3,0.0,0.0
1010,1509,25-09-2019 13:56:00,1,3043.0,2204.0,0.724,14.428,48,10,6,4,38,9,29,2,0.0,0.0
1010,1510,25-09-2019 13:58:00,1,3029.0,2200.0,0.726,14.372,36,10,2,8,26,2,24,0,0.0,0.0
1010,1511,25-09-2019 14:00:00,1,3049.0,2213.0,0.726,14.463,27,2,0,2,25,0,25,0,0.0,0.0
1010,1512,25-09-2019 14:02:00,1,3048.0,2115.0,0.694,14.353,26,1,0,1,25,0,25,3,0.0,0.0
1010,1513,25-09-2019 14:04:00,1,3049.0,2161.0,0.709,14.405,35,1,0,1,34,2,32,1,0.0,0.0
1010,1514,25-09-2019 14:06:00,1,3050.0,2125.0,0.697,14.37,36,0,0,0,36,2,34,1,0.0,0.0
1010,1515,25-09-2019 14:08:00,1,2941.0,2108.0,0.717,13.921,71,10,8,2,61,21,40,3,0.0,0.0
1010,1516,25-09-2019 14:10:00,1,3056.0,2126.0,0.696,14.394,93,0,0,0,93,58,35,2,0.0,0.0
1010,1517,25-09-2019 14:12:00,1,3045.0,2143.0,0.704,14.37,32,0,0,0,32,0,32,0,0.0,0.0
1010,1518,25-09-2019 14:14:00,1,3054.0,2165.0,0.709,14.428,31,0,0,0,31,0,31,3,0.0,0.0
1010,1519,25-09-2019 14:16:00,1,3048.0,2167.0,0.711,14.408,45,14,1,13,31,5,26,2,0.0,0.0
1010,1520,25-09-2019 14:18:00,1,2929.0,2100.0,0.717,13.865,59,19,13,6,40,22,18,0,0.0,0.0
1010,1521,25-09-2019 14:20:00,1,3057.0,2144.0,0.701,14.419,27,0,0,0,27,0,27,0,0.0,0.0
1010,1522,25-09-2019 14:22:00,1,2997.0,2117.5,0.7065,14.1535,52,11,6,5,41,11,30,1,0.0,0.0
1010,1523,25-09-2019 14:24:00,1,2937.0,2091.0,0.712,13.888,30,1,0,1,29,7,22,1,0.0,0.0
1010,1524,25-09-2019 14:26:00,1,2945.0,2118.0,0.719,13.949,32,0,0,0,32,0,32,0,0.0,0.0
1010,1525,25-09-2019 14:28:00,1,3046.0,2168.0,0.712,14.404,63,12,8,4,51,18,33,1,0.0,0.0
1010,1526,25-09-2019 14:30:00,1,3056.0,2151.0,0.704,14.423,287,150,122,28,137,94,43,6,0.0,0.0
1010,1527,25-09-2019 14:32:00,1,3040.0,2210.0,0.727,14.427,284,138,87,51,146,89,57,56,0.0,0.0
1010,1528,25-09-2019 14:34:00,1,3125.0,2334.0,0.747,14.895,204,64,28,36,140,83,57,32,0.0,0.0
1010,1529,25-09-2019 14:36:00,1,3349.0,2466.0,0.736,15.924,181,52,18,34,129,69,60,46,0.0,0.0
1010,1530,25-09-2019 14:38:00,1,3550.0,2637.0,0.743,16.908,171,64,29,35,107,57,50,73,0.0,0.07
1010,1531,25-09-2019 14:40:00,1,3517.0,2790.0,0.793,16.948,526,214,168,46,312,237,75,38,0.08,0.01
1010,1532,25-09-2019 14:42:00,1,3823.0,2928.0,0.766,18.306,382,205,157,48,177,133,44,67,0.0,0.0
1010,1533,25-09-2019 14:44:00,1,3214.0,2458.0,0.765,15.385,220,105,66,39,115,68,47,95,0.0,0.0
1010,1534,25-09-2019 14:46:00,1,3839.0,2987.0,0.778,18.433,192,79,46,33,113,73,40,90,0.0,0.0
1010,1535,25-09-2019 14:48:00,1,3796.0,3096.0,0.816,18.385,667,317,257,60,350,265,85,28,0.08,0.07
1010,1536,25-09-2019 14:50:00,1,3795.0,3151.0,0.83,18.443,171,66,45,21,105,63,42,17,0.0,0.0
1010,1537,25-09-2019 14:52:00,1,2969.0,2447.0,0.824,14.408,114,19,2,17,95,58,37,0,0.0,0.0
1010,1538,25-09-2019 14:54:00,1,3011.0,2343.0,0.778,14.456,104,23,2,21,81,43,38,0,0.0,0.0
1010,1539,25-09-2019 14:56:00,1,3158.5,2489.0,0.7875,15.2,125,35,17,18,90,46,44,1,0.0,0.0
1010,1540,25-09-2019 14:58:00,1,3306.0,2635.0,0.797,15.944,133,42,14,28,91,50,41,0,0.0,0.0
1010,1541,25-09-2019 15:00:00,1,3475.0,2852.0,0.821,16.85,189,42,6,36,147,96,51,0,0.0,0.0
1010,1542,25-09-2019 15:02:00,1,3478.0,2898.0,0.833,16.913,179,42,7,35,137,83,54,0,0.0,0.0
1010,1543,25-09-2019 15:04:00,1,3685.0,2995.0,0.813,17.837,96,38,19,19,58,23,35,0,0.0,0.0
1010,1544,25-09-2019 15:06:00,1,3481.0,2908.0,0.835,16.934,51,0,0,0,51,26,25,0,0.0,0.0
1010,1545,25-09-2019 15:08:00,1,3485.0,2876.0,0.825,16.917,66,1,0,1,65,23,42,0,0.0,0.0
1010,1546,25-09-2019 15:10:00,1,3684.0,3025.0,0.821,17.864,36,0,0,0,36,2,34,0,0.0,0.0
1010,1547,25-09-2019 15:12:00,1,3699.0,3083.0,0.834,17.987,35,1,0,1,34,6,28,0,0.0,0.0
1010,1548,25-09-2019 15:14:00,1,3685.0,3045.0,0.826,17.891,37,0,0,0,37,8,29,0,0.0,0.0
1010,1549,25-09-2019 15:16:00,1,3457.0,3000.0,0.868,16.943,29,0,0,0,29,0,29,0,0.0,0.0
1010,1550,25-09-2019 15:18:00,1,3265.0,2789.0,0.854,15.954,74,11,2,9,63,26,37,0,0.0,0.0
1010,1551,25-09-2019 15:20:00,1,3279.0,2703.0,0.824,15.91,68,28,0,28,40,6,34,0,0.0,0.0
1010,1552,25-09-2019 15:22:00,1,3282.0,2706.0,0.824,15.926,37,5,0,5,32,2,30,0,0.0,0.0
1010,1553,25-09-2019 15:24:00,1,3275.0,2704.0,0.826,15.896,36,0,0,0,36,9,27,0,0.0,0.0
1010,1554,25-09-2019 15:26:00,1,3288.0,2694.0,0.819,15.937,59,3,0,3,56,18,38,0,0.0,0.0
1010,1555,25-09-2019 15:28:00,1,3275.0,2726.0,0.832,15.922,59,13,7,6,46,11,35,0,0.0,0.0
1010,1556,25-09-2019 15:30:00,1,3334.5,2733.0,0.8195,16.1645,43,8,2,6,35,11,24,0,0.0,0.0
1010,1557,25-09-2019 15:32:00,1,3394.0,2740.0,0.807,16.407,42,9,6,3,33,0,33,0,0.0,0.0
1010,1558,25-09-2019 15:34:00,1,3393.0,2716.0,0.8,16.377,57,2,0,2,55,16,39,0,0.0,0.0
1010,1559,25-09-2019 15:36:00,1,3306.0,2624.0,0.794,15.93,113,2,0,2,111,80,31,0,0.0,0.0
1010,1560,25-09-2019 15:38:00,1,3317.0,2544.0,0.767,15.885,43,2,0,2,41,11,30,0,0.0,0.0
1010,1561,25-09-2019 15:40:00,1,3318.0,2575.0,0.776,15.923,43,11,0,11,32,6,26,0,0.0,0.0
1010,1562,25-09-2019 15:42:00,1,3192.0,2511.0,0.787,15.358,45,7,2,5,38,10,28,0,0.0,0.0
1010,1563,25-09-2019 15:44:00,1,3098.0,2485.0,0.802,14.959,38,10,0,10,28,0,28,0,0.0,0.0
1010,1564,25-09-2019 15:46:00,1,2989.0,2389.0,0.799,14.42,49,13,3,10,36,6,30,0,0.0,0.0
1010,1565,25-09-2019 15:48:00,1,2993.0,2350.0,0.785,14.395,87,23,15,8,64,26,38,0,0.0,0.0
1010,1566,25-09-2019 15:50:00,1,2994.0,2380.0,0.795,14.43,41,11,7,4,30,2,28,0,0.0,0.0
1010,1567,25-09-2019 15:52:00,1,3002.0,2345.0,0.781,14.425,67,33,0,33,34,0,34,0,0.0,0.0
1010,1568,25-09-2019 15:54:00,1,3017.0,2323.0,0.77,14.459,62,31,2,29,31,1,30,0,0.0,0.0
1010,1569,25-09-2019 15:56:00,1,3011.0,2287.0,0.759,14.397,179,72,37,35,107,63,44,0,0.0,0.0
1010,1570,25-09-2019 15:58:00,1,3225.0,2481.0,0.769,15.454,274,167,119,48,107,68,39,52,0.0,0.0
1010,1571,25-09-2019 16:00:00,1,3316.0,2511.0,0.757,15.845,170,74,37,37,96,45,51,62,0.0,0.0
1010,1572,25-09-2019 16:02:00,1,3524.0,2717.0,0.771,16.894,130,37,14,23,93,50,43,55,0.0,0.0
1010,1573,25-09-2019 16:04:00,1,3502.0,2817.0,0.8045,16.9175,176,66,32,34,110,67,43,78,0.0,0.05
1010,1574,25-09-2019 16:06:00,1,3480.0,2917.0,0.838,16.941,654,371,296,75,283,215,68,58,0.0,0.03
1010,1575,25-09-2019 16:08:00,1,3396.0,2758.0,0.812,16.433,91,21,14,7,70,32,38,0,0.0,0.0
1010,1576,25-09-2019 16:10:00,1,2812.0,2153.0,0.766,13.464,32,0,0,0,32,2,30,0,0.0,0.0
1010,1577,25-09-2019 16:12:00,1,2579.0,2007.0,0.778,12.382,39,6,3,3,33,0,33,0,0.0,0.0
1010,1578,25-09-2019 16:14:00,1,2770.0,2249.0,0.812,13.404,28,1,0,1,27,0,27,0,0.0,0.0
1010,1579,25-09-2019 16:16:00,1,2987.0,2405.0,0.805,14.433,28,0,0,0,28,0,28,0,0.0,0.0
1010,1580,25-09-2019 16:18:00,1,2961.0,2473.0,0.835,14.403,55,9,3,6,46,13,33,0,0.0,0.0
1010,1581,25-09-2019 16:20:00,1,2958.0,2527.0,0.854,14.454,30,2,0,2,28,0,28,0,0.0,0.0
1010,1582,25-09-2019 16:22:00,1,3173.0,2639.0,0.832,15.423,28,1,0,1,27,0,27,0,0.0,0.0
1010,1583,25-09-2019 16:24:00,1,3265.0,2766.0,0.847,15.926,38,6,0,6,32,6,26,0,0.0,0.0
1010,1584,25-09-2019 16:26:00,1,3374.0,2851.0,0.845,16.452,23,1,0,1,22,2,20,0,0.0,0.0
1010,1585,25-09-2019 16:28:00,1,3490.0,2888.0,0.827,16.949,35,3,1,2,32,8,24,0,0.0,0.0
1010,1586,25-09-2019 16:30:00,1,3371.0,2804.0,0.832,16.386,57,3,2,1,54,22,32,0,0.0,0.0
1010,1587,25-09-2019 16:32:00,1,3256.0,2772.0,0.851,15.9,35,3,2,1,32,3,29,0,0.0,0.0
1010,1588,25-09-2019 16:34:00,1,3272.0,2739.0,0.837,15.924,38,2,0,2,36,1,35,0,0.0,0.0
1010,1589,25-09-2019 16:36:00,1,3271.0,2716.0,0.83,15.896,30,1,0,1,29,8,21,0,0.0,0.0
1010,1590,25-09-2019 16:38:00,1,3271.5,2717.0,0.8305,15.898,48,6,1,5,42,13,29,0,0.0,0.0
1010,1591,25-09-2019 16:40:00,1,3272.0,2718.0,0.831,15.9,116,24,8,16,92,51,41,0,0.0,0.0
1010,1592,25-09-2019 16:42:00,1,3382.0,2819.0,0.833,16.447,206,16,3,13,190,116,74,0,0.0,0.01
1010,1593,25-09-2019 16:44:00,1,3371.0,2841.0,0.843,16.427,131,14,2,12,117,70,47,0,0.0,0.0
1010,1594,25-09-2019 16:46:00,1,3472.0,2889.0,0.832,16.878,51,10,3,7,41,13,28,0,0.0,0.0
1010,1595,25-09-2019 16:48:00,1,3490.0,2883.0,0.826,16.944,235,26,12,14,209,164,45,0,0.0,0.0
1010,1596,25-09-2019 16:50:00,1,3473.0,2930.0,0.844,16.928,6,6,0,6,0,0,0,0,0.0,0.0
1010,1597,25-09-2019 16:52:00,1,3394.0,2795.0,0.824,16.466,62,3,0,3,59,24,35,0,0.0,0.0
1010,1598,25-09-2019 16:54:00,1,3292.0,2674.0,0.812,15.93,33,0,0,0,33,0,33,0,0.0,0.0
1010,1599,25-09-2019 16:56:00,1,3072.0,2568.0,0.836,14.946,48,3,2,1,45,7,38,0,0.0,0.0
1010,1600,25-09-2019 16:58:00,1,2953.0,2500.0,0.847,14.403,26,5,4,1,21,11,10,0,0.0,0.0
1010,1601,25-09-2019 17:00:00,1,2974.0,2479.0,0.834,14.461,40,2,0,2,38,2,36,0,0.0,0.0
1010,1602,25-09-2019 17:02:00,1,2969.0,2430.0,0.818,14.387,32,2,0,2,30,2,28,0,0.0,0.0
1010,1603,25-09-2019 17:04:00,1,2997.0,2388.0,0.797,14.453,29,1,0,1,28,4,24,0,0.0,0.0
1010,1604,25-09-2019 17:06:00,1,2997.0,2303.0,0.768,14.359,50,5,0,5,45,10,35,0,0.0,0.0
1010,1605,25-09-2019 17:08:00,1,3009.0,2317.0,0.77,14.419,30,4,0,4,26,5,21,0,0.0,0.0
1010,1606,25-09-2019 17:10:00,1,3012.0,2326.0,0.772,14.441,30,0,0,0,30,0,30,0,0.0,0.0
1010,1607,25-09-2019 17:12:00,1,3014.5,2310.0,0.766,14.4345,50,1,0,1,49,15,34,0,0.0,0.0
1010,1608,25-09-2019 17:14:00,1,3017.0,2294.0,0.76,14.428,71,12,6,6,59,22,37,0,0.0,0.0
1010,1609,25-09-2019 17:16:00,1,3022.0,2245.0,0.743,14.393,39,1,0,1,38,13,25,0,0.0,0.0
1010,1610,25-09-2019 17:18:00,1,2910.0,2211.0,0.76,13.915,34,0,0,0,34,4,30,0,0.0,0.0
1010,1611,25-09-2019 17:20:00,1,2916.0,2174.0,0.746,13.896,60,22,2,20,38,14,24,0,0.0,0.0
1010,1612,25-09-2019 17:22:00,1,2801.0,2168.0,0.774,13.438,34,9,2,7,25,1,24,0,0.0,0.0
1010,1613,25-09-2019 17:24:00,1,2802.0,2159.0,0.77,13.43,54,13,4,9,41,13,28,0,0.0,0.0
1010,1614,25-09-2019 17:26:00,1,3039.0,2202.0,0.725,14.414,37,7,1,6,30,2,28,0,0.0,0.0
1010,1615,25-09-2019 17:28:00,1,3035.0,2187.0,0.721,14.379,42,0,0,0,42,17,25,0,0.0,0.0
1010,1616,25-09-2019 17:30:00,1,3037.0,2209.0,0.727,14.411,67,0,0,0,67,34,33,0,0.0,0.0
1010,1617,25-09-2019 17:32:00,1,3037.0,2216.0,0.73,14.419,164,52,39,13,112,66,46,18,0.0,0.0
1010,1618,25-09-2019 17:34:00,1,3248.0,2376.0,0.731,15.43,139,53,21,32,86,40,46,56,0.0,0.0
1010,1619,25-09-2019 17:36:00,1,3548.0,2646.0,0.746,16.908,185,63,33,30,122,77,45,57,0.0,0.02
1010,1620,25-09-2019 17:38:00,1,3622.0,2818.0,0.778,17.391,236,133,100,33,103,61,42,65,0.0,0.08
1010,1621,25-09-2019 17:40:00,1,3327.0,2550.0,0.766,15.932,275,134,96,38,141,95,46,64,0.0,0.0
1010,1622,25-09-2019 17:42:00,1,2979.0,2379.0,0.798,14.373,125,29,10,19,96,49,47,0,0.0,0.01
1010,1623,25-09-2019 17:44:00,1,2907.0,2217.0,0.763,13.907,52,5,0,5,47,16,31,0,0.0,0.0
1010,1624,25-09-2019 17:46:00,1,3161.0,2443.0,0.7725,15.1585,75,13,6,7,62,33,29,0,0.0,0.0
1010,1625,25-09-2019 17:48:00,1,3415.0,2669.0,0.782,16.41,28,0,0,0,28,6,22,0,0.0,0.0
1010,1626,25-09-2019 17:50:00,1,3520.0,2719.0,0.772,16.88,29,1,1,0,28,2,26,0,0.0,0.0
1010,1627,25-09-2019 17:52:00,1,3498.0,2769.0,0.792,16.847,25,0,0,0,25,0,25,0,0.0,0.0
1010,1628,25-09-2019 17:54:00,1,3510.0,2752.0,0.784,16.877,82,12,7,5,70,34,36,0,0.0,0.0
1010,1629,25-09-2019 17:56:00,1,3267.0,2731.0,0.836,15.896,59,0,0,0,59,32,27,1,0.0,0.0
1010,1630,25-09-2019 17:58:00,1,3275.0,2754.0,0.841,15.952,30,0,0,0,30,8,22,0,0.0,0.01
1010,1631,25-09-2019 18:00:00,0,3265.0,2747.0,0.841,15.908,27,2,1,1,25,2,23,4,0.0,0.0
1010,1632,25-09-2019 18:02:00,0,3277.0,2732.0,0.834,15.936,36,0,0,0,36,8,28,17,0.0,0.0
1010,1633,25-09-2019 18:04:00,0,3264.0,2761.0,0.846,15.918,134,55,33,22,79,35,44,14,0.0,0.0
1010,1634,25-09-2019 18:06:00,0,3467.0,2966.0,0.856,16.943,103,40,14,26,63,27,36,19,0.0,0.0
1010,1635,25-09-2019 18:08:00,0,3690.0,3093.0,0.838,17.964,196,65,26,39,131,83,48,7,0.0,0.0
1010,1636,25-09-2019 18:10:00,0,3779.0,3203.0,0.847,18.435,606,362,285,77,244,187,57,105,0.0,0.0
1010,1637,25-09-2019 18:12:00,0,3767.0,3271.0,0.868,18.463,312,172,136,36,140,103,37,129,0.0,0.0
1010,1638,25-09-2019 18:14:00,0,3953.0,3466.0,0.877,19.413,272,121,80,41,151,101,50,68,0.0,0.0
1010,1639,25-09-2019 18:16:00,0,3974.0,3447.0,0.867,19.475,352,173,137,36,179,139,40,83,0.0,0.02
1010,1640,25-09-2019 18:18:00,0,3747.0,3252.0,0.868,18.364,338,174,140,34,164,129,35,127,0.0,0.0
1010,1641,25-09-2019 18:20:00,0,3806.0,3297.0,0.8665,18.6455,105,44,27,17,61,41,20,74,0.0,0.0
1010,1642,25-09-2019 18:22:00,0,3865.0,3342.0,0.865,18.927,410,220,180,40,190,144,46,53,0.0,0.01
1010,1643,25-09-2019 18:24:00,0,3633.0,3248.0,0.894,17.909,243,105,68,37,138,91,47,79,0.0,0.0
1010,1644,25-09-2019 18:26:00,0,4147.0,3648.0,0.88,20.379,233,78,44,34,155,101,54,51,0.0,0.02
1010,1645,25-09-2019 18:28:00,0,4128.0,3704.0,0.897,20.366,222,123,83,40,99,56,43,74,0.0,0.05
1010,1646,25-09-2019 18:30:00,0,4350.0,3891.0,0.894,21.447,201,103,68,35,98,65,33,59,0.07,0.04
1010,1647,25-09-2019 18:32:00,0,3640.0,3245.0,0.891,17.935,200,115,99,16,85,68,17,95,0.01,0.02
1010,1648,25-09-2019 18:34:00,0,4150.0,3656.0,0.881,20.397,303,177,141,36,126,91,35,139,0.08,0.15
1010,1649,25-09-2019 18:36:00,0,4298.0,4003.0,0.931,21.365,388,224,171,53,164,129,35,81,0.01,0.03
1010,1650,25-09-2019 18:38:00,0,3939.0,3538.0,0.898,19.437,358,154,118,36,204,157,47,78,0.0,0.0
1010,1651,25-09-2019 18:40:00,0,3062.0,2588.0,0.845,14.93,148,26,7,19,122,73,49,0,0.0,0.0
1010,1652,25-09-2019 18:42:00,0,2754.0,2323.0,0.843,13.423,207,30,6,24,177,114,63,1,0.0,0.0
1010,1653,25-09-2019 18:44:00,0,3470.0,2964.0,0.854,16.956,173,25,0,25,148,100,48,0,0.0,0.0
1010,1654,25-09-2019 18:46:00,0,4373.0,3803.0,0.87,21.441,236,20,1,19,216,147,69,0,0.01,0.0
1010,1655,25-09-2019 18:48:00,0,4346.0,3833.0,0.882,21.368,168,31,9,22,137,83,54,0,0.0,0.0
1010,1656,25-09-2019 18:50:00,0,4332.0,3924.0,0.906,21.414,179,63,38,25,116,67,49,14,0.0,0.0
1010,1657,25-09-2019 18:52:00,0,4627.0,4262.0,0.921,22.947,187,85,52,33,102,62,40,91,0.0,0.0
1010,1658,25-09-2019 18:54:00,0,4665.0,4370.5,0.9365,23.2175,274,142,93,49,132,84,48,79,0.0,0.0
1010,1659,25-09-2019 18:56:00,0,4703.0,4479.0,0.952,23.488,213,90,54,36,123,73,50,51,0.0,0.0
1010,1660,25-09-2019 18:58:00,0,4597.0,4346.0,0.945,22.922,126,41,22,19,85,55,30,36,0.12,0.0
1010,1661,25-09-2019 19:00:00,0,4025.0,3696.0,0.918,19.949,144,71,52,19,73,61,12,61,0.0,0.0
1010,1662,25-09-2019 19:02:00,0,4013.0,3722.0,0.928,19.933,556,317,253,64,239,189,50,160,0.0,0.0
1010,1663,25-09-2019 19:04:00,0,4019.0,3709.0,0.923,19.942,394,180,135,45,214,150,64,77,0.0,0.0
1010,1664,25-09-2019 19:06:00,0,4689.0,4426.0,0.944,23.374,234,116,75,41,118,70,48,63,0.0,0.0
1010,1665,25-09-2019 19:08:00,0,4686.0,4482.0,0.957,23.425,195,111,72,39,84,36,48,51,0.0,0.05
1010,1666,25-09-2019 19:10:00,0,4482.0,4319.0,0.964,22.442,237,116,67,49,121,73,48,9,0.14,0.07
1010,1667,25-09-2019 19:12:00,0,3295.0,3090.0,0.938,16.404,187,47,20,27,140,86,54,0,0.0,0.0
1010,1668,25-09-2019 19:14:00,0,2707.0,2493.0,0.921,13.425,145,18,9,9,127,69,58,0,0.0,0.01
1010,1669,25-09-2019 19:16:00,0,2520.0,2294.0,0.91,12.47,53,1,0,1,52,15,37,0,0.0,0.0
1010,1670,25-09-2019 19:18:00,0,2545.0,2176.0,0.855,12.437,50,6,0,6,44,4,40,0,0.0,0.0
1010,1671,25-09-2019 19:20:00,0,2524.0,2230.0,0.884,12.413,55,13,2,11,42,2,40,0,0.0,0.0
1010,1672,25-09-2019 19:22:00,0,2741.0,2384.0,0.87,13.437,56,16,3,13,40,0,40,0,0.0,0.0
1010,1673,25-09-2019 19:24:00,0,2733.0,2459.0,0.9,13.489,53,16,9,7,37,0,37,0,0.0,0.0
1010,1674,25-09-2019 19:26:00,0,2823.0,2547.0,0.902,13.942,45,4,1,3,41,0,41,0,0.0,0.0
1010,1675,25-09-2019 19:28:00,0,3702.5,3462.0,0.9285,18.421,241,105,62,43,136,76,60,17,0.0,0.0
1010,1676,25-09-2019 19:30:00,0,4582.0,4377.0,0.955,22.9,200,90,57,33,110,65,45,87,0.0,0.01
1010,1677,25-09-2019 19:32:00,0,4953.0,4862.0,0.982,24.899,236,117,69,48,119,76,43,75,0.0,0.01
1010,1678,25-09-2019 19:34:00,0,4964.0,4877.0,0.982,24.958,265,148,108,40,117,79,38,66,0.03,0.09
1010,1679,25-09-2019 19:36:00,0,4575.0,4486.0,0.981,22.991,261,105,86,19,156,106,50,59,0.1,0.0
1010,1680,25-09-2019 19:38:00,0,4154.0,4060.0,0.978,20.86,114,71,61,10,43,32,11,139,0.0,0.0
1010,1681,25-09-2019 19:40:00,0,4674.0,4533.0,0.97,23.432,381,260,210,50,121,95,26,174,0.0,0.03
1010,1682,25-09-2019 19:42:00,0,4748.0,4728.0,0.996,23.939,301,200,149,51,101,61,40,15,0.05,0.0
1010,1683,25-09-2019 19:44:00,0,4482.0,4353.0,0.971,22.478,184,112,81,31,72,43,29,86,0.01,0.0
1010,1684,25-09-2019 19:46:00,0,3994.0,3824.0,0.958,19.97,328,120,77,43,208,147,61,58,0.0,0.0
1010,1685,25-09-2019 19:48:00,0,3290.0,3120.0,0.948,16.416,160,42,23,19,118,57,61,0,0.0,0.0
1010,1686,25-09-2019 19:50:00,0,3026.0,2725.0,0.901,14.939,166,45,19,26,121,66,55,0,0.0,0.0
1010,1687,25-09-2019 19:52:00,0,3996.0,3718.0,0.93,19.862,203,93,51,42,110,63,47,0,0.0,0.0
1010,1688,25-09-2019 19:54:00,0,4761.0,4678.0,0.983,23.936,70,20,3,17,50,10,40,0,0.0,0.0
1010,1689,25-09-2019 19:56:00,0,4260.0,4164.0,0.978,21.392,55,12,2,10,43,8,35,0,0.0,0.0
1010,1690,25-09-2019 19:58:00,0,4396.0,4209.0,0.958,21.98,59,10,0,10,49,8,41,0,0.0,0.0
1010,1691,25-09-2019 20:00:00,0,4478.0,4290.0,0.958,22.391,45,2,1,1,43,7,36,0,0.0,0.0
1010,1692,25-09-2019 20:02:00,0,4366.0,4220.5,0.967,21.8745,53,13,2,11,40,6,34,0,0.0,0.0
1010,1693,25-09-2019 20:04:00,0,4254.0,4151.0,0.976,21.358,131,30,15,15,101,50,51,7,0.0,0.0
1010,1694,25-09-2019 20:06:00,0,4098.0,3907.0,0.953,20.473,243,123,86,37,120,67,53,89,0.0,0.0
1010,1695,25-09-2019 20:08:00,0,4288.0,4071.0,0.949,21.402,183,84,44,40,99,50,49,70,0.0,0.04
1010,1696,25-09-2019 20:10:00,0,4508.0,4231.0,0.938,22.444,207,111,70,41,96,42,54,69,0.0,0.04
1010,1697,25-09-2019 20:12:00,0,4387.0,4233.0,0.965,21.972,149,64,36,28,85,41,44,22,0.0,0.11
1010,1698,25-09-2019 20:14:00,0,4579.0,4453.0,0.972,22.973,255,120,91,29,135,92,43,43,0.12,0.0
1010,1699,25-09-2019 20:16:00,0,4122.0,3827.0,0.928,20.475,263,129,101,28,134,98,36,33,0.0,0.01
1010,1700,25-09-2019 20:18:00,0,3994.0,3737.0,0.936,19.874,140,90,62,28,50,27,23,101,0.0,0.01
1010,1701,25-09-2019 20:20:00,0,4509.0,4195.0,0.93,22.41,231,119,97,22,112,84,28,90,0.1,0.0
1010,1702,25-09-2019 20:22:00,0,4378.0,4157.0,0.95,21.85,168,64,40,24,104,53,51,61,0.0,0.04
1010,1703,25-09-2019 20:24:00,0,4602.0,4334.0,0.942,22.93,173,74,44,30,99,51,48,68,0.0,0.05
1010,1704,25-09-2019 20:26:00,0,4595.0,4417.0,0.961,22.993,188,88,53,35,100,52,48,49,0.0,0.06
1010,1705,25-09-2019 20:28:00,0,4613.0,4324.0,0.937,22.962,344,138,105,33,206,152,54,29,0.05,0.02
1010,1706,25-09-2019 20:30:00,0,4187.0,3975.0,0.949,20.898,303,181,145,36,122,95,27,181,0.0,0.0
1010,1707,25-09-2019 20:32:00,0,4073.0,3914.0,0.961,20.381,318,180,140,40,138,103,35,133,0.0,0.0
1010,1708,25-09-2019 20:34:00,0,4684.0,4404.0,0.94,23.328,192,90,64,26,102,66,36,15,0.05,0.0
1010,1709,25-09-2019 20:36:00,0,4142.0,3904.5,0.943,20.641,201,37,22,15,164,116,48,0,0.0,0.0
1010,1710,25-09-2019 20:38:00,0,3600.0,3405.0,0.946,17.954,43,0,0,0,43,2,41,0,0.0,0.0
1010,1711,25-09-2019 20:40:00,0,3589.0,3347.0,0.933,17.845,77,14,9,5,63,18,45,0,0.0,0.0
1010,1712,25-09-2019 20:42:00,0,3487.0,3319.0,0.952,17.414,45,5,2,3,40,6,34,0,0.0,0.0
1010,1713,25-09-2019 20:44:00,0,3600.0,3391.0,0.942,17.937,33,2,0,2,31,2,29,0,0.0,0.0
1010,1714,25-09-2019 20:46:00,0,3596.0,3405.0,0.947,17.938,54,11,6,5,43,11,32,0,0.0,0.0
1010,1715,25-09-2019 20:48:00,0,3507.0,3298.0,0.94,17.468,19,5,2,3,14,1,13,0,0.0,0.0
1010,1716,25-09-2019 20:50:00,0,3479.0,3384.0,0.973,17.454,58,4,0,4,54,8,46,0,0.0,0.0
1010,1717,25-09-2019 20:52:00,0,3575.0,3490.0,0.976,17.951,47,7,4,3,40,8,32,0,0.0,0.0
1010,1718,25-09-2019 20:54:00,0,3675.0,3536.0,0.962,18.393,64,13,2,11,51,4,47,0,0.0,0.0
1010,1719,25-09-2019 20:56:00,0,3661.0,3566.0,0.974,18.37,48,11,0,11,37,0,37,0,0.0,0.0
1010,1720,25-09-2019 20:58:00,0,3446.0,3489.0,1.013,17.44,98,32,21,11,66,21,45,1,0.0,0.0
1010,1721,25-09-2019 21:00:00,0,3447.0,3483.0,1.01,17.437,245,104,64,40,141,80,61,27,0.0,0.0
1010,1722,25-09-2019 21:02:00,0,3565.0,3501.0,0.982,17.923,214,72,38,34,142,89,53,76,0.0,0.01
1010,1723,25-09-2019 21:04:00,0,3881.0,3760.0,0.969,19.452,183,75,40,35,108,55,53,68,0.0,0.02
1010,1724,25-09-2019 21:06:00,0,3964.0,3922.0,0.989,19.96,208,85,50,35,123,73,50,60,0.0,0.13
1010,1725,25-09-2019 21:08:00,0,4175.0,4044.0,0.968,20.928,201,104,78,26,97,55,42,45,0.13,0.0
1010,1726,25-09-2019 21:10:00,0,3728.5,3625.5,0.9725,18.7045,380,166,133,33,214,163,51,58,0.0,0.0
1010,1727,25-09-2019 21:12:00,0,3282.0,3207.0,0.977,16.481,212,48,23,25,164,98,66,3,0.0,0.0
1010,1728,25-09-2019 21:14:00,0,3468.0,3396.0,0.979,17.425,238,38,8,30,200,131,69,0,0.0,0.0
1010,1729,25-09-2019 21:16:00,0,3956.0,3927.0,0.993,19.932,241,81,46,35,160,99,61,20,0.0,0.0
1010,1730,25-09-2019 21:18:00,0,4365.0,4295.0,0.984,21.955,285,160,128,32,125,99,26,177,0.0,0.0
1010,1731,25-09-2019 21:20:00,0,4138.0,4147.0,1.002,20.896,210,78,39,39,132,81,51,70,0.0,0.03
1010,1732,25-09-2019 21:22:00,0,4459.0,4401.0,0.987,22.439,74,20,11,9,54,14,40,11,0.0,0.37
1010,1733,25-09-2019 21:24:00,0,4249.0,4230.0,0.996,21.423,40,0,0,0,40,0,40,0,0.0,0.0
1010,1734,25-09-2019 21:26:00,0,4263.0,4211.0,0.988,21.457,34,3,2,1,31,0,31,0,0.0,0.0
1010,1735,25-09-2019 21:28:00,0,4364.0,4228.0,0.969,21.874,266,103,84,19,163,109,54,41,0.13,0.0
1010,1736,25-09-2019 21:30:00,0,4441.0,4412.0,0.993,22.383,390,168,121,47,222,171,51,15,0.01,0.0
1010,1737,25-09-2019 21:32:00,0,3971.0,3837.0,0.966,19.893,311,175,142,33,136,98,38,76,0.0,0.0
1010,1738,25-09-2019 21:34:00,0,4492.0,4310.0,0.959,22.47,43,0,0,0,43,0,43,7,0.01,0.01
1010,1739,25-09-2019 21:36:00,0,4447.0,4398.0,0.989,22.39,225,87,55,32,138,81,57,0,0.16,0.0
1010,1740,25-09-2019 21:38:00,0,4148.0,4143.0,0.999,20.929,87,29,2,27,58,13,45,1,0.0,0.0
1010,1741,25-09-2019 21:40:00,0,3494.0,3339.0,0.956,17.461,112,11,2,9,101,60,41,0,0.0,0.0
1010,1742,25-09-2019 21:42:00,0,3775.0,3654.0,0.968,18.919,36,0,0,0,36,0,36,0,0.0,0.0
1010,1743,25-09-2019 21:44:00,0,3870.0,3738.5,0.966,19.3875,43,5,0,5,38,2,36,1,0.0,0.0
1010,1744,25-09-2019 21:46:00,0,3965.0,3823.0,0.964,19.856,49,1,0,1,48,0,48,0,0.0,0.0
1010,1745,25-09-2019 21:48:00,0,3965.0,3892.0,0.982,19.931,50,6,0,6,44,5,39,0,0.0,0.0
1010,1746,25-09-2019 21:50:00,0,3984.0,3821.0,0.959,19.928,81,32,23,9,49,16,33,0,0.0,0.0
1010,1747,25-09-2019 21:52:00,0,3874.0,3762.0,0.971,19.429,39,1,0,1,38,2,36,0,0.0,0.0
1010,1748,25-09-2019 21:54:00,0,3657.0,3656.0,1.0,18.456,48,3,1,2,45,0,45,0,0.0,0.0
1010,1749,25-09-2019 21:56:00,0,3676.0,3561.0,0.969,18.425,48,2,1,1,46,0,46,0,0.0,0.0
1010,1750,25-09-2019 21:58:00,0,3461.0,3448.0,0.996,17.452,38,2,1,1,36,0,36,2,0.0,0.0
1010,1751,25-09-2019 22:00:00,0,3492.0,3304.0,0.946,17.418,55,22,12,10,33,2,31,6,0.0,0.0
1010,1752,25-09-2019 22:02:00,0,3274.0,3219.0,0.983,16.464,16,13,7,6,3,1,2,2,0.0,0.0
1010,1753,25-09-2019 22:04:00,0,3158.0,3166.0,1.003,15.946,214,5,2,3,209,191,18,6,0.0,0.0
1010,1754,25-09-2019 22:06:00,0,3159.0,3179.0,1.006,15.964,169,8,2,6,161,138,23,7,0.0,0.0
1010,1755,25-09-2019 22:08:00,0,3156.0,3144.0,0.996,15.916,202,72,41,31,130,82,48,25,0.0,0.0
1010,1756,25-09-2019 22:10:00,0,3378.0,3279.0,0.971,16.939,363,123,95,28,240,181,59,39,0.0,0.0
1010,1757,25-09-2019 22:12:00,0,3376.0,3300.0,0.977,16.954,210,88,63,25,122,91,31,72,0.0,0.0
1010,1758,25-09-2019 22:14:00,0,3446.0,3483.0,1.011,17.433,346,153,112,41,193,136,57,25,0.0,0.0
1010,1759,25-09-2019 22:16:00,0,3458.0,3466.0,1.002,17.461,159,30,12,18,129,82,47,16,0.0,0.0
1010,1760,25-09-2019 22:18:00,0,3553.5,3560.5,1.002,17.9415,126,19,8,11,107,59,48,15,0.0,0.0
1010,1761,25-09-2019 22:20:00,0,3649.0,3655.0,1.002,18.422,248,62,36,26,186,127,59,32,0.0,0.01
1010,1762,25-09-2019 22:22:00,0,3665.0,3596.0,0.981,18.421,142,66,27,39,76,34,42,17,0.0,0.04
1010,1763,25-09-2019 22:24:00,0,3755.0,3773.0,1.005,18.973,298,113,79,34,185,133,52,66,0.0,0.0
1010,1764,25-09-2019 22:26:00,0,3655.0,3632.0,0.994,18.421,366,217,166,51,149,112,37,69,0.0,0.05
1010,1765,25-09-2019 22:28:00,0,3745.0,3739.0,0.998,18.895,217,94,65,29,123,82,41,96,0.09,0.0
1010,1766,25-09-2019 22:30:00,0,3657.0,3673.0,1.004,18.475,153,49,27,22,104,54,50,55,0.0,0.0
1010,1767,25-09-2019 22:32:00,0,3996.0,3824.0,0.957,19.979,191,78,46,32,113,68,45,73,0.0,0.0
1010,1768,25-09-2019 22:34:00,0,3942.0,3916.0,0.993,19.868,444,203,156,47,241,175,66,30,0.14,0.03
1010,1769,25-09-2019 22:36:00,0,4371.0,4270.0,0.977,21.95,413,218,175,43,195,147,48,115,0.0,0.0
1010,1770,25-09-2019 22:38:00,0,4057.0,3999.0,0.986,20.41,321,188,148,40,133,103,30,116,0.0,0.0
1010,1771,25-09-2019 22:40:00,0,3649.0,3695.0,1.013,18.467,351,196,169,27,155,130,25,189,0.09,0.0
1010,1772,25-09-2019 22:42:00,0,3951.0,3942.0,0.998,19.929,389,244,198,46,145,117,28,112,0.0,0.0
1010,1773,25-09-2019 22:44:00,0,4003.0,3762.0,0.94,19.937,179,97,69,28,82,53,29,66,0.0,0.0
1010,1774,25-09-2019 22:46:00,0,4142.0,4139.0,0.999,20.902,339,183,125,58,156,110,46,50,0.0,0.0
1010,1775,25-09-2019 22:48:00,0,3966.0,3906.0,0.985,19.95,195,97,59,38,98,51,47,89,0.0,0.0
1010,1776,25-09-2019 22:50:00,0,4470.0,4335.0,0.97,22.409,187,100,61,39,87,49,38,76,0.0,0.0
1010,1777,25-09-2019 22:52:00,0,4465.0,4349.0,0.974,22.407,170,80,45,35,90,51,39,76,0.0,0.1
1010,1778,25-09-2019 22:54:00,0,4460.0,4363.0,0.978,22.405,291,152,112,40,139,89,50,53,0.08,0.06
1010,1779,25-09-2019 22:56:00,0,3991.0,3805.0,0.953,19.936,195,81,41,40,114,58,56,0,0.0,0.0
1010,1780,25-09-2019 22:58:00,0,3212.0,2959.0,0.921,15.93,149,66,33,33,83,43,40,0,0.0,0.0
1010,1781,25-09-2019 23:00:00,0,3182.0,3053.0,0.959,15.918,106,24,6,18,82,37,45,0,0.0,0.0
1010,1782,25-09-2019 23:02:00,0,3712.0,3384.0,0.912,18.371,154,46,22,24,108,58,50,0,0.0,0.0
1010,1783,25-09-2019 23:04:00,0,4018.0,3725.0,0.927,19.955,35,0,0,0,35,4,31,0,0.0,0.0
1010,1784,25-09-2019 23:06:00,0,3998.0,3760.0,0.941,19.914,45,0,0,0,45,4,41,0,0.0,0.0
1010,1785,25-09-2019 23:08:00,0,4000.0,3776.0,0.944,19.943,41,1,0,1,40,3,37,0,0.0,0.0
1010,1786,25-09-2019 23:10:00,0,3972.0,3844.0,0.968,19.907,48,0,0,0,48,2,46,0,0.0,0.0
1010,1787,25-09-2019 23:12:00,0,3976.0,3818.0,0.96,19.891,81,22,12,10,59,19,40,0,0.0,0.0
1010,1788,25-09-2019 23:14:00,0,3997.0,3770.0,0.943,19.923,229,6,0,6,223,191,32,0,0.0,0.0
1010,1789,25-09-2019 23:16:00,0,3651.0,3656.0,1.001,18.433,22,3,0,3,19,11,8,0,0.0,0.0
1010,1790,25-09-2019 23:18:00,0,3671.0,3635.0,0.99,18.487,9,2,0,2,7,1,6,0,0.0,0.0
1010,1791,25-09-2019 23:20:00,0,3665.0,3603.0,0.983,18.428,19,1,1,0,18,0,18,0,0.0,0.0
1010,1792,25-09-2019 23:22:00,0,3568.0,3503.0,0.982,17.937,7,3,1,2,4,0,4,0,0.0,0.0
1010,1793,25-09-2019 23:24:00,0,3447.0,3470.0,1.007,17.422,100,49,24,25,51,27,24,0,0.0,0.0
1010,1794,25-09-2019 23:26:00,0,3554.0,3561.0,1.0025,17.9455,277,120,89,31,157,113,44,61,0.0,0.0
1010,1795,25-09-2019 23:28:00,0,3661.0,3652.0,0.998,18.469,346,152,105,47,194,139,55,73,0.0,0.0
1010,1796,25-09-2019 23:30:00,0,3677.0,3633.0,0.988,18.509,173,74,39,35,99,46,53,93,0.0,0.0
1010,1797,25-09-2019 23:32:00,0,3961.0,3838.0,0.969,19.854,169,73,38,35,96,54,42,70,0.0,0.05
1010,1798,25-09-2019 23:34:00,0,3936.0,3964.0,1.007,19.896,136,62,32,30,74,43,31,63,0.0,0.09
1010,1799,25-09-2019 23:36:00,0,4077.0,3984.0,0.977,20.475,420,180,134,46,240,171,69,16,0.17,0.02
1010,1800,25-09-2019 23:38:00,0,3658.0,3636.0,0.994,18.439,1187,592,495,97,595,487,108,2,0.0,0.07
1010,1801,25-09-2019 23:40:00,0,4160.0,4136.0,0.994,20.969,356,187,148,39,169,131,38,79,0.0,0.01
1010,1802,25-09-2019 23:42:00,0,3655.0,3686.0,1.009,18.481,243,128,83,45,115,66,49,76,0.0,0.0
1010,1803,25-09-2019 23:44:00,0,4127.0,4215.0,1.021,20.926,256,129,98,31,127,89,38,53,0.0,0.0
1010,1804,25-09-2019 23:46:00,0,3571.0,3444.0,0.965,17.883,275,141,107,34,134,104,30,28,0.0,0.0
1010,1805,25-09-2019 23:48:00,0,4153.0,4112.0,0.99,20.915,218,120,93,27,98,67,31,87,0.0,0.0
1010,1806,25-09-2019 23:50:00,0,4424.0,4454.0,1.007,22.36,325,156,109,47,169,118,51,30,0.05,0.0
1010,1807,25-09-2019 23:52:00,0,3967.0,3800.0,0.958,19.838,160,60,27,33,100,59,41,1,0.01,0.0
1010,1808,25-09-2019 23:54:00,0,3410.0,3168.0,0.929,16.942,121,51,19,32,70,31,39,0,0.0,0.0
1010,1809,25-09-2019 23:56:00,0,3995.0,3789.0,0.948,19.933,84,10,6,4,74,31,43,0,0.0,0.0
1010,1810,25-09-2019 23:58:00,0,3664.0,3586.0,0.979,18.405,30,0,0,0,30,2,28,0,0.0,0.0
1010,1811,26-09-2019 00:00:00,0,3773.0,3663.5,0.9715,18.9215,52,4,1,3,48,14,34,0,0.0,0.0
1010,1812,26-09-2019 00:02:00,0,3882.0,3741.0,0.964,19.438,46,8,1,7,38,11,27,0,0.0,0.0
1010,1813,26-09-2019 00:04:00,0,3640.0,3697.0,1.016,18.436,43,6,0,6,37,8,29,0,0.0,0.0
1010,1814,26-09-2019 00:06:00,0,3679.0,3635.0,0.988,18.518,96,20,12,8,76,40,36,0,0.0,0.0
1010,1815,26-09-2019 00:08:00,0,3678.0,3563.0,0.969,18.437,139,7,2,5,132,83,49,0,0.0,0.0
1010,1816,26-09-2019 00:10:00,0,3482.0,3368.0,0.967,17.449,82,0,0,0,82,45,37,0,0.0,0.0
1010,1817,26-09-2019 00:12:00,0,3187.0,3056.0,0.959,15.94,64,0,0,0,64,26,38,0,0.0,0.0
1010,1818,26-09-2019 00:14:00,0,2991.0,2873.0,0.961,14.963,32,0,0,0,32,4,28,0,0.0,0.0
1010,1819,26-09-2019 00:16:00,0,2992.0,2781.0,0.929,14.869,32,1,0,1,31,0,31,0,0.0,0.0
1010,1820,26-09-2019 00:18:00,0,3012.0,2798.0,0.929,14.965,33,0,0,0,33,7,26,0,0.0,0.0
1010,1821,26-09-2019 00:20:00,0,2994.0,2847.0,0.951,14.947,49,3,1,2,46,17,29,16,0.0,0.0
1010,1822,26-09-2019 00:22:00,0,3199.0,2999.0,0.938,15.924,219,45,23,22,174,112,62,20,0.0,0.0
1010,1823,26-09-2019 00:24:00,0,3476.0,3429.0,0.987,17.49,217,98,68,30,119,70,49,96,0.0,0.0
1010,1824,26-09-2019 00:26:00,0,3673.0,3538.0,0.963,18.388,187,82,52,30,105,57,48,82,0.0,0.0
1010,1825,26-09-2019 00:28:00,0,3994.0,3815.0,0.955,19.959,158,67,36,31,91,44,47,77,0.0,0.07
1010,1826,26-09-2019 00:30:00,0,3967.0,3880.0,0.978,19.924,176,71,38,33,105,51,54,62,0.0,0.05
1010,1827,26-09-2019 00:32:00,0,3942.0,3984.0,1.011,19.941,93,38,24,14,55,25,30,51,0.0,0.03
1010,1828,26-09-2019 00:34:00,0,3793.0,3838.5,1.012,19.1935,198,92,73,19,106,84,22,22,0.0,0.01
1010,1829,26-09-2019 00:36:00,0,3644.0,3693.0,1.013,18.446,273,124,91,33,149,105,44,66,0.1,0.03
1010,1830,26-09-2019 00:38:00,0,3952.0,3948.0,0.999,19.941,147,86,64,22,61,50,11,128,0.02,0.0
1010,1831,26-09-2019 00:40:00,0,3988.0,3831.0,0.961,19.954,240,118,87,31,122,79,43,95,0.0,0.0
1010,1832,26-09-2019 00:42:00,0,4178.0,4074.0,0.975,20.973,142,57,22,35,85,42,43,59,0.01,0.0
1010,1833,26-09-2019 00:44:00,0,4479.0,4306.0,0.961,22.416,116,50,25,25,66,29,37,52,0.0,0.09
1010,1834,26-09-2019 00:46:00,0,4480.0,4302.0,0.96,22.412,288,129,92,37,159,116,43,38,0.09,0.02
1010,1835,26-09-2019 00:48:00,0,3978.0,3818.0,0.96,19.899,302,223,189,34,79,60,19,211,0.01,0.01
1010,1836,26-09-2019 00:50:00,0,3965.0,3922.0,0.989,19.963,307,203,149,54,104,75,29,34,0.01,0.06
1010,1837,26-09-2019 00:52:00,0,4645.0,4665.0,1.004,23.466,219,105,78,27,114,80,34,53,0.07,0.0
1010,1838,26-09-2019 00:54:00,0,4547.0,4589.0,1.009,22.996,266,122,92,30,144,113,31,33,0.0,0.0
1010,1839,26-09-2019 00:56:00,0,3500.0,3294.0,0.941,17.438,127,32,11,21,95,51,44,3,0.0,0.0
1010,1840,26-09-2019 00:58:00,0,3220.0,2954.0,0.917,15.956,20,12,4,8,8,2,6,1,0.0,0.0
1010,1841,26-09-2019 01:00:00,0,3322.0,3048.0,0.918,16.461,164,71,34,37,93,49,44,13,0.0,0.0
1010,1842,26-09-2019 01:02:00,0,4572.0,4445.0,0.972,22.936,221,84,37,47,137,83,54,13,0.0,0.0
1010,1843,26-09-2019 01:04:00,0,4486.0,4279.0,0.954,22.41,85,42,20,22,43,12,31,17,0.0,0.0
1010,1844,26-09-2019 01:06:00,0,4158.0,4144.0,0.997,20.971,25,0,0,0,25,0,25,15,0.0,0.0
1010,1845,26-09-2019 01:08:00,0,4071.5,4004.5,0.9835,20.4755,57,21,11,10,36,10,26,16,0.0,0.0
1010,1846,26-09-2019 01:10:00,0,3985.0,3865.0,0.97,19.98,11,0,0,0,11,0,11,14,0.0,0.0
1010,1847,26-09-2019 01:12:00,0,3983.0,3799.0,0.954,19.899,41,3,0,3,38,0,38,17,0.0,0.0
1010,1848,26-09-2019 01:14:00,0,3885.0,3762.0,0.969,19.47,55,11,1,10,44,3,41,25,0.0,0.0
1010,1849,26-09-2019 01:16:00,0,3660.0,3580.0,0.978,18.382,34,3,0,3,31,5,26,19,0.0,0.0
1010,1850,26-09-2019 01:18:00,0,3458.0,3466.0,1.002,17.462,3,0,0,0,3,0,3,12,0.0,0.0
1010,1851,26-09-2019 01:20:00,0,3487.0,3309.0,0.949,17.403,31,13,6,7,18,8,10,17,0.0,0.0
1010,1852,26-09-2019 01:22:00,0,3390.0,3243.0,0.957,16.947,72,20,14,6,52,25,27,6,0.0,0.0
1010,1853,26-09-2019 01:24:00,0,3473.0,3378.0,0.972,17.425,27,0,0,0,27,2,25,19,0.0,0.0
1010,1854,26-09-2019 01:26:00,0,3494.0,3358.0,0.961,17.484,30,2,0,2,28,4,24,13,0.0,0.0
1010,1855,26-09-2019 01:28:00,0,3368.0,3257.0,0.967,16.875,23,0,0,0,23,0,23,20,0.0,0.0
1010,1856,26-09-2019 01:30:00,0,3164.0,3140.0,0.992,15.942,34,3,0,3,31,2,29,14,0.0,0.0
1010,1857,26-09-2019 01:32:00,0,3192.0,3019.0,0.946,15.919,65,17,10,7,48,8,40,10,0.0,0.0
1010,1858,26-09-2019 01:34:00,0,3075.0,2995.0,0.974,15.432,48,8,5,3,40,9,31,8,0.0,0.0
1010,1859,26-09-2019 01:36:00,0,2970.0,2955.0,0.995,14.971,39,6,0,6,33,6,27,17,0.0,0.0
1010,1860,26-09-2019 01:38:00,0,2970.0,2931.0,0.987,14.946,77,22,10,12,55,21,34,11,0.0,0.0
1010,1861,26-09-2019 01:40:00,0,3087.0,2936.0,0.951,15.413,20,11,0,11,9,0,9,10,0.0,0.0
1010,1862,26-09-2019 01:42:00,0,3176.5,3066.0,0.9645,15.9095,18,4,0,4,14,3,11,16,0.0,0.0
1010,1863,26-09-2019 01:44:00,0,3266.0,3196.0,0.978,16.406,33,10,5,5,23,3,20,12,0.0,0.0
1010,1864,26-09-2019 01:46:00,0,3164.0,3131.0,0.99,15.934,45,8,5,3,37,3,34,12,0.0,0.0
1010,1865,26-09-2019 01:48:00,0,3200.0,3040.0,0.95,15.975,46,14,7,7,32,7,25,13,0.0,0.0
1010,1866,26-09-2019 01:50:00,0,3186.0,3081.0,0.967,15.963,46,0,0,0,46,20,26,6,0.0,0.0
1010,1867,26-09-2019 01:52:00,0,3194.0,3008.0,0.942,15.915,47,3,0,3,44,17,27,2,0.0,0.0
1010,1868,26-09-2019 01:54:00,0,3178.0,3086.0,0.971,15.939,71,33,13,20,38,17,21,16,0.0,0.0
1010,1869,26-09-2019 01:56:00,0,3519.0,3248.0,0.923,17.463,53,10,5,5,43,16,27,15,0.0,0.0
1010,1870,26-09-2019 01:58:00,0,3382.0,3233.0,0.956,16.904,179,58,30,28,121,72,49,4,0.0,0.0
1010,1871,26-09-2019 02:00:00,0,3482.0,3359.0,0.964,17.439,169,71,35,36,98,55,43,16,0.0,0.0
1010,1872,26-09-2019 02:02:00,0,3572.0,3465.0,0.97,17.91,395,196,159,37,199,152,47,30,0.0,0.0
1010,1873,26-09-2019 02:04:00,0,3484.0,3399.0,0.976,17.488,208,82,59,23,126,66,60,73,0.0,0.0
1010,1874,26-09-2019 02:06:00,0,3654.0,3602.0,0.986,18.382,155,62,30,32,93,42,51,78,0.0,0.04
1010,1875,26-09-2019 02:08:00,0,3780.0,3710.0,0.981,19.001,63,37,24,13,26,14,12,17,0.0,0.26
1010,1876,26-09-2019 02:10:00,0,3168.0,3140.0,0.991,15.958,3,1,0,1,2,0,2,5,0.0,0.0
1010,1877,26-09-2019 02:12:00,0,3491.0,3343.0,0.958,17.458,20,0,0,0,20,2,18,8,0.0,0.01
1010,1878,26-09-2019 02:14:00,0,3884.0,3749.0,0.965,19.453,522,309,262,47,213,167,46,23,0.13,0.0
1010,1879,26-09-2019 02:16:00,0,3925.0,3856.0,0.982,19.733,729,385,314,71,344,268,76,68,0.0,0.05
1010,1880,26-09-2019 02:18:00,0,3966.0,3963.0,0.999,20.013,478,194,141,53,284,218,66,32,0.14,0.0
1010,1881,26-09-2019 02:20:00,0,4169.0,4059.0,0.974,20.919,301,190,146,44,111,85,26,60,0.0,0.0
1010,1882,26-09-2019 02:22:00,0,4139.0,4142.0,1.001,20.892,55,48,24,24,7,3,4,0,0.0,0.0
1010,1883,26-09-2019 02:24:00,0,4180.0,4049.0,0.969,20.95,265,95,56,39,170,119,51,2,0.0,0.0
1010,1884,26-09-2019 02:26:00,0,4178.0,4087.0,0.978,20.986,628,346,271,75,282,219,63,20,0.0,0.0
1010,1885,26-09-2019 02:28:00,0,4159.0,4078.0,0.981,20.899,273,121,91,30,152,120,32,0,0.0,0.0
1010,1886,26-09-2019 02:30:00,0,4186.0,4014.0,0.959,20.938,65,33,14,19,32,15,17,0,0.0,0.0
1010,1887,26-09-2019 02:32:00,0,4201.0,4031.0,0.959,21.014,15,14,3,11,1,0,1,0,0.0,0.0
1010,1888,26-09-2019 02:34:00,0,3969.0,3886.0,0.979,19.938,2,2,1,1,0,0,0,0,0.0,0.0
1010,1889,26-09-2019 02:36:00,0,4016.0,3731.0,0.929,19.951,3,3,2,1,0,0,0,0,0.0,0.0
1010,1890,26-09-2019 02:38:00,0,3681.0,3518.0,0.956,18.397,2,2,0,2,0,0,0,0,0.0,0.0
1010,1891,26-09-2019 02:40:00,0,3470.0,3372.0,0.972,17.406,37,19,10,9,18,8,10,0,0.0,0.0
1010,1892,26-09-2019 02:42:00,0,3518.0,3279.0,0.932,17.492,26,0,0,0,26,0,26,0,0.0,0.0
1010,1893,26-09-2019 02:44:00,0,3277.0,3148.0,0.96,16.397,29,4,1,3,25,0,25,0,0.0,0.0
1010,1894,26-09-2019 02:46:00,0,3188.0,3064.0,0.961,15.955,30,0,0,0,30,0,30,0,0.0,0.0
1010,1895,26-09-2019 02:48:00,0,3103.0,2902.0,0.935,15.437,20,3,0,3,17,0,17,0,0.0,0.0
1010,1896,26-09-2019 02:50:00,0,3056.5,2838.0,0.9285,15.183,33,3,0,3,30,0,30,0,0.0,0.0
1010,1897,26-09-2019 02:52:00,0,3010.0,2774.0,0.922,14.929,33,1,0,1,32,0,32,0,0.0,0.0
1010,1898,26-09-2019 02:54:00,0,3007.0,2773.0,0.922,14.916,78,29,14,15,49,12,37,0,0.0,0.0
1010,1899,26-09-2019 02:56:00,0,3221.0,2973.0,0.923,15.983,35,9,0,9,26,0,26,0,0.0,0.0
1010,1900,26-09-2019 02:58:00,0,3099.0,2925.0,0.944,15.451,34,13,1,12,21,0,21,0,0.0,0.0
1010,1901,26-09-2019 03:00:00,0,3204.0,2995.0,0.935,15.94,30,8,2,6,22,0,22,0,0.0,0.0
1010,1902,26-09-2019 03:02:00,0,3106.0,2926.0,0.942,15.477,46,8,1,7,38,0,38,0,0.0,0.0
1010,1903,26-09-2019 03:04:00,0,3099.0,2937.0,0.948,15.461,19,6,4,2,13,0,13,0,0.0,0.0
1010,1904,26-09-2019 03:06:00,0,3208.0,2943.0,0.917,15.898,38,7,1,6,31,0,31,0,0.0,0.0
1010,1905,26-09-2019 03:08:00,0,3208.0,2989.0,0.932,15.949,61,21,10,11,40,13,27,0,0.0,0.0
1010,1906,26-09-2019 03:10:00,0,3203.0,2983.0,0.931,15.922,37,3,0,3,34,0,34,0,0.0,0.0
1010,1907,26-09-2019 03:12:00,0,3203.0,2978.0,0.93,15.917,39,10,2,8,29,0,29,0,0.0,0.0
1010,1908,26-09-2019 03:14:00,0,2987.0,2872.0,0.961,14.946,5,5,0,5,0,0,0,0,0.0,0.0
1010,1909,26-09-2019 03:16:00,0,3015.0,2764.0,0.917,14.937,24,18,0,18,6,2,4,0,0.0,0.0
1010,1910,26-09-2019 03:18:00,0,3005.0,2772.0,0.922,14.908,122,46,13,33,76,32,44,0,0.0,0.0
1010,1911,26-09-2019 03:20:00,0,3195.0,3038.0,0.951,15.953,167,32,5,27,135,91,44,0,0.0,0.0
1010,1912,26-09-2019 03:22:00,0,3406.0,3200.0,0.94,16.963,293,161,119,42,132,95,37,8,0.0,0.0
1010,1913,26-09-2019 03:24:00,0,3463.5,3211.5,0.928,17.2015,245,82,54,28,163,107,56,3,0.0,0.0
1010,1914,26-09-2019 03:26:00,0,3521.0,3223.0,0.916,17.44,170,45,26,19,125,78,47,0,0.0,0.0
1010,1915,26-09-2019 03:28:00,0,3596.0,3409.0,0.948,17.941,88,11,3,8,77,41,36,0,0.0,0.0
1010,1916,26-09-2019 03:30:00,0,3695.0,3450.0,0.934,18.377,165,39,11,28,126,76,50,0,0.0,0.0
1010,1917,26-09-2019 03:32:00,0,3695.0,3530.0,0.955,18.465,81,23,11,12,58,16,42,0,0.0,0.0
1010,1918,26-09-2019 03:34:00,0,3479.0,3354.0,0.964,17.42,34,0,0,0,34,0,34,0,0.0,0.0
1010,1919,26-09-2019 03:36:00,0,3398.0,3200.0,0.942,16.931,27,0,0,0,27,2,25,0,0.0,0.0
1010,1920,26-09-2019 03:38:00,0,3181.0,3101.0,0.975,15.968,33,0,0,0,33,0,33,0,0.0,0.0
1010,1921,26-09-2019 03:40:00,0,3103.0,2927.0,0.943,15.465,25,4,1,3,21,0,21,0,0.0,0.0
1010,1922,26-09-2019 03:42:00,0,2906.0,2695.0,0.928,14.432,29,0,0,0,29,0,29,0,0.0,0.0
1010,1923,26-09-2019 03:44:00,0,2683.0,2608.0,0.972,13.456,47,3,0,3,44,11,33,0,0.0,0.0
1010,1924,26-09-2019 03:46:00,0,2796.0,2651.0,0.948,13.951,31,9,0,9,22,3,19,0,0.0,0.0
1010,1925,26-09-2019 03:48:00,0,2912.0,2670.0,0.917,14.431,134,49,30,19,85,47,38,0,0.0,0.0
1010,1926,26-09-2019 03:50:00,0,3204.0,2992.0,0.934,15.938,160,69,45,24,91,49,42,58,0.0,0.0
1010,1927,26-09-2019 03:52:00,0,3499.0,3283.0,0.938,17.419,129,58,28,30,71,33,38,61,0.0,0.0
1010,1928,26-09-2019 03:54:00,0,3578.0,3436.0,0.96,17.9,141,53,21,32,88,41,47,75,0.0,0.02
1010,1929,26-09-2019 03:56:00,0,3688.0,3575.0,0.969,18.487,327,200,151,49,127,91,36,108,0.0,0.05
1010,1930,26-09-2019 03:58:00,0,4085.0,3910.5,0.958,20.422,318,200,154,46,118,87,31,163,0.0,0.0
1010,1931,26-09-2019 04:00:00,0,4482.0,4246.0,0.947,22.357,634,355,287,68,279,217,62,11,0.07,0.01
1010,1932,26-09-2019 04:02:00,0,3904.0,3645.0,0.934,19.418,442,197,144,53,245,192,53,26,0.0,0.05
1010,1933,26-09-2019 04:04:00,0,3695.0,3520.0,0.953,18.453,323,133,88,45,190,132,58,1,0.0,0.0
1010,1934,26-09-2019 04:06:00,0,3605.0,3340.0,0.927,17.901,477,178,127,51,299,225,74,0,0.0,0.0
1010,1935,26-09-2019 04:08:00,0,4014.0,3753.0,0.935,19.968,727,404,326,78,323,257,66,53,0.0,0.0
1010,1936,26-09-2019 04:10:00,0,4002.0,3773.0,0.943,19.945,388,225,176,49,163,119,44,86,0.07,0.0
1010,1937,26-09-2019 04:12:00,0,3676.0,3573.0,0.972,18.437,290,104,72,32,186,131,55,1,0.0,0.0
1010,1938,26-09-2019 04:14:00,0,3546.0,3121.0,0.88,17.428,185,60,33,27,125,79,46,0,0.0,0.0
1010,1939,26-09-2019 04:16:00,0,3679.0,3521.0,0.957,18.393,24,22,8,14,2,2,0,0,0.0,0.0
1010,1940,26-09-2019 04:18:00,0,3996.0,3825.0,0.957,19.977,70,21,9,12,49,12,37,0,0.0,0.0
1010,1941,26-09-2019 04:20:00,0,3971.0,3855.0,0.971,19.915,24,4,0,4,20,0,20,0,0.0,0.0
1010,1942,26-09-2019 04:22:00,0,4014.0,3742.0,0.932,19.96,3,0,0,0,3,0,3,0,0.0,0.0
1010,1943,26-09-2019 04:24:00,0,3657.0,3597.0,0.984,18.389,5,0,0,0,5,2,3,0,0.0,0.0
1010,1944,26-09-2019 04:26:00,0,3714.0,3413.0,0.919,18.412,22,9,2,7,13,2,11,0,0.0,0.0
1010,1945,26-09-2019 04:28:00,0,3499.0,3263.0,0.933,17.4,1,1,0,1,0,0,0,0,0.0,0.0
1010,1946,26-09-2019 04:30:00,0,3185.0,3108.0,0.976,15.99,5,3,0,3,2,0,2,0,0.0,0.0
1010,1947,26-09-2019 04:32:00,0,3202.5,3001.5,0.9375,15.9415,0,0,0,0,0,0,0,0,0.0,0.0
1010,1948,26-09-2019 04:34:00,0,3220.0,2895.0,0.899,15.893,8,2,1,1,6,0,6,0,0.0,0.0
1010,1949,26-09-2019 04:36:00,0,3228.0,2923.0,0.906,15.953,0,0,0,0,0,0,0,0,0.0,0.0
1010,1950,26-09-2019 04:38:00,0,3231.0,2913.0,0.902,15.954,3,1,0,1,2,0,2,0,0.0,0.0
1010,1951,26-09-2019 04:40:00,0,2992.0,2856.0,0.954,14.952,47,23,15,8,24,13,11,2,0.0,0.0
1010,1952,26-09-2019 04:42:00,0,3012.0,2752.0,0.914,14.915,9,1,0,1,8,0,8,0,0.0,0.0
1010,1953,26-09-2019 04:44:00,0,3014.0,2750.0,0.912,14.918,67,10,4,6,57,18,39,0,0.0,0.0
1010,1954,26-09-2019 04:46:00,0,3109.0,2879.0,0.926,15.437,29,0,0,0,29,0,29,0,0.0,0.0
1010,1955,26-09-2019 04:48:00,0,3225.0,2894.0,0.897,15.91,75,22,9,13,53,17,36,0,0.0,0.0
1010,1956,26-09-2019 04:50:00,0,2994.0,2853.0,0.953,14.955,38,15,5,10,23,5,18,0,0.0,0.0
1010,1957,26-09-2019 04:52:00,0,3014.0,2788.0,0.925,14.962,19,0,0,0,19,0,19,0,0.0,0.0
1010,1958,26-09-2019 04:54:00,0,3014.0,2765.0,0.917,14.936,36,3,2,1,33,2,31,0,0.0,0.0
1010,1959,26-09-2019 04:56:00,0,3011.0,2767.0,0.919,14.928,98,24,17,7,74,38,36,0,0.0,0.0
1010,1960,26-09-2019 04:58:00,0,3002.0,2788.0,0.929,14.915,270,113,76,37,157,98,59,33,0.0,0.0
1010,1961,26-09-2019 05:00:00,0,3115.0,2897.0,0.93,15.48,276,130,93,37,146,98,48,66,0.0,0.0
1010,1962,26-09-2019 05:02:00,0,3530.0,3187.0,0.903,17.436,172,57,34,23,115,68,47,59,0.0,0.0
1010,1963,26-09-2019 05:04:00,0,3508.0,3255.0,0.928,17.425,144,47,26,21,97,54,43,59,0.0,0.03
1010,1964,26-09-2019 05:06:00,0,3406.0,3197.0,0.939,16.9595,171,104,72,32,67,40,27,83,0.0,0.02
1010,1965,26-09-2019 05:08:00,0,3304.0,3139.0,0.95,16.494,460,253,209,44,207,157,50,20,0.03,0.01
1010,1966,26-09-2019 05:10:00,0,4005.0,3720.0,0.929,19.898,379,207,158,49,172,123,49,89,0.01,0.0
1010,1967,26-09-2019 05:12:00,0,3701.0,3513.0,0.949,18.472,309,184,140,44,125,93,32,65,0.01,0.0
1010,1968,26-09-2019 05:14:00,0,3632.0,3319.0,0.914,17.983,190,112,84,28,78,52,26,123,0.1,0.0
1010,1969,26-09-2019 05:16:00,0,3676.0,3564.0,0.97,18.428,173,123,88,35,50,35,15,207,0.0,0.0
1010,1970,26-09-2019 05:18:00,0,3901.0,3668.0,0.94,19.433,295,179,161,18,116,94,22,171,0.0,0.0
1010,1971,26-09-2019 05:20:00,0,4028.0,3685.0,0.915,19.951,283,173,132,41,110,84,26,141,0.0,0.0
1010,1972,26-09-2019 05:22:00,0,3678.0,3564.0,0.969,18.438,350,226,184,42,124,103,21,153,0.0,0.0
1010,1973,26-09-2019 05:24:00,0,4027.0,3685.0,0.915,19.948,138,25,11,14,113,67,46,3,0.0,0.0
1010,1974,26-09-2019 05:26:00,0,3909.0,3628.0,0.928,19.417,72,22,5,17,50,19,31,0,0.0,0.0
1010,1975,26-09-2019 05:28:00,0,3914.0,3600.0,0.92,19.407,115,33,19,14,82,45,37,1,0.0,0.0
1010,1976,26-09-2019 05:30:00,0,3989.0,3832.0,0.961,19.957,106,57,28,29,49,15,34,0,0.0,0.0
1010,1977,26-09-2019 05:32:00,0,4018.0,3731.0,0.929,19.96,100,34,16,18,66,25,41,0,0.0,0.0
1010,1978,26-09-2019 05:34:00,0,4020.0,3671.0,0.913,19.902,79,21,5,16,58,18,40,0,0.0,0.0
1010,1979,26-09-2019 05:36:00,0,4032.0,3703.0,0.919,19.984,110,52,28,24,58,22,36,0,0.0,0.0
1010,1980,26-09-2019 05:38:00,0,4026.0,3653.0,0.907,19.908,218,125,78,47,93,47,46,0,0.0,0.0
1010,1981,26-09-2019 05:40:00,0,3864.0,3581.0,0.9275,19.1885,148,70,35,35,78,32,46,0,0.0,0.0
1010,1982,26-09-2019 05:42:00,0,3702.0,3509.0,0.948,18.469,476,195,132,63,281,204,77,0,0.0,0.0
1010,1983,26-09-2019 05:44:00,0,3697.0,3461.0,0.936,18.399,366,156,116,40,210,159,51,16,0.0,0.0
1010,1984,26-09-2019 05:46:00,0,3627.0,3299.0,0.909,17.943,208,104,75,29,104,58,46,0,0.0,0.0
1010,1985,26-09-2019 05:48:00,0,3727.0,3396.0,0.911,18.444,537,264,208,56,273,213,60,0,0.0,0.0
1010,1986,26-09-2019 05:50:00,0,3748.0,3363.0,0.897,18.489,673,344,271,73,329,260,69,5,0.0,0.0
1010,1987,26-09-2019 05:52:00,0,3728.0,3327.0,0.892,18.373,277,135,109,26,142,102,40,47,0.0,0.0
1010,1988,26-09-2019 05:54:00,0,3728.0,3334.0,0.894,18.379,297,145,105,40,152,105,47,7,0.0,0.0
1010,1989,26-09-2019 05:56:00,0,3738.0,3304.0,0.884,18.385,596,305,234,71,291,219,72,2,0.0,0.0
1010,1990,26-09-2019 05:58:00,0,3514.0,3173.0,0.903,17.359,622,324,255,69,298,218,80,12,0.0,0.0
1010,1991,26-09-2019 06:00:00,1,3539.0,3136.0,0.886,17.414,116,40,20,20,76,48,28,48,0.0,0.0
1010,1992,26-09-2019 06:02:00,1,3743.0,3340.0,0.892,18.447,310,193,159,34,117,94,23,111,0.0,0.0
1010,1993,26-09-2019 06:04:00,1,3735.0,3371.0,0.903,18.447,119,68,46,22,51,34,17,3,0.0,0.0
1010,1994,26-09-2019 06:06:00,1,3536.0,3177.0,0.899,17.449,83,23,12,11,60,20,40,0,0.0,0.0
1010,1995,26-09-2019 06:08:00,1,3515.0,3237.0,0.921,17.433,46,4,2,2,42,11,31,0,0.0,0.0
1010,1996,26-09-2019 06:10:00,1,3511.0,3220.0,0.917,17.399,82,18,7,11,64,24,40,0,0.0,0.0
1010,1997,26-09-2019 06:12:00,1,3523.0,3199.0,0.908,17.421,36,31,1,30,5,2,3,0,0.0,0.0
1010,1998,26-09-2019 06:14:00,1,3522.5,3195.5,0.907,17.4155,43,27,2,25,16,3,13,0,0.0,0.0
1010,1999,26-09-2019 06:16:00,1,3522.0,3192.0,0.906,17.41,83,25,14,11,58,30,28,0,0.0,0.0
1010,2000,26-09-2019 06:18:00,1,3524.0,3220.0,0.914,17.448,70,33,7,26,37,19,18,0,0.0,0.0
1010,2001,26-09-2019 06:20:00,1,3525.0,3181.0,0.903,17.411,29,18,0,18,11,0,11,0,0.0,0.0
1010,2002,26-09-2019 06:22:00,1,3555.0,3087.0,0.868,17.424,34,0,0,0,34,0,34,0,0.0,0.0
1010,2003,26-09-2019 06:24:00,1,3208.0,2921.0,0.91,15.872,25,2,0,2,23,0,23,0,0.0,0.0
1010,2004,26-09-2019 06:26:00,1,3257.0,2773.0,0.851,15.904,10,0,0,0,10,7,3,0,0.0,0.0
1010,2005,26-09-2019 06:28:00,1,3148.0,2711.0,0.861,15.405,0,0,0,0,0,0,0,0,0.0,0.0
1010,2006,26-09-2019 06:30:00,1,3057.0,2604.0,0.852,14.927,14,14,1,13,0,0,0,0,0.0,0.0
1010,2007,26-09-2019 06:32:00,1,2963.0,2518.0,0.85,14.461,38,19,1,18,19,9,10,0,0.0,0.0
1010,2008,26-09-2019 06:34:00,1,3081.0,2513.0,0.816,14.922,28,0,0,0,28,0,28,0,0.0,0.0
1010,2009,26-09-2019 06:36:00,1,3059.0,2577.0,0.842,14.907,1,0,0,0,1,0,1,0,0.0,0.0
1010,2010,26-09-2019 06:38:00,1,3066.0,2581.0,0.842,14.938,7,7,1,6,0,0,0,0,0.0,0.0
1010,2011,26-09-2019 06:40:00,1,3072.0,2565.0,0.835,14.943,10,9,2,7,1,0,1,0,0.0,0.0
1010,2012,26-09-2019 06:42:00,1,3069.0,2569.0,0.837,14.937,4,4,0,4,0,0,0,0,0.0,0.0
1010,2013,26-09-2019 06:44:00,1,3057.0,2530.0,0.828,14.847,44,14,8,6,30,9,21,0,0.0,0.0
1010,2014,26-09-2019 06:46:00,1,3058.0,2569.0,0.84,14.892,33,0,0,0,33,0,33,0,0.0,0.0
1010,2015,26-09-2019 06:48:00,1,3023.0,2491.5,0.824,14.669,28,1,0,1,27,0,27,0,0.0,0.0
1010,2016,26-09-2019 06:50:00,1,2988.0,2414.0,0.808,14.446,54,19,5,14,35,2,33,0,0.0,0.0
1010,2017,26-09-2019 06:52:00,1,2865.0,2392.0,0.835,13.937,38,8,5,3,30,0,30,0,0.0,0.0
1010,2018,26-09-2019 06:54:00,1,3097.0,2459.0,0.794,14.925,40,12,5,7,28,0,28,0,0.0,0.0
1010,2019,26-09-2019 06:56:00,1,2983.0,2430.0,0.815,14.443,44,16,12,4,28,11,17,0,0.0,0.0
1010,2020,26-09-2019 06:58:00,1,2983.0,2399.0,0.804,14.41,3,1,0,1,2,0,2,0,0.0,0.0
1010,2021,26-09-2019 07:00:00,1,2980.0,2399.0,0.805,14.397,13,7,2,5,6,1,5,0,0.0,0.0
1010,2022,26-09-2019 07:02:00,1,2993.0,2377.0,0.794,14.425,7,3,0,3,4,1,3,0,0.0,0.0
1010,2023,26-09-2019 07:04:00,1,2866.0,2334.0,0.815,13.875,57,24,16,8,33,10,23,0,0.0,0.0
1010,2024,26-09-2019 07:06:00,1,2872.0,2323.0,0.809,13.889,33,0,0,0,33,0,33,0,0.0,0.0
1010,2025,26-09-2019 07:08:00,1,2772.0,2258.0,0.815,13.421,103,42,21,21,61,13,48,0,0.0,0.0
1010,2026,26-09-2019 07:10:00,1,2875.0,2338.0,0.813,13.918,118,35,8,27,83,31,52,0,0.0,0.0
1010,2027,26-09-2019 07:12:00,1,3202.0,2550.0,0.796,15.438,60,23,9,14,37,15,22,2,0.0,0.0
1010,2028,26-09-2019 07:14:00,1,3298.0,2624.0,0.796,15.898,198,101,68,33,97,54,43,55,0.0,0.0
1010,2029,26-09-2019 07:16:00,1,3283.0,2708.0,0.825,15.932,172,62,28,34,110,54,56,68,0.0,0.0
1010,2030,26-09-2019 07:18:00,1,3613.0,2897.0,0.802,17.442,153,64,31,33,89,46,43,66,0.0,0.0
1010,2031,26-09-2019 07:20:00,1,3769.0,3192.0,0.847,18.384,154,80,40,40,74,36,38,66,0.0,0.02
1010,2032,26-09-2019 07:22:00,1,3658.0,3123.0,0.854,17.87,174,81,46,35,93,53,40,43,0.0,0.09
1010,2033,26-09-2019 07:24:00,1,3547.0,3054.0,0.861,17.356,825,433,348,85,392,315,77,15,0.0,0.01
1010,2034,26-09-2019 07:26:00,1,3784.0,3156.0,0.834,18.405,491,250,193,57,241,191,50,49,0.01,0.0
1010,2035,26-09-2019 07:28:00,1,3564.0,3038.0,0.852,17.405,144,60,38,22,84,53,31,11,0.0,0.0
1010,2036,26-09-2019 07:30:00,1,3273.0,2749.0,0.84,15.94,203,70,42,28,133,91,42,0,0.01,0.0
1010,2037,26-09-2019 07:32:00,1,3563.0,3070.0,0.862,17.436,1141,581,479,102,560,442,118,0,0.0,0.0
1010,2038,26-09-2019 07:34:00,1,4080.0,3480.0,0.853,19.928,519,235,181,54,284,220,64,5,0.0,0.0
1010,2039,26-09-2019 07:36:00,1,3581.0,2990.0,0.835,17.421,82,37,3,34,45,25,20,0,0.01,0.0
1010,2040,26-09-2019 07:38:00,1,3488.0,2905.0,0.833,16.958,55,8,2,6,47,13,34,0,0.0,0.0
1010,2041,26-09-2019 07:40:00,1,3581.0,2968.0,0.829,17.397,74,9,1,8,65,23,42,0,0.0,0.0
1010,2042,26-09-2019 07:42:00,1,3571.0,3075.0,0.861,17.475,73,13,2,11,60,20,40,0,0.0,0.0
1010,2043,26-09-2019 07:44:00,1,3579.0,2981.0,0.833,17.403,19,1,0,1,18,4,14,0,0.0,0.0
1010,2044,26-09-2019 07:46:00,1,3237.0,2839.0,0.877,15.896,24,0,0,0,24,4,20,0,0.0,0.0
1010,2045,26-09-2019 07:48:00,1,3265.0,2754.0,0.844,15.912,52,2,1,1,50,22,28,0,0.0,0.0
1010,2046,26-09-2019 07:50:00,1,3050.0,2659.0,0.872,14.96,33,0,0,0,33,0,33,0,0.0,0.0
1010,2047,26-09-2019 07:52:00,1,3050.0,2589.0,0.849,14.885,22,0,0,0,22,0,22,0,0.0,0.0
1010,2048,26-09-2019 07:54:00,1,3059.0,2627.0,0.859,14.96,37,0,0,0,37,0,37,0,0.0,0.0
1010,2049,26-09-2019 07:56:00,1,3049.5,2641.0,0.866,14.9385,35,0,0,0,35,0,35,0,0.0,0.0
1010,2050,26-09-2019 07:58:00,1,3040.0,2655.0,0.873,14.917,25,5,2,3,20,3,17,0,0.0,0.0
1010,2051,26-09-2019 08:00:00,1,3056.0,2607.0,0.853,14.926,118,5,3,2,113,60,53,0,0.0,0.0
1010,2052,26-09-2019 08:02:00,1,3057.0,2582.0,0.845,14.902,28,0,0,0,28,0,28,0,0.0,0.0
1010,2053,26-09-2019 08:04:00,1,2972.0,2483.0,0.835,14.46,47,10,4,6,37,8,29,0,0.0,0.0
1010,2054,26-09-2019 08:06:00,1,2844.0,2460.0,0.865,13.931,0,0,0,0,0,0,0,0,0.0,0.0
1010,2055,26-09-2019 08:08:00,1,2742.0,2404.0,0.877,13.465,36,0,0,0,36,13,23,0,0.0,0.0
1010,2056,26-09-2019 08:10:00,1,2864.0,2428.0,0.848,13.974,49,0,0,0,49,14,35,0,0.0,0.0
1010,2057,26-09-2019 08:12:00,1,2969.0,2424.0,0.816,14.384,85,1,1,0,84,48,36,0,0.0,0.0
1010,2058,26-09-2019 08:14:00,1,3095.0,2460.0,0.795,14.919,42,4,2,2,38,9,29,0,0.0,0.0
1010,2059,26-09-2019 08:16:00,1,3073.0,2571.0,0.837,14.955,46,23,5,18,23,6,17,0,0.0,0.0
1010,2060,26-09-2019 08:18:00,1,3298.0,2662.0,0.807,15.943,97,32,13,19,65,24,41,0,0.0,0.0
1010,2061,26-09-2019 08:20:00,1,3279.0,2734.0,0.834,15.946,94,41,16,25,53,31,22,0,0.0,0.0
1010,2062,26-09-2019 08:22:00,1,3273.0,2744.0,0.838,15.933,117,43,1,42,74,36,38,0,0.0,0.0
1010,2063,26-09-2019 08:24:00,1,3250.0,2822.0,0.868,15.93,78,14,4,10,64,15,49,0,0.0,0.0
1010,2064,26-09-2019 08:26:00,1,3265.0,2776.0,0.85,15.937,38,1,0,1,37,0,37,0,0.0,0.0
1010,2065,26-09-2019 08:28:00,1,3176.0,2621.0,0.825,15.415,44,3,2,1,41,2,39,0,0.0,0.0
1010,2066,26-09-2019 08:30:00,1,2965.0,2472.5,0.8345,14.4195,65,1,0,1,64,22,42,0,0.0,0.0
1010,2067,26-09-2019 08:32:00,1,2754.0,2324.0,0.844,13.424,30,0,0,0,30,0,30,0,0.0,0.0
1010,2068,26-09-2019 08:34:00,1,2747.0,2321.0,0.845,13.393,57,15,6,9,42,2,40,0,0.0,0.0
1010,2069,26-09-2019 08:36:00,1,2884.0,2365.0,0.82,13.983,49,7,0,7,42,0,42,0,0.0,0.0
1010,2070,26-09-2019 08:38:00,1,2983.0,2379.0,0.798,14.387,37,4,2,2,33,0,33,0,0.0,0.0
1010,2071,26-09-2019 08:40:00,1,2882.0,2334.0,0.81,13.941,46,1,0,1,45,0,45,0,0.01,0.0
1010,2072,26-09-2019 08:42:00,1,2767.0,2263.0,0.818,13.41,51,7,0,7,44,4,40,0,0.0,0.0
1010,2073,26-09-2019 08:44:00,1,2889.0,2301.0,0.796,13.932,53,11,4,7,42,6,36,0,0.0,0.0
1010,2074,26-09-2019 08:46:00,1,2771.0,2267.0,0.818,13.428,38,0,0,0,38,3,35,0,0.0,0.0
1010,2075,26-09-2019 08:48:00,1,2889.0,2285.0,0.791,13.911,38,0,0,0,38,0,38,0,0.0,0.0
1010,2076,26-09-2019 08:50:00,1,2785.0,2236.0,0.803,13.449,48,0,0,0,48,2,46,0,0.0,0.0
1010,2077,26-09-2019 08:52:00,1,2781.0,2232.0,0.803,13.427,46,0,0,0,46,0,46,0,0.0,0.0
1010,2078,26-09-2019 08:54:00,1,2780.0,2242.0,0.806,13.436,79,6,3,3,73,32,41,0,0.0,0.0
1010,2079,26-09-2019 08:56:00,1,3008.0,2326.0,0.773,14.426,123,1,0,1,122,82,40,0,0.0,0.0
1010,2080,26-09-2019 08:58:00,1,2891.0,2302.0,0.796,13.939,80,1,0,1,79,36,43,0,0.0,0.0
1010,2081,26-09-2019 09:00:00,1,2768.0,2255.0,0.815,13.401,53,0,0,0,53,20,33,0,0.0,0.0
1010,2082,26-09-2019 09:02:00,1,2784.0,2212.0,0.794,13.419,67,13,6,7,54,16,38,0,0.0,0.0
1010,2083,26-09-2019 09:04:00,1,2785.0,2209.0,0.793,13.419,26,0,0,0,26,0,26,0,0.0,0.0
1010,2084,26-09-2019 09:06:00,1,2786.0,2206.0,0.792,13.419,81,32,17,15,49,19,30,0,0.0,0.0
1010,2085,26-09-2019 09:08:00,1,2897.0,2288.0,0.79,13.947,136,22,10,12,114,49,65,0,0.0,0.0
1010,2086,26-09-2019 09:10:00,1,3113.0,2395.0,0.769,14.918,152,73,48,25,79,32,47,15,0.0,0.02
1010,2087,26-09-2019 09:12:00,1,3201.0,2541.0,0.794,15.423,211,129,103,26,82,57,25,53,0.0,0.0
1010,2088,26-09-2019 09:14:00,1,3291.0,2625.0,0.798,15.874,441,231,175,56,210,165,45,12,0.0,0.0
1010,2089,26-09-2019 09:16:00,1,3300.0,2615.0,0.792,15.899,336,136,92,44,200,137,63,55,0.0,0.0
1010,2090,26-09-2019 09:18:00,1,3316.0,2575.0,0.777,15.915,466,222,172,50,244,178,66,46,0.0,0.02
1010,2091,26-09-2019 09:20:00,1,3291.0,2682.0,0.815,15.935,844,358,285,73,486,376,110,1,0.02,0.02
1010,2092,26-09-2019 09:22:00,1,3289.0,2655.0,0.807,15.899,301,130,94,36,171,130,41,53,0.0,0.0
1010,2093,26-09-2019 09:24:00,1,3192.0,2534.0,0.794,15.383,169,37,17,20,132,88,44,6,0.0,0.0
1010,2094,26-09-2019 09:26:00,1,3262.0,2757.0,0.845,15.904,68,11,2,9,57,16,41,0,0.0,0.0
1010,2095,26-09-2019 09:28:00,1,3268.0,2756.0,0.844,15.927,44,1,0,1,43,0,43,0,0.0,0.0
1010,2096,26-09-2019 09:30:00,1,3279.0,2725.0,0.831,15.938,110,25,1,24,85,31,54,0,0.0,0.0
1010,2097,26-09-2019 09:32:00,1,3282.0,2725.0,0.83,15.947,136,26,8,18,110,60,50,0,0.0,0.0
1010,2098,26-09-2019 09:34:00,1,3262.0,2794.0,0.857,15.945,112,13,1,12,99,59,40,0,0.0,0.0
1010,2099,26-09-2019 09:36:00,1,3263.0,2772.0,0.85,15.927,84,18,0,18,66,25,41,0,0.0,0.0
1010,2100,26-09-2019 09:38:00,1,3166.5,2664.0,0.8415,15.426,33,0,0,0,33,0,33,0,0.0,0.0
1010,2101,26-09-2019 09:40:00,1,3070.0,2556.0,0.833,14.925,46,3,0,3,43,8,35,0,0.0,0.0
1010,2102,26-09-2019 09:42:00,1,2970.0,2432.0,0.819,14.394,49,4,3,1,45,10,35,0,0.0,0.0
1010,2103,26-09-2019 09:44:00,1,2861.0,2379.0,0.832,13.904,64,5,3,2,59,20,39,0,0.0,0.0
1010,2104,26-09-2019 09:46:00,1,2862.0,2398.0,0.838,13.932,37,5,1,4,32,0,32,0,0.0,0.0
1010,2105,26-09-2019 09:48:00,1,2740.0,2382.0,0.869,13.433,47,2,0,2,45,0,45,0,0.0,0.0
1010,2106,26-09-2019 09:50:00,1,3069.0,2569.0,0.837,14.937,32,1,0,1,31,0,31,0,0.0,0.0
1010,2107,26-09-2019 09:52:00,1,3081.0,2535.0,0.823,14.945,54,3,0,3,51,12,39,0,0.0,0.0
1010,2108,26-09-2019 09:54:00,1,3084.0,2497.0,0.81,14.915,35,0,0,0,35,0,35,0,0.0,0.0
1010,2109,26-09-2019 09:56:00,1,3101.0,2454.0,0.791,14.936,36,0,0,0,36,2,34,0,0.0,0.0
1010,2110,26-09-2019 09:58:00,1,2879.0,2361.0,0.82,13.957,33,0,0,0,33,4,29,0,0.0,0.0
1010,2111,26-09-2019 10:00:00,1,2761.0,2288.0,0.828,13.412,38,0,0,0,38,0,38,0,0.0,0.0
1010,2112,26-09-2019 10:02:00,1,2770.0,2259.0,0.816,13.414,36,2,0,2,34,0,34,0,0.0,0.0
1010,2113,26-09-2019 10:04:00,1,2782.0,2247.0,0.808,13.447,53,1,0,1,52,12,40,0,0.0,0.0
1010,2114,26-09-2019 10:06:00,1,2779.0,2233.0,0.803,13.421,38,0,0,0,38,2,36,0,0.0,0.0
1010,2115,26-09-2019 10:08:00,1,3019.0,2331.0,0.772,14.475,44,3,0,3,41,8,33,0,0.0,0.0
1010,2116,26-09-2019 10:10:00,1,3119.0,2348.0,0.753,14.889,77,23,10,13,54,21,33,0,0.0,0.0
1010,2117,26-09-2019 10:12:00,1,3120.0,2350.5,0.7535,14.8965,71,31,1,30,40,2,38,0,0.0,0.0
1010,2118,26-09-2019 10:14:00,1,3121.0,2353.0,0.754,14.904,84,15,12,3,69,24,45,0,0.0,0.0
1010,2119,26-09-2019 10:16:00,1,3010.0,2331.0,0.775,14.439,59,12,2,10,47,6,41,0,0.01,0.0
1010,2120,26-09-2019 10:18:00,1,2881.0,2271.0,0.788,13.867,36,1,0,1,35,4,31,0,0.0,0.0
1010,2121,26-09-2019 10:20:00,1,3133.0,2329.0,0.743,14.921,45,1,0,1,44,11,33,0,0.0,0.0
1010,2122,26-09-2019 10:22:00,1,3124.0,2344.0,0.75,14.904,65,0,0,0,65,34,31,0,0.0,0.0
1010,2123,26-09-2019 10:24:00,1,3011.0,2290.0,0.761,14.398,79,9,4,5,70,40,30,0,0.0,0.0
1010,2124,26-09-2019 10:26:00,1,2891.0,2270.0,0.785,13.905,93,6,1,5,87,43,44,0,0.0,0.0
1010,2125,26-09-2019 10:28:00,1,3119.0,2369.0,0.76,14.912,41,0,0,0,41,9,32,0,0.0,0.0
1010,2126,26-09-2019 10:30:00,1,3129.0,2329.0,0.744,14.907,65,3,2,1,62,31,31,0,0.0,0.0
1010,2127,26-09-2019 10:32:00,1,3010.0,2306.0,0.766,14.413,120,2,1,1,118,66,52,0,0.0,0.0
1010,2128,26-09-2019 10:34:00,1,3011.0,2289.0,0.76,14.398,67,10,5,5,57,24,33,0,0.0,0.0
1010,2129,26-09-2019 10:36:00,1,3024.0,2271.0,0.751,14.427,41,0,0,0,41,2,39,0,0.0,0.0
1010,2130,26-09-2019 10:38:00,1,2895.0,2253.0,0.778,13.903,27,0,0,0,27,0,27,0,0.0,0.0
1010,2131,26-09-2019 10:40:00,1,2805.0,2161.0,0.77,13.443,56,14,1,13,42,7,35,0,0.0,0.0
1010,2132,26-09-2019 10:42:00,1,2698.0,2059.0,0.763,12.911,33,0,0,0,33,0,33,0,0.0,0.0
1010,2133,26-09-2019 10:44:00,1,2577.0,2024.0,0.785,12.396,39,0,0,0,39,0,39,0,0.0,0.0
1010,2134,26-09-2019 10:46:00,1,2736.0,2137.0,0.781,13.147,119,36,20,16,83,46,37,0,0.0,0.0
1010,2135,26-09-2019 10:48:00,1,2895.0,2250.0,0.777,13.898,241,93,59,34,148,95,53,62,0.0,0.0
1010,2136,26-09-2019 10:50:00,1,3334.0,2509.0,0.752,15.913,173,68,37,31,105,57,48,73,0.0,0.0
1010,2137,26-09-2019 10:52:00,1,3641.0,2755.0,0.757,17.395,161,58,33,25,103,63,40,58,0.0,0.04
1010,2138,26-09-2019 10:54:00,1,3611.0,2871.0,0.795,17.406,196,87,58,29,109,69,40,69,0.0,0.06
1010,2139,26-09-2019 10:56:00,1,3587.0,2933.0,0.818,17.38,148,61,32,29,87,51,36,58,0.0,0.03
1010,2140,26-09-2019 10:58:00,1,3708.0,3010.0,0.812,17.942,580,282,224,58,298,222,76,29,0.11,0.05
1010,2141,26-09-2019 11:00:00,1,3608.0,2900.0,0.804,17.428,748,411,333,78,337,274,63,66,0.0,0.04
1010,2142,26-09-2019 11:02:00,1,3584.0,2963.0,0.827,17.402,329,170,129,41,159,106,53,33,0.03,0.0
1010,2143,26-09-2019 11:04:00,1,3085.0,2544.0,0.824,14.972,651,316,243,73,335,260,75,10,0.0,0.0
1010,2144,26-09-2019 11:06:00,1,3607.0,2871.0,0.796,17.391,623,290,226,64,333,263,70,29,0.0,0.02
1010,2145,26-09-2019 11:08:00,1,3564.0,3002.0,0.842,17.365,156,73,52,21,83,51,32,62,0.0,0.0
1010,2146,26-09-2019 11:10:00,1,3257.0,2801.0,0.86,15.934,99,34,17,17,65,28,37,0,0.0,0.0
1010,2147,26-09-2019 11:12:00,1,3486.0,2852.0,0.818,16.894,81,48,16,32,33,8,25,0,0.0,0.0
1010,2148,26-09-2019 11:14:00,1,3563.0,3034.0,0.851,17.398,423,249,208,41,174,117,57,2,0.0,0.0
1010,2149,26-09-2019 11:16:00,1,3758.0,3223.0,0.858,18.375,447,236,177,59,211,167,44,25,0.0,0.0
1010,2150,26-09-2019 11:18:00,1,3788.0,3163.0,0.835,18.428,77,24,11,13,53,19,34,0,0.0,0.0
1010,2151,26-09-2019 11:20:00,1,3778.0,3193.5,0.8455,18.4225,57,15,0,15,42,12,30,0,0.0,0.0
1010,2152,26-09-2019 11:22:00,1,3768.0,3224.0,0.856,18.417,46,6,4,2,40,8,32,0,0.0,0.0
1010,2153,26-09-2019 11:24:00,1,3768.0,3252.0,0.863,18.448,151,23,4,19,128,89,39,0,0.0,0.0
1010,2154,26-09-2019 11:26:00,1,3733.0,3305.0,0.885,18.368,123,65,31,34,58,22,36,0,0.0,0.0
1010,2155,26-09-2019 11:28:00,1,3779.0,3207.0,0.849,18.439,29,0,0,0,29,0,29,0,0.0,0.0
1010,2156,26-09-2019 11:30:00,1,3568.0,3023.0,0.847,17.406,39,7,0,7,32,0,32,0,0.0,0.0
1010,2157,26-09-2019 11:32:00,1,3236.0,2870.0,0.887,15.927,32,6,3,3,26,0,26,0,0.0,0.0
1010,2158,26-09-2019 11:34:00,1,3148.0,2697.0,0.857,15.39,28,0,0,0,28,0,28,0,0.0,0.0
1010,2159,26-09-2019 11:36:00,1,3074.0,2578.0,0.839,14.966,41,2,1,1,39,0,39,0,0.0,0.0
1010,2160,26-09-2019 11:38:00,1,3075.0,2536.0,0.825,14.924,57,14,9,5,43,8,35,0,0.0,0.0
1010,2161,26-09-2019 11:40:00,1,3085.0,2532.0,0.821,14.959,23,0,0,0,23,0,23,0,0.0,0.0
1010,2162,26-09-2019 11:42:00,1,2969.0,2493.0,0.84,14.456,32,2,1,1,30,0,30,0,0.0,0.0
1010,2163,26-09-2019 11:44:00,1,2836.0,2452.0,0.865,13.889,14,0,0,0,14,2,12,0,0.0,0.0
1010,2164,26-09-2019 11:46:00,1,2726.0,2406.0,0.882,13.404,2,0,0,0,2,1,1,0,0.0,0.0
1010,2165,26-09-2019 11:48:00,1,2858.0,2435.0,0.852,13.955,0,0,0,0,0,0,0,0,0.0,0.0
1010,2166,26-09-2019 11:50:00,1,2965.0,2430.0,0.82,14.373,2,0,0,0,2,0,2,0,0.0,0.0
1010,2167,26-09-2019 11:52:00,1,3078.0,2464.0,0.8,14.857,0,0,0,0,0,0,0,0,0.0,0.0
1010,2168,26-09-2019 11:54:00,1,2907.0,2431.0,0.8385,14.1455,8,8,1,7,0,0,0,0,0.0,0.0
1010,2169,26-09-2019 11:56:00,1,2736.0,2398.0,0.877,13.434,5,5,0,5,0,0,0,0,0.0,0.0
1010,2170,26-09-2019 11:58:00,1,2742.0,2376.0,0.867,13.435,44,14,4,10,30,5,25,0,0.01,0.0
1010,2171,26-09-2019 12:00:00,1,2982.0,2441.0,0.818,14.454,31,0,0,0,31,2,29,0,0.0,0.0
1010,2172,26-09-2019 12:02:00,1,2851.0,2423.0,0.85,13.915,31,0,0,0,31,4,27,0,0.0,0.0
1010,2173,26-09-2019 12:04:00,1,2764.0,2315.0,0.837,13.455,65,7,5,2,58,22,36,0,0.0,0.0
1010,2174,26-09-2019 12:06:00,1,2746.0,2313.0,0.842,13.38,32,0,0,0,32,8,24,0,0.0,0.0
1010,2175,26-09-2019 12:08:00,1,2877.0,2368.0,0.823,13.959,23,0,0,0,23,0,23,0,0.0,0.0
1010,2176,26-09-2019 12:10:00,1,2870.0,2368.0,0.825,13.929,52,17,6,11,35,10,25,0,0.0,0.0
1010,2177,26-09-2019 12:12:00,1,3001.0,2393.0,0.797,14.474,25,0,0,0,25,0,25,0,0.0,0.0
1010,2178,26-09-2019 12:14:00,1,2758.0,2284.0,0.828,13.395,55,1,0,1,54,14,40,0,0.0,0.0
1010,2179,26-09-2019 12:16:00,1,2779.0,2237.0,0.805,13.427,15,0,0,0,15,1,14,0,0.0,0.0
1010,2180,26-09-2019 12:18:00,1,2760.0,2315.0,0.839,13.437,3,0,0,0,3,0,3,0,0.0,0.0
1010,2181,26-09-2019 12:20:00,1,2762.0,2285.0,0.828,13.411,25,1,0,1,24,3,21,0,0.0,0.0
1010,2182,26-09-2019 12:22:00,1,2769.0,2266.0,0.818,13.419,43,12,3,9,31,1,30,0,0.0,0.0
1010,2183,26-09-2019 12:24:00,1,2765.0,2302.0,0.832,13.444,37,6,0,6,31,0,31,0,0.0,0.0
1010,2184,26-09-2019 12:26:00,1,2774.0,2258.0,0.814,13.428,40,2,0,2,38,0,38,0,0.0,0.0
1010,2185,26-09-2019 12:28:00,1,2778.5,2237.5,0.805,13.4235,39,1,0,1,38,0,38,0,0.0,0.0
1010,2186,26-09-2019 12:30:00,1,2783.0,2217.0,0.796,13.419,101,43,14,29,58,21,37,0,0.0,0.0
1010,2187,26-09-2019 12:32:00,1,3111.0,2413.0,0.775,14.931,80,30,10,20,50,34,16,0,0.0,0.0
1010,2188,26-09-2019 12:34:00,1,3088.0,2460.0,0.796,14.891,41,27,10,17,14,6,8,1,0.02,0.0
1010,2189,26-09-2019 12:36:00,1,3088.0,2480.0,0.803,14.911,1,1,1,0,0,0,0,0,0.0,0.0
1010,2190,26-09-2019 12:38:00,1,3085.0,2467.0,0.8,14.887,1,1,0,1,0,0,0,0,0.0,0.0
1010,2191,26-09-2019 12:40:00,1,2736.0,2386.0,0.872,13.421,4,4,0,4,0,0,0,0,0.0,0.0
1010,2192,26-09-2019 12:42:00,1,2763.0,2311.0,0.836,13.445,1,1,0,1,0,0,0,0,0.0,0.0
1010,2193,26-09-2019 12:44:00,1,2776.0,2240.0,0.807,13.417,0,0,0,0,0,0,0,0,0.0,0.0
1010,2194,26-09-2019 12:46:00,1,2798.0,2180.0,0.779,13.439,47,26,15,11,21,11,10,0,0.0,0.0
1010,2195,26-09-2019 12:48:00,1,2783.0,2241.0,0.805,13.448,210,107,70,37,103,51,52,23,0.0,0.0
1010,2196,26-09-2019 12:50:00,1,3194.0,2538.0,0.795,15.393,116,39,10,29,77,41,36,39,0.0,0.0
1010,2197,26-09-2019 12:52:00,1,3496.0,2817.0,0.806,16.891,157,62,35,27,95,49,46,41,0.0,0.08
1010,2198,26-09-2019 12:54:00,1,3574.0,3011.0,0.843,17.413,171,77,53,24,94,52,42,74,0.0,0.0
1010,2199,26-09-2019 12:56:00,1,3571.0,3035.0,0.85,17.431,591,298,240,58,293,226,67,25,0.06,0.01
1010,2200,26-09-2019 12:58:00,1,3486.0,2872.0,0.824,16.916,146,58,26,32,88,47,41,45,0.04,0.04
1010,2201,26-09-2019 13:00:00,1,3558.0,3059.0,0.86,17.406,627,319,256,63,308,234,74,1,0.01,0.02
1010,2202,26-09-2019 13:02:00,1,3418.0,2891.5,0.8455,16.6685,329,138,101,37,191,136,55,0,0.0,0.0
1010,2203,26-09-2019 13:04:00,1,3278.0,2724.0,0.831,15.931,407,225,169,56,182,129,53,10,0.0,0.0
1010,2204,26-09-2019 13:06:00,1,3577.0,2993.0,0.837,17.408,151,79,56,23,72,40,32,1,0.07,0.0
1010,2205,26-09-2019 13:08:00,1,3476.0,2892.0,0.832,16.895,10,9,3,6,1,0,1,0,0.01,0.0
1010,2206,26-09-2019 13:10:00,1,3586.0,3034.0,0.846,17.488,65,22,0,22,43,8,35,0,0.0,0.0
1010,2207,26-09-2019 13:12:00,1,3535.0,3139.0,0.888,17.403,108,64,36,28,44,8,36,0,0.0,0.0
1010,2208,26-09-2019 13:14:00,1,3537.0,3149.0,0.89,17.422,31,27,4,23,4,1,3,0,0.0,0.0
1010,2209,26-09-2019 13:16:00,1,3574.0,3021.0,0.845,17.428,3,0,0,0,3,0,3,0,0.0,0.0
1010,2210,26-09-2019 13:18:00,1,3227.0,2888.0,0.895,15.912,3,2,1,1,1,0,1,0,0.0,0.0
1010,2211,26-09-2019 13:20:00,1,3261.0,2783.0,0.853,15.93,0,0,0,0,0,0,0,0,0.0,0.0
1010,2212,26-09-2019 13:22:00,1,3027.0,2690.0,0.889,14.903,0,0,0,0,0,0,0,0,0.0,0.0
1010,2213,26-09-2019 13:24:00,1,3050.0,2638.0,0.865,14.937,0,0,0,0,0,0,0,0,0.0,0.0
1010,2214,26-09-2019 13:26:00,1,2935.0,2550.0,0.869,14.388,1,1,0,1,0,0,0,0,0.0,0.0
1010,2215,26-09-2019 13:28:00,1,2720.0,2466.0,0.906,13.447,0,0,0,0,0,0,0,0,0.0,0.0
1010,2216,26-09-2019 13:30:00,1,2743.0,2421.0,0.883,13.487,6,0,0,0,6,1,5,0,0.0,0.0
1010,2217,26-09-2019 13:32:00,1,2733.0,2383.0,0.872,13.406,19,18,7,11,1,0,1,0,0.0,0.0
1010,2218,26-09-2019 13:34:00,1,2757.0,2359.0,0.855,13.475,0,0,0,0,0,0,0,0,0.0,0.0
1010,2219,26-09-2019 13:36:00,1,2636.5,2324.0,0.8825,12.9615,0,0,0,0,0,0,0,0,0.0,0.0
1010,2220,26-09-2019 13:38:00,1,2516.0,2289.0,0.91,12.448,32,16,12,4,16,6,10,0,0.0,0.01
1010,2221,26-09-2019 13:40:00,1,2729.0,2435.0,0.892,13.449,59,1,0,1,58,28,30,0,0.0,0.0
1010,2222,26-09-2019 13:42:00,1,2705.0,2524.0,0.933,13.451,2,0,0,0,2,0,2,0,0.0,0.0
1010,2223,26-09-2019 13:44:00,1,2716.0,2488.0,0.916,13.457,0,0,0,0,0,0,0,0,0.0,0.0
1010,2224,26-09-2019 13:46:00,1,2717.0,2507.0,0.923,13.481,0,0,0,0,0,0,0,0,0.0,0.0
1010,2225,26-09-2019 13:48:00,1,2706.0,2502.0,0.925,13.431,10,2,0,2,8,5,3,0,0.0,0.0
1010,2226,26-09-2019 13:50:00,1,2723.0,2465.0,0.906,13.456,2,0,0,0,2,1,1,0,0.01,0.0
1010,2227,26-09-2019 13:52:00,1,2718.0,2461.0,0.906,13.435,0,0,0,0,0,0,0,0,0.0,0.0
1010,2228,26-09-2019 13:54:00,1,2716.0,2484.0,0.915,13.45,2,0,0,0,2,1,1,0,0.0,0.0
1010,2229,26-09-2019 13:56:00,1,2721.0,2457.0,0.903,13.442,70,26,15,11,44,29,15,0,0.0,0.0
1010,2230,26-09-2019 13:58:00,1,2713.0,2489.0,0.917,13.447,54,13,0,13,41,2,39,0,0.0,0.0
1010,2231,26-09-2019 14:00:00,1,2717.0,2466.0,0.908,13.435,58,19,1,18,39,7,32,0,0.0,0.0
1010,2232,26-09-2019 14:02:00,1,2835.0,2513.0,0.886,13.951,20,9,4,5,11,4,7,0,0.0,0.0
1010,2233,26-09-2019 14:04:00,1,3063.0,2582.0,0.843,14.928,2,2,0,2,0,0,0,0,0.0,0.0
1010,2234,26-09-2019 14:06:00,1,2720.0,2477.0,0.911,13.458,9,7,0,7,2,1,1,0,0.0,0.0
1010,2235,26-09-2019 14:08:00,1,2740.0,2351.0,0.858,13.398,5,3,0,3,2,0,2,0,0.0,0.0
1010,2236,26-09-2019 14:10:00,1,2742.5,2360.5,0.861,13.4175,1,0,0,0,1,0,1,0,0.0,0.0
1010,2237,26-09-2019 14:12:00,1,2745.0,2370.0,0.864,13.437,0,0,0,0,0,0,0,0,0.0,0.0
1010,2238,26-09-2019 14:14:00,1,2756.0,2336.0,0.847,13.445,3,2,0,2,1,0,1,0,0.0,0.0
1010,2239,26-09-2019 14:16:00,1,2762.0,2310.0,0.836,13.44,2,1,0,1,1,0,1,0,0.0,0.0
1010,2240,26-09-2019 14:18:00,1,2762.0,2292.0,0.83,13.422,40,31,17,14,9,5,4,0,0.0,0.0
1010,2241,26-09-2019 14:20:00,1,2755.0,2347.0,0.852,13.452,70,47,25,22,23,4,19,0,0.0,0.0
1010,2242,26-09-2019 14:22:00,1,3056.0,2596.0,0.85,14.917,41,26,7,19,15,2,13,0,0.0,0.0
1010,2243,26-09-2019 14:24:00,1,3043.0,2648.0,0.87,14.92,89,67,35,32,22,1,21,1,0.0,0.0
1010,2244,26-09-2019 14:26:00,1,3143.0,2765.0,0.88,15.443,77,75,38,37,2,1,1,0,0.0,0.0
1010,2245,26-09-2019 14:28:00,1,3256.0,2796.0,0.859,15.924,76,70,29,41,6,3,3,0,0.0,0.0
1010,2246,26-09-2019 14:30:00,1,3129.0,2755.0,0.881,15.379,278,176,127,49,102,71,31,5,0.0,0.0
1010,2247,26-09-2019 14:32:00,1,3037.0,2688.0,0.885,14.941,33,9,5,4,24,2,22,0,0.0,0.0
1010,2248,26-09-2019 14:34:00,1,3044.0,2650.0,0.87,14.927,28,10,4,6,18,4,14,0,0.0,0.01
1010,2249,26-09-2019 14:36:00,1,3047.0,2655.0,0.871,14.945,2,0,0,0,2,1,1,0,0.0,0.0
1010,2250,26-09-2019 14:38:00,1,2945.0,2541.0,0.863,14.417,7,1,0,1,6,2,4,0,0.0,0.0
1010,2251,26-09-2019 14:40:00,1,2733.0,2414.0,0.883,13.443,7,3,2,1,4,1,3,0,0.0,0.0
1010,2252,26-09-2019 14:42:00,1,2761.0,2318.0,0.839,13.444,2,2,0,2,0,0,0,0,0.0,0.0
1010,2253,26-09-2019 14:44:00,1,2649.5,2249.0,0.849,12.9295,0,0,0,0,0,0,0,0,0.0,0.0
1010,2254,26-09-2019 14:46:00,1,2538.0,2180.0,0.859,12.415,9,6,0,6,3,0,3,0,0.0,0.0
1010,2255,26-09-2019 14:48:00,1,2547.0,2184.0,0.857,12.453,0,0,0,0,0,0,0,0,0.0,0.0
1010,2256,26-09-2019 14:50:00,1,2548.0,2160.0,0.848,12.428,0,0,0,0,0,0,0,0,0.0,0.0
1010,2257,26-09-2019 14:52:00,1,2562.0,2098.0,0.819,12.415,8,5,2,3,3,0,3,0,0.0,0.0
1010,2258,26-09-2019 14:54:00,1,2553.0,2119.0,0.83,12.407,4,1,0,1,3,0,3,0,0.0,0.0
1010,2259,26-09-2019 14:56:00,1,2570.0,2102.0,0.818,12.453,20,13,6,7,7,3,4,0,0.0,0.0
1010,2260,26-09-2019 14:58:00,1,2566.0,2060.0,0.803,12.392,3,2,1,1,1,0,1,0,0.0,0.0
1010,2261,26-09-2019 15:00:00,1,2545.0,2133.0,0.838,12.387,2,0,0,0,2,0,2,0,0.0,0.0
1010,2262,26-09-2019 15:02:00,1,2792.0,2201.0,0.788,13.437,9,9,1,8,0,0,0,0,0.0,0.0
1010,2263,26-09-2019 15:04:00,1,2792.0,2219.0,0.795,13.458,39,39,0,39,0,0,0,0,0.0,0.0
1010,2264,26-09-2019 15:06:00,1,2769.0,2239.0,0.809,13.391,13,12,0,12,1,0,1,0,0.0,0.0
1010,2265,26-09-2019 15:08:00,1,2788.0,2217.0,0.795,13.439,0,0,0,0,0,0,0,0,0.0,0.0
1010,2266,26-09-2019 15:10:00,1,2794.0,2157.0,0.772,13.397,0,0,0,0,0,0,0,0,0.0,0.0
1010,2267,26-09-2019 15:12:00,1,2792.0,2190.0,0.784,13.424,1,0,0,0,1,0,1,0,0.0,0.0
1010,2268,26-09-2019 15:14:00,1,2784.0,2274.0,0.817,13.485,34,31,13,18,3,1,2,0,0.0,0.0
1010,2269,26-09-2019 15:16:00,1,3006.0,2336.0,0.777,14.429,31,31,8,23,0,0,0,0,0.0,0.0
1010,2270,26-09-2019 15:18:00,1,2889.5,2290.5,0.7935,13.919,11,11,2,9,0,0,0,0,0.01,0.0
1010,2271,26-09-2019 15:20:00,1,2773.0,2245.0,0.81,13.409,1,1,0,1,0,0,0,0,0.0,0.0
1010,2272,26-09-2019 15:22:00,1,2784.0,2167.0,0.778,13.369,219,74,35,39,145,97,48,1,0.0,0.0
1010,2273,26-09-2019 15:24:00,1,3019.0,2298.0,0.761,14.439,146,60,36,24,86,41,45,3,0.0,0.0
1010,2274,26-09-2019 15:26:00,1,3099.0,2432.0,0.785,14.903,29,5,0,5,24,0,24,0,0.0,0.0
1010,2275,26-09-2019 15:28:00,1,3101.0,2446.0,0.789,14.926,63,30,12,18,33,6,27,0,0.0,0.0
1010,2276,26-09-2019 15:30:00,1,3315.0,2600.0,0.784,15.94,69,36,14,22,33,13,20,2,0.0,0.0
1010,2277,26-09-2019 15:32:00,1,3265.0,2725.0,0.835,15.883,195,80,48,32,115,65,50,46,0.0,0.07
1010,2278,26-09-2019 15:34:00,1,3602.0,2927.0,0.813,17.432,190,75,39,36,115,71,44,74,0.0,0.0
1010,2279,26-09-2019 15:36:00,1,3576.0,2954.0,0.826,17.361,297,164,133,31,133,93,40,59,0.0,0.0
1010,2280,26-09-2019 15:38:00,1,3075.0,2535.0,0.824,14.925,145,48,18,30,97,53,44,0,0.0,0.01
1010,2281,26-09-2019 15:40:00,1,3275.0,2675.0,0.817,15.867,41,5,0,5,36,4,32,0,0.0,0.0
1010,2282,26-09-2019 15:42:00,1,3284.0,2698.0,0.822,15.926,47,4,0,4,43,9,34,0,0.0,0.0
1010,2283,26-09-2019 15:44:00,1,3298.0,2649.0,0.803,15.926,35,4,0,4,31,4,27,0,0.0,0.0
1010,2284,26-09-2019 15:46:00,1,3309.0,2604.0,0.787,15.922,66,0,0,0,66,33,33,0,0.0,0.0
1010,2285,26-09-2019 15:48:00,1,3082.0,2541.0,0.824,14.955,47,2,0,2,45,18,27,0,0.0,0.0
1010,2286,26-09-2019 15:50:00,1,3101.0,2499.0,0.806,14.985,105,3,0,3,102,74,28,0,0.0,0.0
1010,2287,26-09-2019 15:52:00,1,2974.5,2463.0,0.829,14.447,117,0,0,0,117,77,40,0,0.0,0.0
1010,2288,26-09-2019 15:54:00,1,2848.0,2427.0,0.852,13.909,63,4,1,3,59,17,42,0,0.0,0.0
1010,2289,26-09-2019 15:56:00,1,2968.0,2459.0,0.829,14.415,68,4,3,1,64,26,38,0,0.0,0.0
1010,2290,26-09-2019 15:58:00,1,2964.0,2464.0,0.832,14.405,27,0,0,0,27,0,27,0,0.0,0.0
1010,2291,26-09-2019 16:00:00,1,2983.0,2451.0,0.822,14.466,50,6,2,4,44,8,36,0,0.0,0.0
1010,2292,26-09-2019 16:02:00,1,2843.0,2456.0,0.864,13.92,68,15,5,10,53,13,40,0,0.0,0.0
1010,2293,26-09-2019 16:04:00,1,2728.0,2454.0,0.9,13.465,31,0,0,0,31,0,31,0,0.0,0.0
1010,2294,26-09-2019 16:06:00,1,2837.0,2482.0,0.875,13.926,37,7,1,6,30,0,30,0,0.0,0.01
1010,2295,26-09-2019 16:08:00,1,2836.0,2469.0,0.871,13.91,29,5,0,5,24,0,24,0,0.0,0.0
1010,2296,26-09-2019 16:10:00,1,2845.0,2461.0,0.865,13.932,16,1,0,1,15,0,15,0,0.0,0.0
1010,2297,26-09-2019 16:12:00,1,2838.0,2470.0,0.87,13.917,21,14,0,14,7,0,7,0,0.0,0.0
1010,2298,26-09-2019 16:14:00,1,2851.0,2458.0,0.862,13.953,35,7,0,7,28,0,28,0,0.0,0.0
1010,2299,26-09-2019 16:16:00,1,2965.0,2470.0,0.833,14.415,43,8,4,4,35,8,27,0,0.0,0.0
1010,2300,26-09-2019 16:18:00,1,2967.0,2486.0,0.838,14.442,27,0,0,0,27,0,27,0,0.0,0.01
1010,2301,26-09-2019 16:20:00,1,2968.0,2478.0,0.835,14.439,78,14,3,11,64,24,40,0,0.0,0.0
1010,2302,26-09-2019 16:22:00,1,3069.0,2581.0,0.841,14.948,161,30,8,22,131,81,50,0,0.0,0.0
1010,2303,26-09-2019 16:24:00,1,3057.0,2639.0,0.863,14.967,199,76,40,36,123,81,42,6,0.0,0.0
1010,2304,26-09-2019 16:26:00,1,3103.0,2656.0,0.856,15.1675,208,70,39,31,138,86,52,12,0.0,0.0
1010,2305,26-09-2019 16:28:00,1,3149.0,2673.0,0.849,15.368,173,68,33,35,105,52,53,71,0.0,0.0
1010,2306,26-09-2019 16:30:00,1,3232.0,2850.0,0.882,15.888,189,77,31,46,112,66,46,79,0.0,0.0
1010,2307,26-09-2019 16:32:00,1,3587.0,2984.0,0.832,17.435,472,264,218,46,208,169,39,66,0.0,0.04
1010,2308,26-09-2019 16:34:00,1,3243.0,2864.0,0.883,15.948,162,49,21,28,113,47,66,66,0.0,0.0
1010,2309,26-09-2019 16:36:00,1,3575.0,2997.0,0.838,17.403,133,42,21,21,91,44,47,48,0.0,0.07
1010,2310,26-09-2019 16:38:00,1,3758.0,3204.0,0.853,18.353,923,441,363,78,482,386,96,18,0.1,0.04
1010,2311,26-09-2019 16:40:00,1,3355.0,2912.0,0.868,16.442,901,434,360,74,467,374,93,1,0.0,0.01
1010,2312,26-09-2019 16:42:00,1,3549.0,3078.0,0.867,17.39,138,60,43,17,78,57,21,82,0.0,0.01
1010,2313,26-09-2019 16:44:00,1,3061.0,2604.0,0.851,14.942,115,24,13,11,91,47,44,0,0.0,0.0
1010,2314,26-09-2019 16:46:00,1,2752.0,2355.0,0.856,13.451,149,33,8,25,116,73,43,0,0.0,0.0
1010,2315,26-09-2019 16:48:00,1,3048.0,2639.0,0.866,14.93,48,8,0,8,40,1,39,0,0.0,0.0
1010,2316,26-09-2019 16:50:00,1,3268.0,2734.0,0.836,15.904,48,1,0,1,47,23,24,0,0.0,0.0
1010,2317,26-09-2019 16:52:00,1,3238.0,2843.0,0.878,15.907,42,2,0,2,40,11,29,0,0.02,0.0
1010,2318,26-09-2019 16:54:00,1,3245.0,2840.0,0.875,15.929,39,0,0,0,39,12,27,0,0.0,0.0
1010,2319,26-09-2019 16:56:00,1,3270.0,2801.0,0.856,15.986,38,2,0,2,36,4,32,0,0.0,0.0
1010,2320,26-09-2019 16:58:00,1,3244.0,2777.0,0.856,15.856,41,6,2,4,35,8,27,0,0.0,0.0
1010,2321,26-09-2019 17:00:00,1,3251.0,2796.5,0.86,15.906,55,6,2,4,49,17,32,0,0.0,0.0
1010,2322,26-09-2019 17:02:00,1,3258.0,2816.0,0.864,15.956,37,2,0,2,35,5,30,0,0.0,0.0
1010,2323,26-09-2019 17:04:00,1,3245.0,2803.0,0.864,15.887,43,6,2,4,37,12,25,0,0.0,0.0
1010,2324,26-09-2019 17:06:00,1,3234.0,2839.0,0.878,15.886,35,4,1,3,31,1,30,0,0.0,0.0
1010,2325,26-09-2019 17:08:00,1,3244.0,2845.0,0.877,15.932,43,8,1,7,35,6,29,0,0.0,0.0
1010,2326,26-09-2019 17:10:00,1,3249.0,2851.0,0.877,15.955,45,0,0,0,45,15,30,0,0.0,0.0
1010,2327,26-09-2019 17:12:00,1,3247.0,2831.0,0.872,15.927,26,0,0,0,26,2,24,0,0.0,0.0
1010,2328,26-09-2019 17:14:00,1,3012.0,2761.0,0.917,14.925,36,0,0,0,36,0,36,0,0.0,0.0
1010,2329,26-09-2019 17:16:00,1,3027.0,2735.0,0.903,14.956,25,0,0,0,25,0,25,0,0.0,0.0
1010,2330,26-09-2019 17:18:00,1,3016.0,2710.0,0.898,14.885,154,30,6,24,124,72,52,1,0.0,0.0
1010,2331,26-09-2019 17:20:00,1,3243.0,2875.0,0.887,15.96,190,49,27,22,141,80,61,0,0.0,0.0
1010,2332,26-09-2019 17:22:00,1,3212.0,2977.0,0.927,15.952,153,27,8,19,126,85,41,0,0.0,0.0
1010,2333,26-09-2019 17:24:00,1,3554.0,3067.0,0.863,17.399,150,47,22,25,103,63,40,0,0.0,0.0
1010,2334,26-09-2019 17:26:00,1,3541.0,3114.0,0.879,17.399,235,38,12,26,197,147,50,0,0.0,0.0
1010,2335,26-09-2019 17:28:00,1,3529.0,3155.0,0.894,17.396,220,91,50,41,129,86,43,0,0.0,0.0
1010,2336,26-09-2019 17:30:00,1,3535.0,3173.0,0.898,17.442,136,31,9,22,105,67,38,0,0.0,0.0
1010,2337,26-09-2019 17:32:00,1,3521.0,3178.0,0.903,17.392,156,52,23,29,104,60,44,0,0.0,0.0
1010,2338,26-09-2019 17:34:00,1,3522.0,3178.0,0.9025,17.3955,173,68,37,31,105,65,40,0,0.0,0.0
1010,2339,26-09-2019 17:36:00,1,3523.0,3178.0,0.902,17.399,214,96,63,33,118,68,50,42,0.0,0.0
1010,2340,26-09-2019 17:38:00,1,3776.0,3232.0,0.856,18.456,156,51,29,22,105,53,52,61,0.0,0.0
1010,2341,26-09-2019 17:40:00,1,3732.0,3301.0,0.884,18.36,207,91,50,41,116,55,61,62,0.0,0.02
1010,2342,26-09-2019 17:42:00,1,3737.0,3327.0,0.89,18.406,150,57,25,32,93,49,44,52,0.0,0.07
1010,2343,26-09-2019 17:44:00,1,3729.0,3419.0,0.917,18.478,241,104,82,22,137,94,43,34,0.07,0.02
1010,2344,26-09-2019 17:46:00,1,3570.0,3049.0,0.854,17.442,134,94,69,25,40,27,13,83,0.0,0.0
1010,2345,26-09-2019 17:48:00,1,3851.0,3423.0,0.889,18.961,242,150,106,44,92,64,28,48,0.0,0.0
1010,2346,26-09-2019 17:50:00,1,3545.0,3114.0,0.878,17.413,303,180,147,33,123,82,41,73,0.0,0.0
1010,2347,26-09-2019 17:52:00,1,3033.0,2685.0,0.885,14.924,53,5,2,3,48,18,30,0,0.0,0.0
1010,2348,26-09-2019 17:54:00,1,3070.0,2560.0,0.834,14.931,85,9,1,8,76,32,44,0,0.0,0.0
1010,2349,26-09-2019 17:56:00,1,3451.0,2964.0,0.859,16.879,26,0,0,0,26,4,22,0,0.0,0.0
1010,2350,26-09-2019 17:58:00,1,3560.0,3064.0,0.861,17.417,27,0,0,0,27,0,27,0,0.0,0.0
1010,2351,26-09-2019 18:00:00,0,3582.0,3023.0,0.844,17.46,79,17,11,6,62,27,35,4,0.0,0.0
1010,2352,26-09-2019 18:02:00,0,3728.0,3325.0,0.892,18.371,411,242,190,52,169,128,41,44,0.0,0.0
1010,2353,26-09-2019 18:04:00,0,4043.0,3677.0,0.91,19.998,548,328,270,58,220,179,41,14,0.0,0.0
1010,2354,26-09-2019 18:06:00,0,4103.0,3833.0,0.934,20.408,569,364,303,61,205,163,42,61,0.0,0.0
1010,2355,26-09-2019 18:08:00,0,4103.0,3820.0,0.931,20.393,308,188,153,35,120,97,23,82,0.0,0.0
1010,2356,26-09-2019 18:10:00,0,4103.0,3807.0,0.928,20.378,335,181,130,51,154,112,42,20,0.0,0.0
1010,2357,26-09-2019 18:12:00,0,4022.0,3702.0,0.92,19.945,224,63,32,31,161,105,56,3,0.0,0.0
1010,2358,26-09-2019 18:14:00,0,4006.0,3727.0,0.93,19.909,177,65,26,39,112,60,52,7,0.0,0.0
1010,2359,26-09-2019 18:16:00,0,4020.0,3687.0,0.917,19.921,62,22,2,20,40,11,29,0,0.0,0.0
1010,2360,26-09-2019 18:18:00,0,4018.0,3556.0,0.885,19.769,37,0,0,0,37,4,33,0,0.0,0.0
1010,2361,26-09-2019 18:20:00,0,3729.0,3399.0,0.911,18.457,60,24,6,18,36,4,32,0,0.0,0.0
1010,2362,26-09-2019 18:22:00,0,3718.0,3356.0,0.903,18.362,55,24,0,24,31,13,18,0,0.01,0.0
1010,2363,26-09-2019 18:24:00,0,3746.0,3349.0,0.894,18.467,12,6,0,6,6,3,3,0,0.0,0.0
1010,2364,26-09-2019 18:26:00,0,3540.0,3162.0,0.893,17.447,51,21,9,12,30,0,30,0,0.0,0.0
1010,2365,26-09-2019 18:28:00,0,3444.0,3025.0,0.878,16.916,317,183,146,37,134,93,41,33,0.0,0.0
1010,2366,26-09-2019 18:30:00,0,3825.0,3447.0,0.901,18.888,681,448,381,67,233,193,40,78,0.0,0.0
1010,2367,26-09-2019 18:32:00,0,3733.0,3397.0,0.91,18.471,336,228,193,35,108,84,24,55,0.0,0.0
1010,2368,26-09-2019 18:34:00,0,3732.0,3340.0,0.895,18.403,499,267,220,47,232,189,43,71,0.0,0.0
1010,2369,26-09-2019 18:36:00,0,3722.0,3418.0,0.918,18.448,338,195,145,50,143,103,40,15,0.0,0.0
1010,2370,26-09-2019 18:38:00,0,3743.0,3335.0,0.891,18.438,116,41,20,21,75,41,34,6,0.0,0.0
1010,2371,26-09-2019 18:40:00,0,3758.0,3272.0,0.871,18.431,146,60,31,29,86,50,36,1,0.0,0.0
1010,2372,26-09-2019 18:42:00,0,3753.0,3284.0,0.875,18.4235,94,50,24,26,44,16,28,1,0.0,0.0
1010,2373,26-09-2019 18:44:00,0,3748.0,3296.0,0.879,18.416,473,275,226,49,198,157,41,3,0.0,0.0
1010,2374,26-09-2019 18:46:00,0,3858.0,3358.0,0.871,18.918,351,201,157,44,150,109,41,29,0.0,0.0
1010,2375,26-09-2019 18:48:00,0,3760.0,3297.0,0.877,18.466,264,171,135,36,93,66,27,25,0.0,0.0
1010,2376,26-09-2019 18:50:00,0,3984.0,3307.0,0.83,19.359,243,109,84,25,134,109,25,3,0.0,0.0
1010,2377,26-09-2019 18:52:00,0,3787.0,3136.0,0.828,18.394,30,0,0,0,30,10,20,0,0.0,0.0
1010,2378,26-09-2019 18:54:00,0,3797.0,3099.0,0.816,18.393,48,0,0,0,48,18,30,0,0.0,0.0
1010,2379,26-09-2019 18:56:00,0,3589.0,2958.0,0.824,17.417,22,0,0,0,22,2,20,0,0.0,0.0
1010,2380,26-09-2019 18:58:00,0,3362.0,2806.0,0.834,16.353,26,0,0,0,26,2,24,0,0.0,0.0
1010,2381,26-09-2019 19:00:00,0,3298.0,2684.0,0.814,15.967,21,0,0,0,21,2,19,0,0.0,0.0
1010,2382,26-09-2019 19:02:00,0,3195.0,2576.0,0.806,15.439,42,0,0,0,42,15,27,0,0.0,0.0
1010,2383,26-09-2019 19:04:00,0,3081.0,2496.0,0.81,14.903,24,0,0,0,24,0,24,0,0.0,0.0
1010,2384,26-09-2019 19:06:00,0,3111.0,2419.0,0.778,14.936,142,18,5,13,124,76,48,0,0.0,0.0
1010,2385,26-09-2019 19:08:00,0,3089.0,2474.0,0.801,14.909,373,181,144,37,192,148,44,12,0.0,0.0
1010,2386,26-09-2019 19:10:00,0,3630.0,2781.0,0.766,17.384,447,251,205,46,196,158,38,60,0.0,0.0
1010,2387,26-09-2019 19:12:00,0,3613.0,2844.0,0.787,17.386,447,251,195,56,196,154,42,0,0.0,0.0
1010,2388,26-09-2019 19:14:00,0,3849.0,2933.0,0.762,18.414,354,143,98,45,211,155,56,2,0.0,0.0
1010,2389,26-09-2019 19:16:00,0,3788.0,2927.5,0.773,18.1675,469,270,226,44,199,162,37,45,0.0,0.0
1010,2390,26-09-2019 19:18:00,0,3727.0,2922.0,0.784,17.921,453,265,207,58,188,138,50,44,0.0,0.0
1010,2391,26-09-2019 19:20:00,0,3825.0,2987.0,0.781,18.376,356,228,188,40,128,105,23,39,0.0,0.0
1010,2392,26-09-2019 19:22:00,0,3821.0,3034.0,0.794,18.414,190,74,44,30,116,78,38,2,0.0,0.0
1010,2393,26-09-2019 19:24:00,0,4159.0,3137.0,0.754,19.858,400,229,177,52,171,125,46,26,0.0,0.0
1010,2394,26-09-2019 19:26:00,0,3841.0,2958.0,0.77,18.409,237,131,99,32,106,84,22,10,0.0,0.0
1010,2395,26-09-2019 19:28:00,0,3838.0,2978.0,0.776,18.422,172,90,51,39,82,42,40,0,0.0,0.0
1010,2396,26-09-2019 19:30:00,0,3824.0,2978.0,0.779,18.366,294,165,123,42,129,97,32,7,0.0,0.0
1010,2397,26-09-2019 19:32:00,0,3819.0,2977.0,0.779,18.344,139,80,70,10,59,45,14,117,0.0,0.0
1010,2398,26-09-2019 19:34:00,0,3835.0,3017.0,0.787,18.449,204,77,60,17,127,81,46,8,0.0,0.0
1010,2399,26-09-2019 19:36:00,0,3420.0,2698.0,0.789,16.46,188,50,21,29,138,80,58,0,0.0,0.0
1010,2400,26-09-2019 19:38:00,0,3859.0,2906.0,0.753,18.423,314,173,129,44,141,108,33,44,0.0,0.0
1010,2401,26-09-2019 19:40:00,0,3916.0,3115.0,0.796,18.878,77,36,28,8,41,20,21,2,0.01,0.0
1010,2402,26-09-2019 19:42:00,0,3817.0,3011.0,0.789,18.374,28,3,2,1,25,4,21,0,0.0,0.0
1010,2403,26-09-2019 19:44:00,0,3733.0,2897.0,0.776,17.917,29,0,0,0,29,11,18,0,0.0,0.0
1010,2404,26-09-2019 19:46:00,0,3637.0,2756.0,0.758,17.381,42,0,0,0,42,10,32,0,0.0,0.0
1010,2405,26-09-2019 19:48:00,0,3311.0,2604.0,0.787,15.927,41,2,1,1,39,11,28,0,0.0,0.0
1010,2406,26-09-2019 19:50:00,0,3168.0,2433.5,0.7675,15.1755,46,2,0,2,44,20,24,0,0.0,0.0
1010,2407,26-09-2019 19:52:00,0,3025.0,2263.0,0.748,14.424,16,0,0,0,16,2,14,0,0.0,0.0
1010,2408,26-09-2019 19:54:00,0,2799.0,2177.0,0.778,13.44,38,0,0,0,38,0,38,0,0.0,0.0
1010,2409,26-09-2019 19:56:00,0,2821.0,2086.0,0.739,13.425,19,1,1,0,18,0,18,0,0.0,0.0
1010,2410,26-09-2019 19:58:00,0,2722.0,2012.0,0.739,12.953,124,34,15,19,90,46,44,8,0.0,0.0
1010,2411,26-09-2019 20:00:00,0,2912.0,2205.0,0.757,13.916,541,270,231,39,271,215,56,33,0.0,0.0
1010,2412,26-09-2019 20:02:00,0,3641.0,2749.0,0.755,17.391,541,323,263,60,218,167,51,88,0.0,0.0
1010,2413,26-09-2019 20:04:00,0,3647.0,2728.0,0.748,17.389,317,167,128,39,150,114,36,100,0.0,0.0
1010,2414,26-09-2019 20:06:00,0,3859.0,2899.0,0.751,18.414,386,236,192,44,150,126,24,59,0.0,0.0
1010,2415,26-09-2019 20:08:00,0,3840.0,2931.0,0.763,18.374,254,140,110,30,114,99,15,120,0.0,0.0
1010,2416,26-09-2019 20:10:00,0,4287.0,3210.0,0.749,20.445,318,195,160,35,123,93,30,68,0.0,0.0
1010,2417,26-09-2019 20:12:00,0,4150.0,3148.0,0.759,19.837,274,139,97,42,135,91,44,16,0.0,0.0
1010,2418,26-09-2019 20:14:00,0,4179.0,3077.0,0.736,19.874,267,126,81,45,141,98,43,0,0.0,0.0
1010,2419,26-09-2019 20:16:00,0,3948.0,2968.0,0.752,18.84,275,129,88,41,146,94,52,2,0.0,0.0
1010,2420,26-09-2019 20:18:00,0,4195.0,3000.0,0.715,19.85,246,122,91,31,124,88,36,5,0.0,0.0
1010,2421,26-09-2019 20:20:00,0,4197.0,3056.0,0.728,19.919,180,94,75,19,86,65,21,69,0.0,0.0
1010,2422,26-09-2019 20:22:00,0,4068.0,3034.0,0.746,19.388,365,186,151,35,179,142,37,87,0.11,0.0
1010,2423,26-09-2019 20:24:00,0,4066.5,3030.5,0.7455,19.3775,409,277,231,46,132,101,31,156,0.0,0.0
1010,2424,26-09-2019 20:26:00,0,4065.0,3027.0,0.745,19.367,198,116,65,51,82,44,38,0,0.0,0.0
1010,2425,26-09-2019 20:28:00,0,4185.0,3055.0,0.73,19.872,153,95,52,43,58,34,24,0,0.0,0.0
1010,2426,26-09-2019 20:30:00,0,3850.0,2935.0,0.762,18.418,281,151,103,48,130,85,45,5,0.0,0.0
1010,2427,26-09-2019 20:32:00,0,4163.0,3148.0,0.756,19.888,405,222,175,47,183,144,39,81,0.0,0.0
1010,2428,26-09-2019 20:34:00,0,4041.0,3076.0,0.761,19.329,404,248,195,53,156,124,32,50,0.0,0.0
1010,2429,26-09-2019 20:36:00,0,4068.0,3057.0,0.751,19.411,208,99,60,39,109,70,39,2,0.0,0.0
1010,2430,26-09-2019 20:38:00,0,4153.0,3097.0,0.746,19.792,171,44,15,29,127,78,49,0,0.0,0.0
1010,2431,26-09-2019 20:40:00,0,4067.0,3050.0,0.75,19.399,327,166,120,46,161,109,52,13,0.0,0.0
1010,2432,26-09-2019 20:42:00,0,3863.0,2878.0,0.745,18.409,165,81,57,24,84,58,26,87,0.0,0.0
1010,2433,26-09-2019 20:44:00,0,4065.0,3057.0,0.752,19.403,235,138,107,31,97,71,26,74,0.0,0.0
1010,2434,26-09-2019 20:46:00,0,4142.0,3197.0,0.772,19.86,156,30,6,24,126,80,46,0,0.0,0.0
1010,2435,26-09-2019 20:48:00,0,4049.0,3052.0,0.754,19.335,158,78,42,36,80,42,38,0,0.0,0.0
1010,2436,26-09-2019 20:50:00,0,3830.0,3006.0,0.785,18.419,499,339,260,79,160,125,35,33,0.0,0.0
1010,2437,26-09-2019 20:52:00,0,4155.0,3171.0,0.763,19.88,526,367,284,83,159,123,36,9,0.0,0.0
1010,2438,26-09-2019 20:54:00,0,4148.0,3186.0,0.768,19.871,565,401,316,85,164,123,41,10,0.0,0.0
1010,2439,26-09-2019 20:56:00,0,4142.0,3161.0,0.763,19.818,459,349,256,93,110,83,27,20,0.0,0.0
1010,2440,26-09-2019 20:58:00,0,4143.0,3195.5,0.771,19.86,439,311,234,77,128,93,35,27,0.0,0.0
1010,2441,26-09-2019 21:00:00,0,4144.0,3230.0,0.779,19.902,338,196,159,37,142,94,48,15,0.0,0.0
1010,2442,26-09-2019 21:02:00,0,4374.0,3317.0,0.758,20.908,233,60,36,24,173,117,56,6,0.0,0.0
1010,2443,26-09-2019 21:04:00,0,4163.0,3152.0,0.757,19.892,266,157,111,46,109,58,51,10,0.0,0.0
1010,2444,26-09-2019 21:06:00,0,3845.0,2941.0,0.765,18.408,149,87,50,37,62,33,29,0,0.0,0.0
1010,2445,26-09-2019 21:08:00,0,4175.0,3051.0,0.731,19.83,126,71,34,37,55,28,27,2,0.0,0.0
1010,2446,26-09-2019 21:10:00,0,3868.0,2862.0,0.74,18.409,280,158,123,35,122,86,36,66,0.0,0.0
1010,2447,26-09-2019 21:12:00,0,3798.0,3030.0,0.798,18.32,314,171,138,33,143,114,29,47,0.0,0.0
1010,2448,26-09-2019 21:14:00,0,3808.0,3002.0,0.788,18.329,412,315,239,76,97,75,22,21,0.0,0.0
1010,2449,26-09-2019 21:16:00,0,4166.0,3176.0,0.762,19.932,384,220,165,55,164,115,49,30,0.0,0.0
1010,2450,26-09-2019 21:18:00,0,3848.0,2903.0,0.754,18.376,133,58,34,24,75,42,33,69,0.0,0.0
1010,2451,26-09-2019 21:20:00,0,4169.0,3094.0,0.742,19.854,124,37,19,18,87,52,35,17,0.0,0.0
1010,2452,26-09-2019 21:22:00,0,3813.0,2994.0,0.785,18.338,344,215,170,45,129,90,39,85,0.0,0.0
1010,2453,26-09-2019 21:24:00,0,4066.0,3007.0,0.74,19.349,135,54,20,34,81,41,40,0,0.0,0.0
1010,2454,26-09-2019 21:26:00,0,3850.0,2916.0,0.757,18.399,111,79,33,46,32,0,32,0,0.0,0.0
1010,2455,26-09-2019 21:28:00,0,3866.0,2856.0,0.739,18.395,185,74,39,35,111,63,48,0,0.0,0.0
1010,2456,26-09-2019 21:30:00,0,3955.0,3001.0,0.759,18.905,270,111,80,31,159,106,53,2,0.0,0.0
1010,2457,26-09-2019 21:32:00,0,4063.5,3035.0,0.7475,19.371,374,226,183,43,148,113,35,45,0.0,0.0
1010,2458,26-09-2019 21:34:00,0,4172.0,3069.0,0.736,19.837,343,175,136,39,168,123,45,86,0.06,0.0
1010,2459,26-09-2019 21:36:00,0,4072.0,3076.0,0.756,19.449,461,185,136,49,276,220,56,109,0.0,0.0
1010,2460,26-09-2019 21:38:00,0,3947.0,3044.0,0.771,18.92,415,246,207,39,169,129,40,159,0.0,0.0
1010,2461,26-09-2019 21:40:00,0,4055.0,3016.0,0.744,19.316,147,23,7,16,124,73,51,0,0.0,0.0
1010,2462,26-09-2019 21:42:00,0,4173.0,3117.0,0.747,19.891,227,78,49,29,149,97,52,1,0.0,0.0
1010,2463,26-09-2019 21:44:00,0,3860.0,2900.0,0.751,18.419,127,64,27,37,63,32,31,2,0.0,0.0
1010,2464,26-09-2019 21:46:00,0,3758.0,2803.0,0.746,17.911,146,79,44,35,67,39,28,1,0.0,0.0
1010,2465,26-09-2019 21:48:00,0,3837.0,2898.0,0.755,18.328,376,202,168,34,174,145,29,97,0.0,0.0
1010,2466,26-09-2019 21:50:00,0,4158.0,3188.0,0.767,19.913,434,291,215,76,143,104,39,21,0.0,0.0
1010,2467,26-09-2019 21:52:00,0,4046.0,3035.0,0.75,19.303,545,360,276,84,185,136,49,12,0.0,0.0
1010,2468,26-09-2019 21:54:00,0,4182.0,3056.0,0.731,19.863,326,216,152,64,110,69,41,11,0.0,0.0
1010,2469,26-09-2019 21:56:00,0,4202.0,3009.0,0.716,19.888,178,104,61,43,74,44,30,7,0.0,0.0
1010,2470,26-09-2019 21:58:00,0,4315.0,3046.0,0.706,20.373,162,52,32,20,110,63,47,2,0.0,0.0
1010,2471,26-09-2019 22:00:00,0,4212.0,2993.0,0.711,19.91,317,216,165,51,101,68,33,102,0.0,0.0
1010,2472,26-09-2019 22:02:00,0,4208.0,2942.0,0.699,19.837,439,318,249,69,121,83,38,57,0.0,0.0
1010,2473,26-09-2019 22:04:00,0,4328.0,3040.0,0.702,20.418,172,40,16,24,132,82,50,0,0.0,0.0
1010,2474,26-09-2019 22:06:00,0,4164.0,2944.5,0.707,19.667,122,75,27,48,47,22,25,0,0.0,0.0
1010,2475,26-09-2019 22:08:00,0,4000.0,2849.0,0.712,18.916,214,71,28,43,143,92,51,2,0.0,0.0
1010,2476,26-09-2019 22:10:00,0,4177.0,3087.0,0.739,19.876,188,88,55,33,100,58,42,7,0.0,0.0
1010,2477,26-09-2019 22:12:00,0,4051.0,3022.0,0.746,19.308,300,162,106,56,138,95,43,14,0.0,0.0
1010,2478,26-09-2019 22:14:00,0,3944.0,3015.0,0.765,18.878,457,354,271,83,103,74,29,3,0.0,0.0
1010,2479,26-09-2019 22:16:00,0,4179.0,3078.0,0.737,19.872,353,226,166,60,127,87,40,32,0.0,0.0
1010,2480,26-09-2019 22:18:00,0,3983.0,2878.0,0.723,18.881,304,194,137,57,110,71,39,17,0.0,0.0
1010,2481,26-09-2019 22:20:00,0,3967.0,2966.0,0.748,18.915,423,296,220,76,127,100,27,15,0.0,0.0
1010,2482,26-09-2019 22:22:00,0,4171.0,3094.0,0.742,19.859,245,212,156,56,33,22,11,64,0.0,0.0
1010,2483,26-09-2019 22:24:00,0,3970.0,2905.0,0.732,18.858,113,86,70,16,27,20,7,48,0.0,0.0
1010,2484,26-09-2019 22:26:00,0,4167.0,3094.0,0.743,19.844,201,156,116,40,45,31,14,61,0.0,0.0
1010,2485,26-09-2019 22:28:00,0,3939.0,3001.0,0.762,18.842,351,247,184,63,104,76,28,31,0.0,0.0
1010,2486,26-09-2019 22:30:00,0,4073.0,3016.0,0.741,19.385,263,133,96,37,130,89,41,30,0.07,0.0
1010,2487,26-09-2019 22:32:00,0,3980.0,2943.0,0.739,18.94,110,66,30,36,44,17,27,0,0.0,0.0
1010,2488,26-09-2019 22:34:00,0,3887.0,2799.0,0.72,18.413,127,76,47,29,51,16,35,0,0.0,0.0
1010,2489,26-09-2019 22:36:00,0,3886.0,2827.0,0.727,18.442,128,50,27,23,78,46,32,3,0.0,0.0
1010,2490,26-09-2019 22:38:00,0,3978.0,2901.0,0.729,18.884,194,87,56,31,107,67,40,7,0.0,0.0
1010,2491,26-09-2019 22:40:00,0,3969.0,2896.5,0.7295,18.8445,194,160,117,43,34,22,12,6,0.0,0.0
1010,2492,26-09-2019 22:42:00,0,3960.0,2892.0,0.73,18.805,281,130,92,38,151,102,49,38,0.0,0.0
1010,2493,26-09-2019 22:44:00,0,3990.0,2828.0,0.709,18.851,225,115,84,31,110,66,44,18,0.0,0.0
1010,2494,26-09-2019 22:46:00,0,3764.0,2739.0,0.728,17.865,179,120,99,21,59,42,17,75,0.0,0.0
1010,2495,26-09-2019 22:48:00,0,3979.0,2905.0,0.73,18.896,398,285,230,55,113,85,28,188,0.0,0.0
1010,2496,26-09-2019 22:50:00,0,3965.0,2980.0,0.751,18.921,484,375,289,86,109,80,29,75,0.0,0.0
1010,2497,26-09-2019 22:52:00,0,4409.0,3193.0,0.724,20.906,171,95,62,33,76,46,30,15,0.0,0.0
1010,2498,26-09-2019 22:54:00,0,3965.0,2928.0,0.739,18.864,168,72,42,30,96,53,43,0,0.0,0.0
1010,2499,26-09-2019 22:56:00,0,3977.0,2900.0,0.729,18.883,282,142,100,42,140,89,51,4,0.0,0.0
1010,2500,26-09-2019 22:58:00,0,3981.0,2886.0,0.725,18.88,390,301,247,54,89,66,23,107,0.0,0.0
1010,2501,26-09-2019 23:00:00,0,4190.0,3045.0,0.727,19.882,333,284,213,71,49,29,20,43,0.0,0.0
1010,2502,26-09-2019 23:02:00,0,4192.0,3040.0,0.725,19.885,315,276,214,62,39,22,17,5,0.0,0.0
1010,2503,26-09-2019 23:04:00,0,4157.0,3078.0,0.741,19.789,193,103,76,27,90,60,30,35,0.0,0.0
1010,2504,26-09-2019 23:06:00,0,3981.0,2848.0,0.715,18.839,182,117,64,53,65,34,31,0,0.0,0.0
1010,2505,26-09-2019 23:08:00,0,3960.0,2891.0,0.73,18.804,225,134,82,52,91,60,31,1,0.0,0.0
1010,2506,26-09-2019 23:10:00,0,4523.0,3218.0,0.712,21.385,267,105,66,39,162,107,55,2,0.01,0.0
1010,2507,26-09-2019 23:12:00,0,3964.0,2944.0,0.743,18.876,448,296,236,60,152,111,41,60,0.0,0.0
1010,2508,26-09-2019 23:14:00,0,3921.0,2871.5,0.7325,18.6265,171,59,32,27,112,68,44,4,0.0,0.0
1010,2509,26-09-2019 23:16:00,0,3878.0,2799.0,0.722,18.377,225,118,75,43,107,64,43,7,0.0,0.0
1010,2510,26-09-2019 23:18:00,0,4002.0,2801.0,0.7,18.87,220,141,103,38,79,57,22,139,0.0,0.0
1010,2511,26-09-2019 23:20:00,0,3958.0,2958.0,0.747,18.87,247,213,163,50,34,21,13,11,0.0,0.0
1010,2512,26-09-2019 23:22:00,0,4197.0,3054.0,0.728,19.92,477,385,289,96,92,73,19,35,0.0,0.0
1010,2513,26-09-2019 23:24:00,0,3853.0,2825.0,0.733,18.311,311,91,59,32,220,159,61,19,0.0,0.0
1010,2514,26-09-2019 23:26:00,0,3973.0,2942.0,0.74,18.913,208,97,70,27,111,67,44,42,0.02,0.0
1010,2515,26-09-2019 23:28:00,0,4308.0,3144.0,0.73,20.456,324,226,181,45,98,73,25,145,0.0,0.0
1010,2516,26-09-2019 23:30:00,0,4188.0,3032.0,0.724,19.857,297,213,161,52,84,58,26,31,0.0,0.0
1010,2517,26-09-2019 23:32:00,0,3971.0,2917.0,0.735,18.874,101,20,9,11,81,31,50,0,0.0,0.0
1010,2518,26-09-2019 23:34:00,0,4080.0,2928.0,0.718,19.316,230,125,88,37,105,78,27,72,0.0,0.0
1010,2519,26-09-2019 23:36:00,0,3975.0,2916.0,0.734,18.89,304,217,176,41,87,52,35,27,0.0,0.0
1010,2520,26-09-2019 23:38:00,0,4087.0,2910.0,0.712,19.325,156,51,24,27,105,66,39,0,0.0,0.0
1010,2521,26-09-2019 23:40:00,0,4091.0,2943.0,0.72,19.377,195,113,68,45,82,58,24,2,0.0,0.0
1010,2522,26-09-2019 23:42:00,0,3883.0,2772.0,0.714,18.367,387,219,175,44,168,127,41,113,0.0,0.0
1010,2523,26-09-2019 23:44:00,0,4002.0,2826.0,0.706,18.897,411,283,215,68,128,93,35,112,0.0,0.0
1010,2524,26-09-2019 23:46:00,0,4513.0,3208.0,0.711,21.333,167,104,69,35,63,46,17,68,0.0,0.0
1010,2525,26-09-2019 23:48:00,0,4258.5,3005.0,0.7055,20.105,525,298,227,71,227,174,53,84,0.0,0.0
1010,2526,26-09-2019 23:50:00,0,4004.0,2802.0,0.7,18.877,177,104,56,48,73,37,36,0,0.0,0.0
1010,2527,26-09-2019 23:52:00,0,4011.0,2785.0,0.694,18.889,381,222,166,56,159,123,36,67,0.0,0.0
1010,2528,26-09-2019 23:54:00,0,4000.0,2796.0,0.699,18.855,271,169,137,32,102,78,24,37,0.0,0.0
1010,2529,26-09-2019 23:56:00,0,4217.0,2950.0,0.7,19.883,173,87,70,17,86,69,17,46,0.0,0.0
1010,2530,26-09-2019 23:58:00,0,4005.0,2809.0,0.701,18.892,78,41,23,18,37,14,23,15,0.0,0.0
1010,2531,27-09-2019 00:00:00,0,4009.0,2727.0,0.68,18.816,89,75,58,17,14,6,8,38,0.0,0.0
1010,2532,27-09-2019 00:02:00,0,3648.0,2689.0,0.737,17.349,386,259,184,75,127,86,41,4,0.0,0.0
1010,2533,27-09-2019 00:04:00,0,4024.0,2757.0,0.685,18.908,168,70,32,38,98,55,43,0,0.0,0.0
1010,2534,27-09-2019 00:06:00,0,3669.0,2635.0,0.718,17.375,178,105,69,36,73,33,40,8,0.0,0.0
1010,2535,27-09-2019 00:08:00,0,3894.0,2709.0,0.696,18.343,310,144,108,36,166,117,49,49,0.0,0.0
1010,2536,27-09-2019 00:10:00,0,4000.0,2770.0,0.693,18.828,243,88,59,29,155,101,54,0,0.0,0.0
1010,2537,27-09-2019 00:12:00,0,3900.0,2745.0,0.704,18.408,88,22,15,7,66,24,42,3,0.0,0.0
1010,2538,27-09-2019 00:14:00,0,4000.0,2821.0,0.705,18.886,331,209,152,57,122,92,30,70,0.0,0.0
1010,2539,27-09-2019 00:16:00,0,4087.0,2929.0,0.717,19.346,220,85,63,22,135,97,38,47,0.21,0.0
1010,2540,27-09-2019 00:18:00,0,3774.0,2709.0,0.718,17.87,136,77,52,25,59,36,23,21,0.0,0.0
1010,2541,27-09-2019 00:20:00,0,3657.0,2644.0,0.723,17.336,224,147,112,35,77,50,27,59,0.0,0.0
1010,2542,27-09-2019 00:22:00,0,3719.5,2666.0,0.717,17.6075,334,183,143,40,151,115,36,85,0.0,0.0
1010,2543,27-09-2019 00:24:00,0,3782.0,2688.0,0.711,17.879,340,228,185,43,112,75,37,83,0.0,0.0
1010,2544,27-09-2019 00:26:00,0,3782.0,2691.0,0.711,17.882,327,105,74,31,222,165,57,9,0.0,0.0
1010,2545,27-09-2019 00:28:00,0,3663.0,2666.0,0.728,17.384,147,63,38,25,84,47,37,2,0.0,0.0
1010,2546,27-09-2019 00:30:00,0,3668.0,2645.0,0.721,17.382,284,162,104,58,122,83,39,12,0.02,0.0
1010,2547,27-09-2019 00:32:00,0,3664.0,2615.0,0.714,17.33,431,337,252,85,94,56,38,50,0.0,0.0
1010,2548,27-09-2019 00:34:00,0,4006.0,2801.0,0.699,18.886,246,136,106,30,110,85,25,35,0.0,0.0
1010,2549,27-09-2019 00:36:00,0,3697.0,2556.0,0.691,17.397,248,174,135,39,74,58,16,102,0.0,0.0
1010,2550,27-09-2019 00:38:00,0,3695.0,2569.0,0.695,17.403,178,98,55,43,80,43,37,3,0.0,0.0
1010,2551,27-09-2019 00:40:00,0,3688.0,2583.0,0.701,17.39,165,92,47,45,73,38,35,0,0.0,0.0
1010,2552,27-09-2019 00:42:00,0,3684.0,2578.0,0.7,17.368,188,87,56,31,101,62,39,4,0.0,0.0
1010,2553,27-09-2019 00:44:00,0,3670.0,2598.0,0.708,17.337,150,80,52,28,70,40,30,3,0.0,0.0
1010,2554,27-09-2019 00:46:00,0,3694.0,2577.0,0.698,17.408,103,52,26,26,51,22,29,18,0.0,0.0
1010,2555,27-09-2019 00:48:00,0,3691.0,2575.0,0.698,17.396,307,177,141,36,130,101,29,67,0.0,0.0
1010,2556,27-09-2019 00:50:00,0,3679.0,2564.0,0.697,17.335,167,79,48,31,88,55,33,3,0.0,0.0
1010,2557,27-09-2019 00:52:00,0,3687.0,2593.0,0.703,17.398,249,93,50,43,156,98,58,0,0.0,0.0
1010,2558,27-09-2019 00:54:00,0,3707.0,2511.0,0.678,17.386,430,238,188,50,192,147,45,88,0.04,0.0
1010,2559,27-09-2019 00:56:00,0,3643.0,2500.0,0.6865,17.1215,47,26,19,7,21,3,18,2,0.0,0.0
1010,2560,27-09-2019 00:58:00,0,3579.0,2489.0,0.695,16.857,91,31,14,17,60,24,36,0,0.0,0.0
1010,2561,27-09-2019 01:00:00,0,3459.0,2451.0,0.709,16.343,132,38,27,11,94,59,35,0,0.0,0.0
1010,2562,27-09-2019 01:02:00,0,3587.0,2496.0,0.696,16.898,162,28,9,19,134,85,49,1,0.0,0.0
1010,2563,27-09-2019 01:04:00,0,3700.0,2513.0,0.679,17.36,23,0,0,0,23,0,23,0,0.0,0.0
1010,2564,27-09-2019 01:06:00,0,3476.0,2425.0,0.698,16.382,29,0,0,0,29,0,29,0,0.0,0.0
1010,2565,27-09-2019 01:08:00,0,3386.0,2319.0,0.685,15.908,30,1,1,0,29,0,29,0,0.0,0.0
1010,2566,27-09-2019 01:10:00,0,3168.0,2181.0,0.689,14.896,23,0,0,0,23,0,23,0,0.0,0.0
1010,2567,27-09-2019 01:12:00,0,3199.0,2071.0,0.647,14.897,19,0,0,0,19,0,19,0,0.0,0.0
1010,2568,27-09-2019 01:14:00,0,2974.0,1964.0,0.66,13.894,23,0,0,0,23,0,23,0,0.0,0.0
1010,2569,27-09-2019 01:16:00,0,2884.0,1865.0,0.647,13.43,24,0,0,0,24,0,24,0,0.0,0.0
1010,2570,27-09-2019 01:18:00,0,2654.0,1778.0,0.67,12.425,26,0,0,0,26,0,26,0,0.0,0.0
1010,2571,27-09-2019 01:20:00,0,2656.0,1769.0,0.666,12.423,24,0,0,0,24,1,23,0,0.0,0.0
1010,2572,27-09-2019 01:22:00,0,2663.0,1707.0,0.641,12.384,275,164,117,47,111,75,36,16,0.0,0.0
1010,2573,27-09-2019 01:24:00,0,2645.0,1766.0,0.668,12.375,227,161,127,34,66,51,15,50,0.0,0.0
1010,2574,27-09-2019 01:26:00,0,2869.0,1891.0,0.659,13.398,387,235,186,49,152,110,42,7,0.0,0.0
1010,2575,27-09-2019 01:28:00,0,2971.0,1979.0,0.666,13.899,252,164,124,40,88,55,33,52,0.0,0.0
1010,2576,27-09-2019 01:30:00,0,2951.0,2065.5,0.7,13.9145,397,224,170,54,173,134,39,117,0.0,0.0
1010,2577,27-09-2019 01:32:00,0,2931.0,2152.0,0.734,13.93,292,205,162,43,87,63,24,112,0.0,0.0
1010,2578,27-09-2019 01:34:00,0,3261.0,2266.0,0.695,15.359,277,201,147,54,76,50,26,87,0.0,0.0
1010,2579,27-09-2019 01:36:00,0,3365.0,2405.0,0.715,15.919,160,73,42,31,87,46,41,2,0.0,0.0
1010,2580,27-09-2019 01:38:00,0,3465.0,2427.0,0.7,16.339,233,116,78,38,117,84,33,54,0.0,0.0
1010,2581,27-09-2019 01:40:00,0,3269.0,2302.0,0.704,15.428,170,106,83,23,64,31,33,33,0.01,0.0
1010,2582,27-09-2019 01:42:00,0,3461.0,2483.0,0.717,16.385,184,133,104,29,51,26,25,47,0.0,0.0
1010,2583,27-09-2019 01:44:00,0,3984.0,2869.0,0.72,18.874,164,52,30,22,112,79,33,3,0.0,0.0
1010,2584,27-09-2019 01:46:00,0,3481.0,2440.0,0.701,16.418,188,86,61,25,102,58,44,12,0.0,0.0
1010,2585,27-09-2019 01:48:00,0,3257.0,2311.0,0.71,15.394,189,94,63,31,95,68,27,62,0.0,0.0
1010,2586,27-09-2019 01:50:00,0,4005.0,2801.0,0.699,18.882,294,103,80,23,191,147,44,70,0.0,0.0
1010,2587,27-09-2019 01:52:00,0,3682.0,2604.0,0.707,17.391,308,181,152,29,127,95,32,108,0.0,0.0
1010,2588,27-09-2019 01:54:00,0,3429.0,2568.0,0.749,16.354,255,158,105,53,97,55,42,9,0.0,0.0
1010,2589,27-09-2019 01:56:00,0,3454.0,2517.0,0.729,16.396,160,76,42,34,84,46,38,0,0.0,0.0
1010,2590,27-09-2019 01:58:00,0,3435.0,2529.0,0.736,16.335,222,76,50,26,146,88,58,1,0.0,0.0
1010,2591,27-09-2019 02:00:00,0,3438.0,2592.0,0.754,16.414,365,182,142,40,183,137,46,37,0.14,0.0
1010,2592,27-09-2019 02:02:00,0,3562.0,2600.0,0.73,16.914,70,7,3,4,63,23,40,0,0.0,0.0
1010,2593,27-09-2019 02:04:00,0,3579.5,2541.0,0.71,16.9175,188,70,54,16,118,83,35,45,0.0,0.0
1010,2594,27-09-2019 02:06:00,0,3597.0,2482.0,0.69,16.921,199,77,58,19,122,87,35,18,0.0,0.0
1010,2595,27-09-2019 02:08:00,0,3590.0,2501.0,0.696,16.916,201,112,79,33,89,45,44,18,0.0,0.0
1010,2596,27-09-2019 02:10:00,0,3369.0,2370.0,0.703,15.897,173,70,44,26,103,72,31,1,0.0,0.0
1010,2597,27-09-2019 02:12:00,0,3382.0,2304.0,0.681,15.879,103,35,19,16,68,31,37,31,0.0,0.0
1010,2598,27-09-2019 02:14:00,0,3391.0,2314.0,0.682,15.925,287,213,160,53,74,42,32,25,0.0,0.0
1010,2599,27-09-2019 02:16:00,0,3468.0,2416.0,0.697,16.338,217,128,80,48,89,57,32,0,0.0,0.0
1010,2600,27-09-2019 02:18:00,0,3361.0,2374.0,0.706,15.873,72,25,5,20,47,19,28,0,0.0,0.0
1010,2601,27-09-2019 02:20:00,0,3379.0,2299.0,0.68,15.86,51,0,0,0,51,28,23,0,0.0,0.0
1010,2602,27-09-2019 02:22:00,0,3059.0,2162.0,0.707,14.449,48,0,0,0,48,23,25,0,0.0,0.0
1010,2603,27-09-2019 02:24:00,0,3080.0,2061.0,0.669,14.417,78,7,0,7,71,44,27,0,0.0,0.0
1010,2604,27-09-2019 02:26:00,0,2847.0,1947.0,0.684,13.373,29,0,0,0,29,4,25,0,0.0,0.0
1010,2605,27-09-2019 02:28:00,0,2888.0,1871.0,0.648,13.449,38,12,0,12,26,4,22,0,0.0,0.0
1010,2606,27-09-2019 02:30:00,0,2527.0,1786.0,0.707,11.935,29,4,0,4,25,4,21,0,0.0,0.0
1010,2607,27-09-2019 02:32:00,0,2520.0,1762.0,0.699,11.88,29,2,0,2,27,4,23,0,0.0,0.0
1010,2608,27-09-2019 02:34:00,0,2538.0,1713.0,0.675,11.895,67,7,4,3,60,28,32,0,0.0,0.0
1010,2609,27-09-2019 02:36:00,0,2433.0,1644.0,0.676,11.405,44,5,0,5,39,12,27,0,0.0,0.0
1010,2610,27-09-2019 02:38:00,0,2390.5,1570.0,0.6565,11.1565,24,0,0,0,24,1,23,0,0.0,0.0
1010,2611,27-09-2019 02:40:00,0,2348.0,1496.0,0.637,10.908,18,0,0,0,18,1,17,0,0.0,0.0
1010,2612,27-09-2019 02:42:00,0,2237.0,1457.0,0.651,10.428,13,0,0,0,13,0,13,0,0.0,0.0
1010,2613,27-09-2019 02:44:00,0,2105.0,1434.0,0.681,9.883,26,0,0,0,26,0,26,0,0.0,0.0
1010,2614,27-09-2019 02:46:00,0,2005.0,1421.0,0.709,9.472,107,40,21,19,67,33,34,2,0.0,0.0
1010,2615,27-09-2019 02:48:00,0,2343.0,1513.0,0.646,10.905,293,196,165,31,97,78,19,84,0.0,0.0
1010,2616,27-09-2019 02:50:00,0,2547.0,1716.0,0.674,11.937,374,185,136,49,189,148,41,42,0.0,0.0
1010,2617,27-09-2019 02:52:00,0,2518.0,1793.0,0.712,11.908,185,106,83,23,79,60,19,84,0.0,0.0
1010,2618,27-09-2019 02:54:00,0,2861.0,1924.0,0.673,13.403,322,171,134,37,151,111,40,72,0.0,0.0
1010,2619,27-09-2019 02:56:00,0,2855.0,1935.0,0.678,13.39,274,181,131,50,93,70,23,46,0.0,0.0
1010,2620,27-09-2019 02:58:00,0,2972.0,2004.0,0.674,13.929,147,112,77,35,35,10,25,7,0.0,0.0
1010,2621,27-09-2019 03:00:00,0,2851.0,1990.0,0.698,13.437,62,12,3,9,50,22,28,0,0.0,0.0
1010,2622,27-09-2019 03:02:00,0,2847.0,1958.0,0.688,13.384,72,11,5,6,61,32,29,0,0.0,0.0
1010,2623,27-09-2019 03:04:00,0,2965.0,1998.0,0.674,13.896,165,84,59,25,81,46,35,3,0.0,0.0
1010,2624,27-09-2019 03:06:00,0,3062.0,2089.0,0.682,14.378,247,120,84,36,127,92,35,48,0.0,0.0
1010,2625,27-09-2019 03:08:00,0,2952.0,2011.0,0.681,13.857,71,36,12,24,35,7,28,0,0.01,0.0
1010,2626,27-09-2019 03:10:00,0,3073.0,2015.0,0.656,14.338,142,85,58,27,57,42,15,44,0.0,0.0
1010,2627,27-09-2019 03:12:00,0,3073.5,2024.0,0.6585,14.3495,149,90,69,21,59,38,21,53,0.0,0.0
1010,2628,27-09-2019 03:14:00,0,3074.0,2033.0,0.661,14.361,296,171,131,40,125,91,34,77,0.06,0.0
1010,2629,27-09-2019 03:16:00,0,3389.0,2315.0,0.683,15.917,125,60,44,16,65,44,21,40,0.01,0.0
1010,2630,27-09-2019 03:18:00,0,3147.0,2226.0,0.707,14.863,144,51,30,21,93,59,34,7,0.01,0.0
1010,2631,27-09-2019 03:20:00,0,3066.0,2132.0,0.696,14.441,290,143,105,38,147,92,55,42,0.0,0.0
1010,2632,27-09-2019 03:22:00,0,2966.0,2016.0,0.68,13.92,143,76,47,29,67,27,40,2,0.0,0.0
1010,2633,27-09-2019 03:24:00,0,2849.0,1985.0,0.697,13.423,62,23,11,12,39,22,17,3,0.06,0.0
1010,2634,27-09-2019 03:26:00,0,3270.0,2238.0,0.685,15.361,125,61,42,19,64,38,26,0,0.0,0.0
1010,2635,27-09-2019 03:28:00,0,2835.0,2002.0,0.706,13.388,482,257,200,57,225,172,53,0,0.0,0.0
1010,2636,27-09-2019 03:30:00,0,2825.0,2008.0,0.711,13.355,233,129,87,42,104,62,42,8,0.0,0.0
1010,2637,27-09-2019 03:32:00,0,2861.0,1937.0,0.677,13.418,148,50,19,31,98,48,50,0,0.0,0.0
1010,2638,27-09-2019 03:34:00,0,2974.0,1981.0,0.666,13.913,22,0,0,0,22,0,22,0,0.0,0.0
1010,2639,27-09-2019 03:36:00,0,2872.0,1843.0,0.642,13.355,22,1,0,1,21,0,21,0,0.0,0.0
1010,2640,27-09-2019 03:38:00,0,2644.0,1800.0,0.681,12.411,33,0,0,0,33,0,33,0,0.01,0.0
1010,2641,27-09-2019 03:40:00,0,2537.0,1731.0,0.682,11.914,27,0,0,0,27,0,27,0,0.0,0.0
1010,2642,27-09-2019 03:42:00,0,2551.0,1657.0,0.65,11.885,24,0,0,0,24,0,24,0,0.0,0.0
1010,2643,27-09-2019 03:44:00,0,2556.0,1641.0,0.642,11.888,27,0,0,0,27,0,27,0,0.0,0.0
1010,2644,27-09-2019 03:46:00,0,2441.0,1626.0,0.6675,11.4185,17,0,0,0,17,0,17,0,0.0,0.0
1010,2645,27-09-2019 03:48:00,0,2326.0,1611.0,0.693,10.949,22,0,0,0,22,0,22,0,0.0,0.0
1010,2646,27-09-2019 03:50:00,0,2340.0,1547.0,0.661,10.932,14,0,0,0,14,0,14,0,0.0,0.0
1010,2647,27-09-2019 03:52:00,0,2359.0,1471.0,0.623,10.925,24,0,0,0,24,0,24,0,0.0,0.0
1010,2648,27-09-2019 03:54:00,0,2125.0,1417.0,0.667,9.94,15,0,0,0,15,4,11,0,0.0,0.0
1010,2649,27-09-2019 03:56:00,0,2004.0,1375.0,0.686,9.419,25,0,0,0,25,0,25,0,0.0,0.0
1010,2650,27-09-2019 03:58:00,0,2021.0,1359.0,0.673,9.469,23,0,0,0,23,2,21,0,0.0,0.0
1010,2651,27-09-2019 04:00:00,0,2128.0,1418.0,0.666,9.956,25,0,0,0,25,2,23,0,0.0,0.0
1010,2652,27-09-2019 04:02:00,0,2127.0,1403.0,0.66,9.934,52,9,4,5,43,16,27,0,0.0,0.0
1010,2653,27-09-2019 04:04:00,0,2127.0,1419.0,0.667,9.953,24,1,1,0,23,2,21,0,0.0,0.0
1010,2654,27-09-2019 04:06:00,0,2008.0,1366.0,0.68,9.426,24,0,0,0,24,2,22,0,0.0,0.0
1010,2655,27-09-2019 04:08:00,0,2023.0,1309.0,0.647,9.419,68,17,6,11,51,21,30,0,0.0,0.0
1010,2656,27-09-2019 04:10:00,0,2044.0,1248.0,0.611,9.435,138,60,28,32,78,44,34,0,0.0,0.0
1010,2657,27-09-2019 04:12:00,0,2230.0,1450.0,0.65,10.394,275,110,75,35,165,117,48,31,0.0,0.0
1010,2658,27-09-2019 04:14:00,0,2318.0,1614.0,0.696,10.922,310,188,147,41,122,91,31,66,0.0,0.0
1010,2659,27-09-2019 04:16:00,0,2765.0,1830.0,0.662,12.921,240,125,94,31,115,81,34,21,0.0,0.0
1010,2660,27-09-2019 04:18:00,0,2885.0,1875.0,0.65,13.442,58,13,4,9,45,15,30,0,0.0,0.0
1010,2661,27-09-2019 04:20:00,0,2651.5,1781.0,0.674,12.418,23,2,1,1,21,0,21,0,0.0,0.0
1010,2662,27-09-2019 04:22:00,0,2418.0,1687.0,0.698,11.394,25,0,0,0,25,0,25,0,0.0,0.0
1010,2663,27-09-2019 04:24:00,0,2433.0,1628.0,0.669,11.39,26,1,1,0,25,0,25,0,0.0,0.0
1010,2664,27-09-2019 04:26:00,0,2211.0,1570.0,0.71,10.451,32,0,0,0,32,0,32,0,0.0,0.0
1010,2665,27-09-2019 04:28:00,0,2225.0,1512.0,0.679,10.441,35,5,4,1,30,0,30,0,0.0,0.0
1010,2666,27-09-2019 04:30:00,0,2236.0,1446.0,0.647,10.411,28,1,0,1,27,0,27,0,0.0,0.0
1010,2667,27-09-2019 04:32:00,0,2122.0,1416.0,0.668,9.929,18,3,1,2,15,0,15,0,0.0,0.0
1010,2668,27-09-2019 04:34:00,0,2121.0,1424.0,0.671,9.936,48,5,1,4,43,0,43,0,0.01,0.0
1010,2669,27-09-2019 04:36:00,0,2116.0,1440.0,0.68,9.931,58,16,6,10,42,7,35,0,0.0,0.0
1010,2670,27-09-2019 04:38:00,0,1997.0,1405.0,0.703,9.425,34,0,0,0,34,0,34,0,0.0,0.0
1010,2671,27-09-2019 04:40:00,0,1888.0,1363.0,0.722,8.947,8,1,1,0,7,0,7,0,0.0,0.0
1010,2672,27-09-2019 04:42:00,0,1892.0,1331.0,0.704,8.927,8,2,1,1,6,0,6,0,0.0,0.0
1010,2673,27-09-2019 04:44:00,0,1912.0,1286.0,0.673,8.956,2,0,0,0,2,0,2,0,0.0,0.0
1010,2674,27-09-2019 04:46:00,0,1921.0,1252.0,0.652,8.955,0,0,0,0,0,0,0,0,0.0,0.0
1010,2675,27-09-2019 04:48:00,0,1679.0,1210.0,0.721,7.957,0,0,0,0,0,0,0,0,0.0,0.0
1010,2676,27-09-2019 04:50:00,0,1687.0,1192.0,0.707,7.969,18,7,0,7,11,1,10,0,0.0,0.0
1010,2677,27-09-2019 04:52:00,0,1669.0,1215.0,0.728,7.92,4,3,0,3,1,0,1,0,0.0,0.0
1010,2678,27-09-2019 04:54:00,0,1672.5,1215.0,0.7265,7.9345,8,6,0,6,2,0,2,0,0.0,0.0
1010,2679,27-09-2019 04:56:00,0,1676.0,1215.0,0.725,7.949,13,6,0,6,7,1,6,0,0.0,0.0
1010,2680,27-09-2019 04:58:00,0,1677.0,1189.0,0.709,7.924,20,8,0,8,12,0,12,0,0.0,0.0
1010,2681,27-09-2019 05:00:00,0,1677.0,1199.0,0.715,7.936,187,101,64,37,86,52,34,4,0.0,0.0
1010,2682,27-09-2019 05:02:00,0,2212.0,1546.0,0.699,10.426,180,85,55,30,95,56,39,0,0.0,0.0
1010,2683,27-09-2019 05:04:00,0,2221.0,1494.0,0.672,10.407,211,90,60,30,121,75,46,20,0.0,0.0
1010,2684,27-09-2019 05:06:00,0,2634.0,1839.0,0.698,12.414,222,170,137,33,52,35,17,58,0.0,0.0
1010,2685,27-09-2019 05:08:00,0,2728.0,1939.0,0.711,12.894,196,115,84,31,81,61,20,67,0.0,0.0
1010,2686,27-09-2019 05:10:00,0,2738.0,1930.0,0.705,12.927,77,42,17,25,35,12,23,0,0.0,0.0
1010,2687,27-09-2019 05:12:00,0,2731.0,1894.0,0.694,12.857,278,159,131,28,119,80,39,51,0.02,0.0
1010,2688,27-09-2019 05:14:00,0,2957.0,2022.0,0.684,13.89,382,249,196,53,133,102,31,125,0.0,0.0
1010,2689,27-09-2019 05:16:00,0,3687.0,2063.0,0.56,16.812,275,152,109,43,123,94,29,46,0.04,0.0
1010,2690,27-09-2019 05:18:00,0,4569.0,2032.0,0.445,20.254,84,59,28,31,25,5,20,4,0.0,0.0
1010,2691,27-09-2019 05:20:00,0,4562.0,2085.0,0.457,20.283,62,50,36,14,12,5,7,6,0.0,0.0
1010,2692,27-09-2019 05:22:00,0,4569.0,2129.0,0.466,20.362,107,56,41,15,51,27,24,2,0.0,0.0
1010,2693,27-09-2019 05:24:00,0,4578.0,2032.0,0.444,20.289,65,35,18,17,30,16,14,0,0.0,0.0
1010,2694,27-09-2019 05:26:00,0,4561.0,2058.0,0.451,20.252,17,0,0,0,17,4,13,0,0.0,0.0
1010,2695,27-09-2019 05:28:00,0,3712.0,2003.0,0.5655,16.8455,23,6,1,5,17,3,14,0,0.0,0.0
1010,2696,27-09-2019 05:30:00,0,2863.0,1948.0,0.68,13.439,99,30,7,23,69,39,30,0,0.0,0.0
1010,2697,27-09-2019 05:32:00,0,2833.0,1970.0,0.696,13.343,169,90,60,30,79,57,22,31,0.0,0.0
1010,2698,27-09-2019 05:34:00,0,2876.0,1869.0,0.65,13.399,88,41,26,15,47,20,27,0,0.01,0.0
1010,2699,27-09-2019 05:36:00,0,3150.0,1714.0,0.544,14.311,88,29,15,14,59,21,38,0,0.0,0.0
1010,2700,27-09-2019 05:38:00,0,3284.0,1747.0,0.532,14.876,26,0,0,0,26,0,26,0,0.0,0.0
1010,2701,27-09-2019 05:40:00,0,3052.0,1725.0,0.565,13.936,31,0,0,0,31,0,31,0,0.0,0.0
1010,2702,27-09-2019 05:42:00,0,2925.0,1675.0,0.573,13.379,29,0,0,0,29,0,29,0,0.0,0.0
1010,2703,27-09-2019 05:44:00,0,2809.0,1608.0,0.573,12.849,31,0,0,0,31,0,31,0,0.0,0.0
1010,2704,27-09-2019 05:46:00,0,2705.0,1542.0,0.57,12.366,61,15,4,11,46,11,35,0,0.0,0.0
1010,2705,27-09-2019 05:48:00,0,2598.0,1486.0,0.572,11.884,40,1,1,0,39,8,31,0,0.0,0.0
1010,2706,27-09-2019 05:50:00,0,2370.0,1448.0,0.611,10.943,35,0,0,0,35,0,35,0,0.0,0.0
1010,2707,27-09-2019 05:52:00,0,2376.0,1399.0,0.589,10.91,49,2,0,2,47,10,37,0,0.0,0.0
1010,2708,27-09-2019 05:54:00,0,2141.0,1359.0,0.635,9.939,33,1,0,1,32,0,32,0,0.0,0.0
1010,2709,27-09-2019 05:56:00,0,2121.0,1415.0,0.667,9.922,45,1,0,1,44,17,27,0,0.0,0.0
1010,2710,27-09-2019 05:58:00,0,2117.0,1415.0,0.668,9.907,38,0,0,0,38,8,30,0,0.0,0.0
1010,2711,27-09-2019 06:00:00,1,1762.0,1374.0,0.78,8.463,42,2,0,2,40,11,29,0,0.0,0.01
1010,2712,27-09-2019 06:02:00,1,1927.0,1444.5,0.752,9.1925,164,93,65,28,71,37,34,34,0.0,0.0
1010,2713,27-09-2019 06:04:00,1,2092.0,1515.0,0.724,9.922,217,120,96,24,97,65,32,47,0.0,0.0
1010,2714,27-09-2019 06:06:00,1,2182.0,1659.0,0.76,10.434,169,70,41,29,99,59,40,60,0.0,0.0
1010,2715,27-09-2019 06:08:00,1,2832.0,2039.0,0.72,13.415,176,43,17,26,133,69,64,67,0.0,0.0
1010,2716,27-09-2019 06:10:00,1,3468.0,2460.0,0.709,16.389,184,46,14,32,138,83,55,61,0.0,0.04
1010,2717,27-09-2019 06:12:00,1,3758.0,2774.0,0.738,17.878,163,32,2,30,131,77,54,54,0.0,0.05
1010,2718,27-09-2019 06:14:00,1,3731.0,2899.0,0.777,17.908,152,45,16,29,107,54,53,52,0.0,0.03
1010,2719,27-09-2019 06:16:00,1,3841.0,2988.0,0.778,18.442,147,46,14,32,101,50,51,72,0.0,0.06
1010,2720,27-09-2019 06:18:00,1,3927.0,3054.0,0.778,18.854,142,43,15,28,99,62,37,34,0.15,0.06
1010,2721,27-09-2019 06:20:00,1,3881.0,3260.0,0.84,18.901,169,63,33,30,106,50,56,49,0.0,0.07
1010,2722,27-09-2019 06:22:00,1,3907.0,3117.0,0.798,18.845,227,75,41,34,152,105,47,41,0.2,0.01
1010,2723,27-09-2019 06:24:00,1,3886.0,3251.0,0.837,18.908,286,125,96,29,161,117,44,37,0.08,0.02
1010,2724,27-09-2019 06:26:00,1,3868.0,3236.0,0.837,18.823,103,36,15,21,67,35,32,59,0.0,0.06
1010,2725,27-09-2019 06:28:00,1,3874.0,3331.0,0.86,18.952,124,41,22,19,83,44,39,48,0.12,0.08
1010,2726,27-09-2019 06:30:00,1,3850.0,3402.0,0.884,18.935,226,84,43,41,142,87,55,68,0.02,0.0
1010,2727,27-09-2019 06:32:00,1,3869.0,3352.0,0.866,18.956,143,62,26,36,81,38,43,47,0.0,0.1
1010,2728,27-09-2019 06:34:00,1,4196.0,3550.0,0.846,20.463,105,28,16,12,77,38,39,29,0.0,0.0
1010,2729,27-09-2019 06:36:00,1,4160.0,3443.0,0.8275,20.202,240,113,88,25,127,83,44,44,0.18,0.07
1010,2730,27-09-2019 06:38:00,1,4124.0,3336.0,0.809,19.941,137,54,28,26,83,36,47,47,0.0,0.0
1010,2731,27-09-2019 06:40:00,1,4088.0,3428.0,0.838,19.902,274,125,97,28,149,104,45,27,0.11,0.0
1010,2732,27-09-2019 06:42:00,1,4108.0,3376.0,0.822,19.925,105,52,29,23,53,20,33,9,0.02,0.06
1010,2733,27-09-2019 06:44:00,1,3567.0,3042.0,0.853,17.421,210,120,82,38,90,53,37,52,0.0,0.13
1010,2734,27-09-2019 06:46:00,1,4181.0,3540.0,0.847,20.392,237,116,77,39,121,82,39,46,0.14,0.0
1010,2735,27-09-2019 06:48:00,1,4389.0,3689.0,0.84,21.375,189,79,47,32,110,62,48,68,0.0,0.01
1010,2736,27-09-2019 06:50:00,1,4061.0,3538.0,0.871,19.915,174,68,36,32,106,57,49,61,0.0,0.0
1010,2737,27-09-2019 06:52:00,1,4372.0,3749.0,0.858,21.379,231,108,70,38,123,76,47,34,0.08,0.17
1010,2738,27-09-2019 06:54:00,1,4398.0,3679.0,0.837,21.4,132,58,32,26,74,39,35,46,0.0,0.0
1010,2739,27-09-2019 06:56:00,1,4358.0,3779.0,0.867,21.355,282,126,87,39,156,104,52,28,0.06,0.0
1010,2740,27-09-2019 06:58:00,1,3849.0,3386.0,0.88,18.914,154,54,33,21,100,63,37,58,0.01,0.0
1010,2741,27-09-2019 07:00:00,1,4573.0,3971.0,0.868,22.415,139,51,36,15,88,47,41,13,0.0,0.22
1010,2742,27-09-2019 07:02:00,1,3519.0,3212.0,0.913,17.422,45,1,1,0,44,6,38,0,0.0,0.02
1010,2743,27-09-2019 07:04:00,1,3120.0,2832.0,0.908,15.427,125,51,36,15,74,34,40,8,0.06,0.0
1010,2744,27-09-2019 07:06:00,1,3903.0,3682.0,0.944,19.453,272,123,95,28,149,106,43,13,0.14,0.01
1010,2745,27-09-2019 07:08:00,1,3700.0,3536.0,0.956,18.492,1,0,0,0,1,0,1,0,0.0,0.0
1010,2746,27-09-2019 07:10:00,1,3830.5,3487.5,0.912,18.9535,293,173,134,39,120,81,39,0,0.0,0.0
1010,2747,27-09-2019 07:12:00,1,3961.0,3439.0,0.868,19.415,539,232,181,51,307,235,72,11,0.09,0.0
1010,2748,27-09-2019 07:14:00,1,4029.0,3631.0,0.901,19.893,682,364,294,70,318,243,75,0,0.0,0.0
1010,2749,27-09-2019 07:16:00,1,4035.0,3620.0,0.897,19.907,324,144,109,35,180,130,50,39,0.0,0.0
1010,2750,27-09-2019 07:18:00,1,4121.0,3751.0,0.91,20.391,74,17,2,15,57,16,41,0,0.0,0.0
1010,2751,27-09-2019 07:20:00,1,3520.0,3198.0,0.909,17.41,68,17,0,17,51,2,49,0,0.0,0.0
1010,2752,27-09-2019 07:22:00,1,3751.0,3273.0,0.872,18.404,134,20,8,12,114,56,58,0,0.0,0.0
1010,2753,27-09-2019 07:24:00,1,3715.0,3400.0,0.915,18.403,131,39,15,24,92,40,52,0,0.0,0.0
1010,2754,27-09-2019 07:26:00,1,4039.0,3595.0,0.89,19.896,60,4,2,2,56,11,45,0,0.0,0.0
1010,2755,27-09-2019 07:28:00,1,3826.0,3512.0,0.918,18.961,39,1,0,1,38,2,36,0,0.0,0.0
1010,2756,27-09-2019 07:30:00,1,4969.0,3454.0,0.695,23.403,33,2,0,2,31,0,31,0,0.0,0.0
1010,2757,27-09-2019 07:32:00,1,5222.0,3405.0,0.652,24.347,42,0,0,0,42,0,42,0,0.0,0.0
1010,2758,27-09-2019 07:34:00,1,4978.0,3264.0,0.656,23.23,195,2,0,2,193,152,41,0,0.0,0.0
1010,2759,27-09-2019 07:36:00,1,4923.0,3125.0,0.635,22.858,83,15,8,7,68,27,41,1,0.0,0.0
1010,2760,27-09-2019 07:38:00,1,4809.0,3083.0,0.641,22.361,3,0,0,0,3,0,3,0,0.0,0.0
1010,2761,27-09-2019 07:40:00,1,4791.0,3037.0,0.634,22.241,2,0,0,0,2,0,2,0,0.0,0.0
1010,2762,27-09-2019 07:42:00,1,4808.0,3017.0,0.628,22.285,1,0,0,0,1,0,1,0,0.0,0.0
1010,2763,27-09-2019 07:44:00,1,3902.5,2923.5,0.786,18.6135,49,6,1,5,43,4,39,0,0.0,0.0
1010,2764,27-09-2019 07:46:00,1,2997.0,2830.0,0.944,14.942,42,0,0,0,42,0,42,0,0.0,0.0
1010,2765,27-09-2019 07:48:00,1,2773.0,2723.0,0.982,13.941,55,3,0,3,52,2,50,0,0.0,0.0
1010,2766,27-09-2019 07:50:00,1,2773.0,2657.0,0.958,13.867,107,22,16,6,85,38,47,0,0.0,0.0
1010,2767,27-09-2019 07:52:00,1,2796.0,2672.0,0.956,13.973,65,5,2,3,60,18,42,0,0.0,0.0
1010,2768,27-09-2019 07:54:00,1,2761.0,2758.0,0.999,13.93,83,0,0,0,83,35,48,0,0.0,0.0
1010,2769,27-09-2019 07:56:00,1,2412.0,2716.0,1.126,12.51,113,15,11,4,98,48,50,0,0.0,0.0
1010,2770,27-09-2019 07:58:00,1,2413.0,2675.0,1.109,12.469,46,1,0,1,45,2,43,0,0.0,0.0
1010,2771,27-09-2019 08:00:00,1,2308.0,2595.0,1.124,11.966,31,0,0,0,31,2,29,0,0.0,0.0
1010,2772,27-09-2019 08:02:00,1,2211.0,2496.0,1.129,11.474,50,0,0,0,50,0,50,0,0.0,0.0
1010,2773,27-09-2019 08:04:00,1,1865.0,2426.0,1.3,10.034,69,7,4,3,62,18,44,0,0.0,0.0
1010,2774,27-09-2019 08:06:00,1,1969.0,2467.0,1.253,10.488,67,0,0,0,67,20,47,0,0.0,0.0
1010,2775,27-09-2019 08:08:00,1,1857.0,2436.0,1.312,10.013,97,0,0,0,97,45,52,0,0.0,0.0
1010,2776,27-09-2019 08:10:00,1,1876.0,2386.0,1.272,10.031,79,0,0,0,79,31,48,0,0.0,0.0
1010,2777,27-09-2019 08:12:00,1,1880.0,2331.0,1.24,9.987,53,2,0,2,51,6,45,0,0.0,0.0
1010,2778,27-09-2019 08:14:00,1,1886.0,2347.0,1.244,10.028,193,49,32,17,144,85,59,0,0.0,0.0
1010,2779,27-09-2019 08:16:00,1,1955.0,2543.0,1.301,10.518,218,90,66,24,128,85,43,23,0.0,0.0
1010,2780,27-09-2019 08:18:00,1,2372.0,2619.0,1.1335,12.2455,240,140,97,43,100,55,45,56,0.07,0.0
1010,2781,27-09-2019 08:20:00,1,2789.0,2695.0,0.966,13.973,111,27,7,20,84,38,46,0,0.0,0.0
1010,2782,27-09-2019 08:22:00,1,2757.0,2787.0,1.011,13.948,170,17,0,17,153,95,58,0,0.0,0.0
1010,2783,27-09-2019 08:24:00,1,2983.0,2892.0,0.97,14.954,209,46,20,26,163,103,60,0,0.0,0.0
1010,2784,27-09-2019 08:26:00,1,2959.0,3015.0,1.019,14.995,225,85,43,42,140,85,55,0,0.0,0.0
1010,2785,27-09-2019 08:28:00,1,3173.0,3130.0,0.986,15.965,151,44,22,22,107,56,51,51,0.0,0.01
1010,2786,27-09-2019 08:30:00,1,3260.0,3226.0,0.99,16.416,183,47,18,29,136,73,63,64,0.0,0.02
1010,2787,27-09-2019 08:32:00,1,3486.0,3356.0,0.963,17.452,143,39,15,24,104,62,42,52,0.0,0.11
1010,2788,27-09-2019 08:34:00,1,3465.0,3471.0,1.001,17.496,243,92,73,19,151,94,57,33,0.12,0.0
1010,2789,27-09-2019 08:36:00,1,3244.0,3301.0,1.018,16.436,618,277,227,50,341,266,75,29,0.08,0.0
1010,2790,27-09-2019 08:38:00,1,3460.0,3375.0,0.976,17.367,166,44,21,23,122,70,52,67,0.0,0.0
1010,2791,27-09-2019 08:40:00,1,3477.0,3434.0,0.988,17.503,135,27,10,17,108,59,49,46,0.0,0.1
1010,2792,27-09-2019 08:42:00,1,3466.0,3441.0,0.993,17.466,227,85,49,36,142,89,53,50,0.07,0.04
1010,2793,27-09-2019 08:44:00,1,3446.0,3497.0,1.015,17.449,550,233,182,51,317,257,60,9,0.04,0.07
1010,2794,27-09-2019 08:46:00,1,3284.0,3187.0,0.97,16.469,449,209,160,49,240,166,74,22,0.0,0.0
1010,2795,27-09-2019 08:48:00,1,3449.0,3516.0,1.019,17.48,194,79,48,31,115,70,45,50,0.0,0.1
1010,2796,27-09-2019 08:50:00,1,3464.0,3407.0,0.984,17.42,105,0,0,0,105,59,46,0,0.0,0.02
1010,2797,27-09-2019 08:52:00,1,3438.0,3262.5,0.949,17.157,48,0,0,0,48,7,41,0,0.0,0.0
1010,2798,27-09-2019 08:54:00,1,3412.0,3118.0,0.914,16.894,366,195,149,46,171,110,61,1,0.07,0.0
1010,2799,27-09-2019 08:56:00,1,3733.0,3383.0,0.906,18.454,123,10,7,3,113,59,54,0,0.0,0.0
1010,2800,27-09-2019 08:58:00,1,3528.0,3182.0,0.902,17.424,107,3,0,3,104,62,42,0,0.0,0.0
1010,2801,27-09-2019 09:00:00,1,3613.0,3337.0,0.924,17.931,25,0,0,0,25,1,24,0,0.0,0.0
1010,2802,27-09-2019 09:02:00,1,3500.0,3286.0,0.939,17.428,27,0,0,0,27,0,27,0,0.0,0.0
1010,2803,27-09-2019 09:04:00,1,3485.0,3295.0,0.945,17.377,57,4,0,4,53,19,34,0,0.0,0.0
1010,2804,27-09-2019 09:06:00,1,3492.0,3307.0,0.947,17.42,98,1,0,1,97,55,42,0,0.0,0.0
1010,2805,27-09-2019 09:08:00,1,3392.0,3257.0,0.96,16.969,63,0,0,0,63,16,47,0,0.0,0.0
1010,2806,27-09-2019 09:10:00,1,3175.0,3131.0,0.986,15.976,42,0,0,0,42,3,39,0,0.0,0.0
1010,2807,27-09-2019 09:12:00,1,3081.0,2997.0,0.973,15.455,46,3,0,3,43,14,29,0,0.0,0.0
1010,2808,27-09-2019 09:14:00,1,2977.0,2890.0,0.971,14.928,46,2,0,2,44,9,35,0,0.0,0.0
1010,2809,27-09-2019 09:16:00,1,2871.0,2848.0,0.992,14.464,46,4,0,4,42,4,38,0,0.0,0.0
1010,2810,27-09-2019 09:18:00,1,2548.0,2651.0,1.04,12.975,39,2,0,2,37,2,35,0,0.0,0.0
1010,2811,27-09-2019 09:20:00,1,2441.0,2602.0,1.066,12.499,69,10,4,6,59,14,45,0,0.0,0.0
1010,2812,27-09-2019 09:22:00,1,2439.0,2549.0,1.045,12.431,26,1,1,0,25,0,25,0,0.0,0.0
1010,2813,27-09-2019 09:24:00,1,2458.0,2507.0,1.02,12.46,34,0,0,0,34,0,34,0,0.0,0.0
1010,2814,27-09-2019 09:26:00,1,2465.0,2459.0,0.9975,12.4345,44,8,0,8,36,0,36,0,0.0,0.0
1010,2815,27-09-2019 09:28:00,1,2472.0,2411.0,0.975,12.409,18,5,0,5,13,1,12,0,0.0,0.0
1010,2816,27-09-2019 09:30:00,1,2480.0,2387.0,0.962,12.414,80,18,5,13,62,22,40,0,0.0,0.0
1010,2817,27-09-2019 09:32:00,1,2701.0,2549.0,0.944,13.463,103,17,11,6,86,54,32,0,0.0,0.0
1010,2818,27-09-2019 09:34:00,1,2582.0,2514.0,0.974,12.957,147,4,0,4,143,109,34,0,0.0,0.0
1010,2819,27-09-2019 09:36:00,1,2468.0,2471.0,1.001,12.459,58,0,0,0,58,15,43,0,0.0,0.0
1010,2820,27-09-2019 09:38:00,1,2477.0,2438.0,0.984,12.457,40,0,0,0,40,6,34,0,0.0,0.0
1010,2821,27-09-2019 09:40:00,1,2487.0,2397.0,0.964,12.452,45,0,0,0,45,9,36,0,0.0,0.0
1010,2822,27-09-2019 09:42:00,1,2474.0,2406.0,0.973,12.411,44,5,2,3,39,8,31,0,0.0,0.0
1010,2823,27-09-2019 09:44:00,1,2485.0,2415.0,0.972,12.465,46,3,0,3,43,0,43,0,0.0,0.0
1010,2824,27-09-2019 09:46:00,1,2498.0,2355.0,0.943,12.45,129,19,9,10,110,71,39,0,0.0,0.0
1010,2825,27-09-2019 09:48:00,1,2495.0,2380.0,0.954,12.463,49,7,5,2,42,26,16,0,0.0,0.0
1010,2826,27-09-2019 09:50:00,1,2459.0,2506.0,1.019,12.463,2,0,0,0,2,0,2,0,0.0,0.0
1010,2827,27-09-2019 09:52:00,1,2439.0,2518.0,1.032,12.395,2,0,0,0,2,0,2,0,0.0,0.0
1010,2828,27-09-2019 09:54:00,1,2568.0,2581.0,1.005,12.975,56,20,1,19,36,4,32,0,0.0,0.0
1010,2829,27-09-2019 09:56:00,1,2686.0,2604.0,0.969,13.465,123,28,8,20,95,49,46,0,0.0,0.0
1010,2830,27-09-2019 09:58:00,1,2682.0,2627.0,0.979,13.476,195,48,19,29,147,86,61,0,0.0,0.0
1010,2831,27-09-2019 10:00:00,1,2836.5,2751.0,0.97,14.221,185,20,10,10,165,107,58,0,0.0,0.0
1010,2832,27-09-2019 10:02:00,1,2991.0,2875.0,0.961,14.966,120,30,13,17,90,47,43,0,0.0,0.0
1010,2833,27-09-2019 10:04:00,1,2871.0,2855.0,0.995,14.471,38,0,0,0,38,0,38,0,0.0,0.0
1010,2834,27-09-2019 10:06:00,1,2753.0,2795.0,1.015,13.94,40,0,0,0,40,4,36,0,0.0,0.0
1010,2835,27-09-2019 10:08:00,1,2776.0,2702.0,0.973,13.931,35,0,0,0,35,0,35,0,0.0,0.0
1010,2836,27-09-2019 10:10:00,1,2805.0,2635.0,0.94,13.968,62,12,5,7,50,17,33,0,0.0,0.0
1010,2837,27-09-2019 10:12:00,1,2678.0,2604.0,0.972,13.435,27,0,0,0,27,2,25,0,0.0,0.0
1010,2838,27-09-2019 10:14:00,1,2460.0,2508.0,1.02,12.469,37,4,1,3,33,0,33,0,0.0,0.0
1010,2839,27-09-2019 10:16:00,1,2476.0,2448.0,0.989,12.465,32,0,0,0,32,0,32,0,0.0,0.0
1010,2840,27-09-2019 10:18:00,1,2485.0,2434.0,0.98,12.485,39,0,0,0,39,0,39,0,0.0,0.0
1010,2841,27-09-2019 10:20:00,1,2488.0,2362.0,0.949,12.419,43,6,0,6,37,1,36,0,0.0,0.0
1010,2842,27-09-2019 10:22:00,1,2380.0,2326.0,0.978,11.951,32,3,0,3,29,0,29,0,0.0,0.0
1010,2843,27-09-2019 10:24:00,1,2262.0,2296.0,1.015,11.453,74,20,9,11,54,16,38,0,0.0,0.0
1010,2844,27-09-2019 10:26:00,1,2266.0,2304.0,1.017,11.479,99,3,0,3,96,57,39,0,0.0,0.0
1010,2845,27-09-2019 10:28:00,1,2373.0,2339.0,0.985,11.94,43,2,0,2,41,8,33,0,0.0,0.0
1010,2846,27-09-2019 10:30:00,1,2253.0,2362.0,1.048,11.492,40,0,0,0,40,0,40,0,0.0,0.0
1010,2847,27-09-2019 10:32:00,1,2381.0,2380.0,1.0,12.014,44,0,0,0,44,8,36,0,0.0,0.0
1010,2848,27-09-2019 10:34:00,1,2374.5,2369.0,0.998,11.9765,47,0,0,0,47,13,34,0,0.0,0.0
1010,2849,27-09-2019 10:36:00,1,2368.0,2358.0,0.996,11.939,40,0,0,0,40,4,36,0,0.0,0.0
1010,2850,27-09-2019 10:38:00,1,2492.0,2396.0,0.961,12.473,135,55,34,21,80,43,37,0,0.0,0.0
1010,2851,27-09-2019 10:40:00,1,2553.0,2659.0,1.041,13.001,257,117,71,46,140,81,59,16,0.0,0.0
1010,2852,27-09-2019 10:42:00,1,2846.0,2906.0,1.021,14.428,219,105,76,29,114,67,47,62,0.0,0.0
1010,2853,27-09-2019 10:44:00,1,3077.0,3029.0,0.985,15.476,154,71,45,26,83,43,40,29,0.0,0.3
1010,2854,27-09-2019 10:46:00,1,3070.0,3039.0,0.99,15.458,40,7,3,4,33,0,33,0,0.0,0.01
1010,2855,27-09-2019 10:48:00,1,3019.0,3196.0,1.059,15.435,36,1,0,1,35,0,35,0,0.0,0.0
1010,2856,27-09-2019 10:50:00,1,3241.0,3286.0,1.014,16.407,100,38,31,7,62,25,37,2,0.0,0.0
1010,2857,27-09-2019 10:52:00,1,3401.0,3679.0,1.082,17.472,126,42,28,14,84,56,28,28,0.09,0.0
1010,2858,27-09-2019 10:54:00,1,3329.0,3476.0,1.044,16.963,44,2,1,1,42,6,36,0,0.01,0.0
1010,2859,27-09-2019 10:56:00,1,3334.0,3452.0,1.035,16.957,242,81,45,36,161,103,58,4,0.12,0.0
1010,2860,27-09-2019 10:58:00,1,3290.0,3588.0,1.091,16.932,321,194,142,52,127,83,44,27,0.13,0.0
1010,2861,27-09-2019 11:00:00,1,3307.0,3543.0,1.071,16.95,245,75,40,35,170,114,56,0,0.0,0.0
1010,2862,27-09-2019 11:02:00,1,3294.0,3607.0,1.095,16.972,365,195,136,59,170,112,58,14,0.0,0.21
1010,2863,27-09-2019 11:04:00,1,3298.0,3617.0,1.097,16.997,180,84,45,39,96,46,50,53,0.0,0.0
1010,2864,27-09-2019 11:06:00,1,3525.0,3725.0,1.057,18.01,730,348,279,69,382,294,88,19,0.05,0.0
1010,2865,27-09-2019 11:08:00,1,3764.5,3743.5,0.998,18.976,322,155,108,47,167,113,54,48,0.07,0.0
1010,2866,27-09-2019 11:10:00,1,4004.0,3762.0,0.939,19.942,992,462,366,96,530,425,105,0,0.0,0.0
1010,2867,27-09-2019 11:12:00,1,3792.0,3545.0,0.935,18.865,592,277,207,70,315,243,72,14,0.0,0.0
1010,2868,27-09-2019 11:14:00,1,3817.0,3536.0,0.926,18.955,524,210,167,43,314,241,73,6,0.0,0.0
1010,2869,27-09-2019 11:16:00,1,3801.0,3544.0,0.932,18.899,1062,528,440,88,534,434,100,0,0.09,0.0
1010,2870,27-09-2019 11:18:00,1,3815.0,3552.0,0.931,18.962,672,327,254,73,345,267,78,3,0.0,0.0
1010,2871,27-09-2019 11:20:00,1,3492.0,3349.0,0.959,17.465,331,162,104,58,169,123,46,0,0.0,0.0
1010,2872,27-09-2019 11:22:00,1,3843.0,3434.0,0.894,18.942,58,30,18,12,28,9,19,0,0.0,0.0
1010,2873,27-09-2019 11:24:00,1,3822.0,3517.0,0.92,18.952,79,27,17,10,52,18,34,0,0.0,0.0
1010,2874,27-09-2019 11:26:00,1,3888.0,3673.0,0.945,19.384,34,9,2,7,25,9,16,0,0.0,0.0
1010,2875,27-09-2019 11:28:00,1,3775.0,3677.0,0.974,18.946,9,3,3,0,6,3,3,0,0.0,0.0
1010,2876,27-09-2019 11:30:00,1,3822.0,3511.0,0.919,18.946,8,3,1,2,5,0,5,0,0.0,0.0
1010,2877,27-09-2019 11:32:00,1,3459.0,3366.0,0.973,17.357,4,0,0,0,4,0,4,0,0.0,0.0
1010,2878,27-09-2019 11:34:00,1,3271.0,3252.0,0.994,16.487,2,2,0,2,0,0,0,0,0.0,0.0
1010,2879,27-09-2019 11:36:00,1,3173.0,3107.0,0.979,15.943,13,8,3,5,5,1,4,0,0.0,0.0
1010,2880,27-09-2019 11:38:00,1,3581.0,2964.0,0.828,17.392,94,48,1,47,46,5,41,0,0.0,0.0
1010,2881,27-09-2019 11:40:00,1,4833.0,2997.0,0.62,22.361,227,196,128,68,31,5,26,1,0.0,0.0
1010,2882,27-09-2019 11:42:00,1,4073.5,3035.5,0.774,19.411,33,29,5,24,4,3,1,0,0.0,0.0
1010,2883,27-09-2019 11:44:00,1,3314.0,3074.0,0.928,16.461,22,19,0,19,3,1,2,0,0.0,0.0
1010,2884,27-09-2019 11:46:00,1,3071.0,2981.0,0.971,15.398,15,12,0,12,3,2,1,0,0.0,0.0
1010,2885,27-09-2019 11:48:00,1,2980.0,2885.0,0.968,14.934,7,1,0,1,6,0,6,0,0.0,0.0
1010,2886,27-09-2019 11:50:00,1,2777.0,2743.0,0.988,13.977,0,0,0,0,0,0,0,0,0.0,0.0
1010,2887,27-09-2019 11:52:00,1,2667.0,2695.0,1.01,13.491,2,0,0,0,2,0,2,0,0.0,0.0
1010,2888,27-09-2019 11:54:00,1,2418.0,2633.0,1.089,12.443,0,0,0,0,0,0,0,0,0.0,0.0
1010,2889,27-09-2019 11:56:00,1,2441.0,2583.0,1.058,12.478,26,11,8,3,15,10,5,0,0.0,0.0
1010,2890,27-09-2019 11:58:00,1,2201.0,2553.0,1.16,11.496,0,0,0,0,0,0,0,0,0.0,0.0
1010,2891,27-09-2019 12:00:00,1,2189.0,2554.0,1.167,11.451,28,19,12,7,9,5,4,0,0.0,0.0
1010,2892,27-09-2019 12:02:00,1,2194.0,2572.0,1.172,11.491,5,5,0,5,0,0,0,0,0.0,0.0
1010,2893,27-09-2019 12:04:00,1,1950.0,2554.0,1.31,10.508,1,1,1,0,0,0,0,0,0.0,0.0
1010,2894,27-09-2019 12:06:00,1,1856.0,2458.0,1.324,10.036,29,13,4,9,16,1,15,0,0.0,0.0
1010,2895,27-09-2019 12:08:00,1,1852.0,2447.0,1.321,10.004,8,0,0,0,8,0,8,0,0.0,0.0
1010,2896,27-09-2019 12:10:00,1,1844.0,2518.0,1.365,10.052,7,1,0,1,6,0,6,0,0.0,0.0
1010,2897,27-09-2019 12:12:00,1,1817.0,2581.0,1.42,10.016,147,79,62,17,68,47,21,4,0.0,0.0
1010,2898,27-09-2019 12:14:00,1,1794.0,2699.0,1.504,10.057,4,1,0,1,3,0,3,0,0.0,0.0
1010,2899,27-09-2019 12:16:00,1,2186.0,2609.0,1.2405,11.5015,4,2,0,2,2,0,2,0,0.0,0.0
1010,2900,27-09-2019 12:18:00,1,2578.0,2519.0,0.977,12.946,19,4,0,4,15,1,14,0,0.0,0.0
1010,2901,27-09-2019 12:20:00,1,2460.0,2465.0,1.002,12.423,19,3,2,1,16,2,14,0,0.0,0.0
1010,2902,27-09-2019 12:22:00,1,2460.0,2478.0,1.008,12.434,9,0,0,0,9,1,8,0,0.0,0.0
1010,2903,27-09-2019 12:24:00,1,2456.0,2507.0,1.021,12.452,28,17,7,10,11,2,9,0,0.0,0.0
1010,2904,27-09-2019 12:26:00,1,2459.0,2476.0,1.007,12.429,13,13,2,11,0,0,0,0,0.0,0.0
1010,2905,27-09-2019 12:28:00,1,2489.0,2430.0,0.976,12.497,2,2,0,2,0,0,0,0,0.0,0.0
1010,2906,27-09-2019 12:30:00,1,2498.0,2383.0,0.954,12.478,3,3,0,3,0,0,0,0,0.0,0.0
1010,2907,27-09-2019 12:32:00,1,2496.0,2338.0,0.937,12.422,20,9,4,5,11,4,7,0,0.0,0.0
1010,2908,27-09-2019 12:34:00,1,2487.0,2406.0,0.968,12.463,69,25,11,14,44,18,26,0,0.0,0.0
1010,2909,27-09-2019 12:36:00,1,2651.0,2676.0,1.009,13.406,28,20,7,13,8,5,3,0,0.0,0.0
1010,2910,27-09-2019 12:38:00,1,2871.0,2827.0,0.984,14.441,286,169,124,45,117,75,42,18,0.0,0.0
1010,2911,27-09-2019 12:40:00,1,2859.0,2877.0,1.006,14.45,120,82,34,48,38,4,34,64,0.0,0.0
1010,2912,27-09-2019 12:42:00,1,2966.0,3004.0,1.013,15.013,85,42,15,27,43,0,43,52,0.0,0.0
1010,2913,27-09-2019 12:44:00,1,3144.0,3212.0,1.022,15.945,70,39,13,26,31,2,29,49,0.0,0.0
1010,2914,27-09-2019 12:46:00,1,3122.0,3355.0,1.075,16.015,95,52,19,33,43,0,43,48,0.0,0.0
1010,2915,27-09-2019 12:48:00,1,3084.0,3477.0,1.127,15.998,78,57,26,31,21,0,21,48,0.0,0.09
1010,2916,27-09-2019 12:50:00,1,3736.0,3423.5,0.9475,18.509,99,64,32,32,35,4,31,45,0.0,0.03
1011,1,23-09-2019 11:40:00,1,4298.0,3292.0,0.766,20.581,144,95,62,33,49,32,17,27,0.01,0.03
1011,2,23-09-2019 11:42:00,1,3833.0,2880.0,0.751,18.29,127,78,40,38,49,27,22,5,0.01,0.0
1011,3,23-09-2019 11:44:00,1,4016.0,3057.0,0.761,19.209,190,130,80,50,60,37,23,20,0.0,0.02
1011,4,23-09-2019 11:46:00,1,4019.0,2999.0,0.746,19.154,148,110,63,47,38,21,17,16,0.0,0.0
1011,5,23-09-2019 11:48:00,1,3753.0,2709.0,0.722,17.788,98,42,18,24,56,29,27,13,0.0,0.0
1011,6,23-09-2019 11:50:00,1,3608.0,2703.0,0.749,17.211,121,40,27,13,81,40,41,1,0.0,0.0
1011,7,23-09-2019 11:52:00,1,3441.0,2548.0,0.74,16.38,108,62,30,32,46,24,22,4,0.0,0.0
1011,8,23-09-2019 11:54:00,1,3521.0,2671.0,0.759,16.831,133,110,68,42,23,13,10,27,0.0,0.0
1011,9,23-09-2019 11:56:00,1,3326.0,2524.0,0.759,15.897,64,21,8,13,43,9,34,4,0.0,0.0
1011,10,23-09-2019 11:58:00,1,3275.5,2486.0,0.759,15.657,103,85,42,43,18,8,10,10,0.0,0.0
1011,11,23-09-2019 12:00:00,1,3225.0,2448.0,0.759,15.417,138,93,54,39,45,23,22,9,0.0,0.0
1011,12,23-09-2019 12:02:00,1,3216.0,2505.0,0.779,15.445,42,12,5,7,30,12,18,0,0.0,0.0
1011,13,23-09-2019 12:04:00,1,3060.0,2208.0,0.722,14.5,6,2,0,2,4,1,3,0,0.0,0.0
1011,14,23-09-2019 12:06:00,1,2739.0,2051.0,0.749,13.061,0,0,0,0,0,0,0,0,0.0,0.0
1011,15,23-09-2019 12:08:00,1,2539.0,1941.0,0.765,12.153,52,12,2,10,40,21,19,0,0.0,0.0
1011,16,23-09-2019 12:10:00,1,2562.0,1854.0,0.724,12.149,26,12,2,10,14,1,13,0,0.0,0.0
1011,17,23-09-2019 12:12:00,1,2356.0,1750.0,0.743,11.22,31,10,3,7,21,2,19,0,0.0,0.0
1011,18,23-09-2019 12:14:00,1,2565.0,1856.0,0.724,12.162,201,122,81,41,79,48,31,16,0.0,0.0
1011,19,23-09-2019 12:16:00,1,3053.0,2207.0,0.723,14.473,204,104,75,29,100,75,25,34,0.0,0.0
1011,20,23-09-2019 12:18:00,1,3043.0,2261.0,0.743,14.493,138,76,48,28,62,42,20,51,0.0,0.0
1011,21,23-09-2019 12:20:00,1,3078.0,2179.0,0.708,14.542,113,80,46,34,33,22,11,7,0.0,0.0
1011,22,23-09-2019 12:22:00,1,2834.0,2133.0,0.753,13.526,68,25,3,22,43,12,31,0,0.0,0.0
1011,23,23-09-2019 12:24:00,1,2769.0,1979.0,0.715,13.101,113,47,23,24,66,36,30,0,0.0,0.0
1011,24,23-09-2019 12:26:00,1,2641.0,1993.0,0.755,12.613,84,32,16,16,52,19,33,0,0.0,0.0
1011,25,23-09-2019 12:28:00,1,2641.0,1990.0,0.753,12.61,47,27,8,19,20,2,18,2,0.0,0.0
1011,26,23-09-2019 12:30:00,1,2528.0,1965.0,0.777,12.138,68,41,11,30,27,2,25,0,0.0,0.0
1011,27,23-09-2019 12:32:00,1,2633.0,2026.0,0.7695,12.618,110,64,42,22,46,21,25,6,0.0,0.0
1011,28,23-09-2019 12:34:00,1,2738.0,2087.0,0.762,13.098,131,87,56,31,44,30,14,37,0.0,0.0
1011,29,23-09-2019 12:36:00,1,2528.0,1991.0,0.788,12.164,218,114,83,31,104,69,35,18,0.0,0.0
1011,30,23-09-2019 12:38:00,1,2942.0,2174.0,0.739,13.998,194,108,80,28,86,56,30,7,0.0,0.0
1011,31,23-09-2019 12:40:00,1,2760.0,2014.0,0.73,13.107,21,7,5,2,14,8,6,0,0.0,0.0
1011,32,23-09-2019 12:42:00,1,2344.0,1792.0,0.764,11.221,0,0,0,0,0,0,0,0,0.0,0.0
1011,33,23-09-2019 12:44:00,1,2155.0,1606.0,0.745,10.267,12,11,0,11,1,0,1,0,0.0,0.0
1011,34,23-09-2019 12:46:00,1,2360.0,1755.0,0.744,11.24,152,84,39,45,68,40,28,13,0.0,0.0
1011,35,23-09-2019 12:48:00,1,2557.0,1898.0,0.742,12.175,274,161,119,42,113,82,31,85,0.0,0.0
1011,36,23-09-2019 12:50:00,1,2747.0,2038.0,0.742,13.079,252,145,100,45,107,82,25,26,0.0,0.0
1011,37,23-09-2019 12:52:00,1,2741.0,2028.0,0.74,13.044,69,32,16,16,37,20,17,11,0.0,0.0
1011,38,23-09-2019 12:54:00,1,2458.0,1819.0,0.74,11.698,1,0,0,0,1,0,1,0,0.0,0.0
1011,39,23-09-2019 12:56:00,1,2167.0,1618.0,0.746,10.33,9,0,0,0,9,5,4,0,0.0,0.0
1011,40,23-09-2019 12:58:00,1,1965.0,1427.0,0.726,9.323,0,0,0,0,0,0,0,0,0.0,0.0
1011,41,23-09-2019 13:00:00,1,1890.0,1303.0,0.689,8.891,16,6,1,5,10,4,6,0,0.0,0.0
1011,42,23-09-2019 13:02:00,1,1881.0,1316.0,0.7,8.87,21,0,0,0,21,0,21,0,0.0,0.0
1011,43,23-09-2019 13:04:00,1,1777.0,1267.0,0.713,8.406,28,0,0,0,28,0,28,0,0.0,0.0
1011,44,23-09-2019 13:06:00,1,1829.0,1299.5,0.7105,8.647,36,0,0,0,36,1,35,0,0.0,0.0
1011,45,23-09-2019 13:08:00,1,1881.0,1332.0,0.708,8.888,0,0,0,0,0,0,0,0,0.0,0.0
1011,46,23-09-2019 13:10:00,1,1774.0,1290.0,0.727,8.42,0,0,0,0,0,0,0,0,0.0,0.0
1011,47,23-09-2019 13:12:00,1,1773.0,1273.0,0.718,8.395,18,0,0,0,18,0,18,0,0.0,0.0
1011,48,23-09-2019 13:14:00,1,1660.0,1246.0,0.751,7.919,82,17,7,10,65,35,30,0,0.0,0.0
1011,49,23-09-2019 13:16:00,1,1785.0,1289.0,0.722,8.461,9,0,0,0,9,0,9,0,0.0,0.0
1011,50,23-09-2019 13:18:00,1,1669.0,1237.0,0.741,7.947,11,0,0,0,11,0,11,0,0.0,0.0
1011,51,23-09-2019 13:20:00,1,1555.0,1223.0,0.786,7.479,20,0,0,0,20,0,20,0,0.0,0.0
1011,52,23-09-2019 13:22:00,1,1555.0,1210.0,0.779,7.466,68,28,10,18,40,20,20,0,0.0,0.0
1011,53,23-09-2019 13:24:00,1,2038.0,1649.0,0.809,9.857,175,107,73,34,68,43,25,18,0.0,0.0
1011,54,23-09-2019 13:26:00,1,2511.0,2053.0,0.817,12.167,188,134,102,32,54,43,11,122,0.0,0.0
1011,55,23-09-2019 13:28:00,1,2712.0,2162.0,0.797,13.08,226,146,106,40,80,51,29,98,0.0,0.0
1011,56,23-09-2019 13:30:00,1,3033.0,2295.0,0.757,14.49,137,70,46,24,67,39,28,16,0.0,0.0
1011,57,23-09-2019 13:32:00,1,2516.0,2023.0,0.804,12.155,65,22,11,11,43,22,21,3,0.0,0.0
1011,58,23-09-2019 13:34:00,1,2548.0,1927.0,0.756,12.172,51,31,6,25,20,8,12,0,0.0,0.0
1011,59,23-09-2019 13:36:00,1,2340.0,1772.0,0.757,11.183,14,2,0,2,12,1,11,0,0.0,0.0
1011,60,23-09-2019 13:38:00,1,2359.0,1748.0,0.741,11.229,13,3,2,1,10,3,7,0,0.0,0.0
1011,61,23-09-2019 13:40:00,1,2166.5,1588.0,0.7325,10.294,95,2,1,1,93,85,8,0,0.0,0.0
1011,62,23-09-2019 13:42:00,1,1974.0,1428.0,0.724,9.359,0,0,0,0,0,0,0,0,0.0,0.0
1011,63,23-09-2019 13:44:00,1,1873.0,1339.0,0.715,8.864,3,2,0,2,1,1,0,0,0.0,0.0
1011,64,23-09-2019 13:46:00,1,1772.0,1288.0,0.727,8.409,34,20,9,11,14,7,7,0,0.0,0.0
1011,65,23-09-2019 13:48:00,1,2176.0,1560.0,0.717,10.302,117,58,32,26,59,30,29,29,0.0,0.0
1011,66,23-09-2019 13:50:00,1,2642.0,1954.0,0.739,12.573,199,134,98,36,65,47,18,58,0.0,0.0
1011,67,23-09-2019 13:52:00,1,2748.0,2071.0,0.754,13.121,264,184,136,48,80,52,28,23,0.0,0.0
1011,68,23-09-2019 13:54:00,1,2831.0,2147.0,0.758,13.533,117,49,28,21,68,37,31,26,0.0,0.0
1011,69,23-09-2019 13:56:00,1,2653.0,1981.0,0.747,12.648,199,103,59,44,96,62,34,4,0.0,0.0
1011,70,23-09-2019 13:58:00,1,2651.0,1966.0,0.742,12.624,205,45,11,34,160,110,50,0,0.0,0.0
1011,71,23-09-2019 14:00:00,1,2365.0,1725.0,0.73,11.23,130,24,6,18,106,72,34,0,0.0,0.0
1011,72,23-09-2019 14:02:00,1,2357.0,1747.0,0.741,11.223,118,54,24,30,64,32,32,0,0.0,0.0
1011,73,23-09-2019 14:04:00,1,2463.0,1775.0,0.721,11.67,5,4,0,4,1,0,1,0,0.0,0.0
1011,74,23-09-2019 14:06:00,1,2157.0,1633.0,0.757,10.308,8,3,0,3,5,2,3,0,0.0,0.0
1011,75,23-09-2019 14:08:00,1,2177.0,1550.0,0.712,10.293,1,1,0,1,0,0,0,0,0.0,0.0
1011,76,23-09-2019 14:10:00,1,1954.0,1487.0,0.761,9.345,2,0,0,0,2,1,1,0,0.0,0.0
1011,77,23-09-2019 14:12:00,1,1961.0,1452.0,0.74,9.332,0,0,0,0,0,0,0,0,0.0,0.0
1011,78,23-09-2019 14:14:00,1,1966.0,1430.0,0.7275,9.328,2,1,0,1,1,1,0,0,0.0,0.0
1011,79,23-09-2019 14:16:00,1,1971.0,1408.0,0.715,9.324,2,1,0,1,1,1,0,0,0.0,0.0
1011,80,23-09-2019 14:18:00,1,1955.0,1492.0,0.763,9.355,0,0,0,0,0,0,0,0,0.0,0.0
1011,81,23-09-2019 14:20:00,1,2070.0,1504.0,0.726,9.823,0,0,0,0,0,0,0,0,0.0,0.0
1011,82,23-09-2019 14:22:00,1,2065.0,1492.0,0.723,9.789,0,0,0,0,0,0,0,0,0.0,0.0
1011,83,23-09-2019 14:24:00,1,1964.0,1465.0,0.746,9.359,0,0,0,0,0,0,0,0,0.01,0.0
1011,84,23-09-2019 14:26:00,1,1965.0,1461.0,0.744,9.359,1,1,1,0,0,0,0,0,0.0,0.0
1011,85,23-09-2019 14:28:00,1,1957.0,1466.0,0.749,9.333,0,0,0,0,0,0,0,0,0.0,0.0
1011,86,23-09-2019 14:30:00,1,1967.0,1436.0,0.73,9.34,6,2,1,1,4,1,3,0,0.0,0.0
1011,87,23-09-2019 14:32:00,1,1974.0,1407.0,0.713,9.336,0,0,0,0,0,0,0,0,0.0,0.0
1011,88,23-09-2019 14:34:00,1,1876.0,1341.0,0.715,8.878,14,4,1,3,10,2,8,0,0.0,0.0
1011,89,23-09-2019 14:36:00,1,1761.0,1313.0,0.745,8.392,69,11,5,6,58,39,19,0,0.0,0.0
1011,90,23-09-2019 14:38:00,1,1766.0,1331.0,0.754,8.431,6,4,1,3,2,0,2,0,0.0,0.0
1011,91,23-09-2019 14:40:00,1,1755.0,1324.0,0.754,8.382,1,0,0,0,1,0,1,0,0.0,0.0
1011,92,23-09-2019 14:42:00,1,1986.0,1377.0,0.694,9.351,30,4,4,0,26,10,16,0,0.0,0.0
1011,93,23-09-2019 14:44:00,1,1978.0,1389.0,0.702,9.332,8,7,1,6,1,0,1,0,0.0,0.0
1011,94,23-09-2019 14:46:00,1,1876.0,1348.0,0.719,8.884,4,1,0,1,3,1,2,0,0.0,0.0
1011,95,23-09-2019 14:48:00,1,1926.0,1363.0,0.708,9.0975,10,2,0,2,8,0,8,0,0.0,0.0
1011,96,23-09-2019 14:50:00,1,1976.0,1378.0,0.697,9.311,4,3,1,2,1,0,1,0,0.0,0.0
1011,97,23-09-2019 14:52:00,1,1966.0,1457.0,0.741,9.36,13,7,3,4,6,4,2,0,0.0,0.0
1011,98,23-09-2019 14:54:00,1,1972.0,1431.0,0.726,9.354,0,0,0,0,0,0,0,0,0.0,0.0
1011,99,23-09-2019 14:56:00,1,1982.0,1393.0,0.703,9.353,7,2,1,1,5,3,2,0,0.0,0.0
1011,100,23-09-2019 14:58:00,1,1966.0,1434.0,0.729,9.335,32,5,1,4,27,14,13,0,0.0,0.0
1011,101,23-09-2019 15:00:00,1,1979.0,1420.0,0.717,9.368,110,0,0,0,110,90,20,0,0.0,0.0
1011,102,23-09-2019 15:02:00,1,1969.0,1418.0,0.72,9.329,12,0,0,0,12,0,12,0,0.0,0.0
1011,103,23-09-2019 15:04:00,1,1976.0,1421.0,0.719,9.357,7,0,0,0,7,6,1,0,0.01,0.0
1011,104,23-09-2019 15:06:00,1,1978.0,1387.0,0.701,9.328,113,61,34,27,52,30,22,1,0.0,0.0
1011,105,23-09-2019 15:08:00,1,2350.0,1783.0,0.759,11.232,166,112,69,43,54,36,18,38,0.0,0.0
1011,106,23-09-2019 15:10:00,1,2618.0,2095.0,0.8,12.636,287,158,119,39,129,98,31,15,0.0,0.0
1011,107,23-09-2019 15:12:00,1,2621.0,2105.0,0.803,12.656,121,65,43,22,56,43,13,6,0.0,0.0
1011,108,23-09-2019 15:14:00,1,2737.0,2105.0,0.769,13.114,171,105,67,38,66,39,27,15,0.0,0.0
1011,109,23-09-2019 15:16:00,1,2726.0,2115.0,0.776,13.084,140,86,66,20,54,35,19,40,0.0,0.02
1011,110,23-09-2019 15:18:00,1,2419.0,1931.0,0.798,11.668,70,41,22,19,29,18,11,58,0.0,0.0
1011,111,23-09-2019 15:20:00,1,2452.0,1855.0,0.756,11.717,88,29,8,21,59,29,30,6,0.0,0.0
1011,112,23-09-2019 15:22:00,1,2456.0,1831.5,0.7455,11.705,212,29,16,13,183,154,29,1,0.0,0.0
1011,113,23-09-2019 15:24:00,1,2460.0,1808.0,0.735,11.693,216,29,7,22,187,153,34,2,0.0,0.0
1011,114,23-09-2019 15:26:00,1,2341.0,1774.0,0.758,11.187,119,52,33,19,67,47,20,9,0.0,0.0
1011,115,23-09-2019 15:28:00,1,2244.0,1749.0,0.78,10.778,0,0,0,0,0,0,0,0,0.0,0.0
1011,116,23-09-2019 15:30:00,1,2159.0,1624.0,0.752,10.303,1,1,1,0,0,0,0,0,0.0,0.0
1011,117,23-09-2019 15:32:00,1,2055.0,1558.0,0.758,9.821,21,1,0,1,20,10,10,0,0.0,0.0
1011,118,23-09-2019 15:34:00,1,1967.0,1444.0,0.734,9.35,25,1,0,1,24,2,22,0,0.0,0.0
1011,119,23-09-2019 15:36:00,1,1753.0,1383.0,0.788,8.439,6,2,1,1,4,0,4,0,0.0,0.0
1011,120,23-09-2019 15:38:00,1,1637.0,1347.0,0.823,7.94,7,4,0,4,3,0,3,0,0.0,0.0
1011,121,23-09-2019 15:40:00,1,1645.0,1332.0,0.81,7.957,0,0,0,0,0,0,0,0,0.0,0.0
1011,122,23-09-2019 15:42:00,1,1648.0,1314.0,0.798,7.947,0,0,0,0,0,0,0,0,0.0,0.0
1011,123,23-09-2019 15:44:00,1,1639.0,1336.0,0.815,7.937,20,7,3,4,13,9,4,0,0.0,0.0
1011,124,23-09-2019 15:46:00,1,1640.0,1337.0,0.815,7.942,0,0,0,0,0,0,0,0,0.01,0.0
1011,125,23-09-2019 15:48:00,1,1762.0,1342.0,0.762,8.428,0,0,0,0,0,0,0,0,0.0,0.0
1011,126,23-09-2019 15:50:00,1,1650.0,1322.0,0.801,7.966,17,2,0,2,15,1,14,0,0.0,0.0
1011,127,23-09-2019 15:52:00,1,1653.0,1286.0,0.778,7.935,0,0,0,0,0,0,0,0,0.0,0.0
1011,128,23-09-2019 15:54:00,1,1656.0,1294.0,0.781,7.959,33,11,6,5,22,12,10,0,0.0,0.0
1011,129,23-09-2019 15:56:00,1,1711.5,1312.5,0.7675,8.197,1,0,0,0,1,0,1,0,0.0,0.0
1011,130,23-09-2019 15:58:00,1,1767.0,1331.0,0.754,8.435,21,3,1,2,18,9,9,0,0.0,0.0
1011,131,23-09-2019 16:00:00,1,1979.0,1393.0,0.704,9.34,4,0,0,0,4,1,3,0,0.0,0.0
1011,132,23-09-2019 16:02:00,1,2093.0,1409.0,0.674,9.805,3,2,0,2,1,0,1,0,0.0,0.0
1011,133,23-09-2019 16:04:00,1,1984.0,1385.0,0.698,9.351,0,0,0,0,0,0,0,0,0.0,0.0
1011,134,23-09-2019 16:06:00,1,1765.0,1334.0,0.756,8.43,27,4,0,4,23,17,6,0,0.0,0.0
1011,135,23-09-2019 16:08:00,1,1770.0,1307.0,0.738,8.423,7,0,0,0,7,0,7,0,0.0,0.0
1011,136,23-09-2019 16:10:00,1,1878.0,1335.0,0.711,8.878,18,0,0,0,18,0,18,0,0.0,0.0
1011,137,23-09-2019 16:12:00,1,1872.0,1362.0,0.728,8.886,0,0,0,0,0,0,0,0,0.0,0.0
1011,138,23-09-2019 16:14:00,1,1970.0,1379.0,0.7,9.287,19,0,0,0,19,0,19,0,0.0,0.0
1011,139,23-09-2019 16:16:00,1,2094.0,1416.0,0.676,9.816,35,5,0,5,30,9,21,0,0.0,0.0
1011,140,23-09-2019 16:18:00,1,2070.0,1470.0,0.71,9.785,1,1,0,1,0,0,0,0,0.0,0.0
1011,141,23-09-2019 16:20:00,1,2077.0,1472.0,0.709,9.814,10,10,0,10,0,0,0,0,0.0,0.0
1011,142,23-09-2019 16:22:00,1,2074.0,1471.0,0.709,9.799,29,6,1,5,23,15,8,0,0.0,0.0
1011,143,23-09-2019 16:24:00,1,2094.0,1415.0,0.676,9.819,20,0,0,0,20,0,20,0,0.0,0.0
1011,144,23-09-2019 16:26:00,1,1766.0,1313.0,0.743,8.412,0,0,0,0,0,0,0,0,0.0,0.0
1011,145,23-09-2019 16:28:00,1,1782.0,1255.0,0.704,8.413,64,37,4,33,27,9,18,3,0.0,0.0
1011,146,23-09-2019 16:30:00,1,2165.0,1583.5,0.727,10.285,211,114,68,46,97,69,28,10,0.0,0.0
1011,147,23-09-2019 16:32:00,1,2548.0,1912.0,0.75,12.157,149,81,52,29,68,42,26,43,0.0,0.0
1011,148,23-09-2019 16:34:00,1,2545.0,1924.0,0.756,12.159,130,86,47,39,44,25,19,64,0.02,0.0
1011,149,23-09-2019 16:36:00,1,2742.0,2044.0,0.745,13.065,83,39,14,25,44,23,21,8,0.0,0.03
1011,150,23-09-2019 16:38:00,1,2555.0,1855.0,0.726,12.122,47,18,6,12,29,6,23,0,0.0,0.0
1011,151,23-09-2019 16:40:00,1,2558.0,1874.0,0.733,12.153,80,19,7,12,61,35,26,0,0.0,0.0
1011,152,23-09-2019 16:42:00,1,2348.0,1767.0,0.753,11.209,45,21,5,16,24,3,21,0,0.0,0.0
1011,153,23-09-2019 16:44:00,1,2567.0,1862.0,0.725,12.175,8,7,1,6,1,0,1,0,0.0,0.0
1011,154,23-09-2019 16:46:00,1,2251.0,1712.0,0.761,10.763,55,26,0,26,29,10,19,0,0.0,0.0
1011,155,23-09-2019 16:48:00,1,2457.0,1802.0,0.733,11.678,51,34,7,27,17,6,11,0,0.0,0.0
1011,156,23-09-2019 16:50:00,1,2564.0,1873.0,0.73,12.178,27,20,8,12,7,2,5,0,0.0,0.0
1011,157,23-09-2019 16:52:00,1,2246.0,1752.0,0.78,10.789,14,9,6,3,5,0,5,0,0.0,0.0
1011,158,23-09-2019 16:54:00,1,2277.0,1610.0,0.707,10.754,0,0,0,0,0,0,0,0,0.0,0.0
1011,159,23-09-2019 16:56:00,1,2055.0,1567.0,0.762,9.83,0,0,0,0,0,0,0,0,0.0,0.0
1011,160,23-09-2019 16:58:00,1,2061.0,1544.0,0.749,9.832,0,0,0,0,0,0,0,0,0.0,0.0
1011,161,23-09-2019 17:00:00,1,2055.0,1555.0,0.756,9.82,0,0,0,0,0,0,0,0,0.0,0.0
1011,162,23-09-2019 17:02:00,1,2074.0,1486.0,0.716,9.818,6,4,1,3,2,1,1,0,0.0,0.0
1011,163,23-09-2019 17:04:00,1,2129.5,1495.0,0.702,10.0465,5,4,0,4,1,0,1,0,0.0,0.0
1011,164,23-09-2019 17:06:00,1,2185.0,1504.0,0.688,10.275,2,0,0,0,2,1,1,0,0.0,0.0
1011,165,23-09-2019 17:08:00,1,2187.0,1518.0,0.694,10.299,0,0,0,0,0,0,0,0,0.0,0.0
1011,166,23-09-2019 17:10:00,1,2177.0,1532.0,0.704,10.273,4,2,1,1,2,0,2,0,0.0,0.0
1011,167,23-09-2019 17:12:00,1,2177.0,1558.0,0.716,10.302,0,0,0,0,0,0,0,0,0.0,0.0
1011,168,23-09-2019 17:14:00,1,2173.0,1542.0,0.71,10.268,33,4,2,2,29,18,11,0,0.0,0.0
1011,169,23-09-2019 17:16:00,1,2083.0,1445.0,0.693,9.808,4,4,0,4,0,0,0,0,0.0,0.0
1011,170,23-09-2019 17:18:00,1,1862.0,1378.0,0.74,8.864,2,1,0,1,1,1,0,0,0.0,0.0
1011,171,23-09-2019 17:20:00,1,1872.0,1391.0,0.743,8.918,10,2,0,2,8,2,6,0,0.0,0.0
1011,172,23-09-2019 17:22:00,1,2091.0,1415.0,0.677,9.807,2,2,0,2,0,0,0,0,0.0,0.0
1011,173,23-09-2019 17:24:00,1,1876.0,1363.0,0.726,8.901,0,0,0,0,0,0,0,0,0.0,0.0
1011,174,23-09-2019 17:26:00,1,1876.0,1334.0,0.711,8.869,37,11,2,9,26,16,10,0,0.0,0.0
1011,175,23-09-2019 17:28:00,1,1976.0,1418.0,0.717,9.357,5,1,1,0,4,2,2,0,0.0,0.0
1011,176,23-09-2019 17:30:00,1,2086.0,1430.0,0.686,9.801,4,1,0,1,3,1,2,0,0.0,0.0
1011,177,23-09-2019 17:32:00,1,2086.0,1447.0,0.693,9.822,2,0,0,0,2,1,1,0,0.0,0.0
1011,178,23-09-2019 17:34:00,1,1971.0,1423.0,0.722,9.34,17,8,5,3,9,7,2,0,0.0,0.0
1011,179,23-09-2019 17:36:00,1,2091.0,1426.0,0.682,9.817,29,8,1,7,21,1,20,0,0.0,0.0
1011,180,23-09-2019 17:38:00,1,2036.5,1411.0,0.693,9.5865,30,10,0,10,20,2,18,0,0.0,0.0
1011,181,23-09-2019 17:40:00,1,1982.0,1396.0,0.704,9.356,5,3,0,3,2,0,2,0,0.0,0.0
1011,182,23-09-2019 17:42:00,1,1862.0,1372.0,0.737,8.854,11,8,3,5,3,0,3,0,0.0,0.0
1011,183,23-09-2019 17:44:00,1,1867.0,1381.0,0.739,8.886,2,0,0,0,2,0,2,0,0.0,0.0
1011,184,23-09-2019 17:46:00,1,1881.0,1325.0,0.704,8.879,16,14,0,14,2,0,2,0,0.0,0.0
1011,185,23-09-2019 17:48:00,1,1973.0,1393.0,0.706,9.316,32,13,3,10,19,4,15,0,0.0,0.0
1011,186,23-09-2019 17:50:00,1,2084.0,1454.0,0.698,9.823,145,48,23,25,97,60,37,0,0.0,0.0
1011,187,23-09-2019 17:52:00,1,2382.0,1636.0,0.687,11.196,168,84,50,34,84,56,28,11,0.0,0.02
1011,188,23-09-2019 17:54:00,1,2339.0,1821.0,0.779,11.231,109,70,41,29,39,16,23,26,0.0,0.0
1011,189,23-09-2019 17:56:00,1,2647.0,1994.0,0.753,12.635,149,94,68,26,55,35,20,83,0.0,0.0
1011,190,23-09-2019 17:58:00,1,2460.0,1818.0,0.739,11.706,81,59,34,25,22,11,11,21,0.0,0.0
1011,191,23-09-2019 18:00:00,0,2870.0,2068.0,0.721,13.597,213,126,94,32,87,53,34,23,0.0,0.0
1011,192,23-09-2019 18:02:00,0,2345.0,1769.0,0.754,11.196,417,250,200,50,167,130,37,80,0.0,0.0
1011,193,23-09-2019 18:04:00,0,2859.0,2090.0,0.731,13.579,271,158,117,41,113,79,34,101,0.0,0.0
1011,194,23-09-2019 18:06:00,0,3363.0,2358.0,0.701,15.862,289,197,148,49,92,63,29,59,0.0,0.0
1011,195,23-09-2019 18:08:00,0,3254.0,2376.0,0.73,15.45,424,252,195,57,172,124,48,89,0.0,0.0
1011,196,23-09-2019 18:10:00,0,3142.0,2328.0,0.741,14.958,464,278,221,57,186,141,45,66,0.0,0.0
1011,197,23-09-2019 18:12:00,0,3093.0,2268.5,0.7335,14.6995,208,124,85,39,84,58,26,18,0.0,0.0
1011,198,23-09-2019 18:14:00,0,3044.0,2209.0,0.726,14.441,133,72,42,30,61,33,28,4,0.0,0.0
1011,199,23-09-2019 18:16:00,0,3065.0,2213.0,0.722,14.527,92,61,30,31,31,12,19,2,0.0,0.0
1011,200,23-09-2019 18:18:00,0,3251.0,2366.0,0.728,15.429,172,102,67,35,70,42,28,35,0.01,0.0
1011,201,23-09-2019 18:20:00,0,3532.0,2617.0,0.741,16.812,119,91,50,41,28,4,24,57,0.0,0.0
1011,202,23-09-2019 18:22:00,0,3529.0,2609.0,0.739,16.794,315,225,168,57,90,62,28,66,0.0,0.0
1011,203,23-09-2019 18:24:00,0,3140.0,2401.0,0.765,15.029,275,205,151,54,70,35,35,60,0.0,0.0
1011,204,23-09-2019 18:26:00,0,3324.0,2497.0,0.751,15.863,282,186,132,54,96,67,29,97,0.0,0.0
1011,205,23-09-2019 18:28:00,0,3323.0,2521.0,0.759,15.883,356,203,148,55,153,118,35,122,0.0,0.01
1011,206,23-09-2019 18:30:00,0,2916.0,2279.0,0.782,14.014,372,188,144,44,184,135,49,49,0.0,0.0
1011,207,23-09-2019 18:32:00,0,3521.0,2708.0,0.769,16.873,160,114,65,49,46,19,27,31,0.0,0.01
1011,208,23-09-2019 18:34:00,0,3294.0,2619.0,0.795,15.88,303,191,143,48,112,73,39,113,0.0,0.02
1011,209,23-09-2019 18:36:00,0,3269.0,2734.0,0.836,15.907,205,127,92,35,78,56,22,39,0.0,0.0
1011,210,23-09-2019 18:38:00,0,1842.0,1483.0,0.805,8.901,89,37,15,22,52,41,11,0,0.0,0.0
1011,211,23-09-2019 18:40:00,0,3112.0,2464.0,0.792,14.991,122,47,17,30,75,41,34,2,0.0,0.0
1011,212,23-09-2019 18:42:00,0,3314.0,2574.0,0.777,15.908,51,10,5,5,41,6,35,0,0.0,0.0
1011,213,23-09-2019 18:44:00,0,3196.0,2570.0,0.804,15.439,109,81,45,36,28,5,23,0,0.0,0.0
1011,214,23-09-2019 18:46:00,0,3471.5,2833.0,0.815,16.8145,315,209,162,47,106,76,30,42,0.0,0.0
1011,215,23-09-2019 18:48:00,0,3747.0,3096.0,0.826,18.19,367,188,146,42,179,136,43,96,0.0,0.0
1011,216,23-09-2019 18:50:00,0,3765.0,3085.0,0.819,18.251,352,201,152,49,151,115,36,58,0.0,0.0
1011,217,23-09-2019 18:52:00,0,3005.0,2393.0,0.796,14.491,374,197,161,36,177,135,42,125,0.0,0.0
1011,218,23-09-2019 18:54:00,0,3285.0,2665.0,0.811,15.892,349,211,157,54,138,97,41,63,0.01,0.0
1011,219,23-09-2019 18:56:00,0,3470.0,2823.0,0.814,16.798,439,256,212,44,183,138,45,79,0.09,0.0
1011,220,23-09-2019 18:58:00,0,3500.0,2778.0,0.794,16.866,304,210,166,44,94,73,21,188,0.0,0.02
1011,221,23-09-2019 19:00:00,0,3309.0,2563.0,0.775,15.876,290,168,129,39,122,91,31,96,0.0,0.0
1011,222,23-09-2019 19:02:00,0,3298.0,2650.0,0.803,15.926,423,259,204,55,164,125,39,115,0.0,0.0
1011,223,23-09-2019 19:04:00,0,3284.0,2650.0,0.807,15.875,252,145,110,35,107,79,28,78,0.0,0.0
1011,224,23-09-2019 19:06:00,0,3292.0,2625.0,0.797,15.875,253,167,117,50,86,64,22,34,0.0,0.0
1011,225,23-09-2019 19:08:00,0,3288.0,2652.0,0.807,15.892,437,252,197,55,185,135,50,103,0.0,0.0
1011,226,23-09-2019 19:10:00,0,3318.0,2550.0,0.769,15.895,539,339,271,68,200,148,52,154,0.0,0.0
1011,227,23-09-2019 19:12:00,0,3233.0,2453.0,0.759,15.454,308,166,130,36,142,112,30,80,0.0,0.0
1011,228,23-09-2019 19:14:00,0,3023.0,2335.0,0.772,14.495,326,207,163,44,119,81,38,132,0.0,0.0
1011,229,23-09-2019 19:16:00,0,3243.0,2421.0,0.746,15.459,354,216,174,42,138,100,38,21,0.0,0.0
1011,230,23-09-2019 19:18:00,0,3012.0,2361.0,0.784,14.48,278,163,119,44,115,75,40,66,0.0,0.0
1011,231,23-09-2019 19:20:00,0,3120.5,2389.0,0.766,14.9385,271,167,131,36,104,78,26,81,0.0,0.0
1011,232,23-09-2019 19:22:00,0,3229.0,2417.0,0.748,15.397,262,169,128,41,93,66,27,23,0.0,0.07
1011,233,23-09-2019 19:24:00,0,3053.0,2238.0,0.733,14.507,260,162,119,43,98,64,34,21,0.0,0.0
1011,234,23-09-2019 19:26:00,0,3042.0,2264.0,0.744,14.491,468,268,218,50,200,155,45,118,0.0,0.0
1011,235,23-09-2019 19:28:00,0,3141.0,2336.0,0.744,14.962,153,88,55,33,65,37,28,53,0.0,0.0
1011,236,23-09-2019 19:30:00,0,3337.0,2477.0,0.742,15.89,123,79,48,31,44,8,36,58,0.0,0.03
1011,237,23-09-2019 19:32:00,0,3330.0,2510.0,0.754,15.901,220,150,108,42,70,33,37,30,0.0,0.0
1011,238,23-09-2019 19:34:00,0,3315.0,2532.0,0.764,15.863,266,163,123,40,103,61,42,72,0.0,0.0
1011,239,23-09-2019 19:36:00,0,3321.0,2527.0,0.761,15.884,162,116,89,27,46,10,36,66,0.0,0.0
1011,240,23-09-2019 19:38:00,0,3311.0,2580.0,0.779,15.902,270,198,140,58,72,39,33,49,0.0,0.0
1011,241,23-09-2019 19:40:00,0,3335.0,2496.0,0.748,15.905,187,133,89,44,54,29,25,88,0.0,0.0
1011,242,23-09-2019 19:42:00,0,3042.0,2290.0,0.753,14.522,302,174,131,43,128,83,45,90,0.0,0.0
1011,243,23-09-2019 19:44:00,0,3308.0,2546.0,0.77,15.852,167,125,87,38,42,19,23,48,0.0,0.04
1011,244,23-09-2019 19:46:00,0,2921.0,2299.0,0.787,14.055,337,232,176,56,105,78,27,56,0.0,0.01
1011,245,23-09-2019 19:48:00,0,3311.0,2570.0,0.776,15.891,436,297,239,58,139,105,34,84,0.0,0.0
1011,246,23-09-2019 19:50:00,0,3293.0,2651.0,0.805,15.91,277,164,128,36,113,84,29,56,0.0,0.0
1011,247,23-09-2019 19:52:00,0,2884.0,2404.0,0.834,14.024,201,134,92,42,67,43,24,79,0.02,0.0
1011,248,23-09-2019 19:54:00,0,2706.5,2205.5,0.814,13.106,177,129,93,36,48,35,13,52,0.0,0.0
1011,249,23-09-2019 19:56:00,0,2529.0,2007.0,0.794,12.188,266,180,132,48,86,64,22,141,0.0,0.0
1011,250,23-09-2019 19:58:00,0,2599.0,2138.0,0.822,12.609,240,153,122,31,87,49,38,59,0.03,0.0
1011,251,23-09-2019 20:00:00,0,3756.0,3113.0,0.829,18.246,195,136,91,45,59,26,33,38,0.0,0.0
1011,252,23-09-2019 20:02:00,0,3448.0,2929.0,0.849,16.83,148,115,76,39,33,5,28,54,0.0,0.0
1011,253,23-09-2019 20:04:00,0,3744.0,3165.0,0.845,18.255,368,232,177,55,136,96,40,55,0.0,0.02
1011,254,23-09-2019 20:06:00,0,3466.0,2943.0,0.849,16.914,409,253,200,53,156,112,44,78,0.0,0.0
1011,255,23-09-2019 20:08:00,0,3467.0,2844.0,0.82,16.809,190,149,103,46,41,0,41,81,0.0,0.02
1011,256,23-09-2019 20:10:00,0,3424.0,3083.0,0.9,16.905,235,154,118,36,81,45,36,37,0.04,0.06
1011,257,23-09-2019 20:12:00,0,2277.0,2008.0,0.882,11.196,174,105,82,23,69,39,30,0,0.0,0.0
1011,258,23-09-2019 20:14:00,0,1623.0,1411.0,0.87,7.958,45,23,5,18,22,4,18,15,0.0,0.0
1011,259,23-09-2019 20:16:00,0,1627.0,1393.0,0.856,7.953,219,134,96,38,85,49,36,41,0.0,0.0
1011,260,23-09-2019 20:18:00,0,3159.0,2715.0,0.86,15.451,443,291,234,57,152,115,37,90,0.06,0.0
1011,261,23-09-2019 20:20:00,0,3438.0,2987.0,0.869,16.853,217,121,88,33,96,71,25,37,0.04,0.0
1011,262,23-09-2019 20:22:00,0,2288.0,2018.0,0.882,11.248,254,163,120,43,91,55,36,66,0.02,0.0
1011,263,23-09-2019 20:24:00,0,3909.0,3398.0,0.869,19.164,159,103,66,37,56,26,30,56,0.0,0.0
1011,264,23-09-2019 20:26:00,0,3455.0,2899.0,0.839,16.821,200,145,91,54,55,15,40,63,0.0,0.03
1011,265,23-09-2019 20:28:00,0,3348.0,2873.5,0.859,16.372,256,184,138,46,72,45,27,39,0.0,0.11
1011,266,23-09-2019 20:30:00,0,3241.0,2848.0,0.879,15.923,308,187,141,46,121,90,31,98,0.0,0.0
1011,267,23-09-2019 20:32:00,0,3241.0,2818.0,0.87,15.89,367,184,136,48,183,134,49,84,0.08,0.0
1011,268,23-09-2019 20:34:00,0,3427.0,3049.0,0.89,16.88,389,235,181,54,154,118,36,88,0.05,0.0
1011,269,23-09-2019 20:36:00,0,3235.0,2842.0,0.878,15.891,305,162,132,30,143,112,31,48,0.01,0.0
1011,270,23-09-2019 20:38:00,0,3400.0,3110.0,0.915,16.841,211,139,98,41,72,49,23,42,0.0,0.0
1011,271,23-09-2019 20:40:00,0,2745.0,2494.0,0.908,13.578,334,218,173,45,116,94,22,53,0.0,0.0
1011,272,23-09-2019 20:42:00,0,3045.0,2701.0,0.887,14.988,259,197,144,53,62,29,33,69,0.0,0.0
1011,273,23-09-2019 20:44:00,0,3698.0,3325.0,0.899,18.253,324,254,189,65,70,38,32,56,0.0,0.0
1011,274,23-09-2019 20:46:00,0,3422.0,3062.0,0.895,16.873,379,263,201,62,116,76,40,44,0.01,0.0
1011,275,23-09-2019 20:48:00,0,3423.0,3022.0,0.883,16.831,269,175,138,37,94,70,24,84,0.07,0.0
1011,276,23-09-2019 20:50:00,0,2027.0,1690.0,0.834,9.857,480,297,241,56,183,135,48,45,0.0,0.0
1011,277,23-09-2019 20:52:00,0,3250.0,2797.0,0.86,15.903,179,150,105,45,29,10,19,61,0.02,0.0
1011,278,23-09-2019 20:54:00,0,3900.0,3501.0,0.898,19.243,256,206,151,55,50,18,32,59,0.0,0.0
1011,279,23-09-2019 20:56:00,0,3781.0,3452.0,0.913,18.72,297,212,161,51,85,45,40,75,0.0,0.02
1011,280,23-09-2019 20:58:00,0,3213.0,2913.0,0.907,15.883,407,223,178,45,184,138,46,52,0.0,0.01
1011,281,23-09-2019 21:00:00,0,3327.0,2953.0,0.888,16.378,321,178,137,41,143,94,49,58,0.04,0.0
1011,282,23-09-2019 21:02:00,0,3423.0,3049.0,0.8905,16.863,151,94,67,27,57,34,23,42,0.01,0.0
1011,283,23-09-2019 21:04:00,0,3519.0,3145.0,0.893,17.348,250,195,130,65,55,26,29,39,0.0,0.0
1011,284,23-09-2019 21:06:00,0,3415.0,3019.0,0.884,16.796,217,178,121,57,39,10,29,42,0.02,0.0
1011,285,23-09-2019 21:08:00,0,3251.0,2835.0,0.872,15.946,246,141,97,44,105,59,46,26,0.0,0.02
1011,286,23-09-2019 21:10:00,0,2576.0,2248.0,0.873,12.637,207,157,116,41,50,7,43,52,0.0,0.0
1011,287,23-09-2019 21:12:00,0,3255.0,2792.0,0.858,15.917,207,164,113,51,43,2,41,64,0.0,0.01
1011,288,23-09-2019 21:14:00,0,3500.0,3151.0,0.9,17.277,262,190,138,52,72,39,33,55,0.0,0.04
1011,289,23-09-2019 21:16:00,0,3401.0,3154.0,0.927,16.893,289,158,123,35,131,99,32,83,0.09,0.0
1011,290,23-09-2019 21:18:00,0,2555.0,2299.0,0.9,12.612,320,206,167,39,114,80,34,41,0.0,0.01
1011,291,23-09-2019 21:20:00,0,2267.0,2087.0,0.921,11.242,325,175,130,45,150,108,42,83,0.0,0.0
1011,292,23-09-2019 21:22:00,0,2914.0,2731.0,0.937,14.503,285,176,127,49,109,91,18,123,0.06,0.0
1011,293,23-09-2019 21:24:00,0,2747.0,2493.0,0.908,13.585,561,292,227,65,269,208,61,89,0.01,0.02
1011,294,23-09-2019 21:26:00,0,3307.0,3028.0,0.916,16.381,238,176,129,47,62,27,35,89,0.02,0.0
1011,295,23-09-2019 21:28:00,0,3612.0,3233.0,0.895,17.81,197,146,94,52,51,4,47,59,0.0,0.0
1011,296,23-09-2019 21:30:00,0,3607.0,3198.0,0.887,17.75,198,167,113,54,31,0,31,53,0.0,0.0
1011,297,23-09-2019 21:32:00,0,3399.0,3126.0,0.92,16.852,285,185,130,55,100,58,42,30,0.0,0.1
1011,298,23-09-2019 21:34:00,0,3404.0,3136.0,0.921,16.884,286,184,141,43,102,59,43,54,0.05,0.03
1011,299,23-09-2019 21:36:00,0,2838.5,2592.5,0.9115,14.0545,139,45,15,30,94,55,39,4,0.01,0.0
1011,300,23-09-2019 21:38:00,0,2273.0,2049.0,0.902,11.225,231,74,39,35,157,106,51,7,0.0,0.0
1011,301,23-09-2019 21:40:00,0,2786.0,2383.0,0.855,13.616,223,139,103,36,84,48,36,37,0.05,0.0
1011,302,23-09-2019 21:42:00,0,3412.0,3106.0,0.91,16.882,246,200,136,64,46,0,46,53,0.02,0.0
1011,303,23-09-2019 21:44:00,0,3577.0,3305.0,0.924,17.751,264,179,141,38,85,59,26,45,0.0,0.03
1011,304,23-09-2019 21:46:00,0,3399.0,3129.0,0.921,16.857,359,235,179,56,124,79,45,35,0.05,0.02
1011,305,23-09-2019 21:48:00,0,3892.0,3479.0,0.894,19.187,298,206,156,50,92,49,43,75,0.05,0.0
1011,306,23-09-2019 21:50:00,0,3215.0,2955.0,0.919,15.937,295,209,148,61,86,39,47,63,0.02,0.01
1011,307,23-09-2019 21:52:00,0,3584.0,3304.0,0.922,17.778,220,162,115,47,58,21,37,54,0.0,0.04
1011,308,23-09-2019 21:54:00,0,2938.0,2689.0,0.915,14.552,247,153,116,37,94,62,32,32,0.01,0.0
1011,309,23-09-2019 21:56:00,0,3843.0,3667.0,0.954,19.203,241,140,103,37,101,69,32,33,0.06,0.35
1011,310,23-09-2019 21:58:00,0,2470.0,2240.0,0.907,12.21,246,174,125,49,72,38,34,49,0.0,0.0
1011,311,23-09-2019 22:00:00,0,3674.0,3428.0,0.933,18.272,279,224,167,57,55,21,34,75,0.01,0.0
1011,312,23-09-2019 22:02:00,0,3754.0,3626.0,0.966,18.804,405,268,209,59,137,89,48,57,0.0,0.0
1011,313,23-09-2019 22:04:00,0,3864.0,3603.0,0.932,19.213,259,187,131,56,72,37,35,49,0.0,0.0
1011,314,23-09-2019 22:06:00,0,3593.0,3304.0,0.92,17.813,389,235,182,53,154,114,40,88,0.0,0.0
1011,315,23-09-2019 22:08:00,0,3474.0,3291.0,0.947,17.331,147,111,71,40,36,10,26,58,0.0,0.0
1011,316,23-09-2019 22:10:00,0,3569.0,3365.0,0.943,17.7865,300,181,133,48,119,70,49,43,0.0,0.0
1011,317,23-09-2019 22:12:00,0,3664.0,3439.0,0.939,18.242,296,177,131,46,119,89,30,81,0.06,0.0
1011,318,23-09-2019 22:14:00,0,3137.0,2807.0,0.895,15.466,450,269,209,60,181,138,43,106,0.01,0.0
1011,319,23-09-2019 22:16:00,0,3470.0,3292.0,0.949,17.318,222,142,103,39,80,43,37,57,0.0,0.0
1011,320,23-09-2019 22:18:00,0,3674.0,3442.0,0.937,18.285,195,150,102,48,45,7,38,62,0.01,0.0
1011,321,23-09-2019 22:20:00,0,3863.0,3549.0,0.919,19.148,246,197,140,57,49,19,30,76,0.0,0.0
1011,322,23-09-2019 22:22:00,0,3688.0,3430.0,0.93,18.327,189,145,104,41,44,10,34,57,0.0,0.0
1011,323,23-09-2019 22:24:00,0,3768.0,3552.0,0.942,18.779,170,133,85,48,37,2,35,66,0.01,0.0
1011,324,23-09-2019 22:26:00,0,3673.0,3445.0,0.938,18.284,197,142,99,43,55,9,46,64,0.0,0.0
1011,325,23-09-2019 22:28:00,0,3226.0,2929.0,0.908,15.955,141,61,34,27,80,50,30,3,0.0,0.0
1011,326,23-09-2019 22:30:00,0,2463.0,2239.0,0.909,12.182,89,35,5,30,54,32,22,5,0.0,0.0
1011,327,23-09-2019 22:32:00,0,2185.0,1971.0,0.902,10.789,141,73,48,25,68,47,21,0,0.0,0.0
1011,328,23-09-2019 22:34:00,0,3688.0,3408.0,0.924,18.303,442,262,202,60,180,134,46,73,0.04,0.0
1011,329,23-09-2019 22:36:00,0,3179.0,3022.0,0.951,15.87,539,300,246,54,239,182,57,99,0.03,0.0
1011,330,23-09-2019 22:38:00,0,3845.0,3668.0,0.954,19.209,278,147,109,38,131,99,32,32,0.07,0.0
1011,331,23-09-2019 22:40:00,0,2367.0,2175.0,0.919,11.732,384,230,178,52,154,129,25,30,0.0,0.0
1011,332,23-09-2019 22:42:00,0,3874.0,3595.0,0.928,19.246,227,153,106,47,74,29,45,63,0.0,0.0
1011,333,23-09-2019 22:44:00,0,3820.5,3567.0,0.9335,19.003,151,109,67,42,42,7,35,74,0.01,0.0
1011,334,23-09-2019 22:46:00,0,3767.0,3539.0,0.939,18.76,120,74,41,33,46,2,44,71,0.0,0.0
1011,335,23-09-2019 22:48:00,0,3700.0,3385.0,0.915,18.325,147,99,57,42,48,3,45,72,0.0,0.01
1011,336,23-09-2019 22:50:00,0,3834.0,3635.0,0.948,19.13,181,118,78,40,63,10,53,65,0.0,0.0
1011,337,23-09-2019 22:52:00,0,3697.0,3339.0,0.903,18.263,224,158,117,41,66,33,33,40,0.0,0.08
1011,338,23-09-2019 22:54:00,0,3375.0,3222.0,0.955,16.865,341,182,150,32,159,111,48,42,0.06,0.02
1011,339,23-09-2019 22:56:00,0,3757.0,3602.0,0.959,18.791,330,211,158,53,119,84,35,12,0.11,0.02
1011,340,23-09-2019 22:58:00,0,2556.0,2298.0,0.899,12.615,82,38,22,16,44,28,16,0,0.0,0.0
1011,341,23-09-2019 23:00:00,0,2083.0,1898.0,0.911,10.308,24,11,9,2,13,11,2,0,0.0,0.0
1011,342,23-09-2019 23:02:00,0,1899.0,1728.0,0.91,9.395,37,16,13,3,21,15,6,0,0.01,0.0
1011,343,23-09-2019 23:04:00,0,1796.0,1628.0,0.906,8.88,19,17,0,17,2,1,1,0,0.0,0.0
1011,344,23-09-2019 23:06:00,0,1799.0,1644.0,0.914,8.908,15,12,0,12,3,2,1,0,0.0,0.0
1011,345,23-09-2019 23:08:00,0,1803.0,1617.0,0.897,8.893,9,4,3,1,5,3,2,0,0.0,0.0
1011,346,23-09-2019 23:10:00,0,1896.0,1715.0,0.905,9.368,29,12,6,6,17,13,4,0,0.0,0.0
1011,347,23-09-2019 23:12:00,0,2094.0,1854.0,0.885,10.305,13,7,2,5,6,4,2,0,0.0,0.0
1011,348,23-09-2019 23:14:00,0,2092.0,1874.0,0.896,10.318,6,1,0,1,5,0,5,0,0.0,0.0
1011,349,23-09-2019 23:16:00,0,2095.0,1827.0,0.872,10.279,0,0,0,0,0,0,0,0,0.0,0.0
1011,350,23-09-2019 23:18:00,0,2647.0,2407.0,0.903,13.095,82,41,25,16,41,29,12,4,0.0,0.0
1011,351,23-09-2019 23:20:00,0,3199.0,2987.0,0.934,15.911,558,353,277,76,205,154,51,66,0.0,0.01
1011,352,23-09-2019 23:22:00,0,3553.0,3482.0,0.98,17.852,609,361,298,63,248,191,57,100,0.0,0.0
1011,353,23-09-2019 23:24:00,0,3320.0,3386.0,1.02,16.83,489,281,213,68,208,157,51,82,0.0,0.0
1011,354,23-09-2019 23:26:00,0,3440.0,3438.0,1.0,17.358,290,182,131,51,108,69,39,87,0.03,0.04
1011,355,23-09-2019 23:28:00,0,3548.0,3482.0,0.981,17.833,317,165,125,40,152,114,38,128,0.05,0.0
1011,356,23-09-2019 23:30:00,0,3846.0,3671.0,0.954,19.219,168,121,84,37,47,16,31,61,0.01,0.0
1011,357,23-09-2019 23:32:00,0,4007.0,3868.0,0.965,20.07,170,121,80,41,49,7,42,88,0.01,0.0
1011,358,23-09-2019 23:34:00,0,3648.0,3507.0,0.961,18.258,242,137,87,50,105,46,59,60,0.0,0.0
1011,359,23-09-2019 23:36:00,0,3938.0,3818.0,0.97,19.743,289,195,147,48,94,56,38,44,0.0,0.02
1011,360,23-09-2019 23:38:00,0,3323.0,3393.0,1.021,16.849,322,201,151,50,121,89,32,59,0.0,0.01
1011,361,23-09-2019 23:40:00,0,3351.0,3319.0,0.99,16.877,263,114,71,43,149,105,44,16,0.06,0.01
1011,362,23-09-2019 23:42:00,0,2094.0,1817.0,0.868,10.261,163,79,47,32,84,51,33,75,0.0,0.01
1011,363,23-09-2019 23:44:00,0,3449.0,3412.0,0.989,17.366,254,169,130,39,85,54,31,77,0.05,0.0
1011,364,23-09-2019 23:46:00,0,4111.0,4001.0,0.973,20.625,141,98,58,40,43,16,27,54,0.0,0.07
1011,365,23-09-2019 23:48:00,0,4128.0,3964.0,0.96,20.652,47,22,16,6,25,10,15,15,0.0,0.28
1011,366,23-09-2019 23:50:00,0,3639.0,3512.0,0.965,18.224,10,0,0,0,10,0,10,0,0.0,0.0
1011,367,23-09-2019 23:52:00,0,3643.5,3541.5,0.972,18.2745,100,63,50,13,37,18,19,44,0.0,0.02
1011,368,23-09-2019 23:54:00,0,3648.0,3571.0,0.979,18.325,410,209,170,39,201,142,59,17,0.19,0.0
1011,369,23-09-2019 23:56:00,0,3081.0,2987.0,0.969,15.447,492,292,226,66,200,154,46,98,0.0,0.04
1011,370,23-09-2019 23:58:00,0,3338.0,3360.0,1.007,16.87,312,213,163,50,99,73,26,72,0.0,0.0
1011,371,24-09-2019 00:00:00,0,3539.0,3468.0,0.98,17.781,435,217,163,54,218,170,48,91,0.01,0.0
1011,372,24-09-2019 00:02:00,0,3343.0,3339.0,0.999,16.868,344,217,164,53,127,93,34,31,0.01,0.0
1011,373,24-09-2019 00:04:00,0,3342.0,3341.0,1.0,16.868,422,205,162,43,217,176,41,135,0.06,0.0
1011,374,24-09-2019 00:06:00,0,2734.0,2553.0,0.934,13.599,151,93,60,33,58,42,16,57,0.0,0.0
1011,375,24-09-2019 00:08:00,0,2899.0,2800.0,0.966,14.522,70,34,12,22,36,19,17,7,0.0,0.0
1011,376,24-09-2019 00:10:00,0,2648.0,2443.0,0.923,13.136,183,137,100,37,46,29,17,52,0.0,0.0
1011,377,24-09-2019 00:12:00,0,3854.0,3652.0,0.948,19.228,148,101,64,37,47,8,39,62,0.01,0.0
1011,378,24-09-2019 00:14:00,0,3844.0,3657.0,0.951,19.193,247,173,131,42,74,45,29,46,0.02,0.0
1011,379,24-09-2019 00:16:00,0,3849.0,3637.0,0.945,19.192,147,91,53,38,56,21,35,56,0.01,0.0
1011,380,24-09-2019 00:18:00,0,3650.0,3555.0,0.974,18.315,150,103,63,40,47,12,35,70,0.02,0.0
1011,381,24-09-2019 00:20:00,0,3738.0,3645.0,0.975,18.762,163,131,95,36,32,11,21,57,0.0,0.0
1011,382,24-09-2019 00:22:00,0,3357.0,3287.0,0.979,16.864,175,116,87,29,59,39,20,22,0.0,0.09
1011,383,24-09-2019 00:24:00,0,2264.0,2121.0,0.937,11.268,180,92,63,29,88,55,33,35,0.03,0.0
1011,384,24-09-2019 00:26:00,0,2960.0,2814.5,0.948,14.7785,213,138,104,34,75,45,30,66,0.11,0.0
1011,385,24-09-2019 00:28:00,0,3656.0,3508.0,0.959,18.289,98,58,31,27,40,9,31,51,0.01,0.0
1011,386,24-09-2019 00:30:00,0,3847.0,3667.0,0.953,19.216,295,159,121,38,136,103,33,41,0.02,0.0
1011,387,24-09-2019 00:32:00,0,3192.0,3006.0,0.942,15.904,143,98,50,48,45,8,37,61,0.0,0.0
1011,388,24-09-2019 00:34:00,0,3634.0,3587.0,0.987,18.291,142,73,46,27,69,40,29,50,0.0,0.0
1011,389,24-09-2019 00:36:00,0,3088.0,2950.0,0.955,15.435,245,148,109,39,97,45,52,59,0.0,0.0
1011,390,24-09-2019 00:38:00,0,3373.0,3225.0,0.956,16.861,108,71,40,31,37,8,29,58,0.0,0.02
1011,391,24-09-2019 00:40:00,0,3378.0,3270.0,0.968,16.929,206,114,87,27,92,68,24,66,0.08,0.0
1011,392,24-09-2019 00:42:00,0,3284.0,3130.0,0.953,16.404,227,142,89,53,85,58,27,31,0.0,0.0
1011,393,24-09-2019 00:44:00,0,3388.0,3159.0,0.933,16.845,168,105,74,31,63,50,13,43,0.0,0.05
1011,394,24-09-2019 00:46:00,0,2228.0,2225.0,0.998,11.242,294,164,129,35,130,88,42,50,0.0,0.0
1011,395,24-09-2019 00:48:00,0,3351.0,3316.0,0.989,16.874,178,92,62,30,86,57,29,17,0.11,0.0
1011,396,24-09-2019 00:50:00,0,3640.0,3568.0,0.98,18.292,116,58,29,29,58,33,25,11,0.0,0.0
1011,397,24-09-2019 00:52:00,0,3185.0,3040.0,0.954,15.916,163,127,80,47,36,28,8,9,0.0,0.1
1011,398,24-09-2019 00:54:00,0,3205.0,2987.0,0.932,15.934,283,200,164,36,83,60,23,47,0.0,0.0
1011,399,24-09-2019 00:56:00,0,3384.0,3226.0,0.953,16.904,370,191,147,44,179,142,37,91,0.0,0.0
1011,400,24-09-2019 00:58:00,0,3089.0,2981.0,0.965,15.471,320,183,147,36,137,110,27,215,0.0,0.0
1011,401,24-09-2019 01:00:00,0,3097.5,2947.5,0.9515,15.4675,556,364,293,71,192,152,40,227,0.0,0.0
1011,402,24-09-2019 01:02:00,0,3106.0,2914.0,0.938,15.464,297,156,115,41,141,113,28,67,0.0,0.0
1011,403,24-09-2019 01:04:00,0,3371.0,3241.0,0.961,16.869,227,148,110,38,79,56,23,43,0.0,0.0
1011,404,24-09-2019 01:06:00,0,2898.0,2768.0,0.955,14.482,312,195,149,46,117,81,36,42,0.0,0.0
1011,405,24-09-2019 01:08:00,0,2893.0,2847.0,0.984,14.552,110,61,39,22,49,21,28,1,0.0,0.0
1011,406,24-09-2019 01:10:00,0,3111.0,2889.0,0.928,15.456,98,58,27,31,40,19,21,0,0.0,0.0
1011,407,24-09-2019 01:12:00,0,3014.0,2835.0,0.94,15.015,46,26,9,17,20,9,11,0,0.0,0.0
1011,408,24-09-2019 01:14:00,0,2892.0,2856.0,0.988,14.558,341,202,162,40,139,97,42,33,0.0,0.0
1011,409,24-09-2019 01:16:00,0,3205.0,2916.0,0.91,15.857,89,61,32,29,28,6,22,62,0.0,0.0
1011,410,24-09-2019 01:18:00,0,3190.0,3058.0,0.959,15.954,322,221,172,49,101,72,29,29,0.0,0.0
1011,411,24-09-2019 01:20:00,0,2744.0,2495.0,0.909,13.574,127,74,41,33,53,13,40,84,0.0,0.0
1011,412,24-09-2019 01:22:00,0,3235.0,2899.0,0.896,15.956,75,55,18,37,20,2,18,59,0.0,0.0
1011,413,24-09-2019 01:24:00,0,3013.0,2845.0,0.944,15.022,114,36,14,22,78,39,39,0,0.0,0.0
1011,414,24-09-2019 01:26:00,0,2912.0,2712.0,0.931,14.474,60,21,9,12,39,9,30,0,0.0,0.0
1011,415,24-09-2019 01:28:00,0,2732.0,2582.0,0.945,13.625,1,0,0,0,1,0,1,0,0.0,0.0
1011,416,24-09-2019 01:30:00,0,2548.0,2329.0,0.914,12.616,2,1,1,0,1,1,0,0,0.0,0.0
1011,417,24-09-2019 01:32:00,0,2567.0,2296.0,0.895,12.655,0,0,0,0,0,0,0,0,0.0,0.0
1011,418,24-09-2019 01:34:00,0,2374.5,2145.5,0.9045,11.7315,2,2,1,1,0,0,0,0,0.0,0.0
1011,419,24-09-2019 01:36:00,0,2182.0,1995.0,0.914,10.808,20,10,1,9,10,6,4,0,0.0,0.0
1011,420,24-09-2019 01:38:00,0,2081.0,1850.0,0.889,10.247,3,3,0,3,0,0,0,0,0.0,0.0
1011,421,24-09-2019 01:40:00,0,2100.0,1838.0,0.875,10.31,7,5,0,5,2,1,1,0,0.0,0.0
1011,422,24-09-2019 01:42:00,0,2090.0,1856.0,0.888,10.288,0,0,0,0,0,0,0,0,0.0,0.0
1011,423,24-09-2019 01:44:00,0,2093.0,1857.0,0.887,10.303,5,2,0,2,3,1,2,0,0.0,0.0
1011,424,24-09-2019 01:46:00,0,2086.0,1879.0,0.901,10.299,0,0,0,0,0,0,0,0,0.0,0.0
1011,425,24-09-2019 01:48:00,0,2057.0,1983.0,0.964,10.301,6,3,1,2,3,1,2,0,0.0,0.0
1011,426,24-09-2019 01:50:00,0,2061.0,1962.0,0.952,10.294,11,4,2,2,7,2,5,0,0.0,0.0
1011,427,24-09-2019 01:52:00,0,2061.0,1975.0,0.958,10.308,1,1,0,1,0,0,0,0,0.0,0.0
1011,428,24-09-2019 01:54:00,0,2071.0,1954.0,0.943,10.323,7,4,0,4,3,1,2,0,0.0,0.0
1011,429,24-09-2019 01:56:00,0,2072.0,1910.0,0.922,10.279,1,1,0,1,0,0,0,0,0.0,0.0
1011,430,24-09-2019 01:58:00,0,1994.0,1811.0,0.908,9.861,10,5,0,5,5,2,3,0,0.0,0.0
1011,431,24-09-2019 02:00:00,0,1767.0,1744.0,0.987,8.891,4,1,1,0,3,2,1,0,0.0,0.0
1011,432,24-09-2019 02:02:00,0,2099.0,1818.0,0.866,10.281,5,5,0,5,0,0,0,0,0.0,0.0
1011,433,24-09-2019 02:04:00,0,1981.0,1814.0,0.916,9.812,39,20,9,11,19,9,10,0,0.0,0.0
1011,434,24-09-2019 02:06:00,0,1882.0,1765.0,0.938,9.368,0,0,0,0,0,0,0,0,0.0,0.0
1011,435,24-09-2019 02:08:00,0,1832.5,1740.5,0.9505,9.146,0,0,0,0,0,0,0,0,0.0,0.0
1011,436,24-09-2019 02:10:00,0,1783.0,1716.0,0.963,8.924,5,3,0,3,2,1,1,0,0.0,0.0
1011,437,24-09-2019 02:12:00,0,1877.0,1750.0,0.932,9.335,9,9,2,7,0,0,0,0,0.0,0.0
1011,438,24-09-2019 02:14:00,0,2111.0,1815.0,0.86,10.328,10,10,1,9,0,0,0,0,0.0,0.0
1011,439,24-09-2019 02:16:00,0,2083.0,1903.0,0.914,10.312,0,0,0,0,0,0,0,0,0.0,0.0
1011,440,24-09-2019 02:18:00,0,2285.0,2034.0,0.89,11.254,41,25,12,13,16,8,8,0,0.0,0.0
1011,441,24-09-2019 02:20:00,0,2172.0,1979.0,0.911,10.747,1,0,0,0,1,0,1,0,0.0,0.0
1011,442,24-09-2019 02:22:00,0,2070.0,1964.0,0.949,10.328,0,0,0,0,0,0,0,0,0.0,0.0
1011,443,24-09-2019 02:24:00,0,2278.0,2049.0,0.9,11.243,0,0,0,0,0,0,0,0,0.0,0.0
1011,444,24-09-2019 02:26:00,0,2073.0,1910.0,0.921,10.284,1,1,0,1,0,0,0,0,0.0,0.0
1011,445,24-09-2019 02:28:00,0,2084.0,1912.0,0.918,10.327,12,10,1,9,2,1,1,0,0.0,0.0
1011,446,24-09-2019 02:30:00,0,2102.0,1816.0,0.864,10.293,9,9,1,8,0,0,0,0,0.0,0.0
1011,447,24-09-2019 02:32:00,0,1902.0,1706.0,0.897,9.385,8,8,1,7,0,0,0,0,0.0,0.0
1011,448,24-09-2019 02:34:00,0,1800.0,1648.0,0.915,8.916,3,3,1,2,0,0,0,0,0.0,0.0
1011,449,24-09-2019 02:36:00,0,1801.0,1637.0,0.909,8.907,11,8,3,5,3,0,3,0,0.0,0.0
1011,450,24-09-2019 02:38:00,0,1802.0,1636.0,0.908,8.911,3,3,2,1,0,0,0,0,0.0,0.0
1011,451,24-09-2019 02:40:00,0,1802.0,1661.0,0.922,8.936,0,0,0,0,0,0,0,0,0.0,0.0
1011,452,24-09-2019 02:42:00,0,1899.5,1707.0,0.9,9.372,5,2,1,1,3,1,2,0,0.0,0.0
1011,453,24-09-2019 02:44:00,0,1997.0,1753.0,0.878,9.808,37,21,17,4,16,9,7,0,0.0,0.0
1011,454,24-09-2019 02:46:00,0,2094.0,1859.0,0.888,10.308,2,2,1,1,0,0,0,0,0.0,0.0
1011,455,24-09-2019 02:48:00,0,2192.0,1929.0,0.88,10.773,0,0,0,0,0,0,0,0,0.0,0.0
1011,456,24-09-2019 02:50:00,0,2302.0,1962.0,0.852,11.242,0,0,0,0,0,0,0,0,0.0,0.0
1011,457,24-09-2019 02:52:00,0,2090.0,1860.0,0.89,10.295,11,8,4,4,3,1,2,0,0.0,0.0
1011,458,24-09-2019 02:54:00,0,2103.0,1839.0,0.874,10.324,13,10,1,9,3,1,2,0,0.0,0.0
1011,459,24-09-2019 02:56:00,0,2087.0,1850.0,0.886,10.269,7,7,1,6,0,0,0,0,0.0,0.0
1011,460,24-09-2019 02:58:00,0,2094.0,1872.0,0.894,10.324,10,9,1,8,1,0,1,0,0.0,0.0
1011,461,24-09-2019 03:00:00,0,2308.0,1946.0,0.843,11.249,1,0,0,0,1,0,1,0,0.0,0.0
1011,462,24-09-2019 03:02:00,0,2292.0,2007.0,0.875,11.252,10,10,1,9,0,0,0,0,0.0,0.0
1011,463,24-09-2019 03:04:00,0,2291.0,1994.0,0.87,11.235,18,11,1,10,7,2,5,0,0.0,0.0
1011,464,24-09-2019 03:06:00,0,2202.0,1908.0,0.867,10.786,32,0,0,0,32,21,11,0,0.0,0.0
1011,465,24-09-2019 03:08:00,0,2097.0,1849.0,0.882,10.309,16,0,0,0,16,2,14,0,0.0,0.0
1011,466,24-09-2019 03:10:00,0,2199.0,1900.0,0.864,10.766,95,2,1,1,93,78,15,0,0.0,0.0
1011,467,24-09-2019 03:12:00,0,2196.0,1903.0,0.867,10.76,103,1,0,1,102,82,20,0,0.0,0.0
1011,468,24-09-2019 03:14:00,0,2095.0,1855.0,0.886,10.306,4,1,0,1,3,0,3,0,0.0,0.0
1011,469,24-09-2019 03:16:00,0,2201.5,1908.5,0.868,10.787,58,23,15,8,35,12,23,0,0.0,0.0
1011,470,24-09-2019 03:18:00,0,2308.0,1962.0,0.85,11.268,283,188,147,41,95,64,31,68,0.0,0.0
1011,471,24-09-2019 03:20:00,0,2251.0,2122.0,0.943,11.219,456,295,237,58,161,123,38,73,0.0,0.0
1011,472,24-09-2019 03:22:00,0,2574.0,2268.0,0.881,12.651,221,137,101,36,84,52,32,74,0.0,0.0
1011,473,24-09-2019 03:24:00,0,2563.0,2317.0,0.904,12.664,67,56,28,28,11,2,9,15,0.0,0.0
1011,474,24-09-2019 03:26:00,0,2759.0,2446.0,0.886,13.579,294,190,162,28,104,76,28,80,0.0,0.0
1011,475,24-09-2019 03:28:00,0,2734.0,2536.0,0.928,13.578,216,127,90,37,89,57,32,45,0.0,0.0
1011,476,24-09-2019 03:30:00,0,2727.0,2551.0,0.935,13.57,36,28,9,19,8,2,6,2,0.0,0.0
1011,477,24-09-2019 03:32:00,0,2719.0,2582.0,0.949,13.572,216,131,93,38,85,63,22,90,0.0,0.0
1011,478,24-09-2019 03:34:00,0,2737.0,2522.0,0.921,13.577,258,162,119,43,96,63,33,63,0.0,0.0
1011,479,24-09-2019 03:36:00,0,2760.0,2487.0,0.901,13.628,308,190,152,38,118,97,21,141,0.0,0.0
1011,480,24-09-2019 03:38:00,0,2844.0,2579.0,0.907,14.061,388,221,172,49,167,125,42,95,0.0,0.0
1011,481,24-09-2019 03:40:00,0,2756.0,2476.0,0.898,13.599,202,124,94,30,78,54,24,47,0.0,0.0
1011,482,24-09-2019 03:42:00,0,2845.0,2544.0,0.894,14.025,120,80,40,40,40,26,14,7,0.0,0.0
1011,483,24-09-2019 03:44:00,0,2751.0,2444.0,0.888,13.543,174,110,74,36,64,38,26,35,0.0,0.0
1011,484,24-09-2019 03:46:00,0,2972.0,2548.0,0.857,14.531,100,70,38,32,30,6,24,63,0.0,0.0
1011,485,24-09-2019 03:48:00,0,2940.0,2622.0,0.892,14.488,220,130,95,35,90,58,32,50,0.0,0.0
1011,486,24-09-2019 03:50:00,0,2952.5,2586.0,0.876,14.497,90,74,40,34,16,6,10,44,0.0,0.0
1011,487,24-09-2019 03:52:00,0,2965.0,2550.0,0.86,14.506,146,120,74,46,26,4,22,51,0.0,0.0
1011,488,24-09-2019 03:54:00,0,2959.0,2637.0,0.891,14.578,129,92,64,28,37,22,15,54,0.0,0.0
1011,489,24-09-2019 03:56:00,0,2781.0,2379.0,0.855,13.592,93,72,34,38,21,4,17,51,0.0,0.0
1011,490,24-09-2019 03:58:00,0,2793.0,2327.0,0.833,13.58,98,66,32,34,32,12,20,45,0.0,0.0
1011,491,24-09-2019 04:00:00,0,3072.0,2605.0,0.848,14.987,417,247,204,43,170,129,41,128,0.0,0.0
1011,492,24-09-2019 04:02:00,0,2679.0,2286.0,0.853,13.084,230,153,113,40,77,53,24,68,0.0,0.0
1011,493,24-09-2019 04:04:00,0,2967.0,2538.0,0.856,14.499,68,56,31,25,12,3,9,57,0.0,0.0
1011,494,24-09-2019 04:06:00,0,2856.0,2505.0,0.877,14.027,213,133,110,23,80,61,19,114,0.0,0.0
1011,495,24-09-2019 04:08:00,0,2767.0,2441.0,0.882,13.605,171,89,63,26,82,51,31,33,0.0,0.0
1011,496,24-09-2019 04:10:00,0,2308.0,1939.0,0.84,11.239,179,103,71,32,76,50,26,8,0.0,0.0
1011,497,24-09-2019 04:12:00,0,2761.0,2392.0,0.866,13.528,105,70,46,24,35,26,9,10,0.0,0.06
1011,498,24-09-2019 04:14:00,0,2771.0,2457.0,0.887,13.636,224,126,89,37,98,66,32,71,0.0,0.0
1011,499,24-09-2019 04:16:00,0,2971.0,2532.0,0.852,14.508,92,68,41,27,24,10,14,48,0.0,0.0
1011,500,24-09-2019 04:18:00,0,2578.0,2251.0,0.873,12.651,284,174,144,30,110,77,33,53,0.0,0.0
1011,501,24-09-2019 04:20:00,0,2793.0,2324.0,0.832,13.576,281,171,128,43,110,76,34,95,0.0,0.0
1011,502,24-09-2019 04:22:00,0,2693.0,2250.0,0.836,13.101,57,28,13,15,29,8,21,3,0.0,0.0
1011,503,24-09-2019 04:24:00,0,2693.0,2252.5,0.8365,13.1045,74,33,13,20,41,12,29,5,0.0,0.0
1011,504,24-09-2019 04:26:00,0,2693.0,2255.0,0.837,13.108,200,127,87,40,73,50,23,23,0.0,0.0
1011,505,24-09-2019 04:28:00,0,2595.0,2193.0,0.845,12.651,31,24,11,13,7,3,4,0,0.0,0.0
1011,506,24-09-2019 04:30:00,0,2618.0,2078.0,0.794,12.616,40,24,10,14,16,8,8,1,0.0,0.0
1011,507,24-09-2019 04:32:00,0,2679.0,2284.0,0.853,13.085,187,123,83,40,64,49,15,65,0.0,0.0
1011,508,24-09-2019 04:34:00,0,2803.0,2245.0,0.801,13.529,105,67,36,31,38,17,21,60,0.0,0.0
1011,509,24-09-2019 04:36:00,0,2781.0,2382.0,0.857,13.594,63,45,17,28,18,6,12,57,0.0,0.0
1011,510,24-09-2019 04:38:00,0,3007.0,2422.0,0.806,14.529,92,62,18,44,30,0,30,42,0.0,0.0
1011,511,24-09-2019 04:40:00,0,3186.0,2571.0,0.807,15.397,119,74,29,45,45,4,41,39,0.0,0.0
1011,512,24-09-2019 04:42:00,0,3280.0,2687.0,0.819,15.898,79,44,12,32,35,3,32,55,0.0,0.0
1011,513,24-09-2019 04:44:00,0,3091.0,2544.0,0.823,14.995,73,51,23,28,22,5,17,28,0.0,0.0
1011,514,24-09-2019 04:46:00,0,2989.0,2481.0,0.83,14.523,116,77,53,24,39,32,7,33,0.0,0.0
1011,515,24-09-2019 04:48:00,0,2301.0,1937.0,0.842,11.212,123,93,61,32,30,10,20,46,0.0,0.0
1011,516,24-09-2019 04:50:00,0,2887.0,2393.0,0.829,14.025,78,56,16,40,22,10,12,52,0.0,0.0
1011,517,24-09-2019 04:52:00,0,3070.0,2602.0,0.848,14.977,113,70,26,44,43,17,26,60,0.0,0.0
1011,518,24-09-2019 04:54:00,0,3072.0,2574.0,0.838,14.952,121,79,38,41,42,8,34,54,0.0,0.0
1011,519,24-09-2019 04:56:00,0,3277.0,2727.0,0.832,15.929,115,82,34,48,33,3,30,49,0.0,0.03
1011,520,24-09-2019 04:58:00,0,3167.0,2683.5,0.848,15.4485,222,138,107,31,84,49,35,73,0.0,0.0
1011,521,24-09-2019 05:00:00,0,3057.0,2640.0,0.864,14.968,239,152,103,49,87,64,23,88,0.0,0.0
1011,522,24-09-2019 05:02:00,0,3458.0,2922.0,0.845,16.858,208,127,76,51,81,43,38,58,0.0,0.0
1011,523,24-09-2019 05:04:00,0,3432.0,3014.0,0.878,16.86,123,80,56,24,43,26,17,9,0.04,0.15
1011,524,24-09-2019 05:06:00,0,2766.0,2368.0,0.856,13.521,216,125,93,32,91,67,24,58,0.08,0.04
1011,525,24-09-2019 05:08:00,0,3271.0,2736.0,0.836,15.918,135,90,55,35,45,14,31,68,0.01,0.0
1011,526,24-09-2019 05:10:00,0,3436.0,2994.0,0.871,16.853,130,99,55,44,31,7,24,67,0.01,0.0
1011,527,24-09-2019 05:12:00,0,3416.0,3061.0,0.896,16.849,155,104,68,36,51,26,25,55,0.0,0.0
1011,528,24-09-2019 05:14:00,0,3434.0,3013.0,0.877,16.867,108,79,49,30,29,14,15,33,0.08,0.0
1011,529,24-09-2019 05:16:00,0,3228.0,2903.0,0.899,15.933,131,91,53,38,40,19,21,34,0.01,0.0
1011,530,24-09-2019 05:18:00,0,2272.0,2082.0,0.916,11.256,115,86,53,33,29,22,7,35,0.08,0.0
1011,531,24-09-2019 05:20:00,0,2668.0,2371.0,0.888,13.138,151,96,55,41,55,27,28,42,0.0,0.0
1011,532,24-09-2019 05:22:00,0,3390.0,3127.0,0.922,16.818,101,71,46,25,30,6,24,40,0.0,0.0
1011,533,24-09-2019 05:24:00,0,3571.0,3399.0,0.952,17.833,363,230,183,47,133,99,34,81,0.05,0.0
1011,534,24-09-2019 05:26:00,0,3199.0,2981.0,0.932,15.906,522,289,229,60,233,178,55,175,0.01,0.02
1011,535,24-09-2019 05:28:00,0,3215.0,2967.0,0.923,15.953,362,226,183,43,136,107,29,78,0.06,0.0
1011,536,24-09-2019 05:30:00,0,3852.0,3624.0,0.941,19.188,330,220,165,55,110,79,31,40,0.0,0.0
1011,537,24-09-2019 05:32:00,0,3549.0,3214.0,0.9025,17.54,418,266,221,45,152,112,40,104,0.03,0.0
1011,538,24-09-2019 05:34:00,0,3246.0,2804.0,0.864,15.892,130,84,42,42,46,14,32,64,0.01,0.0
1011,539,24-09-2019 05:36:00,0,3696.0,3371.0,0.912,18.292,152,118,77,41,34,17,17,52,0.0,0.01
1011,540,24-09-2019 05:38:00,0,3206.0,2964.0,0.924,15.914,23,11,1,10,12,5,7,8,0.0,0.0
1011,541,24-09-2019 05:40:00,0,3405.0,3088.0,0.907,16.833,218,120,96,24,98,71,27,89,0.0,0.02
1011,542,24-09-2019 05:42:00,0,3195.0,2997.0,0.938,15.904,319,176,132,44,143,102,41,61,0.06,0.01
1011,543,24-09-2019 05:44:00,0,2540.0,2386.0,0.939,12.649,243,168,113,55,75,53,22,64,0.01,0.0
1011,544,24-09-2019 05:46:00,0,3414.0,3071.0,0.899,16.852,122,84,54,30,38,18,20,57,0.01,0.0
1011,545,24-09-2019 05:48:00,0,3396.0,3164.0,0.931,16.884,129,80,46,34,49,24,25,33,0.0,0.01
1011,546,24-09-2019 05:50:00,0,3411.0,3130.0,0.918,16.906,106,18,6,12,88,58,30,5,0.0,0.0
1011,547,24-09-2019 05:52:00,0,3375.0,3181.0,0.943,16.818,318,203,157,46,115,86,29,127,0.03,0.04
1011,548,24-09-2019 05:54:00,0,3186.0,3027.0,0.95,15.905,310,171,133,38,139,103,36,71,0.07,0.0
1011,549,24-09-2019 05:56:00,0,3231.0,2883.0,0.892,15.923,43,31,9,22,12,6,6,2,0.0,0.0
1011,550,24-09-2019 05:58:00,0,3182.0,3066.0,0.964,15.929,68,44,25,19,24,14,10,5,0.0,0.0
1011,551,24-09-2019 06:00:00,1,3204.0,2977.0,0.929,15.919,180,125,86,39,55,28,27,38,0.0,0.0
1011,552,24-09-2019 06:02:00,1,3194.0,3033.0,0.95,15.942,296,200,151,49,96,68,28,27,0.0,0.03
1011,553,24-09-2019 06:04:00,1,3213.0,2940.0,0.915,15.916,297,199,145,54,98,74,24,78,0.0,0.01
1011,554,24-09-2019 06:06:00,1,3069.0,2831.5,0.923,15.228,80,57,40,17,23,18,5,115,0.0,0.0
1011,555,24-09-2019 06:08:00,1,2925.0,2723.0,0.931,14.54,248,193,146,47,55,32,23,9,0.0,0.0
1011,556,24-09-2019 06:10:00,1,2822.0,2612.0,0.926,14.012,381,227,182,45,154,110,44,20,0.0,0.05
1011,557,24-09-2019 06:12:00,1,2539.0,2380.0,0.938,12.637,172,81,57,24,91,63,28,7,0.0,0.0
1011,558,24-09-2019 06:14:00,1,2781.0,2359.0,0.848,13.569,89,31,11,20,58,39,19,0,0.0,0.0
1011,559,24-09-2019 06:16:00,1,2741.0,2514.0,0.917,13.583,428,300,240,60,128,91,37,0,0.04,0.0
1011,560,24-09-2019 06:18:00,1,2541.0,2370.0,0.933,12.635,189,100,70,30,89,65,24,54,0.0,0.0
1011,561,24-09-2019 06:20:00,1,2741.0,2516.0,0.918,13.583,272,161,133,28,111,81,30,6,0.0,0.0
1011,562,24-09-2019 06:22:00,1,2739.0,2532.0,0.924,13.593,272,102,61,41,170,123,47,0,0.0,0.0
1011,563,24-09-2019 06:24:00,1,2938.0,2618.0,0.891,14.472,104,4,0,4,100,59,41,0,0.0,0.0
1011,564,24-09-2019 06:26:00,1,2768.0,2408.0,0.87,13.571,125,19,5,14,106,57,49,0,0.0,0.0
1011,565,24-09-2019 06:28:00,1,2768.0,2394.0,0.865,13.555,5,0,0,0,5,0,5,0,0.0,0.0
1011,566,24-09-2019 06:30:00,1,2269.0,2061.0,0.908,11.221,0,0,0,0,0,0,0,0,0.0,0.0
1011,567,24-09-2019 06:32:00,1,2316.0,1891.0,0.817,11.218,3,0,0,0,3,1,2,0,0.0,0.0
1011,568,24-09-2019 06:34:00,1,2120.0,1786.0,0.842,10.33,84,27,16,11,57,31,26,16,0.0,0.0
1011,569,24-09-2019 06:36:00,1,2481.0,2185.0,0.881,12.193,174,114,88,26,60,47,13,104,0.0,0.0
1011,570,24-09-2019 06:38:00,1,2569.0,2280.0,0.888,12.644,375,256,215,41,119,92,27,120,0.0,0.0
1011,571,24-09-2019 06:40:00,1,2657.0,2367.5,0.891,13.0895,268,127,94,33,141,106,35,73,0.0,0.0
1011,572,24-09-2019 06:42:00,1,2745.0,2455.0,0.894,13.535,66,32,7,25,34,21,13,0,0.0,0.0
1011,573,24-09-2019 06:44:00,1,2870.0,2480.0,0.864,14.054,62,26,5,21,36,18,18,0,0.0,0.0
1011,574,24-09-2019 06:46:00,1,2771.0,2378.0,0.858,13.552,18,6,4,2,12,2,10,0,0.0,0.0
1011,575,24-09-2019 06:48:00,1,2616.0,2147.0,0.821,12.683,0,0,0,0,0,0,0,0,0.0,0.0
1011,576,24-09-2019 06:50:00,1,2279.0,1973.0,0.866,11.163,12,2,1,1,10,5,5,0,0.0,0.0
1011,577,24-09-2019 06:52:00,1,2323.0,1909.0,0.822,11.268,5,1,1,0,4,0,4,0,0.0,0.0
1011,578,24-09-2019 06:54:00,1,2216.0,1845.0,0.833,10.775,14,0,0,0,14,5,9,0,0.0,0.0
1011,579,24-09-2019 06:56:00,1,2112.0,1764.0,0.835,10.273,11,0,0,0,11,2,9,0,0.0,0.0
1011,580,24-09-2019 06:58:00,1,2131.0,1695.0,0.795,10.274,6,0,0,0,6,0,6,0,0.0,0.0
1011,581,24-09-2019 07:00:00,1,2039.0,1625.0,0.797,9.831,14,0,0,0,14,0,14,0,0.0,0.0
1011,582,24-09-2019 07:02:00,1,2040.0,1619.0,0.794,9.831,0,0,0,0,0,0,0,0,0.0,0.0
1011,583,24-09-2019 07:04:00,1,2142.0,1666.0,0.778,10.284,1,1,0,1,0,0,0,0,0.0,0.0
1011,584,24-09-2019 07:06:00,1,2123.0,1736.0,0.818,10.286,72,12,9,3,60,42,18,0,0.0,0.0
1011,585,24-09-2019 07:08:00,1,2327.0,1860.0,0.799,11.228,25,0,0,0,25,4,21,0,0.0,0.0
1011,586,24-09-2019 07:10:00,1,2520.0,2015.0,0.799,12.162,0,0,0,0,0,0,0,0,0.0,0.0
1011,587,24-09-2019 07:12:00,1,2314.0,1870.0,0.808,11.19,2,0,0,0,2,0,2,0,0.0,0.0
1011,588,24-09-2019 07:14:00,1,2334.5,1805.0,0.7735,11.199,0,0,0,0,0,0,0,0,0.0,0.0
1011,589,24-09-2019 07:16:00,1,2355.0,1740.0,0.739,11.208,6,1,0,1,5,0,5,0,0.0,0.0
1011,590,24-09-2019 07:18:00,1,2347.0,1774.0,0.756,11.213,78,16,8,8,62,29,33,0,0.0,0.0
1011,591,24-09-2019 07:20:00,1,2352.0,1768.0,0.752,11.227,13,2,1,1,11,0,11,0,0.0,0.0
1011,592,24-09-2019 07:22:00,1,2150.0,1640.0,0.763,10.287,14,3,1,2,11,2,9,0,0.0,0.0
1011,593,24-09-2019 07:24:00,1,2147.0,1666.0,0.776,10.303,18,5,0,5,13,3,10,0,0.0,0.0
1011,594,24-09-2019 07:26:00,1,2142.0,1659.0,0.775,10.276,38,0,0,0,38,6,32,0,0.0,0.0
1011,595,24-09-2019 07:28:00,1,2251.0,1708.0,0.759,10.759,19,2,0,2,17,8,9,0,0.0,0.0
1011,596,24-09-2019 07:30:00,1,2350.0,1791.0,0.762,11.242,24,10,2,8,14,1,13,0,0.0,0.0
1011,597,24-09-2019 07:32:00,1,2354.0,1741.0,0.74,11.203,7,4,1,3,3,2,1,0,0.0,0.0
1011,598,24-09-2019 07:34:00,1,2141.0,1690.0,0.789,10.307,2,0,0,0,2,0,2,0,0.0,0.0
1011,599,24-09-2019 07:36:00,1,2250.0,1695.0,0.753,10.743,5,0,0,0,5,0,5,0,0.0,0.0
1011,600,24-09-2019 07:38:00,1,2150.0,1636.0,0.761,10.283,18,2,0,2,16,9,7,0,0.0,0.0
1011,601,24-09-2019 07:40:00,1,2179.0,1527.0,0.701,10.277,2,0,0,0,2,0,2,0,0.0,0.0
1011,602,24-09-2019 07:42:00,1,1859.0,1418.0,0.763,8.894,8,1,0,1,7,0,7,0,0.0,0.0
1011,603,24-09-2019 07:44:00,1,1847.0,1446.0,0.783,8.877,184,48,23,25,136,91,45,8,0.0,0.0
1011,604,24-09-2019 07:46:00,1,2360.0,1714.0,0.726,11.195,216,155,109,46,61,42,19,35,0.0,0.0
1011,605,24-09-2019 07:48:00,1,2504.0,1848.0,0.7375,11.9115,144,97,66,31,47,30,17,53,0.0,0.0
1011,606,24-09-2019 07:50:00,1,2648.0,1982.0,0.749,12.628,53,26,14,12,27,18,9,58,0.0,0.0
1011,607,24-09-2019 07:52:00,1,2621.0,2086.0,0.796,12.637,236,142,89,53,94,55,39,39,0.0,0.0
1011,608,24-09-2019 07:54:00,1,2831.0,2167.0,0.765,13.555,68,24,13,11,44,20,24,0,0.0,0.0
1011,609,24-09-2019 07:56:00,1,2829.0,2207.0,0.78,13.592,131,38,10,28,93,58,35,0,0.0,0.0
1011,610,24-09-2019 07:58:00,1,2714.0,2175.0,0.801,13.102,161,60,29,31,101,71,30,0,0.0,0.0
1011,611,24-09-2019 08:00:00,1,2617.0,2101.0,0.803,12.636,67,38,9,29,29,4,25,0,0.0,0.0
1011,612,24-09-2019 08:02:00,1,2611.0,2128.0,0.815,12.643,152,61,35,26,91,46,45,2,0.0,0.0
1011,613,24-09-2019 08:04:00,1,2605.0,2121.0,0.814,12.613,87,23,9,14,64,38,26,0,0.0,0.0
1011,614,24-09-2019 08:06:00,1,2426.0,1919.0,0.791,11.683,3,0,0,0,3,0,3,0,0.0,0.0
1011,615,24-09-2019 08:08:00,1,2360.0,1746.0,0.74,11.234,2,1,0,1,1,0,1,0,0.0,0.0
1011,616,24-09-2019 08:10:00,1,2158.0,1612.0,0.747,10.287,0,0,0,0,0,0,0,0,0.0,0.0
1011,617,24-09-2019 08:12:00,1,1958.0,1509.0,0.771,9.386,54,6,0,6,48,24,24,0,0.0,0.0
1011,618,24-09-2019 08:14:00,1,1845.0,1461.0,0.792,8.887,8,0,0,0,8,1,7,0,0.0,0.0
1011,619,24-09-2019 08:16:00,1,1861.0,1396.0,0.75,8.876,9,0,0,0,9,0,9,0,0.0,0.0
1011,620,24-09-2019 08:18:00,1,1868.0,1391.0,0.745,8.901,22,0,0,0,22,0,22,0,0.0,0.0
1011,621,24-09-2019 08:20:00,1,1841.0,1464.0,0.795,8.874,38,0,0,0,38,0,38,0,0.0,0.0
1011,622,24-09-2019 08:22:00,1,1955.5,1483.0,0.7605,9.3455,26,1,0,1,25,7,18,0,0.0,0.0
1011,623,24-09-2019 08:24:00,1,2070.0,1502.0,0.726,9.817,20,1,0,1,19,4,15,0,0.0,0.0
1011,624,24-09-2019 08:26:00,1,2062.0,1512.0,0.733,9.799,36,0,0,0,36,5,31,0,0.0,0.0
1011,625,24-09-2019 08:28:00,1,2069.0,1513.0,0.731,9.828,24,0,0,0,24,0,24,0,0.0,0.0
1011,626,24-09-2019 08:30:00,1,1846.0,1465.0,0.794,8.893,12,1,1,0,11,5,6,0,0.0,0.0
1011,627,24-09-2019 08:32:00,1,1859.0,1433.0,0.771,8.911,0,0,0,0,0,0,0,0,0.0,0.0
1011,628,24-09-2019 08:34:00,1,1857.0,1397.0,0.753,8.862,30,0,0,0,30,3,27,0,0.0,0.0
1011,629,24-09-2019 08:36:00,1,1950.0,1471.0,0.754,9.313,17,2,1,1,15,2,13,0,0.0,0.0
1011,630,24-09-2019 08:38:00,1,2175.0,1551.0,0.713,10.289,20,3,0,3,17,12,5,0,0.0,0.0
1011,631,24-09-2019 08:40:00,1,2153.0,1610.0,0.748,10.268,16,0,0,0,16,11,5,0,0.0,0.0
1011,632,24-09-2019 08:42:00,1,2162.0,1610.0,0.745,10.303,18,4,1,3,14,5,9,0,0.0,0.0
1011,633,24-09-2019 08:44:00,1,2169.0,1580.0,0.728,10.297,17,5,1,4,12,6,6,0,0.0,0.0
1011,634,24-09-2019 08:46:00,1,2187.0,1499.0,0.685,10.279,40,5,4,1,35,4,31,0,0.0,0.0
1011,635,24-09-2019 08:48:00,1,2190.0,1504.0,0.687,10.295,0,0,0,0,0,0,0,0,0.0,0.0
1011,636,24-09-2019 08:50:00,1,2179.0,1502.0,0.689,10.25,2,0,0,0,2,1,1,0,0.0,0.0
1011,637,24-09-2019 08:52:00,1,2192.0,1492.0,0.681,10.288,0,0,0,0,0,0,0,0,0.0,0.0
1011,638,24-09-2019 08:54:00,1,1846.0,1409.0,0.763,8.835,25,18,10,8,7,2,5,0,0.0,0.0
1011,639,24-09-2019 08:56:00,1,1909.0,1427.5,0.748,9.103,0,0,0,0,0,0,0,0,0.0,0.0
1011,640,24-09-2019 08:58:00,1,1972.0,1446.0,0.733,9.371,47,16,6,10,31,15,16,0,0.0,0.0
1011,641,24-09-2019 09:00:00,1,2142.0,1670.0,0.78,10.288,73,18,11,7,55,25,30,6,0.0,0.0
1011,642,24-09-2019 09:02:00,1,2141.0,1686.0,0.787,10.303,158,115,83,32,43,27,16,70,0.0,0.0
1011,643,24-09-2019 09:04:00,1,2347.0,1793.0,0.764,11.234,229,151,115,36,78,54,24,72,0.0,0.0
1011,644,24-09-2019 09:06:00,1,2545.0,1924.0,0.756,12.159,56,41,20,21,15,5,10,6,0.0,0.0
1011,645,24-09-2019 09:08:00,1,2635.0,1979.0,0.751,12.574,200,85,64,21,115,85,30,19,0.01,0.0
1011,646,24-09-2019 09:10:00,1,2661.0,1956.0,0.735,12.65,46,20,3,17,26,12,14,0,0.0,0.0
1011,647,24-09-2019 09:12:00,1,2643.0,1954.0,0.739,12.576,55,17,3,14,38,19,19,0,0.0,0.0
1011,648,24-09-2019 09:14:00,1,2651.0,1974.0,0.744,12.632,29,10,2,8,19,1,18,0,0.0,0.0
1011,649,24-09-2019 09:16:00,1,2444.0,1895.0,0.775,11.729,90,49,25,24,41,9,32,0,0.0,0.0
1011,650,24-09-2019 09:18:00,1,2330.0,1838.0,0.789,11.214,329,181,139,42,148,115,33,25,0.0,0.0
1011,651,24-09-2019 09:20:00,1,2345.0,1782.0,0.76,11.212,99,86,63,23,13,10,3,0,0.0,0.0
1011,652,24-09-2019 09:22:00,1,2345.0,1794.0,0.765,11.225,209,149,116,33,60,37,23,12,0.0,0.0
1011,653,24-09-2019 09:24:00,1,2252.0,1712.0,0.76,10.77,83,39,6,33,44,22,22,0,0.0,0.0
1011,654,24-09-2019 09:26:00,1,2343.0,1792.0,0.765,11.215,19,16,7,9,3,0,3,0,0.0,0.0
1011,655,24-09-2019 09:28:00,1,2370.0,1714.0,0.723,11.235,0,0,0,0,0,0,0,0,0.0,0.0
1011,656,24-09-2019 09:30:00,1,2106.0,1595.5,0.7625,10.064,0,0,0,0,0,0,0,0,0.0,0.0
1011,657,24-09-2019 09:32:00,1,1842.0,1477.0,0.802,8.893,39,10,6,4,29,21,8,0,0.0,0.0
1011,658,24-09-2019 09:34:00,1,1849.0,1439.0,0.778,8.877,0,0,0,0,0,0,0,0,0.0,0.0
1011,659,24-09-2019 09:36:00,1,1838.0,1481.0,0.806,8.881,15,0,0,0,15,4,11,0,0.0,0.0
1011,660,24-09-2019 09:38:00,1,1868.0,1378.0,0.738,8.884,9,0,0,0,9,0,9,0,0.0,0.0
1011,661,24-09-2019 09:40:00,1,1768.0,1304.0,0.738,8.41,8,3,1,2,5,0,5,0,0.0,0.0
1011,662,24-09-2019 09:42:00,1,1861.0,1394.0,0.749,8.877,0,0,0,0,0,0,0,0,0.0,0.0
1011,663,24-09-2019 09:44:00,1,1866.0,1383.0,0.741,8.883,3,1,0,1,2,2,0,0,0.0,0.0
1011,664,24-09-2019 09:46:00,1,1866.0,1399.0,0.75,8.9,0,0,0,0,0,0,0,0,0.0,0.0
1011,665,24-09-2019 09:48:00,1,1861.0,1366.0,0.734,8.844,1,1,0,1,0,0,0,0,0.0,0.0
1011,666,24-09-2019 09:50:00,1,1876.0,1337.0,0.713,8.873,2,0,0,0,2,0,2,0,0.0,0.0
1011,667,24-09-2019 09:52:00,1,1885.0,1322.0,0.701,8.89,50,3,1,2,47,9,38,0,0.0,0.0
1011,668,24-09-2019 09:54:00,1,1878.0,1345.0,0.716,8.889,28,0,0,0,28,18,10,0,0.0,0.0
1011,669,24-09-2019 09:56:00,1,1855.0,1429.0,0.771,8.89,46,0,0,0,46,20,26,0,0.0,0.0
1011,670,24-09-2019 09:58:00,1,1855.0,1422.0,0.766,8.883,55,9,1,8,46,7,39,0,0.0,0.0
1011,671,24-09-2019 10:00:00,1,1861.0,1394.0,0.749,8.878,2,0,0,0,2,1,1,0,0.0,0.0
1011,672,24-09-2019 10:02:00,1,1962.0,1459.0,0.744,9.345,0,0,0,0,0,0,0,0,0.0,0.0
1011,673,24-09-2019 10:04:00,1,2017.0,1480.5,0.7345,9.5855,0,0,0,0,0,0,0,0,0.0,0.0
1011,674,24-09-2019 10:06:00,1,2072.0,1502.0,0.725,9.826,0,0,0,0,0,0,0,0,0.0,0.0
1011,675,24-09-2019 10:08:00,1,1966.0,1448.0,0.737,9.347,19,0,0,0,19,6,13,0,0.0,0.0
1011,676,24-09-2019 10:10:00,1,2174.0,1535.0,0.706,10.263,8,0,0,0,8,4,4,0,0.0,0.0
1011,677,24-09-2019 10:12:00,1,2166.0,1592.0,0.735,10.297,31,3,1,2,28,7,21,0,0.0,0.0
1011,678,24-09-2019 10:14:00,1,2060.0,1494.0,0.725,9.772,6,2,0,2,4,3,1,0,0.0,0.0
1011,679,24-09-2019 10:16:00,1,2065.0,1506.0,0.73,9.804,0,0,0,0,0,0,0,0,0.0,0.0
1011,680,24-09-2019 10:18:00,1,1964.0,1456.0,0.742,9.349,26,6,0,6,20,11,9,0,0.0,0.0
1011,681,24-09-2019 10:20:00,1,1856.0,1420.0,0.765,8.884,2,0,0,0,2,1,1,0,0.0,0.0
1011,682,24-09-2019 10:22:00,1,2067.0,1498.0,0.725,9.804,4,0,0,0,4,1,3,0,0.0,0.0
1011,683,24-09-2019 10:24:00,1,2168.0,1562.0,0.721,10.272,10,0,0,0,10,0,10,0,0.01,0.0
1011,684,24-09-2019 10:26:00,1,2169.0,1575.0,0.726,10.29,31,0,0,0,31,0,31,0,0.0,0.0
1011,685,24-09-2019 10:28:00,1,2169.0,1556.0,0.717,10.27,19,3,0,3,16,9,7,0,0.0,0.0
1011,686,24-09-2019 10:30:00,1,2173.0,1560.0,0.718,10.289,40,3,2,1,37,17,20,0,0.0,0.0
1011,687,24-09-2019 10:32:00,1,2177.0,1539.0,0.707,10.281,15,2,1,1,13,6,7,0,0.0,0.0
1011,688,24-09-2019 10:34:00,1,1954.0,1495.0,0.765,9.356,6,3,0,3,3,0,3,0,0.0,0.0
1011,689,24-09-2019 10:36:00,1,2066.0,1509.0,0.73,9.812,27,9,7,2,18,10,8,0,0.0,0.0
1011,690,24-09-2019 10:38:00,1,1960.5,1458.5,0.7445,9.34,10,4,0,4,6,3,3,0,0.0,0.0
1011,691,24-09-2019 10:40:00,1,1855.0,1408.0,0.759,8.868,16,2,0,2,14,5,9,0,0.0,0.0
1011,692,24-09-2019 10:42:00,1,1878.0,1341.0,0.714,8.884,6,4,0,4,2,2,0,0,0.0,0.0
1011,693,24-09-2019 10:44:00,1,1879.0,1335.0,0.711,8.883,70,26,14,12,44,24,20,0,0.0,0.0
1011,694,24-09-2019 10:46:00,1,1662.0,1301.0,0.783,7.99,8,0,0,0,8,0,8,0,0.0,0.0
1011,695,24-09-2019 10:48:00,1,1664.0,1245.0,0.748,7.935,1,0,0,0,1,0,1,0,0.0,0.0
1011,696,24-09-2019 10:50:00,1,1877.0,1340.0,0.714,8.88,0,0,0,0,0,0,0,0,0.0,0.0
1011,697,24-09-2019 10:52:00,1,1774.0,1300.0,0.733,8.43,97,41,19,22,56,34,22,0,0.0,0.0
1011,698,24-09-2019 10:54:00,1,1944.0,1505.0,0.774,9.326,96,75,35,40,21,6,15,0,0.0,0.0
1011,699,24-09-2019 10:56:00,1,2149.0,1643.0,0.764,10.287,172,104,63,41,68,45,23,28,0.0,0.0
1011,700,24-09-2019 10:58:00,1,2339.0,1802.0,0.771,11.211,82,43,20,23,39,24,15,14,0.0,0.0
1011,701,24-09-2019 11:00:00,1,2317.0,1868.0,0.806,11.195,51,3,1,2,48,19,29,0,0.0,0.0
1011,702,24-09-2019 11:02:00,1,2434.0,1914.0,0.786,11.71,55,15,0,15,40,9,31,0,0.0,0.0
1011,703,24-09-2019 11:04:00,1,2316.0,1913.0,0.826,11.245,57,17,3,14,40,21,19,0,0.0,0.0
1011,704,24-09-2019 11:06:00,1,2329.0,1855.0,0.796,11.23,138,22,5,17,116,74,42,0,0.0,0.0
1011,705,24-09-2019 11:08:00,1,2321.0,1860.0,0.801,11.206,14,9,3,6,5,2,3,0,0.0,0.0
1011,706,24-09-2019 11:10:00,1,2246.0,1718.0,0.765,10.752,9,7,0,7,2,2,0,0,0.0,0.0
1011,707,24-09-2019 11:12:00,1,2044.5,1582.5,0.775,9.8085,3,3,0,3,0,0,0,0,0.0,0.0
1011,708,24-09-2019 11:14:00,1,1843.0,1447.0,0.785,8.865,5,5,0,5,0,0,0,0,0.0,0.0
1011,709,24-09-2019 11:16:00,1,1867.0,1392.0,0.745,8.897,5,5,0,5,0,0,0,0,0.0,0.0
1011,710,24-09-2019 11:18:00,1,1643.0,1334.0,0.812,7.949,10,3,1,2,7,3,4,0,0.0,0.0
1011,711,24-09-2019 11:20:00,1,1875.0,1360.0,0.725,8.894,2,0,0,0,2,0,2,0,0.0,0.0
1011,712,24-09-2019 11:22:00,1,1764.0,1318.0,0.747,8.411,2,0,0,0,2,0,2,0,0.0,0.0
1011,713,24-09-2019 11:24:00,1,1653.0,1277.0,0.773,7.928,0,0,0,0,0,0,0,0,0.0,0.0
1011,714,24-09-2019 11:26:00,1,1851.0,1454.0,0.785,8.904,5,0,0,0,5,2,3,0,0.0,0.0
1011,715,24-09-2019 11:28:00,1,2167.0,1570.0,0.724,10.278,1,0,0,0,1,0,1,0,0.0,0.0
1011,716,24-09-2019 11:30:00,1,2176.0,1547.0,0.711,10.284,0,0,0,0,0,0,0,0,0.0,0.0
1011,717,24-09-2019 11:32:00,1,1958.0,1482.0,0.757,9.355,0,0,0,0,0,0,0,0,0.0,0.0
1011,718,24-09-2019 11:34:00,1,1869.0,1375.0,0.736,8.886,3,1,0,1,2,0,2,0,0.0,0.0
1011,719,24-09-2019 11:36:00,1,1650.0,1302.0,0.789,7.944,5,0,0,0,5,2,3,0,0.0,0.0
1011,720,24-09-2019 11:38:00,1,1766.0,1296.0,0.734,8.394,11,0,0,0,11,0,11,0,0.0,0.0
1011,721,24-09-2019 11:40:00,1,1892.0,1316.0,0.695,8.911,20,9,1,8,11,0,11,0,0.0,0.0
1011,722,24-09-2019 11:42:00,1,1870.0,1348.0,0.721,8.861,26,5,0,5,21,4,17,0,0.0,0.0
1011,723,24-09-2019 11:44:00,1,1855.0,1428.0,0.77,8.89,2,1,0,1,1,0,1,0,0.0,0.0
1011,724,24-09-2019 11:46:00,1,1853.5,1433.0,0.7735,8.89,2,2,0,2,0,0,0,0,0.01,0.0
1011,725,24-09-2019 11:48:00,1,1852.0,1438.0,0.777,8.89,0,0,0,0,0,0,0,0,0.0,0.0
1011,726,24-09-2019 11:50:00,1,2072.0,1498.0,0.723,9.822,0,0,0,0,0,0,0,0,0.0,0.0
1011,727,24-09-2019 11:52:00,1,2054.0,1527.0,0.743,9.785,30,10,0,10,20,11,9,0,0.0,0.0
1011,728,24-09-2019 11:54:00,1,2167.0,1580.0,0.729,10.289,25,5,0,5,20,6,14,0,0.0,0.0
1011,729,24-09-2019 11:56:00,1,2159.0,1605.0,0.743,10.285,0,0,0,0,0,0,0,0,0.0,0.0
1011,730,24-09-2019 11:58:00,1,2149.0,1648.0,0.767,10.291,16,0,0,0,16,6,10,0,0.0,0.0
1011,731,24-09-2019 12:00:00,1,2162.0,1597.0,0.739,10.289,32,0,0,0,32,7,25,0,0.0,0.0
1011,732,24-09-2019 12:02:00,1,2070.0,1530.0,0.739,9.85,17,0,0,0,17,6,11,0,0.0,0.0
1011,733,24-09-2019 12:04:00,1,2173.0,1555.0,0.716,10.286,21,0,0,0,21,2,19,0,0.0,0.0
1011,734,24-09-2019 12:06:00,1,2059.0,1508.0,0.732,9.782,22,1,1,0,21,6,15,0,0.0,0.0
1011,735,24-09-2019 12:08:00,1,1849.0,1447.0,0.783,8.886,0,0,0,0,0,0,0,0,0.0,0.0
1011,736,24-09-2019 12:10:00,1,1879.0,1348.0,0.718,8.894,63,16,5,11,47,24,23,0,0.01,0.0
1011,737,24-09-2019 12:12:00,1,1847.0,1455.0,0.788,8.887,24,4,1,3,20,4,16,0,0.0,0.0
1011,738,24-09-2019 12:14:00,1,2057.0,1546.0,0.752,9.816,18,2,0,2,16,3,13,0,0.0,0.0
1011,739,24-09-2019 12:16:00,1,1949.0,1499.0,0.769,9.339,32,3,2,1,29,4,25,0,0.0,0.0
1011,740,24-09-2019 12:18:00,1,1841.0,1480.0,0.804,8.892,6,3,1,2,3,0,3,0,0.0,0.0
1011,741,24-09-2019 12:20:00,1,1892.0,1497.0,0.7915,9.112,51,18,10,8,33,20,13,0,0.0,0.0
1011,742,24-09-2019 12:22:00,1,1943.0,1514.0,0.779,9.332,166,33,5,28,133,84,49,0,0.0,0.0
1011,743,24-09-2019 12:24:00,1,2148.0,1634.0,0.761,10.271,129,41,10,31,88,48,40,2,0.0,0.0
1011,744,24-09-2019 12:26:00,1,2343.0,1806.0,0.771,11.233,170,104,75,29,66,42,24,29,0.0,0.0
1011,745,24-09-2019 12:28:00,1,2238.0,1739.0,0.777,10.745,147,85,57,28,62,36,26,56,0.0,0.0
1011,746,24-09-2019 12:30:00,1,2343.0,1819.0,0.776,11.246,168,108,76,32,60,30,30,13,0.0,0.0
1011,747,24-09-2019 12:32:00,1,2323.0,1862.0,0.801,11.214,195,113,89,24,82,46,36,28,0.0,0.0
1011,748,24-09-2019 12:34:00,1,2342.0,1811.0,0.773,11.231,59,29,3,26,30,7,23,0,0.0,0.0
1011,749,24-09-2019 12:36:00,1,2248.0,1700.0,0.756,10.738,104,62,36,26,42,27,15,23,0.0,0.0
1011,750,24-09-2019 12:38:00,1,2428.0,1920.0,0.791,11.694,411,264,212,52,147,103,44,19,0.0,0.0
1011,751,24-09-2019 12:40:00,1,2327.0,1852.0,0.796,11.22,300,190,147,43,110,73,37,3,0.0,0.0
1011,752,24-09-2019 12:42:00,1,2326.0,1867.0,0.803,11.233,143,85,52,33,58,34,24,25,0.0,0.0
1011,753,24-09-2019 12:44:00,1,2438.0,1892.0,0.776,11.703,93,62,31,31,31,12,19,54,0.0,0.0
1011,754,24-09-2019 12:46:00,1,2634.0,2026.0,0.769,12.62,122,78,48,30,44,12,32,54,0.0,0.0
1011,755,24-09-2019 12:48:00,1,2802.0,2267.0,0.809,13.55,184,148,98,50,36,8,28,55,0.01,0.0
1011,756,24-09-2019 12:50:00,1,2827.0,2197.0,0.777,13.572,156,106,69,37,50,24,26,53,0.0,0.0
1011,757,24-09-2019 12:52:00,1,2802.0,2260.0,0.807,13.542,134,110,64,46,24,7,17,53,0.0,0.0
1011,758,24-09-2019 12:54:00,1,2900.0,2355.5,0.8125,14.0345,211,129,89,40,82,50,32,43,0.01,0.08
1011,759,24-09-2019 12:56:00,1,2998.0,2451.0,0.818,14.527,625,413,340,73,212,170,42,45,0.06,0.0
1011,760,24-09-2019 12:58:00,1,2808.0,2299.0,0.818,13.61,543,334,264,70,209,151,58,8,0.02,0.05
1011,761,24-09-2019 13:00:00,1,2571.0,2233.0,0.868,12.604,447,236,170,66,211,155,56,2,0.0,0.0
1011,762,24-09-2019 13:02:00,1,2102.0,1817.0,0.865,10.294,717,492,393,99,225,164,61,38,0.0,0.0
1011,763,24-09-2019 13:04:00,1,2206.0,1870.0,0.848,10.761,575,322,246,76,253,193,60,6,0.0,0.0
1011,764,24-09-2019 13:06:00,1,2786.0,2367.0,0.85,13.598,435,244,187,57,191,146,45,29,0.03,0.0
1011,765,24-09-2019 13:08:00,1,2767.0,2383.0,0.861,13.542,294,123,81,42,171,123,48,30,0.0,0.0
1011,766,24-09-2019 13:10:00,1,2679.0,2325.0,0.868,13.127,242,93,72,21,149,103,46,0,0.0,0.0
1011,767,24-09-2019 13:12:00,1,2491.0,2120.0,0.851,12.161,142,8,2,6,134,89,45,0,0.0,0.0
1011,768,24-09-2019 13:14:00,1,2372.0,2085.0,0.879,11.654,69,16,0,16,53,33,20,0,0.0,0.0
1011,769,24-09-2019 13:16:00,1,2498.0,2125.0,0.851,12.197,52,12,7,5,40,7,33,0,0.0,0.0
1011,770,24-09-2019 13:18:00,1,2580.0,2203.0,0.854,12.604,5,0,0,0,5,0,5,0,0.0,0.0
1011,771,24-09-2019 13:20:00,1,2271.0,2072.0,0.912,11.242,5,0,0,0,5,2,3,0,0.0,0.0
1011,772,24-09-2019 13:22:00,1,2297.0,1949.0,0.848,11.209,0,0,0,0,0,0,0,0,0.0,0.0
1011,773,24-09-2019 13:24:00,1,2101.0,1864.0,0.887,10.341,8,6,1,5,2,0,2,0,0.0,0.0
1011,774,24-09-2019 13:26:00,1,2206.0,1883.0,0.854,10.777,3,3,0,3,0,0,0,0,0.01,0.0
1011,775,24-09-2019 13:28:00,1,2204.0,1889.0,0.8575,10.775,9,7,0,7,2,0,2,0,0.0,0.0
1011,776,24-09-2019 13:30:00,1,2202.0,1895.0,0.861,10.773,11,4,0,4,7,5,2,0,0.0,0.0
1011,777,24-09-2019 13:32:00,1,2089.0,1860.0,0.89,10.29,0,0,0,0,0,0,0,0,0.0,0.0
1011,778,24-09-2019 13:34:00,1,2094.0,1841.0,0.879,10.288,1,0,0,0,1,1,0,0,0.01,0.0
1011,779,24-09-2019 13:36:00,1,2108.0,1798.0,0.853,10.298,26,6,2,4,20,15,5,0,0.0,0.0
1011,780,24-09-2019 13:38:00,1,2205.0,1884.0,0.855,10.773,0,0,0,0,0,0,0,0,0.0,0.0
1011,781,24-09-2019 13:40:00,1,2095.0,1842.0,0.879,10.293,42,6,3,3,36,5,31,0,0.0,0.0
1011,782,24-09-2019 13:42:00,1,2108.0,1795.0,0.852,10.292,7,0,0,0,7,0,7,0,0.0,0.0
1011,783,24-09-2019 13:44:00,1,2122.0,1746.0,0.823,10.296,0,0,0,0,0,0,0,0,0.0,0.0
1011,784,24-09-2019 13:46:00,1,2126.0,1721.0,0.809,10.282,1,0,0,0,1,0,1,0,0.0,0.0
1011,785,24-09-2019 13:48:00,1,2141.0,1686.0,0.788,10.302,2,0,0,0,2,0,2,0,0.0,0.0
1011,786,24-09-2019 13:50:00,1,2034.0,1647.0,0.81,9.836,1,0,0,0,1,0,1,0,0.0,0.0
1011,787,24-09-2019 13:52:00,1,2145.0,1673.0,0.78,10.303,0,0,0,0,0,0,0,0,0.0,0.0
1011,788,24-09-2019 13:54:00,1,2034.0,1658.0,0.815,9.852,0,0,0,0,0,0,0,0,0.0,0.0
1011,789,24-09-2019 13:56:00,1,2027.0,1638.0,0.808,9.801,1,0,0,0,1,1,0,0,0.0,0.0
1011,790,24-09-2019 13:58:00,1,1818.0,1579.0,0.868,8.912,6,1,0,1,5,2,3,0,0.0,0.0
1011,791,24-09-2019 14:00:00,1,1823.0,1532.0,0.84,8.878,0,0,0,0,0,0,0,0,0.0,0.0
1011,792,24-09-2019 14:02:00,1,1821.0,1544.0,0.8475,8.883,0,0,0,0,0,0,0,0,0.0,0.0
1011,793,24-09-2019 14:04:00,1,1819.0,1556.0,0.855,8.888,0,0,0,0,0,0,0,0,0.0,0.0
1011,794,24-09-2019 14:06:00,1,1835.0,1508.0,0.822,8.9,0,0,0,0,0,0,0,0,0.0,0.0
1011,795,24-09-2019 14:08:00,1,1837.0,1508.0,0.821,8.906,0,0,0,0,0,0,0,0,0.0,0.0
1011,796,24-09-2019 14:10:00,1,1829.0,1513.0,0.827,8.881,21,21,1,20,0,0,0,0,0.0,0.0
1011,797,24-09-2019 14:12:00,1,1841.0,1496.0,0.813,8.911,14,14,0,14,0,0,0,0,0.0,0.0
1011,798,24-09-2019 14:14:00,1,1851.0,1459.0,0.788,8.909,63,15,2,13,48,7,41,0,0.0,0.0
1011,799,24-09-2019 14:16:00,1,2124.0,1735.0,0.817,10.292,223,114,80,34,109,70,39,11,0.0,0.0
1011,800,24-09-2019 14:18:00,1,2332.0,1822.0,0.782,11.205,45,21,6,15,24,12,12,0,0.0,0.0
1011,801,24-09-2019 14:20:00,1,2319.0,1881.0,0.811,11.219,111,85,51,34,26,11,15,0,0.0,0.0
1011,802,24-09-2019 14:22:00,1,2321.0,1906.0,0.821,11.255,120,76,44,32,44,15,29,0,0.0,0.0
1011,803,24-09-2019 14:24:00,1,2317.0,1904.0,0.822,11.237,3,0,0,0,3,1,2,0,0.0,0.0
1011,804,24-09-2019 14:26:00,1,2115.0,1781.0,0.842,10.305,5,0,0,0,5,4,1,0,0.0,0.0
1011,805,24-09-2019 14:28:00,1,2022.0,1652.0,0.817,9.795,3,0,0,0,3,2,1,0,0.0,0.0
1011,806,24-09-2019 14:30:00,1,2032.0,1632.0,0.803,9.813,7,0,0,0,7,0,7,0,0.0,0.0
1011,807,24-09-2019 14:32:00,1,1812.0,1553.0,0.857,8.858,1,0,0,0,1,0,1,0,0.0,0.0
1011,808,24-09-2019 14:34:00,1,1833.0,1525.0,0.832,8.91,6,0,0,0,6,0,6,0,0.0,0.0
1011,809,24-09-2019 14:36:00,1,1834.0,1525.5,0.832,8.9145,2,0,0,0,2,0,2,0,0.0,0.0
1011,810,24-09-2019 14:38:00,1,1835.0,1526.0,0.832,8.919,1,0,0,0,1,0,1,0,0.0,0.0
1011,811,24-09-2019 14:40:00,1,1938.0,1538.0,0.794,9.337,0,0,0,0,0,0,0,0,0.0,0.0
1011,812,24-09-2019 14:42:00,1,1829.0,1517.0,0.829,8.886,14,0,0,0,14,0,14,0,0.0,0.0
1011,813,24-09-2019 14:44:00,1,1845.0,1454.0,0.788,8.879,12,0,0,0,12,0,12,0,0.0,0.0
1011,814,24-09-2019 14:46:00,1,1854.0,1449.0,0.781,8.91,8,0,0,0,8,0,8,0,0.0,0.0
1011,815,24-09-2019 14:48:00,1,1840.0,1484.0,0.806,8.892,0,0,0,0,0,0,0,0,0.0,0.0
1011,816,24-09-2019 14:50:00,1,1831.0,1499.0,0.819,8.872,14,0,0,0,14,0,14,0,0.0,0.0
1011,817,24-09-2019 14:52:00,1,1939.0,1539.0,0.794,9.345,8,0,0,0,8,0,8,0,0.0,0.0
1011,818,24-09-2019 14:54:00,1,2167.0,1577.0,0.728,10.283,0,0,0,0,0,0,0,0,0.0,0.0
1011,819,24-09-2019 14:56:00,1,2159.0,1600.0,0.741,10.28,22,7,4,3,15,8,7,0,0.0,0.0
1011,820,24-09-2019 14:58:00,1,1940.0,1544.0,0.796,9.353,3,0,0,0,3,0,3,0,0.0,0.0
1011,821,24-09-2019 15:00:00,1,1838.0,1492.0,0.812,8.894,1,0,0,0,1,0,1,0,0.0,0.0
1011,822,24-09-2019 15:02:00,1,1843.0,1446.0,0.784,8.863,1,0,0,0,1,0,1,0,0.0,0.0
1011,823,24-09-2019 15:04:00,1,1838.0,1453.0,0.791,8.852,24,2,2,0,22,12,10,0,0.0,0.0
1011,824,24-09-2019 15:06:00,1,2158.0,1618.0,0.75,10.296,14,4,0,4,10,2,8,0,0.0,0.0
1011,825,24-09-2019 15:08:00,1,2159.0,1619.0,0.75,10.3,0,0,0,0,0,0,0,0,0.0,0.0
1011,826,24-09-2019 15:10:00,1,1997.0,1557.0,0.7825,9.593,17,8,1,7,9,6,3,0,0.0,0.0
1011,827,24-09-2019 15:12:00,1,1835.0,1495.0,0.815,8.886,0,0,0,0,0,0,0,0,0.0,0.0
1011,828,24-09-2019 15:14:00,1,1852.0,1415.0,0.764,8.866,11,1,0,1,10,2,8,0,0.0,0.0
1011,829,24-09-2019 15:16:00,1,1839.0,1472.0,0.8,8.876,1,0,0,0,1,0,1,0,0.0,0.0
1011,830,24-09-2019 15:18:00,1,1851.0,1429.0,0.772,8.874,4,0,0,0,4,0,4,0,0.01,0.0
1011,831,24-09-2019 15:20:00,1,1857.0,1401.0,0.754,8.868,2,0,0,0,2,0,2,0,0.0,0.0
1011,832,24-09-2019 15:22:00,1,1849.0,1437.0,0.777,8.874,11,2,0,2,9,4,5,0,0.0,0.0
1011,833,24-09-2019 15:24:00,1,2168.0,1587.0,0.732,10.301,8,4,0,4,4,1,3,0,0.0,0.0
1011,834,24-09-2019 15:26:00,1,2047.0,1591.0,0.777,9.828,2,2,0,2,0,0,0,0,0.0,0.0
1011,835,24-09-2019 15:28:00,1,2048.0,1580.0,0.772,9.817,2,2,0,2,0,0,0,0,0.0,0.0
1011,836,24-09-2019 15:30:00,1,2155.0,1600.0,0.742,10.263,13,7,5,2,6,3,3,0,0.0,0.0
1011,837,24-09-2019 15:32:00,1,1941.0,1560.0,0.804,9.374,13,13,0,13,0,0,0,0,0.0,0.0
1011,838,24-09-2019 15:34:00,1,1856.0,1399.0,0.754,8.861,3,2,0,2,1,0,1,0,0.0,0.0
1011,839,24-09-2019 15:36:00,1,1760.0,1358.0,0.772,8.437,1,0,0,0,1,0,1,0,0.0,0.0
1011,840,24-09-2019 15:38:00,1,1756.0,1343.0,0.765,8.405,10,2,0,2,8,0,8,0,0.0,0.0
1011,841,24-09-2019 15:40:00,1,1861.0,1370.0,0.736,8.849,3,0,0,0,3,0,3,0,0.0,0.0
1011,842,24-09-2019 15:42:00,1,1869.0,1389.0,0.743,8.901,5,0,0,0,5,0,5,0,0.0,0.0
1011,843,24-09-2019 15:44:00,1,1861.5,1408.5,0.757,8.8935,2,0,0,0,2,1,1,0,0.0,0.0
1011,844,24-09-2019 15:46:00,1,1854.0,1428.0,0.771,8.886,54,21,5,16,33,18,15,0,0.0,0.0
1011,845,24-09-2019 15:48:00,1,1947.0,1523.0,0.782,9.357,93,45,19,26,48,25,23,0,0.0,0.0
1011,846,24-09-2019 15:50:00,1,2131.0,1728.0,0.811,10.309,149,94,53,41,55,31,24,83,0.0,0.0
1011,847,24-09-2019 15:52:00,1,2314.0,1896.0,0.819,11.217,92,62,22,40,30,8,22,54,0.0,0.0
1011,848,24-09-2019 15:54:00,1,2518.0,1983.0,0.787,12.118,61,35,11,24,26,5,21,58,0.0,0.0
1011,849,24-09-2019 15:56:00,1,2613.0,2103.0,0.805,12.625,79,44,13,31,35,20,15,64,0.0,0.0
1011,850,24-09-2019 15:58:00,1,2823.0,2209.0,0.782,13.568,359,245,186,59,114,73,41,53,0.0,0.0
1011,851,24-09-2019 16:00:00,1,2799.0,2293.0,0.819,13.567,189,109,79,30,80,65,15,17,0.0,0.01
1011,852,24-09-2019 16:02:00,1,2510.0,2040.0,0.813,12.15,134,73,55,18,61,42,19,42,0.0,0.0
1011,853,24-09-2019 16:04:00,1,2687.0,2222.0,0.827,13.047,327,216,164,52,111,70,41,24,0.0,0.0
1011,854,24-09-2019 16:06:00,1,2333.0,1839.0,0.788,11.228,88,47,21,26,41,13,28,61,0.0,0.0
1011,855,24-09-2019 16:08:00,1,2788.0,2340.0,0.839,13.574,150,83,45,38,67,32,35,56,0.01,0.0
1011,856,24-09-2019 16:10:00,1,2685.0,2266.0,0.844,13.087,123,44,18,26,79,39,40,39,0.0,0.0
1011,857,24-09-2019 16:12:00,1,2685.0,2278.0,0.848,13.1,81,39,18,21,42,18,24,40,0.0,0.0
1011,858,24-09-2019 16:14:00,1,2673.0,2286.0,0.855,13.064,158,67,43,24,91,59,32,30,0.0,0.0
1011,859,24-09-2019 16:16:00,1,2596.0,2174.0,0.838,12.634,12,5,3,2,7,4,3,0,0.0,0.21
1011,860,24-09-2019 16:18:00,1,2685.5,2273.5,0.8465,13.098,82,28,4,24,54,25,29,1,0.0,0.0
1011,861,24-09-2019 16:20:00,1,2775.0,2373.0,0.855,13.562,122,13,7,6,109,67,42,0,0.0,0.0
1011,862,24-09-2019 16:22:00,1,2746.0,2516.0,0.916,13.603,53,10,5,5,43,12,31,0,0.0,0.0
1011,863,24-09-2019 16:24:00,1,2750.0,2437.0,0.886,13.532,17,0,0,0,17,6,11,0,0.0,0.0
1011,864,24-09-2019 16:26:00,1,2575.0,2284.0,0.887,12.672,4,0,0,0,4,2,2,0,0.0,0.0
1011,865,24-09-2019 16:28:00,1,2275.0,2070.0,0.91,11.254,13,5,1,4,8,4,4,0,0.0,0.0
1011,866,24-09-2019 16:30:00,1,2200.0,1901.0,0.864,10.771,11,9,0,9,2,1,1,0,0.0,0.0
1011,867,24-09-2019 16:32:00,1,2121.0,1771.0,0.835,10.319,29,17,6,11,12,6,6,0,0.0,0.0
1011,868,24-09-2019 16:34:00,1,2114.0,1755.0,0.83,10.271,9,7,4,3,2,1,1,0,0.0,0.0
1011,869,24-09-2019 16:36:00,1,2079.0,1901.0,0.914,10.298,7,4,2,2,3,1,2,0,0.0,0.0
1011,870,24-09-2019 16:38:00,1,2296.0,1983.0,0.864,11.243,3,2,0,2,1,0,1,0,0.0,0.0
1011,871,24-09-2019 16:40:00,1,2186.0,1954.0,0.894,10.778,4,0,0,0,4,2,2,0,0.0,0.0
1011,872,24-09-2019 16:42:00,1,2081.0,1926.0,0.925,10.333,1,0,0,0,1,1,0,0,0.0,0.0
1011,873,24-09-2019 16:44:00,1,2297.0,1939.0,0.844,11.197,10,1,0,1,9,3,6,0,0.0,0.0
1011,874,24-09-2019 16:46:00,1,2201.0,1916.0,0.87,10.794,12,0,0,0,12,6,6,0,0.0,0.0
1011,875,24-09-2019 16:48:00,1,2117.0,1782.0,0.841,10.315,15,5,2,3,10,6,4,0,0.0,0.0
1011,876,24-09-2019 16:50:00,1,2100.0,1837.0,0.875,10.306,5,1,1,0,4,0,4,0,0.0,0.0
1011,877,24-09-2019 16:52:00,1,2113.0,1788.5,0.8465,10.3045,2,0,0,0,2,0,2,0,0.0,0.0
1011,878,24-09-2019 16:54:00,1,2126.0,1740.0,0.818,10.303,7,1,0,1,6,2,4,0,0.0,0.0
1011,879,24-09-2019 16:56:00,1,2127.0,1744.0,0.82,10.31,5,2,1,1,3,1,2,0,0.0,0.0
1011,880,24-09-2019 16:58:00,1,2023.0,1709.0,0.845,9.861,0,0,0,0,0,0,0,0,0.0,0.0
1011,881,24-09-2019 17:00:00,1,1912.0,1657.0,0.866,9.369,22,13,7,6,9,4,5,0,0.0,0.0
1011,882,24-09-2019 17:02:00,1,1915.0,1648.0,0.86,9.369,11,7,2,5,4,2,2,0,0.0,0.0
1011,883,24-09-2019 17:04:00,1,2127.0,1736.0,0.816,10.301,75,11,7,4,64,35,29,0,0.0,0.0
1011,884,24-09-2019 17:06:00,1,2111.0,1786.0,0.846,10.295,105,32,11,21,73,41,32,0,0.0,0.0
1011,885,24-09-2019 17:08:00,1,2207.0,1863.0,0.844,10.758,155,19,7,12,136,103,33,0,0.0,0.0
1011,886,24-09-2019 17:10:00,1,2114.0,1762.0,0.833,10.279,161,52,25,27,109,69,40,0,0.0,0.0
1011,887,24-09-2019 17:12:00,1,2300.0,1921.0,0.835,11.19,118,38,11,27,80,38,42,0,0.0,0.0
1011,888,24-09-2019 17:14:00,1,2310.0,1934.0,0.837,11.242,145,43,12,31,102,62,40,2,0.0,0.0
1011,889,24-09-2019 17:16:00,1,2307.0,1928.0,0.836,11.225,101,31,10,21,70,33,37,0,0.0,0.0
1011,890,24-09-2019 17:18:00,1,2314.0,1925.0,0.832,11.248,4,0,0,0,4,0,4,0,0.0,0.0
1011,891,24-09-2019 17:20:00,1,2332.0,1829.0,0.784,11.215,23,0,0,0,23,0,23,0,0.0,0.0
1011,892,24-09-2019 17:22:00,1,2121.0,1758.0,0.829,10.302,4,1,0,1,3,0,3,0,0.0,0.0
1011,893,24-09-2019 17:24:00,1,2137.0,1686.0,0.789,10.286,14,3,1,2,11,2,9,0,0.0,0.0
1011,894,24-09-2019 17:26:00,1,1976.5,1621.0,0.8225,9.5825,2,1,1,0,1,1,0,0,0.0,0.0
1011,895,24-09-2019 17:28:00,1,1816.0,1556.0,0.856,8.879,3,0,0,0,3,2,1,0,0.0,0.0
1011,896,24-09-2019 17:30:00,1,1929.0,1588.0,0.823,9.357,12,8,5,3,4,1,3,0,0.0,0.0
1011,897,24-09-2019 17:32:00,1,1936.0,1590.0,0.821,9.387,4,2,0,2,2,0,2,0,0.0,0.0
1011,898,24-09-2019 17:34:00,1,1934.0,1571.0,0.812,9.358,7,2,0,2,5,0,5,0,0.0,0.0
1011,899,24-09-2019 17:36:00,1,2145.0,1627.0,0.759,10.252,11,1,0,1,10,0,10,0,0.0,0.0
1011,900,24-09-2019 17:38:00,1,2149.0,1657.0,0.771,10.304,45,16,5,11,29,10,19,0,0.0,0.0
1011,901,24-09-2019 17:40:00,1,2151.0,1644.0,0.764,10.297,142,75,46,29,67,43,24,33,0.0,0.0
1011,902,24-09-2019 17:42:00,1,2321.0,1897.0,0.817,11.243,77,66,28,38,11,4,7,53,0.0,0.0
1011,903,24-09-2019 17:44:00,1,2631.0,2046.0,0.778,12.63,107,62,24,38,45,16,29,43,0.0,0.0
1011,904,24-09-2019 17:46:00,1,2629.0,2017.0,0.767,12.591,129,69,36,33,60,20,40,56,0.0,0.0
1011,905,24-09-2019 17:48:00,1,2608.0,2124.0,0.814,12.629,86,25,15,10,61,10,51,34,0.0,0.0
1011,906,24-09-2019 17:50:00,1,2810.0,2237.0,0.796,13.55,154,34,19,15,120,64,56,36,0.01,0.0
1011,907,24-09-2019 17:52:00,1,2831.0,2164.0,0.765,13.549,136,65,39,26,71,30,41,50,0.0,0.0
1011,908,24-09-2019 17:54:00,1,2802.0,2284.0,0.815,13.567,112,42,22,20,70,20,50,50,0.0,0.0
1011,909,24-09-2019 17:56:00,1,3017.0,2381.0,0.789,14.523,155,101,66,35,54,20,34,40,0.0,0.0
1011,910,24-09-2019 17:58:00,1,2610.0,2117.0,0.811,12.625,209,82,62,20,127,80,47,38,0.0,0.0
1011,911,24-09-2019 18:00:00,0,2980.0,2507.5,0.838,14.5155,190,84,49,35,106,56,50,48,0.0,0.0
1011,912,24-09-2019 18:02:00,0,3350.0,2898.0,0.865,16.406,448,297,240,57,151,111,40,155,0.0,0.01
1011,913,24-09-2019 18:04:00,0,2487.0,2117.0,0.851,12.145,618,380,300,80,238,175,63,144,0.0,0.0
1011,914,24-09-2019 18:06:00,0,2683.0,2274.0,0.847,13.087,575,391,325,66,184,141,43,184,0.0,0.02
1011,915,24-09-2019 18:08:00,0,2955.0,2610.0,0.883,14.533,640,433,350,83,207,151,56,102,0.0,0.0
1011,916,24-09-2019 18:10:00,0,3278.0,2709.0,0.826,15.913,235,129,75,54,106,46,60,41,0.0,0.0
1011,917,24-09-2019 18:12:00,0,3443.0,2986.0,0.867,16.873,239,173,120,53,66,20,46,44,0.08,0.02
1011,918,24-09-2019 18:14:00,0,3237.0,2902.0,0.896,15.967,261,158,114,44,103,67,36,54,0.0,0.0
1011,919,24-09-2019 18:16:00,0,3438.0,2928.0,0.852,16.786,170,99,53,46,71,44,27,17,0.03,0.09
1011,920,24-09-2019 18:18:00,0,2937.0,2677.0,0.911,14.537,355,203,154,49,152,110,42,72,0.06,0.0
1011,921,24-09-2019 18:20:00,0,2940.0,2648.0,0.901,14.514,285,172,125,47,113,75,38,47,0.0,0.0
1011,922,24-09-2019 18:22:00,0,3328.0,2945.0,0.885,16.374,169,104,54,50,65,6,59,52,0.01,0.0
1011,923,24-09-2019 18:24:00,0,3604.0,3256.0,0.904,17.804,149,75,42,33,74,32,42,21,0.0,0.0
1011,924,24-09-2019 18:26:00,0,2469.0,2182.0,0.884,12.142,34,9,4,5,25,9,16,0,0.0,0.0
1011,925,24-09-2019 18:28:00,0,2291.0,1993.0,0.87,11.234,124,51,27,24,73,25,48,0,0.0,0.0
1011,926,24-09-2019 18:30:00,0,2564.0,2302.0,0.898,12.651,100,38,19,19,62,29,33,0,0.0,0.0
1011,927,24-09-2019 18:32:00,0,2922.0,2698.0,0.923,14.5,269,157,125,32,112,77,35,71,0.03,0.0
1011,928,24-09-2019 18:34:00,0,3113.5,2859.0,0.9185,15.4325,350,227,176,51,123,92,31,97,0.05,0.0
1011,929,24-09-2019 18:36:00,0,3305.0,3020.0,0.914,16.365,280,181,124,57,99,64,35,66,0.0,0.0
1011,930,24-09-2019 18:38:00,0,3700.0,3308.0,0.894,18.241,280,161,103,58,119,60,59,55,0.0,0.0
1011,931,24-09-2019 18:40:00,0,3654.0,3450.0,0.944,18.218,257,168,111,57,89,35,54,63,0.01,0.0
1011,932,24-09-2019 18:42:00,0,3684.0,3449.0,0.936,18.334,145,92,54,38,53,27,26,21,0.02,0.15
1011,933,24-09-2019 18:44:00,0,3200.0,2994.0,0.936,15.925,296,167,133,34,129,100,29,16,0.0,0.0
1011,934,24-09-2019 18:46:00,0,2463.0,2234.0,0.907,12.179,205,130,90,40,75,39,36,88,0.01,0.0
1011,935,24-09-2019 18:48:00,0,3374.0,3228.0,0.957,16.866,212,132,85,47,80,45,35,52,0.0,0.07
1011,936,24-09-2019 18:50:00,0,3192.0,3000.0,0.94,15.897,239,149,110,39,90,59,31,42,0.13,0.0
1011,937,24-09-2019 18:52:00,0,3701.0,3325.0,0.898,18.263,175,88,59,29,87,53,34,48,0.0,0.03
1011,938,24-09-2019 18:54:00,0,3581.0,3326.0,0.929,17.79,89,40,26,14,49,30,19,18,0.0,0.36
1011,939,24-09-2019 18:56:00,0,3000.0,2851.0,0.95,14.977,178,125,92,33,53,40,13,13,0.01,0.01
1011,940,24-09-2019 18:58:00,0,3012.0,2821.0,0.937,14.993,205,140,113,27,65,50,15,85,0.05,0.0
1011,941,24-09-2019 19:00:00,0,3349.0,3326.0,0.993,16.877,262,148,116,32,114,86,28,81,0.05,0.03
1011,942,24-09-2019 19:02:00,0,3374.0,3202.0,0.949,16.839,83,31,21,10,52,17,35,6,0.0,0.0
1011,943,24-09-2019 19:04:00,0,3396.0,3178.0,0.936,16.9,378,245,200,45,133,91,42,21,0.05,0.0
1011,944,24-09-2019 19:06:00,0,2891.0,2821.0,0.976,14.515,362,222,187,35,140,108,32,148,0.0,0.0
1011,945,24-09-2019 19:08:00,0,3081.0,2960.0,0.962,15.416,487,292,236,56,195,150,45,120,0.06,0.0
1011,946,24-09-2019 19:10:00,0,3271.0,3099.0,0.948,16.317,365,223,171,52,142,112,30,36,0.03,0.0
1011,947,24-09-2019 19:12:00,0,3208.0,2939.0,0.916,15.894,354,225,180,45,129,96,33,63,0.01,0.0
1011,948,24-09-2019 19:14:00,0,3282.0,3122.0,0.951,16.386,172,98,78,20,74,56,18,34,0.04,0.0
1011,949,24-09-2019 19:16:00,0,3572.0,3403.0,0.953,17.841,68,38,27,11,30,18,12,7,0.01,0.0
1011,950,24-09-2019 19:18:00,0,3372.0,3259.0,0.967,16.891,215,114,88,26,101,74,27,18,0.0,0.0
1011,951,24-09-2019 19:20:00,0,3218.0,2950.0,0.917,15.943,253,161,125,36,92,73,19,83,0.06,0.0
1011,952,24-09-2019 19:22:00,0,2918.0,2743.0,0.94,14.532,225,145,111,34,80,41,39,5,0.01,0.0
1011,953,24-09-2019 19:24:00,0,3213.0,2940.0,0.915,15.914,249,128,89,39,121,92,29,56,0.0,0.0
1011,954,24-09-2019 19:26:00,0,3183.0,3084.0,0.969,15.955,365,209,162,47,156,118,38,129,0.04,0.0
1011,955,24-09-2019 19:28:00,0,2889.0,2853.0,0.988,14.541,362,253,207,46,109,83,26,76,0.0,0.0
1011,956,24-09-2019 19:30:00,0,3183.0,3068.0,0.964,15.939,189,109,73,36,80,61,19,54,0.0,0.0
1011,957,24-09-2019 19:32:00,0,3105.0,2913.0,0.938,15.458,240,154,109,45,86,64,22,33,0.02,0.0
1011,958,24-09-2019 19:34:00,0,3215.0,2928.0,0.911,15.908,91,60,37,23,31,22,9,21,0.01,0.01
1011,959,24-09-2019 19:36:00,0,3174.0,3072.0,0.968,15.908,180,94,58,36,86,58,28,2,0.0,0.0
1011,960,24-09-2019 19:38:00,0,3290.0,3112.0,0.946,16.41,85,30,9,21,55,36,19,0,0.0,0.0
1011,961,24-09-2019 19:40:00,0,3389.0,3188.0,0.941,16.882,126,35,16,19,91,54,37,0,0.0,0.0
1011,962,24-09-2019 19:42:00,0,3145.0,3006.5,0.9575,15.7205,65,33,19,14,32,16,16,0,0.0,0.0
1011,963,24-09-2019 19:44:00,0,2901.0,2825.0,0.974,14.559,9,3,2,1,6,4,2,0,0.0,0.0
1011,964,24-09-2019 19:46:00,0,2713.0,2612.0,0.963,13.579,14,4,1,3,10,8,2,0,0.0,0.0
1011,965,24-09-2019 19:48:00,0,2741.0,2480.0,0.905,13.546,2,2,1,1,0,0,0,0,0.0,0.0
1011,966,24-09-2019 19:50:00,0,2531.0,2418.0,0.955,12.647,2,1,0,1,1,1,0,0,0.0,0.0
1011,967,24-09-2019 19:52:00,0,2552.0,2359.0,0.924,12.666,100,39,26,13,61,40,21,1,0.0,0.0
1011,968,24-09-2019 19:54:00,0,2530.0,2404.0,0.95,12.631,14,8,5,3,6,2,4,0,0.0,0.0
1011,969,24-09-2019 19:56:00,0,2801.0,2743.0,0.979,14.072,0,0,0,0,0,0,0,0,0.0,0.0
1011,970,24-09-2019 19:58:00,0,2698.0,2708.0,1.004,13.627,0,0,0,0,0,0,0,0,0.0,0.0
1011,971,24-09-2019 20:00:00,0,2724.0,2579.0,0.947,13.589,3,2,1,1,1,0,1,0,0.01,0.0
1011,972,24-09-2019 20:02:00,0,2522.0,2463.0,0.977,12.664,3,0,0,0,3,0,3,0,0.0,0.0
1011,973,24-09-2019 20:04:00,0,2430.0,2355.0,0.969,12.18,14,6,1,5,8,0,8,0,0.0,0.0
1011,974,24-09-2019 20:06:00,0,2221.0,2267.0,1.021,11.26,49,18,10,8,31,18,13,0,0.0,0.0
1011,975,24-09-2019 20:08:00,0,2224.0,2223.0,0.999,11.225,9,0,0,0,9,0,9,0,0.0,0.0
1011,976,24-09-2019 20:10:00,0,2267.0,2096.0,0.925,11.251,4,2,1,1,2,0,2,0,0.0,0.0
1011,977,24-09-2019 20:12:00,0,2051.0,1998.0,0.974,10.294,12,5,2,3,7,3,4,0,0.0,0.0
1011,978,24-09-2019 20:14:00,0,2060.0,1966.0,0.954,10.294,39,9,3,6,30,4,26,0,0.0,0.0
1011,979,24-09-2019 20:16:00,0,2243.0,2174.0,0.968,11.245,316,205,165,40,111,74,37,57,0.0,0.0
1011,980,24-09-2019 20:18:00,0,2426.0,2382.0,0.982,12.196,325,207,170,37,118,92,26,95,0.0,0.0
1011,981,24-09-2019 20:20:00,0,2511.0,2495.0,0.993,12.657,597,393,341,52,204,155,49,149,0.0,0.0
1011,982,24-09-2019 20:22:00,0,2521.0,2456.0,0.974,12.65,418,269,221,48,149,110,39,194,0.0,0.0
1011,983,24-09-2019 20:24:00,0,2904.0,2796.0,0.963,14.535,458,308,254,54,150,113,37,125,0.0,0.0
1011,984,24-09-2019 20:26:00,0,2897.0,2837.0,0.979,14.554,374,233,189,44,141,100,41,119,0.01,0.11
1011,985,24-09-2019 20:28:00,0,2989.0,2866.0,0.959,14.949,134,61,34,27,73,34,39,49,0.0,0.0
1011,986,24-09-2019 20:30:00,0,3190.0,3064.0,0.961,15.959,244,166,122,44,78,50,28,48,0.0,0.0
1011,987,24-09-2019 20:32:00,0,3180.0,3070.0,0.965,15.929,189,145,102,43,44,16,28,70,0.0,0.0
1011,988,24-09-2019 20:34:00,0,3567.0,3412.0,0.956,17.832,196,124,88,36,72,38,34,65,0.0,0.0
1011,989,24-09-2019 20:36:00,0,3373.0,3214.0,0.953,16.848,189,99,60,39,90,46,44,52,0.0,0.0
1011,990,24-09-2019 20:38:00,0,3347.0,3296.0,0.985,16.836,178,101,64,37,77,46,31,50,0.0,0.06
1011,991,24-09-2019 20:40:00,0,3205.0,2999.0,0.936,15.949,491,300,248,52,191,146,45,73,0.04,0.0
1011,992,24-09-2019 20:42:00,0,3203.0,2980.0,0.93,15.919,314,195,155,40,119,88,31,108,0.04,0.0
1011,993,24-09-2019 20:44:00,0,2716.0,2623.0,0.966,13.607,355,213,165,48,142,98,44,85,0.01,0.0
1011,994,24-09-2019 20:46:00,0,3370.0,3236.0,0.96,16.858,160,73,53,20,87,38,49,82,0.0,0.0
1011,995,24-09-2019 20:48:00,0,3281.0,3123.0,0.952,16.386,283,145,109,36,138,98,40,31,0.0,0.05
1011,996,24-09-2019 20:50:00,0,3188.5,3026.0,0.949,15.913,522,312,266,46,210,161,49,95,0.0,0.05
1011,997,24-09-2019 20:52:00,0,3096.0,2929.0,0.946,15.44,319,215,174,41,104,70,34,138,0.0,0.0
1011,998,24-09-2019 20:54:00,0,2555.0,2332.0,0.913,12.65,305,195,156,39,110,77,33,138,0.05,0.0
1011,999,24-09-2019 20:56:00,0,3224.0,2910.0,0.903,15.926,171,115,74,41,56,26,30,27,0.01,0.0
1011,1000,24-09-2019 20:58:00,0,3376.0,3192.0,0.946,16.836,169,71,36,35,98,46,52,55,0.0,0.0
1011,1001,24-09-2019 21:00:00,0,3758.0,3584.0,0.954,18.776,193,113,72,41,80,31,49,48,0.01,0.0
1011,1002,24-09-2019 21:02:00,0,3558.0,3424.0,0.962,17.807,217,131,97,34,86,54,32,16,0.0,0.0
1011,1003,24-09-2019 21:04:00,0,3382.0,3245.0,0.959,16.918,159,52,33,19,107,55,52,58,0.0,0.0
1011,1004,24-09-2019 21:06:00,0,3567.0,3342.0,0.937,17.752,175,37,16,21,138,77,61,48,0.0,0.0
1011,1005,24-09-2019 21:08:00,0,3680.0,3428.0,0.932,18.294,117,49,12,37,68,28,40,38,0.0,0.0
1011,1006,24-09-2019 21:10:00,0,3354.0,3247.0,0.968,16.808,254,158,116,42,96,67,29,57,0.08,0.0
1011,1007,24-09-2019 21:12:00,0,3340.0,3345.0,1.001,16.863,423,253,211,42,170,127,43,84,0.03,0.1
1011,1008,24-09-2019 21:14:00,0,3301.0,3054.0,0.925,16.386,146,37,15,22,109,51,58,54,0.03,0.0
1011,1009,24-09-2019 21:16:00,0,3688.0,3388.0,0.919,18.283,157,56,18,38,101,49,52,50,0.0,0.0
1011,1010,24-09-2019 21:18:00,0,3674.0,3457.0,0.941,18.301,174,112,75,37,62,41,21,28,0.0,0.02
1011,1011,24-09-2019 21:20:00,0,2808.0,2648.0,0.943,13.995,141,62,46,16,79,30,49,56,0.0,0.0
1011,1012,24-09-2019 21:22:00,0,3691.0,3396.0,0.92,18.301,111,37,21,16,74,35,39,27,0.0,0.08
1011,1013,24-09-2019 21:24:00,0,3441.5,3200.0,0.9305,17.1015,161,111,76,35,50,32,18,35,0.03,0.0
1011,1014,24-09-2019 21:26:00,0,3192.0,3004.0,0.941,15.902,320,154,121,33,166,124,42,106,0.05,0.0
1011,1015,24-09-2019 21:28:00,0,3398.0,3173.0,0.934,16.9,121,46,36,10,75,39,36,71,0.07,0.0
1011,1016,24-09-2019 21:30:00,0,3689.0,3380.0,0.916,18.276,145,86,54,32,59,30,29,42,0.0,0.01
1011,1017,24-09-2019 21:32:00,0,2559.0,2318.0,0.906,12.648,318,181,131,50,137,101,36,92,0.0,0.02
1011,1018,24-09-2019 21:34:00,0,3394.0,3116.0,0.918,16.822,136,28,12,16,108,56,52,51,0.01,0.0
1011,1019,24-09-2019 21:36:00,0,3759.0,3570.0,0.95,18.762,122,45,24,21,77,38,39,52,0.0,0.0
1011,1020,24-09-2019 21:38:00,0,3849.0,3649.0,0.948,19.203,145,62,28,34,83,39,44,34,0.01,0.15
1011,1021,24-09-2019 21:40:00,0,3386.0,3187.0,0.941,16.869,320,177,147,30,143,107,36,76,0.08,0.01
1011,1022,24-09-2019 21:42:00,0,3014.0,2873.0,0.953,15.054,478,288,234,54,190,143,47,124,0.01,0.0
1011,1023,24-09-2019 21:44:00,0,2994.0,2883.0,0.963,14.988,475,256,205,51,219,171,48,125,0.0,0.0
1011,1024,24-09-2019 21:46:00,0,3472.0,3320.0,0.956,17.355,114,26,14,12,88,40,48,62,0.0,0.0
1011,1025,24-09-2019 21:48:00,0,3866.0,3609.0,0.934,19.228,302,148,113,35,154,107,47,56,0.07,0.1
1011,1026,24-09-2019 21:50:00,0,3683.0,3396.0,0.922,18.269,107,35,20,15,72,28,44,47,0.01,0.0
1011,1027,24-09-2019 21:52:00,0,3843.0,3669.0,0.955,19.204,178,100,67,33,78,36,42,27,0.08,0.07
1011,1028,24-09-2019 21:54:00,0,3368.0,3288.0,0.976,16.909,334,163,113,50,171,126,45,37,0.0,0.0
1011,1029,24-09-2019 21:56:00,0,2459.0,2248.0,0.914,12.177,243,117,70,47,126,80,46,50,0.01,0.0
1011,1030,24-09-2019 21:58:00,0,2901.0,2780.5,0.9525,14.508,357,226,174,52,131,99,32,74,0.04,0.0
1011,1031,24-09-2019 22:00:00,0,3343.0,3313.0,0.991,16.839,465,300,248,52,165,121,44,141,0.0,0.0
1011,1032,24-09-2019 22:02:00,0,3450.0,3400.0,0.985,17.358,374,205,163,42,169,136,33,103,0.07,0.0
1011,1033,24-09-2019 22:04:00,0,3636.0,3556.0,0.978,18.262,325,169,126,43,156,106,50,94,0.0,0.02
1011,1034,24-09-2019 22:06:00,0,3582.0,3312.0,0.925,17.778,86,15,7,8,71,31,40,30,0.0,0.02
1011,1035,24-09-2019 22:08:00,0,3824.0,3771.0,0.986,19.24,84,10,6,4,74,22,52,39,0.0,0.0
1011,1036,24-09-2019 22:10:00,0,3854.0,3615.0,0.938,19.186,109,15,9,6,94,35,59,34,0.0,0.04
1011,1037,24-09-2019 22:12:00,0,3841.0,3687.0,0.96,19.216,150,65,48,17,85,47,38,22,0.0,0.06
1011,1038,24-09-2019 22:14:00,0,2721.0,2603.0,0.957,13.604,135,61,45,16,74,39,35,15,0.01,0.01
1011,1039,24-09-2019 22:16:00,0,3745.0,3620.0,0.967,18.763,367,205,161,44,162,120,42,115,0.09,0.02
1011,1040,24-09-2019 22:18:00,0,2998.0,2852.0,0.951,14.971,345,213,172,41,132,103,29,185,0.0,0.0
1011,1041,24-09-2019 22:20:00,0,2897.0,2820.0,0.973,14.537,209,92,67,25,117,63,54,59,0.01,0.0
1011,1042,24-09-2019 22:22:00,0,3829.0,3695.0,0.965,19.179,320,176,138,38,144,113,31,53,0.0,0.06
1011,1043,24-09-2019 22:24:00,0,3164.0,3124.0,0.987,15.926,205,115,77,38,90,39,51,54,0.0,0.0
1011,1044,24-09-2019 22:26:00,0,3845.0,3696.0,0.961,19.242,191,69,38,31,122,55,67,55,0.0,0.0
1011,1045,24-09-2019 22:28:00,0,4327.0,4072.0,0.941,21.555,218,104,67,37,114,67,47,40,0.0,0.03
1011,1046,24-09-2019 22:30:00,0,3279.0,3180.0,0.97,16.44,196,142,110,32,54,35,19,45,0.06,0.0
1011,1047,24-09-2019 22:32:00,0,3042.0,2930.5,0.963,15.2305,196,113,64,49,83,50,33,33,0.05,0.04
1011,1048,24-09-2019 22:34:00,0,2805.0,2681.0,0.956,14.021,355,179,141,38,176,133,43,94,0.07,0.0
1011,1049,24-09-2019 22:36:00,0,3648.0,3501.0,0.96,18.249,168,83,48,35,85,41,44,72,0.0,0.0
1011,1050,24-09-2019 22:38:00,0,4292.0,4140.0,0.965,21.494,216,114,70,44,102,73,29,28,0.0,0.06
1011,1051,24-09-2019 22:40:00,0,4028.0,3865.0,0.96,20.148,366,189,143,46,177,135,42,22,0.04,0.0
1011,1052,24-09-2019 22:42:00,0,3655.0,3498.0,0.957,18.275,92,46,29,17,46,29,17,34,0.0,0.01
1011,1053,24-09-2019 22:44:00,0,3382.0,3217.0,0.951,16.887,262,147,112,35,115,87,28,99,0.0,0.0
1011,1054,24-09-2019 22:46:00,0,3556.0,3400.0,0.956,17.776,291,143,113,30,148,103,45,95,0.18,0.01
1011,1055,24-09-2019 22:48:00,0,4190.0,4171.0,0.996,21.127,345,206,165,41,139,112,27,135,0.0,0.01
1011,1056,24-09-2019 22:50:00,0,3644.0,3539.0,0.971,18.274,252,151,110,41,101,73,28,75,0.0,0.0
1011,1057,24-09-2019 22:52:00,0,3370.0,3208.0,0.952,16.828,290,176,144,32,114,90,24,62,0.0,0.0
1011,1058,24-09-2019 22:54:00,0,3200.0,3016.0,0.942,15.946,353,211,168,43,142,107,35,165,0.0,0.0
1011,1059,24-09-2019 22:56:00,0,3281.0,3105.0,0.946,16.365,184,77,52,25,107,57,50,53,0.0,0.0
1011,1060,24-09-2019 22:58:00,0,3947.0,3787.0,0.96,19.744,97,36,15,21,61,30,31,65,0.0,0.06
1011,1061,24-09-2019 23:00:00,0,3622.0,3625.0,1.001,18.285,276,193,144,49,83,64,19,58,0.0,0.02
1011,1062,24-09-2019 23:02:00,0,3200.0,3012.0,0.941,15.941,230,112,81,31,118,86,32,50,0.0,0.0
1011,1063,24-09-2019 23:04:00,0,3675.0,3449.0,0.939,18.299,273,164,121,43,109,89,20,111,0.0,0.0
1011,1064,24-09-2019 23:06:00,0,3526.0,3334.5,0.946,17.5845,148,76,51,25,72,45,27,60,0.01,0.03
1011,1065,24-09-2019 23:08:00,0,3377.0,3220.0,0.953,16.87,167,71,48,23,96,49,47,50,0.01,0.02
1011,1066,24-09-2019 23:10:00,0,3636.0,3535.0,0.972,18.24,136,58,31,27,78,32,46,63,0.0,0.0
1011,1067,24-09-2019 23:12:00,0,3854.0,3650.0,0.947,19.225,185,87,55,32,98,58,40,40,0.0,0.1
1011,1068,24-09-2019 23:14:00,0,3842.0,3689.0,0.96,19.22,143,71,41,30,72,43,29,26,0.07,0.03
1011,1069,24-09-2019 23:16:00,0,3181.0,3054.0,0.96,15.914,365,177,132,45,188,149,39,78,0.04,0.0
1011,1070,24-09-2019 23:18:00,0,3370.0,3237.0,0.961,16.859,321,207,166,41,114,82,32,142,0.0,0.0
1011,1071,24-09-2019 23:20:00,0,3349.0,3291.0,0.983,16.836,527,326,262,64,201,156,45,111,0.01,0.0
1011,1072,24-09-2019 23:22:00,0,3393.0,3190.0,0.94,16.899,254,137,102,35,117,84,33,102,0.0,0.0
1011,1073,24-09-2019 23:24:00,0,3679.0,3394.0,0.922,18.254,420,225,184,41,195,135,60,78,0.0,0.0
1011,1074,24-09-2019 23:26:00,0,3686.0,3397.0,0.922,18.285,301,159,120,39,142,96,46,95,0.0,0.02
1011,1075,24-09-2019 23:28:00,0,3634.0,3559.0,0.98,18.257,268,165,127,38,103,74,29,43,0.05,0.0
1011,1076,24-09-2019 23:30:00,0,3355.0,3312.0,0.987,16.885,83,63,32,31,20,0,20,45,0.0,0.0
1011,1077,24-09-2019 23:32:00,0,3670.0,3464.0,0.944,18.296,104,86,56,30,18,1,17,56,0.0,0.09
1011,1078,24-09-2019 23:34:00,0,3557.0,3387.0,0.952,17.762,134,93,64,29,41,32,9,108,0.0,0.02
1011,1079,24-09-2019 23:36:00,0,3443.0,3422.0,0.994,17.353,250,170,127,43,80,55,25,51,0.02,0.01
1011,1080,24-09-2019 23:38:00,0,3277.0,3141.0,0.958,16.387,191,124,79,45,67,45,22,54,0.01,0.02
1011,1081,24-09-2019 23:40:00,0,3330.0,3165.5,0.9505,16.623,243,154,113,41,89,61,28,25,0.0,0.09
1011,1082,24-09-2019 23:42:00,0,3383.0,3190.0,0.943,16.859,428,277,222,55,151,104,47,40,0.01,0.0
1011,1083,24-09-2019 23:44:00,0,3635.0,3543.0,0.975,18.244,476,272,211,61,204,155,49,86,0.08,0.0
1011,1084,24-09-2019 23:46:00,0,3185.0,3119.0,0.979,16.004,123,75,47,28,48,31,17,17,0.0,0.0
1011,1085,24-09-2019 23:48:00,0,3281.0,3131.0,0.954,16.394,84,31,9,22,53,36,17,0,0.0,0.0
1011,1086,24-09-2019 23:50:00,0,3382.0,3195.0,0.944,16.863,106,23,11,12,83,48,35,0,0.0,0.0
1011,1087,24-09-2019 23:52:00,0,3178.0,3079.0,0.969,15.932,188,102,65,37,86,61,25,47,0.0,0.0
1011,1088,24-09-2019 23:54:00,0,3450.0,3357.0,0.973,17.31,73,66,38,28,7,1,6,65,0.0,0.04
1011,1089,24-09-2019 23:56:00,0,3347.0,3351.0,1.001,16.898,276,170,126,44,106,84,22,46,0.0,0.0
1011,1090,24-09-2019 23:58:00,0,3382.0,3135.0,0.927,16.794,514,354,288,66,160,123,37,36,0.0,0.01
1011,1091,25-09-2019 00:00:00,0,2999.0,2866.0,0.956,14.99,427,240,182,58,187,149,38,145,0.05,0.0
1011,1092,25-09-2019 00:02:00,0,2987.0,2945.0,0.986,15.029,586,360,291,69,226,171,55,117,0.0,0.0
1011,1093,25-09-2019 00:04:00,0,3181.0,3053.0,0.959,15.914,129,82,51,31,47,27,20,25,0.01,0.04
1011,1094,25-09-2019 00:06:00,0,3367.0,3246.0,0.964,16.859,87,72,44,28,15,2,13,67,0.0,0.0
1011,1095,25-09-2019 00:08:00,0,3352.0,3306.0,0.986,16.868,326,195,150,45,131,100,31,88,0.0,0.01
1011,1096,25-09-2019 00:10:00,0,3175.0,3093.0,0.974,15.932,327,189,151,38,138,100,38,22,0.0,0.0
1011,1097,25-09-2019 00:12:00,0,2903.0,2813.0,0.969,14.55,203,83,62,21,120,83,37,6,0.0,0.0
1011,1098,25-09-2019 00:14:00,0,2954.0,2840.0,0.9615,14.7815,499,270,198,72,229,181,48,9,0.0,0.0
1011,1099,25-09-2019 00:16:00,0,3005.0,2867.0,0.954,15.013,293,164,120,44,129,94,35,22,0.03,0.0
1011,1100,25-09-2019 00:18:00,0,3349.0,3305.0,0.987,16.854,598,242,178,64,356,272,84,1,0.0,0.03
1011,1101,25-09-2019 00:20:00,0,3283.0,3128.0,0.953,16.399,535,325,250,75,210,157,53,44,0.0,0.0
1011,1102,25-09-2019 00:22:00,0,3271.0,3187.0,0.974,16.416,350,185,139,46,165,124,41,24,0.0,0.0
1011,1103,25-09-2019 00:24:00,0,2889.0,2851.0,0.987,14.54,523,241,190,51,282,216,66,11,0.0,0.0
1011,1104,25-09-2019 00:26:00,0,3199.0,2979.0,0.931,15.902,59,47,30,17,12,1,11,73,0.0,0.0
1011,1105,25-09-2019 00:28:00,0,3185.0,3071.0,0.964,15.949,248,163,116,47,85,61,24,84,0.0,0.0
1011,1106,25-09-2019 00:30:00,0,3176.0,3075.0,0.968,15.918,268,163,118,45,105,72,33,42,0.0,0.0
1011,1107,25-09-2019 00:32:00,0,3090.0,2957.0,0.957,15.448,272,109,77,32,163,113,50,64,0.0,0.0
1011,1108,25-09-2019 00:34:00,0,2882.0,2872.0,0.996,14.534,123,39,8,31,84,49,35,0,0.0,0.0
1011,1109,25-09-2019 00:36:00,0,2921.0,2735.0,0.936,14.537,150,47,22,25,103,60,43,0,0.0,0.0
1011,1110,25-09-2019 00:38:00,0,3000.0,2878.0,0.959,15.004,196,74,37,37,122,73,49,0,0.0,0.0
1011,1111,25-09-2019 00:40:00,0,3212.0,2969.0,0.924,15.942,51,22,6,16,29,15,14,0,0.0,0.0
1011,1112,25-09-2019 00:42:00,0,2906.0,2778.0,0.956,14.526,9,1,0,1,8,3,5,0,0.0,0.0
1011,1113,25-09-2019 00:44:00,0,2746.0,2490.0,0.907,13.576,0,0,0,0,0,0,0,0,0.0,0.0
1011,1114,25-09-2019 00:46:00,0,2546.0,2342.0,0.92,12.625,45,22,3,19,23,9,14,0,0.01,0.0
1011,1115,25-09-2019 00:48:00,0,2549.5,2339.0,0.9175,12.636,73,31,8,23,42,23,19,0,0.0,0.0
1011,1116,25-09-2019 00:50:00,0,2553.0,2336.0,0.915,12.647,18,10,6,4,8,3,5,0,0.0,0.0
1011,1117,25-09-2019 00:52:00,0,2462.0,2267.0,0.921,12.211,5,2,2,0,3,1,2,0,0.0,0.0
1011,1118,25-09-2019 00:54:00,0,2232.0,2172.0,0.973,11.198,0,0,0,0,0,0,0,0,0.0,0.0
1011,1119,25-09-2019 00:56:00,0,2244.0,2175.0,0.969,11.251,17,11,7,4,6,3,3,0,0.0,0.0
1011,1120,25-09-2019 00:58:00,0,2243.0,2181.0,0.972,11.251,0,0,0,0,0,0,0,0,0.0,0.0
1011,1121,25-09-2019 01:00:00,0,2254.0,2157.0,0.957,11.27,41,18,9,9,23,8,15,0,0.0,0.0
1011,1122,25-09-2019 01:02:00,0,2247.0,2150.0,0.957,11.235,36,0,0,0,36,0,36,0,0.0,0.0
1011,1123,25-09-2019 01:04:00,0,2251.0,2128.0,0.945,11.224,13,2,0,2,11,1,10,0,0.0,0.0
1011,1124,25-09-2019 01:06:00,0,2229.0,2226.0,0.999,11.247,7,1,1,0,6,1,5,0,0.0,0.0
1011,1125,25-09-2019 01:08:00,0,2430.0,2346.0,0.965,12.172,1,0,0,0,1,0,1,0,0.0,0.0
1011,1126,25-09-2019 01:10:00,0,2433.0,2374.0,0.976,12.213,8,0,0,0,8,0,8,0,0.0,0.0
1011,1127,25-09-2019 01:12:00,0,2224.0,2237.0,1.006,11.237,158,55,37,18,103,69,34,9,0.0,0.0
1011,1128,25-09-2019 01:14:00,0,2500.0,2494.0,0.997,12.612,447,296,239,57,151,110,41,123,0.0,0.0
1011,1129,25-09-2019 01:16:00,0,2724.0,2601.0,0.955,13.614,506,322,272,50,184,132,52,150,0.0,0.0
1011,1130,25-09-2019 01:18:00,0,2685.0,2743.0,1.022,13.615,542,287,234,53,255,187,68,131,0.0,0.0
1011,1131,25-09-2019 01:20:00,0,3092.0,2994.0,0.968,15.497,263,167,125,42,96,65,31,82,0.0,0.0
1011,1132,25-09-2019 01:22:00,0,3140.0,2986.0,0.951,15.677,141,64,30,34,77,35,42,5,0.0,0.0
1011,1133,25-09-2019 01:24:00,0,3188.0,2978.0,0.934,15.857,222,130,88,42,92,57,35,40,0.0,0.0
1011,1134,25-09-2019 01:26:00,0,3182.0,3084.0,0.969,15.951,271,140,115,25,131,97,34,34,0.0,0.04
1011,1135,25-09-2019 01:28:00,0,3169.0,3146.0,0.993,15.967,159,122,76,46,37,21,16,67,0.0,0.0
1011,1136,25-09-2019 01:30:00,0,3180.0,3082.0,0.969,15.943,163,118,83,35,45,31,14,70,0.0,0.0
1011,1137,25-09-2019 01:32:00,0,3212.0,2980.0,0.928,15.954,211,151,103,48,60,37,23,61,0.0,0.0
1011,1138,25-09-2019 01:34:00,0,3173.0,3104.0,0.978,15.939,94,44,22,22,50,24,26,0,0.0,0.0
1011,1139,25-09-2019 01:36:00,0,3103.0,2905.0,0.936,15.44,95,37,24,13,58,33,25,0,0.0,0.0
1011,1140,25-09-2019 01:38:00,0,2992.0,2865.0,0.957,14.959,75,32,2,30,43,15,28,0,0.0,0.0
1011,1141,25-09-2019 01:40:00,0,3194.0,2990.0,0.936,15.896,21,14,2,12,7,0,7,0,0.0,0.0
1011,1142,25-09-2019 01:42:00,0,2889.0,2865.0,0.992,14.556,4,2,1,1,2,0,2,0,0.01,0.0
1011,1143,25-09-2019 01:44:00,0,2700.0,2650.0,0.982,13.572,0,0,0,0,0,0,0,0,0.0,0.0
1011,1144,25-09-2019 01:46:00,0,2733.0,2520.0,0.922,13.557,21,8,3,5,13,5,8,0,0.0,0.0
1011,1145,25-09-2019 01:48:00,0,2541.0,2367.0,0.932,12.63,18,6,2,4,12,5,7,0,0.0,0.0
1011,1146,25-09-2019 01:50:00,0,2557.0,2322.0,0.908,12.643,2,0,0,0,2,0,2,0,0.0,0.0
1011,1147,25-09-2019 01:52:00,0,2334.0,2298.0,0.984,11.74,5,1,1,0,4,0,4,0,0.0,0.0
1011,1148,25-09-2019 01:54:00,0,2242.0,2197.0,0.98,11.265,0,0,0,0,0,0,0,0,0.0,0.0
1011,1149,25-09-2019 01:56:00,0,2255.5,2153.5,0.955,11.2705,2,0,0,0,2,1,1,0,0.0,0.0
1011,1150,25-09-2019 01:58:00,0,2269.0,2110.0,0.93,11.276,11,1,0,1,10,8,2,0,0.0,0.0
1011,1151,25-09-2019 02:00:00,0,2247.0,2157.0,0.96,11.24,56,15,5,10,41,13,28,0,0.0,0.0
1011,1152,25-09-2019 02:02:00,0,2255.0,2126.0,0.943,11.24,7,0,0,0,7,0,7,0,0.0,0.01
1011,1153,25-09-2019 02:04:00,0,2053.0,2007.0,0.977,10.312,6,0,0,0,6,1,5,0,0.0,0.0
1011,1154,25-09-2019 02:06:00,0,2072.0,1943.0,0.938,10.314,17,3,2,1,14,7,7,0,0.0,0.0
1011,1155,25-09-2019 02:08:00,0,2163.0,2032.0,0.94,10.771,4,2,1,1,2,0,2,0,0.0,0.0
1011,1156,25-09-2019 02:10:00,0,2431.0,2368.0,0.974,12.2,41,17,8,9,24,17,7,0,0.0,0.0
1011,1157,25-09-2019 02:12:00,0,2426.0,2346.0,0.967,12.156,0,0,0,0,0,0,0,0,0.0,0.0
1011,1158,25-09-2019 02:14:00,0,2262.0,2112.0,0.934,11.249,0,0,0,0,0,0,0,0,0.0,0.0
1011,1159,25-09-2019 02:16:00,0,2261.0,2105.0,0.931,11.238,0,0,0,0,0,0,0,0,0.0,0.01
1011,1160,25-09-2019 02:18:00,0,2255.0,2125.0,0.942,11.238,0,0,0,0,0,0,0,0,0.0,0.0
1011,1161,25-09-2019 02:20:00,0,2252.0,2147.0,0.954,11.248,32,14,8,6,18,11,7,0,0.0,0.0
1011,1162,25-09-2019 02:22:00,0,2243.0,2187.0,0.975,11.258,383,239,177,62,144,112,32,87,0.0,0.02
1011,1163,25-09-2019 02:24:00,0,2520.0,2445.0,0.97,12.637,222,132,96,36,90,63,27,85,0.0,0.0
1011,1164,25-09-2019 02:26:00,0,2689.0,2695.0,1.002,13.577,307,154,110,44,153,117,36,81,0.0,0.0
1011,1165,25-09-2019 02:28:00,0,2898.0,2837.0,0.979,14.559,197,116,86,30,81,51,30,93,0.0,0.0
1011,1166,25-09-2019 02:30:00,0,3040.5,2934.0,0.9655,15.228,132,52,23,29,80,32,48,61,0.02,0.0
1011,1167,25-09-2019 02:32:00,0,3183.0,3031.0,0.952,15.897,115,28,13,15,87,33,54,63,0.0,0.0
1011,1168,25-09-2019 02:34:00,0,3392.0,3162.0,0.932,16.867,162,68,47,21,94,52,42,50,0.0,0.03
1011,1169,25-09-2019 02:36:00,0,3101.0,2930.0,0.945,15.46,159,96,56,40,63,42,21,73,0.0,0.01
1011,1170,25-09-2019 02:38:00,0,3392.0,3210.0,0.947,16.917,276,169,129,40,107,67,40,46,0.0,0.0
1011,1171,25-09-2019 02:40:00,0,3174.0,3132.0,0.987,15.971,233,176,134,42,57,29,28,70,0.05,0.0
1011,1172,25-09-2019 02:42:00,0,3359.0,3305.0,0.984,16.895,228,120,84,36,108,61,47,85,0.0,0.0
1011,1173,25-09-2019 02:44:00,0,3873.0,3620.0,0.935,19.269,159,51,30,21,108,62,46,59,0.0,0.0
1011,1174,25-09-2019 02:46:00,0,3647.0,3525.0,0.966,18.273,166,59,35,24,107,55,52,57,0.0,0.06
1011,1175,25-09-2019 02:48:00,0,3648.0,3505.0,0.961,18.252,234,85,57,28,149,102,47,39,0.11,0.08
1011,1176,25-09-2019 02:50:00,0,3265.0,3151.0,0.965,16.352,514,366,304,62,148,112,36,103,0.07,0.05
1011,1177,25-09-2019 02:52:00,0,2882.0,2837.0,0.984,14.497,534,319,254,65,215,169,46,90,0.0,0.0
1011,1178,25-09-2019 02:54:00,0,3393.0,3180.0,0.937,16.889,335,195,149,46,140,106,34,78,0.0,0.0
1011,1179,25-09-2019 02:56:00,0,3359.0,3311.0,0.986,16.9,173,135,94,41,38,22,16,56,0.05,0.0
1011,1180,25-09-2019 02:58:00,0,3453.0,3366.0,0.975,17.332,129,94,51,43,35,18,17,64,0.01,0.04
1011,1181,25-09-2019 03:00:00,0,3749.0,3575.0,0.954,18.727,168,80,44,36,88,49,39,66,0.0,0.0
1011,1182,25-09-2019 03:02:00,0,3855.0,3656.0,0.948,19.238,142,51,26,25,91,53,38,43,0.08,0.12
1011,1183,25-09-2019 03:04:00,0,3607.5,3458.5,0.959,18.044,285,154,113,41,131,93,38,11,0.05,0.0
1011,1184,25-09-2019 03:06:00,0,3360.0,3261.0,0.97,16.85,111,51,26,25,60,31,29,0,0.0,0.0
1011,1185,25-09-2019 03:08:00,0,3379.0,3245.0,0.96,16.906,72,22,6,16,50,22,28,0,0.01,0.0
1011,1186,25-09-2019 03:10:00,0,3174.0,3086.0,0.972,15.92,624,356,283,73,268,197,71,31,0.0,0.0
1011,1187,25-09-2019 03:12:00,0,3342.0,3292.0,0.985,16.814,577,314,246,68,263,198,65,29,0.05,0.0
1011,1188,25-09-2019 03:14:00,0,2938.0,2685.0,0.914,14.547,418,214,163,51,204,155,49,53,0.06,0.0
1011,1189,25-09-2019 03:16:00,0,3563.0,3427.0,0.962,17.83,294,120,86,34,174,126,48,0,0.01,0.01
1011,1190,25-09-2019 03:18:00,0,3362.0,3263.0,0.971,16.857,184,120,76,44,64,40,24,64,0.0,0.09
1011,1191,25-09-2019 03:20:00,0,3666.0,3434.0,0.937,18.247,139,65,37,28,74,20,54,66,0.0,0.0
1011,1192,25-09-2019 03:22:00,0,3644.0,3565.0,0.978,18.303,153,66,42,24,87,47,40,49,0.0,0.0
1011,1193,25-09-2019 03:24:00,0,3456.0,3368.0,0.974,17.346,320,178,136,42,142,106,36,85,0.0,0.01
1011,1194,25-09-2019 03:26:00,0,3211.0,2946.0,0.918,15.912,140,72,54,18,68,39,29,0,0.05,0.0
1011,1195,25-09-2019 03:28:00,0,3188.0,3062.0,0.96,15.952,162,55,20,35,107,64,43,0,0.0,0.0
1011,1196,25-09-2019 03:30:00,0,3180.0,3059.0,0.962,15.915,160,60,28,32,100,61,39,0,0.01,0.01
1011,1197,25-09-2019 03:32:00,0,3238.0,2885.0,0.891,15.951,43,6,1,5,37,13,24,0,0.0,0.0
1011,1198,25-09-2019 03:34:00,0,2926.0,2722.0,0.93,14.542,83,0,0,0,83,43,40,0,0.0,0.0
1011,1199,25-09-2019 03:36:00,0,2720.0,2567.0,0.944,13.558,60,0,0,0,60,13,47,0,0.0,0.0
1011,1200,25-09-2019 03:38:00,0,2633.0,2468.5,0.9375,13.106,45,6,1,5,39,18,21,0,0.0,0.0
1011,1201,25-09-2019 03:40:00,0,2546.0,2370.0,0.931,12.654,13,4,0,4,9,1,8,0,0.0,0.0
1011,1202,25-09-2019 03:42:00,0,2464.0,2237.0,0.908,12.186,10,0,0,0,10,0,10,0,0.0,0.0
1011,1203,25-09-2019 03:44:00,0,2240.0,2202.0,0.983,11.264,9,0,0,0,9,4,5,0,0.0,0.0
1011,1204,25-09-2019 03:46:00,0,2249.0,2161.0,0.961,11.253,13,0,0,0,13,0,13,0,0.0,0.0
1011,1205,25-09-2019 03:48:00,0,2253.0,2138.0,0.949,11.244,34,0,0,0,34,22,12,0,0.0,0.0
1011,1206,25-09-2019 03:50:00,0,2249.0,2129.0,0.947,11.218,12,0,0,0,12,1,11,0,0.0,0.0
1011,1207,25-09-2019 03:52:00,0,2259.0,2101.0,0.93,11.226,52,8,4,4,44,22,22,0,0.0,0.0
1011,1208,25-09-2019 03:54:00,0,2332.0,2299.0,0.986,11.734,10,0,0,0,10,0,10,0,0.0,0.0
1011,1209,25-09-2019 03:56:00,0,2427.0,2362.0,0.973,12.176,6,0,0,0,6,0,6,0,0.0,0.0
1011,1210,25-09-2019 03:58:00,0,2552.0,2373.0,0.93,12.682,8,0,0,0,8,0,8,0,0.0,0.0
1011,1211,25-09-2019 04:00:00,0,2340.0,2296.0,0.981,11.761,14,6,1,5,8,4,4,0,0.0,0.0
1011,1212,25-09-2019 04:02:00,0,2242.0,2156.0,0.961,11.221,10,1,0,1,9,4,5,0,0.0,0.0
1011,1213,25-09-2019 04:04:00,0,2248.0,2201.0,0.979,11.295,21,3,1,2,18,9,9,0,0.0,0.0
1011,1214,25-09-2019 04:06:00,0,2156.0,2035.0,0.944,10.748,2,0,0,0,2,2,0,0,0.0,0.02
1011,1215,25-09-2019 04:08:00,0,2068.0,1940.0,0.938,10.297,4,2,0,2,2,1,1,0,0.0,0.03
1011,1216,25-09-2019 04:10:00,0,2063.0,1967.0,0.953,10.305,1,0,0,0,1,0,1,0,0.0,0.0
1011,1217,25-09-2019 04:12:00,0,2062.5,1967.5,0.954,10.3045,0,0,0,0,0,0,0,0,0.0,0.0
1011,1218,25-09-2019 04:14:00,0,2062.0,1968.0,0.955,10.304,161,53,38,15,108,80,28,0,0.0,0.0
1011,1219,25-09-2019 04:16:00,0,2256.0,2128.0,0.943,11.244,29,10,6,4,19,10,9,0,0.0,0.0
1011,1220,25-09-2019 04:18:00,0,2422.0,2382.0,0.983,12.18,0,0,0,0,0,0,0,0,0.0,0.0
1011,1221,25-09-2019 04:20:00,0,2533.0,2433.0,0.96,12.673,8,0,0,0,8,5,3,0,0.0,0.0
1011,1222,25-09-2019 04:22:00,0,2202.0,2335.0,1.06,11.261,3,0,0,0,3,2,1,0,0.0,0.0
1011,1223,25-09-2019 04:24:00,0,2047.0,2040.0,0.997,10.321,22,3,0,3,19,12,7,0,0.0,0.0
1011,1224,25-09-2019 04:26:00,0,2069.0,1916.0,0.926,10.273,4,3,2,1,1,0,1,0,0.0,0.0
1011,1225,25-09-2019 04:28:00,0,2089.0,1881.0,0.901,10.312,0,0,0,0,0,0,0,0,0.0,0.0
1011,1226,25-09-2019 04:30:00,0,1984.0,1845.0,0.93,9.859,38,12,8,4,26,5,21,0,0.0,0.0
1011,1227,25-09-2019 04:32:00,0,2053.0,2016.0,0.982,10.32,16,7,3,4,9,4,5,0,0.0,0.0
1011,1228,25-09-2019 04:34:00,0,2243.0,2160.0,0.963,11.23,136,37,11,26,99,63,36,4,0.0,0.0
1011,1229,25-09-2019 04:36:00,0,2720.0,2587.0,0.951,13.581,175,55,28,27,120,85,35,1,0.0,0.0
1011,1230,25-09-2019 04:38:00,0,2700.0,2642.0,0.979,13.565,129,48,28,20,81,52,29,1,0.0,0.0
1011,1231,25-09-2019 04:40:00,0,2681.0,2793.0,1.042,13.653,361,206,169,37,155,125,30,102,0.0,0.0
1011,1232,25-09-2019 04:42:00,0,2688.0,2703.0,1.005,13.584,332,206,157,49,126,94,32,115,0.0,0.0
1011,1233,25-09-2019 04:44:00,0,2788.0,2773.0,0.995,14.054,194,85,52,33,109,66,43,11,0.0,0.0
1011,1234,25-09-2019 04:46:00,0,2841.5,2801.0,0.986,14.296,281,29,9,20,252,191,61,0,0.0,0.0
1011,1235,25-09-2019 04:48:00,0,2895.0,2829.0,0.977,14.538,104,25,11,14,79,42,37,0,0.0,0.0
1011,1236,25-09-2019 04:50:00,0,3210.0,2956.0,0.921,15.922,71,16,3,13,55,11,44,0,0.0,0.0
1011,1237,25-09-2019 04:52:00,0,2899.0,2834.0,0.977,14.56,63,26,18,8,37,21,16,6,0.01,0.0
1011,1238,25-09-2019 04:54:00,0,2911.0,2743.0,0.942,14.507,112,65,34,31,47,10,37,68,0.0,0.0
1011,1239,25-09-2019 04:56:00,0,3392.0,3152.0,0.929,16.854,110,64,33,31,46,17,29,49,0.0,0.04
1011,1240,25-09-2019 04:58:00,0,3183.0,3067.0,0.964,15.934,237,142,105,37,95,73,22,31,0.0,0.0
1011,1241,25-09-2019 05:00:00,0,3166.0,3117.0,0.984,15.923,277,162,121,41,115,80,35,95,0.05,0.0
1011,1242,25-09-2019 05:02:00,0,3372.0,3250.0,0.964,16.883,137,64,32,32,73,37,36,78,0.0,0.08
1011,1243,25-09-2019 05:04:00,0,3466.0,3358.0,0.969,17.374,162,95,60,35,67,33,34,66,0.01,0.06
1011,1244,25-09-2019 05:06:00,0,3661.0,3462.0,0.946,18.256,18,9,6,3,9,5,4,9,0.0,0.34
1011,1245,25-09-2019 05:08:00,0,3463.0,3348.0,0.967,17.353,221,111,80,31,110,82,28,10,0.02,0.01
1011,1246,25-09-2019 05:10:00,0,2995.0,2890.0,0.965,14.998,516,260,201,59,256,205,51,89,0.08,0.01
1011,1247,25-09-2019 05:12:00,0,3568.0,3367.0,0.944,17.783,432,239,182,57,193,151,42,88,0.07,0.0
1011,1248,25-09-2019 05:14:00,0,3187.0,3018.0,0.947,15.897,295,184,143,41,111,80,31,202,0.01,0.0
1011,1249,25-09-2019 05:16:00,0,3386.0,3189.0,0.942,16.871,110,60,37,23,50,25,25,56,0.05,0.0
1011,1250,25-09-2019 05:18:00,0,3385.0,3223.0,0.952,16.904,297,146,108,38,151,109,42,11,0.05,0.0
1011,1251,25-09-2019 05:20:00,0,3369.5,3269.5,0.9705,16.894,506,276,218,58,230,170,60,149,0.0,0.0
1011,1252,25-09-2019 05:22:00,0,3354.0,3316.0,0.989,16.884,348,112,85,27,236,176,60,41,0.06,0.0
1011,1253,25-09-2019 05:24:00,0,3385.0,3164.0,0.935,16.839,76,49,39,10,27,18,9,15,0.0,0.0
1011,1254,25-09-2019 05:26:00,0,3683.0,3425.0,0.93,18.302,469,223,173,50,246,184,62,10,0.02,0.03
1011,1255,25-09-2019 05:28:00,0,3386.0,3176.0,0.938,16.858,242,136,106,30,106,67,39,6,0.05,0.0
1011,1256,25-09-2019 05:30:00,0,3384.0,3191.0,0.943,16.864,315,187,144,43,128,101,27,9,0.0,0.0
1011,1257,25-09-2019 05:32:00,0,3344.0,3320.0,0.993,16.851,148,66,41,25,82,60,22,2,0.0,0.0
1011,1258,25-09-2019 05:34:00,0,3229.0,2882.0,0.893,15.912,67,17,4,13,50,18,32,0,0.0,0.0
1011,1259,25-09-2019 05:36:00,0,3233.0,2871.0,0.888,15.917,49,12,3,9,37,15,22,0,0.0,0.0
1011,1260,25-09-2019 05:38:00,0,3224.0,2891.0,0.896,15.904,54,2,1,1,52,28,24,0,0.0,0.0
1011,1261,25-09-2019 05:40:00,0,3232.0,2896.0,0.896,15.941,0,0,0,0,0,0,0,0,0.0,0.0
1011,1262,25-09-2019 05:42:00,0,2934.0,2656.0,0.905,14.499,0,0,0,0,0,0,0,0,0.0,0.0
1011,1263,25-09-2019 05:44:00,0,2739.0,2511.0,0.917,13.574,50,3,2,1,47,29,18,0,0.0,0.0
1011,1264,25-09-2019 05:46:00,0,2734.0,2507.0,0.917,13.548,3,0,0,0,3,0,3,0,0.0,0.0
1011,1265,25-09-2019 05:48:00,0,2742.0,2515.0,0.917,13.587,33,4,0,4,29,10,19,0,0.0,0.01
1011,1266,25-09-2019 05:50:00,0,2662.0,2399.0,0.901,13.145,20,0,0,0,20,0,20,0,0.0,0.0
1011,1267,25-09-2019 05:52:00,0,2567.0,2291.0,0.892,12.651,36,9,2,7,27,14,13,0,0.0,0.02
1011,1268,25-09-2019 05:54:00,0,2445.5,2295.0,0.9405,12.177,0,0,0,0,0,0,0,0,0.0,0.0
1011,1269,25-09-2019 05:56:00,0,2324.0,2299.0,0.989,11.703,2,2,0,2,0,0,0,0,0.0,0.03
1011,1270,25-09-2019 05:58:00,0,2331.0,2263.0,0.971,11.688,34,14,2,12,20,13,7,0,0.0,0.0
1011,1271,25-09-2019 06:00:00,1,2331.0,2296.0,0.985,11.725,0,0,0,0,0,0,0,0,0.0,0.0
1011,1272,25-09-2019 06:02:00,1,2240.0,2181.0,0.974,11.241,0,0,0,0,0,0,0,0,0.0,0.0
1011,1273,25-09-2019 06:04:00,1,2245.0,2142.0,0.954,11.218,10,1,0,1,9,4,5,0,0.0,0.0
1011,1274,25-09-2019 06:06:00,1,2344.0,2259.0,0.964,11.736,38,10,6,4,28,14,14,0,0.0,0.0
1011,1275,25-09-2019 06:08:00,1,2343.0,2251.0,0.961,11.725,263,120,88,32,143,108,35,26,0.0,0.0
1011,1276,25-09-2019 06:10:00,1,2688.0,2728.0,1.015,13.611,215,141,100,41,74,50,24,95,0.0,0.0
1011,1277,25-09-2019 06:12:00,1,2667.0,2775.0,1.041,13.582,224,127,85,42,97,68,29,26,0.0,0.0
1011,1278,25-09-2019 06:14:00,1,2690.0,2733.0,1.016,13.623,167,82,50,32,85,63,22,10,0.0,0.0
1011,1279,25-09-2019 06:16:00,1,2701.0,2679.0,0.992,13.609,88,22,1,21,66,30,36,1,0.0,0.0
1011,1280,25-09-2019 06:18:00,1,2524.0,2440.0,0.967,12.644,73,25,7,18,48,18,30,0,0.0,0.0
1011,1281,25-09-2019 06:20:00,1,2716.0,2606.0,0.96,13.584,173,79,55,24,94,55,39,0,0.0,0.0
1011,1282,25-09-2019 06:22:00,1,2706.0,2645.0,0.978,13.589,353,137,96,41,216,159,57,11,0.0,0.0
1011,1283,25-09-2019 06:24:00,1,2696.0,2678.0,0.993,13.587,438,278,205,73,160,118,42,2,0.0,0.0
1011,1284,25-09-2019 06:26:00,1,2696.0,2697.0,1.001,13.607,143,63,21,42,80,46,34,0,0.0,0.0
1011,1285,25-09-2019 06:28:00,1,2707.5,2653.0,0.9805,13.605,100,40,19,21,60,33,27,0,0.0,0.0
1011,1286,25-09-2019 06:30:00,1,2719.0,2609.0,0.96,13.603,17,8,3,5,9,4,5,0,0.0,0.0
1011,1287,25-09-2019 06:32:00,1,2437.0,2352.0,0.965,12.207,0,0,0,0,0,0,0,0,0.01,0.0
1011,1288,25-09-2019 06:34:00,1,2364.0,2181.0,0.922,11.729,4,2,1,1,2,0,2,0,0.0,0.0
1011,1289,25-09-2019 06:36:00,1,2243.0,2143.0,0.956,11.21,9,2,0,2,7,1,6,0,0.0,0.0
1011,1290,25-09-2019 06:38:00,1,2247.0,2150.0,0.957,11.232,3,2,1,1,1,0,1,0,0.0,0.0
1011,1291,25-09-2019 06:40:00,1,2245.0,2188.0,0.975,11.268,35,13,6,7,22,14,8,0,0.0,0.0
1011,1292,25-09-2019 06:42:00,1,2342.0,2243.0,0.958,11.708,1,1,1,0,0,0,0,0,0.0,0.0
1011,1293,25-09-2019 06:44:00,1,2243.0,2179.0,0.971,11.251,4,0,0,0,4,0,4,0,0.0,0.0
1011,1294,25-09-2019 06:46:00,1,2137.0,2136.0,0.999,10.784,0,0,0,0,0,0,0,0,0.0,0.0
1011,1295,25-09-2019 06:48:00,1,2025.0,2127.0,1.05,10.332,2,0,0,0,2,2,0,0,0.0,0.0
1011,1296,25-09-2019 06:50:00,1,2127.0,2161.0,1.016,10.772,20,2,1,1,18,14,4,0,0.0,0.0
1011,1297,25-09-2019 06:52:00,1,2136.0,2145.0,1.004,10.791,22,20,0,20,2,1,1,0,0.0,0.0
1011,1298,25-09-2019 06:54:00,1,2035.0,2068.0,1.016,10.308,5,0,0,0,5,2,3,0,0.0,0.0
1011,1299,25-09-2019 06:56:00,1,2026.0,2100.0,1.036,10.306,32,6,3,3,26,11,15,0,0.0,0.0
1011,1300,25-09-2019 06:58:00,1,2334.0,2283.0,0.978,11.722,8,0,0,0,8,2,6,0,0.0,0.0
1011,1301,25-09-2019 07:00:00,1,2337.0,2234.0,0.956,11.682,1,0,0,0,1,0,1,0,0.0,0.0
1011,1302,25-09-2019 07:02:00,1,2180.0,2170.0,0.9985,10.9925,7,0,0,0,7,1,6,0,0.0,0.0
1011,1303,25-09-2019 07:04:00,1,2023.0,2106.0,1.041,10.303,7,2,1,1,5,2,3,0,0.0,0.0
1011,1304,25-09-2019 07:06:00,1,2229.0,2209.0,0.991,11.229,13,1,0,1,12,5,7,0,0.0,0.0
1011,1305,25-09-2019 07:08:00,1,2026.0,2124.0,1.048,10.334,0,0,0,0,0,0,0,0,0.0,0.0
1011,1306,25-09-2019 07:10:00,1,2042.0,2031.0,0.994,10.294,0,0,0,0,0,0,0,0,0.0,0.0
1011,1307,25-09-2019 07:12:00,1,2032.0,2082.0,1.024,10.312,32,10,5,5,22,14,8,0,0.0,0.0
1011,1308,25-09-2019 07:14:00,1,2356.0,2202.0,0.935,11.719,0,0,0,0,0,0,0,0,0.0,0.0
1011,1309,25-09-2019 07:16:00,1,2328.0,2286.0,0.982,11.703,0,0,0,0,0,0,0,0,0.0,0.0
1011,1310,25-09-2019 07:18:00,1,2342.0,2220.0,0.948,11.686,0,0,0,0,0,0,0,0,0.0,0.0
1011,1311,25-09-2019 07:20:00,1,2021.0,2134.0,1.056,10.325,30,18,6,12,12,10,2,0,0.0,0.0
1011,1312,25-09-2019 07:22:00,1,2035.0,2072.0,1.018,10.311,33,12,7,5,21,16,5,0,0.0,0.0
1011,1313,25-09-2019 07:24:00,1,2041.0,2059.0,1.009,10.321,0,0,0,0,0,0,0,0,0.0,0.0
1011,1314,25-09-2019 07:26:00,1,2137.0,2129.0,0.996,10.775,5,5,2,3,0,0,0,0,0.0,0.0
1011,1315,25-09-2019 07:28:00,1,2032.0,2079.0,1.023,10.308,6,6,2,4,0,0,0,0,0.0,0.0
1011,1316,25-09-2019 07:30:00,1,2035.0,2085.0,1.024,10.327,0,0,0,0,0,0,0,0,0.0,0.0
1011,1317,25-09-2019 07:32:00,1,2030.0,2098.0,1.034,10.322,7,7,0,7,0,0,0,0,0.0,0.0
1011,1318,25-09-2019 07:34:00,1,2032.0,2074.0,1.021,10.302,10,10,3,7,0,0,0,0,0.0,0.0
1011,1319,25-09-2019 07:36:00,1,2086.5,2094.0,1.004,10.5395,3,3,0,3,0,0,0,0,0.0,0.0
1011,1320,25-09-2019 07:38:00,1,2141.0,2114.0,0.987,10.777,2,2,0,2,0,0,0,0,0.0,0.0
1011,1321,25-09-2019 07:40:00,1,2250.0,2183.0,0.97,11.28,1,1,0,1,0,0,0,0,0.0,0.0
1011,1322,25-09-2019 07:42:00,1,2366.0,2189.0,0.925,11.744,3,3,1,2,0,0,0,0,0.0,0.0
1011,1323,25-09-2019 07:44:00,1,2247.0,2152.0,0.958,11.234,4,4,1,3,0,0,0,0,0.0,0.0
1011,1324,25-09-2019 07:46:00,1,2253.0,2152.0,0.955,11.258,4,4,2,2,0,0,0,0,0.0,0.0
1011,1325,25-09-2019 07:48:00,1,2257.0,2148.0,0.952,11.27,0,0,0,0,0,0,0,0,0.0,0.0
1011,1326,25-09-2019 07:50:00,1,2143.0,2088.0,0.974,10.753,0,0,0,0,0,0,0,0,0.0,0.0
1011,1327,25-09-2019 07:52:00,1,2050.0,2024.0,0.987,10.318,125,35,7,28,90,45,45,0,0.0,0.0
1011,1328,25-09-2019 07:54:00,1,2320.0,2312.0,0.996,11.702,68,29,11,18,39,25,14,0,0.0,0.0
1011,1329,25-09-2019 07:56:00,1,2443.0,2328.0,0.953,12.202,315,0,0,0,315,254,61,0,0.0,0.0
1011,1330,25-09-2019 07:58:00,1,2537.0,2388.0,0.941,12.638,221,111,78,33,110,77,33,20,0.0,0.0
1011,1331,25-09-2019 08:00:00,1,2728.0,2584.0,0.947,13.608,261,141,101,40,120,87,33,28,0.0,0.0
1011,1332,25-09-2019 08:02:00,1,2614.0,2563.0,0.98,13.135,190,130,96,34,60,42,18,163,0.0,0.0
1011,1333,25-09-2019 08:04:00,1,2708.0,2608.0,0.963,13.557,218,134,96,38,84,55,29,12,0.0,0.0
1011,1334,25-09-2019 08:06:00,1,2503.0,2526.0,1.009,12.656,75,59,39,20,16,10,6,0,0.0,0.0
1011,1335,25-09-2019 08:08:00,1,2616.0,2526.0,0.965,13.105,61,33,8,25,28,6,22,0,0.0,0.0
1011,1336,25-09-2019 08:10:00,1,2563.5,2510.0,0.979,12.88,102,76,46,30,26,13,13,0,0.0,0.0
1011,1337,25-09-2019 08:12:00,1,2511.0,2494.0,0.993,12.655,65,37,12,25,28,7,21,0,0.0,0.0
1011,1338,25-09-2019 08:14:00,1,2538.0,2401.0,0.946,12.658,107,58,32,26,49,21,28,0,0.0,0.0
1011,1339,25-09-2019 08:16:00,1,2547.0,2369.0,0.93,12.658,35,28,13,15,7,3,4,0,0.0,0.0
1011,1340,25-09-2019 08:18:00,1,2537.0,2444.0,0.963,12.702,21,18,0,18,3,0,3,0,0.0,0.0
1011,1341,25-09-2019 08:20:00,1,2548.0,2346.0,0.921,12.636,49,28,9,19,21,13,8,0,0.0,0.0
1011,1342,25-09-2019 08:22:00,1,2344.0,2244.0,0.957,11.717,13,0,0,0,13,0,13,0,0.0,0.0
1011,1343,25-09-2019 08:24:00,1,2046.0,2033.0,0.994,10.311,3,0,0,0,3,0,3,0,0.0,0.0
1011,1344,25-09-2019 08:26:00,1,2074.0,1938.0,0.934,10.319,1,0,0,0,1,0,1,0,0.0,0.0
1011,1345,25-09-2019 08:28:00,1,2097.0,1859.0,0.887,10.319,1,0,0,0,1,0,1,0,0.0,0.0
1011,1346,25-09-2019 08:30:00,1,1871.0,1809.0,0.967,9.373,13,2,0,2,11,0,11,0,0.0,0.0
1011,1347,25-09-2019 08:32:00,1,2088.0,1882.0,0.902,10.31,3,0,0,0,3,2,1,0,0.01,0.0
1011,1348,25-09-2019 08:34:00,1,2064.0,1958.0,0.948,10.302,1,0,0,0,1,0,1,0,0.0,0.0
1011,1349,25-09-2019 08:36:00,1,2065.0,1945.0,0.942,10.289,1,0,0,0,1,0,1,0,0.0,0.0
1011,1350,25-09-2019 08:38:00,1,1974.0,1877.0,0.951,9.857,1,0,0,0,1,0,1,0,0.0,0.0
1011,1351,25-09-2019 08:40:00,1,1983.0,1836.0,0.926,9.844,4,3,1,2,1,0,1,0,0.0,0.0
1011,1352,25-09-2019 08:42:00,1,2095.0,1875.0,0.895,10.331,18,13,6,7,5,2,3,0,0.0,0.0
1011,1353,25-09-2019 08:44:00,1,2035.5,1862.0,0.915,10.0825,10,7,0,7,3,1,2,0,0.0,0.0
1011,1354,25-09-2019 08:46:00,1,1976.0,1849.0,0.935,9.834,9,7,0,7,2,1,1,0,0.0,0.0
1011,1355,25-09-2019 08:48:00,1,2093.0,1869.0,0.893,10.315,21,9,0,9,12,4,8,0,0.0,0.0
1011,1356,25-09-2019 08:50:00,1,2086.0,1874.0,0.898,10.292,4,3,0,3,1,0,1,0,0.0,0.0
1011,1357,25-09-2019 08:52:00,1,2087.0,1869.0,0.896,10.29,2,2,0,2,0,0,0,0,0.0,0.0
1011,1358,25-09-2019 08:54:00,1,2087.0,1847.0,0.885,10.268,27,16,10,6,11,5,6,0,0.0,0.0
1011,1359,25-09-2019 08:56:00,1,2073.0,1956.0,0.944,10.332,2,0,0,0,2,1,1,0,0.0,0.0
1011,1360,25-09-2019 08:58:00,1,2077.0,1938.0,0.933,10.33,27,14,9,5,13,8,5,0,0.0,0.0
1011,1361,25-09-2019 09:00:00,1,2058.0,1988.0,0.966,10.311,0,0,0,0,0,0,0,0,0.0,0.0
1011,1362,25-09-2019 09:02:00,1,2088.0,1842.0,0.882,10.268,0,0,0,0,0,0,0,0,0.0,0.0
1011,1363,25-09-2019 09:04:00,1,1893.0,1751.0,0.925,9.398,1,1,0,1,0,0,0,0,0.0,0.0
1011,1364,25-09-2019 09:06:00,1,2110.0,1816.0,0.861,10.324,4,4,0,4,0,0,0,0,0.0,0.0
1011,1365,25-09-2019 09:08:00,1,2072.0,1904.0,0.919,10.273,1,1,0,1,0,0,0,0,0.0,0.0
1011,1366,25-09-2019 09:10:00,1,2097.0,1832.0,0.874,10.291,0,0,0,0,0,0,0,0,0.0,0.0
1011,1367,25-09-2019 09:12:00,1,2099.0,1802.0,0.859,10.266,0,0,0,0,0,0,0,0,0.0,0.0
1011,1368,25-09-2019 09:14:00,1,2119.0,1789.0,0.844,10.331,8,3,0,3,5,2,3,0,0.0,0.0
1011,1369,25-09-2019 09:16:00,1,2075.0,1920.0,0.925,10.302,65,51,22,29,14,0,14,0,0.0,0.0
1011,1370,25-09-2019 09:18:00,1,2082.5,1899.5,0.912,10.3095,16,12,3,9,4,1,3,0,0.0,0.0
1011,1371,25-09-2019 09:20:00,1,2090.0,1879.0,0.899,10.317,60,39,13,26,21,10,11,0,0.0,0.0
1011,1372,25-09-2019 09:22:00,1,2173.0,1980.0,0.911,10.755,58,34,5,29,24,9,15,0,0.0,0.0
1011,1373,25-09-2019 09:24:00,1,2364.0,2151.0,0.91,11.695,80,42,23,19,38,20,18,19,0.0,0.0
1011,1374,25-09-2019 09:26:00,1,2575.0,2272.0,0.882,12.662,78,64,37,27,14,6,8,64,0.0,0.0
1011,1375,25-09-2019 09:28:00,1,2760.0,2453.0,0.889,13.589,95,75,45,30,20,6,14,47,0.0,0.0
1011,1376,25-09-2019 09:30:00,1,2763.0,2439.0,0.883,13.588,235,158,124,34,77,58,19,30,0.0,0.0
1011,1377,25-09-2019 09:32:00,1,3033.0,2712.0,0.894,14.952,195,92,65,27,103,81,22,76,0.06,0.0
1011,1378,25-09-2019 09:34:00,1,2738.0,2511.0,0.917,13.568,268,181,143,38,87,61,26,86,0.0,0.0
1011,1379,25-09-2019 09:36:00,1,3046.0,2695.0,0.885,14.985,255,151,106,45,104,72,32,15,0.0,0.0
1011,1380,25-09-2019 09:38:00,1,2558.0,2316.0,0.905,12.644,192,127,100,27,65,51,14,18,0.0,0.0
1011,1381,25-09-2019 09:40:00,1,2348.0,2218.0,0.945,11.706,126,54,44,10,72,51,21,13,0.01,0.0
1011,1382,25-09-2019 09:42:00,1,2532.0,2391.0,0.944,12.624,272,169,134,35,103,80,23,24,0.0,0.0
1011,1383,25-09-2019 09:44:00,1,2638.0,2484.0,0.942,13.143,118,45,23,22,73,42,31,11,0.0,0.0
1011,1384,25-09-2019 09:46:00,1,2746.0,2496.0,0.909,13.584,264,167,129,38,97,62,35,25,0.0,0.04
1011,1385,25-09-2019 09:48:00,1,2529.0,2442.0,0.965,12.666,248,123,90,33,125,99,26,27,0.0,0.0
1011,1386,25-09-2019 09:50:00,1,2517.0,2454.0,0.975,12.634,370,194,144,50,176,130,46,4,0.01,0.0
1011,1387,25-09-2019 09:52:00,1,2591.0,2394.0,0.9255,12.8595,265,158,120,38,107,77,30,6,0.0,0.0
1011,1388,25-09-2019 09:54:00,1,2665.0,2334.0,0.876,13.085,98,81,44,37,17,8,9,0,0.0,0.0
1011,1389,25-09-2019 09:56:00,1,2460.0,2239.0,0.91,12.169,29,25,5,20,4,0,4,0,0.0,0.0
1011,1390,25-09-2019 09:58:00,1,2474.0,2193.0,0.886,12.176,54,28,8,20,26,14,12,0,0.0,0.0
1011,1391,25-09-2019 10:00:00,1,2490.0,2154.0,0.865,12.194,2,1,0,1,1,0,1,0,0.0,0.0
1011,1392,25-09-2019 10:02:00,1,2184.0,1966.0,0.901,10.781,1,1,1,0,0,0,0,0,0.0,0.0
1011,1393,25-09-2019 10:04:00,1,2204.0,1880.0,0.853,10.766,3,2,1,1,1,0,1,0,0.0,0.0
1011,1394,25-09-2019 10:06:00,1,1985.0,1808.0,0.911,9.823,0,0,0,0,0,0,0,0,0.0,0.0
1011,1395,25-09-2019 10:08:00,1,2022.0,1674.0,0.828,9.821,0,0,0,0,0,0,0,0,0.0,0.0
1011,1396,25-09-2019 10:10:00,1,1797.0,1631.0,0.908,8.888,17,16,2,14,1,1,0,0,0.0,0.0
1011,1397,25-09-2019 10:12:00,1,1814.0,1612.0,0.889,8.933,34,34,11,23,0,0,0,0,0.0,0.0
1011,1398,25-09-2019 10:14:00,1,1926.0,1620.0,0.841,9.381,22,22,1,21,0,0,0,0,0.0,0.0
1011,1399,25-09-2019 10:16:00,1,2010.0,1704.0,0.848,9.806,31,13,4,9,18,10,8,0,0.0,0.0
1011,1400,25-09-2019 10:18:00,1,2183.0,1954.0,0.895,10.765,2,1,0,1,1,0,1,0,0.0,0.0
1011,1401,25-09-2019 10:20:00,1,2197.0,1897.0,0.863,10.756,11,4,0,4,7,0,7,0,0.0,0.0
1011,1402,25-09-2019 10:22:00,1,2016.0,1726.0,0.856,9.852,5,5,0,5,0,0,0,0,0.0,0.0
1011,1403,25-09-2019 10:24:00,1,2033.0,1655.0,0.814,9.843,1,1,0,1,0,0,0,0,0.0,0.0
1011,1404,25-09-2019 10:26:00,1,2138.5,1693.5,0.793,10.3015,43,22,6,16,21,10,11,0,0.0,0.0
1011,1405,25-09-2019 10:28:00,1,2244.0,1732.0,0.772,10.76,2,1,0,1,1,0,1,0,0.0,0.0
1011,1406,25-09-2019 10:30:00,1,2136.0,1692.0,0.792,10.291,2,2,0,2,0,0,0,0,0.0,0.0
1011,1407,25-09-2019 10:32:00,1,2142.0,1654.0,0.772,10.272,9,6,1,5,3,1,2,0,0.0,0.0
1011,1408,25-09-2019 10:34:00,1,2147.0,1658.0,0.772,10.294,8,4,0,4,4,3,1,0,0.0,0.0
1011,1409,25-09-2019 10:36:00,1,2148.0,1614.0,0.751,10.249,14,5,2,3,9,4,5,0,0.0,0.0
1011,1410,25-09-2019 10:38:00,1,2145.0,1673.0,0.78,10.305,11,6,3,3,5,2,3,0,0.0,0.0
1011,1411,25-09-2019 10:40:00,1,2321.0,1862.0,0.802,11.209,12,12,2,10,0,0,0,0,0.0,0.0
1011,1412,25-09-2019 10:42:00,1,2327.0,1867.0,0.802,11.238,22,4,3,1,18,12,6,0,0.0,0.0
1011,1413,25-09-2019 10:44:00,1,2336.0,1830.0,0.783,11.228,11,0,0,0,11,4,7,0,0.0,0.0
1011,1414,25-09-2019 10:46:00,1,2342.0,1776.0,0.758,11.195,35,0,0,0,35,3,32,0,0.0,0.0
1011,1415,25-09-2019 10:48:00,1,2344.0,1797.0,0.767,11.226,39,0,0,0,39,16,23,0,0.0,0.0
1011,1416,25-09-2019 10:50:00,1,2345.0,1775.0,0.757,11.207,213,0,0,0,213,187,26,0,0.0,0.0
1011,1417,25-09-2019 10:52:00,1,2364.0,1729.0,0.731,11.231,25,3,1,2,22,16,6,0,0.0,0.0
1011,1418,25-09-2019 10:54:00,1,2255.0,1688.0,0.748,10.755,94,32,11,21,62,42,20,0,0.0,0.0
1011,1419,25-09-2019 10:56:00,1,2370.0,1714.0,0.723,11.235,178,68,33,35,110,61,49,0,0.0,0.0
1011,1420,25-09-2019 10:58:00,1,2649.0,1982.0,0.748,12.63,63,24,10,14,39,21,18,0,0.0,0.0
1011,1421,25-09-2019 11:00:00,1,2689.0,2055.0,0.764,12.87,86,36,19,17,50,32,18,3,0.0,0.0
1011,1422,25-09-2019 11:02:00,1,2729.0,2128.0,0.78,13.11,92,70,33,37,22,11,11,68,0.01,0.0
1011,1423,25-09-2019 11:04:00,1,2796.0,2289.0,0.818,13.552,98,59,30,29,39,8,31,55,0.0,0.06
1011,1424,25-09-2019 11:06:00,1,3319.0,2548.0,0.768,15.9,126,81,56,25,45,26,19,49,0.0,0.0
1011,1425,25-09-2019 11:08:00,1,2997.0,2454.0,0.819,14.526,365,213,173,40,152,126,26,47,0.0,0.0
1011,1426,25-09-2019 11:10:00,1,2797.0,2298.0,0.822,13.563,527,323,248,75,204,144,60,0,0.0,0.0
1011,1427,25-09-2019 11:12:00,1,2990.0,2432.0,0.813,14.472,367,213,155,58,154,120,34,10,0.04,0.0
1011,1428,25-09-2019 11:14:00,1,2796.0,2311.0,0.827,13.573,488,281,206,75,207,155,52,46,0.01,0.04
1011,1429,25-09-2019 11:16:00,1,2800.0,2287.0,0.817,13.562,155,58,43,15,97,55,42,34,0.01,0.0
1011,1430,25-09-2019 11:18:00,1,2965.0,2566.0,0.866,14.524,408,251,187,64,157,115,42,5,0.0,0.0
1011,1431,25-09-2019 11:20:00,1,3258.0,2791.0,0.857,15.926,180,110,76,34,70,55,15,17,0.0,0.0
1011,1432,25-09-2019 11:22:00,1,2508.0,2078.0,0.829,12.181,44,42,14,28,2,1,1,0,0.0,0.0
1011,1433,25-09-2019 11:24:00,1,2596.0,2148.0,0.827,12.607,14,11,0,11,3,0,3,0,0.0,0.0
1011,1434,25-09-2019 11:26:00,1,2506.0,2065.0,0.824,12.161,0,0,0,0,0,0,0,0,0.0,0.0
1011,1435,25-09-2019 11:28:00,1,2296.0,1975.0,0.861,11.231,11,6,2,4,5,0,5,0,0.0,0.0
1011,1436,25-09-2019 11:30:00,1,2311.0,1923.0,0.832,11.233,0,0,0,0,0,0,0,0,0.0,0.0
1011,1437,25-09-2019 11:32:00,1,2320.0,1877.0,0.809,11.219,0,0,0,0,0,0,0,0,0.0,0.0
1011,1438,25-09-2019 11:34:00,1,2217.0,1835.5,0.829,10.7665,7,5,4,1,2,0,2,0,0.0,0.0
1011,1439,25-09-2019 11:36:00,1,2114.0,1794.0,0.849,10.314,6,0,0,0,6,0,6,0,0.0,0.0
1011,1440,25-09-2019 11:38:00,1,2112.0,1775.0,0.84,10.288,9,3,2,1,6,2,4,0,0.0,0.0
1011,1441,25-09-2019 11:40:00,1,2099.0,1826.0,0.87,10.293,0,0,0,0,0,0,0,0,0.0,0.0
1011,1442,25-09-2019 11:42:00,1,2103.0,1850.0,0.88,10.333,11,8,4,4,3,0,3,0,0.0,0.0
1011,1443,25-09-2019 11:44:00,1,2321.0,1877.0,0.809,11.224,0,0,0,0,0,0,0,0,0.0,0.0
1011,1444,25-09-2019 11:46:00,1,2205.0,1830.0,0.83,10.715,0,0,0,0,0,0,0,0,0.0,0.0
1011,1445,25-09-2019 11:48:00,1,2111.0,1804.0,0.854,10.316,2,2,1,1,0,0,0,0,0.0,0.0
1011,1446,25-09-2019 11:50:00,1,2127.0,1771.0,0.833,10.339,0,0,0,0,0,0,0,0,0.0,0.0
1011,1447,25-09-2019 11:52:00,1,2124.0,1717.0,0.808,10.27,3,3,2,1,0,0,0,0,0.0,0.0
1011,1448,25-09-2019 11:54:00,1,2122.0,1736.0,0.818,10.283,13,6,3,3,7,0,7,0,0.0,0.0
1011,1449,25-09-2019 11:56:00,1,2123.0,1737.0,0.818,10.287,0,0,0,0,0,0,0,0,0.0,0.0
1011,1450,25-09-2019 11:58:00,1,2135.0,1718.0,0.805,10.312,3,2,0,2,1,0,1,0,0.0,0.0
1011,1451,25-09-2019 12:00:00,1,2133.0,1691.0,0.793,10.277,0,0,0,0,0,0,0,0,0.0,0.0
1011,1452,25-09-2019 12:02:00,1,2121.0,1737.0,0.819,10.281,19,15,7,8,4,0,4,0,0.0,0.0
1011,1453,25-09-2019 12:04:00,1,2343.0,1808.0,0.772,11.233,2,0,0,0,2,1,1,0,0.0,0.0
1011,1454,25-09-2019 12:06:00,1,2342.0,1816.0,0.775,11.238,0,0,0,0,0,0,0,0,0.0,0.0
1011,1455,25-09-2019 12:08:00,1,2239.5,1756.5,0.7845,10.7675,3,0,0,0,3,0,3,0,0.0,0.0
1011,1456,25-09-2019 12:10:00,1,2137.0,1697.0,0.794,10.297,17,8,3,5,9,1,8,0,0.0,0.0
1011,1457,25-09-2019 12:12:00,1,2137.0,1667.0,0.78,10.267,1,0,0,0,1,0,1,0,0.0,0.0
1011,1458,25-09-2019 12:14:00,1,2155.0,1609.0,0.747,10.272,7,4,1,3,3,0,3,0,0.0,0.0
1011,1459,25-09-2019 12:16:00,1,2046.0,1589.0,0.777,9.821,0,0,0,0,0,0,0,0,0.0,0.0
1011,1460,25-09-2019 12:18:00,1,1935.0,1557.0,0.805,9.35,0,0,0,0,0,0,0,0,0.0,0.0
1011,1461,25-09-2019 12:20:00,1,1936.0,1547.0,0.799,9.341,3,3,1,2,0,0,0,0,0.0,0.0
1011,1462,25-09-2019 12:22:00,1,2161.0,1598.0,0.74,10.282,12,10,2,8,2,1,1,0,0.0,0.0
1011,1463,25-09-2019 12:24:00,1,2162.0,1583.0,0.732,10.27,3,2,0,2,1,1,0,0,0.0,0.0
1011,1464,25-09-2019 12:26:00,1,2151.0,1657.0,0.771,10.31,0,0,0,0,0,0,0,0,0.0,0.0
1011,1465,25-09-2019 12:28:00,1,2145.0,1633.0,0.761,10.26,34,23,10,13,11,9,2,0,0.0,0.0
1011,1466,25-09-2019 12:30:00,1,2319.0,1878.0,0.81,11.216,37,28,3,25,9,1,8,0,0.0,0.0
1011,1467,25-09-2019 12:32:00,1,2515.0,2034.0,0.809,12.159,44,35,10,25,9,0,9,0,0.0,0.0
1011,1468,25-09-2019 12:34:00,1,2613.0,2101.0,0.804,12.623,33,20,2,18,13,4,9,0,0.0,0.0
1011,1469,25-09-2019 12:36:00,1,2606.0,2121.0,0.814,12.616,188,126,94,32,62,39,23,46,0.0,0.0
1011,1470,25-09-2019 12:38:00,1,2805.0,2295.0,0.818,13.592,116,79,43,36,37,16,21,60,0.01,0.0
1011,1471,25-09-2019 12:40:00,1,2981.0,2508.0,0.841,14.522,97,38,19,19,59,25,34,60,0.0,0.0
1011,1472,25-09-2019 12:42:00,1,2990.0,2468.5,0.8255,14.514,337,226,177,49,111,84,27,76,0.0,0.05
1011,1473,25-09-2019 12:44:00,1,2999.0,2429.0,0.81,14.506,282,140,101,39,142,100,42,30,0.0,0.01
1011,1474,25-09-2019 12:46:00,1,2964.0,2551.0,0.861,14.502,333,183,143,40,150,104,46,51,0.03,0.0
1011,1475,25-09-2019 12:48:00,1,2973.0,2552.0,0.858,14.539,151,61,39,22,90,45,45,50,0.0,0.05
1011,1476,25-09-2019 12:50:00,1,2869.0,2482.0,0.865,14.052,345,250,185,65,95,65,30,3,0.0,0.0
1011,1477,25-09-2019 12:52:00,1,2564.0,2273.0,0.887,12.62,474,276,221,55,198,147,51,10,0.04,0.0
1011,1478,25-09-2019 12:54:00,1,2761.0,2450.0,0.888,13.59,209,134,93,41,75,58,17,7,0.01,0.02
1011,1479,25-09-2019 12:56:00,1,2589.0,2245.0,0.867,12.685,6,0,0,0,6,2,4,0,0.0,0.0
1011,1480,25-09-2019 12:58:00,1,2604.0,2153.0,0.827,12.642,66,53,27,26,13,2,11,0,0.0,0.0
1011,1481,25-09-2019 13:00:00,1,2678.0,2319.0,0.866,13.118,39,10,0,10,29,2,27,0,0.0,0.0
1011,1482,25-09-2019 13:02:00,1,2573.0,2249.0,0.874,12.629,0,0,0,0,0,0,0,0,0.0,0.0
1011,1483,25-09-2019 13:04:00,1,2605.0,2170.0,0.833,12.668,1,0,0,0,1,0,1,0,0.0,0.0
1011,1484,25-09-2019 13:06:00,1,2386.0,2065.0,0.865,11.685,0,0,0,0,0,0,0,0,0.0,0.0
1011,1485,25-09-2019 13:08:00,1,2299.0,1981.0,0.862,11.251,3,2,0,2,1,1,0,0,0.0,0.0
1011,1486,25-09-2019 13:10:00,1,2294.0,1983.0,0.864,11.235,6,6,0,6,0,0,0,0,0.0,0.0
1011,1487,25-09-2019 13:12:00,1,2285.0,2016.0,0.882,11.236,0,0,0,0,0,0,0,0,0.0,0.0
1011,1488,25-09-2019 13:14:00,1,2294.0,1970.0,0.859,11.22,1,1,0,1,0,0,0,0,0.0,0.0
1011,1489,25-09-2019 13:16:00,1,2198.5,1900.5,0.865,10.766,1,1,0,1,0,0,0,0,0.0,0.0
1011,1490,25-09-2019 13:18:00,1,2103.0,1831.0,0.871,10.312,0,0,0,0,0,0,0,0,0.0,0.0
1011,1491,25-09-2019 13:20:00,1,2123.0,1727.0,0.814,10.276,1,0,0,0,1,0,1,0,0.0,0.0
1011,1492,25-09-2019 13:22:00,1,2127.0,1732.0,0.814,10.297,0,0,0,0,0,0,0,0,0.0,0.0
1011,1493,25-09-2019 13:24:00,1,2014.0,1704.0,0.846,9.822,5,4,2,2,1,1,0,0,0.0,0.0
1011,1494,25-09-2019 13:26:00,1,2126.0,1730.0,0.814,10.294,0,0,0,0,0,0,0,0,0.0,0.0
1011,1495,25-09-2019 13:28:00,1,2019.0,1701.0,0.843,9.84,0,0,0,0,0,0,0,0,0.0,0.0
1011,1496,25-09-2019 13:30:00,1,2136.0,1726.0,0.808,10.326,0,0,0,0,0,0,0,0,0.0,0.0
1011,1497,25-09-2019 13:32:00,1,2116.0,1742.0,0.823,10.265,4,1,1,0,3,0,3,0,0.0,0.0
1011,1498,25-09-2019 13:34:00,1,1920.0,1627.0,0.847,9.367,0,0,0,0,0,0,0,0,0.0,0.0
1011,1499,25-09-2019 13:36:00,1,1830.0,1515.0,0.828,8.889,5,4,1,3,1,0,1,0,0.0,0.0
1011,1500,25-09-2019 13:38:00,1,1837.0,1485.0,0.809,8.881,3,2,1,1,1,0,1,0,0.0,0.0
1011,1501,25-09-2019 13:40:00,1,2034.0,1623.0,0.798,9.811,0,0,0,0,0,0,0,0,0.0,0.0
1011,1502,25-09-2019 13:42:00,1,2120.0,1746.0,0.824,10.285,9,1,0,1,8,1,7,0,0.0,0.0
1011,1503,25-09-2019 13:44:00,1,2339.0,1820.0,0.778,11.229,5,0,0,0,5,0,5,0,0.01,0.0
1011,1504,25-09-2019 13:46:00,1,2225.0,1775.0,0.798,10.731,0,0,0,0,0,0,0,0,0.0,0.0
1011,1505,25-09-2019 13:48:00,1,2339.0,1813.0,0.775,11.223,21,17,8,9,4,3,1,0,0.0,0.0
1011,1506,25-09-2019 13:50:00,1,2338.0,1829.0,0.7825,11.2365,5,0,0,0,5,1,4,0,0.0,0.0
1011,1507,25-09-2019 13:52:00,1,2337.0,1845.0,0.79,11.25,11,0,0,0,11,0,11,0,0.0,0.0
1011,1508,25-09-2019 13:54:00,1,2342.0,1796.0,0.767,11.217,22,9,5,4,13,5,8,0,0.0,0.0
1011,1509,25-09-2019 13:56:00,1,2329.0,1862.0,0.799,11.237,5,4,2,2,1,1,0,0,0.0,0.0
1011,1510,25-09-2019 13:58:00,1,2324.0,1885.0,0.811,11.242,7,6,3,3,1,0,1,0,0.0,0.0
1011,1511,25-09-2019 14:00:00,1,2319.0,1858.0,0.801,11.196,16,16,4,12,0,0,0,0,0.0,0.0
1011,1512,25-09-2019 14:02:00,1,2327.0,1864.0,0.801,11.231,2,2,1,1,0,0,0,0,0.0,0.0
1011,1513,25-09-2019 14:04:00,1,2334.0,1830.0,0.784,11.224,11,9,5,4,2,1,1,0,0.0,0.0
1011,1514,25-09-2019 14:06:00,1,2337.0,1855.0,0.794,11.261,10,8,5,3,2,1,1,0,0.0,0.0
1011,1515,25-09-2019 14:08:00,1,2345.0,1787.0,0.762,11.219,18,8,6,2,10,3,7,0,0.0,0.0
1011,1516,25-09-2019 14:10:00,1,2159.0,1635.0,0.758,10.316,0,0,0,0,0,0,0,0,0.0,0.0
1011,1517,25-09-2019 14:12:00,1,2052.0,1558.0,0.759,9.81,21,12,8,4,9,5,4,0,0.0,0.0
1011,1518,25-09-2019 14:14:00,1,2174.0,1569.0,0.722,10.302,21,18,2,16,3,1,2,0,0.0,0.0
1011,1519,25-09-2019 14:16:00,1,2061.0,1527.0,0.741,9.811,16,16,5,11,0,0,0,0,0.0,0.0
1011,1520,25-09-2019 14:18:00,1,2065.0,1511.0,0.732,9.808,7,6,1,5,1,0,1,0,0.0,0.0
1011,1521,25-09-2019 14:20:00,1,1949.0,1513.0,0.776,9.355,193,94,60,34,99,63,36,44,0.0,0.0
1011,1522,25-09-2019 14:22:00,1,2620.0,2051.0,0.783,12.593,103,41,22,19,62,23,39,56,0.0,0.0
1011,1523,25-09-2019 14:24:00,1,2706.5,2181.0,0.805,13.079,183,114,80,34,69,24,45,79,0.0,0.02
1011,1524,25-09-2019 14:26:00,1,2793.0,2311.0,0.827,13.565,86,34,13,21,52,15,37,53,0.01,0.0
1011,1525,25-09-2019 14:28:00,1,2796.0,2317.0,0.829,13.581,93,25,12,13,68,26,42,54,0.0,0.07
1011,1526,25-09-2019 14:30:00,1,2989.0,2466.0,0.825,14.508,166,117,75,42,49,30,19,0,0.0,0.0
1011,1527,25-09-2019 14:32:00,1,2577.0,2220.0,0.861,12.61,73,37,14,23,36,6,30,0,0.0,0.0
1011,1528,25-09-2019 14:34:00,1,2585.0,2239.0,0.866,12.664,74,35,13,22,39,10,29,0,0.0,0.01
1011,1529,25-09-2019 14:36:00,1,2581.0,2203.0,0.853,12.607,107,32,11,21,75,38,37,0,0.0,0.0
1011,1530,25-09-2019 14:38:00,1,2495.0,2099.0,0.841,12.156,73,29,5,24,44,15,29,0,0.0,0.0
1011,1531,25-09-2019 14:40:00,1,2585.0,2220.0,0.859,12.642,115,78,35,43,37,9,28,0,0.0,0.0
1011,1532,25-09-2019 14:42:00,1,2664.0,2327.0,0.873,13.073,86,63,35,28,23,6,17,0,0.0,0.0
1011,1533,25-09-2019 14:44:00,1,2762.0,2441.0,0.884,13.585,105,80,44,36,25,9,16,0,0.0,0.0
1011,1534,25-09-2019 14:46:00,1,2771.0,2403.0,0.867,13.579,2,1,0,1,1,1,0,0,0.0,0.0
1011,1535,25-09-2019 14:48:00,1,2565.0,2266.0,0.884,12.615,12,0,0,0,12,0,12,0,0.0,0.0
1011,1536,25-09-2019 14:50:00,1,2592.0,2217.0,0.855,12.667,5,1,1,0,4,0,4,0,0.0,0.0
1011,1537,25-09-2019 14:52:00,1,2480.0,2174.0,0.876,12.178,19,12,8,4,7,3,4,0,0.0,0.0
1011,1538,25-09-2019 14:54:00,1,2585.0,2197.0,0.85,12.619,5,5,3,2,0,0,0,0,0.0,0.0
1011,1539,25-09-2019 14:56:00,1,2477.0,2170.0,0.876,12.162,0,0,0,0,0,0,0,0,0.0,0.0
1011,1540,25-09-2019 14:58:00,1,2481.5,2158.5,0.87,12.167,0,0,0,0,0,0,0,0,0.0,0.0
1011,1541,25-09-2019 15:00:00,1,2486.0,2147.0,0.864,12.172,3,3,1,2,0,0,0,0,0.0,0.0
1011,1542,25-09-2019 15:02:00,1,2382.0,2109.0,0.885,11.721,2,2,0,2,0,0,0,0,0.0,0.0
1011,1543,25-09-2019 15:04:00,1,2483.0,2133.0,0.859,12.144,2,2,0,2,0,0,0,0,0.0,0.0
1011,1544,25-09-2019 15:06:00,1,2391.0,2106.0,0.881,11.754,0,0,0,0,0,0,0,0,0.0,0.0
1011,1545,25-09-2019 15:08:00,1,2302.0,1944.0,0.844,11.223,35,23,12,11,12,8,4,0,0.0,0.01
1011,1546,25-09-2019 15:10:00,1,2105.0,1814.0,0.862,10.304,0,0,0,0,0,0,0,0,0.0,0.0
1011,1547,25-09-2019 15:12:00,1,2122.0,1733.0,0.817,10.279,3,3,2,1,0,0,0,0,0.0,0.0
1011,1548,25-09-2019 15:14:00,1,2122.0,1758.0,0.829,10.309,4,0,0,0,4,1,3,0,0.01,0.0
1011,1549,25-09-2019 15:16:00,1,2317.0,1853.0,0.8,11.179,4,0,0,0,4,1,3,0,0.0,0.01
1011,1550,25-09-2019 15:18:00,1,2318.0,1907.0,0.823,11.245,0,0,0,0,0,0,0,0,0.0,0.0
1011,1551,25-09-2019 15:20:00,1,2311.0,1908.0,0.826,11.218,2,1,1,0,1,0,1,0,0.0,0.0
1011,1552,25-09-2019 15:22:00,1,2316.0,1896.0,0.819,11.223,13,12,8,4,1,1,0,0,0.0,0.0
1011,1553,25-09-2019 15:24:00,1,2305.0,1930.0,0.837,11.221,0,0,0,0,0,0,0,0,0.0,0.0
1011,1554,25-09-2019 15:26:00,1,2318.0,1903.0,0.821,11.24,22,11,6,5,11,7,4,0,0.0,0.0
1011,1555,25-09-2019 15:28:00,1,2308.0,1905.0,0.826,11.201,1,1,0,1,0,0,0,0,0.0,0.0
1011,1556,25-09-2019 15:30:00,1,2311.0,1910.0,0.827,11.221,7,7,2,5,0,0,0,0,0.0,0.0
1011,1557,25-09-2019 15:32:00,1,2310.5,1918.5,0.8305,11.227,3,3,1,2,0,0,0,0,0.0,0.0
1011,1558,25-09-2019 15:34:00,1,2310.0,1927.0,0.834,11.233,12,0,0,0,12,1,11,0,0.0,0.0
1011,1559,25-09-2019 15:36:00,1,2306.0,1931.0,0.837,11.222,23,12,6,6,11,5,6,0,0.0,0.0
1011,1560,25-09-2019 15:38:00,1,2331.0,1819.0,0.78,11.2,3,0,0,0,3,1,2,0,0.0,0.0
1011,1561,25-09-2019 15:40:00,1,2354.0,1763.0,0.749,11.226,0,0,0,0,0,0,0,0,0.0,0.0
1011,1562,25-09-2019 15:42:00,1,2353.0,1759.0,0.747,11.219,1,1,1,0,0,0,0,0,0.0,0.0
1011,1563,25-09-2019 15:44:00,1,2250.0,1705.0,0.758,10.752,3,1,0,1,2,1,1,0,0.0,0.0
1011,1564,25-09-2019 15:46:00,1,2136.0,1678.0,0.786,10.274,6,5,0,5,1,0,1,0,0.0,0.0
1011,1565,25-09-2019 15:48:00,1,2138.0,1680.0,0.786,10.284,0,0,0,0,0,0,0,0,0.0,0.0
1011,1566,25-09-2019 15:50:00,1,2138.0,1664.0,0.778,10.268,0,0,0,0,0,0,0,0,0.0,0.0
1011,1567,25-09-2019 15:52:00,1,2166.0,1595.0,0.737,10.299,134,72,41,31,62,42,20,1,0.0,0.0
1011,1568,25-09-2019 15:54:00,1,2337.0,1818.0,0.778,11.222,202,93,51,42,109,84,25,0,0.0,0.0
1011,1569,25-09-2019 15:56:00,1,2527.0,1972.0,0.78,12.141,57,33,15,18,24,7,17,0,0.0,0.0
1011,1570,25-09-2019 15:58:00,1,2619.0,2078.0,0.794,12.619,134,83,48,35,51,30,21,20,0.0,0.0
1011,1571,25-09-2019 16:00:00,1,2692.0,2228.0,0.828,13.074,125,85,49,36,40,14,26,65,0.0,0.0
1011,1572,25-09-2019 16:02:00,1,2890.0,2419.0,0.837,14.066,118,48,23,25,70,34,36,58,0.0,0.0
1011,1573,25-09-2019 16:04:00,1,2992.0,2479.0,0.829,14.535,120,37,24,13,83,30,53,54,0.0,0.0
1011,1574,25-09-2019 16:06:00,1,3130.0,2599.5,0.8305,15.211,84,17,10,7,67,37,30,48,0.0,0.16
1011,1575,25-09-2019 16:08:00,1,3268.0,2720.0,0.832,15.887,200,132,102,30,68,43,25,92,0.05,0.06
1011,1576,25-09-2019 16:10:00,1,2766.0,2436.0,0.881,13.594,409,236,186,50,173,132,41,63,0.06,0.0
1011,1577,25-09-2019 16:12:00,1,2872.0,2481.0,0.864,14.061,436,263,206,57,173,128,45,93,0.02,0.0
1011,1578,25-09-2019 16:14:00,1,2775.0,2368.0,0.853,13.556,215,118,84,34,97,65,32,99,0.0,0.0
1011,1579,25-09-2019 16:16:00,1,2747.0,2472.0,0.9,13.561,291,162,125,37,129,97,32,151,0.0,0.0
1011,1580,25-09-2019 16:18:00,1,2965.0,2573.0,0.868,14.531,488,322,262,60,166,129,37,140,0.06,0.0
1011,1581,25-09-2019 16:20:00,1,2939.0,2631.0,0.895,14.494,139,53,22,31,86,44,42,69,0.0,0.0
1011,1582,25-09-2019 16:22:00,1,3417.0,3013.0,0.882,16.8,151,69,39,30,82,54,28,23,0.06,0.09
1011,1583,25-09-2019 16:24:00,1,2943.0,2646.0,0.899,14.526,28,8,2,6,20,4,16,0,0.0,0.0
1011,1584,25-09-2019 16:26:00,1,2770.0,2415.0,0.872,13.585,82,42,15,27,40,7,33,0,0.01,0.01
1011,1585,25-09-2019 16:28:00,1,2765.0,2434.0,0.88,13.589,31,13,6,7,18,2,16,0,0.0,0.01
1011,1586,25-09-2019 16:30:00,1,2776.0,2354.0,0.848,13.544,2,0,0,0,2,0,2,0,0.0,0.0
1011,1587,25-09-2019 16:32:00,1,2790.0,2353.0,0.844,13.598,0,0,0,0,0,0,0,0,0.0,0.0
1011,1588,25-09-2019 16:34:00,1,2561.0,2289.0,0.894,12.626,2,0,0,0,2,2,0,0,0.01,0.0
1011,1589,25-09-2019 16:36:00,1,2577.0,2252.0,0.874,12.646,0,0,0,0,0,0,0,0,0.0,0.0
1011,1590,25-09-2019 16:38:00,1,2584.0,2189.0,0.847,12.604,2,0,0,0,2,1,1,0,0.0,0.0
1011,1591,25-09-2019 16:40:00,1,2429.0,2128.0,0.878,11.926,5,1,1,0,4,1,3,0,0.0,0.0
1011,1592,25-09-2019 16:42:00,1,2274.0,2067.0,0.909,11.248,3,0,0,0,3,1,2,0,0.0,0.01
1011,1593,25-09-2019 16:44:00,1,2282.0,2036.0,0.892,11.246,0,0,0,0,0,0,0,0,0.0,0.0
1011,1594,25-09-2019 16:46:00,1,2302.0,1957.0,0.85,11.237,8,1,0,1,7,2,5,0,0.0,0.0
1011,1595,25-09-2019 16:48:00,1,2188.0,1944.0,0.888,10.771,8,0,0,0,8,4,4,0,0.0,0.0
1011,1596,25-09-2019 16:50:00,1,2070.0,1931.0,0.933,10.293,1,0,0,0,1,0,1,0,0.0,0.0
1011,1597,25-09-2019 16:52:00,1,2070.0,1953.0,0.944,10.317,0,0,0,0,0,0,0,0,0.0,0.0
1011,1598,25-09-2019 16:54:00,1,2178.0,1999.0,0.918,10.795,43,0,0,0,43,0,43,0,0.0,0.0
1011,1599,25-09-2019 16:56:00,1,2062.0,1984.0,0.962,10.319,5,0,0,0,5,0,5,0,0.0,0.0
1011,1600,25-09-2019 16:58:00,1,2065.0,1960.0,0.949,10.306,118,48,30,18,70,46,24,0,0.0,0.0
1011,1601,25-09-2019 17:00:00,1,2229.0,2219.0,0.995,11.24,276,137,99,38,139,96,43,36,0.0,0.0
1011,1602,25-09-2019 17:02:00,1,2526.0,2421.0,0.959,12.633,113,70,38,32,43,14,29,2,0.0,0.0
1011,1603,25-09-2019 17:04:00,1,2525.0,2406.0,0.953,12.611,120,66,42,24,54,24,30,0,0.0,0.0
1011,1604,25-09-2019 17:06:00,1,2537.0,2409.0,0.949,12.663,56,48,20,28,8,0,8,0,0.0,0.0
1011,1605,25-09-2019 17:08:00,1,2639.0,2479.0,0.939,13.142,41,32,17,15,9,0,9,0,0.0,0.0
1011,1606,25-09-2019 17:10:00,1,2746.0,2488.0,0.906,13.574,65,51,26,25,14,4,10,0,0.0,0.0
1011,1607,25-09-2019 17:12:00,1,2744.0,2507.0,0.913,13.587,29,21,6,15,8,2,6,0,0.0,0.0
1011,1608,25-09-2019 17:14:00,1,2603.5,2358.0,0.905,12.868,1,1,0,1,0,0,0,0,0.0,0.0
1011,1609,25-09-2019 17:16:00,1,2463.0,2209.0,0.897,12.149,10,6,1,5,4,0,4,0,0.0,0.0
1011,1610,25-09-2019 17:18:00,1,2257.0,2121.0,0.94,11.239,77,22,7,15,55,31,24,0,0.0,0.0
1011,1611,25-09-2019 17:20:00,1,2358.0,2179.0,0.924,11.702,55,16,0,16,39,22,17,0,0.0,0.0
1011,1612,25-09-2019 17:22:00,1,2246.0,2129.0,0.948,11.205,8,6,1,5,2,1,1,0,0.0,0.0
1011,1613,25-09-2019 17:24:00,1,2269.0,2096.0,0.924,11.258,38,0,0,0,38,20,18,0,0.0,0.0
1011,1614,25-09-2019 17:26:00,1,2275.0,2077.0,0.913,11.263,120,36,11,25,84,57,27,0,0.0,0.0
1011,1615,25-09-2019 17:28:00,1,2465.0,2201.0,0.893,12.15,9,9,0,9,0,0,0,0,0.0,0.0
1011,1616,25-09-2019 17:30:00,1,2245.0,2153.0,0.959,11.228,5,5,0,5,0,0,0,0,0.0,0.0
1011,1617,25-09-2019 17:32:00,1,2247.0,2142.0,0.953,11.225,0,0,0,0,0,0,0,0,0.0,0.0
1011,1618,25-09-2019 17:34:00,1,2284.0,2061.0,0.903,11.281,9,7,3,4,2,1,1,0,0.0,0.0
1011,1619,25-09-2019 17:36:00,1,2281.0,2009.0,0.881,11.211,3,2,1,1,1,0,1,0,0.0,0.0
1011,1620,25-09-2019 17:38:00,1,2277.0,2032.0,0.892,11.219,31,28,12,16,3,0,3,0,0.0,0.0
1011,1621,25-09-2019 17:40:00,1,2280.0,2050.0,0.899,11.253,132,68,33,35,64,37,27,0,0.0,0.0
1011,1622,25-09-2019 17:42:00,1,2568.0,2244.0,0.874,12.604,115,47,34,13,68,41,27,18,0.0,0.0
1011,1623,25-09-2019 17:44:00,1,2741.0,2518.0,0.918,13.587,59,12,5,7,47,25,22,40,0.0,0.06
1011,1624,25-09-2019 17:46:00,1,2955.0,2610.0,0.883,14.532,233,129,105,24,104,70,34,35,0.0,0.06
1011,1625,25-09-2019 17:48:00,1,2855.5,2518.0,0.8815,14.039,220,138,97,41,82,60,22,73,0.0,0.0
1011,1626,25-09-2019 17:50:00,1,2756.0,2426.0,0.88,13.546,228,117,77,40,111,81,30,7,0.0,0.0
1011,1627,25-09-2019 17:52:00,1,2758.0,2427.0,0.88,13.555,43,17,1,16,26,9,17,0,0.0,0.0
1011,1628,25-09-2019 17:54:00,1,2759.0,2432.0,0.882,13.562,41,7,0,7,34,0,34,0,0.0,0.0
1011,1629,25-09-2019 17:56:00,1,2755.0,2459.0,0.893,13.577,82,13,3,10,69,51,18,0,0.0,0.0
1011,1630,25-09-2019 17:58:00,1,2762.0,2436.0,0.882,13.581,27,8,2,6,19,3,16,0,0.0,0.0
1011,1631,25-09-2019 18:00:00,0,2541.0,2356.0,0.927,12.62,10,3,1,2,7,3,4,0,0.0,0.0
1011,1632,25-09-2019 18:02:00,0,2767.0,2439.0,0.881,13.602,0,0,0,0,0,0,0,0,0.0,0.0
1011,1633,25-09-2019 18:04:00,0,2755.0,2460.0,0.893,13.577,112,41,19,22,71,41,30,0,0.0,0.0
1011,1634,25-09-2019 18:06:00,0,2742.0,2502.0,0.913,13.572,105,47,20,27,58,28,30,0,0.0,0.0
1011,1635,25-09-2019 18:08:00,0,2750.0,2495.0,0.908,13.596,61,26,12,14,35,11,24,0,0.0,0.0
1011,1636,25-09-2019 18:10:00,0,2717.0,2580.0,0.949,13.562,226,133,93,40,93,62,31,38,0.0,0.0
1011,1637,25-09-2019 18:12:00,0,3023.0,2767.0,0.915,14.973,74,52,34,18,22,11,11,27,0.0,0.3
1011,1638,25-09-2019 18:14:00,0,3015.0,2801.0,0.929,14.98,308,191,153,38,117,93,24,51,0.07,0.0
1011,1639,25-09-2019 18:16:00,0,3241.0,2855.0,0.881,15.929,532,327,264,63,205,157,48,154,0.01,0.0
1011,1640,25-09-2019 18:18:00,0,3225.0,2897.0,0.898,15.914,363,230,184,46,133,107,26,195,0.07,0.0
1011,1641,25-09-2019 18:20:00,0,3188.0,2971.0,0.932,15.851,497,262,210,52,235,190,45,193,0.0,0.01
1011,1642,25-09-2019 18:22:00,0,3299.0,3031.5,0.9195,16.3555,342,199,150,49,143,110,33,137,0.06,0.0
1011,1643,25-09-2019 18:24:00,0,3410.0,3092.0,0.907,16.86,556,321,257,64,235,186,49,118,0.01,0.0
1011,1644,25-09-2019 18:26:00,0,3195.0,3007.0,0.941,15.918,32,17,8,9,15,12,3,2,0.02,0.0
1011,1645,25-09-2019 18:28:00,0,3194.0,3000.0,0.939,15.907,265,200,158,42,65,48,17,85,0.0,0.0
1011,1646,25-09-2019 18:30:00,0,3199.0,3024.0,0.945,15.953,612,363,300,63,249,193,56,109,0.03,0.0
1011,1647,25-09-2019 18:32:00,0,3411.0,3100.0,0.909,16.87,510,304,249,55,206,165,41,225,0.0,0.0
1011,1648,25-09-2019 18:34:00,0,3400.0,3166.0,0.931,16.899,424,232,185,47,192,148,44,148,0.03,0.0
1011,1649,25-09-2019 18:36:00,0,3383.0,3210.0,0.949,16.883,430,254,199,55,176,133,43,82,0.0,0.0
1011,1650,25-09-2019 18:38:00,0,3396.0,3148.0,0.927,16.866,454,294,240,54,160,120,40,111,0.0,0.0
1011,1651,25-09-2019 18:40:00,0,3197.0,3014.0,0.943,15.934,527,310,256,54,217,164,53,214,0.05,0.0
1011,1652,25-09-2019 18:42:00,0,3402.0,3113.0,0.915,16.848,397,229,183,46,168,134,34,87,0.0,0.03
1011,1653,25-09-2019 18:44:00,0,3416.0,3065.0,0.897,16.85,353,201,158,43,152,114,38,89,0.01,0.0
1011,1654,25-09-2019 18:46:00,0,3399.0,3126.0,0.92,16.854,270,157,111,46,113,79,34,77,0.0,0.01
1011,1655,25-09-2019 18:48:00,0,3383.0,3189.0,0.943,16.859,405,255,205,50,150,107,43,72,0.05,0.0
1011,1656,25-09-2019 18:50:00,0,3374.0,3235.0,0.959,16.873,254,134,93,41,120,91,29,67,0.0,0.0
1011,1657,25-09-2019 18:52:00,0,3487.0,3247.0,0.931,17.334,119,46,24,22,73,36,37,59,0.0,0.01
1011,1658,25-09-2019 18:54:00,0,3365.0,3274.0,0.973,16.882,290,170,133,37,120,91,29,48,0.0,0.02
1011,1659,25-09-2019 18:56:00,0,3468.5,3306.5,0.954,17.3255,207,127,83,44,80,57,23,79,0.01,0.0
1011,1660,25-09-2019 18:58:00,0,3572.0,3339.0,0.935,17.769,211,128,91,37,83,49,34,107,0.0,0.01
1011,1661,25-09-2019 19:00:00,0,3671.0,3426.0,0.933,18.256,207,66,45,21,141,87,54,60,0.0,0.0
1011,1662,25-09-2019 19:02:00,0,3881.0,3532.0,0.91,19.202,186,103,81,22,83,57,26,31,0.0,0.11
1011,1663,25-09-2019 19:04:00,0,3405.0,3081.0,0.905,16.826,458,261,209,52,197,148,49,90,0.06,0.0
1011,1664,25-09-2019 19:06:00,0,3198.0,2982.0,0.933,15.9,336,176,144,32,160,109,51,76,0.05,0.0
1011,1665,25-09-2019 19:08:00,0,3693.0,3361.0,0.91,18.27,145,72,42,30,73,31,42,48,0.0,0.0
1011,1666,25-09-2019 19:10:00,0,3298.0,3076.0,0.933,16.399,343,196,145,51,147,98,49,37,0.05,0.0
1011,1667,25-09-2019 19:12:00,0,3195.0,2982.0,0.933,15.89,463,270,220,50,193,157,36,167,0.06,0.09
1011,1668,25-09-2019 19:14:00,0,3209.0,2947.0,0.918,15.906,201,109,76,33,92,53,39,77,0.0,0.0
1011,1669,25-09-2019 19:16:00,0,3654.0,3520.0,0.963,18.294,396,194,160,34,202,152,50,68,0.0,0.09
1011,1670,25-09-2019 19:18:00,0,3416.0,3087.0,0.904,16.878,215,120,92,28,95,78,17,60,0.04,0.0
1011,1671,25-09-2019 19:20:00,0,3871.0,3546.0,0.916,19.176,174,98,62,36,76,48,28,22,0.0,0.0
1011,1672,25-09-2019 19:22:00,0,3675.0,3433.0,0.934,18.279,392,237,205,32,155,119,36,114,0.01,0.0
1011,1673,25-09-2019 19:24:00,0,3009.0,2833.0,0.942,14.99,253,89,51,38,164,113,51,70,0.0,0.0
1011,1674,25-09-2019 19:26:00,0,3883.0,3545.0,0.913,19.225,180,69,40,29,111,57,54,67,0.0,0.0
1011,1675,25-09-2019 19:28:00,0,4161.0,3799.0,0.913,20.6,205,110,70,40,95,45,50,60,0.0,0.02
1011,1676,25-09-2019 19:30:00,0,3864.0,3633.5,0.9425,19.2475,154,73,40,33,81,37,44,52,0.0,0.05
1011,1677,25-09-2019 19:32:00,0,3567.0,3468.0,0.972,17.895,287,169,141,28,118,94,24,75,0.08,0.06
1011,1678,25-09-2019 19:34:00,0,3563.0,3394.0,0.953,17.795,565,378,324,54,187,138,49,122,0.0,0.01
1011,1679,25-09-2019 19:36:00,0,3546.0,3484.0,0.983,17.826,503,325,261,64,178,132,46,111,0.0,0.09
1011,1680,25-09-2019 19:38:00,0,3251.0,3233.0,0.995,16.386,412,215,176,39,197,156,41,97,0.06,0.0
1011,1681,25-09-2019 19:40:00,0,3096.0,2962.0,0.957,15.477,161,79,54,25,82,42,40,71,0.01,0.0
1011,1682,25-09-2019 19:42:00,0,4060.0,3763.0,0.927,20.162,236,116,83,33,120,68,52,45,0.0,0.0
1011,1683,25-09-2019 19:44:00,0,3553.0,3468.0,0.976,17.837,264,143,105,38,121,80,41,51,0.06,0.01
1011,1684,25-09-2019 19:46:00,0,3121.0,2883.0,0.924,15.488,280,134,97,37,146,110,36,52,0.0,0.0
1011,1685,25-09-2019 19:48:00,0,2718.0,2599.0,0.956,13.586,134,58,25,33,76,40,36,19,0.0,0.0
1011,1686,25-09-2019 19:50:00,0,2813.0,2701.0,0.96,14.072,83,43,10,33,40,13,27,8,0.0,0.0
1011,1687,25-09-2019 19:52:00,0,3286.0,3125.0,0.951,16.406,202,111,80,31,91,66,25,15,0.05,0.0
1011,1688,25-09-2019 19:54:00,0,3093.0,2985.0,0.965,15.493,208,112,85,27,96,69,27,16,0.01,0.0
1011,1689,25-09-2019 19:56:00,0,3103.0,2901.0,0.935,15.436,175,106,78,28,69,34,35,65,0.0,0.0
1011,1690,25-09-2019 19:58:00,0,3946.0,3744.0,0.949,19.691,137,66,31,35,71,34,37,59,0.0,0.0
1011,1691,25-09-2019 20:00:00,0,4031.0,3870.0,0.96,20.167,378,225,176,49,153,129,24,119,0.04,0.03
1011,1692,25-09-2019 20:02:00,0,3536.0,3519.0,0.995,17.826,439,234,179,55,205,164,41,131,0.01,0.04
1011,1693,25-09-2019 20:04:00,0,3393.5,3368.5,0.9925,17.0985,347,196,155,41,151,119,32,100,0.06,0.0
1011,1694,25-09-2019 20:06:00,0,3251.0,3218.0,0.99,16.371,526,318,259,59,208,165,43,137,0.03,0.0
1011,1695,25-09-2019 20:08:00,0,3760.0,3578.0,0.951,18.777,243,145,109,36,98,55,43,97,0.0,0.0
1011,1696,25-09-2019 20:10:00,0,4025.0,3854.0,0.958,20.125,78,25,19,6,53,24,29,51,0.0,0.05
1011,1697,25-09-2019 20:12:00,0,4022.0,3876.0,0.964,20.138,97,48,33,15,49,24,25,60,0.0,0.04
1011,1698,25-09-2019 20:14:00,0,3729.0,3663.0,0.982,18.749,111,29,14,15,82,53,29,13,0.0,0.0
1011,1699,25-09-2019 20:16:00,0,2822.0,2637.0,0.935,14.039,321,166,131,35,155,119,36,76,0.05,0.08
1011,1700,25-09-2019 20:18:00,0,3548.0,3463.0,0.976,17.811,211,115,86,29,96,65,31,46,0.0,0.0
1011,1701,25-09-2019 20:20:00,0,3290.0,3110.0,0.945,16.406,345,190,144,46,155,118,37,90,0.04,0.01
1011,1702,25-09-2019 20:22:00,0,3260.0,3183.0,0.976,16.37,420,199,157,42,221,168,53,99,0.01,0.0
1011,1703,25-09-2019 20:24:00,0,3566.0,3397.0,0.953,17.81,112,42,22,20,70,29,41,66,0.0,0.0
1011,1704,25-09-2019 20:26:00,0,4042.0,3832.0,0.948,20.167,98,35,18,17,63,31,32,57,0.0,0.08
1011,1705,25-09-2019 20:28:00,0,3993.0,3954.0,0.99,20.109,78,40,23,17,38,22,16,11,0.0,0.29
1011,1706,25-09-2019 20:30:00,0,3544.0,3468.0,0.979,17.802,290,158,115,43,132,99,33,78,0.06,0.05
1011,1707,25-09-2019 20:32:00,0,3102.0,2952.0,0.952,15.491,116,56,35,21,60,38,22,25,0.0,0.03
1011,1708,25-09-2019 20:34:00,0,3109.0,2856.0,0.919,15.41,109,77,40,37,32,18,14,6,0.04,0.0
1011,1709,25-09-2019 20:36:00,0,3089.0,2988.0,0.967,15.48,95,70,25,45,25,10,15,1,0.01,0.0
1011,1710,25-09-2019 20:38:00,0,3318.5,3218.5,0.9695,16.6385,78,56,35,21,22,5,17,0,0.0,0.0
1011,1711,25-09-2019 20:40:00,0,3548.0,3449.0,0.972,17.797,62,50,32,18,12,4,8,0,0.0,0.0
1011,1712,25-09-2019 20:42:00,0,3550.0,3408.0,0.96,17.762,40,22,15,7,18,8,10,0,0.0,0.0
1011,1713,25-09-2019 20:44:00,0,3268.0,3235.0,0.99,16.458,0,0,0,0,0,0,0,0,0.0,0.0
1011,1714,25-09-2019 20:46:00,0,3285.0,3115.0,0.948,16.39,5,0,0,0,5,2,3,0,0.0,0.0
1011,1715,25-09-2019 20:48:00,0,3193.0,3042.0,0.953,15.947,7,3,2,1,4,2,2,0,0.0,0.0
1011,1716,25-09-2019 20:50:00,0,3097.0,2972.0,0.96,15.492,7,5,4,1,2,1,1,0,0.0,0.0
1011,1717,25-09-2019 20:52:00,0,2880.0,2831.0,0.983,14.483,187,46,33,13,141,123,18,0,0.0,0.0
1011,1718,25-09-2019 20:54:00,0,3109.0,2956.0,0.951,15.524,289,137,103,34,152,113,39,69,0.0,0.0
1011,1719,25-09-2019 20:56:00,0,3292.0,3131.0,0.951,16.437,357,198,153,45,159,122,37,119,0.0,0.0
1011,1720,25-09-2019 20:58:00,0,3346.0,3343.0,0.999,16.882,410,222,176,46,188,142,46,113,0.07,0.0
1011,1721,25-09-2019 21:00:00,0,3246.0,3264.0,1.005,16.404,457,258,207,51,199,154,45,164,0.01,0.0
1011,1722,25-09-2019 21:02:00,0,3558.0,3404.0,0.957,17.786,348,211,157,54,137,106,31,272,0.0,0.0
1011,1723,25-09-2019 21:04:00,0,3240.0,3304.0,1.02,16.424,424,267,220,47,157,129,28,229,0.0,0.0
1011,1724,25-09-2019 21:06:00,0,3523.0,3543.0,1.006,17.803,504,295,239,56,209,169,40,269,0.0,0.0
1011,1725,25-09-2019 21:08:00,0,3756.0,3543.0,0.943,18.719,260,166,139,27,94,67,27,82,0.0,0.0
1011,1726,25-09-2019 21:10:00,0,3559.0,3419.0,0.961,17.808,343,189,148,41,154,124,30,196,0.05,0.0
1011,1727,25-09-2019 21:12:00,0,3500.0,3382.5,0.9665,17.5355,460,229,183,46,231,181,50,188,0.01,0.0
1011,1728,25-09-2019 21:14:00,0,3441.0,3346.0,0.972,17.263,528,288,224,64,240,186,54,145,0.04,0.0
1011,1729,25-09-2019 21:16:00,0,3548.0,3490.0,0.984,17.844,439,246,196,50,193,155,38,279,0.01,0.0
1011,1730,25-09-2019 21:18:00,0,3740.0,3615.0,0.967,18.738,295,192,141,51,103,83,20,59,0.0,0.0
1011,1731,25-09-2019 21:20:00,0,3733.0,3614.0,0.968,18.71,232,97,69,28,135,103,32,47,0.01,0.0
1011,1732,25-09-2019 21:22:00,0,3564.0,3412.0,0.957,17.82,226,126,99,27,100,77,23,44,0.01,0.0
1011,1733,25-09-2019 21:24:00,0,3455.0,3345.0,0.968,17.316,212,117,89,28,95,71,24,25,0.0,0.0
1011,1734,25-09-2019 21:26:00,0,3448.0,3368.0,0.977,17.312,396,225,183,42,171,138,33,198,0.0,0.0
1011,1735,25-09-2019 21:28:00,0,3550.0,3512.0,0.989,17.874,221,122,93,29,99,79,20,30,0.11,0.0
1011,1736,25-09-2019 21:30:00,0,3355.0,3299.0,0.983,16.871,417,216,173,43,201,161,40,74,0.02,0.0
1011,1737,25-09-2019 21:32:00,0,3247.0,3289.0,1.013,16.434,286,179,137,42,107,78,29,41,0.0,0.0
1011,1738,25-09-2019 21:34:00,0,3260.0,3252.0,0.998,16.443,196,106,72,34,90,54,36,54,0.0,0.0
1011,1739,25-09-2019 21:36:00,0,3350.0,3325.0,0.993,16.881,258,167,132,35,91,67,24,102,0.0,0.0
1011,1740,25-09-2019 21:38:00,0,3576.0,3401.0,0.951,17.854,121,76,47,29,45,30,15,68,0.0,0.0
1011,1741,25-09-2019 21:40:00,0,3084.0,2996.0,0.972,15.469,345,174,136,38,171,139,32,44,0.0,0.02
1011,1742,25-09-2019 21:42:00,0,3271.0,3220.0,0.985,16.453,154,104,66,38,50,38,12,92,0.0,0.04
1011,1743,25-09-2019 21:44:00,0,3347.0,3350.0,1.001,16.896,405,240,189,51,165,132,33,207,0.01,0.02
1011,1744,25-09-2019 21:46:00,0,3454.5,3386.0,0.981,17.3585,383,218,173,45,165,130,35,120,0.04,0.01
1011,1745,25-09-2019 21:48:00,0,3562.0,3422.0,0.961,17.821,282,177,131,46,105,75,30,66,0.01,0.01
1011,1746,25-09-2019 21:50:00,0,3287.0,3148.0,0.958,16.436,193,139,91,48,54,39,15,93,0.0,0.0
1011,1747,25-09-2019 21:52:00,0,3355.0,3317.0,0.989,16.89,374,178,142,36,196,161,35,48,0.05,0.02
1011,1748,25-09-2019 21:54:00,0,3262.0,3174.0,0.973,16.365,358,195,145,50,163,120,43,90,0.0,0.0
1011,1749,25-09-2019 21:56:00,0,3278.0,3123.0,0.953,16.371,276,176,136,40,100,71,29,138,0.0,0.03
1011,1750,25-09-2019 21:58:00,0,3353.0,3275.0,0.977,16.837,75,53,25,28,22,7,15,27,0.0,0.11
1011,1751,25-09-2019 22:00:00,0,3337.0,3306.0,0.991,16.808,126,88,54,34,38,19,19,67,0.0,0.0
1011,1752,25-09-2019 22:02:00,0,3571.0,3356.0,0.94,17.784,183,115,79,36,68,37,31,44,0.0,0.0
1011,1753,25-09-2019 22:04:00,0,3279.0,3144.0,0.959,16.398,288,192,156,36,96,72,24,61,0.0,0.0
1011,1754,25-09-2019 22:06:00,0,3232.0,3291.0,1.018,16.378,360,241,198,43,119,94,25,94,0.05,0.0
1011,1755,25-09-2019 22:08:00,0,3256.0,3236.0,0.994,16.41,313,181,139,42,132,102,30,61,0.0,0.0
1011,1756,25-09-2019 22:10:00,0,3280.0,3149.0,0.96,16.41,142,52,31,21,90,52,38,14,0.0,0.0
1011,1757,25-09-2019 22:12:00,0,2922.0,2719.0,0.931,14.523,167,107,71,36,60,39,21,97,0.0,0.0
1011,1758,25-09-2019 22:14:00,0,3755.0,3566.0,0.95,18.743,104,59,30,29,45,14,31,55,0.0,0.07
1011,1759,25-09-2019 22:16:00,0,3738.0,3657.0,0.978,18.778,209,130,90,40,79,41,38,53,0.01,0.0
1011,1760,25-09-2019 22:18:00,0,3237.0,3296.0,1.018,16.404,134,83,64,19,51,32,19,5,0.0,0.06
1011,1761,25-09-2019 22:20:00,0,3120.0,3078.0,0.985,15.702,136,52,22,30,84,48,36,7,0.08,0.02
1011,1762,25-09-2019 22:22:00,0,3003.0,2860.0,0.952,15.0,177,63,37,26,114,79,35,3,0.0,0.0
1011,1763,25-09-2019 22:24:00,0,2975.0,2965.0,0.997,15.005,82,24,6,18,58,21,37,0,0.0,0.0
1011,1764,25-09-2019 22:26:00,0,3187.0,3053.0,0.958,15.936,103,23,10,13,80,40,40,0,0.0,0.0
1011,1765,25-09-2019 22:28:00,0,3176.0,3115.0,0.981,15.963,5,0,0,0,5,0,5,0,0.0,0.0
1011,1766,25-09-2019 22:30:00,0,3077.0,3023.0,0.982,15.471,1,0,0,0,1,0,1,0,0.0,0.0
1011,1767,25-09-2019 22:32:00,0,3004.0,2854.0,0.95,14.996,1,0,0,0,1,0,1,0,0.0,0.0
1011,1768,25-09-2019 22:34:00,0,2689.0,2705.0,1.006,13.588,4,0,0,0,4,1,3,0,0.0,0.0
1011,1769,25-09-2019 22:36:00,0,2501.0,2508.0,1.003,12.63,41,11,6,5,30,10,20,0,0.0,0.01
1011,1770,25-09-2019 22:38:00,0,2710.0,2654.0,0.979,13.616,14,2,2,0,12,0,12,0,0.0,0.0
1011,1771,25-09-2019 22:40:00,0,2491.0,2577.0,1.035,12.666,1,1,0,1,0,0,0,0,0.0,0.0
1011,1772,25-09-2019 22:42:00,0,2499.0,2537.0,1.015,12.654,14,7,3,4,7,2,5,0,0.0,0.0
1011,1773,25-09-2019 22:44:00,0,2513.0,2493.0,0.992,12.66,1,1,0,1,0,0,0,0,0.0,0.0
1011,1774,25-09-2019 22:46:00,0,2292.0,2426.0,1.058,11.718,13,6,4,2,7,1,6,0,0.0,0.0
1011,1775,25-09-2019 22:48:00,0,2312.0,2347.0,1.015,11.708,6,0,0,0,6,0,6,0,0.0,0.0
1011,1776,25-09-2019 22:50:00,0,2011.0,2191.0,1.089,10.348,6,3,0,3,3,0,3,0,0.0,0.01
1011,1777,25-09-2019 22:52:00,0,2006.0,2149.0,1.071,10.284,1,1,0,1,0,0,0,0,0.0,0.0
1011,1778,25-09-2019 22:54:00,0,2164.0,2242.0,1.038,11.0085,57,20,12,8,37,13,24,0,0.0,0.0
1011,1779,25-09-2019 22:56:00,0,2322.0,2335.0,1.005,11.733,12,2,0,2,10,2,8,0,0.0,0.0
1011,1780,25-09-2019 22:58:00,0,2216.0,2266.0,1.023,11.241,16,0,0,0,16,0,16,0,0.0,0.0
1011,1781,25-09-2019 23:00:00,0,2029.0,2091.0,1.031,10.307,0,0,0,0,0,0,0,0,0.0,0.0
1011,1782,25-09-2019 23:02:00,0,2059.0,2010.0,0.976,10.338,47,5,1,4,42,11,31,0,0.0,0.0
1011,1783,25-09-2019 23:04:00,0,2039.0,2036.0,0.998,10.288,13,0,0,0,13,6,7,0,0.0,0.0
1011,1784,25-09-2019 23:06:00,0,2022.0,2130.0,1.053,10.323,0,0,0,0,0,0,0,0,0.0,0.01
1011,1785,25-09-2019 23:08:00,0,2009.0,2188.0,1.089,10.339,7,0,0,0,7,3,4,0,0.0,0.0
1011,1786,25-09-2019 23:10:00,0,2106.0,2233.0,1.061,10.77,229,140,116,24,89,62,27,47,0.0,0.0
1011,1787,25-09-2019 23:12:00,0,2459.0,2697.0,1.097,12.674,315,197,151,46,118,87,31,155,0.0,0.0
1011,1788,25-09-2019 23:14:00,0,2669.0,2820.0,1.057,13.638,567,370,307,63,197,154,43,155,0.0,0.0
1011,1789,25-09-2019 23:16:00,0,2949.0,2999.0,1.017,14.937,535,352,286,66,183,143,40,184,0.0,0.0
1011,1790,25-09-2019 23:18:00,0,3146.0,3201.0,1.017,15.936,297,206,168,38,91,65,26,134,0.0,0.0
1011,1791,25-09-2019 23:20:00,0,3174.0,3123.0,0.984,15.962,185,94,62,32,91,41,50,71,0.0,0.01
1011,1792,25-09-2019 23:22:00,0,3321.0,3437.0,1.035,16.889,313,193,144,49,120,84,36,70,0.0,0.01
1011,1793,25-09-2019 23:24:00,0,3451.0,3382.0,0.98,17.341,158,97,61,36,61,13,48,79,0.0,0.01
1011,1794,25-09-2019 23:26:00,0,3596.0,3685.0,1.025,18.246,277,183,138,45,94,69,25,91,0.08,0.07
1011,1795,25-09-2019 23:28:00,0,3516.0,3569.0,1.015,17.803,314,178,140,38,136,105,31,85,0.04,0.01
1011,1796,25-09-2019 23:30:00,0,3436.0,3453.0,1.005,17.36,145,79,54,25,66,30,36,76,0.0,0.0
1011,1797,25-09-2019 23:32:00,0,3599.0,3709.0,1.031,18.285,156,84,58,26,72,36,36,59,0.01,0.08
1011,1798,25-09-2019 23:34:00,0,3047.0,3118.0,1.023,15.456,509,291,239,52,218,173,45,65,0.07,0.0
1011,1799,25-09-2019 23:36:00,0,3236.0,3321.0,1.026,16.428,328,203,151,52,125,104,21,211,0.01,0.02
1011,1800,25-09-2019 23:38:00,0,3458.0,3388.0,0.98,17.374,518,281,235,46,237,170,67,209,0.05,0.0
1011,1801,25-09-2019 23:40:00,0,3446.0,3381.0,0.981,17.318,400,222,174,48,178,134,44,193,0.01,0.0
1011,1802,25-09-2019 23:42:00,0,3926.0,3826.0,0.974,19.705,181,114,75,39,67,24,43,84,0.0,0.0
1011,1803,25-09-2019 23:44:00,0,3978.0,4016.0,1.01,20.118,149,96,58,38,53,17,36,67,0.0,0.13
1011,1804,25-09-2019 23:46:00,0,4097.0,4090.0,0.998,20.671,168,75,46,29,93,57,36,62,0.04,0.05
1011,1805,25-09-2019 23:48:00,0,3333.0,3409.0,1.023,16.904,400,212,169,43,188,139,49,76,0.07,0.01
1011,1806,25-09-2019 23:50:00,0,3602.0,3693.0,1.025,18.28,566,343,278,65,223,173,50,213,0.0,0.0
1011,1807,25-09-2019 23:52:00,0,3905.0,3851.0,0.986,19.649,540,282,227,55,258,196,62,186,0.07,0.0
1011,1808,25-09-2019 23:54:00,0,3416.0,3521.0,1.031,17.358,465,283,226,57,182,134,48,65,0.0,0.0
1011,1809,25-09-2019 23:56:00,0,3618.0,3684.0,1.018,18.332,139,81,41,40,58,25,33,64,0.0,0.0
1011,1810,25-09-2019 23:58:00,0,3983.0,4019.0,1.009,20.141,120,48,21,27,72,41,31,65,0.0,0.1
1011,1811,26-09-2019 00:00:00,0,3865.0,4021.0,1.04,19.677,132,62,34,28,70,45,25,22,0.06,0.06
1011,1812,26-09-2019 00:02:00,0,3496.0,3646.5,1.043,17.809,518,296,234,62,222,169,53,38,0.07,0.01
1011,1813,26-09-2019 00:04:00,0,3127.0,3272.0,1.046,15.941,376,234,187,47,142,112,30,142,0.03,0.0
1011,1814,26-09-2019 00:06:00,0,3417.0,3525.0,1.032,17.364,376,210,168,42,166,125,41,50,0.01,0.0
1011,1815,26-09-2019 00:08:00,0,3125.0,3269.0,1.046,15.929,422,231,181,50,191,154,37,191,0.07,0.06
1011,1816,26-09-2019 00:10:00,0,3418.0,3478.0,1.017,17.319,95,82,43,39,13,2,11,38,0.0,0.11
1011,1817,26-09-2019 00:12:00,0,3811.0,3802.0,0.998,19.222,405,241,189,52,164,133,31,66,0.0,0.0
1011,1818,26-09-2019 00:14:00,0,3907.0,3862.0,0.989,19.668,61,34,15,19,27,5,22,43,0.01,0.0
1011,1819,26-09-2019 00:16:00,0,4074.0,4193.0,1.029,20.692,216,122,86,36,94,73,21,22,0.0,0.0
1011,1820,26-09-2019 00:18:00,0,3443.0,3425.0,0.995,17.355,335,214,151,63,121,88,33,79,0.04,0.0
1011,1821,26-09-2019 00:20:00,0,3645.0,3565.0,0.978,18.307,246,134,97,37,112,81,31,105,0.0,0.0
1011,1822,26-09-2019 00:22:00,0,3419.0,3446.0,1.008,17.284,401,203,149,54,198,154,44,115,0.06,0.0
1011,1823,26-09-2019 00:24:00,0,3420.0,3516.0,1.028,17.366,271,149,120,29,122,91,31,212,0.01,0.07
1011,1824,26-09-2019 00:26:00,0,3528.0,3540.0,1.003,17.821,117,61,22,39,56,19,37,1,0.0,0.0
1011,1825,26-09-2019 00:28:00,0,3428.0,3522.0,1.028,17.404,512,255,192,63,257,197,60,34,0.0,0.0
1011,1826,26-09-2019 00:30:00,0,3637.0,3566.0,0.981,18.277,101,60,31,29,41,18,23,30,0.0,0.21
1011,1827,26-09-2019 00:32:00,0,3153.0,3162.0,1.003,15.922,159,91,60,31,68,38,30,14,0.0,0.01
1011,1828,26-09-2019 00:34:00,0,3626.0,3599.0,0.992,18.271,405,228,171,57,177,128,49,27,0.01,0.01
1011,1829,26-09-2019 00:36:00,0,3533.5,3506.5,0.992,17.805,452,248,198,50,204,150,54,30,0.06,0.0
1011,1830,26-09-2019 00:38:00,0,3441.0,3414.0,0.992,17.339,330,168,129,39,162,127,35,72,0.05,0.06
1011,1831,26-09-2019 00:40:00,0,3440.0,3474.0,1.01,17.399,310,174,137,37,136,102,34,17,0.0,0.0
1011,1832,26-09-2019 00:42:00,0,3447.0,3439.0,0.998,17.388,415,235,187,48,180,134,46,70,0.0,0.0
1011,1833,26-09-2019 00:44:00,0,3348.0,3359.0,1.003,16.91,464,220,176,44,244,182,62,17,0.04,0.0
1011,1834,26-09-2019 00:46:00,0,3125.0,3284.0,1.051,15.949,181,75,39,36,106,74,32,0,0.0,0.0
1011,1835,26-09-2019 00:48:00,0,3161.0,3168.0,1.002,15.96,432,193,142,51,239,177,62,4,0.0,0.0
1011,1836,26-09-2019 00:50:00,0,3228.0,3330.0,1.032,16.406,203,55,31,24,148,90,58,0,0.0,0.0
1011,1837,26-09-2019 00:52:00,0,3164.0,3189.0,1.008,15.996,156,50,21,29,106,67,39,0,0.0,0.0
1011,1838,26-09-2019 00:54:00,0,3111.0,3243.0,1.043,15.846,60,27,8,19,33,18,15,0,0.0,0.0
1011,1839,26-09-2019 00:56:00,0,3075.0,3051.0,0.992,15.494,103,62,28,34,41,15,26,0,0.0,0.0
1011,1840,26-09-2019 00:58:00,0,3178.0,3094.0,0.974,15.946,165,63,27,36,102,61,41,0,0.0,0.0
1011,1841,26-09-2019 01:00:00,0,3136.0,3230.0,1.03,15.932,15,3,3,0,12,9,3,0,0.0,0.0
1011,1842,26-09-2019 01:02:00,0,2989.0,2900.0,0.97,14.989,0,0,0,0,0,0,0,0,0.0,0.0
1011,1843,26-09-2019 01:04:00,0,2697.0,2703.0,1.002,13.616,9,3,0,3,6,2,4,0,0.0,0.0
1011,1844,26-09-2019 01:06:00,0,2482.0,2586.0,1.042,12.643,1,1,0,1,0,0,0,0,0.0,0.0
1011,1845,26-09-2019 01:08:00,0,2521.0,2445.0,0.97,12.641,0,0,0,0,0,0,0,0,0.0,0.0
1011,1846,26-09-2019 01:10:00,0,2481.5,2370.5,0.955,12.402,24,5,2,3,19,11,8,0,0.0,0.0
1011,1847,26-09-2019 01:12:00,0,2442.0,2296.0,0.94,12.163,0,0,0,0,0,0,0,0,0.0,0.0
1011,1848,26-09-2019 01:14:00,0,2347.0,2212.0,0.943,11.698,115,32,13,19,83,43,40,0,0.0,0.0
1011,1849,26-09-2019 01:16:00,0,2801.0,2731.0,0.975,14.058,414,206,158,48,208,148,60,54,0.01,0.0
1011,1850,26-09-2019 01:18:00,0,2808.0,2732.0,0.973,14.086,418,266,216,50,152,124,28,161,0.0,0.0
1011,1851,26-09-2019 01:20:00,0,3083.0,2965.0,0.962,15.428,348,215,161,54,133,97,36,155,0.07,0.0
1011,1852,26-09-2019 01:22:00,0,3066.0,3046.0,0.994,15.453,236,67,37,30,169,116,53,6,0.0,0.0
1011,1853,26-09-2019 01:24:00,0,3054.0,3129.0,1.025,15.496,87,28,7,21,59,26,33,1,0.0,0.0
1011,1854,26-09-2019 01:26:00,0,3060.0,3098.0,1.012,15.486,44,23,2,21,21,8,13,0,0.0,0.0
1011,1855,26-09-2019 01:28:00,0,3055.0,3062.0,1.002,15.428,11,0,0,0,11,0,11,0,0.0,0.0
1011,1856,26-09-2019 01:30:00,0,2978.0,2907.0,0.976,14.95,0,0,0,0,0,0,0,0,0.0,0.0
1011,1857,26-09-2019 01:32:00,0,2790.0,2783.0,0.998,14.075,2,0,0,0,2,0,2,0,0.0,0.0
1011,1858,26-09-2019 01:34:00,0,2583.0,2672.0,1.035,13.133,11,2,1,1,9,5,4,0,0.0,0.0
1011,1859,26-09-2019 01:36:00,0,2622.0,2484.0,0.947,13.082,0,0,0,0,0,0,0,0,0.01,0.0
1011,1860,26-09-2019 01:38:00,0,2430.0,2362.0,0.972,12.188,41,7,5,2,34,16,18,0,0.0,0.0
1011,1861,26-09-2019 01:40:00,0,2457.0,2272.0,0.925,12.196,3,0,0,0,3,0,3,0,0.0,0.0
1011,1862,26-09-2019 01:42:00,0,2341.0,2268.0,0.969,11.735,0,0,0,0,0,0,0,0,0.0,0.0
1011,1863,26-09-2019 01:44:00,0,2388.0,2310.0,0.9675,11.966,3,0,0,0,3,0,3,0,0.0,0.0
1011,1864,26-09-2019 01:46:00,0,2435.0,2352.0,0.966,12.197,0,0,0,0,0,0,0,0,0.0,0.0
1011,1865,26-09-2019 01:48:00,0,2447.0,2305.0,0.942,12.192,1,0,0,0,1,0,1,0,0.0,0.0
1011,1866,26-09-2019 01:50:00,0,2332.0,2280.0,0.978,11.71,4,0,0,0,4,1,3,0,0.0,0.0
1011,1867,26-09-2019 01:52:00,0,2227.0,2253.0,1.012,11.267,10,0,0,0,10,4,6,0,0.0,0.0
1011,1868,26-09-2019 01:54:00,0,2338.0,2290.0,0.979,11.749,11,0,0,0,11,1,10,0,0.0,0.0
1011,1869,26-09-2019 01:56:00,0,2437.0,2360.0,0.969,12.215,129,62,45,17,67,41,26,2,0.0,0.0
1011,1870,26-09-2019 01:58:00,0,2621.0,2546.0,0.972,13.145,6,0,0,0,6,1,5,0,0.0,0.0
1011,1871,26-09-2019 02:00:00,0,2576.0,2695.0,1.046,13.133,23,8,3,5,15,0,15,0,0.0,0.0
1011,1872,26-09-2019 02:02:00,0,2594.0,2609.0,1.006,13.108,37,2,1,1,35,0,35,0,0.0,0.0
1011,1873,26-09-2019 02:04:00,0,2514.0,2469.0,0.982,12.639,29,10,4,6,19,4,15,0,0.0,0.0
1011,1874,26-09-2019 02:06:00,0,2415.0,2419.0,1.002,12.191,0,0,0,0,0,0,0,0,0.0,0.0
1011,1875,26-09-2019 02:08:00,0,2341.0,2266.0,0.968,11.734,5,5,3,2,0,0,0,0,0.0,0.0
1011,1876,26-09-2019 02:10:00,0,2230.0,2221.0,0.996,11.245,21,8,2,6,13,8,5,0,0.0,0.0
1011,1877,26-09-2019 02:12:00,0,2115.0,2201.0,1.041,10.769,13,12,2,10,1,0,1,0,0.0,0.0
1011,1878,26-09-2019 02:14:00,0,2115.0,2211.0,1.045,10.781,255,137,100,37,118,83,35,4,0.0,0.0
1011,1879,26-09-2019 02:16:00,0,2127.0,2202.0,1.035,10.817,99,30,0,30,69,43,26,0,0.0,0.0
1011,1880,26-09-2019 02:18:00,0,1947.5,1987.0,1.0185,9.8715,106,39,0,39,67,43,24,0,0.0,0.0
1011,1881,26-09-2019 02:20:00,0,1768.0,1772.0,1.002,8.926,5,0,0,0,5,1,4,0,0.0,0.0
1011,1882,26-09-2019 02:22:00,0,1856.0,1868.0,1.006,9.38,12,1,0,1,11,3,8,0,0.0,0.0
1011,1883,26-09-2019 02:24:00,0,1841.0,1933.0,1.05,9.392,0,0,0,0,0,0,0,0,0.0,0.0
1011,1884,26-09-2019 02:26:00,0,1863.0,1824.0,0.979,9.361,5,2,0,2,3,0,3,0,0.0,0.0
1011,1885,26-09-2019 02:28:00,0,1859.0,1827.0,0.983,9.346,2,2,0,2,0,0,0,0,0.0,0.0
1011,1886,26-09-2019 02:30:00,0,1866.0,1828.0,0.979,9.378,8,8,0,8,0,0,0,0,0.0,0.0
1011,1887,26-09-2019 02:32:00,0,1653.0,1733.0,1.048,8.431,92,45,37,8,47,34,13,0,0.0,0.0
1011,1888,26-09-2019 02:34:00,0,2227.0,2242.0,1.007,11.257,239,136,95,41,103,72,31,84,0.0,0.0
1011,1889,26-09-2019 02:36:00,0,2455.0,2707.0,1.102,12.671,211,76,46,30,135,101,34,20,0.0,0.0
1011,1890,26-09-2019 02:38:00,0,2654.0,2814.0,1.06,13.573,130,41,17,24,89,51,38,0,0.0,0.0
1011,1891,26-09-2019 02:40:00,0,2646.0,2827.0,1.069,13.555,19,14,1,13,5,0,5,0,0.0,0.0
1011,1892,26-09-2019 02:42:00,0,2964.0,2993.0,1.01,14.993,103,37,15,22,66,40,26,1,0.0,0.0
1011,1893,26-09-2019 02:44:00,0,2946.0,3037.0,1.031,14.968,76,54,24,30,22,3,19,0,0.0,0.0
1011,1894,26-09-2019 02:46:00,0,2948.0,3071.0,1.042,15.015,95,43,9,34,52,21,31,0,0.0,0.0
1011,1895,26-09-2019 02:48:00,0,2951.0,3048.0,1.033,14.999,155,41,17,24,114,72,42,0,0.0,0.0
1011,1896,26-09-2019 02:50:00,0,3057.0,3128.0,1.023,15.509,211,60,34,26,151,97,54,0,0.0,0.0
1011,1897,26-09-2019 02:52:00,0,3149.5,3179.0,1.0095,15.928,270,144,103,41,126,81,45,30,0.01,0.0
1011,1898,26-09-2019 02:54:00,0,3242.0,3230.0,0.996,16.347,352,216,164,52,136,98,38,59,0.0,0.0
1011,1899,26-09-2019 02:56:00,0,3248.0,3256.0,1.002,16.402,382,234,194,40,148,114,34,178,0.0,0.0
1011,1900,26-09-2019 02:58:00,0,3245.0,3267.0,1.007,16.401,466,257,209,48,209,161,48,260,0.0,0.0
1011,1901,26-09-2019 03:00:00,0,3224.0,3331.0,1.033,16.39,273,209,157,52,64,43,21,92,0.0,0.0
1011,1902,26-09-2019 03:02:00,0,3470.0,3342.0,0.963,17.373,142,105,65,40,37,17,20,55,0.0,0.0
1011,1903,26-09-2019 03:04:00,0,3247.0,3249.0,1.001,16.391,440,255,214,41,185,139,46,125,0.0,0.0
1011,1904,26-09-2019 03:06:00,0,3256.0,3217.0,0.988,16.39,246,113,87,26,133,82,51,60,0.01,0.0
1011,1905,26-09-2019 03:08:00,0,3270.0,3192.0,0.976,16.419,410,277,227,50,133,98,35,57,0.08,0.04
1011,1906,26-09-2019 03:10:00,0,3458.0,3300.0,0.954,17.279,361,215,157,58,146,95,51,128,0.01,0.0
1011,1907,26-09-2019 03:12:00,0,3471.0,3305.0,0.952,17.335,216,135,103,32,81,45,36,109,0.0,0.04
1011,1908,26-09-2019 03:14:00,0,3754.0,3573.0,0.952,18.747,188,115,84,31,73,40,33,21,0.03,0.0
1011,1909,26-09-2019 03:16:00,0,3255.0,3278.0,1.007,16.453,79,36,17,19,43,19,24,50,0.01,0.0
1011,1910,26-09-2019 03:18:00,0,3757.0,3532.0,0.94,18.713,254,131,97,34,123,85,38,75,0.0,0.11
1011,1911,26-09-2019 03:20:00,0,3536.0,3511.0,0.993,17.82,109,81,51,30,28,1,27,70,0.0,0.0
1011,1912,26-09-2019 03:22:00,0,4038.0,3828.0,0.948,20.149,267,139,108,31,128,91,37,42,0.1,0.0
1011,1913,26-09-2019 03:24:00,0,3719.0,3672.0,0.987,18.72,330,164,129,35,166,123,43,17,0.04,0.0
1011,1914,26-09-2019 03:26:00,0,3393.0,3363.0,0.9915,17.0925,430,253,204,49,177,137,40,130,0.0,0.0
1011,1915,26-09-2019 03:28:00,0,3067.0,3054.0,0.996,15.465,398,264,210,54,134,101,33,180,0.06,0.0
1011,1916,26-09-2019 03:30:00,0,3244.0,3251.0,1.002,16.381,466,271,223,48,195,149,46,228,0.0,0.0
1011,1917,26-09-2019 03:32:00,0,3461.0,3314.0,0.958,17.305,474,271,217,54,203,152,51,267,0.0,0.0
1011,1918,26-09-2019 03:34:00,0,3766.0,3550.0,0.942,18.769,234,146,111,35,88,75,13,130,0.0,0.0
1011,1919,26-09-2019 03:36:00,0,3747.0,3563.0,0.951,18.706,205,96,61,35,109,68,41,5,0.0,0.0
1011,1920,26-09-2019 03:38:00,0,3542.0,3514.0,0.992,17.846,40,28,6,22,12,0,12,0,0.0,0.0
1011,1921,26-09-2019 03:40:00,0,3256.0,3232.0,0.993,16.407,53,26,7,19,27,2,25,0,0.0,0.0
1011,1922,26-09-2019 03:42:00,0,3298.0,3103.0,0.941,16.428,4,2,0,2,2,0,2,0,0.0,0.0
1011,1923,26-09-2019 03:44:00,0,3028.0,2801.0,0.925,15.031,0,0,0,0,0,0,0,0,0.0,0.0
1011,1924,26-09-2019 03:46:00,0,2837.0,2592.0,0.914,14.047,4,4,2,2,0,0,0,0,0.0,0.0
1011,1925,26-09-2019 03:48:00,0,2650.0,2413.0,0.91,13.113,9,5,1,4,4,1,3,0,0.0,0.0
1011,1926,26-09-2019 03:50:00,0,2467.0,2236.0,0.907,12.195,1,1,1,0,0,0,0,0,0.0,0.0
1011,1927,26-09-2019 03:52:00,0,2367.0,2167.0,0.916,11.724,0,0,0,0,0,0,0,0,0.0,0.0
1011,1928,26-09-2019 03:54:00,0,2259.0,2109.0,0.934,11.236,0,0,0,0,0,0,0,0,0.0,0.0
1011,1929,26-09-2019 03:56:00,0,2146.0,2115.0,0.985,10.798,27,18,10,8,9,3,6,0,0.0,0.0
1011,1930,26-09-2019 03:58:00,0,2450.0,2305.0,0.941,12.203,0,0,0,0,0,0,0,0,0.0,0.0
1011,1931,26-09-2019 04:00:00,0,2398.0,2277.0,0.9495,11.9685,47,14,7,7,33,20,13,0,0.0,0.0
1011,1932,26-09-2019 04:02:00,0,2346.0,2249.0,0.958,11.734,32,0,0,0,32,0,32,0,0.0,0.0
1011,1933,26-09-2019 04:04:00,0,2342.0,2241.0,0.957,11.709,18,3,0,3,15,2,13,0,0.0,0.0
1011,1934,26-09-2019 04:06:00,0,2240.0,2179.0,0.973,11.236,4,0,0,0,4,2,2,0,0.0,0.0
1011,1935,26-09-2019 04:08:00,0,2136.0,2138.0,1.001,10.783,5,0,0,0,5,2,3,0,0.0,0.0
1011,1936,26-09-2019 04:10:00,0,2139.0,2124.0,0.993,10.781,4,1,1,0,3,0,3,0,0.0,0.0
1011,1937,26-09-2019 04:12:00,0,2033.0,2088.0,1.027,10.32,43,24,20,4,19,11,8,0,0.0,0.0
1011,1938,26-09-2019 04:14:00,0,2240.0,2187.0,0.976,11.246,0,0,0,0,0,0,0,0,0.0,0.0
1011,1939,26-09-2019 04:16:00,0,2067.0,1946.0,0.941,10.3,2,0,0,0,2,1,1,0,0.0,0.0
1011,1940,26-09-2019 04:18:00,0,1969.0,1887.0,0.958,9.849,17,9,3,6,8,4,4,0,0.0,0.0
1011,1941,26-09-2019 04:20:00,0,1856.0,1841.0,0.992,9.352,33,18,9,9,15,7,8,0,0.0,0.0
1011,1942,26-09-2019 04:22:00,0,1854.0,1869.0,1.008,9.375,34,23,3,20,11,2,9,0,0.0,0.0
1011,1943,26-09-2019 04:24:00,0,1852.0,1855.0,1.001,9.352,176,98,75,23,78,56,22,1,0.0,0.0
1011,1944,26-09-2019 04:26:00,0,2517.0,2515.0,0.999,12.702,158,92,48,44,66,39,27,28,0.0,0.0
1011,1945,26-09-2019 04:28:00,0,2706.0,2645.0,0.977,13.591,358,208,166,42,150,118,32,100,0.0,0.0
1011,1946,26-09-2019 04:30:00,0,2682.0,2721.0,1.015,13.578,74,67,41,26,7,2,5,36,0.0,0.0
1011,1947,26-09-2019 04:32:00,0,2991.0,2911.0,0.973,15.007,334,209,159,50,125,90,35,76,0.0,0.0
1011,1948,26-09-2019 04:34:00,0,3045.0,2942.0,0.966,15.2535,86,29,16,13,57,12,45,65,0.0,0.0
1011,1949,26-09-2019 04:36:00,0,3099.0,2973.0,0.959,15.5,162,104,73,31,58,34,24,31,0.0,0.04
1011,1950,26-09-2019 04:38:00,0,2606.0,2609.0,1.001,13.158,328,189,148,41,139,102,37,92,0.01,0.0
1011,1951,26-09-2019 04:40:00,0,2959.0,2996.0,1.012,14.975,424,239,193,46,185,151,34,139,0.05,0.02
1011,1952,26-09-2019 04:42:00,0,2950.0,3038.0,1.03,14.986,354,240,200,40,114,81,33,108,0.01,0.0
1011,1953,26-09-2019 04:44:00,0,2989.0,2937.0,0.983,15.028,340,163,126,37,177,130,47,53,0.0,0.0
1011,1954,26-09-2019 04:46:00,0,2988.0,2941.0,0.984,15.029,189,101,63,38,88,47,41,66,0.0,0.01
1011,1955,26-09-2019 04:48:00,0,3143.0,3177.0,1.011,15.902,273,170,122,48,103,74,29,77,0.02,0.02
1011,1956,26-09-2019 04:50:00,0,3141.0,3210.0,1.022,15.929,421,223,174,49,198,148,50,53,0.01,0.0
1011,1957,26-09-2019 04:52:00,0,3093.0,2973.0,0.961,15.476,300,173,141,32,127,91,36,140,0.0,0.03
1011,1958,26-09-2019 04:54:00,0,3175.0,3050.0,0.961,15.887,425,255,204,51,170,131,39,218,0.0,0.0
1011,1959,26-09-2019 04:56:00,0,3157.0,3181.0,1.007,15.96,356,193,146,47,163,129,34,179,0.05,0.0
1011,1960,26-09-2019 04:58:00,0,3654.0,3496.0,0.957,18.268,116,37,17,20,79,49,30,2,0.0,0.0
1011,1961,26-09-2019 05:00:00,0,3433.0,3429.0,0.999,17.322,369,230,181,49,139,103,36,32,0.0,0.0
1011,1962,26-09-2019 05:02:00,0,3580.0,3372.0,0.942,17.84,350,203,154,49,147,111,36,25,0.0,0.0
1011,1963,26-09-2019 05:04:00,0,3005.0,2821.0,0.939,14.962,252,162,122,40,90,65,25,63,0.01,0.0
1011,1964,26-09-2019 05:06:00,0,3162.0,3188.0,1.008,15.988,411,172,120,52,239,169,70,4,0.0,0.0
1011,1965,26-09-2019 05:08:00,0,3077.5,3032.5,0.9845,15.482,614,362,302,60,252,201,51,88,0.0,0.03
1011,1966,26-09-2019 05:10:00,0,2993.0,2877.0,0.961,14.976,215,125,97,28,90,67,23,76,0.0,0.0
1011,1967,26-09-2019 05:12:00,0,3247.0,3241.0,0.998,16.383,380,182,142,40,198,141,57,47,0.0,0.0
1011,1968,26-09-2019 05:14:00,0,3011.0,2824.0,0.938,14.989,383,167,117,50,216,157,59,32,0.0,0.0
1011,1969,26-09-2019 05:16:00,0,3209.0,2956.0,0.921,15.918,123,81,40,41,42,16,26,80,0.0,0.0
1011,1970,26-09-2019 05:18:00,0,3190.0,3062.0,0.96,15.96,154,81,42,39,73,38,35,20,0.0,0.0
1011,1971,26-09-2019 05:20:00,0,2989.0,2926.0,0.979,15.014,255,63,17,46,192,118,74,11,0.0,0.0
1011,1972,26-09-2019 05:22:00,0,3001.0,2861.0,0.954,14.99,299,160,116,44,139,103,36,104,0.0,0.01
1011,1973,26-09-2019 05:24:00,0,2900.0,2788.0,0.961,14.512,167,73,37,36,94,48,46,2,0.0,0.0
1011,1974,26-09-2019 05:26:00,0,2701.0,2690.0,0.996,13.621,88,37,18,19,51,25,26,1,0.0,0.0
1011,1975,26-09-2019 05:28:00,0,2813.0,2705.0,0.962,14.079,65,29,22,7,36,10,26,0,0.0,0.0
1011,1976,26-09-2019 05:30:00,0,2722.0,2570.0,0.944,13.568,51,2,1,1,49,37,12,0,0.0,0.0
1011,1977,26-09-2019 05:32:00,0,2437.0,2313.0,0.949,12.161,5,4,0,4,1,1,0,0,0.0,0.0
1011,1978,26-09-2019 05:34:00,0,2261.0,2123.0,0.939,11.259,9,3,0,3,6,3,3,0,0.0,0.0
1011,1979,26-09-2019 05:36:00,0,2043.0,2031.0,0.994,10.297,11,1,0,1,10,3,7,0,0.0,0.0
1011,1980,26-09-2019 05:38:00,0,2053.0,2008.0,0.978,10.313,23,2,0,2,21,0,21,0,0.0,0.0
1011,1981,26-09-2019 05:40:00,0,2066.0,1977.0,0.957,10.328,56,10,1,9,46,3,43,0,0.0,0.0
1011,1982,26-09-2019 05:42:00,0,2249.5,2165.5,0.9625,11.2605,314,164,122,42,150,106,44,44,0.0,0.0
1011,1983,26-09-2019 05:44:00,0,2433.0,2354.0,0.968,12.193,375,250,203,47,125,93,32,166,0.0,0.0
1011,1984,26-09-2019 05:46:00,0,2733.0,2538.0,0.929,13.579,387,215,170,45,172,127,45,118,0.0,0.0
1011,1985,26-09-2019 05:48:00,0,3032.0,2779.0,0.916,15.023,420,250,199,51,170,144,26,109,0.03,0.01
1011,1986,26-09-2019 05:50:00,0,2925.0,2710.0,0.927,14.523,422,199,154,45,223,172,51,42,0.0,0.0
1011,1987,26-09-2019 05:52:00,0,2822.0,2666.0,0.944,14.072,244,176,129,47,68,45,23,130,0.0,0.0
1011,1988,26-09-2019 05:54:00,0,3047.0,2698.0,0.885,14.993,102,68,35,33,34,14,20,63,0.0,0.0
1011,1989,26-09-2019 05:56:00,0,3025.0,2723.0,0.9,14.932,144,57,39,18,87,54,33,15,0.0,0.04
1011,1990,26-09-2019 05:58:00,0,2718.0,2590.0,0.953,13.578,85,51,27,24,34,22,12,0,0.0,0.01
1011,1991,26-09-2019 06:00:00,1,2731.0,2551.0,0.934,13.587,185,90,53,37,95,57,38,7,0.0,0.01
1011,1992,26-09-2019 06:02:00,1,2816.0,2654.0,0.942,14.033,308,129,106,23,179,131,48,73,0.0,0.0
1011,1993,26-09-2019 06:04:00,1,2712.0,2622.0,0.967,13.586,97,58,37,21,39,22,17,91,0.0,0.0
1011,1994,26-09-2019 06:06:00,1,2815.0,2677.0,0.951,14.052,132,62,34,28,70,35,35,0,0.0,0.0
1011,1995,26-09-2019 06:08:00,1,2752.0,2534.0,0.921,13.647,31,8,5,3,23,8,15,0,0.01,0.0
1011,1996,26-09-2019 06:10:00,1,2736.0,2515.0,0.919,13.564,89,25,6,19,64,33,31,0,0.0,0.0
1011,1997,26-09-2019 06:12:00,1,2633.0,2469.0,0.938,13.107,48,11,2,9,37,20,17,0,0.0,0.0
1011,1998,26-09-2019 06:14:00,1,2350.0,2234.0,0.951,11.731,1,0,0,0,1,1,0,0,0.0,0.0
1011,1999,26-09-2019 06:16:00,1,2217.5,2067.0,0.931,11.0255,0,0,0,0,0,0,0,0,0.0,0.0
1011,2000,26-09-2019 06:18:00,1,2085.0,1900.0,0.911,10.32,1,0,0,0,1,1,0,0,0.0,0.0
1011,2001,26-09-2019 06:20:00,1,2086.0,1893.0,0.907,10.316,96,18,5,13,78,39,39,0,0.0,0.0
1011,2002,26-09-2019 06:22:00,1,2088.0,1867.0,0.894,10.294,13,0,0,0,13,0,13,0,0.01,0.01
1011,2003,26-09-2019 06:24:00,1,1985.0,1808.0,0.911,9.821,34,6,2,4,28,0,28,0,0.0,0.0
1011,2004,26-09-2019 06:26:00,1,1986.0,1805.0,0.909,9.824,20,4,1,3,16,2,14,0,0.0,0.0
1011,2005,26-09-2019 06:28:00,1,2090.0,1862.0,0.891,10.295,10,1,0,1,9,0,9,0,0.0,0.0
1011,2006,26-09-2019 06:30:00,1,2099.0,1818.0,0.866,10.284,3,0,0,0,3,2,1,0,0.0,0.0
1011,2007,26-09-2019 06:32:00,1,2111.0,1814.0,0.86,10.324,12,2,0,2,10,7,3,0,0.0,0.0
1011,2008,26-09-2019 06:34:00,1,2112.0,1794.0,0.849,10.31,9,1,0,1,8,3,5,0,0.0,0.0
1011,2009,26-09-2019 06:36:00,1,2111.0,1774.0,0.84,10.283,21,0,0,0,21,4,17,0,0.0,0.0
1011,2010,26-09-2019 06:38:00,1,2110.0,1788.0,0.847,10.291,46,8,3,5,38,22,16,0,0.0,0.0
1011,2011,26-09-2019 06:40:00,1,2089.0,1856.0,0.889,10.285,18,1,0,1,17,0,17,0,0.0,0.0
1011,2012,26-09-2019 06:42:00,1,2100.0,1843.0,0.878,10.315,14,14,0,14,0,0,0,0,0.0,0.0
1011,2013,26-09-2019 06:44:00,1,2114.0,1742.0,0.824,10.259,41,27,12,15,14,7,7,0,0.0,0.0
1011,2014,26-09-2019 06:46:00,1,2131.0,1727.0,0.81,10.306,5,4,2,2,1,0,1,0,0.0,0.0
1011,2015,26-09-2019 06:48:00,1,1918.0,1655.0,0.863,9.39,0,0,0,0,0,0,0,0,0.0,0.0
1011,2016,26-09-2019 06:50:00,1,1912.0,1663.0,0.87,9.375,43,17,10,7,26,17,9,0,0.0,0.0
1011,2017,26-09-2019 06:52:00,1,1906.0,1671.0,0.877,9.36,49,15,7,8,34,20,14,0,0.0,0.0
1011,2018,26-09-2019 06:54:00,1,2105.0,1788.0,0.849,10.275,10,9,4,5,1,0,1,0,0.0,0.0
1011,2019,26-09-2019 06:56:00,1,2308.0,1911.0,0.828,11.21,10,9,4,5,1,1,0,0,0.0,0.0
1011,2020,26-09-2019 06:58:00,1,2312.0,1907.0,0.825,11.22,1,0,0,0,1,0,1,0,0.0,0.0
1011,2021,26-09-2019 07:00:00,1,2323.0,1884.0,0.811,11.237,1,0,0,0,1,0,1,0,0.0,0.0
1011,2022,26-09-2019 07:02:00,1,2211.0,1845.0,0.835,10.754,48,28,8,20,20,11,9,0,0.0,0.0
1011,2023,26-09-2019 07:04:00,1,2323.0,1895.0,0.816,11.251,5,0,0,0,5,3,2,0,0.0,0.0
1011,2024,26-09-2019 07:06:00,1,2133.0,1703.0,0.798,10.288,17,2,2,0,15,3,12,0,0.0,0.0
1011,2025,26-09-2019 07:08:00,1,2148.0,1647.0,0.767,10.286,34,8,2,6,26,12,14,0,0.0,0.0
1011,2026,26-09-2019 07:10:00,1,2123.0,1768.0,0.833,10.323,14,1,1,0,13,0,13,0,0.0,0.0
1011,2027,26-09-2019 07:12:00,1,2119.0,1771.0,0.836,10.308,33,6,2,4,27,8,19,0,0.0,0.0
1011,2028,26-09-2019 07:14:00,1,2128.0,1749.0,0.822,10.322,8,0,0,0,8,1,7,0,0.0,0.0
1011,2029,26-09-2019 07:16:00,1,2135.0,1721.0,0.806,10.318,7,0,0,0,7,1,6,0,0.0,0.0
1011,2030,26-09-2019 07:18:00,1,2132.0,1698.0,0.796,10.282,60,10,5,5,50,33,17,0,0.0,0.0
1011,2031,26-09-2019 07:20:00,1,2138.0,1675.0,0.783,10.279,224,43,13,30,181,122,59,0,0.0,0.0
1011,2032,26-09-2019 07:22:00,1,2107.0,1804.0,0.856,10.299,223,87,50,37,136,86,50,6,0.0,0.0
1011,2033,26-09-2019 07:24:00,1,2304.5,1952.5,0.848,11.2415,183,111,82,29,72,54,18,38,0.0,0.0
1011,2034,26-09-2019 07:26:00,1,2502.0,2101.0,0.84,12.184,165,94,66,28,71,46,25,76,0.0,0.0
1011,2035,26-09-2019 07:28:00,1,2617.0,2095.0,0.8,12.629,315,213,168,45,102,75,27,188,0.0,0.0
1011,2036,26-09-2019 07:30:00,1,2597.0,2180.0,0.839,12.645,146,58,28,30,88,58,30,2,0.0,0.0
1011,2037,26-09-2019 07:32:00,1,2601.0,2174.0,0.836,12.655,36,13,4,9,23,10,13,0,0.0,0.03
1011,2038,26-09-2019 07:34:00,1,2606.0,2123.0,0.815,12.617,29,8,2,6,21,12,9,3,0.0,0.03
1011,2039,26-09-2019 07:36:00,1,2396.0,2036.0,0.85,11.695,253,121,87,34,132,94,38,5,0.01,0.0
1011,2040,26-09-2019 07:38:00,1,2607.0,2131.0,0.817,12.631,74,41,31,10,33,23,10,9,0.01,0.0
1011,2041,26-09-2019 07:40:00,1,2575.0,2208.0,0.857,12.592,112,62,41,21,50,33,17,34,0.0,0.0
1011,2042,26-09-2019 07:42:00,1,2398.0,2051.0,0.855,11.72,324,182,133,49,142,104,38,22,0.0,0.0
1011,2043,26-09-2019 07:44:00,1,2402.0,2012.0,0.837,11.692,414,202,152,50,212,156,56,6,0.0,0.0
1011,2044,26-09-2019 07:46:00,1,2612.0,2129.0,0.815,12.65,164,84,60,24,80,50,30,48,0.01,0.0
1011,2045,26-09-2019 07:48:00,1,2506.0,2080.0,0.83,12.177,26,8,4,4,18,5,13,0,0.0,0.0
1011,2046,26-09-2019 07:50:00,1,2406.0,2028.0,0.843,11.724,21,21,0,21,0,0,0,0,0.0,0.0
1011,2047,26-09-2019 07:52:00,1,2419.0,1978.0,0.818,11.722,56,17,3,14,39,20,19,0,0.0,0.0
1011,2048,26-09-2019 07:54:00,1,2410.0,1978.0,0.821,11.686,5,1,0,1,4,3,1,0,0.01,0.0
1011,2049,26-09-2019 07:56:00,1,2097.0,1850.0,0.882,10.312,0,0,0,0,0,0,0,0,0.0,0.0
1011,2050,26-09-2019 07:58:00,1,2110.5,1786.0,0.8465,10.293,13,8,2,6,5,3,2,0,0.0,0.0
1011,2051,26-09-2019 08:00:00,1,2124.0,1722.0,0.811,10.274,10,6,2,4,4,1,3,0,0.0,0.0
1011,2052,26-09-2019 08:02:00,1,2134.0,1715.0,0.804,10.306,31,13,3,10,18,5,13,0,0.0,0.0
1011,2053,26-09-2019 08:04:00,1,2114.0,1762.0,0.834,10.279,42,31,0,31,11,1,10,0,0.0,0.0
1011,2054,26-09-2019 08:06:00,1,2136.0,1693.0,0.793,10.289,35,28,0,28,7,3,4,0,0.0,0.0
1011,2055,26-09-2019 08:08:00,1,2161.0,1626.0,0.752,10.313,7,1,0,1,6,0,6,0,0.0,0.0
1011,2056,26-09-2019 08:10:00,1,1927.0,1576.0,0.818,9.338,18,7,0,7,11,1,10,0,0.0,0.0
1011,2057,26-09-2019 08:12:00,1,1943.0,1531.0,0.788,9.351,24,16,0,16,8,3,5,0,0.0,0.0
1011,2058,26-09-2019 08:14:00,1,2050.0,1563.0,0.762,9.805,39,12,2,10,27,8,19,0,0.01,0.0
1011,2059,26-09-2019 08:16:00,1,2152.0,1628.0,0.757,10.28,17,4,0,4,13,0,13,0,0.0,0.0
1011,2060,26-09-2019 08:18:00,1,2148.0,1652.0,0.769,10.291,43,3,0,3,40,1,39,0,0.0,0.0
1011,2061,26-09-2019 08:20:00,1,2135.0,1695.0,0.794,10.289,31,3,0,3,28,0,28,0,0.0,0.0
1011,2062,26-09-2019 08:22:00,1,2129.0,1719.0,0.807,10.29,3,1,0,1,2,0,2,0,0.0,0.0
1011,2063,26-09-2019 08:24:00,1,2229.0,1785.0,0.801,10.76,44,0,0,0,44,0,44,0,0.0,0.0
1011,2064,26-09-2019 08:26:00,1,2115.0,1724.0,0.815,10.24,52,2,0,2,50,6,44,0,0.0,0.0
1011,2065,26-09-2019 08:28:00,1,2144.0,1680.0,0.784,10.309,20,1,1,0,19,0,19,0,0.0,0.0
1011,2066,26-09-2019 08:30:00,1,2050.0,1563.0,0.762,9.806,3,0,0,0,3,0,3,0,0.0,0.0
1011,2067,26-09-2019 08:32:00,1,1999.0,1532.5,0.7665,9.5725,8,0,0,0,8,1,7,0,0.0,0.0
1011,2068,26-09-2019 08:34:00,1,1948.0,1502.0,0.771,9.339,2,0,0,0,2,1,1,0,0.0,0.0
1011,2069,26-09-2019 08:36:00,1,2059.0,1541.0,0.748,9.817,0,0,0,0,0,0,0,0,0.0,0.0
1011,2070,26-09-2019 08:38:00,1,2156.0,1618.0,0.75,10.284,0,0,0,0,0,0,0,0,0.0,0.0
1011,2071,26-09-2019 08:40:00,1,2156.0,1600.0,0.742,10.267,36,4,1,3,32,11,21,0,0.0,0.0
1011,2072,26-09-2019 08:42:00,1,2141.0,1632.0,0.762,10.244,2,0,0,0,2,1,1,0,0.0,0.0
1011,2073,26-09-2019 08:44:00,1,2166.0,1600.0,0.739,10.305,41,10,6,4,31,22,9,0,0.0,0.0
1011,2074,26-09-2019 08:46:00,1,2152.0,1633.0,0.759,10.286,0,0,0,0,0,0,0,0,0.0,0.0
1011,2075,26-09-2019 08:48:00,1,2051.0,1578.0,0.77,9.828,2,0,0,0,2,1,1,0,0.0,0.0
1011,2076,26-09-2019 08:50:00,1,2051.0,1565.0,0.763,9.811,0,0,0,0,0,0,0,0,0.0,0.0
1011,2077,26-09-2019 08:52:00,1,2156.0,1610.0,0.747,10.276,5,0,0,0,5,3,2,0,0.0,0.0
1011,2078,26-09-2019 08:54:00,1,2144.0,1657.0,0.773,10.281,1,0,0,0,1,0,1,0,0.0,0.0
1011,2079,26-09-2019 08:56:00,1,2146.0,1646.0,0.767,10.277,0,0,0,0,0,0,0,0,0.0,0.0
1011,2080,26-09-2019 08:58:00,1,2151.0,1625.0,0.756,10.274,34,16,6,10,18,11,7,0,0.0,0.0
1011,2081,26-09-2019 09:00:00,1,2167.0,1600.0,0.739,10.309,22,3,1,2,19,5,14,0,0.0,0.0
1011,2082,26-09-2019 09:02:00,1,2053.0,1563.0,0.761,9.82,38,9,5,4,29,15,14,0,0.0,0.0
1011,2083,26-09-2019 09:04:00,1,2122.0,1744.0,0.822,10.291,3,3,1,2,0,0,0,0,0.0,0.0
1011,2084,26-09-2019 09:06:00,1,2227.0,1779.5,0.8,10.7445,5,4,0,4,1,1,0,0,0.0,0.0
1011,2085,26-09-2019 09:08:00,1,2332.0,1815.0,0.778,11.198,2,0,0,0,2,0,2,0,0.0,0.0
1011,2086,26-09-2019 09:10:00,1,2336.0,1824.0,0.781,11.223,11,0,0,0,11,4,7,0,0.0,0.0
1011,2087,26-09-2019 09:12:00,1,2137.0,1671.0,0.782,10.271,13,2,0,2,11,5,6,0,0.0,0.0
1011,2088,26-09-2019 09:14:00,1,1953.0,1502.0,0.769,9.36,9,0,0,0,9,5,4,0,0.0,0.0
1011,2089,26-09-2019 09:16:00,1,1858.0,1413.0,0.76,8.885,19,0,0,0,19,8,11,0,0.0,0.0
1011,2090,26-09-2019 09:18:00,1,1745.0,1388.0,0.796,8.413,7,0,0,0,7,4,3,0,0.0,0.0
1011,2091,26-09-2019 09:20:00,1,1963.0,1460.0,0.744,9.353,0,0,0,0,0,0,0,0,0.0,0.0
1011,2092,26-09-2019 09:22:00,1,2166.0,1584.0,0.731,10.286,0,0,0,0,0,0,0,0,0.0,0.0
1011,2093,26-09-2019 09:24:00,1,2155.0,1578.0,0.732,10.236,6,0,0,0,6,4,2,0,0.0,0.0
1011,2094,26-09-2019 09:26:00,1,2157.0,1626.0,0.754,10.3,107,34,11,23,73,38,35,0,0.0,0.0
1011,2095,26-09-2019 09:28:00,1,2230.0,1770.0,0.794,10.747,125,45,17,28,80,40,40,0,0.0,0.0
1011,2096,26-09-2019 09:30:00,1,2446.0,1857.0,0.759,11.692,152,36,8,28,116,69,47,0,0.0,0.0
1011,2097,26-09-2019 09:32:00,1,2407.0,2013.0,0.836,11.713,207,133,95,38,74,50,24,47,0.0,0.0
1011,2098,26-09-2019 09:34:00,1,2587.0,2185.0,0.844,12.613,123,65,37,28,58,25,33,59,0.0,0.0
1011,2099,26-09-2019 09:36:00,1,2795.0,2332.0,0.834,13.595,154,51,29,22,103,37,66,50,0.0,0.0
1011,2100,26-09-2019 09:38:00,1,3116.0,2410.0,0.773,14.945,160,19,3,16,141,91,50,41,0.0,0.0
1011,2101,26-09-2019 09:40:00,1,3209.0,2520.5,0.785,15.4345,217,141,104,37,76,44,32,50,0.02,0.0
1011,2102,26-09-2019 09:42:00,1,3302.0,2631.0,0.797,15.924,168,39,14,25,129,74,55,70,0.0,0.0
1011,2103,26-09-2019 09:44:00,1,3257.0,2760.0,0.847,15.89,154,56,43,13,98,63,35,19,0.09,0.09
1011,2104,26-09-2019 09:46:00,1,2874.0,2468.0,0.859,14.057,457,262,209,53,195,144,51,74,0.02,0.01
1011,2105,26-09-2019 09:48:00,1,3082.0,2585.0,0.839,15.006,290,156,127,29,134,101,33,205,0.06,0.01
1011,2106,26-09-2019 09:50:00,1,3073.0,2553.0,0.831,14.933,366,205,162,43,161,117,44,73,0.04,0.0
1011,2107,26-09-2019 09:52:00,1,2865.0,2515.0,0.878,14.074,237,121,91,30,116,79,37,39,0.0,0.0
1011,2108,26-09-2019 09:54:00,1,3154.0,2733.0,0.867,15.451,316,204,156,48,112,81,31,18,0.03,0.04
1011,2109,26-09-2019 09:56:00,1,2956.0,2578.0,0.872,14.499,178,67,35,32,111,75,36,1,0.0,0.0
1011,2110,26-09-2019 09:58:00,1,2753.0,2450.0,0.89,13.56,98,52,6,46,46,15,31,0,0.0,0.0
1011,2111,26-09-2019 10:00:00,1,2752.0,2498.0,0.908,13.609,62,13,6,7,49,20,29,0,0.0,0.0
1011,2112,26-09-2019 10:02:00,1,2751.0,2451.0,0.891,13.553,41,11,0,11,30,15,15,0,0.0,0.0
1011,2113,26-09-2019 10:04:00,1,2541.0,2363.0,0.93,12.627,3,0,0,0,3,3,0,0,0.0,0.0
1011,2114,26-09-2019 10:06:00,1,2364.0,2175.0,0.92,11.722,9,2,1,1,7,5,2,0,0.0,0.0
1011,2115,26-09-2019 10:08:00,1,2363.0,2192.0,0.928,11.737,45,10,2,8,35,3,32,0,0.0,0.0
1011,2116,26-09-2019 10:10:00,1,2341.0,2248.0,0.96,11.711,46,0,0,0,46,0,46,0,0.0,0.0
1011,2117,26-09-2019 10:12:00,1,2357.0,2198.0,0.933,11.72,8,0,0,0,8,2,6,0,0.0,0.0
1011,2118,26-09-2019 10:14:00,1,2200.5,2123.0,0.9675,11.02,19,0,0,0,19,1,18,0,0.0,0.0
1011,2119,26-09-2019 10:16:00,1,2044.0,2048.0,1.002,10.32,35,0,0,0,35,12,23,0,0.0,0.0
1011,2120,26-09-2019 10:18:00,1,2056.0,1970.0,0.958,10.282,7,0,0,0,7,2,5,0,0.02,0.0
1011,2121,26-09-2019 10:20:00,1,2054.0,2002.0,0.974,10.31,193,0,0,0,193,162,31,0,0.0,0.0
1011,2122,26-09-2019 10:22:00,1,2085.0,1902.0,0.912,10.32,242,0,0,0,242,186,56,0,0.0,0.0
1011,2123,26-09-2019 10:24:00,1,2075.0,1917.0,0.924,10.298,15,0,0,0,15,1,14,0,0.0,0.0
1011,2124,26-09-2019 10:26:00,1,2088.0,1878.0,0.899,10.305,85,0,0,0,85,38,47,0,0.0,0.0
1011,2125,26-09-2019 10:28:00,1,1974.0,1845.0,0.934,9.821,26,0,0,0,26,6,20,0,0.0,0.0
1011,2126,26-09-2019 10:30:00,1,1983.0,1831.0,0.923,9.84,32,8,6,2,24,13,11,0,0.0,0.0
1011,2127,26-09-2019 10:32:00,1,2078.0,1901.0,0.915,10.293,1,0,0,0,1,0,1,0,0.0,0.0
1011,2128,26-09-2019 10:34:00,1,2049.0,2017.0,0.985,10.306,1,0,0,0,1,0,1,0,0.0,0.0
1011,2129,26-09-2019 10:36:00,1,2073.0,1930.0,0.931,10.304,0,0,0,0,0,0,0,0,0.0,0.0
1011,2130,26-09-2019 10:38:00,1,2072.0,1926.0,0.929,10.298,9,1,1,0,8,4,4,0,0.0,0.0
1011,2131,26-09-2019 10:40:00,1,2076.0,1889.0,0.91,10.273,0,0,0,0,0,0,0,0,0.0,0.0
1011,2132,26-09-2019 10:42:00,1,2116.0,1795.0,0.848,10.324,3,0,0,0,3,0,3,0,0.0,0.0
1011,2133,26-09-2019 10:44:00,1,2000.0,1771.0,0.886,9.84,5,0,0,0,5,1,4,0,0.0,0.0
1011,2134,26-09-2019 10:46:00,1,1897.0,1721.0,0.907,9.379,6,0,0,0,6,2,4,0,0.0,0.0
1011,2135,26-09-2019 10:48:00,1,2062.0,1764.0,0.859,10.078,0,0,0,0,0,0,0,0,0.0,0.0
1011,2136,26-09-2019 10:50:00,1,2227.0,1807.0,0.811,10.777,30,3,2,1,27,13,14,0,0.0,0.0
1011,2137,26-09-2019 10:52:00,1,2213.0,1850.0,0.836,10.769,17,13,1,12,4,2,2,0,0.0,0.0
1011,2138,26-09-2019 10:54:00,1,2234.0,1762.0,0.789,10.752,18,9,0,9,9,6,3,0,0.0,0.0
1011,2139,26-09-2019 10:56:00,1,2124.0,1730.0,0.815,10.284,13,6,1,5,7,4,3,0,0.0,0.0
1011,2140,26-09-2019 10:58:00,1,2022.0,1697.0,0.839,9.844,23,2,0,2,21,0,21,0,0.0,0.0
1011,2141,26-09-2019 11:00:00,1,2027.0,1654.0,0.816,9.817,0,0,0,0,0,0,0,0,0.0,0.0
1011,2142,26-09-2019 11:02:00,1,2028.0,1656.0,0.816,9.825,11,4,0,4,7,3,4,0,0.0,0.0
1011,2143,26-09-2019 11:04:00,1,2138.0,1693.0,0.792,10.299,2,2,0,2,0,0,0,0,0.0,0.0
1011,2144,26-09-2019 11:06:00,1,2014.0,1690.0,0.839,9.806,24,22,0,22,2,1,1,0,0.0,0.0
1011,2145,26-09-2019 11:08:00,1,2234.0,1777.0,0.796,10.769,12,12,0,12,0,0,0,0,0.0,0.0
1011,2146,26-09-2019 11:10:00,1,2235.0,1760.0,0.788,10.754,0,0,0,0,0,0,0,0,0.0,0.0
1011,2147,26-09-2019 11:12:00,1,2126.0,1698.0,0.798,10.258,25,4,0,4,21,7,14,0,0.0,0.0
1011,2148,26-09-2019 11:14:00,1,2028.0,1664.0,0.82,9.834,40,13,9,4,27,17,10,0,0.0,0.0
1011,2149,26-09-2019 11:16:00,1,2037.0,1627.0,0.799,9.827,40,0,0,0,40,33,7,0,0.0,0.0
1011,2150,26-09-2019 11:18:00,1,2248.0,1732.0,0.771,10.776,5,0,0,0,5,2,3,0,0.0,0.0
1011,2151,26-09-2019 11:20:00,1,2224.0,1801.0,0.81,10.755,23,0,0,0,23,2,21,0,0.0,0.0
1011,2152,26-09-2019 11:22:00,1,2227.0,1806.0,0.811,10.7735,13,0,0,0,13,2,11,0,0.0,0.0
1011,2153,26-09-2019 11:24:00,1,2230.0,1811.0,0.812,10.792,0,0,0,0,0,0,0,0,0.0,0.0
1011,2154,26-09-2019 11:26:00,1,2236.0,1734.0,0.776,10.731,148,45,13,32,103,63,40,1,0.0,0.0
1011,2155,26-09-2019 11:28:00,1,2215.0,1859.0,0.839,10.784,68,30,4,26,38,8,30,0,0.0,0.0
1011,2156,26-09-2019 11:30:00,1,2532.0,1987.0,0.785,12.178,111,16,4,12,95,59,36,0,0.0,0.0
1011,2157,26-09-2019 11:32:00,1,2516.0,2000.0,0.795,12.128,89,37,19,18,52,27,25,0,0.0,0.0
1011,2158,26-09-2019 11:34:00,1,2597.0,2163.0,0.833,12.627,108,30,12,18,78,36,42,0,0.0,0.0
1011,2159,26-09-2019 11:36:00,1,2672.0,2338.0,0.875,13.114,144,63,32,31,81,54,27,54,0.0,0.0
1011,2160,26-09-2019 11:38:00,1,2877.0,2462.0,0.856,14.062,229,113,81,32,116,79,37,83,0.0,0.0
1011,2161,26-09-2019 11:40:00,1,2894.0,2373.0,0.82,14.029,386,175,134,41,211,155,56,42,0.01,0.02
1011,2162,26-09-2019 11:42:00,1,2872.0,2453.0,0.854,14.032,412,244,191,53,168,130,38,23,0.05,0.01
1011,2163,26-09-2019 11:44:00,1,2897.0,2387.0,0.824,14.057,332,169,123,46,163,119,44,38,0.0,0.0
1011,2164,26-09-2019 11:46:00,1,2685.0,2306.0,0.859,13.132,386,171,123,48,215,162,53,12,0.0,0.0
1011,2165,26-09-2019 11:48:00,1,3180.0,2632.0,0.827,15.444,274,147,106,41,127,90,37,12,0.02,0.0
1011,2166,26-09-2019 11:50:00,1,3196.0,2595.0,0.812,15.466,231,112,84,28,119,81,38,41,0.0,0.01
1011,2167,26-09-2019 11:52:00,1,2683.0,2321.0,0.865,13.142,171,73,49,24,98,61,37,63,0.0,0.02
1011,2168,26-09-2019 11:54:00,1,2966.0,2549.0,0.859,14.508,149,38,4,34,111,79,32,52,0.0,0.03
1011,2169,26-09-2019 11:56:00,1,2959.0,2553.5,0.863,14.4855,120,35,21,14,85,53,32,42,0.0,0.11
1011,2170,26-09-2019 11:58:00,1,2952.0,2558.0,0.867,14.463,184,50,25,25,134,84,50,0,0.01,0.01
1011,2171,26-09-2019 12:00:00,1,2779.0,2368.0,0.852,13.571,113,44,23,21,69,29,40,0,0.0,0.0
1011,2172,26-09-2019 12:02:00,1,2814.0,2256.0,0.802,13.585,29,1,1,0,28,18,10,0,0.01,0.0
1011,2173,26-09-2019 12:04:00,1,2596.0,2157.0,0.831,12.617,21,0,0,0,21,1,20,0,0.0,0.01
1011,2174,26-09-2019 12:06:00,1,2508.0,2095.0,0.835,12.203,16,0,0,0,16,0,16,0,0.0,0.0
1011,2175,26-09-2019 12:08:00,1,2294.0,1944.0,0.847,11.192,26,6,3,3,20,8,12,0,0.0,0.0
1011,2176,26-09-2019 12:10:00,1,2205.0,1867.0,0.847,10.754,0,0,0,0,0,0,0,0,0.0,0.0
1011,2177,26-09-2019 12:12:00,1,2104.0,1822.0,0.866,10.306,1,0,0,0,1,0,1,0,0.0,0.0
1011,2178,26-09-2019 12:14:00,1,2095.0,1823.0,0.87,10.273,6,0,0,0,6,6,0,0,0.0,0.01
1011,2179,26-09-2019 12:16:00,1,2090.0,1877.0,0.898,10.312,4,0,0,0,4,4,0,0,0.0,0.02
1011,2180,26-09-2019 12:18:00,1,2369.0,2115.0,0.893,11.677,21,7,3,4,14,8,6,0,0.0,0.0
1011,2181,26-09-2019 12:20:00,1,2586.0,2204.0,0.852,12.628,4,3,1,2,1,0,1,0,0.0,0.0
1011,2182,26-09-2019 12:22:00,1,2576.0,2235.0,0.868,12.624,2,2,0,2,0,0,0,0,0.0,0.0
1011,2183,26-09-2019 12:24:00,1,2478.0,2187.0,0.882,12.186,22,12,2,10,10,1,9,0,0.0,0.0
1011,2184,26-09-2019 12:26:00,1,2261.0,2112.0,0.934,11.248,16,2,1,1,14,4,10,0,0.0,0.0
1011,2185,26-09-2019 12:28:00,1,2301.0,1965.0,0.854,11.242,1,0,0,0,1,0,1,0,0.0,0.0
1011,2186,26-09-2019 12:30:00,1,2131.0,1936.5,0.9135,10.5405,1,0,0,0,1,0,1,0,0.0,0.0
1011,2187,26-09-2019 12:32:00,1,1961.0,1908.0,0.973,9.839,0,0,0,0,0,0,0,0,0.0,0.0
1011,2188,26-09-2019 12:34:00,1,2181.0,1940.0,0.89,10.741,53,8,6,2,45,25,20,0,0.0,0.0
1011,2189,26-09-2019 12:36:00,1,2146.0,2111.0,0.984,10.792,14,0,0,0,14,7,7,0,0.01,0.01
1011,2190,26-09-2019 12:38:00,1,2429.0,2341.0,0.964,12.164,29,0,0,0,29,13,16,0,0.0,0.0
1011,2191,26-09-2019 12:40:00,1,2453.0,2264.0,0.923,12.169,5,0,0,0,5,1,4,0,0.0,0.0
1011,2192,26-09-2019 12:42:00,1,2447.0,2310.0,0.944,12.198,17,9,2,7,8,2,6,0,0.0,0.0
1011,2193,26-09-2019 12:44:00,1,2464.0,2224.0,0.902,12.171,141,32,9,23,109,80,29,0,0.0,0.0
1011,2194,26-09-2019 12:46:00,1,2151.0,2107.0,0.98,10.807,33,0,0,0,33,0,33,0,0.0,0.0
1011,2195,26-09-2019 12:48:00,1,2196.0,1921.0,0.875,10.778,33,0,0,0,33,0,33,0,0.0,0.0
1011,2196,26-09-2019 12:50:00,1,1968.0,1849.0,0.94,9.8,98,23,14,9,75,33,42,0,0.0,0.0
1011,2197,26-09-2019 12:52:00,1,2165.0,2015.0,0.931,10.759,71,18,0,18,53,12,41,0,0.0,0.0
1011,2198,26-09-2019 12:54:00,1,2253.0,2147.0,0.953,11.255,125,40,2,38,85,46,39,0,0.0,0.0
1011,2199,26-09-2019 12:56:00,1,2467.0,2222.0,0.901,12.179,102,39,16,23,63,29,34,0,0.0,0.0
1011,2200,26-09-2019 12:58:00,1,2625.0,2497.0,0.951,13.106,96,29,8,21,67,45,22,0,0.0,0.0
1011,2201,26-09-2019 13:00:00,1,2633.0,2434.0,0.924,13.07,107,26,8,18,81,36,45,0,0.0,0.0
1011,2202,26-09-2019 13:02:00,1,2646.0,2433.0,0.92,13.117,36,8,2,6,28,13,15,0,0.0,0.0
1011,2203,26-09-2019 13:04:00,1,2660.5,2388.0,0.898,13.1255,6,1,0,1,5,0,5,0,0.0,0.0
1011,2204,26-09-2019 13:06:00,1,2675.0,2343.0,0.876,13.134,55,13,2,11,42,17,25,0,0.0,0.0
1011,2205,26-09-2019 13:08:00,1,2674.0,2355.0,0.881,13.143,24,4,0,4,20,12,8,0,0.0,0.0
1011,2206,26-09-2019 13:10:00,1,2590.0,2160.0,0.834,12.598,0,0,0,0,0,0,0,0,0.0,0.0
1011,2207,26-09-2019 13:12:00,1,2285.0,2031.0,0.889,11.25,1,1,0,1,0,0,0,0,0.0,0.0
1011,2208,26-09-2019 13:14:00,1,2307.0,1951.0,0.846,11.252,26,14,3,11,12,7,5,0,0.0,0.0
1011,2209,26-09-2019 13:16:00,1,2285.0,2012.0,0.88,11.231,9,6,1,5,3,1,2,0,0.0,0.0
1011,2210,26-09-2019 13:18:00,1,2299.0,1948.0,0.847,11.215,1,0,0,0,1,0,1,0,0.0,0.0
1011,2211,26-09-2019 13:20:00,1,2309.0,1895.0,0.821,11.197,0,0,0,0,0,0,0,0,0.0,0.0
1011,2212,26-09-2019 13:22:00,1,2298.0,1949.0,0.848,11.214,4,2,1,1,2,0,2,0,0.0,0.0
1011,2213,26-09-2019 13:24:00,1,2326.0,1862.0,0.801,11.225,0,0,0,0,0,0,0,0,0.0,0.0
1011,2214,26-09-2019 13:26:00,1,2340.0,1807.0,0.772,11.222,0,0,0,0,0,0,0,0,0.0,0.0
1011,2215,26-09-2019 13:28:00,1,2336.0,1863.0,0.797,11.266,0,0,0,0,0,0,0,0,0.0,0.0
1011,2216,26-09-2019 13:30:00,1,2127.0,1703.0,0.801,10.265,3,1,0,1,2,0,2,0,0.0,0.0
1011,2217,26-09-2019 13:32:00,1,2341.0,1802.0,0.77,11.22,21,6,4,2,15,10,5,0,0.0,0.0
1011,2218,26-09-2019 13:34:00,1,2239.0,1740.0,0.777,10.75,1,1,0,1,0,0,0,0,0.0,0.0
1011,2219,26-09-2019 13:36:00,1,2243.0,1723.0,0.768,10.747,9,4,2,2,5,2,3,0,0.0,0.0
1011,2220,26-09-2019 13:38:00,1,2225.0,1791.0,0.805,10.7495,5,1,0,1,4,2,2,0,0.0,0.0
1011,2221,26-09-2019 13:40:00,1,2207.0,1859.0,0.842,10.752,0,0,0,0,0,0,0,0,0.0,0.0
1011,2222,26-09-2019 13:42:00,1,2205.0,1862.0,0.844,10.749,0,0,0,0,0,0,0,0,0.0,0.0
1011,2223,26-09-2019 13:44:00,1,2219.0,1819.0,0.819,10.758,3,0,0,0,3,1,2,0,0.0,0.0
1011,2224,26-09-2019 13:46:00,1,2234.0,1757.0,0.787,10.748,0,0,0,0,0,0,0,0,0.0,0.0
1011,2225,26-09-2019 13:48:00,1,2135.0,1705.0,0.798,10.3,6,0,0,0,6,2,4,0,0.0,0.0
1011,2226,26-09-2019 13:50:00,1,2247.0,1723.0,0.767,10.763,2,2,1,1,0,0,0,0,0.0,0.0
1011,2227,26-09-2019 13:52:00,1,2240.0,1739.0,0.777,10.75,2,1,0,1,1,1,0,0,0.0,0.0
1011,2228,26-09-2019 13:54:00,1,2245.0,1727.0,0.77,10.757,0,0,0,0,0,0,0,0,0.0,0.0
1011,2229,26-09-2019 13:56:00,1,2028.0,1649.0,0.813,9.815,7,0,0,0,7,5,2,0,0.0,0.0
1011,2230,26-09-2019 13:58:00,1,2031.0,1657.0,0.816,9.837,3,0,0,0,3,0,3,0,0.0,0.0
1011,2231,26-09-2019 14:00:00,1,2028.0,1671.0,0.824,9.841,1,0,0,0,1,0,1,0,0.0,0.0
1011,2232,26-09-2019 14:02:00,1,2135.0,1686.0,0.789,10.28,30,11,6,5,19,12,7,0,0.0,0.0
1011,2233,26-09-2019 14:04:00,1,2233.0,1788.0,0.801,10.78,24,4,4,0,20,6,14,0,0.0,0.0
1011,2234,26-09-2019 14:06:00,1,2026.0,1658.0,0.819,9.817,0,0,0,0,0,0,0,0,0.0,0.0
1011,2235,26-09-2019 14:08:00,1,2037.0,1599.0,0.785,9.795,1,0,0,0,1,1,0,0,0.0,0.0
1011,2236,26-09-2019 14:10:00,1,2242.0,1734.0,0.774,10.753,7,2,0,2,5,3,2,0,0.0,0.0
1011,2237,26-09-2019 14:12:00,1,2232.0,1770.5,0.7935,10.753,2,1,0,1,1,1,0,0,0.0,0.0
1011,2238,26-09-2019 14:14:00,1,2222.0,1807.0,0.813,10.753,68,36,12,24,32,11,21,0,0.0,0.0
1011,2239,26-09-2019 14:16:00,1,2498.0,2103.0,0.842,12.172,42,21,0,21,21,6,15,0,0.0,0.0
1011,2240,26-09-2019 14:18:00,1,2706.0,2160.0,0.798,13.054,106,50,28,22,56,24,32,14,0.0,0.0
1011,2241,26-09-2019 14:20:00,1,2792.0,2349.0,0.842,13.601,134,40,16,24,94,51,43,46,0.0,0.02
1011,2242,26-09-2019 14:22:00,1,3167.0,2660.0,0.84,15.423,94,20,10,10,74,46,28,44,0.0,0.04
1011,2243,26-09-2019 14:24:00,1,3078.0,2575.0,0.837,14.977,65,20,9,11,45,30,15,15,0.0,0.28
1011,2244,26-09-2019 14:26:00,1,2889.0,2421.0,0.838,14.064,341,223,188,35,118,94,24,69,0.06,0.01
1011,2245,26-09-2019 14:28:00,1,2877.0,2458.0,0.854,14.057,256,178,134,44,78,62,16,9,0.05,0.0
1011,2246,26-09-2019 14:30:00,1,2864.0,2448.0,0.855,13.994,365,212,161,51,153,104,49,11,0.04,0.0
1011,2247,26-09-2019 14:32:00,1,2867.0,2516.0,0.878,14.084,174,39,10,29,135,92,43,1,0.0,0.0
1011,2248,26-09-2019 14:34:00,1,2652.0,2380.0,0.897,13.082,122,21,7,14,101,61,40,0,0.0,0.0
1011,2249,26-09-2019 14:36:00,1,2875.0,2501.0,0.87,14.097,158,87,54,33,71,32,39,0,0.0,0.0
1011,2250,26-09-2019 14:38:00,1,2834.0,2625.0,0.926,14.071,66,30,8,22,36,12,24,0,0.0,0.0
1011,2251,26-09-2019 14:40:00,1,2746.0,2503.0,0.911,13.59,10,9,1,8,1,0,1,0,0.0,0.0
1011,2252,26-09-2019 14:42:00,1,2570.0,2294.0,0.892,12.667,27,12,5,7,15,11,4,0,0.0,0.0
1011,2253,26-09-2019 14:44:00,1,2476.0,2165.0,0.875,12.152,2,2,0,2,0,0,0,0,0.0,0.0
1011,2254,26-09-2019 14:46:00,1,2425.5,2150.0,0.887,11.936,15,7,1,6,8,1,7,0,0.0,0.01
1011,2255,26-09-2019 14:48:00,1,2375.0,2135.0,0.899,11.72,11,6,2,4,5,0,5,0,0.0,0.0
1011,2256,26-09-2019 14:50:00,1,2370.0,2144.0,0.904,11.713,0,0,0,0,0,0,0,0,0.0,0.0
1011,2257,26-09-2019 14:52:00,1,2252.0,2133.0,0.947,11.235,9,4,0,4,5,3,2,0,0.0,0.0
1011,2258,26-09-2019 14:54:00,1,2248.0,2112.0,0.94,11.196,6,0,0,0,6,3,3,0,0.0,0.0
1011,2259,26-09-2019 14:56:00,1,2366.0,2181.0,0.922,11.736,0,0,0,0,0,0,0,0,0.0,0.0
1011,2260,26-09-2019 14:58:00,1,2462.0,2238.0,0.909,12.179,31,4,0,4,27,6,21,0,0.0,0.0
1011,2261,26-09-2019 15:00:00,1,2355.0,2205.0,0.937,11.718,18,9,0,9,9,1,8,0,0.0,0.0
1011,2262,26-09-2019 15:02:00,1,2247.0,2121.0,0.944,11.203,29,9,0,9,20,12,8,0,0.0,0.0
1011,2263,26-09-2019 15:04:00,1,2140.0,2124.0,0.992,10.782,2,0,0,0,2,0,2,0,0.0,0.0
1011,2264,26-09-2019 15:06:00,1,2148.0,2109.0,0.982,10.799,30,9,5,4,21,13,8,0,0.0,0.0
1011,2265,26-09-2019 15:08:00,1,2187.0,1961.0,0.896,10.789,4,1,1,0,3,1,2,0,0.0,0.0
1011,2266,26-09-2019 15:10:00,1,2081.0,1882.0,0.904,10.285,2,1,1,0,1,0,1,0,0.0,0.0
1011,2267,26-09-2019 15:12:00,1,2086.0,1865.0,0.894,10.283,13,4,2,2,9,5,4,0,0.0,0.0
1011,2268,26-09-2019 15:14:00,1,2201.0,1905.0,0.866,10.783,7,0,0,0,7,4,3,0,0.0,0.0
1011,2269,26-09-2019 15:16:00,1,2182.0,1984.0,0.91,10.792,0,0,0,0,0,0,0,0,0.0,0.0
1011,2270,26-09-2019 15:18:00,1,2179.0,1982.0,0.91,10.781,1,0,0,0,1,0,1,0,0.0,0.0
1011,2271,26-09-2019 15:20:00,1,2193.5,1927.5,0.879,10.7775,0,0,0,0,0,0,0,0,0.0,0.0
1011,2272,26-09-2019 15:22:00,1,2208.0,1873.0,0.848,10.774,20,20,1,19,0,0,0,0,0.0,0.0
1011,2273,26-09-2019 15:24:00,1,1998.0,1796.0,0.899,9.86,22,10,1,9,12,6,6,0,0.0,0.0
1011,2274,26-09-2019 15:26:00,1,2207.0,1863.0,0.844,10.758,5,1,1,0,4,1,3,0,0.0,0.0
1011,2275,26-09-2019 15:28:00,1,2095.0,1847.0,0.882,10.298,10,5,2,3,5,3,2,0,0.0,0.0
1011,2276,26-09-2019 15:30:00,1,2100.0,1809.0,0.861,10.278,44,10,6,4,34,22,12,0,0.01,0.0
1011,2277,26-09-2019 15:32:00,1,2288.0,2038.0,0.891,11.269,88,28,21,7,60,40,20,0,0.0,0.0
1011,2278,26-09-2019 15:34:00,1,2656.0,2366.0,0.891,13.084,0,0,0,0,0,0,0,0,0.0,0.0
1011,2279,26-09-2019 15:36:00,1,3133.0,2783.0,0.888,15.427,138,102,72,30,36,23,13,68,0.0,0.01
1011,2280,26-09-2019 15:38:00,1,2645.0,2415.0,0.913,13.096,442,300,243,57,142,107,35,120,0.03,0.0
1011,2281,26-09-2019 15:40:00,1,2831.0,2612.0,0.923,14.044,275,166,131,35,109,81,28,129,0.04,0.0
1011,2282,26-09-2019 15:42:00,1,2825.0,2666.0,0.944,14.081,372,204,156,48,168,118,50,86,0.03,0.0
1011,2283,26-09-2019 15:44:00,1,2812.0,2686.0,0.955,14.054,309,180,146,34,129,100,29,91,0.03,0.0
1011,2284,26-09-2019 15:46:00,1,3030.0,2775.0,0.916,15.008,129,42,22,20,87,51,36,0,0.0,0.0
1011,2285,26-09-2019 15:48:00,1,2827.0,2611.0,0.924,14.028,139,18,5,13,121,71,50,0,0.01,0.0
1011,2286,26-09-2019 15:50:00,1,2814.0,2659.0,0.945,14.03,89,4,1,3,85,65,20,0,0.0,0.0
1011,2287,26-09-2019 15:52:00,1,2804.0,2709.0,0.966,14.047,232,13,1,12,219,194,25,0,0.0,0.0
1011,2288,26-09-2019 15:54:00,1,2857.0,2724.5,0.9535,14.2735,249,24,7,17,225,191,34,0,0.0,0.0
1011,2289,26-09-2019 15:56:00,1,2910.0,2740.0,0.941,14.5,66,23,6,17,43,15,28,0,0.0,0.0
1011,2290,26-09-2019 15:58:00,1,2806.0,2731.0,0.973,14.078,64,11,3,8,53,27,26,0,0.0,0.0
1011,2291,26-09-2019 16:00:00,1,2821.0,2656.0,0.942,14.057,12,1,0,1,11,8,3,0,0.0,0.0
1011,2292,26-09-2019 16:02:00,1,2629.0,2495.0,0.949,13.119,8,0,0,0,8,1,7,0,0.0,0.0
1011,2293,26-09-2019 16:04:00,1,2446.0,2329.0,0.952,12.214,0,0,0,0,0,0,0,0,0.0,0.0
1011,2294,26-09-2019 16:06:00,1,2256.0,2139.0,0.948,11.255,5,1,0,1,4,2,2,0,0.0,0.0
1011,2295,26-09-2019 16:08:00,1,2178.0,1959.0,0.9,10.752,0,0,0,0,0,0,0,0,0.0,0.0
1011,2296,26-09-2019 16:10:00,1,2198.0,1917.0,0.872,10.781,2,2,1,1,0,0,0,0,0.0,0.0
1011,2297,26-09-2019 16:12:00,1,1984.0,1832.0,0.923,9.846,6,6,0,6,0,0,0,0,0.0,0.0
1011,2298,26-09-2019 16:14:00,1,1978.0,1810.0,0.915,9.799,4,2,1,1,2,1,1,0,0.0,0.0
1011,2299,26-09-2019 16:16:00,1,2207.0,1875.0,0.85,10.771,16,0,0,0,16,3,13,0,0.0,0.0
1011,2300,26-09-2019 16:18:00,1,2091.0,1853.0,0.886,10.291,6,0,0,0,6,0,6,0,0.0,0.0
1011,2301,26-09-2019 16:20:00,1,1994.0,1789.0,0.897,9.838,3,0,0,0,3,0,3,0,0.01,0.0
1011,2302,26-09-2019 16:22:00,1,2214.0,1862.0,0.841,10.784,16,6,4,2,10,7,3,0,0.0,0.0
1011,2303,26-09-2019 16:24:00,1,2273.0,2053.0,0.903,11.227,0,0,0,0,0,0,0,0,0.0,0.0
1011,2304,26-09-2019 16:26:00,1,2160.0,2049.0,0.948,10.781,4,0,0,0,4,3,1,0,0.0,0.0
1011,2305,26-09-2019 16:28:00,1,2226.0,2021.0,0.9085,11.0085,28,10,2,8,18,10,8,0,0.0,0.0
1011,2306,26-09-2019 16:30:00,1,2292.0,1993.0,0.869,11.236,0,0,0,0,0,0,0,0,0.0,0.0
1011,2307,26-09-2019 16:32:00,1,2299.0,1950.0,0.848,11.219,7,5,0,5,2,0,2,0,0.0,0.0
1011,2308,26-09-2019 16:34:00,1,2299.0,1995.0,0.867,11.267,9,0,0,0,9,0,9,0,0.0,0.0
1011,2309,26-09-2019 16:36:00,1,2301.0,1961.0,0.852,11.236,67,34,17,17,33,25,8,0,0.0,0.0
1011,2310,26-09-2019 16:38:00,1,2311.0,1931.0,0.835,11.245,30,2,0,2,28,22,6,0,0.0,0.0
1011,2311,26-09-2019 16:40:00,1,2328.0,1830.0,0.786,11.197,12,2,0,2,10,4,6,0,0.0,0.0
1011,2312,26-09-2019 16:42:00,1,2341.0,1811.0,0.773,11.229,110,0,0,0,110,70,40,0,0.0,0.0
1011,2313,26-09-2019 16:44:00,1,2343.0,1809.0,0.772,11.233,58,10,2,8,48,31,17,0,0.0,0.0
1011,2314,26-09-2019 16:46:00,1,2340.0,1803.0,0.771,11.216,196,48,22,26,148,99,49,0,0.0,0.0
1011,2315,26-09-2019 16:48:00,1,2317.0,1884.0,0.813,11.213,153,42,22,20,111,71,40,0,0.0,0.0
1011,2316,26-09-2019 16:50:00,1,2625.0,2078.0,0.791,12.644,83,39,8,31,44,16,28,0,0.0,0.0
1011,2317,26-09-2019 16:52:00,1,2599.0,2111.0,0.812,12.577,67,22,3,19,45,16,29,0,0.0,0.0
1011,2318,26-09-2019 16:54:00,1,2614.0,2105.0,0.805,12.631,123,43,16,27,80,40,40,1,0.0,0.0
1011,2319,26-09-2019 16:56:00,1,2603.0,2099.0,0.806,12.581,150,86,55,31,64,36,28,53,0.0,0.0
1011,2320,26-09-2019 16:58:00,1,2803.0,2305.0,0.822,13.596,384,240,184,56,144,112,32,52,0.0,0.01
1011,2321,26-09-2019 17:00:00,1,2798.0,2285.0,0.817,13.553,416,245,180,65,171,133,38,71,0.0,0.02
1011,2322,26-09-2019 17:02:00,1,2711.0,2174.0,0.8015,13.0875,232,132,89,43,100,65,35,11,0.0,0.02
1011,2323,26-09-2019 17:04:00,1,2624.0,2063.0,0.786,12.622,522,319,255,64,203,155,48,11,0.0,0.01
1011,2324,26-09-2019 17:06:00,1,2801.0,2299.0,0.821,13.58,270,179,144,35,91,70,21,15,0.03,0.01
1011,2325,26-09-2019 17:08:00,1,2701.0,2198.0,0.814,13.074,19,11,1,10,8,8,0,0,0.0,0.0
1011,2326,26-09-2019 17:10:00,1,2715.0,2211.0,0.814,13.147,48,20,6,14,28,9,19,1,0.01,0.0
1011,2327,26-09-2019 17:12:00,1,2789.0,2294.0,0.822,13.528,9,0,0,0,9,0,9,0,0.0,0.0
1011,2328,26-09-2019 17:14:00,1,2601.0,2176.0,0.837,12.657,1,1,0,1,0,0,0,0,0.0,0.0
1011,2329,26-09-2019 17:16:00,1,2513.0,2053.0,0.817,12.176,12,1,0,1,11,0,11,0,0.0,0.0
1011,2330,26-09-2019 17:18:00,1,2304.0,1926.0,0.836,11.212,33,0,0,0,33,0,33,0,0.0,0.0
1011,2331,26-09-2019 17:20:00,1,2344.0,1824.0,0.778,11.257,42,0,0,0,42,0,42,0,0.0,0.0
1011,2332,26-09-2019 17:22:00,1,2225.0,1791.0,0.805,10.751,58,9,3,6,49,0,49,0,0.0,0.0
1011,2333,26-09-2019 17:24:00,1,2225.0,1767.0,0.794,10.724,38,0,0,0,38,0,38,0,0.0,0.0
1011,2334,26-09-2019 17:26:00,1,2149.0,1660.0,0.772,10.306,42,1,0,1,41,0,41,0,0.0,0.0
1011,2335,26-09-2019 17:28:00,1,2155.0,1626.0,0.755,10.289,51,6,0,6,45,12,33,0,0.0,0.0
1011,2336,26-09-2019 17:30:00,1,2327.0,1827.0,0.785,11.192,41,3,2,1,38,2,36,0,0.0,0.0
1011,2337,26-09-2019 17:32:00,1,2310.0,1914.0,0.829,11.22,40,0,0,0,40,0,40,0,0.0,0.0
1011,2338,26-09-2019 17:34:00,1,2346.0,1836.0,0.783,11.277,42,3,0,3,39,0,39,0,0.0,0.0
1011,2339,26-09-2019 17:36:00,1,2346.0,1816.0,0.7745,11.2545,91,47,12,35,44,17,27,0,0.0,0.0
1011,2340,26-09-2019 17:38:00,1,2346.0,1796.0,0.766,11.232,111,107,68,39,4,2,2,0,0.01,0.0
1011,2341,26-09-2019 17:40:00,1,2123.0,1716.0,0.808,10.267,66,36,18,18,30,6,24,0,0.0,0.0
1011,2342,26-09-2019 17:42:00,1,2526.0,1998.0,0.791,12.164,115,58,22,36,57,26,31,0,0.0,0.0
1011,2343,26-09-2019 17:44:00,1,2587.0,2189.0,0.846,12.617,74,12,1,11,62,35,27,0,0.0,0.0
1011,2344,26-09-2019 17:46:00,1,2595.0,2192.0,0.845,12.65,44,20,1,19,24,9,15,0,0.0,0.0
1011,2345,26-09-2019 17:48:00,1,2788.0,2349.0,0.843,13.585,51,23,4,19,28,12,16,0,0.0,0.0
1011,2346,26-09-2019 17:50:00,1,2806.0,2271.0,0.81,13.57,55,22,1,21,33,13,20,0,0.0,0.0
1011,2347,26-09-2019 17:52:00,1,2878.0,2409.0,0.837,14.006,257,130,87,43,127,86,41,48,0.0,0.23
1011,2348,26-09-2019 17:54:00,1,2992.0,2450.0,0.819,14.501,44,0,0,0,44,0,44,0,0.0,0.02
1011,2349,26-09-2019 17:56:00,1,3013.0,2397.0,0.795,14.526,174,82,65,17,92,49,43,25,0.0,0.0
1011,2350,26-09-2019 17:58:00,1,3100.0,2486.0,0.802,14.969,325,153,119,34,172,128,44,25,0.03,0.0
1011,2351,26-09-2019 18:00:00,0,2782.0,2347.0,0.844,13.559,395,192,158,34,203,159,44,170,0.01,0.0
1011,2352,26-09-2019 18:02:00,0,3256.0,2755.0,0.846,15.878,794,486,397,89,308,249,59,61,0.0,0.0
1011,2353,26-09-2019 18:04:00,0,3248.0,2818.0,0.868,15.916,423,254,210,44,169,123,46,206,0.0,0.0
1011,2354,26-09-2019 18:06:00,0,3451.0,2926.0,0.848,16.837,583,378,314,64,205,156,49,118,0.03,0.0
1011,2355,26-09-2019 18:08:00,0,3625.0,3175.0,0.876,17.796,391,218,179,39,173,129,44,49,0.01,0.0
1011,2356,26-09-2019 18:10:00,0,3516.5,3096.5,0.881,17.2815,374,223,177,46,151,114,37,99,0.01,0.0
1011,2357,26-09-2019 18:12:00,0,3408.0,3018.0,0.886,16.767,245,168,122,46,77,62,15,109,0.01,0.0
1011,2358,26-09-2019 18:14:00,0,3513.0,3147.0,0.896,17.327,158,116,66,50,42,28,14,31,0.01,0.0
1011,2359,26-09-2019 18:16:00,0,3612.0,3232.0,0.895,17.81,177,134,97,37,43,28,15,13,0.0,0.0
1011,2360,26-09-2019 18:18:00,0,3713.0,3276.0,0.882,18.257,55,28,7,21,27,9,18,0,0.0,0.0
1011,2361,26-09-2019 18:20:00,0,3499.0,3201.0,0.915,17.328,73,47,20,27,26,10,16,0,0.0,0.0
1011,2362,26-09-2019 18:22:00,0,3693.0,3339.0,0.904,18.246,138,114,71,43,24,12,12,0,0.0,0.0
1011,2363,26-09-2019 18:24:00,0,3687.0,3371.0,0.914,18.259,226,145,109,36,81,56,25,1,0.04,0.0
1011,2364,26-09-2019 18:26:00,0,3676.0,3424.0,0.932,18.274,349,225,178,47,124,99,25,84,0.01,0.0
1011,2365,26-09-2019 18:28:00,0,3689.0,3409.0,0.924,18.309,308,177,139,38,131,95,36,37,0.0,0.0
1011,2366,26-09-2019 18:30:00,0,3704.0,3345.0,0.903,18.296,40,16,7,9,24,7,17,0,0.01,0.0
1011,2367,26-09-2019 18:32:00,0,3408.0,3122.0,0.916,16.885,153,89,66,23,64,41,23,2,0.0,0.0
1011,2368,26-09-2019 18:34:00,0,3388.0,3222.0,0.951,16.916,292,157,115,42,135,105,30,43,0.0,0.0
1011,2369,26-09-2019 18:36:00,0,3588.0,3291.0,0.917,17.781,364,199,149,50,165,123,42,31,0.01,0.0
1011,2370,26-09-2019 18:38:00,0,3394.0,3117.0,0.918,16.823,381,206,168,38,175,142,33,38,0.0,0.0
1011,2371,26-09-2019 18:40:00,0,3396.0,3143.0,0.925,16.859,497,266,211,55,231,186,45,138,0.0,0.0
1011,2372,26-09-2019 18:42:00,0,3388.0,3191.0,0.942,16.88,422,258,211,47,164,129,35,226,0.0,0.0
1011,2373,26-09-2019 18:44:00,0,3386.5,3189.0,0.9415,16.8725,253,133,104,29,120,82,38,29,0.0,0.0
1011,2374,26-09-2019 18:46:00,0,3385.0,3187.0,0.941,16.865,476,256,199,57,220,164,56,85,0.0,0.0
1011,2375,26-09-2019 18:48:00,0,3407.0,3082.0,0.904,16.836,585,346,291,55,239,189,50,212,0.01,0.0
1011,2376,26-09-2019 18:50:00,0,3391.0,3100.0,0.914,16.79,464,287,225,62,177,151,26,142,0.0,0.0
1011,2377,26-09-2019 18:52:00,0,3410.0,3077.0,0.902,16.842,550,381,331,50,169,136,33,214,0.0,0.0
1011,2378,26-09-2019 18:54:00,0,3520.0,3159.0,0.897,17.367,547,392,323,69,155,126,29,22,0.0,0.0
1011,2379,26-09-2019 18:56:00,0,3732.0,3239.0,0.868,18.292,571,353,290,63,218,176,42,53,0.0,0.0
1011,2380,26-09-2019 18:58:00,0,3437.0,2996.0,0.872,16.858,498,300,243,57,198,155,43,78,0.0,0.0
1011,2381,26-09-2019 19:00:00,0,3454.0,2918.0,0.845,16.84,220,122,89,33,98,71,27,38,0.0,0.0
1011,2382,26-09-2019 19:02:00,0,3463.0,2924.0,0.845,16.88,480,288,238,50,192,148,44,183,0.0,0.0
1011,2383,26-09-2019 19:04:00,0,3463.0,2883.0,0.832,16.837,189,102,71,31,87,61,26,32,0.03,0.0
1011,2384,26-09-2019 19:06:00,0,3739.0,3122.0,0.835,18.19,160,94,51,43,66,47,19,2,0.0,0.0
1011,2385,26-09-2019 19:08:00,0,3280.0,2692.0,0.821,15.905,139,93,43,50,46,16,30,0,0.0,0.0
1011,2386,26-09-2019 19:10:00,0,3380.0,2753.0,0.814,16.365,298,185,134,51,113,77,36,70,0.01,0.0
1011,2387,26-09-2019 19:12:00,0,3468.0,2816.0,0.812,16.782,459,317,254,63,142,114,28,174,0.05,0.0
1011,2388,26-09-2019 19:14:00,0,3487.0,2818.0,0.808,16.858,547,318,252,66,229,191,38,83,0.0,0.0
1011,2389,26-09-2019 19:16:00,0,3489.0,2814.0,0.807,16.861,236,103,69,34,133,93,40,65,0.0,0.0
1011,2390,26-09-2019 19:18:00,0,3384.5,2758.5,0.8155,16.3895,166,87,48,39,79,37,42,0,0.0,0.0
1011,2391,26-09-2019 19:20:00,0,3280.0,2703.0,0.824,15.918,366,245,189,56,121,88,33,172,0.0,0.0
1011,2392,26-09-2019 19:22:00,0,3371.0,2768.0,0.821,16.347,396,245,201,44,151,117,34,135,0.0,0.0
1011,2393,26-09-2019 19:24:00,0,3254.0,2750.0,0.845,15.866,251,131,103,28,120,97,23,38,0.0,0.0
1011,2394,26-09-2019 19:26:00,0,3460.0,2876.0,0.831,16.817,301,168,127,41,133,108,25,53,0.0,0.0
1011,2395,26-09-2019 19:28:00,0,3395.0,2717.0,0.8,16.387,232,122,80,42,110,83,27,51,0.0,0.0
1011,2396,26-09-2019 19:30:00,0,3315.0,2541.0,0.767,15.874,99,79,37,42,20,5,15,0,0.0,0.0
1011,2397,26-09-2019 19:32:00,0,3323.0,2571.0,0.774,15.941,167,91,60,31,76,44,32,5,0.0,0.0
1011,2398,26-09-2019 19:34:00,0,3297.0,2587.0,0.785,15.854,504,324,270,54,180,132,48,148,0.0,0.0
1011,2399,26-09-2019 19:36:00,0,3295.0,2654.0,0.806,15.919,594,322,258,64,272,206,66,118,0.0,0.0
1011,2400,26-09-2019 19:38:00,0,3384.0,2759.0,0.815,16.389,274,175,134,41,99,67,32,92,0.0,0.0
1011,2401,26-09-2019 19:40:00,0,3270.0,2710.0,0.829,15.886,336,163,121,42,173,130,43,59,0.0,0.0
1011,2402,26-09-2019 19:42:00,0,3276.0,2738.0,0.836,15.937,399,226,164,62,173,130,43,59,0.0,0.0
1011,2403,26-09-2019 19:44:00,0,3278.0,2676.0,0.816,15.879,358,207,167,40,151,111,40,57,0.0,0.0
1011,2404,26-09-2019 19:46:00,0,3300.0,2665.0,0.808,15.952,657,439,345,94,218,170,48,23,0.0,0.0
1011,2405,26-09-2019 19:48:00,0,3495.0,2784.0,0.797,16.851,619,418,346,72,201,149,52,48,0.01,0.0
1011,2406,26-09-2019 19:50:00,0,3489.0,2760.0,0.791,16.803,324,198,151,47,126,99,27,19,0.04,0.0
1011,2407,26-09-2019 19:52:00,0,3355.0,2615.5,0.779,16.116,212,101,62,39,111,66,45,44,0.0,0.0
1011,2408,26-09-2019 19:54:00,0,3221.0,2471.0,0.767,15.429,115,70,27,43,45,20,25,0,0.0,0.0
1011,2409,26-09-2019 19:56:00,0,3310.0,2536.0,0.766,15.848,382,223,182,41,159,126,33,96,0.0,0.0
1011,2410,26-09-2019 19:58:00,0,3311.0,2571.0,0.777,15.892,426,257,200,57,169,134,35,278,0.0,0.0
1011,2411,26-09-2019 20:00:00,0,3301.0,2585.0,0.783,15.869,606,401,317,84,205,166,39,97,0.0,0.0
1011,2412,26-09-2019 20:02:00,0,3407.0,2651.0,0.778,16.361,136,80,55,25,56,33,23,75,0.0,0.0
1011,2413,26-09-2019 20:04:00,0,3525.0,2667.0,0.757,16.843,187,112,70,42,75,46,29,37,0.0,0.0
1011,2414,26-09-2019 20:06:00,0,3329.0,2501.0,0.751,15.887,88,56,25,31,32,5,27,0,0.0,0.0
1011,2415,26-09-2019 20:08:00,0,3303.0,2574.0,0.779,15.866,217,166,117,49,51,27,24,6,0.0,0.0
1011,2416,26-09-2019 20:10:00,0,3326.0,2548.0,0.766,15.924,253,136,108,28,117,92,25,88,0.0,0.0
1011,2417,26-09-2019 20:12:00,0,3291.0,2641.0,0.802,15.89,495,236,191,45,259,203,56,111,0.0,0.0
1011,2418,26-09-2019 20:14:00,0,3402.0,2630.0,0.773,16.316,633,403,335,68,230,185,45,18,0.0,0.0
1011,2419,26-09-2019 20:16:00,0,3417.0,2648.0,0.775,16.394,408,277,214,63,131,101,30,24,0.0,0.0
1011,2420,26-09-2019 20:18:00,0,3504.0,2727.0,0.778,16.825,409,249,197,52,160,128,32,74,0.0,0.0
1011,2421,26-09-2019 20:20:00,0,3310.0,2602.0,0.786,15.921,125,41,17,24,84,47,37,0,0.0,0.0
1011,2422,26-09-2019 20:22:00,0,3326.0,2498.0,0.751,15.87,90,60,30,30,30,7,23,0,0.0,0.0
1011,2423,26-09-2019 20:24:00,0,3118.0,2389.0,0.766,14.929,65,37,11,26,28,16,12,6,0.0,0.0
1011,2424,26-09-2019 20:26:00,0,3121.5,2400.0,0.769,14.9545,291,158,113,45,133,95,38,31,0.0,0.0
1011,2425,26-09-2019 20:28:00,0,3125.0,2411.0,0.772,14.98,195,148,99,49,47,24,23,4,0.0,0.0
1011,2426,26-09-2019 20:30:00,0,3324.0,2520.0,0.758,15.887,588,348,275,73,240,186,54,101,0.0,0.0
1011,2427,26-09-2019 20:32:00,0,3121.0,2426.0,0.777,14.983,146,91,48,43,55,28,27,2,0.0,0.0
1011,2428,26-09-2019 20:34:00,0,3129.0,2385.0,0.762,14.971,275,129,98,31,146,116,30,45,0.0,0.0
1011,2429,26-09-2019 20:36:00,0,3416.0,2598.0,0.76,16.335,569,331,255,76,238,186,52,218,0.0,0.0
1011,2430,26-09-2019 20:38:00,0,3302.0,2600.0,0.787,15.89,328,214,166,48,114,87,27,57,0.0,0.0
1011,2431,26-09-2019 20:40:00,0,3336.0,2491.0,0.747,15.903,106,67,31,36,39,17,22,0,0.0,0.0
1011,2432,26-09-2019 20:42:00,0,3322.0,2517.0,0.758,15.874,482,281,229,52,201,155,46,163,0.09,0.0
1011,2433,26-09-2019 20:44:00,0,3427.0,2593.0,0.757,16.374,398,269,211,58,129,94,35,129,0.0,0.0
1011,2434,26-09-2019 20:46:00,0,3331.0,2494.0,0.749,15.884,496,306,245,61,190,152,38,87,0.0,0.0
1011,2435,26-09-2019 20:48:00,0,3335.0,2514.0,0.754,15.922,304,179,141,38,125,96,29,121,0.0,0.0
1011,2436,26-09-2019 20:50:00,0,3343.0,2491.0,0.745,15.931,369,213,166,47,156,121,35,137,0.01,0.0
1011,2437,26-09-2019 20:52:00,0,3355.0,2383.0,0.71,15.858,90,61,26,35,29,12,17,0,0.0,0.0
1011,2438,26-09-2019 20:54:00,0,3243.0,2369.0,0.73,15.401,338,183,137,46,155,120,35,47,0.0,0.0
1011,2439,26-09-2019 20:56:00,0,3334.0,2519.0,0.755,15.927,217,108,74,34,109,78,31,15,0.0,0.0
1011,2440,26-09-2019 20:58:00,0,3344.0,2472.0,0.739,15.913,281,140,99,41,141,98,43,99,0.0,0.0
1011,2441,26-09-2019 21:00:00,0,3348.0,2442.0,0.7295,15.8945,168,99,63,36,69,47,22,15,0.0,0.0
1011,2442,26-09-2019 21:02:00,0,3352.0,2412.0,0.72,15.876,232,129,85,44,103,72,31,15,0.0,0.0
1011,2443,26-09-2019 21:04:00,0,3249.0,2370.0,0.729,15.425,185,95,57,38,90,48,42,2,0.0,0.0
1011,2444,26-09-2019 21:06:00,0,3131.0,2369.0,0.757,14.961,448,248,191,57,200,159,41,152,0.0,0.0
1011,2445,26-09-2019 21:08:00,0,3352.0,2434.0,0.726,15.903,339,203,168,35,136,102,34,98,0.0,0.0
1011,2446,26-09-2019 21:10:00,0,3341.0,2436.0,0.729,15.862,503,302,241,61,201,159,42,169,0.0,0.0
1011,2447,26-09-2019 21:12:00,0,3348.0,2418.0,0.722,15.868,278,173,128,45,105,74,31,85,0.0,0.0
1011,2448,26-09-2019 21:14:00,0,3367.0,2403.0,0.714,15.926,383,243,199,44,140,114,26,122,0.0,0.0
1011,2449,26-09-2019 21:16:00,0,3348.0,2461.0,0.735,15.917,366,237,192,45,129,101,28,80,0.0,0.0
1011,2450,26-09-2019 21:18:00,0,3311.0,2516.0,0.76,15.831,395,227,184,43,168,137,31,130,0.0,0.0
1011,2451,26-09-2019 21:20:00,0,3331.0,2503.0,0.751,15.897,503,331,265,66,172,137,35,187,0.0,0.0
1011,2452,26-09-2019 21:22:00,0,3335.0,2508.0,0.752,15.918,210,119,92,27,91,68,23,38,0.0,0.0
1011,2453,26-09-2019 21:24:00,0,3450.0,2515.0,0.729,16.379,476,368,305,63,108,71,37,18,0.0,0.0
1011,2454,26-09-2019 21:26:00,0,3532.0,2627.0,0.744,16.825,558,429,338,91,129,97,32,26,0.0,0.0
1011,2455,26-09-2019 21:28:00,0,3519.0,2673.0,0.759,16.826,480,355,272,83,125,94,31,51,0.0,0.0
1011,2456,26-09-2019 21:30:00,0,3533.0,2613.0,0.74,16.813,476,338,257,81,138,100,38,55,0.04,0.0
1011,2457,26-09-2019 21:32:00,0,3843.0,2752.0,0.716,18.191,516,331,259,72,185,132,53,17,0.03,0.0
1011,2458,26-09-2019 21:34:00,0,3692.0,2690.0,0.729,17.5255,350,243,180,63,107,77,30,74,0.0,0.0
1011,2459,26-09-2019 21:36:00,0,3541.0,2628.0,0.742,16.86,455,323,249,74,132,91,41,25,0.0,0.0
1011,2460,26-09-2019 21:38:00,0,3551.0,2532.0,0.713,16.796,291,178,142,36,113,79,34,52,0.02,0.0
1011,2461,26-09-2019 21:40:00,0,3550.0,2564.0,0.722,16.825,343,215,167,48,128,93,35,129,0.0,0.0
1011,2462,26-09-2019 21:42:00,0,3745.0,2705.0,0.722,17.753,530,287,239,48,243,191,52,168,0.02,0.0
1011,2463,26-09-2019 21:44:00,0,3641.0,2655.0,0.729,17.286,444,287,235,52,157,116,41,109,0.04,0.0
1011,2464,26-09-2019 21:46:00,0,3845.0,2739.0,0.712,18.183,704,418,319,99,286,205,81,18,0.01,0.0
1011,2465,26-09-2019 21:48:00,0,3537.0,2603.0,0.736,16.817,194,54,26,28,140,131,9,4,0.0,0.0
1011,2466,26-09-2019 21:50:00,0,3553.0,2572.0,0.724,16.846,484,285,217,68,199,160,39,77,0.0,0.0
1011,2467,26-09-2019 21:52:00,0,3535.0,2635.0,0.745,16.846,753,471,375,96,282,216,66,44,0.0,0.0
1011,2468,26-09-2019 21:54:00,0,3630.0,2655.0,0.731,17.241,334,194,150,44,140,109,31,114,0.04,0.0
1011,2469,26-09-2019 21:56:00,0,3531.0,2652.0,0.751,16.848,560,326,264,62,234,179,55,98,0.01,0.0
1011,2470,26-09-2019 21:58:00,0,3747.0,2705.0,0.722,17.76,97,56,41,15,41,25,16,48,0.0,0.0
1011,2471,26-09-2019 22:00:00,0,3856.0,2818.0,0.731,18.314,96,38,16,22,58,34,24,0,0.0,0.0
1011,2472,26-09-2019 22:02:00,0,3540.0,2609.0,0.737,16.836,443,268,208,60,175,136,39,132,0.0,0.0
1011,2473,26-09-2019 22:04:00,0,3554.0,2523.0,0.71,16.797,718,428,344,84,290,225,65,58,0.0,0.0
1011,2474,26-09-2019 22:06:00,0,3548.0,2561.0,0.722,16.813,421,258,200,58,163,125,38,80,0.0,0.0
1011,2475,26-09-2019 22:08:00,0,3556.5,2549.0,0.717,16.835,425,255,204,51,170,136,34,59,0.0,0.0
1011,2476,26-09-2019 22:10:00,0,3565.0,2537.0,0.712,16.857,440,274,225,49,166,131,35,141,0.02,0.0
1011,2477,26-09-2019 22:12:00,0,3540.0,2618.0,0.74,16.845,872,589,473,116,283,203,80,34,0.0,0.0
1011,2478,26-09-2019 22:14:00,0,3848.0,2784.0,0.724,18.244,464,369,285,84,95,57,38,14,0.0,0.0
1011,2479,26-09-2019 22:16:00,0,3632.0,2674.0,0.736,17.271,397,247,175,72,150,109,41,20,0.0,0.0
1011,2480,26-09-2019 22:18:00,0,3349.0,2400.0,0.717,15.853,304,178,140,38,126,79,47,61,0.0,0.0
1011,2481,26-09-2019 22:20:00,0,3541.0,2603.0,0.735,16.834,614,378,312,66,236,173,63,71,0.0,0.0
1011,2482,26-09-2019 22:22:00,0,3526.0,2634.0,0.747,16.808,316,192,145,47,124,88,36,33,0.0,0.0
1011,2483,26-09-2019 22:24:00,0,4054.0,2878.0,0.71,19.16,300,186,142,44,114,82,32,57,0.0,0.0
1011,2484,26-09-2019 22:26:00,0,3528.0,2667.0,0.756,16.852,198,119,93,26,79,63,16,69,0.02,0.0
1011,2485,26-09-2019 22:28:00,0,3537.0,2616.0,0.74,16.834,494,331,261,70,163,129,34,55,0.01,0.0
1011,2486,26-09-2019 22:30:00,0,3525.0,2656.0,0.753,16.831,674,398,325,73,276,219,57,88,0.0,0.0
1011,2487,26-09-2019 22:32:00,0,3534.0,2629.0,0.744,16.836,614,394,322,72,220,174,46,161,0.0,0.0
1011,2488,26-09-2019 22:34:00,0,3563.0,2537.0,0.712,16.849,117,74,40,34,43,26,17,3,0.0,0.0
1011,2489,26-09-2019 22:36:00,0,3447.0,2502.0,0.726,16.351,488,266,213,53,222,183,39,84,0.0,0.0
1011,2490,26-09-2019 22:38:00,0,3451.0,2482.0,0.719,16.345,565,389,314,75,176,132,44,61,0.0,0.0
1011,2491,26-09-2019 22:40:00,0,3450.0,2488.0,0.721,16.347,335,194,138,56,141,105,36,53,0.0,0.0
1011,2492,26-09-2019 22:42:00,0,3507.0,2497.5,0.7125,16.582,262,170,128,42,92,61,31,49,0.06,0.0
1011,2493,26-09-2019 22:44:00,0,3564.0,2507.0,0.704,16.817,491,308,252,56,183,138,45,110,0.0,0.0
1011,2494,26-09-2019 22:46:00,0,3562.0,2531.0,0.711,16.835,465,262,210,52,203,162,41,146,0.03,0.0
1011,2495,26-09-2019 22:48:00,0,3528.0,2634.0,0.747,16.818,532,298,240,58,234,178,56,75,0.03,0.0
1011,2496,26-09-2019 22:50:00,0,3525.0,2633.0,0.747,16.806,638,386,311,75,252,193,59,68,0.0,0.0
1011,2497,26-09-2019 22:52:00,0,3542.0,2554.0,0.721,16.785,836,546,438,108,290,213,77,57,0.0,0.0
1011,2498,26-09-2019 22:54:00,0,3642.0,2668.0,0.733,17.302,847,560,452,108,287,207,80,32,0.0,0.0
1011,2499,26-09-2019 22:56:00,0,3747.0,2721.0,0.726,17.777,405,224,162,62,181,121,60,4,0.0,0.0
1011,2500,26-09-2019 22:58:00,0,3884.0,2620.0,0.675,18.205,309,195,148,47,114,83,31,31,0.05,0.0
1011,2501,26-09-2019 23:00:00,0,3575.0,2433.0,0.681,16.782,92,33,17,16,59,31,28,0,0.0,0.0
1011,2502,26-09-2019 23:02:00,0,3909.0,2535.0,0.648,18.211,141,71,41,30,70,47,23,10,0.0,0.0
1011,2503,26-09-2019 23:04:00,0,3917.0,2506.0,0.64,18.207,360,233,185,48,127,90,37,70,0.0,0.0
1011,2504,26-09-2019 23:06:00,0,4001.0,2637.0,0.659,18.686,818,585,476,109,233,173,60,57,0.0,0.0
1011,2505,26-09-2019 23:08:00,0,3880.0,2592.0,0.668,18.158,581,418,326,92,163,115,48,59,0.0,0.0
1011,2506,26-09-2019 23:10:00,0,3810.0,2477.0,0.65,17.753,294,149,113,36,145,111,34,128,0.0,0.0
1011,2507,26-09-2019 23:12:00,0,3902.0,2577.0,0.66,18.227,314,192,146,46,122,90,32,93,0.0,0.0
1011,2508,26-09-2019 23:14:00,0,3802.0,2452.0,0.645,17.694,236,170,128,42,66,51,15,55,0.0,0.0
1011,2509,26-09-2019 23:16:00,0,3687.0,2482.5,0.6745,17.2755,366,186,140,46,180,140,40,52,0.0,0.0
1011,2510,26-09-2019 23:18:00,0,3572.0,2513.0,0.704,16.857,357,200,148,52,157,112,45,41,0.0,0.0
1011,2511,26-09-2019 23:20:00,0,3550.0,2499.0,0.704,16.754,456,220,165,55,236,172,64,43,0.0,0.0
1011,2512,26-09-2019 23:22:00,0,3350.0,2464.0,0.736,15.927,262,166,116,50,96,71,25,80,0.0,0.0
1011,2513,26-09-2019 23:24:00,0,3462.0,2482.0,0.717,16.388,421,285,215,70,136,88,48,10,0.0,0.0
1011,2514,26-09-2019 23:26:00,0,3453.0,2506.0,0.726,16.381,434,231,181,50,203,157,46,123,0.0,0.0
1011,2515,26-09-2019 23:28:00,0,3548.0,2509.0,0.707,16.759,758,607,494,113,151,107,44,52,0.01,0.0
1011,2516,26-09-2019 23:30:00,0,3531.0,2602.0,0.737,16.793,201,118,75,43,83,51,32,9,0.0,0.0
1011,2517,26-09-2019 23:32:00,0,3246.0,2411.0,0.743,15.461,525,304,243,61,221,175,46,126,0.0,0.0
1011,2518,26-09-2019 23:34:00,0,3331.0,2457.0,0.738,15.843,574,345,270,75,229,171,58,51,0.06,0.0
1011,2519,26-09-2019 23:36:00,0,3228.0,2417.0,0.749,15.394,197,119,78,41,78,63,15,19,0.01,0.0
1011,2520,26-09-2019 23:38:00,0,3459.0,2505.0,0.724,16.401,542,439,356,83,103,71,32,27,0.0,0.0
1011,2521,26-09-2019 23:40:00,0,3459.0,2468.0,0.714,16.361,185,120,74,46,65,39,26,0,0.0,0.0
1011,2522,26-09-2019 23:42:00,0,3272.0,2274.0,0.695,15.408,264,152,111,41,112,84,28,117,0.0,0.0
1011,2523,26-09-2019 23:44:00,0,3246.0,2428.0,0.748,15.477,460,286,227,59,174,128,46,150,0.0,0.0
1011,2524,26-09-2019 23:46:00,0,3246.0,2385.0,0.735,15.43,502,322,269,53,180,147,33,178,0.03,0.0
1011,2525,26-09-2019 23:48:00,0,3232.0,2432.0,0.752,15.428,728,476,397,79,252,195,57,63,0.03,0.0
1011,2526,26-09-2019 23:50:00,0,3388.0,2502.0,0.739,16.1205,322,246,179,67,76,51,25,10,0.0,0.0
1011,2527,26-09-2019 23:52:00,0,3544.0,2572.0,0.726,16.813,441,340,258,82,101,66,35,12,0.0,0.0
1011,2528,26-09-2019 23:54:00,0,3563.0,2546.0,0.714,16.858,284,180,137,43,104,79,25,30,0.0,0.0
1011,2529,26-09-2019 23:56:00,0,3230.0,2411.0,0.747,15.395,366,241,187,54,125,91,34,58,0.0,0.0
1011,2530,26-09-2019 23:58:00,0,3331.0,2447.0,0.735,15.833,671,484,389,95,187,140,47,19,0.0,0.0
1011,2531,27-09-2019 00:00:00,0,3153.0,2263.0,0.718,14.929,72,36,16,20,36,17,19,1,0.0,0.0
1011,2532,27-09-2019 00:02:00,0,3356.0,2433.0,0.725,15.915,262,204,150,54,58,48,10,1,0.0,0.0
1011,2533,27-09-2019 00:04:00,0,3225.0,2423.0,0.751,15.39,700,395,317,78,305,236,69,61,0.0,0.0
1011,2534,27-09-2019 00:06:00,0,3232.0,2403.0,0.743,15.394,374,269,205,64,105,73,32,45,0.02,0.0
1011,2535,27-09-2019 00:08:00,0,3455.0,2472.0,0.715,16.352,263,132,104,28,131,96,35,78,0.07,0.0
1011,2536,27-09-2019 00:10:00,0,3253.0,2312.0,0.711,15.379,81,50,24,26,31,17,14,0,0.0,0.0
1011,2537,27-09-2019 00:12:00,0,3271.0,2282.0,0.698,15.417,366,182,126,56,184,133,51,8,0.0,0.0
1011,2538,27-09-2019 00:14:00,0,3066.0,2184.0,0.712,14.497,439,271,213,58,168,125,43,102,0.0,0.0
1011,2539,27-09-2019 00:16:00,0,3244.0,2415.0,0.744,15.455,457,291,218,73,166,115,51,10,0.02,0.0
1011,2540,27-09-2019 00:18:00,0,3252.0,2371.0,0.729,15.439,356,204,165,39,152,118,34,130,0.01,0.0
1011,2541,27-09-2019 00:20:00,0,3042.0,2242.0,0.737,14.467,390,221,183,38,169,134,35,116,0.06,0.0
1011,2542,27-09-2019 00:22:00,0,3249.0,2380.0,0.732,15.435,489,303,222,81,186,137,49,33,0.01,0.0
1011,2543,27-09-2019 00:24:00,0,3250.5,2359.0,0.7255,15.418,158,109,78,31,49,36,13,10,0.01,0.0
1011,2544,27-09-2019 00:26:00,0,3252.0,2338.0,0.719,15.401,272,170,131,39,102,68,34,28,0.0,0.0
1011,2545,27-09-2019 00:28:00,0,3262.0,2343.0,0.718,15.445,337,190,145,45,147,112,35,39,0.04,0.0
1011,2546,27-09-2019 00:30:00,0,3050.0,2208.0,0.724,14.463,115,73,46,27,42,15,27,35,0.0,0.0
1011,2547,27-09-2019 00:32:00,0,3055.0,2209.0,0.723,14.481,325,187,153,34,138,110,28,158,0.0,0.0
1011,2548,27-09-2019 00:34:00,0,3070.0,2152.0,0.701,14.477,328,197,151,46,131,100,31,66,0.0,0.0
1011,2549,27-09-2019 00:36:00,0,3277.0,2309.0,0.704,15.47,368,235,174,61,133,90,43,22,0.0,0.0
1011,2550,27-09-2019 00:38:00,0,3047.0,2212.0,0.726,14.455,384,234,187,47,150,114,36,51,0.02,0.0
1011,2551,27-09-2019 00:40:00,0,3050.0,2253.0,0.739,14.511,93,61,30,31,32,20,12,10,0.0,0.0
1011,2552,27-09-2019 00:42:00,0,3051.0,2177.0,0.713,14.433,221,124,82,42,97,61,36,27,0.01,0.0
1011,2553,27-09-2019 00:44:00,0,3151.0,2275.0,0.722,14.936,251,149,119,30,102,65,37,24,0.0,0.0
1011,2554,27-09-2019 00:46:00,0,3072.0,2207.0,0.718,14.546,229,148,127,21,81,45,36,11,0.05,0.0
1011,2555,27-09-2019 00:48:00,0,3079.0,2117.0,0.688,14.477,382,215,154,61,167,126,41,13,0.01,0.0
1011,2556,27-09-2019 00:50:00,0,3074.0,2140.0,0.696,14.482,137,84,62,22,53,37,16,14,0.0,0.0
1011,2557,27-09-2019 00:52:00,0,3104.0,2011.0,0.648,14.458,175,126,84,42,49,33,16,26,0.0,0.0
1011,2558,27-09-2019 00:54:00,0,3100.0,2036.0,0.657,14.467,118,69,51,18,49,35,14,1,0.0,0.0
1011,2559,27-09-2019 00:56:00,0,2992.0,1997.0,0.667,13.998,113,74,40,34,39,20,19,11,0.0,0.0
1011,2560,27-09-2019 00:58:00,0,2819.5,1996.0,0.7105,13.3185,323,153,118,35,170,132,38,16,0.0,0.0
1011,2561,27-09-2019 01:00:00,0,2647.0,1995.0,0.754,12.639,182,114,87,27,68,52,16,66,0.06,0.0
1011,2562,27-09-2019 01:02:00,0,2757.0,1993.0,0.723,13.069,443,316,248,68,127,78,49,39,0.0,0.0
1011,2563,27-09-2019 01:04:00,0,2854.0,2063.0,0.723,13.531,198,117,73,44,81,52,29,0,0.0,0.0
1011,2564,27-09-2019 01:06:00,0,2866.0,2005.0,0.7,13.514,105,68,34,34,37,22,15,0,0.0,0.0
1011,2565,27-09-2019 01:08:00,0,2542.0,1944.0,0.765,12.169,373,208,152,56,165,127,38,31,0.0,0.0
1011,2566,27-09-2019 01:10:00,0,2861.0,2030.0,0.71,13.52,412,261,212,49,151,118,33,110,0.0,0.0
1011,2567,27-09-2019 01:12:00,0,2647.0,1969.0,0.744,12.609,184,113,76,37,71,48,23,33,0.0,0.0
1011,2568,27-09-2019 01:14:00,0,2644.0,1980.0,0.749,12.611,192,116,84,32,76,56,20,61,0.0,0.0
1011,2569,27-09-2019 01:16:00,0,2762.0,1993.0,0.722,13.089,298,143,104,39,155,122,33,25,0.0,0.0
1011,2570,27-09-2019 01:18:00,0,2547.0,1934.0,0.759,12.176,27,7,3,4,20,10,10,0,0.0,0.0
1011,2571,27-09-2019 01:20:00,0,2536.0,1938.0,0.764,12.139,124,44,19,25,80,44,36,8,0.0,0.0
1011,2572,27-09-2019 01:22:00,0,2555.0,1921.0,0.752,12.194,139,51,21,30,88,58,30,6,0.0,0.0
1011,2573,27-09-2019 01:24:00,0,2544.0,1924.0,0.756,12.156,14,14,0,14,0,0,0,0,0.0,0.0
1011,2574,27-09-2019 01:26:00,0,2341.0,1797.0,0.767,11.214,2,2,0,2,0,0,0,0,0.0,0.0
1011,2575,27-09-2019 01:28:00,0,2265.0,1648.0,0.728,10.748,41,13,8,5,28,20,8,0,0.0,0.0
1011,2576,27-09-2019 01:30:00,0,2166.0,1605.0,0.741,10.313,0,0,0,0,0,0,0,0,0.0,0.0
1011,2577,27-09-2019 01:32:00,0,2010.5,1502.0,0.7475,9.5855,6,3,0,3,3,2,1,0,0.0,0.0
1011,2578,27-09-2019 01:34:00,0,1855.0,1399.0,0.754,8.858,3,0,0,0,3,2,1,0,0.0,0.0
1011,2579,27-09-2019 01:36:00,0,1881.0,1340.0,0.712,8.896,1,0,0,0,1,1,0,0,0.0,0.0
1011,2580,27-09-2019 01:38:00,0,1779.0,1275.0,0.717,8.422,3,0,0,0,3,2,1,0,0.0,0.0
1011,2581,27-09-2019 01:40:00,0,1671.0,1218.0,0.729,7.931,7,0,0,0,7,4,3,0,0.0,0.0
1011,2582,27-09-2019 01:42:00,0,1680.0,1209.0,0.719,7.959,0,0,0,0,0,0,0,0,0.0,0.0
1011,2583,27-09-2019 01:44:00,0,1679.0,1193.0,0.71,7.936,453,261,211,50,192,147,45,81,0.0,0.0
1011,2584,27-09-2019 01:46:00,0,1873.0,1329.0,0.71,8.851,324,191,141,50,133,102,31,53,0.0,0.0
1011,2585,27-09-2019 01:48:00,0,2062.0,1524.0,0.739,9.812,263,186,139,47,77,55,22,16,0.0,0.0
1011,2586,27-09-2019 01:50:00,0,2169.0,1576.0,0.726,10.29,429,277,229,48,152,115,37,90,0.0,0.0
1011,2587,27-09-2019 01:52:00,0,2360.0,1746.0,0.74,11.231,237,168,128,40,69,38,31,18,0.02,0.0
1011,2588,27-09-2019 01:54:00,0,2375.0,1684.0,0.709,11.221,163,97,63,34,66,47,19,1,0.0,0.0
1011,2589,27-09-2019 01:56:00,0,2360.0,1725.0,0.731,11.209,343,201,165,36,142,107,35,98,0.0,0.0
1011,2590,27-09-2019 01:58:00,0,2353.0,1775.0,0.755,11.237,292,198,164,34,94,75,19,142,0.0,0.0
1011,2591,27-09-2019 02:00:00,0,2549.0,1917.0,0.752,12.165,132,88,69,19,44,35,9,77,0.0,0.0
1011,2592,27-09-2019 02:02:00,0,3077.0,2143.0,0.697,14.496,96,61,29,32,35,15,20,0,0.0,0.0
1011,2593,27-09-2019 02:04:00,0,2548.0,1907.0,0.748,12.152,412,227,176,51,185,147,38,31,0.03,0.0
1011,2594,27-09-2019 02:06:00,0,2797.0,2075.0,0.742,13.319,345,200,162,38,145,118,27,100,0.0,0.0
1011,2595,27-09-2019 02:08:00,0,3046.0,2243.0,0.736,14.486,348,234,189,45,114,80,34,13,0.0,0.0
1011,2596,27-09-2019 02:10:00,0,2857.0,2091.0,0.732,13.571,404,239,181,58,165,122,43,10,0.02,0.0
1011,2597,27-09-2019 02:12:00,0,2874.0,2001.0,0.696,13.539,483,255,205,50,228,183,45,128,0.0,0.0
1011,2598,27-09-2019 02:14:00,0,2847.0,2080.0,0.73,13.521,160,106,70,36,54,37,17,14,0.0,0.0
1011,2599,27-09-2019 02:16:00,0,2845.0,2140.0,0.752,13.58,208,90,61,29,118,75,43,34,0.0,0.0
1011,2600,27-09-2019 02:18:00,0,2861.0,2036.0,0.712,13.527,266,181,143,38,85,64,21,51,0.03,0.0
1011,2601,27-09-2019 02:20:00,0,2858.0,2034.0,0.712,13.512,531,289,233,56,242,192,50,99,0.0,0.0
1011,2602,27-09-2019 02:22:00,0,2871.0,2023.0,0.705,13.551,274,143,105,38,131,95,36,62,0.0,0.0
1011,2603,27-09-2019 02:24:00,0,2864.0,2079.0,0.726,13.586,104,67,50,17,37,24,13,3,0.0,0.0
1011,2604,27-09-2019 02:26:00,0,2756.0,1997.0,0.725,13.069,111,62,44,18,49,31,18,1,0.0,0.0
1011,2605,27-09-2019 02:28:00,0,2544.0,1928.0,0.758,12.16,93,64,41,23,29,18,11,8,0.0,0.0
1011,2606,27-09-2019 02:30:00,0,2648.0,1974.0,0.745,12.619,24,10,5,5,14,4,10,1,0.0,0.0
1011,2607,27-09-2019 02:32:00,0,2543.0,1936.0,0.761,12.164,328,178,138,40,150,109,41,19,0.0,0.0
1011,2608,27-09-2019 02:34:00,0,2565.0,1852.0,0.722,12.158,514,288,224,64,226,172,54,27,0.0,0.0
1011,2609,27-09-2019 02:36:00,0,2357.0,1705.0,0.724,11.176,163,87,61,26,76,54,22,17,0.0,0.0
1011,2610,27-09-2019 02:38:00,0,2250.0,1664.0,0.74,10.706,128,74,49,25,54,41,13,49,0.0,0.0
1011,2611,27-09-2019 02:40:00,0,2357.5,1730.5,0.7345,11.203,414,276,208,68,138,109,29,76,0.0,0.0
1011,2612,27-09-2019 02:42:00,0,2465.0,1797.0,0.729,11.7,186,109,79,30,77,54,23,1,0.0,0.0
1011,2613,27-09-2019 02:44:00,0,2459.0,1756.0,0.714,11.631,32,17,7,10,15,7,8,0,0.0,0.0
1011,2614,27-09-2019 02:46:00,0,2483.0,1704.0,0.686,11.671,0,0,0,0,0,0,0,0,0.0,0.0
1011,2615,27-09-2019 02:48:00,0,2275.0,1597.0,0.702,10.733,29,11,4,7,18,13,5,0,0.0,0.0
1011,2616,27-09-2019 02:50:00,0,2191.0,1517.0,0.692,10.311,0,0,0,0,0,0,0,0,0.0,0.0
1011,2617,27-09-2019 02:52:00,0,1974.0,1414.0,0.716,9.345,4,1,0,1,3,2,1,0,0.0,0.0
1011,2618,27-09-2019 02:54:00,0,1997.0,1333.0,0.667,9.345,0,0,0,0,0,0,0,0,0.0,0.0
1011,2619,27-09-2019 02:56:00,0,1779.0,1240.0,0.697,8.382,6,1,0,1,5,2,3,0,0.0,0.0
1011,2620,27-09-2019 02:58:00,0,1798.0,1182.0,0.657,8.394,4,1,0,1,3,2,1,0,0.0,0.0
1011,2621,27-09-2019 03:00:00,0,1687.0,1158.0,0.686,7.93,12,0,0,0,12,5,7,0,0.0,0.0
1011,2622,27-09-2019 03:02:00,0,1465.0,1118.0,0.763,7.012,40,0,0,0,40,3,37,0,0.0,0.0
1011,2623,27-09-2019 03:04:00,0,1474.0,1069.0,0.725,6.992,44,13,8,5,31,16,15,0,0.0,0.0
1011,2624,27-09-2019 03:06:00,0,1491.0,1024.0,0.687,7.009,19,14,3,11,5,1,4,0,0.0,0.0
1011,2625,27-09-2019 03:08:00,0,1491.0,1026.0,0.688,7.011,7,7,1,6,0,0,0,0,0.0,0.0
1011,2626,27-09-2019 03:10:00,0,1382.0,1010.0,0.731,6.564,3,3,2,1,0,0,0,0,0.0,0.0
1011,2627,27-09-2019 03:12:00,0,1378.0,982.0,0.713,6.518,0,0,0,0,0,0,0,0,0.0,0.0
1011,2628,27-09-2019 03:14:00,0,1437.0,995.5,0.6935,6.765,0,0,0,0,0,0,0,0,0.0,0.0
1011,2629,27-09-2019 03:16:00,0,1496.0,1009.0,0.674,7.012,0,0,0,0,0,0,0,0,0.0,0.0
1011,2630,27-09-2019 03:18:00,0,1498.0,1007.0,0.672,7.015,0,0,0,0,0,0,0,0,0.0,0.0
1011,2631,27-09-2019 03:20:00,0,1385.0,973.0,0.702,6.535,2,0,0,0,2,0,2,0,0.0,0.0
1011,2632,27-09-2019 03:22:00,0,1388.0,941.0,0.678,6.512,0,0,0,0,0,0,0,0,0.0,0.0
1011,2633,27-09-2019 03:24:00,0,1397.0,950.0,0.68,6.555,0,0,0,0,0,0,0,0,0.0,0.0
1011,2634,27-09-2019 03:26:00,0,1392.0,951.0,0.683,6.537,0,0,0,0,0,0,0,0,0.0,0.0
1011,2635,27-09-2019 03:28:00,0,1392.0,958.0,0.689,6.544,0,0,0,0,0,0,0,0,0.0,0.0
1011,2636,27-09-2019 03:30:00,0,1385.0,970.0,0.701,6.531,0,0,0,0,0,0,0,0,0.0,0.0
1011,2637,27-09-2019 03:32:00,0,1496.0,996.0,0.666,6.996,0,0,0,0,0,0,0,0,0.0,0.0
1011,2638,27-09-2019 03:34:00,0,1607.0,1034.0,0.643,7.476,0,0,0,0,0,0,0,0,0.0,0.0
1011,2639,27-09-2019 03:36:00,0,1596.0,1070.0,0.671,7.474,0,0,0,0,0,0,0,0,0.0,0.0
1011,2640,27-09-2019 03:38:00,0,2649.0,1085.0,0.41,11.639,0,0,0,0,0,0,0,0,0.0,0.0
1011,2641,27-09-2019 03:40:00,0,3338.0,1107.0,0.332,14.378,0,0,0,0,0,0,0,0,0.0,0.0
1011,2642,27-09-2019 03:42:00,0,3343.0,1118.0,0.335,14.41,57,30,6,24,27,11,16,1,0.0,0.0
1011,2643,27-09-2019 03:44:00,0,3521.0,1332.0,0.378,15.351,477,278,219,59,199,148,51,67,0.0,0.0
1011,2644,27-09-2019 03:46:00,0,4018.0,1698.0,0.423,17.713,417,296,243,53,121,94,27,27,0.0,0.0
1011,2645,27-09-2019 03:48:00,0,3353.0,1769.0,0.554,15.1705,192,90,50,40,102,69,33,31,0.0,0.0
1011,2646,27-09-2019 03:50:00,0,2688.0,1840.0,0.685,12.628,355,202,162,40,153,118,35,90,0.0,0.0
1011,2647,27-09-2019 03:52:00,0,2673.0,1858.0,0.695,12.591,245,135,100,35,110,82,28,45,0.0,0.0
1011,2648,27-09-2019 03:54:00,0,2662.0,1904.0,0.715,12.596,404,256,208,48,148,117,31,39,0.0,0.0
1011,2649,27-09-2019 03:56:00,0,2671.0,1900.0,0.712,12.627,148,93,64,29,55,37,18,17,0.0,0.0
1011,2650,27-09-2019 03:58:00,0,2547.0,1898.0,0.745,12.139,52,43,17,26,9,7,2,1,0.0,0.0
1011,2651,27-09-2019 04:00:00,0,2316.0,1905.0,0.822,11.235,261,181,144,37,80,70,10,79,0.0,0.0
1011,2652,27-09-2019 04:02:00,0,2314.0,1917.0,0.828,11.238,223,161,121,40,62,44,18,35,0.0,0.0
1011,2653,27-09-2019 04:04:00,0,2322.0,1882.0,0.81,11.231,78,44,19,25,34,9,25,0,0.0,0.0
1011,2654,27-09-2019 04:06:00,0,2111.0,1752.0,0.83,10.259,108,73,42,31,35,13,22,0,0.0,0.0
1011,2655,27-09-2019 04:08:00,0,2097.0,1851.0,0.883,10.312,396,218,157,61,178,134,44,53,0.0,0.0
1011,2656,27-09-2019 04:10:00,0,2076.0,1913.0,0.922,10.296,284,149,112,37,135,102,33,20,0.0,0.0
1011,2657,27-09-2019 04:12:00,0,2080.0,1900.0,0.913,10.298,226,91,66,25,135,100,35,18,0.0,0.0
1011,2658,27-09-2019 04:14:00,0,1743.0,1849.0,1.061,8.913,285,143,107,36,142,108,34,57,0.1,0.0
1011,2659,27-09-2019 04:16:00,0,1741.0,1859.0,1.068,8.917,215,119,85,34,96,71,25,14,0.0,0.0
1011,2660,27-09-2019 04:18:00,0,1662.0,1693.0,1.019,8.424,186,115,88,27,71,52,19,5,0.0,0.0
1011,2661,27-09-2019 04:20:00,0,1658.0,1724.0,1.04,8.439,181,114,89,25,67,47,20,43,0.0,0.0
1011,2662,27-09-2019 04:22:00,0,2017.0,1692.5,0.8695,9.8195,48,8,4,4,40,21,19,0,0.0,0.0
1011,2663,27-09-2019 04:24:00,0,2376.0,1661.0,0.699,11.2,149,50,21,29,99,65,34,0,0.0,0.0
1011,2664,27-09-2019 04:26:00,0,2577.0,1799.0,0.698,12.146,58,17,6,11,41,25,16,0,0.0,0.0
1011,2665,27-09-2019 04:28:00,0,2375.0,1662.0,0.7,11.196,0,0,0,0,0,0,0,0,0.0,0.0
1011,2666,27-09-2019 04:30:00,0,2169.0,1556.0,0.717,10.269,0,0,0,0,0,0,0,0,0.0,0.0
1011,2667,27-09-2019 04:32:00,0,2082.0,1474.0,0.708,9.836,0,0,0,0,0,0,0,0,0.0,0.0
1011,2668,27-09-2019 04:34:00,0,1963.0,1438.0,0.733,9.325,0,0,0,0,0,0,0,0,0.0,0.0
1011,2669,27-09-2019 04:36:00,0,1967.0,1437.0,0.731,9.343,0,0,0,0,0,0,0,0,0.0,0.0
1011,2670,27-09-2019 04:38:00,0,1875.0,1376.0,0.734,8.91,32,10,4,6,22,14,8,0,0.0,0.0
1011,2671,27-09-2019 04:40:00,0,1652.0,1292.0,0.782,7.94,30,17,0,17,13,0,13,0,0.0,0.0
1011,2672,27-09-2019 04:42:00,0,1678.0,1207.0,0.72,7.947,3,1,0,1,2,0,2,0,0.0,0.0
1011,2673,27-09-2019 04:44:00,0,1579.0,1144.0,0.725,7.488,5,2,0,2,3,0,3,0,0.0,0.0
1011,2674,27-09-2019 04:46:00,0,1356.0,1088.0,0.802,6.546,5,0,0,0,5,0,5,0,0.0,0.0
1011,2675,27-09-2019 04:48:00,0,1367.0,1046.0,0.765,6.543,4,0,0,0,4,0,4,0,0.0,0.0
1011,2676,27-09-2019 04:50:00,0,1378.0,1018.0,0.738,6.556,18,0,0,0,18,0,18,0,0.0,0.0
1011,2677,27-09-2019 04:52:00,0,1367.0,1006.0,0.736,6.501,2,0,0,0,2,0,2,0,0.0,0.0
1011,2678,27-09-2019 04:54:00,0,1381.0,1003.0,0.726,6.553,1,0,0,0,1,0,1,0,0.0,0.0
1011,2679,27-09-2019 04:56:00,0,1330.5,967.0,0.7265,6.314,0,0,0,0,0,0,0,0,0.0,0.0
1011,2680,27-09-2019 04:58:00,0,1280.0,931.0,0.727,6.075,128,70,45,25,58,37,21,0,0.0,0.0
1011,2681,27-09-2019 05:00:00,0,1789.0,1228.0,0.687,8.409,256,186,137,49,70,52,18,29,0.0,0.0
1011,2682,27-09-2019 05:02:00,0,1573.0,1150.0,0.731,7.47,318,213,169,44,105,70,35,57,0.04,0.0
1011,2683,27-09-2019 05:04:00,0,1884.0,1363.0,0.724,8.932,193,110,90,20,83,65,18,85,0.0,0.0
1011,2684,27-09-2019 05:06:00,0,1959.0,1477.0,0.754,9.354,116,70,52,18,46,33,13,1,0.0,0.0
1011,2685,27-09-2019 05:08:00,0,1980.0,1397.0,0.705,9.348,53,14,9,5,39,18,21,10,0.0,0.0
1011,2686,27-09-2019 05:10:00,0,1965.0,1471.0,0.749,9.371,170,102,71,31,68,52,16,57,0.0,0.0
1011,2687,27-09-2019 05:12:00,0,2170.0,1545.0,0.712,10.262,374,200,148,52,174,133,41,20,0.0,0.0
1011,2688,27-09-2019 05:14:00,0,1953.0,1493.0,0.765,9.347,75,63,49,14,12,9,3,0,0.0,0.0
1011,2689,27-09-2019 05:16:00,0,1967.0,1436.0,0.73,9.341,22,11,3,8,11,4,7,1,0.0,0.0
1011,2690,27-09-2019 05:18:00,0,2187.0,1506.0,0.689,10.285,76,26,7,19,50,34,16,0,0.0,0.0
1011,2691,27-09-2019 05:20:00,0,1957.0,1464.0,0.748,9.334,11,8,1,7,3,0,3,0,0.0,0.0
1011,2692,27-09-2019 05:22:00,0,1987.0,1378.0,0.693,9.356,7,7,0,7,0,0,0,0,0.0,0.0
1011,2693,27-09-2019 05:24:00,0,1763.0,1299.0,0.737,8.384,12,7,2,5,5,2,3,0,0.0,0.0
1011,2694,27-09-2019 05:26:00,0,1757.0,1338.0,0.761,8.405,19,4,0,4,15,3,12,0,0.0,0.0
1011,2695,27-09-2019 05:28:00,0,1776.0,1294.0,0.729,8.433,26,7,0,7,19,5,14,0,0.0,0.0
1011,2696,27-09-2019 05:30:00,0,1735.0,1218.0,0.7015,8.1855,6,0,0,0,6,3,3,0,0.0,0.0
1011,2697,27-09-2019 05:32:00,0,1694.0,1142.0,0.674,7.938,12,2,0,2,10,4,6,0,0.0,0.0
1011,2698,27-09-2019 05:34:00,0,1476.0,1089.0,0.738,7.021,16,1,0,1,15,7,8,0,0.0,0.0
1011,2699,27-09-2019 05:36:00,0,1488.0,1035.0,0.696,7.009,2,0,0,0,2,0,2,0,0.0,0.0
1011,2700,27-09-2019 05:38:00,0,1492.0,1008.0,0.676,6.995,2,0,0,0,2,0,2,0,0.0,0.0
1011,2701,27-09-2019 05:40:00,0,1387.0,980.0,0.706,6.549,28,6,2,4,22,13,9,0,0.0,0.0
1011,2702,27-09-2019 05:42:00,0,1386.0,960.0,0.693,6.523,3,1,0,1,2,0,2,0,0.0,0.0
1011,2703,27-09-2019 05:44:00,0,1280.0,940.0,0.734,6.084,9,1,0,1,8,0,8,0,0.0,0.0
1011,2704,27-09-2019 05:46:00,0,1167.0,928.0,0.795,5.626,3,0,0,0,3,0,3,0,0.0,0.0
1011,2705,27-09-2019 05:48:00,0,1165.0,920.0,0.79,5.609,17,4,0,4,13,0,13,0,0.0,0.0
1011,2706,27-09-2019 05:50:00,0,1163.0,928.0,0.799,5.608,11,1,0,1,10,0,10,0,0.0,0.0
1011,2707,27-09-2019 05:52:00,0,1164.0,932.0,0.8,5.619,26,3,0,3,23,0,23,0,0.0,0.0
1011,2708,27-09-2019 05:54:00,0,1160.0,944.0,0.814,5.617,0,0,0,0,0,0,0,0,0.0,0.0
1011,2709,27-09-2019 05:56:00,0,1379.0,989.0,0.717,6.53,0,0,0,0,0,0,0,0,0.0,0.0
1011,2710,27-09-2019 05:58:00,0,1493.0,1007.0,0.674,6.997,22,13,0,13,9,2,7,0,0.0,0.0
1011,2711,27-09-2019 06:00:00,1,1485.0,1055.0,0.711,7.02,17,5,2,3,12,1,11,0,0.0,0.0
1011,2712,27-09-2019 06:02:00,1,1481.0,1064.0,0.719,7.014,181,130,103,27,51,31,20,35,0.0,0.0
1011,2713,27-09-2019 06:04:00,1,2146.5,1453.0,0.687,10.066,60,15,7,8,45,18,27,28,0.0,0.0
1011,2714,27-09-2019 06:06:00,1,2812.0,1842.0,0.655,13.118,78,50,23,27,28,4,24,56,0.0,0.02
1011,2715,27-09-2019 06:08:00,1,2954.0,2142.0,0.725,14.01,67,21,15,6,46,13,33,56,0.0,0.02
1011,2716,27-09-2019 06:10:00,1,3462.0,2480.0,0.716,16.387,65,29,11,18,36,10,26,52,0.0,0.0
1011,2717,27-09-2019 06:12:00,1,3358.0,2390.0,0.712,15.876,90,37,19,18,53,21,32,42,0.0,0.13
1011,2718,27-09-2019 06:14:00,1,3444.0,2480.0,0.72,16.314,348,203,159,44,145,121,24,66,0.16,0.04
1011,2719,27-09-2019 06:16:00,1,3427.0,2604.0,0.76,16.385,143,108,68,40,35,7,28,59,0.0,0.0
1011,2720,27-09-2019 06:18:00,1,3416.0,2621.0,0.767,16.363,245,148,112,36,97,71,26,65,0.12,0.05
1011,2721,27-09-2019 06:20:00,1,3415.0,2607.0,0.763,16.343,75,41,22,19,34,19,15,15,0.06,0.03
1011,2722,27-09-2019 06:22:00,1,3389.0,2715.0,0.801,16.358,109,66,36,30,43,19,24,58,0.0,0.0
1011,2723,27-09-2019 06:24:00,1,3710.0,2889.0,0.779,17.815,244,134,103,31,110,79,31,73,0.08,0.08
1011,2724,27-09-2019 06:26:00,1,3469.0,2833.0,0.817,16.806,151,84,54,30,67,42,25,70,0.11,0.04
1011,2725,27-09-2019 06:28:00,1,3681.0,2935.0,0.797,17.754,168,99,55,44,69,35,34,55,0.05,0.0
1011,2726,27-09-2019 06:30:00,1,3472.0,2835.0,0.817,16.817,104,47,27,20,57,19,38,64,0.0,0.07
1011,2727,27-09-2019 06:32:00,1,3358.0,2862.0,0.852,16.401,136,26,19,7,110,65,45,46,0.0,0.11
1011,2728,27-09-2019 06:34:00,1,3562.0,2980.0,0.837,17.335,418,245,199,46,173,149,24,83,0.17,0.01
1011,2729,27-09-2019 06:36:00,1,3160.0,2697.0,0.854,15.436,298,213,168,45,85,54,31,63,0.04,0.0
1011,2730,27-09-2019 06:38:00,1,3416.5,2839.0,0.8325,16.605,138,110,75,35,28,12,16,48,0.0,0.0
1011,2731,27-09-2019 06:40:00,1,3673.0,2981.0,0.811,17.774,122,40,26,14,82,51,31,54,0.0,0.02
1011,2732,27-09-2019 06:42:00,1,3649.0,3083.0,0.845,17.792,188,91,62,29,97,64,33,33,0.07,0.09
1011,2733,27-09-2019 06:44:00,1,3343.0,2917.0,0.873,16.4,286,155,119,36,131,93,38,58,0.09,0.0
1011,2734,27-09-2019 06:46:00,1,3377.0,2791.0,0.826,16.396,79,19,11,8,60,18,42,47,0.01,0.05
1011,2735,27-09-2019 06:48:00,1,3544.0,2981.0,0.841,17.265,247,136,101,35,111,76,35,32,0.08,0.02
1011,2736,27-09-2019 06:50:00,1,3658.0,3090.0,0.845,17.832,203,112,76,36,91,63,28,81,0.05,0.0
1011,2737,27-09-2019 06:52:00,1,3253.0,2766.0,0.85,15.879,419,206,165,41,213,169,44,50,0.06,0.02
1011,2738,27-09-2019 06:54:00,1,2973.0,2558.0,0.86,14.546,115,39,18,21,76,38,38,59,0.0,0.02
1011,2739,27-09-2019 06:56:00,1,3613.0,3233.0,0.895,17.815,101,34,7,27,67,38,29,54,0.0,0.06
1011,2740,27-09-2019 06:58:00,1,3631.0,3142.0,0.865,17.787,186,76,49,27,110,68,42,24,0.07,0.01
1011,2741,27-09-2019 07:00:00,1,2937.0,2670.0,0.909,14.529,257,160,120,40,97,68,29,11,0.03,0.1
1011,2742,27-09-2019 07:02:00,1,3319.0,3023.0,0.911,16.423,163,70,52,18,93,65,28,2,0.03,0.0
1011,2743,27-09-2019 07:04:00,1,2668.0,2378.0,0.891,13.144,106,25,12,13,81,45,36,0,0.0,0.0
1011,2744,27-09-2019 07:06:00,1,2862.0,2522.0,0.881,14.07,163,36,19,17,127,81,46,0,0.0,0.0
1011,2745,27-09-2019 07:08:00,1,2840.0,2584.0,0.91,14.051,17,3,1,2,14,6,8,0,0.0,0.0
1011,2746,27-09-2019 07:10:00,1,2843.0,2563.0,0.902,14.038,0,0,0,0,0,0,0,0,0.0,0.0
1011,2747,27-09-2019 07:12:00,1,2806.0,2492.0,0.888,13.8135,1,0,0,0,1,0,1,0,0.0,0.0
1011,2748,27-09-2019 07:14:00,1,2769.0,2421.0,0.874,13.589,25,6,0,6,19,4,15,0,0.0,0.0
1011,2749,27-09-2019 07:16:00,1,2790.0,2366.0,0.848,13.611,27,1,0,1,26,2,24,0,0.0,0.0
1011,2750,27-09-2019 07:18:00,1,2801.0,2296.0,0.82,13.576,5,0,0,0,5,0,5,0,0.0,0.0
1011,2751,27-09-2019 07:20:00,1,2468.0,2202.0,0.892,12.163,0,0,0,0,0,0,0,0,0.0,0.0
1011,2752,27-09-2019 07:22:00,1,2495.0,2120.0,0.85,12.177,44,18,11,7,26,16,10,0,0.0,0.0
1011,2753,27-09-2019 07:24:00,1,2479.0,2180.0,0.88,12.179,2,2,1,1,0,0,0,0,0.0,0.0
1011,2754,27-09-2019 07:26:00,1,2483.0,2137.0,0.861,12.148,8,1,0,1,7,1,6,0,0.0,0.0
1011,2755,27-09-2019 07:28:00,1,2281.0,2048.0,0.898,11.253,8,1,0,1,7,0,7,0,0.0,0.0
1011,2756,27-09-2019 07:30:00,1,2301.0,1948.0,0.847,11.222,4,2,0,2,2,0,2,0,0.0,0.0
1011,2757,27-09-2019 07:32:00,1,2197.0,1901.0,0.865,10.762,0,0,0,0,0,0,0,0,0.0,0.0
1011,2758,27-09-2019 07:34:00,1,2086.0,1903.0,0.912,10.327,15,8,1,7,7,3,4,0,0.01,0.0
1011,2759,27-09-2019 07:36:00,1,2074.0,1891.0,0.912,10.266,269,83,54,29,186,129,57,4,0.0,0.0
1011,2760,27-09-2019 07:38:00,1,2276.0,2037.0,0.895,11.222,107,18,11,7,89,53,36,0,0.0,0.0
1011,2761,27-09-2019 07:40:00,1,2480.0,2190.0,0.883,12.195,104,23,6,17,81,35,46,1,0.0,0.0
1011,2762,27-09-2019 07:42:00,1,2554.0,2341.0,0.917,12.653,39,2,0,2,37,21,16,0,0.0,0.0
1011,2763,27-09-2019 07:44:00,1,2667.0,2368.0,0.888,13.13,5,1,0,1,4,1,3,0,0.0,0.0
1011,2764,27-09-2019 07:46:00,1,2573.5,2276.5,0.8845,12.6605,24,7,0,7,17,4,13,0,0.0,0.0
1011,2765,27-09-2019 07:48:00,1,2480.0,2185.0,0.881,12.191,15,4,0,4,11,0,11,0,0.0,0.0
1011,2766,27-09-2019 07:50:00,1,2258.0,2109.0,0.934,11.233,3,0,0,0,3,2,1,0,0.0,0.0
1011,2767,27-09-2019 07:52:00,1,2266.0,2083.0,0.919,11.235,0,0,0,0,0,0,0,0,0.0,0.0
1011,2768,27-09-2019 07:54:00,1,2264.0,2131.0,0.941,11.279,39,5,0,5,34,20,14,0,0.0,0.0
1011,2769,27-09-2019 07:56:00,1,2258.0,2134.0,0.945,11.259,22,11,1,10,11,4,7,0,0.0,0.0
1011,2770,27-09-2019 07:58:00,1,2287.0,2012.0,0.88,11.238,58,16,0,16,42,25,17,0,0.0,0.0
1011,2771,27-09-2019 08:00:00,1,2285.0,2016.0,0.882,11.236,11,0,0,0,11,0,11,0,0.01,0.0
1011,2772,27-09-2019 08:02:00,1,2181.0,1962.0,0.9,10.767,95,17,10,7,78,55,23,0,0.0,0.0
1011,2773,27-09-2019 08:04:00,1,2177.0,1978.0,0.909,10.77,104,23,15,8,81,53,28,0,0.0,0.0
1011,2774,27-09-2019 08:06:00,1,2260.0,2125.0,0.94,11.257,11,0,0,0,11,1,10,0,0.0,0.0
1011,2775,27-09-2019 08:08:00,1,2252.0,2133.0,0.947,11.236,5,0,0,0,5,0,5,0,0.0,0.0
1011,2776,27-09-2019 08:10:00,1,2269.0,2058.0,0.907,11.218,1,1,1,0,0,0,0,0,0.0,0.0
1011,2777,27-09-2019 08:12:00,1,2063.0,1966.0,0.953,10.306,4,0,0,0,4,2,2,0,0.0,0.0
1011,2778,27-09-2019 08:14:00,1,2069.0,1949.0,0.942,10.308,30,0,0,0,30,19,11,0,0.0,0.0
1011,2779,27-09-2019 08:16:00,1,2076.0,1942.0,0.936,10.33,86,18,11,7,68,53,15,0,0.0,0.0
1011,2780,27-09-2019 08:18:00,1,2172.0,2018.0,0.929,10.79,119,80,59,21,39,16,23,54,0.0,0.0
1011,2781,27-09-2019 08:20:00,1,2359.0,2180.0,0.9245,11.707,186,98,66,32,88,51,37,79,0.0,0.0
1011,2782,27-09-2019 08:22:00,1,2546.0,2342.0,0.92,12.624,110,21,3,18,89,47,42,59,0.0,0.0
1011,2783,27-09-2019 08:24:00,1,2944.0,2650.0,0.9,14.532,74,15,0,15,59,36,23,22,0.0,0.33
1011,2784,27-09-2019 08:26:00,1,2942.0,2632.0,0.895,14.505,59,14,0,14,45,26,19,0,0.09,0.01
1011,2785,27-09-2019 08:28:00,1,2931.0,2681.0,0.915,14.518,169,99,75,24,70,52,18,16,0.05,0.0
1011,2786,27-09-2019 08:30:00,1,3100.0,2942.0,0.949,15.471,246,131,104,27,115,85,30,39,0.04,0.0
1011,2787,27-09-2019 08:32:00,1,2930.0,2704.0,0.923,14.54,60,42,21,21,18,6,12,25,0.0,0.01
1011,2788,27-09-2019 08:34:00,1,3205.0,3000.0,0.936,15.95,67,35,16,19,32,13,19,0,0.06,0.0
1011,2789,27-09-2019 08:36:00,1,2866.0,2937.0,1.025,14.542,352,203,155,48,149,117,32,77,0.06,0.03
1011,2790,27-09-2019 08:38:00,1,2704.0,2637.0,0.975,13.575,342,213,165,48,129,95,34,49,0.05,0.0
1011,2791,27-09-2019 08:40:00,1,2726.0,2580.0,0.946,13.598,151,107,63,44,44,21,23,60,0.04,0.0
1011,2792,27-09-2019 08:42:00,1,2899.0,2829.0,0.976,14.552,140,60,37,23,80,39,41,63,0.0,0.04
1011,2793,27-09-2019 08:44:00,1,2869.0,2904.0,1.012,14.519,369,156,113,43,213,159,54,24,0.05,0.04
1011,2794,27-09-2019 08:46:00,1,2616.0,2548.0,0.974,13.128,390,223,174,49,167,122,45,25,0.04,0.0
1011,2795,27-09-2019 08:48:00,1,2915.0,2790.0,0.957,14.576,125,97,67,30,28,11,17,62,0.0,0.0
1011,2796,27-09-2019 08:50:00,1,2895.0,2859.0,0.988,14.571,293,136,92,44,157,123,34,25,0.0,0.03
1011,2797,27-09-2019 08:52:00,1,2510.0,2487.0,0.991,12.641,314,164,127,37,150,116,34,5,0.08,0.01
1011,2798,27-09-2019 08:54:00,1,2478.0,2397.0,0.967,12.415,56,40,11,29,16,7,9,0,0.0,0.0
1011,2799,27-09-2019 08:56:00,1,2446.0,2307.0,0.943,12.189,130,65,27,38,65,31,34,0,0.0,0.0
1011,2800,27-09-2019 08:58:00,1,2759.0,2467.0,0.894,13.6,54,12,2,10,42,22,20,0,0.0,0.0
1011,2801,27-09-2019 09:00:00,1,2733.0,2478.0,0.907,13.509,14,0,0,0,14,11,3,0,0.0,0.0
1011,2802,27-09-2019 09:02:00,1,2770.0,2425.0,0.875,13.6,6,0,0,0,6,3,3,0,0.0,0.0
1011,2803,27-09-2019 09:04:00,1,2768.0,2436.0,0.88,13.601,0,0,0,0,0,0,0,0,0.0,0.0
1011,2804,27-09-2019 09:06:00,1,2547.0,2362.0,0.927,12.651,25,4,1,3,21,7,14,0,0.0,0.0
1011,2805,27-09-2019 09:08:00,1,2452.0,2299.0,0.938,12.207,21,2,1,1,19,1,18,0,0.0,0.0
1011,2806,27-09-2019 09:10:00,1,2463.0,2232.0,0.906,12.175,3,1,0,1,2,0,2,0,0.0,0.0
1011,2807,27-09-2019 09:12:00,1,2241.0,2165.0,0.966,11.228,0,0,0,0,0,0,0,0,0.0,0.0
1011,2808,27-09-2019 09:14:00,1,2270.0,2093.0,0.922,11.26,2,2,0,2,0,0,0,0,0.0,0.0
1011,2809,27-09-2019 09:16:00,1,2055.0,1970.0,0.959,10.277,1,1,0,1,0,0,0,0,0.0,0.0
1011,2810,27-09-2019 09:18:00,1,2101.0,1845.0,0.878,10.319,7,4,0,4,3,1,2,0,0.0,0.0
1011,2811,27-09-2019 09:20:00,1,1988.0,1799.0,0.905,9.823,0,0,0,0,0,0,0,0,0.0,0.0
1011,2812,27-09-2019 09:22:00,1,1868.0,1795.0,0.961,9.348,22,4,0,4,18,9,9,0,0.0,0.0
1011,2813,27-09-2019 09:24:00,1,1972.0,1873.0,0.95,9.843,2,0,0,0,2,0,2,0,0.01,0.0
1011,2814,27-09-2019 09:26:00,1,1962.0,1899.0,0.968,9.835,5,0,0,0,5,0,5,0,0.0,0.0
1011,2815,27-09-2019 09:28:00,1,1965.5,1888.5,0.961,9.836,113,46,38,8,67,52,15,3,0.0,0.01
1011,2816,27-09-2019 09:30:00,1,1969.0,1878.0,0.954,9.837,12,12,1,11,0,0,0,0,0.0,0.0
1011,2817,27-09-2019 09:32:00,1,1758.0,1791.0,1.019,8.908,8,8,0,8,0,0,0,0,0.0,0.0
1011,2818,27-09-2019 09:34:00,1,1774.0,1751.0,0.987,8.926,8,8,0,8,0,0,0,0,0.0,0.0
1011,2819,27-09-2019 09:36:00,1,1768.0,1730.0,0.978,8.883,3,1,0,1,2,1,1,0,0.0,0.0
1011,2820,27-09-2019 09:38:00,1,1776.0,1731.0,0.974,8.916,0,0,0,0,0,0,0,0,0.0,0.0
1011,2821,27-09-2019 09:40:00,1,1777.0,1747.0,0.983,8.935,1,0,0,0,1,0,1,0,0.0,0.0
1011,2822,27-09-2019 09:42:00,1,2060.0,1991.0,0.966,10.32,83,4,0,4,79,59,20,0,0.0,0.0
1011,2823,27-09-2019 09:44:00,1,2056.0,2002.0,0.974,10.316,34,9,0,9,25,4,21,0,0.0,0.0
1011,2824,27-09-2019 09:46:00,1,2065.0,1971.0,0.955,10.317,137,19,6,13,118,78,40,0,0.0,0.0
1011,2825,27-09-2019 09:48:00,1,2063.0,1961.0,0.951,10.299,4,1,0,1,3,0,3,0,0.0,0.0
1011,2826,27-09-2019 09:50:00,1,2057.0,1979.0,0.962,10.296,27,1,1,0,26,2,24,0,0.0,0.0
1011,2827,27-09-2019 09:52:00,1,2061.0,1973.0,0.957,10.305,6,3,1,2,3,2,1,0,0.0,0.0
1011,2828,27-09-2019 09:54:00,1,2059.0,1993.0,0.968,10.32,9,4,0,4,5,3,2,0,0.0,0.0
1011,2829,27-09-2019 09:56:00,1,2060.0,1992.0,0.967,10.319,33,7,0,7,26,16,10,0,0.0,0.0
1011,2830,27-09-2019 09:58:00,1,2055.0,2001.0,0.974,10.311,190,70,47,23,120,73,47,4,0.0,0.0
1011,2831,27-09-2019 10:00:00,1,2044.0,2046.0,1.001,10.317,212,36,7,29,176,111,65,0,0.0,0.0
1011,2832,27-09-2019 10:02:00,1,2234.0,2208.5,0.9895,11.246,158,22,3,19,136,83,53,0,0.0,0.0
1011,2833,27-09-2019 10:04:00,1,2424.0,2371.0,0.978,12.175,177,25,8,17,152,97,55,0,0.0,0.0
1011,2834,27-09-2019 10:06:00,1,2423.0,2409.0,0.994,12.213,17,4,2,2,13,1,12,0,0.0,0.0
1011,2835,27-09-2019 10:08:00,1,2428.0,2357.0,0.971,12.174,0,0,0,0,0,0,0,0,0.0,0.0
1011,2836,27-09-2019 10:10:00,1,2230.0,2255.0,1.012,11.281,22,6,4,2,16,10,6,0,0.0,0.0
1011,2837,27-09-2019 10:12:00,1,2227.0,2245.0,1.008,11.26,2,2,1,1,0,0,0,0,0.0,0.0
1011,2838,27-09-2019 10:14:00,1,2247.0,2172.0,0.967,11.259,19,3,1,2,16,5,11,0,0.0,0.0
1011,2839,27-09-2019 10:16:00,1,2152.0,2096.0,0.974,10.798,4,1,0,1,3,1,2,0,0.0,0.0
1011,2840,27-09-2019 10:18:00,1,2042.0,2081.0,1.019,10.35,2,2,0,2,0,0,0,0,0.0,0.0
1011,2841,27-09-2019 10:20:00,1,2057.0,2000.0,0.972,10.321,2,0,0,0,2,0,2,0,0.0,0.0
1011,2842,27-09-2019 10:22:00,1,2062.0,1944.0,0.943,10.276,0,0,0,0,0,0,0,0,0.0,0.0
1011,2843,27-09-2019 10:24:00,1,1958.0,1915.0,0.978,9.834,3,2,0,2,1,0,1,0,0.0,0.0
1011,2844,27-09-2019 10:26:00,1,1857.0,1858.0,1.0,9.374,59,14,8,6,45,32,13,0,0.0,0.0
1011,2845,27-09-2019 10:28:00,1,2076.0,1924.0,0.927,10.31,129,58,35,23,71,47,24,32,0.0,0.0
1011,2846,27-09-2019 10:30:00,1,2242.0,2190.0,0.977,11.257,205,146,111,35,59,41,18,112,0.05,0.0
1011,2847,27-09-2019 10:32:00,1,2436.0,2329.0,0.956,12.178,78,55,23,32,23,2,21,52,0.0,0.0
1011,2848,27-09-2019 10:34:00,1,2710.0,2588.0,0.955,13.541,91,54,30,24,37,15,22,34,0.0,0.04
1011,2849,27-09-2019 10:36:00,1,2807.5,2665.0,0.9495,14.012,139,106,65,41,33,10,23,56,0.0,0.0
1011,2850,27-09-2019 10:38:00,1,2905.0,2742.0,0.944,14.483,124,78,41,37,46,28,18,52,0.06,0.05
1011,2851,27-09-2019 10:40:00,1,2904.0,2816.0,0.97,14.56,93,60,30,30,33,11,22,57,0.0,0.0
1011,2852,27-09-2019 10:42:00,1,2885.0,2885.0,1.0,14.562,126,83,50,33,43,14,29,75,0.0,0.0
1011,2853,27-09-2019 10:44:00,1,3203.0,3044.0,0.95,15.989,267,214,162,52,53,35,18,52,0.09,0.08
1011,2854,27-09-2019 10:46:00,1,2872.0,2877.0,1.002,14.502,242,119,80,39,123,85,38,39,0.05,0.02
1011,2855,27-09-2019 10:48:00,1,2894.0,2826.0,0.977,14.531,177,89,64,25,88,57,31,47,0.0,0.04
1011,2856,27-09-2019 10:50:00,1,3384.0,3193.0,0.943,16.869,125,94,53,41,31,15,16,65,0.01,0.0
1011,2857,27-09-2019 10:52:00,1,3392.0,3198.0,0.943,16.907,81,64,40,24,17,5,12,46,0.0,0.06
1011,2858,27-09-2019 10:54:00,1,3161.0,3092.0,0.978,15.877,219,137,92,45,82,48,34,60,0.07,0.03
1011,2859,27-09-2019 10:56:00,1,3092.0,2991.0,0.967,15.496,247,188,152,36,59,38,21,80,0.04,0.0
1011,2860,27-09-2019 10:58:00,1,3177.0,3091.0,0.973,15.938,58,38,23,15,20,6,14,56,0.01,0.0
1011,2861,27-09-2019 11:00:00,1,3358.0,3222.0,0.96,16.797,59,27,23,4,32,18,14,50,0.0,0.12
1011,2862,27-09-2019 11:02:00,1,3396.0,3182.0,0.937,16.901,375,216,173,43,159,115,44,35,0.11,0.03
1011,2863,27-09-2019 11:04:00,1,3091.0,2963.0,0.959,15.457,322,208,168,40,114,82,32,27,0.04,0.05
1011,2864,27-09-2019 11:06:00,1,3273.0,3165.0,0.967,16.397,542,266,209,57,276,217,59,1,0.0,0.02
1011,2865,27-09-2019 11:08:00,1,3175.0,3071.0,0.967,15.91,153,80,52,28,73,49,24,0,0.02,0.0
1011,2866,27-09-2019 11:10:00,1,2910.0,2748.0,0.942,14.508,40,11,0,11,29,8,21,0,0.0,0.0
1011,2867,27-09-2019 11:12:00,1,2645.0,2425.0,0.917,13.106,48,5,0,5,43,2,41,0,0.0,0.0
1011,2868,27-09-2019 11:14:00,1,2737.0,2498.0,0.913,13.549,27,3,2,1,24,6,18,0,0.0,0.0
1011,2869,27-09-2019 11:16:00,1,2752.0,2486.0,0.903,13.595,6,0,0,0,6,0,6,0,0.0,0.0
1011,2870,27-09-2019 11:18:00,1,2642.0,2454.0,0.929,13.127,9,2,1,1,7,0,7,0,0.0,0.0
1011,2871,27-09-2019 11:20:00,1,2536.0,2425.0,0.956,12.677,17,0,0,0,17,0,17,0,0.01,0.0
1011,2872,27-09-2019 11:22:00,1,3953.0,2352.0,0.595,18.18,17,1,0,1,16,0,16,0,0.0,0.0
1011,2873,27-09-2019 11:24:00,1,4185.0,2314.0,0.553,19.052,17,3,0,3,14,2,12,0,0.0,0.0
1011,2874,27-09-2019 11:26:00,1,4209.0,2314.0,0.55,19.147,1,0,0,0,1,0,1,0,0.0,0.0
1011,2875,27-09-2019 11:28:00,1,4101.0,2280.0,0.556,18.682,9,0,0,0,9,0,9,0,0.0,0.0
1011,2876,27-09-2019 11:30:00,1,3996.0,2228.0,0.558,18.214,26,13,6,7,13,4,9,0,0.0,0.0
1011,2877,27-09-2019 11:32:00,1,3994.0,2252.0,0.564,18.23,0,0,0,0,0,0,0,0,0.0,0.0
1011,2878,27-09-2019 11:34:00,1,3778.0,2145.0,0.568,17.261,12,3,0,3,9,6,3,0,0.0,0.0
1011,2879,27-09-2019 11:36:00,1,3682.0,2050.0,0.557,16.777,5,5,0,5,0,0,0,0,0.0,0.0
1011,2880,27-09-2019 11:38:00,1,3585.0,1976.0,0.551,16.315,0,0,0,0,0,0,0,0,0.0,0.0
1011,2881,27-09-2019 11:40:00,1,3488.0,1906.0,0.546,15.854,14,14,0,14,0,0,0,0,0.0,0.0
1011,2882,27-09-2019 11:42:00,1,3262.0,1867.0,0.572,14.92,35,22,4,18,13,9,4,0,0.0,0.0
1011,2883,27-09-2019 11:44:00,1,2498.5,1875.0,0.8285,11.9205,9,4,2,2,5,2,3,0,0.0,0.0
1011,2884,27-09-2019 11:46:00,1,1735.0,1883.0,1.085,8.921,0,0,0,0,0,0,0,0,0.0,0.0
1011,2885,27-09-2019 11:48:00,1,1750.0,1826.0,1.044,8.917,44,23,10,13,21,12,9,0,0.0,0.0
1011,2886,27-09-2019 11:50:00,1,1722.0,1931.0,1.121,8.924,4,1,0,1,3,1,2,0,0.0,0.0
1011,2887,27-09-2019 11:52:00,1,1716.0,1946.0,1.134,8.916,22,2,0,2,20,11,9,0,0.0,0.0
1011,2888,27-09-2019 11:54:00,1,1718.0,1936.0,1.127,8.912,11,1,0,1,10,6,4,0,0.0,0.0
1011,2889,27-09-2019 11:56:00,1,1504.0,1884.0,1.253,8.01,10,6,3,3,4,2,2,0,0.0,0.0
1011,2890,27-09-2019 11:58:00,1,1485.0,1909.0,1.286,7.963,0,0,0,0,0,0,0,0,0.0,0.0
1011,2891,27-09-2019 12:00:00,1,1493.0,1904.0,1.275,7.991,15,11,5,6,4,2,2,0,0.0,0.0
1011,2892,27-09-2019 12:02:00,1,1492.0,1927.0,1.292,8.01,13,0,0,0,13,1,12,0,0.0,0.0
1011,2893,27-09-2019 12:04:00,1,1501.0,1891.0,1.26,8.006,65,27,8,19,38,5,33,0,0.0,0.0
1011,2894,27-09-2019 12:06:00,1,1500.0,1903.0,1.269,8.016,61,17,2,15,44,8,36,0,0.0,0.0
1011,2895,27-09-2019 12:08:00,1,1492.0,1873.0,1.255,7.951,8,0,0,0,8,0,8,0,0.0,0.0
1011,2896,27-09-2019 12:10:00,1,1391.0,1859.0,1.336,7.539,145,85,64,21,60,39,21,2,0.0,0.0
1011,2897,27-09-2019 12:12:00,1,1355.0,1978.0,1.46,7.526,7,2,0,2,5,2,3,0,0.0,0.0
1011,2898,27-09-2019 12:14:00,1,1238.0,1992.0,1.609,7.08,140,70,46,24,70,41,29,2,0.0,0.0
1011,2899,27-09-2019 12:16:00,1,1222.0,2063.0,1.688,7.097,36,19,6,13,17,8,9,0,0.0,0.0
1011,2900,27-09-2019 12:18:00,1,1581.5,2039.5,1.3635,8.488,2,2,0,2,0,0,0,0,0.0,0.0
1011,2901,27-09-2019 12:20:00,1,1941.0,2016.0,1.039,9.879,8,7,4,3,1,0,1,0,0.0,0.0
1011,2902,27-09-2019 12:22:00,1,1933.0,2034.0,1.052,9.869,5,4,0,4,1,0,1,0,0.0,0.0
1011,2903,27-09-2019 12:24:00,1,1719.0,1940.0,1.128,8.92,11,10,3,7,1,0,1,0,0.0,0.0
1011,2904,27-09-2019 12:26:00,1,1723.0,1930.0,1.12,8.925,91,40,12,28,51,27,24,2,0.0,0.0
1011,2905,27-09-2019 12:28:00,1,1904.0,2116.0,1.111,9.845,214,45,20,25,169,112,57,7,0.0,0.0
1011,2906,27-09-2019 12:30:00,1,1880.0,2243.0,1.193,9.889,93,2,0,2,91,58,33,0,0.0,0.0
1011,2907,27-09-2019 12:32:00,1,2190.0,2360.0,1.077,11.242,102,3,1,2,99,55,44,0,0.0,0.0
1011,2908,27-09-2019 12:34:00,1,2174.0,2427.0,1.116,11.253,111,25,2,23,86,59,27,3,0.0,0.0
1011,2909,27-09-2019 12:36:00,1,2267.0,2554.0,1.127,11.758,161,56,26,30,105,65,40,3,0.0,0.0
1011,2910,27-09-2019 12:38:00,1,2349.0,2668.0,1.136,12.208,208,89,54,35,119,76,43,28,0.0,0.0
1011,2911,27-09-2019 12:40:00,1,2430.0,2791.0,1.149,12.663,155,104,66,38,51,24,27,70,0.0,0.0
1011,2912,27-09-2019 12:42:00,1,2663.0,2814.0,1.057,13.605,244,159,112,47,85,59,26,39,0.0,0.02
1011,2913,27-09-2019 12:44:00,1,2659.0,2828.0,1.064,13.608,156,59,38,21,97,53,44,44,0.01,0.08
1011,2914,27-09-2019 12:46:00,1,2853.0,2987.0,1.047,14.546,148,69,38,31,79,41,38,52,0.0,0.0
1011,2915,27-09-2019 12:48:00,1,2817.0,3110.0,1.104,14.543,181,94,50,44,87,50,37,47,0.11,0.03
1011,2916,27-09-2019 12:50:00,1,2811.0,3114.0,1.108,14.522,120,77,45,32,43,18,25,51,0.0,0.04
1012,1,23-09-2019 11:40:00,1,5281.0,3703.0,0.701,24.908,418,154,113,41,264,202,62,25,0.01,0.0
1012,2,23-09-2019 11:42:00,1,4882.0,3409.0,0.698,23.012,223,96,61,35,127,85,42,42,0.0,0.01
1012,3,23-09-2019 11:44:00,1,4629.0,3333.0,0.72,21.928,483,255,200,55,228,172,56,21,0.0,0.0
1012,4,23-09-2019 11:46:00,1,4794.0,3251.0,0.678,22.491,326,167,122,45,159,105,54,28,0.0,0.0
1012,5,23-09-2019 11:48:00,1,4741.0,3386.0,0.714,22.431,196,112,79,33,84,56,28,15,0.04,0.0
1012,6,23-09-2019 11:50:00,1,4773.0,3296.0,0.691,22.455,124,71,41,30,53,27,26,23,0.0,0.0
1012,7,23-09-2019 11:52:00,1,4638.0,3286.0,0.708,21.913,265,144,105,39,121,83,38,41,0.0,0.0
1012,8,23-09-2019 11:54:00,1,4575.0,3144.0,0.687,21.505,138,82,47,35,56,23,33,23,0.0,0.0
1012,9,23-09-2019 11:56:00,1,4351.0,3087.0,0.709,20.56,104,60,36,24,44,18,26,8,0.0,0.0
1012,10,23-09-2019 11:58:00,1,4324.0,3147.0,0.728,20.522,206,90,63,27,116,74,42,61,0.0,0.0
1012,11,23-09-2019 12:00:00,1,4186.0,3008.0,0.7185,19.8235,314,149,104,45,165,128,37,22,0.0,0.04
1012,12,23-09-2019 12:02:00,1,4048.0,2869.0,0.709,19.125,343,135,93,42,208,149,59,19,0.0,0.0
1012,13,23-09-2019 12:04:00,1,3968.0,2757.0,0.695,18.688,80,35,14,21,45,9,36,0,0.0,0.0
1012,14,23-09-2019 12:06:00,1,4048.0,2857.0,0.706,19.113,241,116,83,33,125,83,42,36,0.0,0.0
1012,15,23-09-2019 12:08:00,1,4042.0,2847.0,0.704,19.077,163,90,46,44,73,41,32,9,0.0,0.0
1012,16,23-09-2019 12:10:00,1,4030.0,2978.0,0.739,19.176,149,65,39,26,84,50,34,0,0.0,0.0
1012,17,23-09-2019 12:12:00,1,4039.0,2880.0,0.713,19.101,54,21,6,15,33,11,22,0,0.0,0.0
1012,18,23-09-2019 12:14:00,1,3735.0,2730.0,0.731,17.739,142,61,26,35,81,40,41,14,0.0,0.0
1012,19,23-09-2019 12:16:00,1,4055.0,2817.0,0.695,19.097,77,41,28,13,36,12,24,0,0.0,0.0
1012,20,23-09-2019 12:18:00,1,3750.0,2649.0,0.706,17.709,30,3,0,3,27,0,27,0,0.0,0.0
1012,21,23-09-2019 12:20:00,1,3675.0,2441.0,0.664,17.182,33,2,0,2,31,0,31,0,0.0,0.0
1012,22,23-09-2019 12:22:00,1,3572.0,2360.0,0.661,16.686,20,6,0,6,14,0,14,0,0.0,0.0
1012,23,23-09-2019 12:24:00,1,3368.0,2245.0,0.667,15.756,23,6,0,6,17,0,17,0,0.0,0.0
1012,24,23-09-2019 12:26:00,1,3159.0,2157.0,0.683,14.833,40,16,4,12,24,0,24,0,0.0,0.0
1012,25,23-09-2019 12:28:00,1,3361.0,2249.0,0.669,15.732,274,120,85,35,154,114,40,42,0.0,0.0
1012,26,23-09-2019 12:30:00,1,3470.0,2356.0,0.679,16.279,422,184,130,54,238,174,64,99,0.0,0.0
1012,27,23-09-2019 12:32:00,1,3545.0,2455.0,0.692,16.686,276,137,97,40,139,97,42,23,0.0,0.0
1012,28,23-09-2019 12:34:00,1,3605.0,2479.0,0.6875,16.949,131,64,32,32,67,30,37,0,0.0,0.0
1012,29,23-09-2019 12:36:00,1,3665.0,2503.0,0.683,17.212,237,116,78,38,121,82,39,29,0.0,0.0
1012,30,23-09-2019 12:38:00,1,3659.0,2504.0,0.684,17.188,324,133,96,37,191,142,49,63,0.0,0.0
1012,31,23-09-2019 12:40:00,1,3677.0,2468.0,0.671,17.22,157,66,46,20,91,54,37,5,0.0,0.0
1012,32,23-09-2019 12:42:00,1,3565.0,2434.0,0.683,16.74,88,34,18,16,54,24,30,2,0.0,0.0
1012,33,23-09-2019 12:44:00,1,3475.0,2327.0,0.67,16.268,183,79,41,38,104,63,41,5,0.0,0.0
1012,34,23-09-2019 12:46:00,1,3571.0,2403.0,0.673,16.733,304,141,111,30,163,122,41,50,0.0,0.0
1012,35,23-09-2019 12:48:00,1,3252.0,2227.0,0.685,15.28,173,60,38,22,113,66,47,13,0.0,0.0
1012,36,23-09-2019 12:50:00,1,3483.0,2233.0,0.641,16.195,160,17,4,13,143,90,53,0,0.0,0.0
1012,37,23-09-2019 12:52:00,1,3474.0,2310.0,0.665,16.244,117,28,12,16,89,45,44,3,0.0,0.0
1012,38,23-09-2019 12:54:00,1,3482.0,2327.0,0.668,16.297,361,157,107,50,204,148,56,24,0.0,0.0
1012,39,23-09-2019 12:56:00,1,3465.0,2321.0,0.67,16.223,270,27,6,21,243,174,69,0,0.0,0.0
1012,40,23-09-2019 12:58:00,1,3471.0,2333.0,0.672,16.259,152,21,9,12,131,86,45,0,0.0,0.0
1012,41,23-09-2019 13:00:00,1,3149.0,2212.0,0.702,14.857,89,34,14,20,55,20,35,0,0.0,0.0
1012,42,23-09-2019 13:02:00,1,3161.0,2082.0,0.659,14.76,44,0,0,0,44,0,44,0,0.0,0.0
1012,43,23-09-2019 13:04:00,1,2974.0,1911.0,0.643,13.835,40,0,0,0,40,0,40,0,0.0,0.0
1012,44,23-09-2019 13:06:00,1,2771.0,1761.0,0.635,12.868,46,0,0,0,46,0,46,0,0.0,0.0
1012,45,23-09-2019 13:08:00,1,2765.5,1792.5,0.648,12.882,51,7,3,4,44,5,39,0,0.0,0.0
1012,46,23-09-2019 13:10:00,1,2760.0,1824.0,0.661,12.896,346,147,101,46,199,141,58,34,0.0,0.0
1012,47,23-09-2019 13:12:00,1,3176.0,2103.0,0.662,14.841,440,201,155,46,239,186,53,105,0.0,0.0
1012,48,23-09-2019 13:14:00,1,3485.0,2263.0,0.649,16.236,355,128,103,25,227,172,55,63,0.0,0.0
1012,49,23-09-2019 13:16:00,1,3235.0,2306.0,0.713,15.3,446,162,113,49,284,219,65,39,0.0,0.0
1012,50,23-09-2019 13:18:00,1,3467.0,2341.0,0.675,16.254,346,134,102,32,212,161,51,14,0.0,0.0
1012,51,23-09-2019 13:20:00,1,3137.0,2231.0,0.711,14.829,133,7,2,5,126,76,50,0,0.0,0.0
1012,52,23-09-2019 13:22:00,1,2951.0,1999.0,0.677,13.841,34,0,0,0,34,0,34,0,0.0,0.0
1012,53,23-09-2019 13:24:00,1,2998.0,1814.0,0.605,13.823,50,0,0,0,50,10,40,0,0.0,0.0
1012,54,23-09-2019 13:26:00,1,2667.0,1769.0,0.663,12.466,39,0,0,0,39,0,39,0,0.0,0.0
1012,55,23-09-2019 13:28:00,1,2689.0,1623.0,0.604,12.394,34,0,0,0,34,0,34,0,0.0,0.0
1012,56,23-09-2019 13:30:00,1,2553.0,1683.0,0.659,11.922,124,36,23,13,88,42,46,1,0.0,0.0
1012,57,23-09-2019 13:32:00,1,2967.0,1991.0,0.671,13.895,274,143,106,37,131,86,45,26,0.0,0.0
1012,58,23-09-2019 13:34:00,1,2650.0,1794.0,0.677,12.43,314,146,100,46,168,109,59,22,0.0,0.0
1012,59,23-09-2019 13:36:00,1,3189.0,1993.0,0.625,14.772,255,118,75,43,137,87,50,11,0.0,0.0
1012,60,23-09-2019 13:38:00,1,2987.0,1905.0,0.638,13.878,58,13,7,6,45,15,30,0,0.0,0.0
1012,61,23-09-2019 13:40:00,1,2882.0,1859.0,0.645,13.414,39,0,0,0,39,0,39,0,0.0,0.0
1012,62,23-09-2019 13:42:00,1,2781.0,1767.0,0.635,12.9145,42,0,0,0,42,0,42,0,0.0,0.0
1012,63,23-09-2019 13:44:00,1,2680.0,1675.0,0.625,12.415,32,0,0,0,32,0,32,0,0.0,0.0
1012,64,23-09-2019 13:46:00,1,2678.0,1684.0,0.629,12.417,39,1,0,1,38,0,38,0,0.0,0.0
1012,65,23-09-2019 13:48:00,1,2580.0,1672.0,0.648,12.018,35,2,0,2,33,0,33,0,0.0,0.0
1012,66,23-09-2019 13:50:00,1,2479.0,1506.0,0.608,11.435,38,5,3,2,33,0,33,0,0.0,0.0
1012,67,23-09-2019 13:52:00,1,2495.0,1472.0,0.59,11.463,42,0,0,0,42,0,42,0,0.0,0.0
1012,68,23-09-2019 13:54:00,1,2269.0,1450.0,0.639,10.547,35,7,4,3,28,0,28,0,0.0,0.0
1012,69,23-09-2019 13:56:00,1,2483.0,1521.0,0.613,11.467,227,92,65,27,135,90,45,9,0.0,0.0
1012,70,23-09-2019 13:58:00,1,2954.0,2001.0,0.677,13.855,347,144,107,37,203,152,51,80,0.0,0.0
1012,71,23-09-2019 14:00:00,1,3272.0,2197.0,0.671,15.323,404,156,118,38,248,191,57,68,0.01,0.0
1012,72,23-09-2019 14:02:00,1,3497.0,2267.0,0.648,16.288,194,56,39,17,138,87,51,20,0.0,0.0
1012,73,23-09-2019 14:04:00,1,3491.0,2231.0,0.639,16.224,193,54,17,37,139,84,55,55,0.0,0.0
1012,74,23-09-2019 14:06:00,1,3467.0,2387.0,0.688,16.304,360,173,121,52,187,134,53,75,0.0,0.0
1012,75,23-09-2019 14:08:00,1,2963.0,1941.0,0.655,13.824,306,96,74,22,210,171,39,58,0.0,0.0
1012,76,23-09-2019 14:10:00,1,2466.0,1597.0,0.648,11.483,328,114,81,33,214,156,58,1,0.0,0.0
1012,77,23-09-2019 14:12:00,1,3887.0,2589.0,0.666,18.182,334,121,85,36,213,158,55,73,0.0,0.0
1012,78,23-09-2019 14:14:00,1,3840.0,2743.0,0.714,18.168,232,58,35,23,174,117,57,55,0.0,0.0
1012,79,23-09-2019 14:16:00,1,3414.0,2318.0,0.674,16.019,89,10,2,8,79,35,44,0,0.0,0.0
1012,80,23-09-2019 14:18:00,1,2988.0,1893.0,0.634,13.87,174,67,38,29,107,65,42,0,0.0,0.0
1012,81,23-09-2019 14:20:00,1,3192.0,2073.0,0.65,14.871,306,106,68,38,200,148,52,9,0.0,0.0
1012,82,23-09-2019 14:22:00,1,2696.0,1610.0,0.597,12.405,46,1,1,0,45,11,34,0,0.0,0.0
1012,83,23-09-2019 14:24:00,1,2467.0,1532.0,0.621,11.418,38,0,0,0,38,2,36,0,0.0,0.0
1012,84,23-09-2019 14:26:00,1,2486.0,1506.0,0.606,11.463,32,1,1,0,31,0,31,0,0.0,0.0
1012,85,23-09-2019 14:28:00,1,2498.0,1469.0,0.588,11.469,76,15,7,8,61,13,48,0,0.0,0.0
1012,86,23-09-2019 14:30:00,1,2367.0,1475.0,0.623,10.961,248,1,1,0,247,190,57,0,0.0,0.0
1012,87,23-09-2019 14:32:00,1,2494.0,1506.0,0.604,11.494,317,0,0,0,317,259,58,0,0.0,0.0
1012,88,23-09-2019 14:34:00,1,2479.0,1522.0,0.614,11.453,225,1,1,0,224,175,49,0,0.0,0.0
1012,89,23-09-2019 14:36:00,1,2581.0,1617.0,0.626,11.961,315,10,0,10,305,245,60,0,0.0,0.0
1012,90,23-09-2019 14:38:00,1,2668.0,1674.0,0.627,12.364,166,11,3,8,155,111,44,0,0.0,0.0
1012,91,23-09-2019 14:40:00,1,2972.0,1942.0,0.654,13.862,76,5,0,5,71,30,41,0,0.0,0.0
1012,92,23-09-2019 14:42:00,1,2784.0,1812.0,0.651,12.976,42,2,1,1,40,0,40,0,0.0,0.0
1012,93,23-09-2019 14:44:00,1,2996.0,1882.0,0.628,13.889,301,126,84,42,175,126,49,22,0.0,0.0
1012,94,23-09-2019 14:46:00,1,3381.0,2179.0,0.644,15.735,381,192,139,53,189,140,49,39,0.0,0.0
1012,95,23-09-2019 14:48:00,1,2665.0,1750.0,0.657,12.438,167,42,21,21,125,73,52,0,0.0,0.0
1012,96,23-09-2019 14:50:00,1,2804.5,1888.5,0.6725,13.1405,189,64,41,23,125,85,40,3,0.01,0.0
1012,97,23-09-2019 14:52:00,1,2944.0,2027.0,0.688,13.843,40,0,0,0,40,0,40,0,0.0,0.0
1012,98,23-09-2019 14:54:00,1,2644.0,1808.0,0.684,12.42,28,0,0,0,28,0,28,0,0.0,0.0
1012,99,23-09-2019 14:56:00,1,2636.0,1828.0,0.693,12.411,39,0,0,0,39,0,39,0,0.0,0.0
1012,100,23-09-2019 14:58:00,1,2650.0,1771.0,0.668,12.402,35,0,0,0,35,0,35,0,0.0,0.0
1012,101,23-09-2019 15:00:00,1,2645.0,1793.0,0.678,12.407,37,1,0,1,36,0,36,0,0.0,0.0
1012,102,23-09-2019 15:02:00,1,2740.0,1864.0,0.68,12.861,41,0,0,0,41,0,41,0,0.0,0.0
1012,103,23-09-2019 15:04:00,1,2871.0,1881.0,0.655,13.394,39,3,0,3,36,0,36,0,0.0,0.0
1012,104,23-09-2019 15:06:00,1,2641.0,1808.0,0.685,12.407,44,0,0,0,44,0,44,0,0.0,0.0
1012,105,23-09-2019 15:08:00,1,2478.0,1546.0,0.624,11.475,35,0,0,0,35,0,35,0,0.0,0.0
1012,106,23-09-2019 15:10:00,1,2251.0,1503.0,0.668,10.535,36,0,0,0,36,0,36,0,0.0,0.0
1012,107,23-09-2019 15:12:00,1,2248.0,1504.0,0.669,10.524,39,0,0,0,39,2,37,0,0.0,0.0
1012,108,23-09-2019 15:14:00,1,2252.0,1512.0,0.671,10.547,29,0,0,0,29,0,29,0,0.0,0.0
1012,109,23-09-2019 15:16:00,1,2247.0,1508.0,0.671,10.522,38,0,0,0,38,0,38,0,0.0,0.0
1012,110,23-09-2019 15:18:00,1,2449.0,1590.0,0.649,11.41,38,0,0,0,38,0,38,0,0.0,0.0
1012,111,23-09-2019 15:20:00,1,2565.0,1703.0,0.664,11.992,44,2,1,1,42,0,42,0,0.0,0.0
1012,112,23-09-2019 15:22:00,1,2671.0,1719.0,0.644,12.426,29,0,0,0,29,0,29,0,0.0,0.0
1012,113,23-09-2019 15:24:00,1,2662.5,1732.0,0.6505,12.408,42,0,0,0,42,0,42,0,0.0,0.0
1012,114,23-09-2019 15:26:00,1,2654.0,1745.0,0.657,12.39,39,3,0,3,36,0,36,0,0.0,0.0
1012,115,23-09-2019 15:28:00,1,2451.0,1626.0,0.663,11.458,40,0,0,0,40,0,40,0,0.0,0.0
1012,116,23-09-2019 15:30:00,1,2254.0,1497.0,0.664,10.537,47,0,0,0,47,0,47,0,0.0,0.0
1012,117,23-09-2019 15:32:00,1,2254.0,1463.0,0.649,10.502,40,2,0,2,38,0,38,0,0.0,0.0
1012,118,23-09-2019 15:34:00,1,2259.0,1468.0,0.65,10.528,39,1,0,1,38,0,38,0,0.0,0.0
1012,119,23-09-2019 15:36:00,1,2262.0,1459.0,0.645,10.528,44,0,0,0,44,0,44,0,0.0,0.0
1012,120,23-09-2019 15:38:00,1,2358.0,1543.0,0.654,11.001,31,1,0,1,30,0,30,0,0.0,0.0
1012,121,23-09-2019 15:40:00,1,2463.0,1592.0,0.646,11.466,78,16,10,6,62,21,41,0,0.0,0.0
1012,122,23-09-2019 15:42:00,1,2658.0,1746.0,0.657,12.407,35,0,0,0,35,0,35,0,0.0,0.0
1012,123,23-09-2019 15:44:00,1,2440.0,1659.0,0.68,11.452,38,2,0,2,36,0,36,0,0.0,0.0
1012,124,23-09-2019 15:46:00,1,2449.0,1644.0,0.671,11.468,38,0,0,0,38,0,38,0,0.0,0.0
1012,125,23-09-2019 15:48:00,1,2667.0,1762.0,0.66,12.459,34,2,0,2,32,0,32,0,0.0,0.0
1012,126,23-09-2019 15:50:00,1,2427.0,1687.0,0.695,11.432,33,2,0,2,31,0,31,0,0.0,0.0
1012,127,23-09-2019 15:52:00,1,2547.0,1699.0,0.667,11.916,36,3,2,1,33,0,33,0,0.0,0.0
1012,128,23-09-2019 15:54:00,1,2661.0,1738.0,0.653,12.409,79,4,0,4,75,26,49,0,0.0,0.0
1012,129,23-09-2019 15:56:00,1,2673.0,1749.0,0.654,12.468,34,3,1,2,31,0,31,0,0.0,0.0
1012,130,23-09-2019 15:58:00,1,2608.0,1726.5,0.662,12.188,39,4,0,4,35,0,35,0,0.0,0.0
1012,131,23-09-2019 16:00:00,1,2543.0,1704.0,0.67,11.908,39,0,0,0,39,0,39,0,0.0,0.0
1012,132,23-09-2019 16:02:00,1,2678.0,1667.0,0.623,12.397,34,1,0,1,33,0,33,0,0.0,0.0
1012,133,23-09-2019 16:04:00,1,2669.0,1732.0,0.649,12.436,52,6,4,2,46,6,40,0,0.0,0.0
1012,134,23-09-2019 16:06:00,1,2754.0,1839.0,0.668,12.888,300,132,101,31,168,122,46,20,0.0,0.0
1012,135,23-09-2019 16:08:00,1,3151.0,2164.0,0.687,14.809,306,110,77,33,196,147,49,77,0.0,0.0
1012,136,23-09-2019 16:10:00,1,2982.0,1966.0,0.659,13.926,117,52,33,19,65,45,20,58,0.0,0.0
1012,137,23-09-2019 16:12:00,1,3111.0,2220.0,0.714,14.715,286,116,76,40,170,117,53,77,0.0,0.0
1012,138,23-09-2019 16:14:00,1,3145.0,2230.0,0.709,14.859,170,21,5,16,149,87,62,0,0.0,0.0
1012,139,23-09-2019 16:16:00,1,3431.0,2376.0,0.693,16.148,175,63,34,29,112,52,60,0,0.0,0.0
1012,140,23-09-2019 16:18:00,1,3238.0,2292.0,0.708,15.297,123,27,12,15,96,50,46,0,0.0,0.0
1012,141,23-09-2019 16:20:00,1,3416.0,2507.0,0.734,16.236,200,64,30,34,136,83,53,0,0.0,0.0
1012,142,23-09-2019 16:22:00,1,3428.0,2421.0,0.706,16.187,153,51,19,32,102,54,48,0,0.0,0.0
1012,143,23-09-2019 16:24:00,1,3452.0,2373.0,0.687,16.227,105,5,1,4,100,44,56,0,0.0,0.0
1012,144,23-09-2019 16:26:00,1,3117.0,2288.0,0.734,14.816,53,0,0,0,53,6,47,0,0.0,0.0
1012,145,23-09-2019 16:28:00,1,3172.0,2157.0,0.68,14.885,41,0,0,0,41,0,41,0,0.0,0.0
1012,146,23-09-2019 16:30:00,1,2947.0,2019.0,0.685,13.847,52,2,1,1,50,2,48,0,0.0,0.0
1012,147,23-09-2019 16:32:00,1,2800.0,1904.0,0.6795,13.14,53,8,2,6,45,0,45,0,0.0,0.0
1012,148,23-09-2019 16:34:00,1,2653.0,1789.0,0.674,12.433,44,2,0,2,42,2,40,0,0.0,0.0
1012,149,23-09-2019 16:36:00,1,2653.0,1786.0,0.673,12.433,70,12,4,8,58,15,43,0,0.0,0.0
1012,150,23-09-2019 16:38:00,1,2962.0,1961.0,0.662,13.841,41,0,0,0,41,0,41,0,0.0,0.0
1012,151,23-09-2019 16:40:00,1,2752.0,1849.0,0.672,12.891,44,0,0,0,44,0,44,0,0.0,0.0
1012,152,23-09-2019 16:42:00,1,2633.0,1856.0,0.705,12.428,44,3,1,2,41,0,41,0,0.0,0.0
1012,153,23-09-2019 16:44:00,1,2640.0,1793.0,0.679,12.387,43,0,0,0,43,0,43,0,0.0,0.0
1012,154,23-09-2019 16:46:00,1,2650.0,1778.0,0.671,12.41,43,0,0,0,43,0,43,0,0.0,0.0
1012,155,23-09-2019 16:48:00,1,2672.0,1755.0,0.657,12.469,47,8,4,4,39,0,39,0,0.01,0.0
1012,156,23-09-2019 16:50:00,1,2644.0,1820.0,0.688,12.434,41,0,0,0,41,2,39,0,0.0,0.0
1012,157,23-09-2019 16:52:00,1,2657.0,1761.0,0.663,12.417,57,0,0,0,57,10,47,0,0.0,0.0
1012,158,23-09-2019 16:54:00,1,2461.0,1600.0,0.65,11.468,42,0,0,0,42,0,42,0,0.0,0.0
1012,159,23-09-2019 16:56:00,1,2347.0,1571.0,0.669,10.987,110,15,10,5,95,47,48,2,0.0,0.0
1012,160,23-09-2019 16:58:00,1,2357.0,1540.0,0.653,10.991,191,24,1,23,167,102,65,0,0.0,0.0
1012,161,23-09-2019 17:00:00,1,2366.0,1479.0,0.625,10.959,120,8,2,6,112,51,61,0,0.0,0.0
1012,162,23-09-2019 17:02:00,1,2454.0,1665.0,0.679,11.512,50,4,3,1,46,2,44,0,0.0,0.0
1012,163,23-09-2019 17:04:00,1,2673.0,1724.0,0.645,12.441,59,12,5,7,47,3,44,0,0.0,0.0
1012,164,23-09-2019 17:06:00,1,2611.5,1719.5,0.659,12.1935,62,16,0,16,46,0,46,0,0.0,0.0
1012,165,23-09-2019 17:08:00,1,2550.0,1715.0,0.673,11.946,44,1,0,1,43,0,43,0,0.0,0.0
1012,166,23-09-2019 17:10:00,1,2554.0,1700.0,0.666,11.945,50,0,0,0,50,0,50,0,0.0,0.0
1012,167,23-09-2019 17:12:00,1,2681.0,1681.0,0.627,12.426,44,6,0,6,38,0,38,0,0.0,0.0
1012,168,23-09-2019 17:14:00,1,2663.0,1698.0,0.638,12.372,39,1,0,1,38,0,38,0,0.0,0.0
1012,169,23-09-2019 17:16:00,1,2431.0,1675.0,0.689,11.432,47,8,2,6,39,0,39,0,0.0,0.0
1012,170,23-09-2019 17:18:00,1,2347.0,1574.0,0.671,10.99,56,8,2,6,48,0,48,0,0.0,0.0
1012,171,23-09-2019 17:20:00,1,2465.0,1587.0,0.644,11.47,45,2,0,2,43,0,43,0,0.0,0.0
1012,172,23-09-2019 17:22:00,1,2453.0,1587.0,0.647,11.422,54,6,2,4,48,0,48,0,0.0,0.0
1012,173,23-09-2019 17:24:00,1,2446.0,1683.0,0.688,11.501,66,19,10,9,47,4,43,0,0.0,0.0
1012,174,23-09-2019 17:26:00,1,2621.0,1835.0,0.7,12.361,188,49,16,33,139,78,61,0,0.0,0.0
1012,175,23-09-2019 17:28:00,1,3149.0,2199.0,0.698,14.843,369,138,99,39,231,174,57,69,0.0,0.0
1012,176,23-09-2019 17:30:00,1,3138.0,2202.0,0.702,14.804,276,85,59,26,191,139,52,74,0.0,0.0
1012,177,23-09-2019 17:32:00,1,3054.0,2107.0,0.69,14.366,201,31,15,16,170,107,63,0,0.0,0.0
1012,178,23-09-2019 17:34:00,1,3167.0,2138.0,0.675,14.846,194,33,9,24,161,109,52,0,0.0,0.0
1012,179,23-09-2019 17:36:00,1,3156.0,2135.0,0.677,14.8,251,86,52,34,165,116,49,28,0.0,0.0
1012,180,23-09-2019 17:38:00,1,3133.0,2184.0,0.697,14.765,164,41,20,21,123,66,57,0,0.0,0.0
1012,181,23-09-2019 17:40:00,1,3034.5,2129.5,0.702,14.316,187,121,67,54,66,21,45,0,0.0,0.0
1012,182,23-09-2019 17:42:00,1,2936.0,2075.0,0.707,13.867,102,52,26,26,50,0,50,0,0.0,0.0
1012,183,23-09-2019 17:44:00,1,2939.0,2080.0,0.708,13.884,183,49,18,31,134,78,56,0,0.0,0.0
1012,184,23-09-2019 17:46:00,1,3151.0,2123.0,0.674,14.767,201,54,19,35,147,81,66,0,0.0,0.0
1012,185,23-09-2019 17:48:00,1,3151.0,2122.0,0.674,14.764,236,70,44,26,166,110,56,7,0.0,0.0
1012,186,23-09-2019 17:50:00,1,3718.0,2733.0,0.735,17.674,262,112,74,38,150,101,49,39,0.0,0.0
1012,187,23-09-2019 17:52:00,1,3347.0,2335.0,0.698,15.774,283,124,89,35,159,131,28,66,0.0,0.0
1012,188,23-09-2019 17:54:00,1,3047.0,2167.0,0.711,14.404,38,1,0,1,37,33,4,0,0.0,0.0
1012,189,23-09-2019 17:56:00,1,2732.0,1946.0,0.712,12.919,6,0,0,0,6,6,0,0,0.0,0.0
1012,190,23-09-2019 17:58:00,1,2638.0,1805.0,0.684,12.393,4,0,0,0,4,4,0,0,0.0,0.0
1012,191,23-09-2019 18:00:00,0,2670.0,1739.0,0.651,12.448,1,1,1,0,0,0,0,0,0.0,0.0
1012,192,23-09-2019 18:02:00,0,2442.0,1685.0,0.69,11.488,3,0,0,0,3,2,1,0,0.0,0.0
1012,193,23-09-2019 18:04:00,0,2443.0,1680.0,0.688,11.485,18,15,0,15,3,3,0,0,0.0,0.0
1012,194,23-09-2019 18:06:00,0,2451.0,1607.0,0.656,11.436,22,15,0,15,7,6,1,0,0.0,0.0
1012,195,23-09-2019 18:08:00,0,2343.0,1554.0,0.663,10.953,2,2,0,2,0,0,0,0,0.0,0.0
1012,196,23-09-2019 18:10:00,0,2235.0,1578.0,0.706,10.555,5,3,0,3,2,2,0,0,0.0,0.0
1012,197,23-09-2019 18:12:00,0,2246.0,1509.0,0.672,10.522,9,0,0,0,9,9,0,0,0.0,0.0
1012,198,23-09-2019 18:14:00,0,2348.0,1580.0,0.673,11.001,3,3,0,3,0,0,0,0,0.0,0.0
1012,199,23-09-2019 18:16:00,0,2450.0,1651.0,0.674,11.48,0,0,0,0,0,0,0,0,0.0,0.0
1012,200,23-09-2019 18:18:00,0,2344.0,1565.0,0.668,10.968,5,5,1,4,0,0,0,0,0.0,0.0
1012,201,23-09-2019 18:20:00,0,2236.0,1525.0,0.682,10.497,76,9,0,9,67,61,6,0,0.0,0.0
1012,202,23-09-2019 18:22:00,0,2252.0,1505.0,0.668,10.54,108,3,0,3,105,97,8,0,0.0,0.0
1012,203,23-09-2019 18:24:00,0,2241.0,1521.0,0.678,10.515,16,2,0,2,14,11,3,0,0.0,0.0
1012,204,23-09-2019 18:26:00,0,2246.0,1496.0,0.666,10.506,256,57,35,22,199,186,13,2,0.0,0.0
1012,205,23-09-2019 18:28:00,0,3446.0,2359.0,0.685,16.191,517,146,115,31,371,329,42,87,0.0,0.0
1012,206,23-09-2019 18:30:00,0,3818.0,2876.0,0.753,18.228,474,176,128,48,298,274,24,123,0.0,0.0
1012,207,23-09-2019 18:32:00,0,3878.0,2652.0,0.684,18.218,313,62,40,22,251,245,6,71,0.0,0.0
1012,208,23-09-2019 18:34:00,0,3815.0,2808.0,0.736,18.141,280,86,53,33,194,187,7,74,0.0,0.0
1012,209,23-09-2019 18:36:00,0,4135.0,2982.0,0.721,19.593,697,280,226,54,417,368,49,123,0.0,0.0
1012,210,23-09-2019 18:38:00,0,3932.0,2818.0,0.717,18.614,432,142,96,46,290,264,26,75,0.01,0.0
1012,211,23-09-2019 18:40:00,0,4106.0,3049.0,0.743,19.554,267,99,69,30,168,137,31,15,0.0,0.0
1012,212,23-09-2019 18:42:00,0,3127.0,2290.0,0.732,14.855,341,156,122,34,185,125,60,100,0.0,0.0
1012,213,23-09-2019 18:44:00,0,4104.0,3076.0,0.75,19.575,503,241,196,45,262,209,53,261,0.0,0.0
1012,214,23-09-2019 18:46:00,0,4091.0,3160.0,0.773,19.618,454,197,146,51,257,183,74,110,0.0,0.0
1012,215,23-09-2019 18:48:00,0,3786.5,2904.0,0.7665,18.135,352,144,107,37,208,149,59,30,0.0,0.0
1012,216,23-09-2019 18:50:00,0,3482.0,2648.0,0.76,16.652,323,147,114,33,176,133,43,164,0.0,0.0
1012,217,23-09-2019 18:52:00,0,3692.0,2878.0,0.78,17.732,430,174,138,36,256,205,51,171,0.0,0.0
1012,218,23-09-2019 18:54:00,0,4599.0,3540.0,0.77,22.039,336,83,55,28,253,192,61,67,0.0,0.0
1012,219,23-09-2019 18:56:00,0,4180.0,3285.0,0.786,20.105,342,139,113,26,203,159,44,184,0.0,0.01
1012,220,23-09-2019 18:58:00,0,3414.0,2549.0,0.747,16.272,245,60,39,21,185,125,60,21,0.0,0.0
1012,221,23-09-2019 19:00:00,0,2889.0,2257.0,0.782,13.88,537,200,146,54,337,267,70,48,0.0,0.0
1012,222,23-09-2019 19:02:00,0,4871.0,3838.0,0.788,23.442,546,271,199,72,275,213,62,162,0.0,0.0
1012,223,23-09-2019 19:04:00,0,3792.0,2927.0,0.772,18.182,251,121,91,30,130,92,38,98,0.0,0.0
1012,224,23-09-2019 19:06:00,0,3763.0,3002.0,0.798,18.15,353,162,113,49,191,147,44,12,0.04,0.04
1012,225,23-09-2019 19:08:00,0,3844.0,3163.0,0.823,18.646,467,203,161,42,264,213,51,185,0.0,0.0
1012,226,23-09-2019 19:10:00,0,3376.0,2617.0,0.775,16.198,457,168,125,43,289,211,78,69,0.0,0.0
1012,227,23-09-2019 19:12:00,0,4263.0,3521.0,0.826,20.694,439,164,120,44,275,207,68,107,0.0,0.0
1012,228,23-09-2019 19:14:00,0,3291.0,2534.0,0.77,15.774,388,126,83,43,262,198,64,15,0.0,0.0
1012,229,23-09-2019 19:16:00,0,3396.0,2531.0,0.745,16.182,455,215,165,50,240,177,63,100,0.06,0.0
1012,230,23-09-2019 19:18:00,0,4350.0,3525.0,0.81,21.043,341,102,68,34,239,183,56,121,0.0,0.0
1012,231,23-09-2019 19:20:00,0,4764.0,3871.0,0.813,23.055,295,92,57,35,203,137,66,72,0.0,0.0
1012,232,23-09-2019 19:22:00,0,4326.0,3486.0,0.805,20.904,209,77,50,27,132,76,56,31,0.0,0.0
1012,233,23-09-2019 19:24:00,0,3888.0,3101.0,0.797,18.753,205,62,29,33,143,95,48,26,0.0,0.0
1012,234,23-09-2019 19:26:00,0,2996.0,2243.0,0.749,14.288,339,104,69,35,235,176,59,113,0.0,0.0
1012,235,23-09-2019 19:28:00,0,4579.0,3639.0,0.795,22.071,299,117,78,39,182,124,58,58,0.0,0.0
1012,236,23-09-2019 19:30:00,0,4776.0,3749.0,0.785,22.97,285,57,36,21,228,163,65,64,0.0,0.0
1012,237,23-09-2019 19:32:00,0,4963.0,3869.0,0.78,23.84,196,63,35,28,133,84,49,49,0.0,0.03
1012,238,23-09-2019 19:34:00,0,4780.0,3672.0,0.768,22.897,328,65,40,25,263,185,78,63,0.0,0.0
1012,239,23-09-2019 19:36:00,0,4591.0,3603.0,0.785,22.08,161,51,22,29,110,57,53,16,0.0,0.0
1012,240,23-09-2019 19:38:00,0,3792.0,2968.0,0.783,18.226,164,42,20,22,122,71,51,1,0.0,0.0
1012,241,23-09-2019 19:40:00,0,4073.0,3180.0,0.781,19.57,505,151,111,40,354,276,78,74,0.0,0.0
1012,242,23-09-2019 19:42:00,0,3787.0,2999.0,0.792,18.24,402,164,131,33,238,186,52,113,0.0,0.0
1012,243,23-09-2019 19:44:00,0,3607.0,2755.0,0.764,17.261,226,84,65,19,142,87,55,27,0.0,0.0
1012,244,23-09-2019 19:46:00,0,3785.0,2907.0,0.768,18.131,380,133,100,33,247,179,68,98,0.0,0.0
1012,245,23-09-2019 19:48:00,0,4282.0,3365.0,0.786,20.598,282,71,57,14,211,156,55,3,0.0,0.01
1012,246,23-09-2019 19:50:00,0,3766.0,3062.0,0.813,18.227,419,106,67,39,313,244,69,13,0.0,0.0
1012,247,23-09-2019 19:52:00,0,3107.0,2258.0,0.727,14.743,449,130,84,46,319,242,77,10,0.0,0.0
1012,248,23-09-2019 19:54:00,0,2918.0,2134.0,0.731,13.862,406,147,99,48,259,188,71,25,0.0,0.0
1012,249,23-09-2019 19:56:00,0,3463.5,2588.5,0.745,16.513,621,236,190,46,385,313,72,139,0.0,0.0
1012,250,23-09-2019 19:58:00,0,4009.0,3043.0,0.759,19.164,485,140,99,41,345,321,24,72,0.0,0.0
1012,251,23-09-2019 20:00:00,0,4778.0,3780.0,0.791,23.012,247,30,4,26,217,198,19,35,0.0,0.0
1012,252,23-09-2019 20:02:00,0,4800.0,3697.0,0.77,23.005,410,65,29,36,345,316,29,52,0.0,0.0
1012,253,23-09-2019 20:04:00,0,4695.0,3620.0,0.771,22.509,351,44,17,27,307,285,22,51,0.0,0.01
1012,254,23-09-2019 20:06:00,0,4170.0,3322.0,0.797,20.106,359,100,64,36,259,239,20,8,0.0,0.0
1012,255,23-09-2019 20:08:00,0,3407.0,2559.0,0.751,16.259,474,183,127,56,291,248,43,24,0.0,0.0
1012,256,23-09-2019 20:10:00,0,4674.0,3743.0,0.801,22.561,511,191,141,50,320,281,39,89,0.0,0.03
1012,257,23-09-2019 20:12:00,0,3983.0,3094.0,0.777,19.118,390,136,104,32,254,227,27,140,0.0,0.0
1012,258,23-09-2019 20:14:00,0,3583.0,2778.0,0.775,17.193,394,142,105,37,252,225,27,88,0.0,0.0
1012,259,23-09-2019 20:16:00,0,3606.0,2748.0,0.762,17.249,345,31,9,22,314,284,30,7,0.0,0.0
1012,260,23-09-2019 20:18:00,0,3108.0,2390.0,0.769,14.891,393,125,86,39,268,248,20,27,0.0,0.0
1012,261,23-09-2019 20:20:00,0,3972.0,3130.0,0.788,19.113,672,246,183,63,426,379,47,90,0.0,0.0
1012,262,23-09-2019 20:22:00,0,4739.0,3849.0,0.812,22.932,306,95,56,39,211,187,24,41,0.0,0.0
1012,263,23-09-2019 20:24:00,0,4781.0,3698.0,0.773,22.934,560,98,57,41,462,426,36,63,0.0,0.0
1012,264,23-09-2019 20:26:00,0,4742.0,3804.0,0.802,22.894,187,50,18,32,137,125,12,21,0.0,0.0
1012,265,23-09-2019 20:28:00,0,3614.0,2769.0,0.766,17.304,340,119,72,47,221,203,18,34,0.0,0.0
1012,266,23-09-2019 20:30:00,0,3644.0,2806.0,0.77,17.463,554,156,107,49,398,366,32,106,0.0,0.0
1012,267,23-09-2019 20:32:00,0,3674.0,2843.0,0.774,17.622,467,201,162,39,266,223,43,164,0.0,0.0
1012,268,23-09-2019 20:34:00,0,4291.0,3348.0,0.78,20.614,399,113,72,41,286,254,32,84,0.0,0.01
1012,269,23-09-2019 20:36:00,0,4377.0,3521.0,0.804,21.144,534,80,52,28,454,428,26,63,0.0,0.0
1012,270,23-09-2019 20:38:00,0,4525.0,3696.0,0.817,21.922,516,77,46,31,439,411,28,66,0.0,0.0
1012,271,23-09-2019 20:40:00,0,4780.0,3744.0,0.783,22.98,434,92,57,35,342,323,19,32,0.0,0.03
1012,272,23-09-2019 20:42:00,0,3581.0,2856.0,0.798,17.271,322,84,36,48,238,213,25,18,0.0,0.0
1012,273,23-09-2019 20:44:00,0,3289.0,2547.0,0.774,15.777,427,158,122,36,269,233,36,111,0.0,0.0
1012,274,23-09-2019 20:46:00,0,4377.0,3518.0,0.804,21.139,582,139,105,34,443,397,46,107,0.0,0.01
1012,275,23-09-2019 20:48:00,0,3751.0,2994.0,0.798,18.092,433,68,37,31,365,328,37,82,0.0,0.0
1012,276,23-09-2019 20:50:00,0,4726.0,3902.0,0.826,22.941,504,85,45,40,419,375,44,68,0.0,0.02
1012,277,23-09-2019 20:52:00,0,4726.0,3909.0,0.827,22.948,369,54,33,21,315,283,32,27,0.0,0.03
1012,278,23-09-2019 20:54:00,0,4268.0,3364.0,0.788,20.542,594,204,147,57,390,340,50,50,0.0,0.01
1012,279,23-09-2019 20:56:00,0,3735.0,3116.0,0.834,18.166,556,189,148,41,367,311,56,136,0.0,0.0
1012,280,23-09-2019 20:58:00,0,3352.0,2759.0,0.823,16.26,375,106,82,24,269,225,44,31,0.0,0.01
1012,281,23-09-2019 21:00:00,0,3560.0,2966.0,0.833,17.311,427,42,18,24,385,327,58,8,0.0,0.0
1012,282,23-09-2019 21:02:00,0,3376.0,2678.0,0.793,16.267,294,45,20,25,249,206,43,12,0.0,0.0
1012,283,23-09-2019 21:04:00,0,3724.5,2978.0,0.799,17.973,332,76,47,29,256,219,37,47,0.0,0.0
1012,284,23-09-2019 21:06:00,0,4073.0,3278.0,0.805,19.679,375,126,93,33,249,199,50,134,0.0,0.0
1012,285,23-09-2019 21:08:00,0,4748.0,3872.0,0.816,22.992,526,195,154,41,331,269,62,103,0.0,0.0
1012,286,23-09-2019 21:10:00,0,4149.0,3387.0,0.816,20.099,488,59,32,27,429,366,63,59,0.0,0.0
1012,287,23-09-2019 21:12:00,0,4931.0,4155.0,0.843,24.028,414,47,19,28,367,317,50,55,0.0,0.0
1012,288,23-09-2019 21:14:00,0,4780.0,4028.0,0.843,23.293,399,52,25,27,347,279,68,51,0.01,0.03
1012,289,23-09-2019 21:16:00,0,4712.0,3956.0,0.84,22.946,513,82,44,38,431,358,73,63,0.0,0.02
1012,290,23-09-2019 21:18:00,0,4676.0,4073.0,0.871,22.934,33,4,1,3,29,25,4,1,0.0,0.02
1012,291,23-09-2019 21:20:00,0,4743.0,3904.0,0.823,23.009,346,40,28,12,306,255,51,5,0.0,0.0
1012,292,23-09-2019 21:22:00,0,3712.0,3197.0,0.861,18.166,320,72,41,31,248,199,49,18,0.0,0.0
1012,293,23-09-2019 21:24:00,0,3329.0,2805.0,0.842,16.222,488,146,95,51,342,277,65,70,0.1,0.0
1012,294,23-09-2019 21:26:00,0,4535.0,3787.0,0.835,22.06,418,179,145,34,239,195,44,155,0.0,0.06
1012,295,23-09-2019 21:28:00,0,3559.0,2915.0,0.819,17.249,238,103,75,28,135,98,37,50,0.0,0.0
1012,296,23-09-2019 21:30:00,0,3654.0,3028.0,0.829,17.75,299,119,83,36,180,131,49,73,0.0,0.0
1012,297,23-09-2019 21:32:00,0,4676.0,4024.0,0.861,22.878,300,139,100,39,161,123,38,52,0.06,0.0
1012,298,23-09-2019 21:34:00,0,4519.0,3779.0,0.836,21.988,281,89,54,35,192,122,70,67,0.0,0.0
1012,299,23-09-2019 21:36:00,0,4692.0,4073.0,0.868,22.998,215,69,44,25,146,77,69,61,0.0,0.03
1012,300,23-09-2019 21:38:00,0,4712.5,3985.5,0.846,22.9815,216,63,28,35,153,88,65,54,0.0,0.04
1012,301,23-09-2019 21:40:00,0,4733.0,3898.0,0.824,22.965,200,58,26,32,142,85,57,60,0.0,0.0
1012,302,23-09-2019 21:42:00,0,4650.0,4186.0,0.9,22.957,264,59,25,34,205,136,69,39,0.0,0.02
1012,303,23-09-2019 21:44:00,0,4503.0,3911.0,0.868,22.073,136,34,27,7,102,63,39,5,0.02,0.0
1012,304,23-09-2019 21:46:00,0,3746.0,3070.0,0.819,18.159,190,78,57,21,112,80,32,33,0.0,0.0
1012,305,23-09-2019 21:48:00,0,3802.0,3343.0,0.879,18.682,452,232,178,54,220,170,50,101,0.03,0.01
1012,306,23-09-2019 21:50:00,0,3527.0,3015.0,0.855,17.235,352,156,116,40,196,145,51,16,0.04,0.04
1012,307,23-09-2019 21:52:00,0,3905.0,3355.0,0.859,19.1,91,34,24,10,57,39,18,5,0.0,0.0
1012,308,23-09-2019 21:54:00,0,3292.0,2990.0,0.908,16.281,186,94,56,38,92,59,33,51,0.0,0.0
1012,309,23-09-2019 21:56:00,0,3327.0,2934.0,0.882,16.356,130,64,41,23,66,36,30,78,0.0,0.0
1012,310,23-09-2019 21:58:00,0,4398.0,3758.0,0.855,21.488,185,76,50,26,109,56,53,64,0.0,0.0
1012,311,23-09-2019 22:00:00,0,4652.0,4175.0,0.897,22.953,227,59,38,21,168,99,69,40,0.02,0.03
1012,312,23-09-2019 22:02:00,0,4647.0,4185.0,0.901,22.941,213,59,38,21,154,87,67,40,0.0,0.03
1012,313,23-09-2019 22:04:00,0,4644.0,4237.0,0.912,22.988,192,23,10,13,169,72,97,22,0.0,0.12
1012,314,23-09-2019 22:06:00,0,4687.0,4091.0,0.873,22.997,221,66,50,16,155,87,68,14,0.06,0.07
1012,315,23-09-2019 22:08:00,0,3992.0,3512.0,0.88,19.617,193,83,58,25,110,75,35,3,0.08,0.0
1012,316,23-09-2019 22:10:00,0,4595.0,4020.0,0.875,22.555,283,111,82,29,172,132,40,107,0.04,0.22
1012,317,23-09-2019 22:12:00,0,4099.5,3621.5,0.8845,20.162,414,208,168,40,206,162,44,174,0.0,0.0
1012,318,23-09-2019 22:14:00,0,3604.0,3223.0,0.894,17.769,401,209,152,57,192,146,46,89,0.04,0.0
1012,319,23-09-2019 22:16:00,0,3998.0,3474.0,0.869,19.601,337,154,116,38,183,129,54,91,0.0,0.0
1012,320,23-09-2019 22:18:00,0,3797.0,3440.0,0.906,18.769,142,63,48,15,79,56,23,4,0.0,0.0
1012,321,23-09-2019 22:20:00,0,3587.0,3134.0,0.874,17.602,292,125,90,35,167,132,35,76,0.18,0.0
1012,322,23-09-2019 22:22:00,0,4664.0,4295.0,0.921,23.132,340,168,122,46,172,130,42,21,0.0,0.0
1012,323,23-09-2019 22:24:00,0,3615.0,3150.0,0.872,17.73,129,43,28,15,86,45,41,0,0.0,0.0
1012,324,23-09-2019 22:26:00,0,3526.0,3027.0,0.859,17.243,135,98,49,49,37,14,23,0,0.0,0.0
1012,325,23-09-2019 22:28:00,0,3333.0,2846.0,0.854,16.282,77,46,14,32,31,12,19,1,0.0,0.0
1012,326,23-09-2019 22:30:00,0,3453.0,2808.0,0.813,16.715,150,60,29,31,90,52,38,0,0.0,0.0
1012,327,23-09-2019 22:32:00,0,3687.0,3243.0,0.88,18.116,34,9,3,6,25,12,13,0,0.0,0.0
1012,328,23-09-2019 22:34:00,0,3301.0,2898.0,0.878,16.216,30,18,0,18,12,0,12,0,0.0,0.0
1012,329,23-09-2019 22:36:00,0,3317.0,2914.0,0.878,16.297,22,7,4,3,15,0,15,0,0.0,0.0
1012,330,23-09-2019 22:38:00,0,3337.0,2855.0,0.856,16.308,17,6,3,3,11,0,11,0,0.0,0.0
1012,331,23-09-2019 22:40:00,0,3336.0,2871.0,0.861,16.323,32,20,3,17,12,0,12,0,0.0,0.0
1012,332,23-09-2019 22:42:00,0,3305.0,2841.0,0.86,16.168,51,29,16,13,22,10,12,0,0.0,0.0
1012,333,23-09-2019 22:44:00,0,3015.0,2749.0,0.912,14.923,31,10,3,7,21,8,13,0,0.0,0.0
1012,334,23-09-2019 22:46:00,0,3165.0,2843.0,0.899,15.617,43,18,12,6,25,12,13,0,0.0,0.0
1012,335,23-09-2019 22:48:00,0,3315.0,2937.0,0.886,16.311,8,0,0,0,8,0,8,0,0.0,0.0
1012,336,23-09-2019 22:50:00,0,3321.0,2904.0,0.874,16.301,42,16,6,10,26,6,20,0,0.0,0.0
1012,337,23-09-2019 22:52:00,0,2982.0,2754.0,0.924,14.799,15,1,0,1,14,0,14,0,0.0,0.0
1012,338,23-09-2019 22:54:00,0,3026.0,2637.0,0.871,14.843,13,1,0,1,12,2,10,0,0.0,0.0
1012,339,23-09-2019 22:56:00,0,3049.0,2591.0,0.85,14.882,13,2,0,2,11,0,11,0,0.0,0.0
1012,340,23-09-2019 22:58:00,0,3012.0,2724.0,0.904,14.883,138,49,39,10,89,50,39,16,0.0,0.0
1012,341,23-09-2019 23:00:00,0,3587.0,3268.0,0.911,17.75,110,39,22,17,71,30,41,32,0.0,0.09
1012,342,23-09-2019 23:02:00,0,3604.0,3602.0,0.999,18.187,67,0,0,0,67,31,36,0,0.0,0.01
1012,343,23-09-2019 23:04:00,0,3749.0,3564.0,0.951,18.716,54,0,0,0,54,26,28,0,0.0,0.01
1012,344,23-09-2019 23:06:00,0,3723.0,3590.0,0.965,18.642,52,0,0,0,52,19,33,0,0.0,0.0
1012,345,23-09-2019 23:08:00,0,3843.0,3722.0,0.968,19.262,185,97,78,19,88,59,29,30,0.0,0.0
1012,346,23-09-2019 23:10:00,0,3609.0,3588.0,0.994,18.192,407,173,136,37,234,179,55,89,0.0,0.0
1012,347,23-09-2019 23:12:00,0,3640.0,3439.0,0.945,18.147,413,209,170,39,204,152,52,110,0.0,0.0
1012,348,23-09-2019 23:14:00,0,4025.0,3851.0,0.957,20.122,412,209,163,46,203,152,51,72,0.06,0.0
1012,349,23-09-2019 23:16:00,0,3916.0,3817.0,0.975,19.652,347,154,111,43,193,151,42,63,0.0,0.0
1012,350,23-09-2019 23:18:00,0,2979.0,2854.0,0.958,14.896,226,105,67,38,121,80,41,0,0.0,0.0
1012,351,23-09-2019 23:20:00,0,3598.0,3441.0,0.9565,17.9855,290,137,104,33,153,119,34,91,0.04,0.0
1012,352,23-09-2019 23:22:00,0,4217.0,4028.0,0.955,21.075,385,182,136,46,203,158,45,33,0.06,0.03
1012,353,23-09-2019 23:24:00,0,4044.0,3823.0,0.945,20.164,351,195,156,39,156,110,46,152,0.0,0.0
1012,354,23-09-2019 23:26:00,0,3739.0,3513.0,0.939,18.622,311,138,112,26,173,120,53,101,0.0,0.0
1012,355,23-09-2019 23:28:00,0,3950.0,3670.0,0.929,19.627,262,91,61,30,171,123,48,28,0.0,0.0
1012,356,23-09-2019 23:30:00,0,3644.0,3459.0,0.949,18.186,206,80,60,20,126,78,48,37,0.0,0.0
1012,357,23-09-2019 23:32:00,0,3648.0,3488.0,0.956,18.233,316,151,108,43,165,122,43,119,0.0,0.0
1012,358,23-09-2019 23:34:00,0,4182.0,3795.0,0.907,20.681,283,121,91,30,162,125,37,32,0.01,0.0
1012,359,23-09-2019 23:36:00,0,4100.0,3898.0,0.951,20.47,280,131,97,34,149,107,42,55,0.0,0.0
1012,360,23-09-2019 23:38:00,0,3392.0,3121.0,0.92,16.82,253,126,88,38,127,70,57,71,0.0,0.0
1012,361,23-09-2019 23:40:00,0,4124.0,3970.0,0.963,20.641,270,119,76,43,151,101,50,79,0.0,0.02
1012,362,23-09-2019 23:42:00,0,4367.0,3978.0,0.911,21.612,320,96,62,34,224,188,36,63,0.0,0.0
1012,363,23-09-2019 23:44:00,0,4443.0,4116.0,0.926,22.062,444,86,53,33,358,340,18,59,0.0,0.0
1012,364,23-09-2019 23:46:00,0,3657.0,3469.0,0.949,18.248,269,109,80,29,160,138,22,52,0.0,0.0
1012,365,23-09-2019 23:48:00,0,3451.0,3240.0,0.939,17.184,215,83,51,32,132,77,55,28,0.03,0.0
1012,366,23-09-2019 23:50:00,0,4345.0,4070.0,0.937,21.625,230,65,39,26,165,96,69,51,0.0,0.01
1012,367,23-09-2019 23:52:00,0,4118.0,4002.0,0.972,20.654,406,148,116,32,258,192,66,19,0.0,0.0
1012,368,23-09-2019 23:54:00,0,3554.5,3377.5,0.946,17.743,231,115,65,50,116,65,51,1,0.0,0.0
1012,369,23-09-2019 23:56:00,0,2991.0,2753.0,0.92,14.832,161,59,27,32,102,46,56,0,0.0,0.0
1012,370,23-09-2019 23:58:00,0,3219.0,2766.0,0.859,15.743,169,49,24,25,120,79,41,0,0.0,0.01
1012,371,24-09-2019 00:00:00,0,3309.0,2949.0,0.891,16.302,289,118,83,35,171,120,51,22,0.03,0.01
1012,372,24-09-2019 00:02:00,0,4463.0,4086.0,0.916,22.107,215,83,53,30,132,80,52,48,0.0,0.0
1012,373,24-09-2019 00:04:00,0,4631.0,4373.0,0.944,23.088,238,75,34,41,163,95,68,61,0.01,0.02
1012,374,24-09-2019 00:06:00,0,4629.0,4213.0,0.91,22.903,219,60,31,29,159,105,54,51,0.01,0.02
1012,375,24-09-2019 00:08:00,0,4414.0,4219.0,0.956,22.063,108,11,3,8,97,45,52,1,0.1,0.04
1012,376,24-09-2019 00:10:00,0,3644.0,3487.0,0.957,18.216,44,1,0,1,43,4,39,0,0.0,0.0
1012,377,24-09-2019 00:12:00,0,3705.0,3302.0,0.891,18.254,156,40,31,9,116,59,57,0,0.0,0.01
1012,378,24-09-2019 00:14:00,0,3003.0,2756.0,0.918,14.881,295,0,0,0,295,259,36,0,0.0,0.0
1012,379,24-09-2019 00:16:00,0,2843.0,2442.0,0.859,13.907,430,0,0,0,430,394,36,0,0.0,0.0
1012,380,24-09-2019 00:18:00,0,2541.0,2199.0,0.866,12.444,69,1,0,1,68,28,40,0,0.0,0.0
1012,381,24-09-2019 00:20:00,0,2566.0,2150.0,0.838,12.489,159,28,18,10,131,82,49,0,0.0,0.0
1012,382,24-09-2019 00:22:00,0,2557.0,2163.0,0.846,12.469,45,0,0,0,45,0,45,0,0.0,0.0
1012,383,24-09-2019 00:24:00,0,2558.0,2140.0,0.837,12.45,39,0,0,0,39,2,37,0,0.0,0.0
1012,384,24-09-2019 00:26:00,0,2354.0,2048.0,0.87,11.542,46,0,0,0,46,0,46,0,0.0,0.0
1012,385,24-09-2019 00:28:00,0,2362.5,2022.0,0.856,11.5465,32,1,1,0,31,0,31,0,0.0,0.0
1012,386,24-09-2019 00:30:00,0,2371.0,1996.0,0.842,11.551,85,6,3,3,79,29,50,0,0.0,0.0
1012,387,24-09-2019 00:32:00,0,2330.0,2044.0,0.877,11.443,83,9,3,6,74,35,39,0,0.0,0.0
1012,388,24-09-2019 00:34:00,0,2447.0,2126.0,0.869,11.994,38,0,0,0,38,0,38,0,0.0,0.0
1012,389,24-09-2019 00:36:00,0,2562.0,2114.0,0.825,12.436,191,13,3,10,178,143,35,0,0.0,0.0
1012,390,24-09-2019 00:38:00,0,2546.0,2229.0,0.876,12.5,10,4,3,1,6,6,0,0,0.0,0.01
1012,391,24-09-2019 00:40:00,0,2538.0,2190.0,0.863,12.422,4,4,1,3,0,0,0,0,0.0,0.0
1012,392,24-09-2019 00:42:00,0,2547.0,2212.0,0.868,12.486,276,15,8,7,261,240,21,0,0.0,0.0
1012,393,24-09-2019 00:44:00,0,3023.0,2627.0,0.869,14.82,24,18,7,11,6,5,1,0,0.0,0.0
1012,394,24-09-2019 00:46:00,0,2814.0,2515.0,0.894,13.872,1,1,1,0,0,0,0,0,0.0,0.0
1012,395,24-09-2019 00:48:00,0,2848.0,2394.0,0.841,13.873,0,0,0,0,0,0,0,0,0.0,0.0
1012,396,24-09-2019 00:50:00,0,2819.0,2574.0,0.913,13.958,0,0,0,0,0,0,0,0,0.0,0.0
1012,397,24-09-2019 00:52:00,0,3041.0,2589.0,0.851,14.849,158,62,45,17,96,89,7,6,0.0,0.0
1012,398,24-09-2019 00:54:00,0,3549.0,3373.0,0.95,17.715,418,85,65,20,333,303,30,22,0.0,0.0
1012,399,24-09-2019 00:56:00,0,3937.0,3799.0,0.965,19.718,302,17,4,13,285,268,17,15,0.0,0.06
1012,400,24-09-2019 00:58:00,0,3926.0,3685.0,0.939,19.549,361,11,2,9,350,316,34,11,0.0,0.03
1012,401,24-09-2019 01:00:00,0,4015.0,3841.0,0.957,20.071,515,95,66,29,420,366,54,97,0.0,0.01
1012,402,24-09-2019 01:02:00,0,4066.0,3892.5,0.9575,20.329,539,105,72,33,434,365,69,31,0.0,0.0
1012,403,24-09-2019 01:04:00,0,4117.0,3944.0,0.958,20.587,447,148,101,47,299,228,71,48,0.03,0.0
1012,404,24-09-2019 01:06:00,0,3666.0,3437.0,0.937,18.25,312,137,105,32,175,131,44,78,0.0,0.01
1012,405,24-09-2019 01:08:00,0,4203.0,4042.0,0.962,21.036,396,174,124,50,222,159,63,83,0.02,0.0
1012,406,24-09-2019 01:10:00,0,4132.0,3945.0,0.955,20.647,178,29,12,17,149,91,58,50,0.0,0.02
1012,407,24-09-2019 01:12:00,0,4166.0,3833.0,0.92,20.66,248,129,88,41,119,85,34,88,0.04,0.01
1012,408,24-09-2019 01:14:00,0,3932.0,3714.0,0.945,19.602,256,120,77,43,136,108,28,54,0.06,0.0
1012,409,24-09-2019 01:16:00,0,3930.0,3754.0,0.955,19.641,370,158,122,36,212,161,51,50,0.0,0.0
1012,410,24-09-2019 01:18:00,0,3754.0,3502.0,0.933,18.667,253,122,89,33,131,106,25,98,0.06,0.02
1012,411,24-09-2019 01:20:00,0,3959.0,3633.0,0.918,19.619,165,63,41,22,102,63,39,19,0.0,0.0
1012,412,24-09-2019 01:22:00,0,3284.0,3011.0,0.917,16.274,86,20,9,11,66,38,28,0,0.0,0.0
1012,413,24-09-2019 01:24:00,0,3883.0,3508.0,0.904,19.181,234,97,71,26,137,105,32,72,0.0,0.0
1012,414,24-09-2019 01:26:00,0,4124.0,3864.0,0.937,20.525,216,37,13,24,179,124,55,46,0.0,0.0
1012,415,24-09-2019 01:28:00,0,4438.0,4128.0,0.93,22.055,208,37,8,29,171,105,66,27,0.0,0.02
1012,416,24-09-2019 01:30:00,0,4526.0,4201.0,0.928,22.484,217,31,8,23,186,103,83,38,0.0,0.06
1012,417,24-09-2019 01:32:00,0,4361.0,3953.0,0.907,21.558,341,142,107,35,199,142,57,23,0.07,0.02
1012,418,24-09-2019 01:34:00,0,4122.0,4041.0,0.98,20.714,243,118,82,36,125,81,44,47,0.03,0.01
1012,419,24-09-2019 01:36:00,0,3523.5,3311.5,0.9315,17.5485,221,72,36,36,149,99,50,14,0.0,0.0
1012,420,24-09-2019 01:38:00,0,2925.0,2582.0,0.883,14.383,224,74,32,42,150,99,51,3,0.0,0.0
1012,421,24-09-2019 01:40:00,0,3028.0,2659.0,0.878,14.874,132,24,2,22,108,64,44,0,0.0,0.0
1012,422,24-09-2019 01:42:00,0,2774.0,2615.0,0.943,13.822,188,86,45,41,102,59,43,0,0.0,0.0
1012,423,24-09-2019 01:44:00,0,2872.0,2352.0,0.819,13.919,62,17,8,9,45,20,25,0,0.0,0.0
1012,424,24-09-2019 01:46:00,0,3041.0,2553.0,0.84,14.807,100,0,0,0,100,85,15,0,0.0,0.0
1012,425,24-09-2019 01:48:00,0,3035.0,2609.0,0.86,14.844,32,0,0,0,32,8,24,0,0.0,0.0
1012,426,24-09-2019 01:50:00,0,3499.0,3085.0,0.882,17.201,538,266,199,67,272,204,68,9,0.0,0.03
1012,427,24-09-2019 01:52:00,0,4153.0,3906.0,0.941,20.687,563,231,175,56,332,264,68,122,0.0,0.0
1012,428,24-09-2019 01:54:00,0,3673.0,3381.0,0.921,18.213,411,208,142,66,203,144,59,5,0.0,0.0
1012,429,24-09-2019 01:56:00,0,3691.0,3371.0,0.913,18.273,498,231,177,54,267,205,62,43,0.01,0.0
1012,430,24-09-2019 01:58:00,0,3624.0,3410.0,0.941,18.055,24,5,1,4,19,1,18,0,0.0,0.0
1012,431,24-09-2019 02:00:00,0,3704.0,3335.0,0.9,18.288,55,6,2,4,49,26,23,0,0.0,0.0
1012,432,24-09-2019 02:02:00,0,3465.0,3282.0,0.947,17.283,95,19,4,15,76,42,34,16,0.0,0.0
1012,433,24-09-2019 02:04:00,0,3975.0,3607.0,0.908,19.654,97,16,0,16,81,42,39,14,0.0,0.0
1012,434,24-09-2019 02:06:00,0,3957.0,3587.0,0.907,19.561,54,26,0,26,28,7,21,33,0.0,0.0
1012,435,24-09-2019 02:08:00,0,3885.0,3504.0,0.902,19.188,95,26,0,26,69,36,33,16,0.0,0.0
1012,436,24-09-2019 02:10:00,0,3787.5,3392.0,0.8955,18.6785,69,12,2,10,57,28,29,0,0.0,0.0
1012,437,24-09-2019 02:12:00,0,3690.0,3280.0,0.889,18.169,33,0,0,0,33,7,26,0,0.0,0.0
1012,438,24-09-2019 02:14:00,0,3507.0,3109.0,0.887,17.259,27,0,0,0,27,8,19,0,0.0,0.0
1012,439,24-09-2019 02:16:00,0,3310.0,2986.0,0.902,16.348,17,0,0,0,17,2,15,0,0.0,0.0
1012,440,24-09-2019 02:18:00,0,3199.0,2903.0,0.908,15.818,19,0,0,0,19,4,15,0,0.0,0.0
1012,441,24-09-2019 02:20:00,0,3002.0,2746.0,0.915,14.867,20,4,1,3,16,4,12,0,0.0,0.0
1012,442,24-09-2019 02:22:00,0,3024.0,2638.0,0.872,14.836,52,5,1,4,47,21,26,0,0.0,0.0
1012,443,24-09-2019 02:24:00,0,2797.0,2550.0,0.912,13.845,37,3,0,3,34,9,25,0,0.0,0.0
1012,444,24-09-2019 02:26:00,0,2854.0,2414.0,0.846,13.916,32,4,2,2,28,6,22,0,0.0,0.0
1012,445,24-09-2019 02:28:00,0,2839.0,2450.0,0.863,13.899,52,2,1,1,50,26,24,0,0.0,0.0
1012,446,24-09-2019 02:30:00,0,2634.0,2363.0,0.897,12.993,58,3,1,2,55,29,26,0,0.0,0.0
1012,447,24-09-2019 02:32:00,0,2507.0,2279.0,0.909,12.4,32,2,0,2,30,14,16,0,0.0,0.0
1012,448,24-09-2019 02:34:00,0,2523.0,2239.0,0.888,12.418,66,11,4,7,55,28,27,0,0.0,0.0
1012,449,24-09-2019 02:36:00,0,2522.0,2284.0,0.906,12.463,43,11,10,1,32,6,26,0,0.0,0.0
1012,450,24-09-2019 02:38:00,0,2546.0,2183.0,0.858,12.448,28,0,0,0,28,9,19,0,0.0,0.0
1012,451,24-09-2019 02:40:00,0,2507.0,2332.0,0.93,12.461,63,4,0,4,59,28,31,0,0.0,0.0
1012,452,24-09-2019 02:42:00,0,2551.0,2169.0,0.85,12.453,66,2,0,2,64,45,19,0,0.0,0.0
1012,453,24-09-2019 02:44:00,0,2548.5,2193.0,0.8605,12.4695,53,2,0,2,51,25,26,0,0.0,0.0
1012,454,24-09-2019 02:46:00,0,2546.0,2217.0,0.871,12.486,43,6,1,5,37,15,22,0,0.0,0.0
1012,455,24-09-2019 02:48:00,0,2432.0,2188.0,0.899,12.005,69,13,6,7,56,22,34,0,0.0,0.0
1012,456,24-09-2019 02:50:00,0,2435.0,2092.0,0.859,11.911,76,0,0,0,76,57,19,0,0.0,0.0
1012,457,24-09-2019 02:52:00,0,2444.0,2155.0,0.882,12.015,127,0,0,0,127,112,15,0,0.0,0.0
1012,458,24-09-2019 02:54:00,0,2315.0,2122.0,0.917,11.468,64,0,0,0,64,49,15,0,0.0,0.0
1012,459,24-09-2019 02:56:00,0,2343.0,2037.0,0.869,11.487,22,0,0,0,22,18,4,0,0.0,0.0
1012,460,24-09-2019 02:58:00,0,2326.0,2078.0,0.893,11.467,33,6,3,3,27,11,16,0,0.0,0.0
1012,461,24-09-2019 03:00:00,0,2366.0,2017.0,0.852,11.556,26,7,0,7,19,1,18,0,0.0,0.0
1012,462,24-09-2019 03:02:00,0,2359.0,1959.0,0.83,11.462,381,198,150,48,183,140,43,42,0.0,0.0
1012,463,24-09-2019 03:04:00,0,2549.0,2146.0,0.842,12.417,223,68,54,14,155,108,47,24,0.0,0.0
1012,464,24-09-2019 03:06:00,0,2539.0,2236.0,0.881,12.48,163,20,2,18,143,100,43,6,0.0,0.0
1012,465,24-09-2019 03:08:00,0,2647.0,2232.0,0.844,12.899,138,19,1,18,119,73,46,4,0.0,0.0
1012,466,24-09-2019 03:10:00,0,2848.0,2426.0,0.852,13.907,83,8,1,7,75,41,34,1,0.0,0.0
1012,467,24-09-2019 03:12:00,0,3038.0,2505.0,0.824,14.743,61,4,1,3,57,22,35,0,0.0,0.0
1012,468,24-09-2019 03:14:00,0,2823.0,2499.0,0.885,13.89,52,0,0,0,52,21,31,0,0.0,0.0
1012,469,24-09-2019 03:16:00,0,2842.0,2416.0,0.85,13.875,80,0,0,0,80,32,48,0,0.0,0.0
1012,470,24-09-2019 03:18:00,0,2704.0,2236.5,0.826,13.132,35,0,0,0,35,4,31,0,0.0,0.0
1012,471,24-09-2019 03:20:00,0,2566.0,2057.0,0.802,12.389,69,7,2,5,62,35,27,0,0.0,0.0
1012,472,24-09-2019 03:22:00,0,2548.0,2156.0,0.846,12.426,60,6,1,5,54,18,36,0,0.0,0.0
1012,473,24-09-2019 03:24:00,0,2573.0,2098.0,0.815,12.461,19,0,0,0,19,0,19,0,0.0,0.0
1012,474,24-09-2019 03:26:00,0,2466.0,2045.0,0.829,11.979,69,3,0,3,66,36,30,0,0.0,0.0
1012,475,24-09-2019 03:28:00,0,2354.0,1956.0,0.831,11.439,110,14,10,4,96,55,41,0,0.0,0.0
1012,476,24-09-2019 03:30:00,0,2439.0,2080.0,0.853,11.911,47,7,4,3,40,16,24,0,0.0,0.0
1012,477,24-09-2019 03:32:00,0,2468.0,2063.0,0.836,12.009,20,0,0,0,20,0,20,0,0.0,0.0
1012,478,24-09-2019 03:34:00,0,2584.0,2064.0,0.799,12.466,31,0,0,0,31,6,25,0,0.0,0.0
1012,479,24-09-2019 03:36:00,0,2573.0,2071.0,0.805,12.431,25,0,0,0,25,13,12,0,0.0,0.0
1012,480,24-09-2019 03:38:00,0,2546.0,2143.0,0.842,12.405,47,2,1,1,45,35,10,0,0.0,0.0
1012,481,24-09-2019 03:40:00,0,2561.0,2107.0,0.823,12.422,59,0,0,0,59,34,25,0,0.0,0.0
1012,482,24-09-2019 03:42:00,0,2569.0,2114.0,0.823,12.46,185,46,37,9,139,99,40,3,0.0,0.0
1012,483,24-09-2019 03:44:00,0,2693.0,2086.0,0.774,12.919,102,0,0,0,102,55,47,0,0.0,0.0
1012,484,24-09-2019 03:46:00,0,2533.0,2289.0,0.904,12.513,130,0,0,0,130,64,66,0,0.0,0.0
1012,485,24-09-2019 03:48:00,0,2551.0,2152.0,0.844,12.433,109,0,0,0,109,71,38,0,0.0,0.0
1012,486,24-09-2019 03:50:00,0,2556.0,2145.0,0.839,12.446,74,0,0,0,74,34,40,0,0.0,0.0
1012,487,24-09-2019 03:52:00,0,2569.0,2105.5,0.8195,12.454,35,0,0,0,35,5,30,0,0.0,0.0
1012,488,24-09-2019 03:54:00,0,2582.0,2066.0,0.8,12.462,33,0,0,0,33,15,18,0,0.0,0.0
1012,489,24-09-2019 03:56:00,0,2577.0,2092.0,0.812,12.468,8,0,0,0,8,5,3,0,0.0,0.0
1012,490,24-09-2019 03:58:00,0,2586.0,1987.0,0.768,12.389,26,1,0,1,25,4,21,0,0.0,0.0
1012,491,24-09-2019 04:00:00,0,2489.0,1950.0,0.784,11.966,21,0,0,0,21,0,21,0,0.0,0.0
1012,492,24-09-2019 04:02:00,0,2382.0,1929.0,0.81,11.519,189,105,71,34,84,53,31,24,0.0,0.0
1012,493,24-09-2019 04:04:00,0,2571.0,2071.0,0.805,12.423,160,47,34,13,113,67,46,0,0.01,0.0
1012,494,24-09-2019 04:06:00,0,2596.0,2047.0,0.789,12.494,29,0,0,0,29,5,24,0,0.0,0.0
1012,495,24-09-2019 04:08:00,0,2623.0,1885.0,0.719,12.423,52,0,0,0,52,19,33,0,0.0,0.0
1012,496,24-09-2019 04:10:00,0,2481.0,1982.0,0.799,11.97,44,1,1,0,43,12,31,0,0.0,0.0
1012,497,24-09-2019 04:12:00,0,2608.0,1941.0,0.744,12.427,34,1,1,0,33,4,29,0,0.0,0.0
1012,498,24-09-2019 04:14:00,0,2613.0,1973.0,0.755,12.48,39,0,0,0,39,20,19,0,0.0,0.0
1012,499,24-09-2019 04:16:00,0,2590.0,2002.0,0.773,12.422,55,14,5,9,41,15,26,0,0.0,0.0
1012,500,24-09-2019 04:18:00,0,2614.0,1954.0,0.747,12.463,30,6,2,4,24,9,15,0,0.0,0.0
1012,501,24-09-2019 04:20:00,0,2485.0,1932.0,0.778,11.932,28,3,1,2,25,4,21,0,0.0,0.0
1012,502,24-09-2019 04:22:00,0,2383.0,1845.0,0.774,11.431,25,1,0,1,24,4,20,0,0.0,0.0
1012,503,24-09-2019 04:24:00,0,2393.0,1856.0,0.776,11.483,20,0,0,0,20,0,20,0,0.0,0.0
1012,504,24-09-2019 04:26:00,0,2492.5,1941.0,0.779,11.9685,227,28,10,18,199,128,71,2,0.0,0.0
1012,505,24-09-2019 04:28:00,0,2592.0,2026.0,0.782,12.454,154,62,35,27,92,48,44,1,0.0,0.0
1012,506,24-09-2019 04:30:00,0,2589.0,2074.0,0.801,12.499,66,3,0,3,63,34,29,0,0.0,0.0
1012,507,24-09-2019 04:32:00,0,2774.0,2125.0,0.766,13.284,157,55,36,19,102,55,47,4,0.0,0.0
1012,508,24-09-2019 04:34:00,0,2867.0,2300.0,0.802,13.843,364,154,114,40,210,155,55,48,0.02,0.0
1012,509,24-09-2019 04:36:00,0,3076.0,2448.0,0.796,14.829,180,48,22,26,132,85,47,49,0.0,0.0
1012,510,24-09-2019 04:38:00,0,3567.0,2883.0,0.808,17.248,236,36,12,24,200,131,69,42,0.0,0.0
1012,511,24-09-2019 04:40:00,0,3562.0,2892.0,0.812,17.236,138,28,15,13,110,55,55,32,0.0,0.04
1012,512,24-09-2019 04:42:00,0,3778.0,2977.0,0.788,18.181,198,34,13,21,164,98,66,20,0.0,0.05
1012,513,24-09-2019 04:44:00,0,3776.0,2994.0,0.793,18.192,117,19,4,15,98,55,43,12,0.0,0.0
1012,514,24-09-2019 04:46:00,0,3824.0,3200.0,0.837,18.609,137,26,10,16,111,62,49,12,0.0,0.05
1012,515,24-09-2019 04:48:00,0,3540.0,2975.0,0.84,17.243,371,146,111,35,225,171,54,83,0.0,0.01
1012,516,24-09-2019 04:50:00,0,3660.0,2989.0,0.817,17.729,485,268,210,58,217,162,55,114,0.02,0.0
1012,517,24-09-2019 04:52:00,0,3732.0,3203.0,0.858,18.249,430,193,147,46,237,179,58,98,0.0,0.0
1012,518,24-09-2019 04:54:00,0,2965.0,2440.0,0.823,14.386,269,100,74,26,169,120,49,101,0.03,0.0
1012,519,24-09-2019 04:56:00,0,3320.0,2823.0,0.851,16.205,526,204,161,43,322,254,68,125,0.0,0.0
1012,520,24-09-2019 04:58:00,0,3371.0,2666.0,0.791,16.232,562,247,189,58,315,249,66,57,0.1,0.0
1012,521,24-09-2019 05:00:00,0,3213.0,2623.5,0.818,15.563,274,148,123,25,126,93,33,85,0.0,0.0
1012,522,24-09-2019 05:02:00,0,3055.0,2581.0,0.845,14.894,126,52,36,16,74,45,29,3,0.0,0.0
1012,523,24-09-2019 05:04:00,0,3572.0,2839.0,0.795,17.219,89,48,21,27,41,20,21,0,0.0,0.0
1012,524,24-09-2019 05:06:00,0,3725.0,3132.0,0.841,18.144,112,46,21,25,66,31,35,0,0.0,0.0
1012,525,24-09-2019 05:08:00,0,3740.0,3209.0,0.858,18.288,267,114,85,29,153,106,47,53,0.13,0.0
1012,526,24-09-2019 05:10:00,0,4182.0,3717.0,0.889,20.591,144,61,39,22,83,52,31,1,0.0,0.0
1012,527,24-09-2019 05:12:00,0,3329.0,2845.0,0.855,16.268,317,160,109,51,157,111,46,0,0.0,0.01
1012,528,24-09-2019 05:14:00,0,3531.0,2957.0,0.837,17.187,722,353,274,79,369,299,70,29,0.0,0.0
1012,529,24-09-2019 05:16:00,0,3747.0,3139.0,0.838,18.24,479,199,156,43,280,222,58,8,0.0,0.19
1012,530,24-09-2019 05:18:00,0,3557.0,2973.0,0.836,17.306,123,60,42,18,63,34,29,0,0.0,0.0
1012,531,24-09-2019 05:20:00,0,3543.0,2967.0,0.837,17.244,128,16,3,13,112,65,47,0,0.0,0.0
1012,532,24-09-2019 05:22:00,0,3647.0,3072.0,0.842,17.771,59,20,4,16,39,21,18,0,0.0,0.0
1012,533,24-09-2019 05:24:00,0,3740.0,3058.0,0.818,18.12,33,16,5,11,17,5,12,0,0.0,0.0
1012,534,24-09-2019 05:26:00,0,3347.0,2757.0,0.823,16.241,8,4,0,4,4,0,4,0,0.0,0.0
1012,535,24-09-2019 05:28:00,0,3389.0,2604.0,0.768,16.235,16,0,0,0,16,0,16,0,0.0,0.0
1012,536,24-09-2019 05:30:00,0,3142.0,2646.0,0.842,15.309,9,5,0,5,4,0,4,0,0.0,0.0
1012,537,24-09-2019 05:32:00,0,3053.0,2547.0,0.834,14.848,3,0,0,0,3,0,3,0,0.0,0.0
1012,538,24-09-2019 05:34:00,0,2959.0,2449.0,0.8275,14.369,16,5,1,4,11,4,7,0,0.0,0.0
1012,539,24-09-2019 05:36:00,0,2865.0,2351.0,0.821,13.89,7,0,0,0,7,0,7,0,0.0,0.0
1012,540,24-09-2019 05:38:00,0,2886.0,2204.0,0.764,13.811,7,3,0,3,4,0,4,0,0.0,0.0
1012,541,24-09-2019 05:40:00,0,2666.0,2142.0,0.803,12.875,14,6,0,6,8,0,8,0,0.0,0.0
1012,542,24-09-2019 05:42:00,0,2553.0,2166.0,0.848,12.459,19,10,0,10,9,0,9,0,0.0,0.0
1012,543,24-09-2019 05:44:00,0,2568.0,2095.0,0.816,12.435,4,0,0,0,4,0,4,0,0.0,0.0
1012,544,24-09-2019 05:46:00,0,2588.0,2000.0,0.773,12.409,16,7,0,7,9,4,5,0,0.0,0.0
1012,545,24-09-2019 05:48:00,0,2610.0,1984.0,0.76,12.48,19,13,0,13,6,2,4,0,0.0,0.0
1012,546,24-09-2019 05:50:00,0,2599.0,2020.0,0.777,12.479,35,12,1,11,23,13,10,0,0.0,0.0
1012,547,24-09-2019 05:52:00,0,2580.0,2030.0,0.787,12.412,17,0,0,0,17,9,8,0,0.0,0.0
1012,548,24-09-2019 05:54:00,0,2582.0,1988.0,0.77,12.374,18,1,0,1,17,10,7,0,0.0,0.0
1012,549,24-09-2019 05:56:00,0,2495.0,1916.0,0.768,11.953,7,0,0,0,7,3,4,0,0.0,0.0
1012,550,24-09-2019 05:58:00,0,2383.0,1905.0,0.799,11.498,14,0,0,0,14,8,6,0,0.0,0.0
1012,551,24-09-2019 06:00:00,1,2380.0,1860.0,0.781,11.436,14,0,0,0,14,5,9,0,0.0,0.0
1012,552,24-09-2019 06:02:00,1,2396.0,1844.0,0.77,11.48,132,60,38,22,72,54,18,25,0.0,0.0
1012,553,24-09-2019 06:04:00,1,2577.0,2095.0,0.813,12.473,225,82,52,30,143,94,49,19,0.0,0.0
1012,554,24-09-2019 06:06:00,1,3103.0,2358.0,0.76,14.835,314,159,121,38,155,121,34,180,0.0,0.0
1012,555,24-09-2019 06:08:00,1,3238.5,2522.5,0.778,15.552,349,167,134,33,182,140,42,214,0.0,0.0
1012,556,24-09-2019 06:10:00,1,3374.0,2687.0,0.796,16.269,194,86,59,27,108,73,35,87,0.0,0.0
1012,557,24-09-2019 06:12:00,1,3794.0,2972.0,0.783,18.239,105,11,2,9,94,38,56,13,0.0,0.0
1012,558,24-09-2019 06:14:00,1,4060.0,3175.0,0.782,19.512,187,19,6,13,168,106,62,29,0.0,0.0
1012,559,24-09-2019 06:16:00,1,4086.0,3221.0,0.788,19.665,171,29,5,24,142,77,65,33,0.0,0.0
1012,560,24-09-2019 06:18:00,1,4064.0,3204.0,0.788,19.56,331,139,110,29,192,118,74,42,0.0,0.0
1012,561,24-09-2019 06:20:00,1,3073.0,2495.0,0.812,14.87,386,151,127,24,235,189,46,146,0.0,0.0
1012,562,24-09-2019 06:22:00,1,3475.0,2768.0,0.796,16.758,297,121,92,29,176,116,60,41,0.0,0.0
1012,563,24-09-2019 06:24:00,1,3365.0,2666.0,0.792,16.211,374,188,140,48,186,133,53,60,0.0,0.0
1012,564,24-09-2019 06:26:00,1,3727.0,3191.0,0.856,18.217,340,150,118,32,190,147,43,170,0.01,0.0
1012,565,24-09-2019 06:28:00,1,3064.0,2472.0,0.807,14.81,342,147,107,40,195,133,62,49,0.0,0.0
1012,566,24-09-2019 06:30:00,1,2990.0,2314.0,0.774,14.341,232,75,47,28,157,114,43,36,0.0,0.0
1012,567,24-09-2019 06:32:00,1,3722.0,3187.0,0.856,18.193,235,106,87,19,129,95,34,158,0.03,0.0
1012,568,24-09-2019 06:34:00,1,3852.0,3200.0,0.831,18.717,174,47,27,20,127,86,41,5,0.0,0.0
1012,569,24-09-2019 06:36:00,1,3564.0,2911.0,0.817,17.264,67,20,0,20,47,41,6,0,0.0,0.0
1012,570,24-09-2019 06:38:00,1,3772.0,3000.0,0.795,18.184,76,20,6,14,56,52,4,0,0.0,0.0
1012,571,24-09-2019 06:40:00,1,3782.0,3019.0,0.798,18.246,26,1,0,1,25,21,4,0,0.0,0.0
1012,572,24-09-2019 06:42:00,1,3675.5,2904.5,0.79,17.6985,45,4,2,2,41,40,1,0,0.0,0.0
1012,573,24-09-2019 06:44:00,1,3569.0,2790.0,0.782,17.151,58,0,0,0,58,29,29,0,0.02,0.0
1012,574,24-09-2019 06:46:00,1,3365.0,2744.0,0.816,16.298,22,0,0,0,22,8,14,0,0.0,0.0
1012,575,24-09-2019 06:48:00,1,3174.0,2590.0,0.816,15.374,60,21,13,8,39,22,17,0,0.0,0.0
1012,576,24-09-2019 06:50:00,1,3061.0,2495.0,0.815,14.821,35,9,4,5,26,13,13,0,0.0,0.0
1012,577,24-09-2019 06:52:00,1,2973.0,2403.0,0.808,14.376,52,26,15,11,26,12,14,0,0.0,0.0
1012,578,24-09-2019 06:54:00,1,2874.0,2332.0,0.811,13.906,32,5,0,5,27,16,11,0,0.0,0.0
1012,579,24-09-2019 06:56:00,1,2664.0,2187.0,0.821,12.918,26,1,1,0,25,8,17,0,0.0,0.0
1012,580,24-09-2019 06:58:00,1,2574.0,2135.0,0.829,12.508,79,13,6,7,66,34,32,0,0.0,0.0
1012,581,24-09-2019 07:00:00,1,2560.0,2085.0,0.814,12.395,29,0,0,0,29,13,16,0,0.0,0.0
1012,582,24-09-2019 07:02:00,1,2575.0,2109.0,0.819,12.48,40,0,0,0,40,26,14,0,0.0,0.0
1012,583,24-09-2019 07:04:00,1,2580.0,2040.0,0.791,12.426,59,19,9,10,40,20,20,0,0.0,0.0
1012,584,24-09-2019 07:06:00,1,2597.0,2032.0,0.782,12.482,32,3,0,3,29,14,15,0,0.0,0.0
1012,585,24-09-2019 07:08:00,1,2356.0,2005.0,0.851,11.504,47,1,0,1,46,17,29,0,0.0,0.0
1012,586,24-09-2019 07:10:00,1,2453.0,2016.0,0.822,11.896,73,12,3,9,61,29,32,0,0.0,0.0
1012,587,24-09-2019 07:12:00,1,2477.0,1989.0,0.803,11.963,73,7,4,3,66,33,33,0,0.0,0.0
1012,588,24-09-2019 07:14:00,1,2603.0,1939.0,0.745,12.401,91,19,10,9,72,36,36,0,0.0,0.0
1012,589,24-09-2019 07:16:00,1,2601.0,1963.0,0.755,12.4215,25,1,0,1,24,10,14,0,0.0,0.0
1012,590,24-09-2019 07:18:00,1,2599.0,1987.0,0.765,12.442,47,12,0,12,35,19,16,0,0.0,0.0
1012,591,24-09-2019 07:20:00,1,2595.0,2013.0,0.776,12.452,87,19,7,12,68,37,31,0,0.0,0.0
1012,592,24-09-2019 07:22:00,1,2814.0,2054.0,0.73,13.363,190,50,26,24,140,89,51,15,0.0,0.0
1012,593,24-09-2019 07:24:00,1,3367.0,2688.0,0.798,16.243,162,30,5,25,132,81,51,14,0.0,0.04
1012,594,24-09-2019 07:26:00,1,3685.0,2931.0,0.795,17.767,186,13,3,10,173,86,87,7,0.0,0.07
1012,595,24-09-2019 07:28:00,1,3490.0,2682.0,0.768,16.722,187,19,4,15,168,96,72,8,0.0,0.09
1012,596,24-09-2019 07:30:00,1,3520.0,2963.0,0.842,17.15,207,2,0,2,205,115,90,1,0.0,0.26
1012,597,24-09-2019 07:32:00,1,3346.0,2808.0,0.839,16.293,82,0,0,0,82,72,10,0,0.0,0.0
1012,598,24-09-2019 07:34:00,1,3540.0,2958.0,0.835,17.222,155,0,0,0,155,109,46,0,0.0,0.0
1012,599,24-09-2019 07:36:00,1,3522.0,2969.0,0.843,17.162,90,18,8,10,72,39,33,11,0.03,0.01
1012,600,24-09-2019 07:38:00,1,3425.0,2898.0,0.846,16.701,466,191,144,47,275,213,62,84,0.11,0.01
1012,601,24-09-2019 07:40:00,1,3051.0,2574.0,0.844,14.872,278,88,64,24,190,158,32,67,0.0,0.0
1012,602,24-09-2019 07:42:00,1,3025.0,2610.0,0.863,14.808,274,95,73,22,179,149,30,27,0.06,0.0
1012,603,24-09-2019 07:44:00,1,3705.0,3352.0,0.904,18.31,567,190,141,49,377,285,92,77,0.08,0.0
1012,604,24-09-2019 07:46:00,1,3292.0,2932.0,0.891,16.216,539,226,179,47,313,257,56,153,0.0,0.0
1012,605,24-09-2019 07:48:00,1,3736.0,3168.0,0.848,18.226,275,122,97,25,153,119,34,195,0.0,0.0
1012,606,24-09-2019 07:50:00,1,3739.0,3177.0,0.8495,18.249,437,161,116,45,276,220,56,31,0.2,0.01
1012,607,24-09-2019 07:52:00,1,3742.0,3186.0,0.851,18.272,335,117,97,20,218,158,60,55,0.0,0.0
1012,608,24-09-2019 07:54:00,1,3733.0,3121.0,0.836,18.165,355,157,117,40,198,145,53,6,0.0,0.0
1012,609,24-09-2019 07:56:00,1,3734.0,3101.0,0.831,18.146,441,244,190,54,197,141,56,0,0.0,0.0
1012,610,24-09-2019 07:58:00,1,4015.0,3492.0,0.87,19.686,429,205,151,54,224,178,46,29,0.0,0.05
1012,611,24-09-2019 08:00:00,1,3714.0,3158.0,0.85,18.131,563,259,197,62,304,239,65,5,0.0,0.0
1012,612,24-09-2019 08:02:00,1,3608.0,3160.0,0.876,17.716,268,154,106,48,114,79,35,1,0.0,0.0
1012,613,24-09-2019 08:04:00,1,3731.0,3156.0,0.846,18.194,320,161,123,38,159,118,41,1,0.0,0.0
1012,614,24-09-2019 08:06:00,1,3528.0,2972.0,0.843,17.189,42,11,1,10,31,12,19,0,0.0,0.0
1012,615,24-09-2019 08:08:00,1,3317.0,2852.0,0.86,16.228,59,23,4,19,36,14,22,0,0.0,0.0
1012,616,24-09-2019 08:10:00,1,3525.0,3027.0,0.859,17.241,79,38,6,32,41,12,29,0,0.0,0.0
1012,617,24-09-2019 08:12:00,1,3533.0,3054.0,0.864,17.3,6,0,0,0,6,0,6,0,0.0,0.0
1012,618,24-09-2019 08:14:00,1,3320.0,2928.0,0.882,16.321,10,0,0,0,10,1,9,0,0.0,0.0
1012,619,24-09-2019 08:16:00,1,3325.0,2875.0,0.865,16.283,18,0,0,0,18,8,10,0,0.0,0.0
1012,620,24-09-2019 08:18:00,1,3043.0,2643.0,0.869,14.915,8,1,0,1,7,1,6,0,0.0,0.0
1012,621,24-09-2019 08:20:00,1,3066.0,2486.0,0.811,14.834,15,0,0,0,15,7,8,0,0.0,0.0
1012,622,24-09-2019 08:22:00,1,2860.0,2409.0,0.842,13.934,18,10,2,8,8,3,5,0,0.0,0.0
1012,623,24-09-2019 08:24:00,1,2755.5,2314.0,0.8395,13.4175,6,0,0,0,6,0,6,0,0.0,0.0
1012,624,24-09-2019 08:26:00,1,2651.0,2219.0,0.837,12.901,11,0,0,0,11,2,9,0,0.0,0.0
1012,625,24-09-2019 08:28:00,1,2529.0,2248.0,0.889,12.453,13,6,0,6,7,0,7,0,0.0,0.0
1012,626,24-09-2019 08:30:00,1,2547.0,2196.0,0.862,12.467,29,14,0,14,15,6,9,0,0.0,0.0
1012,627,24-09-2019 08:32:00,1,2563.0,2173.0,0.848,12.506,11,1,1,0,10,5,5,0,0.0,0.0
1012,628,24-09-2019 08:34:00,1,2573.0,2092.0,0.813,12.452,9,0,0,0,9,0,9,0,0.0,0.0
1012,629,24-09-2019 08:36:00,1,2553.0,2121.0,0.831,12.409,9,2,1,1,7,0,7,0,0.0,0.0
1012,630,24-09-2019 08:38:00,1,2359.0,2034.0,0.862,11.545,5,0,0,0,5,0,5,0,0.0,0.0
1012,631,24-09-2019 08:40:00,1,2354.0,1986.0,0.844,11.473,24,9,3,6,15,2,13,0,0.0,0.0
1012,632,24-09-2019 08:42:00,1,2558.0,2122.0,0.829,12.427,77,25,8,17,52,32,20,0,0.0,0.0
1012,633,24-09-2019 08:44:00,1,2548.0,2180.0,0.856,12.451,21,4,3,1,17,11,6,0,0.0,0.0
1012,634,24-09-2019 08:46:00,1,2540.0,2231.0,0.878,12.479,5,0,0,0,5,1,4,0,0.0,0.0
1012,635,24-09-2019 08:48:00,1,2540.0,2207.0,0.869,12.453,14,7,3,4,7,1,6,0,0.0,0.0
1012,636,24-09-2019 08:50:00,1,2567.0,2122.0,0.827,12.464,12,0,0,0,12,4,8,0,0.0,0.0
1012,637,24-09-2019 08:52:00,1,2536.0,2208.0,0.871,12.437,17,9,5,4,8,1,7,0,0.0,0.0
1012,638,24-09-2019 08:54:00,1,2568.0,2117.0,0.824,12.462,6,3,1,2,3,0,3,0,0.0,0.0
1012,639,24-09-2019 08:56:00,1,2539.0,2162.0,0.852,12.396,213,93,75,18,120,85,35,16,0.0,0.0
1012,640,24-09-2019 08:58:00,1,2693.0,2279.0,0.847,13.1325,244,108,72,36,136,107,29,4,0.0,0.0
1012,641,24-09-2019 09:00:00,1,2847.0,2396.0,0.842,13.869,20,14,1,13,6,3,3,0,0.0,0.0
1012,642,24-09-2019 09:02:00,1,2938.0,2545.0,0.866,14.392,50,27,4,23,23,11,12,0,0.0,0.0
1012,643,24-09-2019 09:04:00,1,3045.0,2521.0,0.828,14.788,27,9,0,9,18,5,13,0,0.0,0.0
1012,644,24-09-2019 09:06:00,1,2837.0,2412.0,0.85,13.847,92,0,0,0,92,75,17,0,0.0,0.0
1012,645,24-09-2019 09:08:00,1,2775.0,2245.0,0.809,13.419,65,3,0,3,62,53,9,0,0.0,0.0
1012,646,24-09-2019 09:10:00,1,2540.0,2145.0,0.844,12.384,3,0,0,0,3,1,2,0,0.0,0.0
1012,647,24-09-2019 09:12:00,1,2462.0,2058.0,0.836,11.979,14,0,0,0,14,4,10,0,0.0,0.0
1012,648,24-09-2019 09:14:00,1,2348.0,2006.0,0.854,11.473,37,5,0,5,32,16,16,0,0.0,0.0
1012,649,24-09-2019 09:16:00,1,2367.0,1950.0,0.824,11.485,16,0,0,0,16,16,0,0,0.0,0.0
1012,650,24-09-2019 09:18:00,1,2380.0,1883.0,0.791,11.464,33,0,0,0,33,24,9,0,0.0,0.0
1012,651,24-09-2019 09:20:00,1,2261.0,1924.0,0.851,11.039,62,0,0,0,62,56,6,0,0.0,0.0
1012,652,24-09-2019 09:22:00,1,2265.0,1872.0,0.826,10.996,100,0,0,0,100,89,11,0,0.0,0.0
1012,653,24-09-2019 09:24:00,1,2166.0,1830.0,0.845,10.559,51,1,0,1,50,26,24,0,0.0,0.0
1012,654,24-09-2019 09:26:00,1,2159.0,1850.0,0.857,10.553,25,0,0,0,25,12,13,0,0.0,0.0
1012,655,24-09-2019 09:28:00,1,2169.0,1838.0,0.848,10.582,16,0,0,0,16,9,7,0,0.0,0.0
1012,656,24-09-2019 09:30:00,1,2152.0,1854.0,0.862,10.532,52,0,0,0,52,32,20,0,0.0,0.0
1012,657,24-09-2019 09:32:00,1,2159.5,1824.5,0.845,10.5285,22,0,0,0,22,11,11,0,0.0,0.0
1012,658,24-09-2019 09:34:00,1,2167.0,1795.0,0.828,10.525,17,0,0,0,17,4,13,0,0.0,0.0
1012,659,24-09-2019 09:36:00,1,2174.0,1741.0,0.801,10.492,19,0,0,0,19,10,9,0,0.0,0.0
1012,660,24-09-2019 09:38:00,1,2158.0,1806.0,0.837,10.503,8,1,1,0,7,6,1,0,0.0,0.0
1012,661,24-09-2019 09:40:00,1,2166.0,1828.0,0.844,10.559,29,1,0,1,28,17,11,0,0.0,0.0
1012,662,24-09-2019 09:42:00,1,2149.0,1826.0,0.85,10.488,53,0,0,0,53,31,22,0,0.0,0.0
1012,663,24-09-2019 09:44:00,1,2150.0,1864.0,0.867,10.533,46,0,0,0,46,25,21,0,0.0,0.0
1012,664,24-09-2019 09:46:00,1,2164.0,1821.0,0.841,10.542,27,0,0,0,27,13,14,0,0.0,0.0
1012,665,24-09-2019 09:48:00,1,2159.0,1838.0,0.851,10.54,172,70,44,26,102,60,42,1,0.0,0.0
1012,666,24-09-2019 09:50:00,1,2556.0,2148.0,0.841,12.448,214,91,64,27,123,89,34,15,0.0,0.0
1012,667,24-09-2019 09:52:00,1,2872.0,2304.0,0.802,13.869,36,2,0,2,34,15,19,0,0.0,0.0
1012,668,24-09-2019 09:54:00,1,2526.0,2240.0,0.887,12.43,18,0,0,0,18,4,14,0,0.0,0.0
1012,669,24-09-2019 09:56:00,1,2537.0,2199.0,0.867,12.429,12,1,0,1,11,2,9,0,0.0,0.0
1012,670,24-09-2019 09:58:00,1,2579.0,2074.0,0.804,12.456,14,0,0,0,14,5,9,0,0.0,0.0
1012,671,24-09-2019 10:00:00,1,2465.0,2071.0,0.84,12.005,27,8,5,3,19,15,4,0,0.0,0.0
1012,672,24-09-2019 10:02:00,1,2556.0,2129.0,0.833,12.429,21,6,1,5,15,6,9,0,0.0,0.0
1012,673,24-09-2019 10:04:00,1,2557.0,2163.0,0.846,12.468,46,35,1,34,11,5,6,0,0.0,0.0
1012,674,24-09-2019 10:06:00,1,2694.5,2305.5,0.855,13.1675,183,66,47,19,117,76,41,41,0.0,0.0
1012,675,24-09-2019 10:08:00,1,2832.0,2448.0,0.864,13.867,382,154,114,40,228,167,61,13,0.0,0.0
1012,676,24-09-2019 10:10:00,1,2660.0,2244.0,0.844,12.963,780,492,397,95,288,214,74,12,0.0,0.0
1012,677,24-09-2019 10:12:00,1,3049.0,2577.0,0.845,14.866,185,88,68,20,97,75,22,73,0.0,0.0
1012,678,24-09-2019 10:14:00,1,3061.0,2480.0,0.81,14.807,736,422,343,79,314,243,71,14,0.0,0.0
1012,679,24-09-2019 10:16:00,1,2847.0,2461.0,0.864,13.944,415,199,148,51,216,155,61,9,0.0,0.0
1012,680,24-09-2019 10:18:00,1,2872.0,2369.0,0.825,13.941,599,294,226,68,305,215,90,0,0.0,0.01
1012,681,24-09-2019 10:20:00,1,3041.0,2584.0,0.85,14.841,715,354,264,90,361,277,84,1,0.0,0.0
1012,682,24-09-2019 10:22:00,1,3056.0,2493.0,0.816,14.801,554,242,194,48,312,232,80,16,0.0,0.0
1012,683,24-09-2019 10:24:00,1,2866.0,2315.0,0.808,13.854,78,12,6,6,66,34,32,1,0.0,0.0
1012,684,24-09-2019 10:26:00,1,2847.0,2408.0,0.846,13.881,95,33,8,25,62,39,23,2,0.0,0.0
1012,685,24-09-2019 10:28:00,1,3063.0,2475.0,0.808,14.807,109,41,16,25,68,34,34,0,0.0,0.0
1012,686,24-09-2019 10:30:00,1,3060.0,2559.0,0.837,14.889,161,3,3,0,158,106,52,0,0.0,0.0
1012,687,24-09-2019 10:32:00,1,3083.0,2448.0,0.794,14.857,175,36,17,19,139,81,58,0,0.0,0.0
1012,688,24-09-2019 10:34:00,1,2967.0,2411.0,0.813,14.359,370,3,0,3,367,282,85,0,0.0,0.0
1012,689,24-09-2019 10:36:00,1,2893.0,2231.0,0.771,13.868,107,3,0,3,104,66,38,0,0.0,0.0
1012,690,24-09-2019 10:38:00,1,2704.0,2084.0,0.771,12.961,4,0,0,0,4,3,1,0,0.0,0.0
1012,691,24-09-2019 10:40:00,1,2538.0,2012.5,0.7945,12.229,85,12,4,8,73,67,6,0,0.0,0.0
1012,692,24-09-2019 10:42:00,1,2372.0,1941.0,0.818,11.497,197,1,0,1,196,168,28,0,0.0,0.0
1012,693,24-09-2019 10:44:00,1,2388.0,1881.0,0.788,11.493,187,6,2,4,181,148,33,0,0.0,0.0
1012,694,24-09-2019 10:46:00,1,2368.0,1947.0,0.823,11.484,163,0,0,0,163,144,19,0,0.0,0.0
1012,695,24-09-2019 10:48:00,1,2402.0,1827.0,0.761,11.485,165,3,1,2,162,144,18,0,0.0,0.0
1012,696,24-09-2019 10:50:00,1,2491.0,1909.0,0.766,11.928,12,0,0,0,12,12,0,0,0.0,0.0
1012,697,24-09-2019 10:52:00,1,2489.0,1977.0,0.794,11.994,263,0,0,0,263,240,23,0,0.0,0.0
1012,698,24-09-2019 10:54:00,1,2387.0,1885.0,0.79,11.49,351,2,0,2,349,308,41,0,0.0,0.0
1012,699,24-09-2019 10:56:00,1,2404.0,1807.0,0.752,11.472,492,0,0,0,492,429,63,0,0.0,0.0
1012,700,24-09-2019 10:58:00,1,2413.0,1772.0,0.734,11.47,465,1,0,1,464,407,57,0,0.0,0.0
1012,701,24-09-2019 11:00:00,1,2414.0,1776.0,0.735,11.477,307,0,0,0,307,273,34,0,0.0,0.0
1012,702,24-09-2019 11:02:00,1,2310.0,1707.0,0.739,10.991,423,0,0,0,423,365,58,0,0.0,0.0
1012,703,24-09-2019 11:04:00,1,2299.0,1748.0,0.76,10.992,414,1,0,1,413,377,36,0,0.0,0.0
1012,704,24-09-2019 11:06:00,1,2302.0,1764.0,0.766,11.023,18,0,0,0,18,14,4,0,0.0,0.0
1012,705,24-09-2019 11:08:00,1,2192.0,1692.0,0.772,10.51,64,1,0,1,63,23,40,0,0.0,0.0
1012,706,24-09-2019 11:10:00,1,2203.0,1661.0,0.754,10.52,61,0,0,0,61,30,31,0,0.0,0.0
1012,707,24-09-2019 11:12:00,1,2212.0,1619.0,0.732,10.509,247,2,0,2,245,192,53,0,0.0,0.0
1012,708,24-09-2019 11:14:00,1,2213.0,1622.0,0.733,10.515,515,0,0,0,515,460,55,0,0.0,0.0
1012,709,24-09-2019 11:16:00,1,2214.0,1625.0,0.734,10.521,527,0,0,0,527,488,39,0,0.0,0.0
1012,710,24-09-2019 11:18:00,1,2232.0,1568.0,0.702,10.531,574,0,0,0,574,527,47,0,0.0,0.0
1012,711,24-09-2019 11:20:00,1,2184.0,1689.0,0.773,10.475,591,0,0,0,591,548,43,0,0.0,0.0
1012,712,24-09-2019 11:22:00,1,2199.0,1658.0,0.754,10.498,626,0,0,0,626,572,54,0,0.0,0.0
1012,713,24-09-2019 11:24:00,1,2205.0,1628.0,0.738,10.49,77,0,0,0,77,64,13,0,0.0,0.0
1012,714,24-09-2019 11:26:00,1,2223.0,1594.0,0.717,10.523,57,1,0,1,56,31,25,0,0.0,0.0
1012,715,24-09-2019 11:28:00,1,2224.0,1614.0,0.726,10.549,810,0,0,0,810,741,69,0,0.0,0.0
1012,716,24-09-2019 11:30:00,1,2219.0,1627.0,0.733,10.543,689,1,1,0,688,638,50,0,0.0,0.0
1012,717,24-09-2019 11:32:00,1,2201.0,1618.0,0.735,10.463,808,0,0,0,808,750,58,0,0.0,0.0
1012,718,24-09-2019 11:34:00,1,2214.0,1626.0,0.735,10.523,1039,0,0,0,1039,982,57,0,0.0,0.0
1012,719,24-09-2019 11:36:00,1,2203.0,1656.0,0.752,10.513,75,0,0,0,75,68,7,0,0.0,0.0
1012,720,24-09-2019 11:38:00,1,2218.0,1607.0,0.724,10.518,77,1,1,0,76,72,4,0,0.0,0.0
1012,721,24-09-2019 11:40:00,1,2208.0,1650.0,0.747,10.525,161,26,2,24,135,124,11,0,0.0,0.0
1012,722,24-09-2019 11:42:00,1,2406.0,1788.0,0.743,11.459,136,30,8,22,106,92,14,0,0.0,0.0
1012,723,24-09-2019 11:44:00,1,2572.0,2039.0,0.793,12.391,401,119,77,42,282,245,37,14,0.0,0.0
1012,724,24-09-2019 11:46:00,1,2580.0,2060.0,0.798,12.447,293,109,73,36,184,129,55,16,0.0,0.0
1012,725,24-09-2019 11:48:00,1,2635.0,2088.0,0.7925,12.694,23,1,0,1,22,14,8,0,0.0,0.0
1012,726,24-09-2019 11:50:00,1,2690.0,2116.0,0.787,12.941,19,0,0,0,19,10,9,0,0.0,0.0
1012,727,24-09-2019 11:52:00,1,2596.0,1943.0,0.749,12.379,18,0,0,0,18,11,7,0,0.0,0.0
1012,728,24-09-2019 11:54:00,1,2402.0,1829.0,0.761,11.489,21,0,0,0,21,9,12,0,0.0,0.0
1012,729,24-09-2019 11:56:00,1,2397.0,1845.0,0.77,11.486,42,2,0,2,40,20,20,0,0.0,0.0
1012,730,24-09-2019 11:58:00,1,2385.0,1917.0,0.804,11.521,58,0,0,0,58,24,34,0,0.0,0.0
1012,731,24-09-2019 12:00:00,1,2500.0,1908.0,0.763,11.962,73,0,0,0,73,22,51,0,0.0,0.0
1012,732,24-09-2019 12:02:00,1,2508.0,1879.0,0.749,11.964,66,0,0,0,66,27,39,0,0.0,0.0
1012,733,24-09-2019 12:04:00,1,2619.0,1884.0,0.719,12.403,174,3,2,1,171,131,40,0,0.0,0.0
1012,734,24-09-2019 12:06:00,1,2616.0,1880.0,0.719,12.389,120,0,0,0,120,79,41,0,0.0,0.0
1012,735,24-09-2019 12:08:00,1,2524.0,1788.0,0.708,11.924,163,13,3,10,150,126,24,0,0.0,0.0
1012,736,24-09-2019 12:10:00,1,2615.0,1894.0,0.724,12.399,51,13,9,4,38,20,18,0,0.0,0.0
1012,737,24-09-2019 12:12:00,1,2498.0,1934.0,0.774,11.983,1,0,0,0,1,0,1,0,0.0,0.0
1012,738,24-09-2019 12:14:00,1,2413.0,1791.0,0.742,11.489,2,1,0,1,1,1,0,0,0.0,0.0
1012,739,24-09-2019 12:16:00,1,2423.0,1727.0,0.713,11.459,25,10,7,3,15,9,6,0,0.0,0.0
1012,740,24-09-2019 12:18:00,1,2514.0,1826.0,0.726,11.929,21,0,0,0,21,10,11,0,0.0,0.0
1012,741,24-09-2019 12:20:00,1,2509.0,1818.0,0.724,11.898,40,6,2,4,34,19,15,0,0.0,0.0
1012,742,24-09-2019 12:22:00,1,2463.0,1798.5,0.73,11.696,9,0,0,0,9,2,7,0,0.0,0.0
1012,743,24-09-2019 12:24:00,1,2417.0,1779.0,0.736,11.494,27,7,3,4,20,6,14,0,0.0,0.0
1012,744,24-09-2019 12:26:00,1,2405.0,1813.0,0.754,11.484,157,30,14,16,127,90,37,0,0.0,0.0
1012,745,24-09-2019 12:28:00,1,2607.0,1987.0,0.762,12.472,219,67,42,25,152,112,40,0,0.0,0.0
1012,746,24-09-2019 12:30:00,1,2812.0,2134.0,0.759,13.442,671,355,284,71,316,246,70,36,0.0,0.0
1012,747,24-09-2019 12:32:00,1,2713.0,2022.0,0.745,12.926,361,201,146,55,160,113,47,18,0.0,0.0
1012,748,24-09-2019 12:34:00,1,2700.0,2100.0,0.778,12.964,133,68,37,31,65,34,31,0,0.0,0.0
1012,749,24-09-2019 12:36:00,1,3091.0,2321.0,0.751,14.748,585,223,171,52,362,267,95,3,0.0,0.0
1012,750,24-09-2019 12:38:00,1,2928.0,2146.0,0.733,13.912,480,253,202,51,227,174,53,72,0.0,0.0
1012,751,24-09-2019 12:40:00,1,3001.0,2242.0,0.747,14.305,178,83,65,18,95,73,22,171,0.0,0.0
1012,752,24-09-2019 12:42:00,1,3082.0,2429.0,0.788,14.834,269,100,74,26,169,131,38,20,0.0,0.0
1012,753,24-09-2019 12:44:00,1,3105.0,2337.0,0.753,14.822,29,9,1,8,20,3,17,0,0.0,0.0
1012,754,24-09-2019 12:46:00,1,3106.0,2359.0,0.759,14.85,93,16,5,11,77,40,37,5,0.0,0.0
1012,755,24-09-2019 12:48:00,1,3105.0,2350.0,0.757,14.836,112,20,2,18,92,46,46,0,0.0,0.0
1012,756,24-09-2019 12:50:00,1,3077.0,2410.0,0.783,14.792,55,14,1,13,41,12,29,0,0.0,0.0
1012,757,24-09-2019 12:52:00,1,3077.0,2472.0,0.803,14.862,124,24,7,17,100,60,40,0,0.0,0.0
1012,758,24-09-2019 12:54:00,1,3086.0,2437.0,0.79,14.857,45,9,2,7,36,13,23,0,0.0,0.0
1012,759,24-09-2019 12:56:00,1,2956.0,2232.5,0.754,14.1175,49,0,0,0,49,29,20,0,0.0,0.0
1012,760,24-09-2019 12:58:00,1,2826.0,2028.0,0.718,13.378,62,1,0,1,61,20,41,0,0.0,0.0
1012,761,24-09-2019 13:00:00,1,2604.0,1946.0,0.747,12.413,37,0,0,0,37,0,37,0,0.0,0.0
1012,762,24-09-2019 13:02:00,1,2626.0,1887.0,0.719,12.434,52,8,4,4,44,5,39,0,0.0,0.0
1012,763,24-09-2019 13:04:00,1,2636.0,1875.0,0.711,12.462,39,0,0,0,39,4,35,0,0.0,0.0
1012,764,24-09-2019 13:06:00,1,2624.0,1852.0,0.706,12.388,121,0,0,0,121,80,41,0,0.0,0.0
1012,765,24-09-2019 13:08:00,1,2525.0,1820.0,0.721,11.964,39,0,0,0,39,0,39,0,0.0,0.0
1012,766,24-09-2019 13:10:00,1,2545.0,1767.0,0.694,11.982,35,1,1,0,34,4,30,0,0.0,0.0
1012,767,24-09-2019 13:12:00,1,2643.0,1832.0,0.693,12.442,54,10,0,10,44,2,42,0,0.0,0.0
1012,768,24-09-2019 13:14:00,1,2635.0,1850.0,0.702,12.43,51,1,0,1,50,8,42,0,0.0,0.0
1012,769,24-09-2019 13:16:00,1,2516.0,1831.0,0.728,11.943,48,3,0,3,45,0,45,0,0.0,0.0
1012,770,24-09-2019 13:18:00,1,2627.0,1882.0,0.716,12.435,42,5,0,5,37,0,37,0,0.0,0.0
1012,771,24-09-2019 13:20:00,1,2624.0,1884.0,0.718,12.424,51,1,0,1,50,2,48,0,0.0,0.0
1012,772,24-09-2019 13:22:00,1,2518.0,1827.0,0.726,11.943,43,0,0,0,43,2,41,0,0.0,0.0
1012,773,24-09-2019 13:24:00,1,2647.0,1823.0,0.688,12.45,40,0,0,0,40,2,38,0,0.0,0.0
1012,774,24-09-2019 13:26:00,1,2636.0,1860.0,0.706,12.445,19,0,0,0,19,1,18,0,0.0,0.0
1012,775,24-09-2019 13:28:00,1,2657.0,1806.0,0.68,12.467,8,0,0,0,8,2,6,0,0.0,0.0
1012,776,24-09-2019 13:30:00,1,2635.0,1846.5,0.701,12.4255,16,6,1,5,10,1,9,0,0.0,0.0
1012,777,24-09-2019 13:32:00,1,2613.0,1887.0,0.722,12.384,52,1,0,1,51,18,33,0,0.0,0.0
1012,778,24-09-2019 13:34:00,1,2622.0,1891.0,0.721,12.426,28,0,0,0,28,10,18,0,0.0,0.0
1012,779,24-09-2019 13:36:00,1,2634.0,1866.0,0.708,12.446,40,10,8,2,30,14,16,0,0.0,0.0
1012,780,24-09-2019 13:38:00,1,2411.0,1778.0,0.738,11.467,3,0,0,0,3,0,3,0,0.0,0.0
1012,781,24-09-2019 13:40:00,1,2432.0,1710.0,0.703,11.476,8,2,0,2,6,2,4,0,0.0,0.0
1012,782,24-09-2019 13:42:00,1,2420.0,1719.0,0.711,11.437,3,0,0,0,3,0,3,0,0.0,0.0
1012,783,24-09-2019 13:44:00,1,2434.0,1744.0,0.717,11.522,23,9,5,4,14,7,7,0,0.0,0.0
1012,784,24-09-2019 13:46:00,1,2520.0,1809.0,0.718,11.933,9,0,0,0,9,1,8,0,0.0,0.0
1012,785,24-09-2019 13:48:00,1,2603.0,1932.0,0.742,12.394,5,0,0,0,5,2,3,0,0.0,0.0
1012,786,24-09-2019 13:50:00,1,2598.0,1960.0,0.754,12.406,3,0,0,0,3,0,3,0,0.0,0.0
1012,787,24-09-2019 13:52:00,1,2704.0,1999.0,0.739,12.869,8,0,0,0,8,0,8,0,0.0,0.0
1012,788,24-09-2019 13:54:00,1,2712.0,2027.0,0.748,12.929,11,0,0,0,11,7,4,0,0.0,0.0
1012,789,24-09-2019 13:56:00,1,2604.0,1945.0,0.747,12.412,14,0,0,0,14,9,5,0,0.0,0.0
1012,790,24-09-2019 13:58:00,1,2513.0,1873.0,0.745,11.977,44,20,8,12,24,12,12,0,0.0,0.0
1012,791,24-09-2019 14:00:00,1,2401.0,1838.0,0.766,11.493,73,2,0,2,71,41,30,0,0.0,0.0
1012,792,24-09-2019 14:02:00,1,2382.0,1890.0,0.793,11.479,39,0,0,0,39,23,16,0,0.0,0.0
1012,793,24-09-2019 14:04:00,1,2466.5,1805.0,0.7335,11.717,24,0,0,0,24,1,23,0,0.0,0.0
1012,794,24-09-2019 14:06:00,1,2551.0,1720.0,0.674,11.955,43,4,2,2,39,16,23,0,0.0,0.0
1012,795,24-09-2019 14:08:00,1,2551.0,1718.0,0.673,11.955,72,2,0,2,70,36,34,0,0.0,0.0
1012,796,24-09-2019 14:10:00,1,2549.0,1693.0,0.664,11.917,34,0,0,0,34,10,24,0,0.0,0.0
1012,797,24-09-2019 14:12:00,1,2547.0,1710.0,0.671,11.929,32,0,0,0,32,2,30,0,0.0,0.0
1012,798,24-09-2019 14:14:00,1,2551.0,1714.0,0.672,11.95,48,0,0,0,48,13,35,0,0.0,0.0
1012,799,24-09-2019 14:16:00,1,2565.0,1678.0,0.654,11.964,45,17,9,8,28,12,16,0,0.0,0.0
1012,800,24-09-2019 14:18:00,1,2538.0,1768.0,0.697,11.958,11,1,0,1,10,4,6,0,0.0,0.0
1012,801,24-09-2019 14:20:00,1,2534.0,1735.0,0.685,11.908,13,3,2,1,10,3,7,0,0.0,0.0
1012,802,24-09-2019 14:22:00,1,2441.0,1664.0,0.682,11.461,6,3,0,3,3,0,3,0,0.0,0.0
1012,803,24-09-2019 14:24:00,1,2323.0,1638.0,0.705,10.967,18,1,0,1,17,6,11,0,0.0,0.0
1012,804,24-09-2019 14:26:00,1,2448.0,1655.0,0.676,11.477,5,0,0,0,5,0,5,0,0.0,0.0
1012,805,24-09-2019 14:28:00,1,2456.0,1673.0,0.681,11.528,8,4,1,3,4,0,4,0,0.0,0.0
1012,806,24-09-2019 14:30:00,1,2325.0,1617.0,0.695,10.952,35,25,9,16,10,4,6,0,0.0,0.0
1012,807,24-09-2019 14:32:00,1,2531.0,1798.0,0.71,11.964,53,28,11,17,25,13,12,0,0.0,0.0
1012,808,24-09-2019 14:34:00,1,2751.0,1860.0,0.676,12.897,165,117,78,39,48,24,24,1,0.0,0.0
1012,809,24-09-2019 14:36:00,1,2722.0,1942.0,0.713,12.875,51,25,7,18,26,12,14,0,0.0,0.0
1012,810,24-09-2019 14:38:00,1,2823.5,2034.5,0.72,13.377,276,128,93,35,148,110,38,18,0.0,0.0
1012,811,24-09-2019 14:40:00,1,2925.0,2127.0,0.727,13.879,316,200,159,41,116,88,28,43,0.0,0.0
1012,812,24-09-2019 14:42:00,1,2914.0,2122.0,0.728,13.83,120,54,25,29,66,47,19,0,0.0,0.0
1012,813,24-09-2019 14:44:00,1,2918.0,2143.0,0.734,13.872,57,31,3,28,26,10,16,0,0.0,0.0
1012,814,24-09-2019 14:46:00,1,2919.0,2105.0,0.721,13.831,14,2,0,2,12,6,6,0,0.0,0.0
1012,815,24-09-2019 14:48:00,1,2586.0,2003.0,0.775,12.406,6,0,0,0,6,0,6,0,0.0,0.0
1012,816,24-09-2019 14:50:00,1,2655.0,1836.0,0.692,12.494,20,0,0,0,20,13,7,0,0.0,0.0
1012,817,24-09-2019 14:52:00,1,2402.0,1762.0,0.733,11.414,63,4,1,3,59,48,11,0,0.0,0.0
1012,818,24-09-2019 14:54:00,1,2416.0,1738.0,0.719,11.445,8,1,0,1,7,4,3,0,0.0,0.0
1012,819,24-09-2019 14:56:00,1,2425.0,1713.0,0.707,11.452,27,6,2,4,21,8,13,0,0.0,0.0
1012,820,24-09-2019 14:58:00,1,2436.0,1713.0,0.703,11.495,21,5,1,4,16,4,12,0,0.0,0.0
1012,821,24-09-2019 15:00:00,1,2425.0,1760.0,0.726,11.502,14,1,0,1,13,0,13,0,0.0,0.0
1012,822,24-09-2019 15:02:00,1,2414.0,1759.0,0.729,11.459,23,4,1,3,19,9,10,0,0.0,0.0
1012,823,24-09-2019 15:04:00,1,2637.0,1842.0,0.698,12.43,14,0,0,0,14,2,12,0,0.0,0.0
1012,824,24-09-2019 15:06:00,1,2639.0,1858.0,0.704,12.457,26,9,3,6,17,10,7,0,0.0,0.0
1012,825,24-09-2019 15:08:00,1,2628.0,1829.0,0.696,12.381,18,4,0,4,14,3,11,0,0.0,0.0
1012,826,24-09-2019 15:10:00,1,2422.0,1732.0,0.715,11.461,11,0,0,0,11,0,11,0,0.0,0.0
1012,827,24-09-2019 15:12:00,1,2475.5,1763.5,0.7125,11.706,32,4,3,1,28,12,16,0,0.0,0.0
1012,828,24-09-2019 15:14:00,1,2529.0,1795.0,0.71,11.951,15,0,0,0,15,4,11,0,0.0,0.0
1012,829,24-09-2019 15:16:00,1,2647.0,1814.0,0.685,12.438,19,0,0,0,19,2,17,0,0.0,0.0
1012,830,24-09-2019 15:18:00,1,2754.0,1793.0,0.651,12.837,28,0,0,0,28,9,19,0,0.0,0.0
1012,831,24-09-2019 15:20:00,1,2766.0,1785.0,0.645,12.876,16,0,0,0,16,7,9,0,0.0,0.0
1012,832,24-09-2019 15:22:00,1,2774.0,1765.0,0.637,12.883,109,9,6,3,100,83,17,0,0.0,0.0
1012,833,24-09-2019 15:24:00,1,2763.0,1797.0,0.65,12.874,74,0,0,0,74,66,8,0,0.0,0.0
1012,834,24-09-2019 15:26:00,1,2535.0,1771.0,0.699,11.948,124,0,0,0,124,102,22,0,0.0,0.0
1012,835,24-09-2019 15:28:00,1,2572.0,1657.0,0.644,11.968,29,4,1,3,25,23,2,0,0.0,0.0
1012,836,24-09-2019 15:30:00,1,2574.0,1629.0,0.633,11.945,41,1,0,1,40,34,6,0,0.0,0.0
1012,837,24-09-2019 15:32:00,1,2565.0,1651.0,0.644,11.933,27,2,1,1,25,22,3,0,0.0,0.0
1012,838,24-09-2019 15:34:00,1,2580.0,1633.0,0.633,11.975,359,1,0,1,358,326,32,0,0.0,0.0
1012,839,24-09-2019 15:36:00,1,2588.0,1570.0,0.607,11.937,149,12,0,12,137,125,12,0,0.0,0.0
1012,840,24-09-2019 15:38:00,1,2333.0,1614.0,0.692,10.978,28,0,0,0,28,26,2,0,0.0,0.0
1012,841,24-09-2019 15:40:00,1,2579.0,1618.0,0.627,11.955,36,1,0,1,35,34,1,0,0.0,0.0
1012,842,24-09-2019 15:42:00,1,2573.0,1677.0,0.652,11.995,82,3,0,3,79,71,8,0,0.0,0.0
1012,843,24-09-2019 15:44:00,1,2571.0,1647.0,0.641,11.956,24,0,0,0,24,22,2,0,0.0,0.0
1012,844,24-09-2019 15:46:00,1,2454.5,1622.5,0.6625,11.468,35,0,0,0,35,31,4,0,0.0,0.0
1012,845,24-09-2019 15:48:00,1,2338.0,1598.0,0.684,10.98,49,8,0,8,41,38,3,0,0.0,0.0
1012,846,24-09-2019 15:50:00,1,2447.0,1644.0,0.672,11.463,17,1,0,1,16,16,0,0,0.0,0.0
1012,847,24-09-2019 15:52:00,1,2449.0,1648.0,0.673,11.475,46,5,0,5,41,36,5,0,0.0,0.0
1012,848,24-09-2019 15:54:00,1,2447.0,1627.0,0.665,11.444,32,2,0,2,30,27,3,0,0.0,0.0
1012,849,24-09-2019 15:56:00,1,2344.0,1604.0,0.684,11.014,209,37,12,25,172,120,52,0,0.0,0.0
1012,850,24-09-2019 15:58:00,1,2632.0,1845.0,0.701,12.415,208,11,1,10,197,165,32,0,0.0,0.0
1012,851,24-09-2019 16:00:00,1,2745.0,1916.0,0.698,12.937,343,147,104,43,196,144,52,107,0.0,0.0
1012,852,24-09-2019 16:02:00,1,3012.0,2229.0,0.74,14.335,275,103,86,17,172,114,58,84,0.0,0.0
1012,853,24-09-2019 16:04:00,1,3247.0,2269.0,0.699,15.306,350,163,132,31,187,137,50,73,0.0,0.0
1012,854,24-09-2019 16:06:00,1,3030.0,2234.0,0.737,14.413,245,104,84,20,141,100,41,67,0.0,0.0
1012,855,24-09-2019 16:08:00,1,3259.0,2261.0,0.694,15.345,201,103,75,28,98,48,50,78,0.0,0.0
1012,856,24-09-2019 16:10:00,1,3235.0,2275.0,0.703,15.265,279,119,82,37,160,113,47,21,0.0,0.0
1012,857,24-09-2019 16:12:00,1,2733.0,1960.0,0.717,12.94,151,85,75,10,66,48,18,144,0.0,0.0
1012,858,24-09-2019 16:14:00,1,3030.0,2171.0,0.717,14.341,260,134,110,24,126,96,30,166,0.0,0.0
1012,859,24-09-2019 16:16:00,1,3254.0,2217.0,0.681,15.277,221,127,95,32,94,73,21,132,0.0,0.0
1012,860,24-09-2019 16:18:00,1,3448.0,2431.0,0.705,16.276,114,57,46,11,57,44,13,46,0.0,0.0
1012,861,24-09-2019 16:20:00,1,3276.5,2384.5,0.729,15.55,29,14,4,10,15,6,9,0,0.0,0.0
1012,862,24-09-2019 16:22:00,1,3105.0,2338.0,0.753,14.824,44,13,5,8,31,13,18,0,0.0,0.0
1012,863,24-09-2019 16:24:00,1,3102.0,2377.0,0.766,14.855,91,54,21,33,37,7,30,0,0.0,0.0
1012,864,24-09-2019 16:26:00,1,3308.0,2442.0,0.738,15.736,137,39,17,22,98,57,41,0,0.0,0.0
1012,865,24-09-2019 16:28:00,1,3428.0,2463.0,0.719,16.234,507,281,211,70,226,180,46,5,0.0,0.01
1012,866,24-09-2019 16:30:00,1,3312.0,2507.0,0.757,15.826,563,337,268,69,226,165,61,14,0.0,0.0
1012,867,24-09-2019 16:32:00,1,3411.0,2472.0,0.725,16.178,498,267,220,47,231,170,61,13,0.0,0.0
1012,868,24-09-2019 16:34:00,1,3138.0,2251.0,0.717,14.854,110,53,31,22,57,35,22,0,0.0,0.0
1012,869,24-09-2019 16:36:00,1,3107.0,2305.0,0.742,14.795,67,23,3,20,44,24,20,0,0.0,0.0
1012,870,24-09-2019 16:38:00,1,3114.0,2270.0,0.729,14.782,40,16,0,16,24,8,16,0,0.0,0.0
1012,871,24-09-2019 16:40:00,1,3114.0,2271.0,0.729,14.782,11,1,0,1,10,0,10,0,0.0,0.0
1012,872,24-09-2019 16:42:00,1,2921.0,2126.0,0.728,13.862,9,0,0,0,9,0,9,0,0.0,0.0
1012,873,24-09-2019 16:44:00,1,2845.0,1999.0,0.703,13.424,18,3,2,1,15,4,11,0,0.0,0.0
1012,874,24-09-2019 16:46:00,1,2610.0,1942.0,0.744,12.432,3,0,0,0,3,0,3,0,0.0,0.0
1012,875,24-09-2019 16:48:00,1,2630.0,1890.0,0.719,12.455,25,10,2,8,15,5,10,0,0.0,0.0
1012,876,24-09-2019 16:50:00,1,2627.0,1899.0,0.723,12.452,14,2,1,1,12,4,8,0,0.0,0.0
1012,877,24-09-2019 16:52:00,1,2613.0,1898.0,0.726,12.398,9,2,1,1,7,2,5,0,0.0,0.0
1012,878,24-09-2019 16:54:00,1,2676.5,1872.0,0.7,12.6185,23,1,0,1,22,11,11,0,0.0,0.0
1012,879,24-09-2019 16:56:00,1,2740.0,1846.0,0.674,12.839,50,18,5,13,32,17,15,0,0.0,0.0
1012,880,24-09-2019 16:58:00,1,2732.0,1944.0,0.712,12.919,11,2,0,2,9,0,9,0,0.0,0.0
1012,881,24-09-2019 17:00:00,1,2759.0,1837.0,0.666,12.904,21,2,0,2,19,0,19,0,0.0,0.0
1012,882,24-09-2019 17:02:00,1,2760.0,1827.0,0.662,12.896,15,0,0,0,15,6,9,0,0.0,0.0
1012,883,24-09-2019 17:04:00,1,2759.0,1842.0,0.668,12.91,18,2,1,1,16,5,11,0,0.0,0.0
1012,884,24-09-2019 17:06:00,1,2658.0,1752.0,0.659,12.414,26,5,2,3,21,3,18,0,0.0,0.0
1012,885,24-09-2019 17:08:00,1,2547.0,1728.0,0.678,11.949,25,3,1,2,22,5,17,0,0.0,0.0
1012,886,24-09-2019 17:10:00,1,2552.0,1677.0,0.657,11.914,20,0,0,0,20,0,20,0,0.0,0.0
1012,887,24-09-2019 17:12:00,1,2333.0,1601.0,0.686,10.964,17,2,0,2,15,2,13,0,0.0,0.0
1012,888,24-09-2019 17:14:00,1,2335.0,1601.0,0.686,10.972,32,13,2,11,19,2,17,0,0.0,0.0
1012,889,24-09-2019 17:16:00,1,2339.0,1536.0,0.657,10.916,62,17,0,17,45,19,26,0,0.0,0.0
1012,890,24-09-2019 17:18:00,1,2536.0,1756.0,0.692,11.935,182,115,71,44,67,35,32,3,0.0,0.0
1012,891,24-09-2019 17:20:00,1,2740.0,1915.0,0.699,12.915,99,39,26,13,60,43,17,13,0.0,0.0
1012,892,24-09-2019 17:22:00,1,2740.0,1922.0,0.701,12.925,14,3,1,2,11,0,11,0,0.0,0.0
1012,893,24-09-2019 17:24:00,1,2649.0,1752.0,0.662,12.377,13,1,0,1,12,0,12,0,0.0,0.0
1012,894,24-09-2019 17:26:00,1,2524.0,1748.0,0.692,11.881,7,0,0,0,7,0,7,0,0.0,0.0
1012,895,24-09-2019 17:28:00,1,2368.5,1685.5,0.7125,11.199,17,1,0,1,16,0,16,0,0.0,0.0
1012,896,24-09-2019 17:30:00,1,2213.0,1623.0,0.733,10.517,11,0,0,0,11,0,11,0,0.0,0.0
1012,897,24-09-2019 17:32:00,1,2213.0,1600.0,0.723,10.493,13,6,0,6,7,0,7,0,0.0,0.0
1012,898,24-09-2019 17:34:00,1,2337.0,1645.0,0.704,11.028,14,3,0,3,11,4,7,0,0.0,0.0
1012,899,24-09-2019 17:36:00,1,2438.0,1675.0,0.687,11.46,27,2,0,2,25,5,20,0,0.0,0.0
1012,900,24-09-2019 17:38:00,1,2440.0,1647.0,0.675,11.437,37,1,0,1,36,19,17,0,0.0,0.0
1012,901,24-09-2019 17:40:00,1,2435.0,1716.0,0.705,11.496,14,0,0,0,14,5,9,0,0.0,0.0
1012,902,24-09-2019 17:42:00,1,2657.0,1753.0,0.66,12.409,16,0,0,0,16,4,12,0,0.0,0.0
1012,903,24-09-2019 17:44:00,1,2635.0,1829.0,0.694,12.407,23,0,0,0,23,7,16,0,0.0,0.0
1012,904,24-09-2019 17:46:00,1,2656.0,1757.0,0.662,12.409,11,0,0,0,11,0,11,0,0.0,0.0
1012,905,24-09-2019 17:48:00,1,2423.0,1720.0,0.71,11.45,16,1,1,0,15,3,12,0,0.0,0.0
1012,906,24-09-2019 17:50:00,1,2428.0,1717.0,0.707,11.468,148,65,47,18,83,56,27,31,0.0,0.0
1012,907,24-09-2019 17:52:00,1,2956.0,2033.0,0.688,13.896,295,155,114,41,140,90,50,111,0.0,0.0
1012,908,24-09-2019 17:54:00,1,2932.0,2096.0,0.715,13.874,130,53,44,9,77,32,45,62,0.0,0.0
1012,909,24-09-2019 17:56:00,1,3137.0,2251.0,0.717,14.853,187,98,64,34,89,52,37,65,0.0,0.0
1012,910,24-09-2019 17:58:00,1,2998.0,2277.0,0.76,14.335,199,104,63,41,95,50,45,62,0.0,0.0
1012,911,24-09-2019 18:00:00,0,3225.0,2358.0,0.731,15.319,130,74,54,20,56,33,23,17,0.0,0.0
1012,912,24-09-2019 18:02:00,0,3027.5,2193.0,0.7235,14.357,114,43,14,29,71,36,35,0,0.0,0.0
1012,913,24-09-2019 18:04:00,0,2830.0,2028.0,0.716,13.395,176,26,11,15,150,106,44,0,0.0,0.0
1012,914,24-09-2019 18:06:00,0,2953.0,1997.0,0.676,13.845,166,59,23,36,107,59,48,0,0.0,0.0
1012,915,24-09-2019 18:08:00,0,2922.0,2084.0,0.713,13.822,364,177,137,40,187,144,43,156,0.0,0.0
1012,916,24-09-2019 18:10:00,0,3411.0,2500.0,0.733,16.208,391,229,190,39,162,125,37,95,0.0,0.0
1012,917,24-09-2019 18:12:00,0,3721.0,2732.0,0.734,17.685,348,170,142,28,178,139,39,153,0.0,0.02
1012,918,24-09-2019 18:14:00,0,3419.0,2545.0,0.744,16.289,208,112,91,21,96,76,20,150,0.0,0.0
1012,919,24-09-2019 18:16:00,0,3431.0,2508.0,0.731,16.296,144,82,64,18,62,47,15,99,0.0,0.0
1012,920,24-09-2019 18:18:00,0,3609.0,2668.0,0.739,17.175,257,135,104,31,122,83,39,188,0.0,0.0
1012,921,24-09-2019 18:20:00,0,4149.0,2966.0,0.715,19.631,169,99,64,35,70,11,59,63,0.0,0.0
1012,922,24-09-2019 18:22:00,0,4108.0,2991.0,0.728,19.496,184,77,49,28,107,54,53,46,0.0,0.0
1012,923,24-09-2019 18:24:00,0,3525.0,2551.0,0.724,16.715,170,42,15,27,128,90,38,1,0.0,0.0
1012,924,24-09-2019 18:26:00,0,3337.0,2320.0,0.695,15.717,100,38,11,27,62,36,26,0,0.0,0.0
1012,925,24-09-2019 18:28:00,0,3643.0,2558.0,0.702,17.186,236,119,78,41,117,72,45,40,0.0,0.0
1012,926,24-09-2019 18:30:00,0,4100.0,3053.0,0.745,19.536,59,33,22,11,26,11,15,80,0.0,0.0
1012,927,24-09-2019 18:32:00,0,3347.0,2413.0,0.721,15.859,165,84,65,19,81,44,37,107,0.0,0.0
1012,928,24-09-2019 18:34:00,0,4198.0,3160.0,0.753,20.038,142,83,45,38,59,21,38,60,0.0,0.0
1012,929,24-09-2019 18:36:00,0,4246.5,3222.5,0.759,20.3,163,76,42,34,87,44,43,49,0.0,0.0
1012,930,24-09-2019 18:38:00,0,4295.0,3285.0,0.765,20.562,173,71,43,28,102,53,49,69,0.0,0.0
1012,931,24-09-2019 18:40:00,0,4272.0,3313.0,0.775,20.501,134,75,43,32,59,17,42,72,0.0,0.0
1012,932,24-09-2019 18:42:00,0,4082.0,3246.0,0.795,19.677,274,136,96,40,138,99,39,56,0.0,0.0
1012,933,24-09-2019 18:44:00,0,3722.0,2743.0,0.737,17.703,206,121,101,20,85,64,21,122,0.0,0.0
1012,934,24-09-2019 18:46:00,0,3819.0,2834.0,0.742,18.184,27,8,5,3,19,7,12,0,0.0,0.0
1012,935,24-09-2019 18:48:00,0,3605.0,2716.0,0.753,17.211,300,151,117,34,149,112,37,30,0.0,0.02
1012,936,24-09-2019 18:50:00,0,3567.0,2825.0,0.792,17.18,305,169,140,29,136,111,25,177,0.0,0.0
1012,937,24-09-2019 18:52:00,0,3691.0,2840.0,0.769,17.687,211,59,43,16,152,90,62,63,0.0,0.0
1012,938,24-09-2019 18:54:00,0,4256.0,3402.0,0.799,20.534,138,67,43,24,71,27,44,60,0.0,0.01
1012,939,24-09-2019 18:56:00,0,4267.0,3355.0,0.786,20.528,155,85,51,34,70,35,35,64,0.0,0.07
1012,940,24-09-2019 18:58:00,0,4234.0,3533.0,0.834,20.593,221,102,75,27,119,84,35,50,0.01,0.01
1012,941,24-09-2019 19:00:00,0,4002.0,3491.0,0.872,19.631,259,129,107,22,130,107,23,173,0.01,0.0
1012,942,24-09-2019 19:02:00,0,3775.0,3007.0,0.796,18.204,385,180,147,33,205,162,43,156,0.05,0.0
1012,943,24-09-2019 19:04:00,0,3349.0,2730.0,0.815,16.218,337,172,137,35,165,126,39,172,0.04,0.0
1012,944,24-09-2019 19:06:00,0,3695.0,3259.0,0.882,18.168,314,161,136,25,153,122,31,186,0.04,0.01
1012,945,24-09-2019 19:08:00,0,4305.0,3742.0,0.869,21.106,173,98,66,32,75,59,16,115,0.01,0.04
1012,946,24-09-2019 19:10:00,0,4114.5,3561.5,0.8655,20.156,266,151,117,34,115,93,22,110,0.0,0.01
1012,947,24-09-2019 19:12:00,0,3924.0,3381.0,0.862,19.206,359,180,137,43,179,143,36,106,0.0,0.0
1012,948,24-09-2019 19:14:00,0,4836.0,4016.0,0.83,23.502,231,126,100,26,105,75,30,61,0.0,0.0
1012,949,24-09-2019 19:16:00,0,3266.0,2628.0,0.805,15.776,205,87,41,46,118,78,40,17,0.0,0.0
1012,950,24-09-2019 19:18:00,0,4137.0,3432.0,0.829,20.099,282,143,115,28,139,108,31,146,0.0,0.0
1012,951,24-09-2019 19:20:00,0,4921.0,4101.0,0.833,23.93,136,39,23,16,97,55,42,52,0.02,0.0
1012,952,24-09-2019 19:22:00,0,4968.0,4350.0,0.876,24.389,147,63,38,25,84,55,29,15,0.0,0.0
1012,953,24-09-2019 19:24:00,0,3464.0,2838.0,0.82,16.789,41,18,11,7,23,10,13,3,0.0,0.0
1012,954,24-09-2019 19:26:00,0,3068.0,2488.0,0.811,14.844,294,127,110,17,167,130,37,110,0.0,0.0
1012,955,24-09-2019 19:28:00,0,4131.0,3442.0,0.833,20.087,166,43,20,23,123,75,48,29,0.0,0.0
1012,956,24-09-2019 19:30:00,0,4963.0,4397.0,0.886,24.423,236,97,70,27,139,81,58,82,0.0,0.06
1012,957,24-09-2019 19:32:00,0,4700.0,4056.0,0.863,23.007,332,135,101,34,197,142,55,126,0.03,0.0
1012,958,24-09-2019 19:34:00,0,4205.0,3699.0,0.88,20.661,423,100,71,29,323,238,85,64,0.0,0.0
1012,959,24-09-2019 19:36:00,0,3552.0,2868.0,0.807,17.169,163,47,29,18,116,89,27,0,0.0,0.0
1012,960,24-09-2019 19:38:00,0,4097.0,3537.0,0.863,20.059,96,20,6,14,76,38,38,0,0.0,0.0
1012,961,24-09-2019 19:40:00,0,3723.0,3203.0,0.86,18.216,228,24,11,13,204,160,44,0,0.0,0.0
1012,962,24-09-2019 19:42:00,0,4487.0,3927.0,0.875,22.028,458,91,52,39,367,316,51,48,0.0,0.0
1012,963,24-09-2019 19:44:00,0,4441.0,3876.0,0.8725,21.7905,252,86,59,27,166,110,56,44,0.0,0.0
1012,964,24-09-2019 19:46:00,0,4395.0,3825.0,0.87,21.553,257,76,47,29,181,124,57,42,0.0,0.0
1012,965,24-09-2019 19:48:00,0,4595.0,3904.0,0.85,22.426,137,17,1,16,120,75,45,12,0.0,0.03
1012,966,24-09-2019 19:50:00,0,4861.0,4269.0,0.878,23.878,112,15,0,15,97,67,30,8,0.0,0.02
1012,967,24-09-2019 19:52:00,0,4749.0,4264.0,0.898,23.431,129,25,1,24,104,66,38,14,0.0,0.07
1012,968,24-09-2019 19:54:00,0,4160.0,3797.0,0.913,20.594,274,126,105,21,148,100,48,126,0.05,0.07
1012,969,24-09-2019 19:56:00,0,3819.0,3313.0,0.868,18.714,251,118,88,30,133,99,34,127,0.06,0.0
1012,970,24-09-2019 19:58:00,0,4169.0,3793.0,0.91,20.623,307,155,118,37,152,109,43,75,0.0,0.0
1012,971,24-09-2019 20:00:00,0,4253.0,3860.0,0.908,21.03,412,202,166,36,210,164,46,166,0.01,0.0
1012,972,24-09-2019 20:02:00,0,3502.0,3109.0,0.888,17.239,260,86,59,27,174,123,51,39,0.02,0.0
1012,973,24-09-2019 20:04:00,0,3693.0,3332.0,0.902,18.239,359,191,155,36,168,126,42,161,0.01,0.0
1012,974,24-09-2019 20:06:00,0,4161.0,3772.0,0.907,20.569,216,86,55,31,130,76,54,92,0.01,0.0
1012,975,24-09-2019 20:08:00,0,3897.0,3472.0,0.891,19.199,278,136,106,30,142,115,27,116,0.03,0.02
1012,976,24-09-2019 20:10:00,0,4828.0,4396.0,0.911,23.889,126,52,39,13,74,46,28,90,0.02,0.0
1012,977,24-09-2019 20:12:00,0,4573.0,4055.0,0.887,22.508,145,49,33,16,96,41,55,45,0.01,0.0
1012,978,24-09-2019 20:14:00,0,4857.0,4279.0,0.881,23.874,198,61,31,30,137,65,72,36,0.0,0.0
1012,979,24-09-2019 20:16:00,0,4664.0,4165.0,0.893,22.988,191,69,37,32,122,64,58,11,0.0,0.06
1012,980,24-09-2019 20:18:00,0,4081.0,3657.5,0.897,20.129,57,20,11,9,37,18,19,1,0.0,0.01
1012,981,24-09-2019 20:20:00,0,3498.0,3150.0,0.901,17.27,87,38,28,10,49,31,18,0,0.0,0.0
1012,982,24-09-2019 20:22:00,0,3324.0,2861.0,0.861,16.265,75,2,0,2,73,13,60,0,0.0,0.0
1012,983,24-09-2019 20:24:00,0,3414.0,2976.0,0.872,16.747,45,4,2,2,41,12,29,0,0.0,0.0
1012,984,24-09-2019 20:26:00,0,3321.0,2888.0,0.87,16.282,52,2,0,2,50,11,39,0,0.0,0.0
1012,985,24-09-2019 20:28:00,0,3333.0,2870.0,0.861,16.311,60,6,2,4,54,15,39,0,0.0,0.0
1012,986,24-09-2019 20:30:00,0,3325.0,2865.0,0.862,16.274,23,2,1,1,21,4,17,0,0.0,0.0
1012,987,24-09-2019 20:32:00,0,3029.0,2631.0,0.869,14.846,28,6,1,5,22,9,13,0,0.0,0.01
1012,988,24-09-2019 20:34:00,0,2829.0,2488.0,0.88,13.9,55,7,0,7,48,20,28,0,0.0,0.0
1012,989,24-09-2019 20:36:00,0,3037.0,2564.0,0.844,14.805,53,3,0,3,50,19,31,0,0.0,0.0
1012,990,24-09-2019 20:38:00,0,3204.0,2856.0,0.891,15.786,67,2,0,2,65,24,41,0,0.0,0.0
1012,991,24-09-2019 20:40:00,0,3299.0,3006.0,0.911,16.328,75,2,0,2,73,29,44,0,0.0,0.01
1012,992,24-09-2019 20:42:00,0,3288.0,2991.0,0.91,16.265,61,0,0,0,61,6,55,0,0.0,0.0
1012,993,24-09-2019 20:44:00,0,3305.0,2962.0,0.896,16.303,25,3,0,3,22,4,18,0,0.0,0.0
1012,994,24-09-2019 20:46:00,0,3278.0,3029.0,0.924,16.271,247,100,65,35,147,93,54,11,0.0,0.0
1012,995,24-09-2019 20:48:00,0,3935.0,3637.0,0.924,19.529,154,35,14,21,119,68,51,13,0.0,0.02
1012,996,24-09-2019 20:50:00,0,4134.0,3899.0,0.943,20.605,109,23,8,15,86,51,35,8,0.0,0.04
1012,997,24-09-2019 20:52:00,0,4029.0,3832.0,0.951,20.1175,135,49,25,24,86,58,28,10,0.0,0.04
1012,998,24-09-2019 20:54:00,0,3924.0,3765.0,0.959,19.63,455,212,166,46,243,184,59,161,0.03,0.02
1012,999,24-09-2019 20:56:00,0,3303.0,2964.0,0.897,16.295,300,136,112,24,164,126,38,147,0.07,0.0
1012,1000,24-09-2019 20:58:00,0,3487.0,3123.0,0.896,17.195,273,147,122,25,126,98,28,208,0.0,0.0
1012,1001,24-09-2019 21:00:00,0,3648.0,3466.0,0.95,18.212,240,109,81,28,131,93,38,102,0.0,0.0
1012,1002,24-09-2019 21:02:00,0,3965.0,3670.0,0.926,19.687,342,177,142,35,165,131,34,219,0.0,0.0
1012,1003,24-09-2019 21:04:00,0,3751.0,3518.0,0.938,18.675,138,70,55,15,68,50,18,169,0.01,0.0
1012,1004,24-09-2019 21:06:00,0,4143.0,3920.0,0.946,20.664,400,179,149,30,221,181,40,128,0.0,0.0
1012,1005,24-09-2019 21:08:00,0,4214.0,3985.0,0.945,21.016,243,94,72,22,149,111,38,179,0.0,0.0
1012,1006,24-09-2019 21:10:00,0,4124.0,3908.0,0.948,20.575,222,107,80,27,115,83,32,166,0.0,0.0
1012,1007,24-09-2019 21:12:00,0,4135.0,3938.0,0.952,20.653,191,59,43,16,132,55,77,40,0.0,0.04
1012,1008,24-09-2019 21:14:00,0,4810.0,4534.0,0.943,23.971,125,24,4,20,101,55,46,11,0.0,0.03
1012,1009,24-09-2019 21:16:00,0,4794.0,4631.0,0.966,24.013,121,47,30,17,74,49,25,27,0.0,0.01
1012,1010,24-09-2019 21:18:00,0,3640.0,3455.0,0.949,18.166,216,127,88,39,89,67,22,156,0.01,0.01
1012,1011,24-09-2019 21:20:00,0,4637.0,4276.0,0.922,23.005,206,124,98,26,82,52,30,101,0.01,0.02
1012,1012,24-09-2019 21:22:00,0,4725.0,4420.0,0.936,23.509,130,67,51,16,63,47,16,43,0.0,0.0
1012,1013,24-09-2019 21:24:00,0,4424.0,4214.0,0.953,22.094,255,118,94,24,137,95,42,152,0.0,0.0
1012,1014,24-09-2019 21:26:00,0,3759.5,3511.0,0.93,18.699,176,53,40,13,123,86,37,17,0.0,0.0
1012,1015,24-09-2019 21:28:00,0,3095.0,2808.0,0.907,15.304,305,102,73,29,203,143,60,91,0.01,0.0
1012,1016,24-09-2019 21:30:00,0,3684.0,3318.0,0.901,18.187,124,78,57,21,46,28,18,56,0.01,0.0
1012,1017,24-09-2019 21:32:00,0,4552.0,4153.0,0.912,22.533,202,47,30,17,155,83,72,70,0.0,0.0
1012,1018,24-09-2019 21:34:00,0,5085.0,4767.0,0.938,25.311,160,26,7,19,134,82,52,18,0.01,0.05
1012,1019,24-09-2019 21:36:00,0,5114.0,4810.0,0.941,25.476,146,20,2,18,126,56,70,7,0.0,0.06
1012,1020,24-09-2019 21:38:00,0,5094.0,4766.0,0.936,25.347,109,12,0,12,97,31,66,5,0.0,0.49
1012,1021,24-09-2019 21:40:00,0,4621.0,4283.0,0.927,22.946,11,8,1,7,3,1,2,0,0.0,0.0
1012,1022,24-09-2019 21:42:00,0,4436.0,4151.0,0.936,22.075,17,13,0,13,4,1,3,0,0.0,0.0
1012,1023,24-09-2019 21:44:00,0,4606.0,4312.0,0.936,22.919,234,131,101,30,103,73,30,46,0.07,0.0
1012,1024,24-09-2019 21:46:00,0,4152.0,3876.0,0.934,20.649,284,151,123,28,133,107,26,139,0.08,0.0
1012,1025,24-09-2019 21:48:00,0,4190.0,4093.0,0.977,21.039,399,208,166,42,191,148,43,132,0.01,0.01
1012,1026,24-09-2019 21:50:00,0,3939.0,3713.0,0.943,19.629,221,107,88,19,114,88,26,148,0.07,0.0
1012,1027,24-09-2019 21:52:00,0,4069.0,3774.0,0.928,20.21,143,77,62,15,66,42,24,96,0.0,0.0
1012,1028,24-09-2019 21:54:00,0,4916.0,4585.0,0.933,24.445,24,0,0,0,24,10,14,0,0.0,0.0
1012,1029,24-09-2019 21:56:00,0,5124.0,4756.0,0.928,25.453,32,0,0,0,32,15,17,0,0.0,0.0
1012,1030,24-09-2019 21:58:00,0,5094.0,4752.0,0.933,25.331,219,103,80,23,116,72,44,31,0.06,0.0
1012,1031,24-09-2019 22:00:00,0,4915.0,4584.0,0.9325,24.44,294,114,86,28,180,144,36,113,0.09,0.08
1012,1032,24-09-2019 22:02:00,0,4736.0,4416.0,0.932,23.549,228,98,68,30,130,90,40,83,0.0,0.0
1012,1033,24-09-2019 22:04:00,0,3700.0,3235.0,0.874,18.161,135,68,41,27,67,37,30,54,0.0,0.0
1012,1034,24-09-2019 22:06:00,0,4450.0,4068.0,0.914,22.036,423,185,145,40,238,179,59,138,0.03,0.0
1012,1035,24-09-2019 22:08:00,0,4457.0,4066.0,0.912,22.064,170,48,36,12,122,72,50,33,0.0,0.0
1012,1036,24-09-2019 22:10:00,0,3958.0,3567.0,0.901,19.545,380,175,143,32,205,163,42,208,0.04,0.0
1012,1037,24-09-2019 22:12:00,0,4478.0,4001.0,0.894,22.071,221,119,94,25,102,76,26,129,0.03,0.0
1012,1038,24-09-2019 22:14:00,0,4912.0,4593.0,0.935,24.437,186,89,68,21,97,72,25,109,0.0,0.01
1012,1039,24-09-2019 22:16:00,0,4720.0,4383.0,0.929,23.448,308,141,120,21,167,131,36,166,0.01,0.0
1012,1040,24-09-2019 22:18:00,0,3660.0,3377.0,0.923,18.161,268,130,98,32,138,106,32,141,0.02,0.0
1012,1041,24-09-2019 22:20:00,0,4626.0,4268.0,0.923,22.951,324,172,137,35,152,120,32,148,0.0,0.0
1012,1042,24-09-2019 22:22:00,0,4636.0,4266.0,0.92,22.989,265,98,60,38,167,113,54,53,0.0,0.0
1012,1043,24-09-2019 22:24:00,0,4645.0,4292.0,0.924,23.053,212,48,22,26,164,106,58,2,0.0,0.0
1012,1044,24-09-2019 22:26:00,0,4627.0,4324.0,0.934,23.018,158,48,30,18,110,59,51,1,0.0,0.0
1012,1045,24-09-2019 22:28:00,0,4736.0,4348.0,0.918,23.472,284,102,76,26,182,127,55,67,0.0,0.0
1012,1046,24-09-2019 22:30:00,0,5003.0,4733.0,0.946,24.951,413,159,128,31,254,203,51,250,0.0,0.0
1012,1047,24-09-2019 22:32:00,0,4705.0,4420.0,0.94,23.43,379,143,114,29,236,182,54,133,0.05,0.0
1012,1048,24-09-2019 22:34:00,0,4675.0,4313.0,0.9225,23.194,366,144,119,25,222,174,48,168,0.0,0.0
1012,1049,24-09-2019 22:36:00,0,4645.0,4206.0,0.905,22.958,252,125,103,22,127,98,29,215,0.06,0.0
1012,1050,24-09-2019 22:38:00,0,4605.0,4323.0,0.939,22.928,272,131,100,31,141,97,44,101,0.0,0.0
1012,1051,24-09-2019 22:40:00,0,4658.0,4208.0,0.904,23.011,301,116,84,32,185,141,44,149,0.0,0.01
1012,1052,24-09-2019 22:42:00,0,4615.0,4363.0,0.945,23.014,303,148,120,28,155,127,28,196,0.0,0.0
1012,1053,24-09-2019 22:44:00,0,4848.0,4452.0,0.918,24.03,103,32,18,14,71,51,20,57,0.0,0.0
1012,1054,24-09-2019 22:46:00,0,4406.0,4134.0,0.938,21.934,238,99,74,25,139,93,46,36,0.0,0.03
1012,1055,24-09-2019 22:48:00,0,4465.0,3951.0,0.885,21.968,142,49,32,17,93,60,33,127,0.0,0.0
1012,1056,24-09-2019 22:50:00,0,4488.0,3991.0,0.889,22.1,176,38,17,21,138,76,62,63,0.0,0.0
1012,1057,24-09-2019 22:52:00,0,4456.0,4065.0,0.912,22.057,266,73,51,22,193,147,46,162,0.0,0.0
1012,1058,24-09-2019 22:54:00,0,4343.0,3981.0,0.917,21.52,450,149,114,35,301,225,76,80,0.0,0.0
1012,1059,24-09-2019 22:56:00,0,4172.0,3798.0,0.91,20.643,294,137,107,30,157,121,36,233,0.0,0.0
1012,1060,24-09-2019 22:58:00,0,4359.0,3967.0,0.91,21.567,325,121,99,22,204,161,43,235,0.0,0.0
1012,1061,24-09-2019 23:00:00,0,4366.0,4001.0,0.916,21.633,316,133,111,22,183,134,49,213,0.0,0.0
1012,1062,24-09-2019 23:02:00,0,3953.0,3552.0,0.899,19.507,360,162,123,39,198,149,49,68,0.0,0.0
1012,1063,24-09-2019 23:04:00,0,4260.0,3860.0,0.906,21.057,248,73,50,23,175,122,53,71,0.0,0.0
1012,1064,24-09-2019 23:06:00,0,3715.0,3250.0,0.875,18.236,223,85,66,19,138,98,40,128,0.01,0.0
1012,1065,24-09-2019 23:08:00,0,4078.5,3670.5,0.898,20.1345,243,107,82,25,136,106,30,166,0.0,0.0
1012,1066,24-09-2019 23:10:00,0,4442.0,4091.0,0.921,22.033,225,94,62,32,131,94,37,98,0.0,0.0
1012,1067,24-09-2019 23:12:00,0,4368.0,3906.0,0.894,21.536,458,216,174,42,242,187,55,89,0.0,0.0
1012,1068,24-09-2019 23:14:00,0,4823.0,4426.0,0.918,23.904,510,208,165,43,302,227,75,61,0.0,0.0
1012,1069,24-09-2019 23:16:00,0,4727.0,4385.0,0.928,23.48,362,166,126,40,196,151,45,109,0.0,0.0
1012,1070,24-09-2019 23:18:00,0,4120.0,3995.0,0.97,20.654,346,146,119,27,200,156,44,172,0.0,0.0
1012,1071,24-09-2019 23:20:00,0,4353.0,4015.0,0.923,21.595,210,109,82,27,101,60,41,96,0.0,0.01
1012,1072,24-09-2019 23:22:00,0,4559.0,4095.0,0.898,22.495,282,134,105,29,148,109,39,212,0.0,0.01
1012,1073,24-09-2019 23:24:00,0,4163.0,3786.0,0.909,20.596,276,103,76,27,173,134,39,127,0.04,0.01
1012,1074,24-09-2019 23:26:00,0,3983.0,3537.0,0.888,19.611,246,95,75,20,151,102,49,139,0.0,0.02
1012,1075,24-09-2019 23:28:00,0,3691.0,3362.0,0.911,18.265,174,87,64,23,87,55,32,90,0.0,0.0
1012,1076,24-09-2019 23:30:00,0,4348.0,3982.0,0.916,21.539,385,86,50,36,299,222,77,28,0.0,0.0
1012,1077,24-09-2019 23:32:00,0,4243.0,3902.0,0.92,21.036,243,98,63,35,145,99,46,7,0.0,0.0
1012,1078,24-09-2019 23:34:00,0,4242.0,3947.0,0.931,21.083,495,221,174,47,274,224,50,190,0.0,0.01
1012,1079,24-09-2019 23:36:00,0,4865.0,4372.0,0.899,24.006,281,95,72,23,186,146,40,75,0.0,0.0
1012,1080,24-09-2019 23:38:00,0,4358.0,3986.0,0.915,21.583,431,104,81,23,327,252,75,72,0.0,0.08
1012,1081,24-09-2019 23:40:00,0,3747.0,3515.0,0.938,18.656,558,203,157,46,355,301,54,54,0.0,0.0
1012,1082,24-09-2019 23:42:00,0,4204.0,3888.5,0.926,20.869,305,124,97,27,181,136,45,49,0.0,0.0
1012,1083,24-09-2019 23:44:00,0,4661.0,4262.0,0.914,23.082,379,159,119,40,220,167,53,70,0.0,0.0
1012,1084,24-09-2019 23:46:00,0,4613.0,4198.0,0.91,22.825,386,190,139,51,196,146,50,140,0.0,0.0
1012,1085,24-09-2019 23:48:00,0,4514.0,4158.0,0.921,22.39,378,162,118,44,216,172,44,138,0.05,0.0
1012,1086,24-09-2019 23:50:00,0,4562.0,4161.0,0.912,22.58,463,131,93,38,332,259,73,103,0.0,0.0
1012,1087,24-09-2019 23:52:00,0,3613.0,3208.0,0.888,17.788,472,180,134,46,292,232,60,77,0.0,0.0
1012,1088,24-09-2019 23:54:00,0,4165.0,3776.0,0.907,20.591,517,215,168,47,302,261,41,117,0.0,0.0
1012,1089,24-09-2019 23:56:00,0,4456.0,4020.0,0.902,22.006,390,146,111,35,244,197,47,138,0.04,0.0
1012,1090,24-09-2019 23:58:00,0,4138.0,3841.0,0.928,20.555,405,136,106,30,269,218,51,168,0.01,0.0
1012,1091,25-09-2019 00:00:00,0,3645.0,3486.0,0.956,18.222,406,161,118,43,245,209,36,116,0.0,0.0
1012,1092,25-09-2019 00:02:00,0,4617.0,4197.0,0.909,22.837,338,124,100,24,214,164,50,115,0.0,0.0
1012,1093,25-09-2019 00:04:00,0,4572.0,4075.0,0.891,22.526,382,165,129,36,217,175,42,101,0.0,0.0
1012,1094,25-09-2019 00:06:00,0,3951.0,3627.0,0.918,19.583,354,163,121,42,191,145,46,132,0.0,0.0
1012,1095,25-09-2019 00:08:00,0,4563.0,4158.0,0.911,22.581,246,88,71,17,158,114,44,74,0.0,0.0
1012,1096,25-09-2019 00:10:00,0,3675.0,3375.0,0.918,18.214,72,43,17,26,29,21,8,0,0.0,0.0
1012,1097,25-09-2019 00:12:00,0,3661.0,3396.0,0.928,18.183,292,30,16,14,262,219,43,0,0.0,0.0
1012,1098,25-09-2019 00:14:00,0,3904.0,3451.0,0.884,19.202,566,33,9,24,533,490,43,0,0.0,0.0
1012,1099,25-09-2019 00:16:00,0,3944.0,3476.5,0.8815,19.3885,377,10,0,10,367,319,48,0,0.0,0.0
1012,1100,25-09-2019 00:18:00,0,3984.0,3502.0,0.879,19.575,1027,115,81,34,912,828,84,6,0.0,0.0
1012,1101,25-09-2019 00:20:00,0,3928.0,3784.0,0.963,19.663,814,226,174,52,588,503,85,14,0.0,0.0
1012,1102,25-09-2019 00:22:00,0,4054.0,3752.0,0.925,20.127,499,179,143,36,320,259,61,76,0.01,0.0
1012,1103,25-09-2019 00:24:00,0,3993.0,3558.0,0.891,19.672,136,33,16,17,103,79,24,6,0.0,0.0
1012,1104,25-09-2019 00:26:00,0,3664.0,3397.0,0.927,18.198,142,12,3,9,130,109,21,0,0.0,0.0
1012,1105,25-09-2019 00:28:00,0,3712.0,3274.0,0.882,18.251,392,86,49,37,306,279,27,2,0.0,0.0
1012,1106,25-09-2019 00:30:00,0,3704.0,3243.0,0.876,18.183,82,33,12,21,49,41,8,0,0.0,0.0
1012,1107,25-09-2019 00:32:00,0,3505.0,3122.0,0.891,17.265,184,60,29,31,124,104,20,0,0.0,0.0
1012,1108,25-09-2019 00:34:00,0,3716.0,3219.0,0.866,18.205,278,50,22,28,228,202,26,0,0.0,0.0
1012,1109,25-09-2019 00:36:00,0,3592.0,3186.0,0.887,17.68,196,16,0,16,180,160,20,0,0.0,0.0
1012,1110,25-09-2019 00:38:00,0,3494.0,3145.0,0.9,17.248,197,24,4,20,173,155,18,0,0.0,0.0
1012,1111,25-09-2019 00:40:00,0,3516.0,3045.0,0.866,17.224,6,5,0,5,1,0,1,0,0.0,0.0
1012,1112,25-09-2019 00:42:00,0,3316.0,2902.0,0.875,16.277,5,3,0,3,2,0,2,0,0.0,0.0
1012,1113,25-09-2019 00:44:00,0,3113.0,2771.0,0.89,15.333,12,12,0,12,0,0,0,0,0.0,0.0
1012,1114,25-09-2019 00:46:00,0,3010.0,2695.0,0.895,14.841,219,3,1,2,216,199,17,0,0.0,0.0
1012,1115,25-09-2019 00:48:00,0,3026.0,2660.0,0.879,14.868,138,6,0,6,132,117,15,0,0.0,0.0
1012,1116,25-09-2019 00:50:00,0,2973.0,2615.0,0.8795,14.609,352,0,0,0,352,319,33,0,0.0,0.0
1012,1117,25-09-2019 00:52:00,0,2920.0,2570.0,0.88,14.35,46,0,0,0,46,42,4,0,0.0,0.0
1012,1118,25-09-2019 00:54:00,0,2853.0,2398.0,0.841,13.897,165,16,10,6,149,138,11,0,0.0,0.0
1012,1119,25-09-2019 00:56:00,0,2932.0,2526.0,0.862,14.35,131,15,6,9,116,105,11,0,0.0,0.0
1012,1120,25-09-2019 00:58:00,0,3057.0,2522.0,0.825,14.836,0,0,0,0,0,0,0,0,0.0,0.0
1012,1121,25-09-2019 01:00:00,0,2942.0,2479.0,0.843,14.337,0,0,0,0,0,0,0,0,0.0,0.0
1012,1122,25-09-2019 01:02:00,0,2829.0,2414.0,0.853,13.82,1,1,0,1,0,0,0,0,0.0,0.0
1012,1123,25-09-2019 01:04:00,0,2857.0,2392.0,0.837,13.905,24,8,6,2,16,16,0,0,0.0,0.0
1012,1124,25-09-2019 01:06:00,0,2876.0,2307.0,0.802,13.885,33,6,2,4,27,26,1,0,0.0,0.0
1012,1125,25-09-2019 01:08:00,0,2551.0,2173.0,0.852,12.456,6,3,1,2,3,2,1,0,0.0,0.0
1012,1126,25-09-2019 01:10:00,0,2551.0,2159.0,0.846,12.442,0,0,0,0,0,0,0,0,0.0,0.0
1012,1127,25-09-2019 01:12:00,0,2662.0,2185.0,0.821,12.907,1,0,0,0,1,0,1,0,0.0,0.0
1012,1128,25-09-2019 01:14:00,0,2655.0,2196.0,0.827,12.891,128,0,0,0,128,117,11,0,0.0,0.0
1012,1129,25-09-2019 01:16:00,0,2650.0,2220.0,0.838,12.9,18,7,4,3,11,10,1,0,0.0,0.0
1012,1130,25-09-2019 01:18:00,0,2875.0,2303.0,0.801,13.876,290,110,88,22,180,131,49,33,0.0,0.0
1012,1131,25-09-2019 01:20:00,0,3037.0,2549.0,0.839,14.788,390,190,145,45,200,150,50,108,0.0,0.0
1012,1132,25-09-2019 01:22:00,0,3037.0,2553.0,0.84,14.794,224,79,51,28,145,82,63,87,0.0,0.0
1012,1133,25-09-2019 01:24:00,0,3275.5,2796.0,0.8525,16.001,174,57,32,25,117,64,53,50,0.0,0.0
1012,1134,25-09-2019 01:26:00,0,3514.0,3039.0,0.865,17.208,185,38,19,19,147,87,60,46,0.0,0.0
1012,1135,25-09-2019 01:28:00,0,3990.0,3482.0,0.873,19.575,112,18,1,17,94,64,30,10,0.0,0.0
1012,1136,25-09-2019 01:30:00,0,4090.0,3662.0,0.895,20.171,285,113,87,26,172,126,46,86,0.0,0.11
1012,1137,25-09-2019 01:32:00,0,3510.0,3124.0,0.89,17.289,465,210,164,46,255,201,54,154,0.02,0.0
1012,1138,25-09-2019 01:34:00,0,3415.0,3002.0,0.879,16.779,151,63,52,11,88,66,22,123,0.0,0.0
1012,1139,25-09-2019 01:36:00,0,4213.0,3708.0,0.88,20.704,134,26,11,15,108,60,48,12,0.0,0.07
1012,1140,25-09-2019 01:38:00,0,4342.0,3916.0,0.902,21.444,222,84,56,28,138,100,38,57,0.0,0.03
1012,1141,25-09-2019 01:40:00,0,3495.0,3157.0,0.904,17.264,365,179,139,40,186,149,37,150,0.09,0.01
1012,1142,25-09-2019 01:42:00,0,3775.0,3445.0,0.913,18.685,278,147,107,40,131,94,37,139,0.0,0.0
1012,1143,25-09-2019 01:44:00,0,3129.0,2747.0,0.878,15.371,350,148,123,25,202,163,39,135,0.04,0.0
1012,1144,25-09-2019 01:46:00,0,4749.0,4301.0,0.906,23.471,71,9,2,7,62,44,18,11,0.0,0.0
1012,1145,25-09-2019 01:48:00,0,4806.0,4452.0,0.926,23.864,163,23,4,19,140,88,52,17,0.0,0.08
1012,1146,25-09-2019 01:50:00,0,4640.0,4255.0,0.917,22.995,499,41,29,12,458,391,67,0,0.08,0.0
1012,1147,25-09-2019 01:52:00,0,3305.0,2942.0,0.89,16.28,572,0,0,0,572,518,54,0,0.0,0.01
1012,1148,25-09-2019 01:54:00,0,3043.0,2582.0,0.849,14.847,160,0,0,0,160,136,24,0,0.0,0.0
1012,1149,25-09-2019 01:56:00,0,3079.0,2493.0,0.81,14.892,159,10,5,5,149,132,17,0,0.0,0.0
1012,1150,25-09-2019 01:58:00,0,3059.0,2543.5,0.832,14.8695,148,0,0,0,148,129,19,0,0.0,0.0
1012,1151,25-09-2019 02:00:00,0,3039.0,2594.0,0.854,14.847,201,6,4,2,195,171,24,0,0.0,0.0
1012,1152,25-09-2019 02:02:00,0,3234.0,2767.0,0.856,15.808,146,0,0,0,146,129,17,0,0.0,0.0
1012,1153,25-09-2019 02:04:00,0,3009.0,2696.0,0.896,14.84,134,2,0,2,132,112,20,0,0.0,0.0
1012,1154,25-09-2019 02:06:00,0,3107.0,2732.0,0.879,15.265,152,0,0,0,152,136,16,0,0.0,0.01
1012,1155,25-09-2019 02:08:00,0,3340.0,2858.0,0.856,16.325,109,0,0,0,109,95,14,0,0.0,0.0
1012,1156,25-09-2019 02:10:00,0,3325.0,2813.0,0.846,16.215,196,2,0,2,194,170,24,0,0.0,0.0
1012,1157,25-09-2019 02:12:00,0,3327.0,2878.0,0.865,16.293,105,0,0,0,105,91,14,0,0.0,0.0
1012,1158,25-09-2019 02:14:00,0,3318.0,2893.0,0.872,16.276,114,0,0,0,114,101,13,0,0.0,0.0
1012,1159,25-09-2019 02:16:00,0,3305.0,2991.0,0.905,16.332,389,66,41,25,323,274,49,14,0.0,0.01
1012,1160,25-09-2019 02:18:00,0,3663.0,3389.0,0.925,18.184,401,156,120,36,245,190,55,140,0.0,0.0
1012,1161,25-09-2019 02:20:00,0,3455.0,3315.0,0.96,17.283,387,215,164,51,172,128,44,132,0.0,0.0
1012,1162,25-09-2019 02:22:00,0,3654.0,3390.0,0.928,18.151,337,169,132,37,168,129,39,140,0.0,0.0
1012,1163,25-09-2019 02:24:00,0,3587.0,3255.0,0.907,17.737,324,147,112,35,177,127,50,140,0.04,0.0
1012,1164,25-09-2019 02:26:00,0,3945.0,3689.0,0.935,19.629,159,31,18,13,128,77,51,48,0.0,0.0
1012,1165,25-09-2019 02:28:00,0,4140.0,3848.0,0.93,20.569,165,23,2,21,142,87,55,18,0.01,0.03
1012,1166,25-09-2019 02:30:00,0,4323.0,4023.0,0.931,21.485,160,42,21,21,118,84,34,32,0.0,0.02
1012,1167,25-09-2019 02:32:00,0,3916.0,3544.0,0.9025,19.352,417,219,172,47,198,151,47,76,0.04,0.05
1012,1168,25-09-2019 02:34:00,0,3509.0,3065.0,0.874,17.219,88,53,43,10,35,27,8,105,0.01,0.0
1012,1169,25-09-2019 02:36:00,0,3246.0,2771.0,0.854,15.858,207,108,83,25,99,77,22,194,0.0,0.0
1012,1170,25-09-2019 02:38:00,0,3974.0,3600.0,0.906,19.642,358,204,155,49,154,127,27,198,0.0,0.0
1012,1171,25-09-2019 02:40:00,0,3634.0,3434.0,0.945,18.12,194,78,50,28,116,79,37,2,0.0,0.0
1012,1172,25-09-2019 02:42:00,0,3675.0,3356.0,0.913,18.196,124,28,10,18,96,67,29,0,0.0,0.0
1012,1173,25-09-2019 02:44:00,0,4004.0,3482.0,0.87,19.631,462,190,146,44,272,206,66,1,0.0,0.0
1012,1174,25-09-2019 02:46:00,0,4041.0,3762.0,0.931,20.087,435,221,182,39,214,167,47,159,0.0,0.0
1012,1175,25-09-2019 02:48:00,0,4496.0,4031.0,0.897,22.176,203,12,3,9,191,120,71,22,0.01,0.0
1012,1176,25-09-2019 02:50:00,0,4654.0,4175.0,0.897,22.96,150,19,3,16,131,81,50,12,0.0,0.0
1012,1177,25-09-2019 02:52:00,0,4613.0,4274.0,0.927,22.906,231,100,75,25,131,86,45,30,0.01,0.03
1012,1178,25-09-2019 02:54:00,0,3713.0,3197.0,0.861,18.169,411,164,130,34,247,180,67,106,0.05,0.03
1012,1179,25-09-2019 02:56:00,0,3325.0,2857.0,0.859,16.265,294,51,28,23,243,166,77,0,0.0,0.0
1012,1180,25-09-2019 02:58:00,0,3007.0,2731.0,0.908,14.87,190,47,23,24,143,83,60,0,0.0,0.0
1012,1181,25-09-2019 03:00:00,0,3571.0,2933.0,0.821,17.315,263,82,44,38,181,117,64,0,0.0,0.0
1012,1182,25-09-2019 03:02:00,0,3705.0,3224.0,0.87,18.167,172,27,5,22,145,86,59,0,0.0,0.0
1012,1183,25-09-2019 03:04:00,0,3800.0,3346.0,0.88,18.678,72,1,0,1,71,37,34,0,0.0,0.0
1012,1184,25-09-2019 03:06:00,0,3647.5,3236.5,0.8875,17.956,76,0,0,0,76,42,34,0,0.0,0.0
1012,1185,25-09-2019 03:08:00,0,3495.0,3127.0,0.895,17.234,75,17,10,7,58,15,43,0,0.0,0.0
1012,1186,25-09-2019 03:10:00,0,3421.0,2962.0,0.866,16.757,22,1,0,1,21,0,21,0,0.0,0.0
1012,1187,25-09-2019 03:12:00,0,3290.0,2960.0,0.9,16.239,59,0,0,0,59,21,38,0,0.0,0.0
1012,1188,25-09-2019 03:14:00,0,3298.0,2958.0,0.897,16.269,51,0,0,0,51,16,35,0,0.0,0.0
1012,1189,25-09-2019 03:16:00,0,3437.0,2925.0,0.851,16.781,72,0,0,0,72,37,35,0,0.0,0.0
1012,1190,25-09-2019 03:18:00,0,3277.0,3025.0,0.923,16.26,55,0,0,0,55,27,28,0,0.0,0.0
1012,1191,25-09-2019 03:20:00,0,3309.0,2966.0,0.896,16.321,55,0,0,0,55,27,28,0,0.0,0.0
1012,1192,25-09-2019 03:22:00,0,3318.0,2933.0,0.884,16.318,41,0,0,0,41,20,21,0,0.0,0.0
1012,1193,25-09-2019 03:24:00,0,3239.0,2787.0,0.86,15.848,51,0,0,0,51,21,30,0,0.0,0.0
1012,1194,25-09-2019 03:26:00,0,2981.0,2767.0,0.928,14.807,48,18,1,17,30,14,16,0,0.0,0.0
1012,1195,25-09-2019 03:28:00,0,3007.0,2752.0,0.915,14.892,56,22,2,20,34,7,27,0,0.0,0.0
1012,1196,25-09-2019 03:30:00,0,3000.0,2697.0,0.899,14.807,679,255,202,53,424,352,72,16,0.0,0.0
1012,1197,25-09-2019 03:32:00,0,3320.0,2882.0,0.868,16.271,467,236,188,48,231,170,61,73,0.0,0.0
1012,1198,25-09-2019 03:34:00,0,3404.0,3066.0,0.9,16.807,149,17,2,15,132,79,53,6,0.0,0.02
1012,1199,25-09-2019 03:36:00,0,3690.0,3337.0,0.904,18.232,145,24,0,24,121,83,38,12,0.0,0.01
1012,1200,25-09-2019 03:38:00,0,3690.0,3351.0,0.908,18.248,125,25,4,21,100,68,32,12,0.0,0.0
1012,1201,25-09-2019 03:40:00,0,3689.5,3356.0,0.9095,18.2525,228,32,2,30,196,145,51,15,0.0,0.1
1012,1202,25-09-2019 03:42:00,0,3689.0,3361.0,0.911,18.257,163,19,2,17,144,100,44,5,0.0,0.07
1012,1203,25-09-2019 03:44:00,0,3658.0,3394.0,0.928,18.17,244,78,63,15,166,116,50,45,0.03,0.03
1012,1204,25-09-2019 03:46:00,0,3468.0,3232.0,0.932,17.244,686,265,197,68,421,330,91,61,0.03,0.0
1012,1205,25-09-2019 03:48:00,0,3303.0,2958.0,0.896,16.289,835,257,206,51,578,469,109,43,0.02,0.0
1012,1206,25-09-2019 03:50:00,0,3708.0,3271.0,0.882,18.23,457,186,139,47,271,205,66,86,0.06,0.11
1012,1207,25-09-2019 03:52:00,0,3111.0,2768.0,0.89,15.32,945,348,283,65,597,475,122,24,0.0,0.0
1012,1208,25-09-2019 03:54:00,0,3299.0,2955.0,0.896,16.27,1120,434,350,84,686,567,119,13,0.0,0.0
1012,1209,25-09-2019 03:56:00,0,3287.0,2995.0,0.911,16.266,602,301,245,56,301,228,73,37,0.01,0.0
1012,1210,25-09-2019 03:58:00,0,4002.0,3521.0,0.88,19.666,283,159,130,29,124,96,28,211,0.03,0.0
1012,1211,25-09-2019 04:00:00,0,3995.0,3586.0,0.898,19.71,286,120,97,23,166,124,42,115,0.0,0.0
1012,1212,25-09-2019 04:02:00,0,3762.0,3396.0,0.903,18.581,143,45,20,25,98,62,36,0,0.0,0.0
1012,1213,25-09-2019 04:04:00,0,3856.0,3542.0,0.919,19.114,125,48,18,30,77,41,36,0,0.0,0.0
1012,1214,25-09-2019 04:06:00,0,3893.0,3440.0,0.884,19.145,250,54,32,22,196,165,31,0,0.01,0.0
1012,1215,25-09-2019 04:08:00,0,3668.0,3411.0,0.93,18.229,132,4,1,3,128,70,58,0,0.0,0.0
1012,1216,25-09-2019 04:10:00,0,3724.0,3162.0,0.849,18.175,89,2,1,1,87,44,43,0,0.0,0.0
1012,1217,25-09-2019 04:12:00,0,3491.0,3199.0,0.916,17.297,81,0,0,0,81,40,41,0,0.0,0.0
1012,1218,25-09-2019 04:14:00,0,3413.5,3032.0,0.8875,16.8055,65,1,0,1,64,23,41,0,0.0,0.0
1012,1219,25-09-2019 04:16:00,0,3336.0,2865.0,0.859,16.314,35,1,0,1,34,0,34,0,0.0,0.0
1012,1220,25-09-2019 04:18:00,0,3217.0,2808.0,0.873,15.783,29,0,0,0,29,0,29,0,0.0,0.0
1012,1221,25-09-2019 04:20:00,0,3014.0,2677.0,0.888,14.839,95,3,0,3,92,48,44,0,0.0,0.0
1012,1222,25-09-2019 04:22:00,0,3011.0,2716.0,0.902,14.87,70,1,0,1,69,30,39,0,0.0,0.0
1012,1223,25-09-2019 04:24:00,0,3021.0,2654.0,0.879,14.84,48,2,0,2,46,22,24,0,0.0,0.0
1012,1224,25-09-2019 04:26:00,0,3028.0,2690.0,0.889,14.907,61,4,0,4,57,23,34,0,0.0,0.0
1012,1225,25-09-2019 04:28:00,0,3017.0,2664.0,0.883,14.838,81,2,0,2,79,34,45,0,0.0,0.0
1012,1226,25-09-2019 04:30:00,0,3019.0,2701.0,0.895,14.884,57,9,2,7,48,14,34,0,0.0,0.0
1012,1227,25-09-2019 04:32:00,0,2990.0,2749.0,0.92,14.823,194,2,1,1,192,109,83,0,0.0,0.0
1012,1228,25-09-2019 04:34:00,0,3035.0,2557.0,0.843,14.787,167,0,0,0,167,96,71,0,0.0,0.0
1012,1229,25-09-2019 04:36:00,0,2816.0,2555.0,0.907,13.925,288,91,64,27,197,139,58,7,0.0,0.0
1012,1230,25-09-2019 04:38:00,0,3010.0,2704.0,0.898,14.854,223,18,13,5,205,182,23,0,0.01,0.0
1012,1231,25-09-2019 04:40:00,0,2939.0,2510.0,0.854,14.357,102,0,0,0,102,89,13,0,0.0,0.0
1012,1232,25-09-2019 04:42:00,0,2842.0,2398.0,0.844,13.854,71,6,1,5,65,57,8,0,0.0,0.0
1012,1233,25-09-2019 04:44:00,0,2748.0,2315.0,0.843,13.389,150,5,0,5,145,130,15,0,0.0,0.0
1012,1234,25-09-2019 04:46:00,0,2744.0,2327.0,0.848,13.389,119,3,0,3,116,101,15,0,0.0,0.0
1012,1235,25-09-2019 04:48:00,0,2753.5,2300.0,0.8355,13.3965,194,7,1,6,187,161,26,0,0.0,0.0
1012,1236,25-09-2019 04:50:00,0,2763.0,2273.0,0.823,13.404,146,5,0,5,141,128,13,0,0.0,0.0
1012,1237,25-09-2019 04:52:00,0,2880.0,2296.0,0.797,13.889,150,1,0,1,149,124,25,0,0.0,0.0
1012,1238,25-09-2019 04:54:00,0,2869.0,2340.0,0.816,13.897,151,1,0,1,150,127,23,0,0.0,0.0
1012,1239,25-09-2019 04:56:00,0,2832.0,2456.0,0.867,13.875,166,1,0,1,165,143,22,0,0.0,0.0
1012,1240,25-09-2019 04:58:00,0,2862.0,2412.0,0.843,13.946,173,10,4,6,163,143,20,0,0.0,0.0
1012,1241,25-09-2019 05:00:00,0,2859.0,2360.0,0.825,13.876,208,54,13,41,154,98,56,0,0.0,0.0
1012,1242,25-09-2019 05:02:00,0,3069.0,2485.0,0.81,14.845,349,131,91,40,218,152,66,63,0.0,0.0
1012,1243,25-09-2019 05:04:00,0,2980.0,2848.0,0.956,14.896,387,43,17,26,344,277,67,0,0.0,0.0
1012,1244,25-09-2019 05:06:00,0,3213.0,2858.0,0.89,15.825,373,34,17,17,339,274,65,24,0.0,0.0
1012,1245,25-09-2019 05:08:00,0,3695.0,3285.0,0.889,18.196,205,18,5,13,187,141,46,12,0.0,0.0
1012,1246,25-09-2019 05:10:00,0,4020.0,3431.0,0.853,19.636,80,21,8,13,59,41,18,7,0.0,0.11
1012,1247,25-09-2019 05:12:00,0,4017.0,3431.0,0.854,19.624,0,0,0,0,0,0,0,0,0.0,0.01
1012,1248,25-09-2019 05:14:00,0,3692.0,3280.0,0.888,18.176,196,86,74,12,110,85,25,47,0.0,0.0
1012,1249,25-09-2019 05:16:00,0,3746.0,3154.0,0.842,18.252,559,246,203,43,313,277,36,259,0.0,0.0
1012,1250,25-09-2019 05:18:00,0,3294.0,2933.0,0.891,16.225,323,157,120,37,166,150,16,201,0.0,0.0
1012,1251,25-09-2019 05:20:00,0,3705.0,3254.0,0.878,18.199,141,50,33,17,91,59,32,71,0.11,0.0
1012,1252,25-09-2019 05:22:00,0,3836.0,3406.5,0.8875,18.8845,351,149,122,27,202,153,49,133,0.0,0.0
1012,1253,25-09-2019 05:24:00,0,3967.0,3559.0,0.897,19.57,43,4,0,4,39,6,33,0,0.0,0.33
1012,1254,25-09-2019 05:26:00,0,3784.0,3450.0,0.912,18.726,32,0,0,0,32,0,32,0,0.0,0.01
1012,1255,25-09-2019 05:28:00,0,3656.0,3465.0,0.948,18.242,27,0,0,0,27,0,27,0,0.0,0.0
1012,1256,25-09-2019 05:30:00,0,3679.0,3373.0,0.917,18.228,38,2,0,2,36,0,36,0,0.0,0.0
1012,1257,25-09-2019 05:32:00,0,3786.0,3418.0,0.903,18.7,363,115,89,26,248,185,63,30,0.08,0.0
1012,1258,25-09-2019 05:34:00,0,4183.0,3701.0,0.885,20.578,405,205,155,50,200,146,54,112,0.02,0.0
1012,1259,25-09-2019 05:36:00,0,3410.0,3042.0,0.892,16.804,407,174,128,46,233,175,58,49,0.05,0.0
1012,1260,25-09-2019 05:38:00,0,3691.0,3308.0,0.896,18.205,47,5,0,5,42,21,21,0,0.0,0.0
1012,1261,25-09-2019 05:40:00,0,3705.0,3274.0,0.884,18.221,51,11,5,6,40,15,25,0,0.0,0.0
1012,1262,25-09-2019 05:42:00,0,3873.0,3444.0,0.889,19.072,62,18,3,15,44,13,31,0,0.0,0.0
1012,1263,25-09-2019 05:44:00,0,3808.0,3351.0,0.88,18.715,48,0,0,0,48,18,30,0,0.02,0.0
1012,1264,25-09-2019 05:46:00,0,3672.0,3288.0,0.895,18.11,42,0,0,0,42,15,27,0,0.0,0.0
1012,1265,25-09-2019 05:48:00,0,3696.0,3287.0,0.889,18.2,42,3,0,3,39,16,23,0,0.0,0.0
1012,1266,25-09-2019 05:50:00,0,3578.0,3248.0,0.908,17.691,35,0,0,0,35,8,27,0,0.0,0.0
1012,1267,25-09-2019 05:52:00,0,3508.0,3110.0,0.887,17.265,26,0,0,0,26,5,21,0,0.0,0.0
1012,1268,25-09-2019 05:54:00,0,3311.0,2915.0,0.88,16.272,34,0,0,0,34,11,23,0,0.0,0.0
1012,1269,25-09-2019 05:56:00,0,3256.0,2907.5,0.893,16.0475,104,48,32,16,56,28,28,0,0.0,0.0
1012,1270,25-09-2019 05:58:00,0,3201.0,2900.0,0.906,15.823,29,5,4,1,24,5,19,0,0.0,0.0
1012,1271,25-09-2019 06:00:00,1,3106.0,2806.0,0.903,15.345,38,3,2,1,35,9,26,0,0.0,0.0
1012,1272,25-09-2019 06:02:00,1,3213.0,2804.0,0.873,15.762,25,1,0,1,24,4,20,0,0.0,0.0
1012,1273,25-09-2019 06:04:00,1,3124.0,2744.0,0.878,15.347,39,7,0,7,32,4,28,0,0.0,0.0
1012,1274,25-09-2019 06:06:00,1,2981.0,2788.0,0.935,14.832,387,139,103,36,248,184,64,45,0.0,0.0
1012,1275,25-09-2019 06:08:00,1,3192.0,2899.0,0.908,15.784,135,39,10,29,96,62,34,0,0.0,0.0
1012,1276,25-09-2019 06:10:00,1,3305.0,3000.0,0.908,16.343,35,1,0,1,34,7,27,0,0.0,0.0
1012,1277,25-09-2019 06:12:00,1,3275.0,3008.0,0.918,16.235,23,2,2,0,21,7,14,0,0.0,0.0
1012,1278,25-09-2019 06:14:00,1,3202.0,2879.0,0.899,15.801,27,2,0,2,25,5,20,0,0.0,0.0
1012,1279,25-09-2019 06:16:00,1,3002.0,2757.0,0.919,14.879,23,3,0,3,20,0,20,0,0.0,0.0
1012,1280,25-09-2019 06:18:00,1,3028.0,2641.0,0.872,14.853,21,3,0,3,18,5,13,0,0.0,0.0
1012,1281,25-09-2019 06:20:00,1,3025.0,2584.0,0.854,14.78,28,1,0,1,27,10,17,0,0.0,0.0
1012,1282,25-09-2019 06:22:00,1,2928.0,2528.0,0.863,14.333,40,6,0,6,34,8,26,0,0.0,0.0
1012,1283,25-09-2019 06:24:00,1,2811.0,2586.0,0.92,13.937,30,2,0,2,28,12,16,0,0.0,0.0
1012,1284,25-09-2019 06:26:00,1,2812.0,2536.0,0.902,13.885,40,5,1,4,35,15,20,0,0.0,0.0
1012,1285,25-09-2019 06:28:00,1,2742.0,2327.0,0.849,13.381,42,8,0,8,34,9,25,0,0.0,0.0
1012,1286,25-09-2019 06:30:00,1,2792.0,2382.5,0.8535,13.6395,58,3,0,3,55,36,19,0,0.0,0.0
1012,1287,25-09-2019 06:32:00,1,2842.0,2438.0,0.858,13.898,105,2,1,1,103,64,39,0,0.0,0.0
1012,1288,25-09-2019 06:34:00,1,2824.0,2478.0,0.877,13.872,87,1,0,1,86,48,38,0,0.0,0.0
1012,1289,25-09-2019 06:36:00,1,2815.0,2507.0,0.891,13.865,79,0,0,0,79,39,40,0,0.0,0.0
1012,1290,25-09-2019 06:38:00,1,2820.0,2533.0,0.898,13.916,116,13,9,4,103,56,47,0,0.0,0.0
1012,1291,25-09-2019 06:40:00,1,2796.0,2550.0,0.912,13.839,58,10,6,4,48,19,29,0,0.0,0.0
1012,1292,25-09-2019 06:42:00,1,2845.0,2427.0,0.853,13.898,20,0,0,0,20,5,15,0,0.0,0.0
1012,1293,25-09-2019 06:44:00,1,2839.0,2410.0,0.849,13.853,33,6,2,4,27,10,17,0,0.0,0.0
1012,1294,25-09-2019 06:46:00,1,2837.0,2365.0,0.834,13.795,40,4,2,2,36,6,30,0,0.0,0.0
1012,1295,25-09-2019 06:48:00,1,2868.0,2362.0,0.824,13.915,47,21,7,14,26,13,13,0,0.0,0.0
1012,1296,25-09-2019 06:50:00,1,2822.0,2511.0,0.89,13.897,218,79,46,33,139,86,53,38,0.0,0.0
1012,1297,25-09-2019 06:52:00,1,3003.0,2736.0,0.911,14.861,105,47,21,26,58,27,31,54,0.0,0.02
1012,1298,25-09-2019 06:54:00,1,3271.0,3002.0,0.918,16.21,187,114,77,37,73,33,40,63,0.0,0.02
1012,1299,25-09-2019 06:56:00,1,3385.0,3042.0,0.898,16.706,292,117,82,35,175,114,61,107,0.0,0.02
1012,1300,25-09-2019 06:58:00,1,3328.0,2898.0,0.871,16.32,176,85,70,15,91,70,21,219,0.0,0.0
1012,1301,25-09-2019 07:00:00,1,3725.0,3167.0,0.85,18.182,310,132,102,30,178,132,46,154,0.0,0.0
1012,1302,25-09-2019 07:02:00,1,3661.0,3466.0,0.947,18.262,447,182,145,37,265,221,44,169,0.0,0.0
1012,1303,25-09-2019 07:04:00,1,3929.0,3574.5,0.912,19.4385,145,40,17,23,105,62,43,4,0.06,0.14
1012,1304,25-09-2019 07:06:00,1,4197.0,3683.0,0.877,20.615,390,203,163,40,187,139,48,194,0.07,0.0
1012,1305,25-09-2019 07:08:00,1,3664.0,3459.0,0.944,18.267,213,53,40,13,160,105,55,4,0.04,0.0
1012,1306,25-09-2019 07:10:00,1,3235.0,2780.0,0.859,15.823,160,56,35,21,104,60,44,9,0.0,0.0
1012,1307,25-09-2019 07:12:00,1,3993.0,3527.0,0.883,19.638,448,120,89,31,328,241,87,20,0.01,0.0
1012,1308,25-09-2019 07:14:00,1,4163.0,3799.0,0.913,20.606,419,172,138,34,247,182,65,32,0.01,0.0
1012,1309,25-09-2019 07:16:00,1,3689.0,3333.0,0.904,18.225,560,262,208,54,298,229,69,0,0.0,0.0
1012,1310,25-09-2019 07:18:00,1,3690.0,3288.0,0.891,18.179,485,212,165,47,273,208,65,30,0.0,0.0
1012,1311,25-09-2019 07:20:00,1,3678.0,3381.0,0.919,18.235,654,246,181,65,408,318,90,7,0.0,0.0
1012,1312,25-09-2019 07:22:00,1,3629.0,3131.0,0.863,17.763,740,330,253,77,410,313,97,0,0.0,0.0
1012,1313,25-09-2019 07:24:00,1,3691.0,3274.0,0.887,18.168,388,164,131,33,224,168,56,4,0.0,0.0
1012,1314,25-09-2019 07:26:00,1,3628.0,3141.0,0.866,17.773,723,363,282,81,360,287,73,46,0.0,0.0
1012,1315,25-09-2019 07:28:00,1,3497.0,3084.0,0.882,17.193,505,200,151,49,305,231,74,102,0.0,0.0
1012,1316,25-09-2019 07:30:00,1,3515.0,3002.0,0.854,17.172,878,436,342,94,442,346,96,3,0.0,0.0
1012,1317,25-09-2019 07:32:00,1,3512.0,3077.0,0.876,17.245,521,281,217,64,240,187,53,8,0.0,0.0
1012,1318,25-09-2019 07:34:00,1,3500.0,3024.0,0.864,17.14,655,326,255,71,329,264,65,3,0.0,0.0
1012,1319,25-09-2019 07:36:00,1,3534.0,2999.0,0.849,17.243,910,295,238,57,615,517,98,2,0.0,0.0
1012,1320,25-09-2019 07:38:00,1,3527.0,3051.0,0.8655,17.2735,586,20,0,20,566,507,59,0,0.0,0.0
1012,1321,25-09-2019 07:40:00,1,3520.0,3103.0,0.882,17.304,161,38,18,20,123,111,12,0,0.0,0.0
1012,1322,25-09-2019 07:42:00,1,3539.0,3038.0,0.858,17.308,182,66,29,37,116,104,12,0,0.0,0.0
1012,1323,25-09-2019 07:44:00,1,3547.0,2918.0,0.823,17.206,78,27,8,19,51,21,30,0,0.0,0.0
1012,1324,25-09-2019 07:46:00,1,3346.0,2842.0,0.849,16.329,33,0,0,0,33,0,33,0,0.0,0.0
1012,1325,25-09-2019 07:48:00,1,3027.0,2562.0,0.846,14.765,94,8,5,3,86,38,48,0,0.0,0.0
1012,1326,25-09-2019 07:50:00,1,2876.0,2348.0,0.817,13.93,118,4,0,4,114,91,23,0,0.0,0.0
1012,1327,25-09-2019 07:52:00,1,2776.0,2228.0,0.803,13.403,101,5,1,4,96,80,16,0,0.0,0.0
1012,1328,25-09-2019 07:54:00,1,2664.0,2197.0,0.825,12.93,75,3,0,3,72,61,11,0,0.0,0.0
1012,1329,25-09-2019 07:56:00,1,2566.0,2070.0,0.807,12.404,115,0,0,0,115,100,15,0,0.0,0.0
1012,1330,25-09-2019 07:58:00,1,2567.0,2066.0,0.805,12.403,72,2,0,2,70,60,10,0,0.0,0.0
1012,1331,25-09-2019 08:00:00,1,2592.0,1954.0,0.754,12.376,118,6,0,6,112,93,19,0,0.0,0.0
1012,1332,25-09-2019 08:02:00,1,2494.0,1948.0,0.781,11.983,151,0,0,0,151,135,16,0,0.0,0.0
1012,1333,25-09-2019 08:04:00,1,2495.0,1938.0,0.777,11.975,102,0,0,0,102,91,11,0,0.0,0.0
1012,1334,25-09-2019 08:06:00,1,2362.0,1935.0,0.819,11.449,86,0,0,0,86,57,29,0,0.0,0.0
1012,1335,25-09-2019 08:08:00,1,2377.0,1947.0,0.819,11.522,50,0,0,0,50,19,31,0,0.0,0.0
1012,1336,25-09-2019 08:10:00,1,2356.0,1989.0,0.844,11.484,43,0,0,0,43,15,28,0,0.0,0.0
1012,1337,25-09-2019 08:12:00,1,2370.5,1926.5,0.8125,11.472,53,0,0,0,53,25,28,0,0.0,0.0
1012,1338,25-09-2019 08:14:00,1,2385.0,1864.0,0.781,11.46,130,42,19,23,88,54,34,0,0.0,0.0
1012,1339,25-09-2019 08:16:00,1,2597.0,2023.0,0.779,12.473,46,0,0,0,46,20,26,0,0.0,0.0
1012,1340,25-09-2019 08:18:00,1,2587.0,2026.0,0.783,12.437,32,0,0,0,32,8,24,0,0.0,0.0
1012,1341,25-09-2019 08:20:00,1,2588.0,1996.0,0.771,12.405,38,3,0,3,35,2,33,0,0.0,0.0
1012,1342,25-09-2019 08:22:00,1,2605.0,1990.0,0.764,12.469,39,2,0,2,37,4,33,0,0.0,0.0
1012,1343,25-09-2019 08:24:00,1,2597.0,1974.0,0.76,12.418,36,0,0,0,36,2,34,0,0.0,0.0
1012,1344,25-09-2019 08:26:00,1,2494.0,1919.0,0.77,11.951,58,0,0,0,58,17,41,0,0.0,0.0
1012,1345,25-09-2019 08:28:00,1,2601.0,1996.0,0.768,12.457,33,1,0,1,32,10,22,0,0.0,0.0
1012,1346,25-09-2019 08:30:00,1,2587.0,2014.0,0.778,12.424,54,6,1,5,48,11,37,0,0.0,0.0
1012,1347,25-09-2019 08:32:00,1,2598.0,2004.0,0.771,12.455,25,3,0,3,22,5,17,0,0.0,0.0
1012,1348,25-09-2019 08:34:00,1,2607.0,1983.0,0.761,12.467,24,1,0,1,23,0,23,0,0.0,0.0
1012,1349,25-09-2019 08:36:00,1,2590.0,2029.0,0.784,12.451,34,1,0,1,33,6,27,0,0.0,0.0
1012,1350,25-09-2019 08:38:00,1,2603.0,1964.0,0.754,12.429,35,0,0,0,35,13,22,0,0.0,0.0
1012,1351,25-09-2019 08:40:00,1,2591.0,1981.0,0.765,12.404,45,0,0,0,45,24,21,0,0.0,0.0
1012,1352,25-09-2019 08:42:00,1,2588.0,2034.0,0.786,12.448,131,37,19,18,94,52,42,0,0.0,0.0
1012,1353,25-09-2019 08:44:00,1,2913.0,2131.0,0.732,13.837,202,104,77,27,98,61,37,23,0.0,0.0
1012,1354,25-09-2019 08:46:00,1,2980.0,2320.0,0.7775,14.31,292,135,108,27,157,110,47,89,0.0,0.0
1012,1355,25-09-2019 08:48:00,1,3047.0,2509.0,0.823,14.783,400,149,114,35,251,195,56,17,0.01,0.0
1012,1356,25-09-2019 08:50:00,1,3051.0,2566.0,0.841,14.863,25,7,1,6,18,11,7,0,0.0,0.0
1012,1357,25-09-2019 08:52:00,1,3058.0,2491.0,0.815,14.806,181,102,69,33,79,52,27,0,0.0,0.0
1012,1358,25-09-2019 08:54:00,1,3075.0,2422.0,0.788,14.797,588,316,247,69,272,207,65,7,0.0,0.0
1012,1359,25-09-2019 08:56:00,1,3065.0,2472.0,0.807,14.813,223,136,99,37,87,73,14,2,0.0,0.0
1012,1360,25-09-2019 08:58:00,1,3094.0,2437.0,0.788,14.887,418,30,7,23,388,347,41,2,0.0,0.0
1012,1361,25-09-2019 09:00:00,1,3043.0,2544.0,0.836,14.804,128,37,11,26,91,74,17,0,0.0,0.0
1012,1362,25-09-2019 09:02:00,1,3058.0,2473.0,0.809,14.787,54,5,1,4,49,16,33,0,0.0,0.0
1012,1363,25-09-2019 09:04:00,1,3109.0,2325.0,0.748,14.825,17,4,2,2,13,5,8,0,0.0,0.0
1012,1364,25-09-2019 09:06:00,1,2913.0,2145.0,0.736,13.854,111,0,0,0,111,57,54,0,0.0,0.0
1012,1365,25-09-2019 09:08:00,1,2578.0,2065.0,0.801,12.446,201,20,10,10,181,118,63,0,0.0,0.0
1012,1366,25-09-2019 09:10:00,1,2618.0,1898.0,0.725,12.416,67,4,0,4,63,6,57,0,0.0,0.0
1012,1367,25-09-2019 09:12:00,1,2392.0,1885.0,0.788,11.511,104,32,19,13,72,29,43,0,0.0,0.0
1012,1368,25-09-2019 09:14:00,1,2392.0,1878.0,0.785,11.505,30,0,0,0,30,7,23,0,0.0,0.0
1012,1369,25-09-2019 09:16:00,1,2392.0,1875.0,0.784,11.499,4,0,0,0,4,0,4,0,0.0,0.0
1012,1370,25-09-2019 09:18:00,1,2411.0,1796.0,0.745,11.488,3,0,0,0,3,2,1,0,0.0,0.0
1012,1371,25-09-2019 09:20:00,1,2353.5,1769.0,0.752,11.232,9,0,0,0,9,8,1,0,0.0,0.0
1012,1372,25-09-2019 09:22:00,1,2296.0,1742.0,0.759,10.976,25,1,1,0,24,20,4,0,0.0,0.0
1012,1373,25-09-2019 09:24:00,1,2401.0,1777.0,0.74,11.427,1,0,0,0,1,1,0,0,0.0,0.0
1012,1374,25-09-2019 09:26:00,1,2424.0,1778.0,0.733,11.521,16,0,0,0,16,16,0,0,0.0,0.0
1012,1375,25-09-2019 09:28:00,1,2294.0,1738.0,0.757,10.964,40,11,8,3,29,22,7,0,0.0,0.0
1012,1376,25-09-2019 09:30:00,1,2388.0,1893.0,0.792,11.506,11,0,0,0,11,10,1,0,0.0,0.0
1012,1377,25-09-2019 09:32:00,1,2379.0,1905.0,0.801,11.484,8,0,0,0,8,8,0,0,0.0,0.0
1012,1378,25-09-2019 09:34:00,1,2609.0,1965.0,0.753,12.454,1,0,0,0,1,0,1,0,0.0,0.0
1012,1379,25-09-2019 09:36:00,1,2608.0,1945.0,0.746,12.431,16,0,0,0,16,15,1,0,0.0,0.0
1012,1380,25-09-2019 09:38:00,1,2622.0,1950.0,0.744,12.488,0,0,0,0,0,0,0,0,0.0,0.0
1012,1381,25-09-2019 09:40:00,1,2602.0,1915.0,0.736,12.372,21,7,3,4,14,6,8,0,0.0,0.0
1012,1382,25-09-2019 09:42:00,1,2596.0,2009.0,0.774,12.453,57,1,1,0,56,2,54,0,0.0,0.0
1012,1383,25-09-2019 09:44:00,1,2616.0,1922.0,0.735,12.436,60,0,0,0,60,10,50,0,0.0,0.0
1012,1384,25-09-2019 09:46:00,1,2513.0,1888.0,0.751,11.992,18,1,0,1,17,4,13,0,0.0,0.0
1012,1385,25-09-2019 09:48:00,1,2393.0,1853.0,0.774,11.48,26,1,0,1,25,7,18,0,0.0,0.0
1012,1386,25-09-2019 09:50:00,1,2511.0,1814.0,0.723,11.903,34,1,0,1,33,3,30,0,0.0,0.0
1012,1387,25-09-2019 09:52:00,1,2409.0,1796.0,0.746,11.48,42,0,0,0,42,2,40,0,0.0,0.0
1012,1388,25-09-2019 09:54:00,1,2513.0,1850.0,0.7365,11.95,241,11,1,10,230,191,39,0,0.0,0.0
1012,1389,25-09-2019 09:56:00,1,2617.0,1904.0,0.727,12.42,28,20,9,11,8,3,5,0,0.0,0.0
1012,1390,25-09-2019 09:58:00,1,2498.0,1855.0,0.743,11.896,0,0,0,0,0,0,0,0,0.0,0.0
1012,1391,25-09-2019 10:00:00,1,2515.0,1866.0,0.742,11.977,3,0,0,0,3,2,1,0,0.0,0.0
1012,1392,25-09-2019 10:02:00,1,2410.0,1782.0,0.74,11.468,22,11,7,4,11,6,5,0,0.0,0.0
1012,1393,25-09-2019 10:04:00,1,2426.0,1719.0,0.709,11.461,1,0,0,0,1,1,0,0,0.0,0.0
1012,1394,25-09-2019 10:06:00,1,2440.0,1652.0,0.677,11.443,5,4,0,4,1,0,1,0,0.0,0.0
1012,1395,25-09-2019 10:08:00,1,2432.0,1697.0,0.698,11.46,1,1,0,1,0,0,0,0,0.0,0.0
1012,1396,25-09-2019 10:10:00,1,2425.0,1733.0,0.715,11.475,10,3,0,3,7,1,6,0,0.0,0.0
1012,1397,25-09-2019 10:12:00,1,2454.0,1643.0,0.669,11.488,9,0,0,0,9,2,7,0,0.0,0.0
1012,1398,25-09-2019 10:14:00,1,2211.0,1661.0,0.751,10.552,11,0,0,0,11,3,8,0,0.0,0.0
1012,1399,25-09-2019 10:16:00,1,2327.0,1675.0,0.72,11.022,1,0,0,0,1,1,0,0,0.0,0.0
1012,1400,25-09-2019 10:18:00,1,2213.0,1574.0,0.711,10.46,33,14,6,8,19,9,10,0,0.0,0.0
1012,1401,25-09-2019 10:20:00,1,2231.0,1535.0,0.688,10.489,15,12,6,6,3,2,1,0,0.0,0.0
1012,1402,25-09-2019 10:22:00,1,2227.0,1553.0,0.697,10.494,6,2,1,1,4,0,4,0,0.0,0.0
1012,1403,25-09-2019 10:24:00,1,2231.0,1544.0,0.692,10.499,7,2,0,2,5,3,2,0,0.0,0.0
1012,1404,25-09-2019 10:26:00,1,2236.0,1538.0,0.688,10.512,4,0,0,0,4,3,1,0,0.0,0.0
1012,1405,25-09-2019 10:28:00,1,2225.0,1586.5,0.713,10.524,0,0,0,0,0,0,0,0,0.0,0.0
1012,1406,25-09-2019 10:30:00,1,2214.0,1635.0,0.738,10.536,29,16,9,7,13,8,5,0,0.0,0.0
1012,1407,25-09-2019 10:32:00,1,2531.0,1789.0,0.707,11.953,47,25,2,23,22,21,1,0,0.0,0.0
1012,1408,25-09-2019 10:34:00,1,2530.0,1852.0,0.732,12.018,21,6,2,4,15,15,0,0,0.0,0.0
1012,1409,25-09-2019 10:36:00,1,2498.0,1872.0,0.749,11.915,24,13,1,12,11,5,6,0,0.0,0.0
1012,1410,25-09-2019 10:38:00,1,2413.0,1783.0,0.739,11.48,33,0,0,0,33,10,23,0,0.0,0.0
1012,1411,25-09-2019 10:40:00,1,2423.0,1735.0,0.716,11.469,27,5,0,5,22,2,20,0,0.0,0.0
1012,1412,25-09-2019 10:42:00,1,2336.0,1639.0,0.702,11.017,29,1,1,0,28,9,19,0,0.0,0.0
1012,1413,25-09-2019 10:44:00,1,2228.0,1611.0,0.723,10.563,28,0,0,0,28,10,18,0,0.01,0.0
1012,1414,25-09-2019 10:46:00,1,2206.0,1645.0,0.746,10.513,22,0,0,0,22,2,20,0,0.0,0.0
1012,1415,25-09-2019 10:48:00,1,2223.0,1597.0,0.718,10.529,12,0,0,0,12,2,10,0,0.0,0.0
1012,1416,25-09-2019 10:50:00,1,2451.0,1668.0,0.681,11.502,7,1,0,1,6,3,3,0,0.0,0.0
1012,1417,25-09-2019 10:52:00,1,2319.0,1629.0,0.702,10.939,14,0,0,0,14,6,8,0,0.0,0.0
1012,1418,25-09-2019 10:54:00,1,2216.0,1616.0,0.73,10.519,6,0,0,0,6,2,4,0,0.0,0.0
1012,1419,25-09-2019 10:56:00,1,2417.0,1731.0,0.716,11.441,35,9,3,6,26,11,15,0,0.0,0.0
1012,1420,25-09-2019 10:58:00,1,2650.0,1823.0,0.688,12.459,222,138,101,37,84,52,32,71,0.0,0.0
1012,1421,25-09-2019 11:00:00,1,2579.0,2038.0,0.79,12.419,188,85,69,16,103,63,40,64,0.0,0.0
1012,1422,25-09-2019 11:02:00,1,2857.5,2169.0,0.762,13.6615,183,105,87,18,78,64,14,154,0.0,0.0
1012,1423,25-09-2019 11:04:00,1,3136.0,2300.0,0.734,14.904,322,86,54,32,236,188,48,79,0.0,0.0
1012,1424,25-09-2019 11:06:00,1,3318.0,2441.0,0.736,15.776,444,72,38,34,372,275,97,4,0.0,0.0
1012,1425,25-09-2019 11:08:00,1,3404.0,2496.0,0.733,16.176,138,63,51,12,75,55,20,87,0.0,0.0
1012,1426,25-09-2019 11:10:00,1,3615.0,2671.0,0.739,17.201,98,52,21,31,46,19,27,9,0.0,0.0
1012,1427,25-09-2019 11:12:00,1,3511.0,2617.0,0.745,16.732,307,234,176,58,73,44,29,67,0.0,0.0
1012,1428,25-09-2019 11:14:00,1,3630.0,2679.0,0.738,17.269,288,171,127,44,117,77,40,87,0.0,0.0
1012,1429,25-09-2019 11:16:00,1,3309.0,2444.0,0.739,15.746,184,112,81,31,72,47,25,13,0.0,0.0
1012,1430,25-09-2019 11:18:00,1,3204.0,2393.0,0.747,15.273,507,251,190,61,256,189,67,57,0.0,0.0
1012,1431,25-09-2019 11:20:00,1,3417.0,2496.0,0.73,16.226,477,219,167,52,258,201,57,58,0.0,0.0
1012,1432,25-09-2019 11:22:00,1,3402.0,2567.0,0.754,16.246,760,393,324,69,367,297,70,16,0.0,0.0
1012,1433,25-09-2019 11:24:00,1,3498.0,2646.0,0.756,16.713,505,239,192,47,266,212,54,15,0.1,0.0
1012,1434,25-09-2019 11:26:00,1,3508.0,2638.0,0.752,16.741,535,270,197,73,265,206,59,9,0.0,0.0
1012,1435,25-09-2019 11:28:00,1,3307.0,2502.0,0.756,15.801,580,304,242,62,276,222,54,3,0.0,0.0
1012,1436,25-09-2019 11:30:00,1,3414.0,2518.0,0.738,16.238,336,146,108,38,190,148,42,7,0.0,0.0
1012,1437,25-09-2019 11:32:00,1,3089.0,2381.0,0.771,14.809,895,389,302,87,506,407,99,8,0.0,0.0
1012,1438,25-09-2019 11:34:00,1,3435.0,2484.0,0.723,16.285,369,192,132,60,177,134,43,6,0.0,0.0
1012,1439,25-09-2019 11:36:00,1,3266.5,2429.0,0.7445,15.5605,127,25,11,14,102,57,45,0,0.0,0.0
1012,1440,25-09-2019 11:38:00,1,3098.0,2374.0,0.766,14.836,117,27,0,27,90,35,55,0,0.0,0.0
1012,1441,25-09-2019 11:40:00,1,3094.0,2402.0,0.776,14.852,160,66,32,34,94,44,50,0,0.0,0.0
1012,1442,25-09-2019 11:42:00,1,3099.0,2406.0,0.776,14.876,130,22,3,19,108,63,45,0,0.0,0.0
1012,1443,25-09-2019 11:44:00,1,3000.0,2304.0,0.768,14.372,45,6,1,5,39,6,33,0,0.0,0.0
1012,1444,25-09-2019 11:46:00,1,2930.0,2070.0,0.707,13.835,5,2,0,2,3,2,1,0,0.0,0.0
1012,1445,25-09-2019 11:48:00,1,2934.0,2086.0,0.711,13.869,2,0,0,0,2,1,1,0,0.0,0.0
1012,1446,25-09-2019 11:50:00,1,2591.0,1983.0,0.765,12.404,7,0,0,0,7,2,5,0,0.0,0.0
1012,1447,25-09-2019 11:52:00,1,2629.0,1859.0,0.707,12.416,70,4,0,4,66,32,34,0,0.0,0.0
1012,1448,25-09-2019 11:54:00,1,2618.0,1911.0,0.73,12.431,38,0,0,0,38,7,31,0,0.0,0.0
1012,1449,25-09-2019 11:56:00,1,2739.0,1926.0,0.703,12.925,1,0,0,0,1,0,1,0,0.0,0.0
1012,1450,25-09-2019 11:58:00,1,2731.0,1926.0,0.705,12.895,12,3,1,2,9,3,6,0,0.0,0.0
1012,1451,25-09-2019 12:00:00,1,2615.0,1931.0,0.739,12.441,24,4,0,4,20,0,20,0,0.0,0.0
1012,1452,25-09-2019 12:02:00,1,2630.0,1870.0,0.711,12.432,7,1,0,1,6,0,6,0,0.0,0.0
1012,1453,25-09-2019 12:04:00,1,2654.0,1810.0,0.682,12.462,35,12,3,9,23,14,9,0,0.0,0.0
1012,1454,25-09-2019 12:06:00,1,2629.0,1822.0,0.693,12.377,3,0,0,0,3,0,3,0,0.0,0.0
1012,1455,25-09-2019 12:08:00,1,2654.0,1827.0,0.688,12.478,11,8,0,8,3,1,2,0,0.0,0.0
1012,1456,25-09-2019 12:10:00,1,2650.0,1834.0,0.692,12.47,15,7,1,6,8,2,6,0,0.0,0.0
1012,1457,25-09-2019 12:12:00,1,2646.0,1841.0,0.696,12.462,15,9,2,7,6,2,4,0,0.0,0.0
1012,1458,25-09-2019 12:14:00,1,2637.0,1825.0,0.692,12.411,6,2,1,1,4,1,3,0,0.0,0.0
1012,1459,25-09-2019 12:16:00,1,2642.0,1829.0,0.692,12.435,11,2,1,1,9,1,8,0,0.0,0.0
1012,1460,25-09-2019 12:18:00,1,2642.0,1832.0,0.693,12.436,2,0,0,0,2,0,2,0,0.0,0.0
1012,1461,25-09-2019 12:20:00,1,2643.0,1778.0,0.673,12.384,257,128,92,36,129,96,33,24,0.0,0.0
1012,1462,25-09-2019 12:22:00,1,2622.0,1932.0,0.737,12.469,275,160,117,43,115,77,38,69,0.0,0.0
1012,1463,25-09-2019 12:24:00,1,2937.0,2037.0,0.693,13.829,195,98,65,33,97,73,24,56,0.0,0.0
1012,1464,25-09-2019 12:26:00,1,2949.0,2027.0,0.687,13.861,96,28,14,14,68,30,38,0,0.0,0.0
1012,1465,25-09-2019 12:28:00,1,2920.0,2096.0,0.718,13.824,66,12,3,9,54,27,27,0,0.0,0.0
1012,1466,25-09-2019 12:30:00,1,2953.0,2072.0,0.702,13.928,96,40,4,36,56,29,27,0,0.0,0.0
1012,1467,25-09-2019 12:32:00,1,3137.0,2258.0,0.72,14.859,120,62,36,26,58,34,24,0,0.0,0.0
1012,1468,25-09-2019 12:34:00,1,3143.0,2212.0,0.704,14.835,6,0,0,0,6,1,5,0,0.0,0.0
1012,1469,25-09-2019 12:36:00,1,2925.0,2106.0,0.72,13.854,10,0,0,0,10,0,10,0,0.0,0.0
1012,1470,25-09-2019 12:38:00,1,2835.0,1987.0,0.701,13.369,9,0,0,0,9,0,9,0,0.0,0.0
1012,1471,25-09-2019 12:40:00,1,2610.0,1902.0,0.729,12.39,10,0,0,0,10,3,7,0,0.0,0.0
1012,1472,25-09-2019 12:42:00,1,2626.0,1884.0,0.717,12.432,14,0,0,0,14,1,13,0,0.0,0.0
1012,1473,25-09-2019 12:44:00,1,2648.0,1822.0,0.688,12.4495,28,13,0,13,15,4,11,0,0.0,0.0
1012,1474,25-09-2019 12:46:00,1,2670.0,1760.0,0.659,12.467,9,0,0,0,9,0,9,0,0.0,0.0
1012,1475,25-09-2019 12:48:00,1,2544.0,1759.0,0.692,11.971,14,5,1,4,9,2,7,0,0.0,0.0
1012,1476,25-09-2019 12:50:00,1,2531.0,1775.0,0.701,11.936,37,4,0,4,33,3,30,0,0.0,0.0
1012,1477,25-09-2019 12:52:00,1,2550.0,1702.0,0.668,11.933,22,0,0,0,22,0,22,0,0.0,0.0
1012,1478,25-09-2019 12:54:00,1,2567.0,1673.0,0.652,11.966,8,1,0,1,7,0,7,0,0.0,0.0
1012,1479,25-09-2019 12:56:00,1,2542.0,1741.0,0.685,11.944,10,0,0,0,10,0,10,0,0.0,0.0
1012,1480,25-09-2019 12:58:00,1,2551.0,1658.0,0.65,11.888,51,16,4,12,35,17,18,0,0.0,0.0
1012,1481,25-09-2019 13:00:00,1,2665.0,1768.0,0.663,12.458,66,17,11,6,49,31,18,0,0.0,0.0
1012,1482,25-09-2019 13:02:00,1,2748.0,1826.0,0.664,12.848,13,0,0,0,13,2,11,0,0.0,0.0
1012,1483,25-09-2019 13:04:00,1,2766.0,1812.0,0.655,12.905,9,0,0,0,9,0,9,0,0.0,0.0
1012,1484,25-09-2019 13:06:00,1,2779.0,1796.0,0.646,12.939,9,0,0,0,9,0,9,0,0.0,0.0
1012,1485,25-09-2019 13:08:00,1,2654.0,1772.0,0.668,12.419,31,5,1,4,26,9,17,0,0.0,0.0
1012,1486,25-09-2019 13:10:00,1,2772.0,1763.0,0.636,12.874,14,0,0,0,14,0,14,0,0.0,0.0
1012,1487,25-09-2019 13:12:00,1,2677.0,1710.0,0.639,12.442,7,0,0,0,7,0,7,0,0.0,0.0
1012,1488,25-09-2019 13:14:00,1,2792.0,1758.0,0.63,12.949,11,0,0,0,11,0,11,0,0.0,0.0
1012,1489,25-09-2019 13:16:00,1,2657.0,1730.0,0.651,12.384,8,0,0,0,8,0,8,0,0.0,0.0
1012,1490,25-09-2019 13:18:00,1,2548.5,1698.5,0.667,11.922,9,0,0,0,9,0,9,0,0.0,0.0
1012,1491,25-09-2019 13:20:00,1,2440.0,1667.0,0.683,11.46,32,10,6,4,22,11,11,0,0.0,0.0
1012,1492,25-09-2019 13:22:00,1,2533.0,1765.0,0.697,11.935,7,0,0,0,7,0,7,0,0.0,0.0
1012,1493,25-09-2019 13:24:00,1,2431.0,1719.0,0.707,11.48,14,1,0,1,13,4,9,0,0.0,0.0
1012,1494,25-09-2019 13:26:00,1,2431.0,1708.0,0.703,11.47,12,5,1,4,7,2,5,0,0.0,0.0
1012,1495,25-09-2019 13:28:00,1,2426.0,1764.0,0.727,11.51,15,7,0,7,8,4,4,0,0.0,0.0
1012,1496,25-09-2019 13:30:00,1,2427.0,1733.0,0.714,11.483,16,8,2,6,8,4,4,0,0.0,0.0
1012,1497,25-09-2019 13:32:00,1,2424.0,1730.0,0.714,11.467,14,4,2,2,10,4,6,0,0.0,0.0
1012,1498,25-09-2019 13:34:00,1,2554.0,1724.0,0.675,11.972,12,9,0,9,3,2,1,0,0.0,0.0
1012,1499,25-09-2019 13:36:00,1,2428.0,1722.0,0.709,11.473,10,3,0,3,7,0,7,0,0.0,0.0
1012,1500,25-09-2019 13:38:00,1,2440.0,1716.0,0.703,11.516,115,54,27,27,61,36,25,0,0.0,0.0
1012,1501,25-09-2019 13:40:00,1,2860.0,1882.0,0.658,13.353,151,38,20,18,113,70,43,0,0.0,0.0
1012,1502,25-09-2019 13:42:00,1,2947.0,2037.0,0.691,13.866,78,34,8,26,44,14,30,0,0.0,0.0
1012,1503,25-09-2019 13:44:00,1,2943.0,2063.0,0.701,13.88,99,25,11,14,74,42,32,0,0.0,0.0
1012,1504,25-09-2019 13:46:00,1,3145.0,2211.0,0.703,14.841,91,25,11,14,66,41,25,0,0.0,0.0
1012,1505,25-09-2019 13:48:00,1,2928.0,2082.0,0.711,13.843,18,9,4,5,9,2,7,0,0.0,0.0
1012,1506,25-09-2019 13:50:00,1,2952.0,2035.0,0.69,13.883,18,8,4,4,10,0,10,0,0.0,0.0
1012,1507,25-09-2019 13:52:00,1,2786.5,1958.0,0.7035,13.146,19,5,4,1,14,0,14,0,0.0,0.0
1012,1508,25-09-2019 13:54:00,1,2621.0,1881.0,0.717,12.409,33,0,0,0,33,0,33,0,0.0,0.0
1012,1509,25-09-2019 13:56:00,1,2627.0,1878.0,0.715,12.431,22,4,2,2,18,2,16,0,0.0,0.0
1012,1510,25-09-2019 13:58:00,1,2731.0,1924.0,0.704,12.892,8,0,0,0,8,0,8,0,0.0,0.0
1012,1511,25-09-2019 14:00:00,1,2615.0,1900.0,0.727,12.407,6,0,0,0,6,0,6,0,0.0,0.0
1012,1512,25-09-2019 14:02:00,1,2620.0,1875.0,0.716,12.397,15,0,0,0,15,1,14,0,0.0,0.0
1012,1513,25-09-2019 14:04:00,1,2635.0,1848.0,0.701,12.427,48,16,9,7,32,19,13,0,0.0,0.0
1012,1514,25-09-2019 14:06:00,1,2765.0,1853.0,0.67,12.948,19,5,4,1,14,7,7,0,0.0,0.0
1012,1515,25-09-2019 14:08:00,1,2647.0,1795.0,0.678,12.419,4,0,0,0,4,1,3,0,0.0,0.0
1012,1516,25-09-2019 14:10:00,1,2634.0,1794.0,0.681,12.365,5,0,0,0,5,0,5,0,0.0,0.0
1012,1517,25-09-2019 14:12:00,1,2675.0,1727.0,0.645,12.453,1,0,0,0,1,0,1,0,0.0,0.0
1012,1518,25-09-2019 14:14:00,1,2541.0,1766.0,0.695,11.969,23,0,0,0,23,6,17,0,0.0,0.0
1012,1519,25-09-2019 14:16:00,1,2533.0,1739.0,0.687,11.904,10,0,0,0,10,5,5,0,0.0,0.0
1012,1520,25-09-2019 14:18:00,1,2671.0,1757.0,0.658,12.469,39,21,16,5,18,10,8,0,0.0,0.0
1012,1521,25-09-2019 14:20:00,1,2421.0,1720.0,0.711,11.442,2,0,0,0,2,0,2,0,0.0,0.0
1012,1522,25-09-2019 14:22:00,1,2419.0,1722.0,0.712,11.439,1,0,0,0,1,0,1,0,0.0,0.0
1012,1523,25-09-2019 14:24:00,1,2540.0,1751.0,0.689,11.948,3,0,0,0,3,1,2,0,0.0,0.0
1012,1524,25-09-2019 14:26:00,1,2602.0,1749.5,0.6725,12.1905,26,13,1,12,13,4,9,0,0.0,0.0
1012,1525,25-09-2019 14:28:00,1,2664.0,1748.0,0.656,12.433,21,12,1,11,9,3,6,0,0.0,0.0
1012,1526,25-09-2019 14:30:00,1,2631.0,1837.0,0.698,12.4,15,5,1,4,10,1,9,0,0.0,0.0
1012,1527,25-09-2019 14:32:00,1,2645.0,1837.0,0.695,12.454,5,3,0,3,2,1,1,0,0.0,0.0
1012,1528,25-09-2019 14:34:00,1,2652.0,1829.0,0.69,12.472,25,21,0,21,4,0,4,0,0.0,0.0
1012,1529,25-09-2019 14:36:00,1,2617.0,1884.0,0.72,12.397,59,22,11,11,37,22,15,0,0.0,0.0
1012,1530,25-09-2019 14:38:00,1,2425.0,1735.0,0.715,11.476,5,0,0,0,5,0,5,0,0.0,0.0
1012,1531,25-09-2019 14:40:00,1,2450.0,1624.0,0.663,11.453,4,0,0,0,4,2,2,0,0.0,0.0
1012,1532,25-09-2019 14:42:00,1,2405.0,1784.0,0.742,11.453,23,12,2,10,11,6,5,0,0.0,0.0
1012,1533,25-09-2019 14:44:00,1,2635.0,1860.0,0.706,12.442,122,35,25,10,87,54,33,7,0.0,0.0
1012,1534,25-09-2019 14:46:00,1,2662.0,1726.0,0.648,12.401,36,12,2,10,24,7,17,0,0.0,0.0
1012,1535,25-09-2019 14:48:00,1,2637.0,1791.0,0.679,12.372,85,56,27,29,29,7,22,0,0.0,0.0
1012,1536,25-09-2019 14:50:00,1,2610.0,1938.0,0.742,12.431,147,78,42,36,69,37,32,0,0.0,0.0
1012,1537,25-09-2019 14:52:00,1,2854.0,1957.0,0.686,13.414,99,51,22,29,48,14,34,0,0.0,0.0
1012,1538,25-09-2019 14:54:00,1,2854.0,1921.0,0.673,13.372,121,69,29,40,52,17,35,0,0.0,0.0
1012,1539,25-09-2019 14:56:00,1,2944.0,2059.0,0.699,13.88,166,90,57,33,76,49,27,6,0.0,0.0
1012,1540,25-09-2019 14:58:00,1,2713.0,2023.0,0.746,12.93,45,16,8,8,29,17,12,0,0.0,0.0
1012,1541,25-09-2019 15:00:00,1,2819.5,2052.5,0.729,13.3815,98,35,22,13,63,28,35,0,0.0,0.0
1012,1542,25-09-2019 15:02:00,1,2926.0,2082.0,0.712,13.833,297,125,92,33,172,131,41,53,0.0,0.0
1012,1543,25-09-2019 15:04:00,1,3012.0,2221.0,0.737,14.329,58,36,12,24,22,5,17,0,0.0,0.0
1012,1544,25-09-2019 15:06:00,1,3106.0,2348.0,0.756,14.837,878,342,260,82,536,432,104,15,0.0,0.0
1012,1545,25-09-2019 15:08:00,1,2914.0,2203.0,0.756,13.922,572,231,178,53,341,279,62,8,0.0,0.0
1012,1546,25-09-2019 15:10:00,1,2930.0,2101.0,0.717,13.872,553,194,136,58,359,288,71,46,0.0,0.0
1012,1547,25-09-2019 15:12:00,1,3123.0,2206.0,0.706,14.749,561,267,199,68,294,227,67,12,0.0,0.0
1012,1548,25-09-2019 15:14:00,1,3525.0,2564.0,0.727,16.729,294,130,91,39,164,137,27,10,0.0,0.0
1012,1549,25-09-2019 15:16:00,1,2915.0,2118.0,0.727,13.829,44,40,17,23,4,2,2,1,0.0,0.0
1012,1550,25-09-2019 15:18:00,1,2915.0,2179.0,0.747,13.898,27,27,5,22,0,0,0,0,0.0,0.0
1012,1551,25-09-2019 15:20:00,1,2934.0,2097.0,0.715,13.881,4,4,2,2,0,0,0,0,0.0,0.0
1012,1552,25-09-2019 15:22:00,1,2821.0,1994.0,0.707,13.324,0,0,0,0,0,0,0,0,0.0,0.0
1012,1553,25-09-2019 15:24:00,1,2622.0,1906.0,0.727,12.443,1,1,1,0,0,0,0,0,0.0,0.0
1012,1554,25-09-2019 15:26:00,1,2620.0,1869.0,0.713,12.393,5,5,3,2,0,0,0,0,0.0,0.0
1012,1555,25-09-2019 15:28:00,1,2423.0,1753.0,0.723,11.488,0,0,0,0,0,0,0,0,0.0,0.0
1012,1556,25-09-2019 15:30:00,1,2430.0,1696.0,0.698,11.452,23,22,10,12,1,0,1,0,0.0,0.0
1012,1557,25-09-2019 15:32:00,1,2425.0,1747.0,0.721,11.488,0,0,0,0,0,0,0,0,0.0,0.0
1012,1558,25-09-2019 15:34:00,1,2384.0,1659.0,0.696,11.23,0,0,0,0,0,0,0,0,0.0,0.0
1012,1559,25-09-2019 15:36:00,1,2343.0,1571.0,0.671,10.972,11,9,3,6,2,1,1,0,0.0,0.0
1012,1560,25-09-2019 15:38:00,1,2220.0,1633.0,0.735,10.555,11,0,0,0,11,4,7,0,0.0,0.0
1012,1561,25-09-2019 15:40:00,1,2453.0,1641.0,0.669,11.484,7,7,3,4,0,0,0,0,0.0,0.0
1012,1562,25-09-2019 15:42:00,1,2452.0,1645.0,0.671,11.483,383,381,343,38,2,0,2,0,0.0,0.0
1012,1563,25-09-2019 15:44:00,1,2446.0,1639.0,0.67,11.452,225,219,175,44,6,0,6,0,0.0,0.0
1012,1564,25-09-2019 15:46:00,1,2216.0,1617.0,0.73,10.523,80,55,22,33,25,0,25,0,0.0,0.0
1012,1565,25-09-2019 15:48:00,1,2331.0,1599.0,0.686,10.956,9,8,4,4,1,0,1,0,0.0,0.0
1012,1566,25-09-2019 15:50:00,1,2452.0,1624.0,0.662,11.459,9,5,1,4,4,0,4,0,0.0,0.0
1012,1567,25-09-2019 15:52:00,1,2329.0,1618.0,0.695,10.968,1,1,0,1,0,0,0,0,0.0,0.0
1012,1568,25-09-2019 15:54:00,1,2338.0,1589.0,0.68,10.969,0,0,0,0,0,0,0,0,0.0,0.0
1012,1569,25-09-2019 15:56:00,1,2217.0,1599.0,0.721,10.505,2,0,0,0,2,1,1,0,0.0,0.0
1012,1570,25-09-2019 15:58:00,1,2455.0,1655.0,0.674,11.506,0,0,0,0,0,0,0,0,0.0,0.0
1012,1571,25-09-2019 16:00:00,1,2457.0,1633.0,0.665,11.49,22,11,0,11,11,4,7,0,0.0,0.0
1012,1572,25-09-2019 16:02:00,1,2437.0,1694.0,0.695,11.478,5,0,0,0,5,2,3,0,0.0,0.0
1012,1573,25-09-2019 16:04:00,1,2328.0,1637.0,0.703,10.987,0,0,0,0,0,0,0,0,0.0,0.0
1012,1574,25-09-2019 16:06:00,1,2224.0,1598.0,0.718,10.531,6,3,0,3,3,0,3,0,0.0,0.0
1012,1575,25-09-2019 16:08:00,1,2340.5,1640.0,0.7015,11.037,9,6,0,6,3,0,3,0,0.0,0.0
1012,1576,25-09-2019 16:10:00,1,2457.0,1682.0,0.685,11.543,6,2,0,2,4,0,4,0,0.0,0.0
1012,1577,25-09-2019 16:12:00,1,2211.0,1603.0,0.725,10.488,5,1,0,1,4,1,3,0,0.0,0.0
1012,1578,25-09-2019 16:14:00,1,2218.0,1582.0,0.713,10.489,5,0,0,0,5,1,4,0,0.0,0.0
1012,1579,25-09-2019 16:16:00,1,2229.0,1541.0,0.691,10.487,0,0,0,0,0,0,0,0,0.0,0.0
1012,1580,25-09-2019 16:18:00,1,2227.0,1571.0,0.705,10.514,8,3,0,3,5,1,4,0,0.0,0.0
1012,1581,25-09-2019 16:20:00,1,2203.0,1666.0,0.756,10.527,51,28,7,21,23,12,11,0,0.0,0.0
1012,1582,25-09-2019 16:22:00,1,2306.0,1701.0,0.738,10.97,5,5,2,3,0,0,0,0,0.0,0.0
1012,1583,25-09-2019 16:24:00,1,2209.0,1666.0,0.754,10.548,12,12,5,7,0,0,0,0,0.0,0.0
1012,1584,25-09-2019 16:26:00,1,2210.0,1638.0,0.741,10.521,13,10,0,10,3,1,2,0,0.0,0.0
1012,1585,25-09-2019 16:28:00,1,2215.0,1621.0,0.732,10.523,2,2,0,2,0,0,0,0,0.0,0.0
1012,1586,25-09-2019 16:30:00,1,2235.0,1519.0,0.68,10.487,3,3,0,3,0,0,0,0,0.0,0.0
1012,1587,25-09-2019 16:32:00,1,2218.0,1629.0,0.735,10.542,1,0,0,0,1,0,1,0,0.0,0.0
1012,1588,25-09-2019 16:34:00,1,2217.0,1640.0,0.74,10.55,4,1,0,1,3,0,3,0,0.0,0.0
1012,1589,25-09-2019 16:36:00,1,2197.0,1648.0,0.75,10.48,6,5,2,3,1,1,0,0,0.0,0.0
1012,1590,25-09-2019 16:38:00,1,2206.0,1646.0,0.746,10.516,0,0,0,0,0,0,0,0,0.0,0.0
1012,1591,25-09-2019 16:40:00,1,2226.0,1602.0,0.72,10.544,6,5,2,3,1,1,0,0,0.0,0.0
1012,1592,25-09-2019 16:42:00,1,2294.5,1554.5,0.679,10.762,2,0,0,0,2,0,2,0,0.0,0.0
1012,1593,25-09-2019 16:44:00,1,2363.0,1507.0,0.638,10.98,14,12,6,6,2,1,1,0,0.0,0.0
1012,1594,25-09-2019 16:46:00,1,2342.0,1611.0,0.688,11.011,242,124,85,39,118,97,21,22,0.0,0.0
1012,1595,25-09-2019 16:48:00,1,2741.0,1900.0,0.693,12.904,142,82,43,39,60,50,10,1,0.0,0.0
1012,1596,25-09-2019 16:50:00,1,2739.0,1949.0,0.712,12.952,9,7,1,6,2,1,1,0,0.0,0.0
1012,1597,25-09-2019 16:52:00,1,2845.0,1988.0,0.699,13.409,28,19,0,19,9,1,8,0,0.0,0.0
1012,1598,25-09-2019 16:54:00,1,2963.0,2012.0,0.679,13.905,50,29,6,23,21,1,20,0,0.0,0.0
1012,1599,25-09-2019 16:56:00,1,3020.0,2129.0,0.705,14.256,53,39,8,31,14,2,12,0,0.0,0.0
1012,1600,25-09-2019 16:58:00,1,3058.0,2058.0,0.673,14.33,160,105,65,40,55,18,37,27,0.0,0.0
1012,1601,25-09-2019 17:00:00,1,3236.0,2261.0,0.699,15.254,290,178,129,49,112,68,44,62,0.0,0.0
1012,1602,25-09-2019 17:02:00,1,3218.0,2348.0,0.73,15.278,469,323,256,67,146,96,50,86,0.0,0.0
1012,1603,25-09-2019 17:04:00,1,3353.0,2403.0,0.716,15.872,340,233,172,61,107,67,40,54,0.0,0.0
1012,1604,25-09-2019 17:06:00,1,3217.0,2411.0,0.749,15.344,476,225,178,47,251,194,57,125,0.0,0.0
1012,1605,25-09-2019 17:08:00,1,3548.0,2478.0,0.698,16.722,467,172,124,48,295,237,58,35,0.0,0.0
1012,1606,25-09-2019 17:10:00,1,3049.0,2190.0,0.718,14.44,438,110,84,26,328,259,69,75,0.0,0.0
1012,1607,25-09-2019 17:12:00,1,3223.0,2339.0,0.725,15.29,161,45,20,25,116,73,43,1,0.0,0.0
1012,1608,25-09-2019 17:14:00,1,2955.0,1968.0,0.666,13.821,29,3,1,2,26,11,15,0,0.0,0.0
1012,1609,25-09-2019 17:16:00,1,2937.0,2032.5,0.692,13.823,64,21,8,13,43,18,25,0,0.0,0.0
1012,1610,25-09-2019 17:18:00,1,2919.0,2097.0,0.718,13.825,80,35,17,18,45,24,21,0,0.0,0.0
1012,1611,25-09-2019 17:20:00,1,3027.0,2189.0,0.723,14.349,70,28,1,27,42,22,20,0,0.0,0.0
1012,1612,25-09-2019 17:22:00,1,3147.0,2215.0,0.704,14.852,8,0,0,0,8,1,7,0,0.0,0.0
1012,1613,25-09-2019 17:24:00,1,2894.0,2207.0,0.763,13.848,18,2,1,1,16,6,10,0,0.0,0.0
1012,1614,25-09-2019 17:26:00,1,2933.0,2079.0,0.709,13.859,3,0,0,0,3,1,2,0,0.0,0.0
1012,1615,25-09-2019 17:28:00,1,2950.0,2047.0,0.694,13.889,2,0,0,0,2,0,2,0,0.0,0.0
1012,1616,25-09-2019 17:30:00,1,2825.0,2045.0,0.724,13.394,8,1,0,1,7,2,5,0,0.0,0.0
1012,1617,25-09-2019 17:32:00,1,2950.0,1978.0,0.67,13.815,9,0,0,0,9,0,9,0,0.0,0.0
1012,1618,25-09-2019 17:34:00,1,2946.0,2044.0,0.694,13.869,7,0,0,0,7,3,4,0,0.0,0.0
1012,1619,25-09-2019 17:36:00,1,2949.0,1996.0,0.677,13.829,16,0,0,0,16,9,7,0,0.0,0.0
1012,1620,25-09-2019 17:38:00,1,2950.0,2005.0,0.68,13.845,11,1,0,1,10,5,5,0,0.0,0.0
1012,1621,25-09-2019 17:40:00,1,2620.0,1908.0,0.728,12.437,43,0,0,0,43,8,35,0,0.0,0.0
1012,1622,25-09-2019 17:42:00,1,2635.0,1871.0,0.71,12.454,153,59,35,24,94,46,48,0,0.0,0.0
1012,1623,25-09-2019 17:44:00,1,2825.0,2050.0,0.726,13.399,151,92,39,53,59,29,30,13,0.0,0.0
1012,1624,25-09-2019 17:46:00,1,3120.0,2331.0,0.747,14.875,211,125,91,34,86,41,45,63,0.0,0.0
1012,1625,25-09-2019 17:48:00,1,3489.0,2734.0,0.784,16.773,407,247,188,59,160,105,55,97,0.0,0.0
1012,1626,25-09-2019 17:50:00,1,3570.5,2652.0,0.744,17.0035,226,112,85,27,114,65,49,72,0.0,0.0
1012,1627,25-09-2019 17:52:00,1,3652.0,2570.0,0.704,17.234,183,81,46,35,102,61,41,54,0.0,0.0
1012,1628,25-09-2019 17:54:00,1,3712.0,2708.0,0.73,17.625,148,45,22,23,103,38,65,64,0.0,0.0
1012,1629,25-09-2019 17:56:00,1,3823.0,2741.0,0.717,18.098,214,81,52,29,133,64,69,42,0.0,0.0
1012,1630,25-09-2019 17:58:00,1,3552.0,2465.0,0.694,16.726,538,202,155,47,336,261,75,48,0.0,0.0
1012,1631,25-09-2019 18:00:00,0,3227.0,2328.0,0.721,15.293,619,21,4,17,598,540,58,0,0.0,0.0
1012,1632,25-09-2019 18:02:00,0,3240.0,2293.0,0.708,15.303,324,123,94,29,201,158,43,68,0.0,0.0
1012,1633,25-09-2019 18:04:00,0,3210.0,2416.0,0.752,15.323,382,205,152,53,177,116,61,81,0.0,0.0
1012,1634,25-09-2019 18:06:00,0,3665.0,2542.0,0.694,17.254,208,89,57,32,119,55,64,66,0.0,0.0
1012,1635,25-09-2019 18:08:00,0,3528.0,2592.0,0.735,16.771,101,29,15,14,72,44,28,0,0.0,0.0
1012,1636,25-09-2019 18:10:00,0,3259.0,2200.0,0.675,15.277,68,35,9,26,33,13,20,0,0.0,0.0
1012,1637,25-09-2019 18:12:00,0,3329.0,2340.0,0.703,15.707,85,52,21,31,33,19,14,0,0.0,0.0
1012,1638,25-09-2019 18:14:00,0,3522.0,2542.0,0.722,16.69,329,154,109,45,175,114,61,62,0.0,0.0
1012,1639,25-09-2019 18:16:00,0,3942.0,2821.0,0.716,18.654,143,43,21,22,100,38,62,42,0.0,0.0
1012,1640,25-09-2019 18:18:00,0,3931.0,2861.0,0.728,18.655,173,51,22,29,122,75,47,29,0.0,0.0
1012,1641,25-09-2019 18:20:00,0,3991.0,3019.0,0.757,19.066,148,58,31,27,90,33,57,53,0.0,0.0
1012,1642,25-09-2019 18:22:00,0,4206.0,3196.0,0.76,20.11,129,19,9,10,110,70,40,11,0.0,0.03
1012,1643,25-09-2019 18:24:00,0,4097.5,3131.5,0.7645,19.6115,29,16,6,10,13,7,6,8,0.0,0.0
1012,1644,25-09-2019 18:26:00,0,3989.0,3067.0,0.769,19.113,301,127,95,32,174,136,38,132,0.0,0.04
1012,1645,25-09-2019 18:28:00,0,4283.0,3349.0,0.782,20.583,80,13,4,9,67,44,23,8,0.0,0.0
1012,1646,25-09-2019 18:30:00,0,4069.0,3262.0,0.802,19.644,276,130,105,25,146,114,32,111,0.02,0.03
1012,1647,25-09-2019 18:32:00,0,3473.0,2776.0,0.799,16.756,166,89,58,31,77,57,20,91,0.01,0.0
1012,1648,25-09-2019 18:34:00,0,3758.0,3018.0,0.803,18.15,305,130,105,25,175,129,46,48,0.19,0.0
1012,1649,25-09-2019 18:36:00,0,3094.0,2395.0,0.774,14.841,209,35,16,19,174,107,67,0,0.0,0.0
1012,1650,25-09-2019 18:38:00,0,3077.0,2465.0,0.801,14.851,264,47,17,30,217,165,52,0,0.0,0.01
1012,1651,25-09-2019 18:40:00,0,3599.0,2814.0,0.782,17.294,181,63,26,37,118,76,42,0,0.0,0.0
1012,1652,25-09-2019 18:42:00,0,3295.0,2593.0,0.787,15.851,21,6,0,6,15,5,10,0,0.0,0.0
1012,1653,25-09-2019 18:44:00,0,3370.0,2610.0,0.774,16.169,10,2,0,2,8,4,4,0,0.0,0.01
1012,1654,25-09-2019 18:46:00,0,3363.0,2741.0,0.815,16.288,10,0,0,0,10,7,3,0,0.0,0.0
1012,1655,25-09-2019 18:48:00,0,3376.0,2698.0,0.799,16.289,11,5,2,3,6,2,4,0,0.0,0.0
1012,1656,25-09-2019 18:50:00,0,3409.0,2536.0,0.744,16.239,9,0,0,0,9,2,7,0,0.0,0.0
1012,1657,25-09-2019 18:52:00,0,3327.0,2854.0,0.858,16.267,14,2,1,1,12,6,6,0,0.0,0.0
1012,1658,25-09-2019 18:54:00,0,3381.0,2674.0,0.791,16.282,18,7,3,4,11,4,7,0,0.0,0.0
1012,1659,25-09-2019 18:56:00,0,3004.0,2671.0,0.889,14.794,19,3,1,2,16,6,10,0,0.0,0.0
1012,1660,25-09-2019 18:58:00,0,3128.5,2702.0,0.8645,15.318,12,0,0,0,12,4,8,0,0.0,0.0
1012,1661,25-09-2019 19:00:00,0,3253.0,2733.0,0.84,15.842,90,29,14,15,61,34,27,0,0.0,0.0
1012,1662,25-09-2019 19:02:00,0,3538.0,2900.0,0.819,17.152,257,110,76,34,147,87,60,64,0.0,0.0
1012,1663,25-09-2019 19:04:00,0,3826.0,3272.0,0.855,18.696,129,55,27,28,74,30,44,39,0.0,0.0
1012,1664,25-09-2019 19:06:00,0,3723.0,3180.0,0.854,18.188,125,36,19,17,89,55,34,25,0.0,0.0
1012,1665,25-09-2019 19:08:00,0,4003.0,3445.0,0.861,19.587,289,119,96,23,170,121,49,88,0.0,0.03
1012,1666,25-09-2019 19:10:00,0,3543.0,3012.0,0.85,17.295,141,37,21,16,104,35,69,65,0.0,0.0
1012,1667,25-09-2019 19:12:00,0,4101.0,3525.0,0.86,20.06,190,24,3,21,166,138,28,11,0.0,0.07
1012,1668,25-09-2019 19:14:00,0,4177.0,3703.0,0.887,20.556,354,131,110,21,223,186,37,135,0.0,0.02
1012,1669,25-09-2019 19:16:00,0,3434.0,2916.0,0.849,16.759,311,145,118,27,166,133,33,167,0.0,0.0
1012,1670,25-09-2019 19:18:00,0,3335.0,2860.0,0.858,16.305,173,95,73,22,78,60,18,124,0.0,0.0
1012,1671,25-09-2019 19:20:00,0,3489.0,3127.0,0.896,17.208,192,108,90,18,84,67,17,161,0.0,0.0
1012,1672,25-09-2019 19:22:00,0,3914.0,3360.0,0.859,19.141,176,86,61,25,90,33,57,72,0.0,0.0
1012,1673,25-09-2019 19:24:00,0,4693.0,4078.0,0.869,23.007,144,55,36,19,89,50,39,11,0.0,0.04
1012,1674,25-09-2019 19:26:00,0,3516.0,3026.0,0.861,17.205,240,105,84,21,135,107,28,115,0.0,0.0
1012,1675,25-09-2019 19:28:00,0,3802.0,3385.0,0.89,18.727,319,177,131,46,142,104,38,92,0.0,0.0
1012,1676,25-09-2019 19:30:00,0,3312.0,2911.0,0.879,16.271,176,104,86,18,72,54,18,102,0.0,0.0
1012,1677,25-09-2019 19:32:00,0,3956.5,3466.5,0.8765,19.4255,368,179,142,37,189,158,31,179,0.0,0.01
1012,1678,25-09-2019 19:34:00,0,4601.0,4022.0,0.874,22.58,290,148,128,20,142,108,34,158,0.0,0.0
1012,1679,25-09-2019 19:36:00,0,4671.0,4066.0,0.871,22.904,152,77,46,31,75,37,38,47,0.01,0.0
1012,1680,25-09-2019 19:38:00,0,4951.0,4403.0,0.889,24.383,115,53,38,15,62,37,25,23,0.0,0.05
1012,1681,25-09-2019 19:40:00,0,4002.0,3523.0,0.88,19.666,334,193,150,43,141,106,35,149,0.03,0.0
1012,1682,25-09-2019 19:42:00,0,4215.0,3654.0,0.867,20.652,254,119,97,22,135,101,34,168,0.01,0.04
1012,1683,25-09-2019 19:44:00,0,3889.0,3421.0,0.88,19.11,397,213,173,40,184,142,42,155,0.01,0.0
1012,1684,25-09-2019 19:46:00,0,4305.0,3740.0,0.869,21.104,232,114,88,26,118,88,30,90,0.0,0.0
1012,1685,25-09-2019 19:48:00,0,4200.0,3660.0,0.871,20.6,92,34,14,20,58,41,17,42,0.01,0.0
1012,1686,25-09-2019 19:50:00,0,5041.0,4573.0,0.907,24.923,81,29,10,19,52,35,17,43,0.0,0.01
1012,1687,25-09-2019 19:52:00,0,4469.0,4000.0,0.895,22.036,330,144,118,26,186,112,74,45,0.0,0.01
1012,1688,25-09-2019 19:54:00,0,3686.0,3289.0,0.892,18.166,184,71,29,42,113,74,39,10,0.0,0.0
1012,1689,25-09-2019 19:56:00,0,3249.0,2721.0,0.838,15.813,75,19,3,16,56,31,25,0,0.0,0.0
1012,1690,25-09-2019 19:58:00,0,3143.0,2627.0,0.836,15.292,124,58,30,28,66,39,27,0,0.0,0.0
1012,1691,25-09-2019 20:00:00,0,3254.0,2691.0,0.827,15.799,83,30,5,25,53,31,22,0,0.0,0.0
1012,1692,25-09-2019 20:02:00,0,3717.0,3182.0,0.856,18.168,128,65,36,29,63,42,21,48,0.0,0.0
1012,1693,25-09-2019 20:04:00,0,4689.0,4092.0,0.873,23.004,177,61,41,20,116,87,29,74,0.01,0.0
1012,1694,25-09-2019 20:06:00,0,5045.0,4522.0,0.895,24.884,65,16,4,12,49,32,17,17,0.0,0.02
1012,1695,25-09-2019 20:08:00,0,5401.0,4952.0,0.917,26.764,52,7,2,5,45,28,17,4,0.0,0.08
1012,1696,25-09-2019 20:10:00,0,5154.0,4695.0,0.911,25.503,167,47,37,10,120,85,35,20,0.01,0.02
1012,1697,25-09-2019 20:12:00,0,4427.0,4022.0,0.908,21.897,349,174,135,39,175,131,44,126,0.11,0.01
1012,1698,25-09-2019 20:14:00,0,3970.0,3615.0,0.911,19.646,157,84,54,30,73,58,15,87,0.0,0.0
1012,1699,25-09-2019 20:16:00,0,5038.0,4624.0,0.918,24.97,122,15,2,13,107,60,47,6,0.0,0.07
1012,1700,25-09-2019 20:18:00,0,5231.0,4753.0,0.909,25.873,213,50,28,22,163,137,26,4,0.03,0.05
1012,1701,25-09-2019 20:20:00,0,4234.0,3959.0,0.935,21.065,78,31,16,15,47,28,19,0,0.0,0.01
1012,1702,25-09-2019 20:22:00,0,3778.0,3437.0,0.91,18.69,28,9,1,8,19,0,19,0,0.0,0.0
1012,1703,25-09-2019 20:24:00,0,3497.0,3085.0,0.882,17.192,45,13,9,4,32,16,16,0,0.01,0.0
1012,1704,25-09-2019 20:26:00,0,3369.0,2734.0,0.812,16.299,32,0,0,0,32,4,28,0,0.0,0.0
1012,1705,25-09-2019 20:28:00,0,3013.0,2669.0,0.886,14.825,25,0,0,0,25,4,21,0,0.0,0.0
1012,1706,25-09-2019 20:30:00,0,3031.0,2573.0,0.849,14.79,58,11,5,6,47,12,35,0,0.0,0.0
1012,1707,25-09-2019 20:32:00,0,3029.0,2661.0,0.879,14.881,25,0,0,0,25,0,25,0,0.0,0.0
1012,1708,25-09-2019 20:34:00,0,3038.0,2602.0,0.856,14.851,28,0,0,0,28,4,24,0,0.0,0.0
1012,1709,25-09-2019 20:36:00,0,3033.0,2626.0,0.866,14.858,34,0,0,0,34,2,32,0,0.0,0.0
1012,1710,25-09-2019 20:38:00,0,3024.0,2675.0,0.885,14.876,239,108,74,34,131,91,40,32,0.0,0.0
1012,1711,25-09-2019 20:40:00,0,3913.5,3562.5,0.9055,19.3635,148,18,5,13,130,84,46,14,0.0,0.03
1012,1712,25-09-2019 20:42:00,0,4803.0,4450.0,0.926,23.851,91,21,6,15,70,55,15,10,0.0,0.05
1012,1713,25-09-2019 20:44:00,0,4787.0,4685.0,0.979,24.048,58,18,7,11,40,30,10,8,0.0,0.06
1012,1714,25-09-2019 20:46:00,0,4790.0,4674.0,0.976,24.049,23,17,6,11,6,4,2,9,0.0,0.09
1012,1715,25-09-2019 20:48:00,0,4584.0,4382.0,0.956,22.913,275,115,82,33,160,123,37,126,0.11,0.02
1012,1716,25-09-2019 20:50:00,0,4109.0,3964.0,0.965,20.579,344,164,131,33,180,139,41,169,0.0,0.0
1012,1717,25-09-2019 20:52:00,0,3758.0,3500.0,0.931,18.682,322,159,127,32,163,131,32,141,0.0,0.0
1012,1718,25-09-2019 20:54:00,0,3939.0,3721.0,0.945,19.638,376,202,149,53,174,131,43,135,0.01,0.0
1012,1719,25-09-2019 20:56:00,0,4343.0,4007.0,0.923,21.549,230,127,98,29,103,71,32,100,0.04,0.0
1012,1720,25-09-2019 20:58:00,0,4354.0,4017.0,0.923,21.602,351,115,80,35,236,181,55,60,0.03,0.0
1012,1721,25-09-2019 21:00:00,0,3972.0,3672.0,0.924,19.716,195,86,55,31,109,68,41,24,0.0,0.0
1012,1722,25-09-2019 21:02:00,0,3767.0,3537.0,0.939,18.758,152,75,50,25,77,60,17,87,0.0,0.0
1012,1723,25-09-2019 21:04:00,0,5273.0,4943.0,0.937,26.248,67,8,0,8,59,15,44,6,0.0,0.09
1012,1724,25-09-2019 21:06:00,0,5369.0,5161.0,0.961,26.867,48,7,0,7,41,35,6,4,0.0,0.04
1012,1725,25-09-2019 21:08:00,0,5288.0,4952.0,0.936,26.318,137,4,0,4,133,53,80,2,0.0,0.17
1012,1726,25-09-2019 21:10:00,0,4815.0,4515.0,0.938,23.969,28,0,0,0,28,7,21,0,0.0,0.01
1012,1727,25-09-2019 21:12:00,0,4905.0,4667.0,0.951,24.493,135,64,46,18,71,39,32,9,0.02,0.0
1012,1728,25-09-2019 21:14:00,0,4400.0,4064.5,0.92,21.8355,353,172,132,40,181,129,52,144,0.13,0.01
1012,1729,25-09-2019 21:16:00,0,3895.0,3462.0,0.889,19.178,214,91,52,39,123,92,31,5,0.0,0.0
1012,1730,25-09-2019 21:18:00,0,3323.0,2918.0,0.878,16.322,241,124,93,31,117,85,32,120,0.0,0.0
1012,1731,25-09-2019 21:20:00,0,4847.0,4478.0,0.924,24.055,319,124,93,31,195,145,50,80,0.05,0.0
1012,1732,25-09-2019 21:22:00,0,4634.0,4224.0,0.912,22.935,218,117,89,28,101,75,26,128,0.12,0.0
1012,1733,25-09-2019 21:24:00,0,4645.0,4171.0,0.898,22.92,222,135,108,27,87,70,17,118,0.0,0.0
1012,1734,25-09-2019 21:26:00,0,4614.0,4242.0,0.919,22.876,265,153,123,30,112,88,24,118,0.0,0.0
1012,1735,25-09-2019 21:28:00,0,4833.0,4375.0,0.905,23.884,263,142,114,28,121,100,21,168,0.0,0.0
1012,1736,25-09-2019 21:30:00,0,4761.0,4317.0,0.907,23.537,293,169,139,30,124,104,20,191,0.0,0.0
1012,1737,25-09-2019 21:32:00,0,4727.0,4380.0,0.926,23.473,113,51,28,23,62,38,24,34,0.0,0.0
1012,1738,25-09-2019 21:34:00,0,4151.0,3720.0,0.896,20.474,378,180,145,35,198,154,44,120,0.0,0.0
1012,1739,25-09-2019 21:36:00,0,5131.0,4679.0,0.912,25.398,266,133,89,44,133,99,34,75,0.03,0.0
1012,1740,25-09-2019 21:38:00,0,4824.0,4531.0,0.939,24.025,180,63,33,30,117,72,45,0,0.0,0.0
1012,1741,25-09-2019 21:40:00,0,4421.0,4047.0,0.915,21.9,194,50,17,33,144,92,52,0,0.0,0.0
1012,1742,25-09-2019 21:42:00,0,4489.0,3943.0,0.878,22.051,200,44,15,29,156,110,46,0,0.0,0.0
1012,1743,25-09-2019 21:44:00,0,4370.0,3936.0,0.901,21.577,583,103,62,41,480,427,53,0,0.0,0.0
1012,1744,25-09-2019 21:46:00,0,4240.0,3947.0,0.931,21.075,109,31,16,15,78,70,8,0,0.0,0.0
1012,1745,25-09-2019 21:48:00,0,4156.0,3847.0,0.9255,20.634,17,9,4,5,8,8,0,0,0.0,0.0
1012,1746,25-09-2019 21:50:00,0,4072.0,3747.0,0.92,20.193,35,13,6,7,22,21,1,0,0.0,0.0
1012,1747,25-09-2019 21:52:00,0,3994.0,3503.0,0.877,19.616,58,24,3,21,34,13,21,0,0.0,0.0
1012,1748,25-09-2019 21:54:00,0,3797.0,3423.0,0.901,18.75,45,28,4,24,17,6,11,0,0.0,0.0
1012,1749,25-09-2019 21:56:00,0,3679.0,3371.0,0.917,18.226,24,5,1,4,19,9,10,0,0.0,0.0
1012,1750,25-09-2019 21:58:00,0,3696.0,3242.0,0.877,18.153,7,2,0,2,5,2,3,0,0.0,0.0
1012,1751,25-09-2019 22:00:00,0,3497.0,3200.0,0.915,17.321,8,2,0,2,6,0,6,0,0.0,0.0
1012,1752,25-09-2019 22:02:00,0,3294.0,2984.0,0.906,16.282,266,127,103,24,139,113,26,14,0.0,0.0
1012,1753,25-09-2019 22:04:00,0,3274.0,3063.0,0.936,16.291,178,82,50,32,96,58,38,13,0.0,0.0
1012,1754,25-09-2019 22:06:00,0,3971.0,3650.0,0.919,19.688,77,11,0,11,66,32,34,11,0.0,0.03
1012,1755,25-09-2019 22:08:00,0,3928.0,3705.0,0.943,19.577,104,17,3,14,87,36,51,9,0.0,0.07
1012,1756,25-09-2019 22:10:00,0,3779.0,3526.0,0.933,18.792,148,25,11,14,123,63,60,30,0.0,0.04
1012,1757,25-09-2019 22:12:00,0,3581.0,3235.0,0.904,17.69,319,175,138,37,144,107,37,137,0.0,0.01
1012,1758,25-09-2019 22:14:00,0,3467.0,3190.0,0.92,17.191,346,201,162,39,145,119,26,183,0.0,0.0
1012,1759,25-09-2019 22:16:00,0,3479.0,3196.0,0.919,17.245,221,117,99,18,104,84,20,106,0.04,0.0
1012,1760,25-09-2019 22:18:00,0,4226.0,4003.0,0.947,21.082,216,128,100,28,88,66,22,141,0.0,0.0
1012,1761,25-09-2019 22:20:00,0,3986.0,3568.0,0.895,19.656,260,124,95,29,136,99,37,104,0.01,0.05
1012,1762,25-09-2019 22:22:00,0,4068.0,3705.0,0.9105,20.1305,47,27,16,11,20,4,16,6,0.0,0.03
1012,1763,25-09-2019 22:24:00,0,4150.0,3842.0,0.926,20.605,236,110,78,32,126,72,54,66,0.0,0.03
1012,1764,25-09-2019 22:26:00,0,3949.0,3725.0,0.943,19.685,201,124,104,20,77,66,11,183,0.01,0.0
1012,1765,25-09-2019 22:28:00,0,3790.0,3408.0,0.899,18.707,244,113,89,24,131,110,21,134,0.01,0.0
1012,1766,25-09-2019 22:30:00,0,4052.0,3800.0,0.938,20.173,293,110,71,39,183,136,47,42,0.06,0.0
1012,1767,25-09-2019 22:32:00,0,3868.0,3531.0,0.913,19.15,108,68,31,37,40,24,16,0,0.0,0.0
1012,1768,25-09-2019 22:34:00,0,4062.0,3766.0,0.927,20.175,125,75,42,33,50,27,23,8,0.0,0.0
1012,1769,25-09-2019 22:36:00,0,4344.0,3956.0,0.911,21.495,266,151,116,35,115,93,22,137,0.01,0.01
1012,1770,25-09-2019 22:38:00,0,4602.0,4343.0,0.944,22.94,300,144,115,29,156,124,32,152,0.05,0.0
1012,1771,25-09-2019 22:40:00,0,4647.0,4261.0,0.917,23.026,283,138,102,36,145,112,33,122,0.0,0.0
1012,1772,25-09-2019 22:42:00,0,4827.0,4448.0,0.921,23.941,116,18,0,18,98,58,40,14,0.0,0.03
1012,1773,25-09-2019 22:44:00,0,4778.0,4712.0,0.986,24.042,121,39,29,10,82,52,30,3,0.0,0.04
1012,1774,25-09-2019 22:46:00,0,3695.0,3349.0,0.906,18.266,139,84,53,31,55,36,19,6,0.0,0.01
1012,1775,25-09-2019 22:48:00,0,3773.0,3448.0,0.914,18.683,221,120,92,28,101,73,28,84,0.06,0.03
1012,1776,25-09-2019 22:50:00,0,4462.0,4012.0,0.899,22.02,159,61,45,16,98,65,33,46,0.02,0.01
1012,1777,25-09-2019 22:52:00,0,3980.0,3646.0,0.916,19.718,252,120,80,40,132,94,38,51,0.0,0.0
1012,1778,25-09-2019 22:54:00,0,4638.0,4163.0,0.898,22.883,44,26,6,20,18,8,10,14,0.0,0.0
1012,1779,25-09-2019 22:56:00,0,4697.0,4439.0,0.9445,23.4215,54,15,4,11,39,27,12,7,0.0,0.04
1012,1780,25-09-2019 22:58:00,0,4756.0,4715.0,0.991,23.96,70,29,18,11,41,13,28,26,0.0,0.01
1012,1781,25-09-2019 23:00:00,0,3689.0,3291.0,0.892,18.18,82,44,32,12,38,25,13,7,0.0,0.01
1012,1782,25-09-2019 23:02:00,0,3013.0,2655.0,0.881,14.81,229,140,104,36,89,63,26,2,0.0,0.1
1012,1783,25-09-2019 23:04:00,0,4484.0,3958.0,0.883,22.048,553,320,262,58,233,183,50,42,0.0,0.0
1012,1784,25-09-2019 23:06:00,0,4244.0,3982.0,0.938,21.13,228,113,79,34,115,87,28,93,0.04,0.0
1012,1785,25-09-2019 23:08:00,0,3887.0,3470.0,0.893,19.156,152,66,41,25,86,52,34,2,0.01,0.0
1012,1786,25-09-2019 23:10:00,0,4157.0,3824.0,0.92,20.611,569,259,207,52,310,246,64,101,0.02,0.0
1012,1787,25-09-2019 23:12:00,0,4522.0,4205.0,0.93,22.471,533,244,195,49,289,234,55,98,0.02,0.0
1012,1788,25-09-2019 23:14:00,0,4621.0,4290.0,0.928,22.957,371,203,162,41,168,125,43,118,0.0,0.0
1012,1789,25-09-2019 23:16:00,0,4123.0,3953.0,0.959,20.62,134,63,29,34,71,39,32,16,0.0,0.0
1012,1790,25-09-2019 23:18:00,0,4141.0,3931.0,0.949,20.668,159,77,44,33,82,44,38,2,0.0,0.0
1012,1791,25-09-2019 23:20:00,0,4061.0,3738.0,0.92,20.138,86,43,22,21,43,20,23,0,0.0,0.0
1012,1792,25-09-2019 23:22:00,0,3985.0,3606.0,0.905,19.694,19,12,5,7,7,1,6,0,0.0,0.0
1012,1793,25-09-2019 23:24:00,0,3722.0,3578.0,0.961,18.625,6,2,0,2,4,0,4,0,0.0,0.0
1012,1794,25-09-2019 23:26:00,0,3666.0,3390.0,0.925,18.196,12,0,0,0,12,5,7,0,0.0,0.0
1012,1795,25-09-2019 23:28:00,0,3700.0,3328.0,0.899,18.264,16,0,0,0,16,8,8,0,0.0,0.0
1012,1796,25-09-2019 23:30:00,0,3610.5,3211.0,0.889,17.78,40,10,7,3,30,19,11,0,0.0,0.0
1012,1797,25-09-2019 23:32:00,0,3521.0,3094.0,0.879,17.296,79,29,14,15,50,30,20,0,0.0,0.0
1012,1798,25-09-2019 23:34:00,0,3503.0,3097.0,0.884,17.232,125,52,28,24,73,42,31,0,0.0,0.0
1012,1799,25-09-2019 23:36:00,0,3475.0,3262.0,0.939,17.303,139,53,31,22,86,60,26,17,0.0,0.0
1012,1800,25-09-2019 23:38:00,0,3466.0,3240.0,0.935,17.243,217,115,83,32,102,76,26,60,0.0,0.0
1012,1801,25-09-2019 23:40:00,0,3847.0,3534.0,0.919,19.069,147,52,34,18,95,36,59,46,0.0,0.0
1012,1802,25-09-2019 23:42:00,0,4062.0,3732.0,0.919,20.135,106,15,2,13,91,39,52,10,0.0,0.0
1012,1803,25-09-2019 23:44:00,0,4141.0,3783.0,0.914,20.503,84,18,0,18,66,50,16,10,0.0,0.02
1012,1804,25-09-2019 23:46:00,0,4135.0,3890.0,0.941,20.599,245,137,108,29,108,83,25,88,0.0,0.02
1012,1805,25-09-2019 23:48:00,0,3687.0,3383.0,0.917,18.274,271,119,92,27,152,119,33,104,0.02,0.0
1012,1806,25-09-2019 23:50:00,0,3836.0,3644.0,0.95,19.146,185,110,86,24,75,59,16,142,0.0,0.03
1012,1807,25-09-2019 23:52:00,0,3413.0,3032.0,0.889,16.804,255,148,109,39,107,75,32,113,0.0,0.0
1012,1808,25-09-2019 23:54:00,0,4167.0,3766.0,0.904,20.589,266,151,116,35,115,92,23,111,0.06,0.02
1012,1809,25-09-2019 23:56:00,0,3928.0,3739.0,0.952,19.616,373,210,164,46,163,126,37,115,0.02,0.0
1012,1810,25-09-2019 23:58:00,0,4046.0,3818.0,0.944,20.168,183,111,78,33,72,49,23,100,0.0,0.0
1012,1811,26-09-2019 00:00:00,0,4430.0,4181.0,0.944,22.084,147,97,64,33,50,25,25,35,0.0,0.0
1012,1812,26-09-2019 00:02:00,0,4463.0,3998.0,0.896,22.01,259,139,108,31,120,78,42,72,0.0,0.03
1012,1813,26-09-2019 00:04:00,0,4204.0,3863.0,0.9205,20.84,258,122,94,28,136,104,32,77,0.0,0.0
1012,1814,26-09-2019 00:06:00,0,3945.0,3728.0,0.945,19.67,150,57,33,24,93,60,33,3,0.07,0.01
1012,1815,26-09-2019 00:08:00,0,3596.0,3186.0,0.886,17.695,44,17,7,10,27,9,18,0,0.0,0.0
1012,1816,26-09-2019 00:10:00,0,3968.0,3530.0,0.89,19.542,58,26,5,21,32,13,19,0,0.0,0.0
1012,1817,26-09-2019 00:12:00,0,3950.0,3737.0,0.946,19.702,59,21,5,16,38,16,22,0,0.0,0.0
1012,1818,26-09-2019 00:14:00,0,3932.0,3657.0,0.93,19.539,20,10,0,10,10,0,10,0,0.0,0.0
1012,1819,26-09-2019 00:16:00,0,3992.0,3596.0,0.901,19.711,107,46,12,34,61,30,31,0,0.0,0.0
1012,1820,26-09-2019 00:18:00,0,3865.0,3532.0,0.914,19.138,27,3,1,2,24,7,17,0,0.0,0.0
1012,1821,26-09-2019 00:20:00,0,3789.0,3438.0,0.907,18.735,38,2,0,2,36,22,14,0,0.0,0.0
1012,1822,26-09-2019 00:22:00,0,3685.0,3334.0,0.905,18.209,24,0,0,0,24,7,17,0,0.0,0.0
1012,1823,26-09-2019 00:24:00,0,3489.0,3183.0,0.912,17.27,11,2,1,1,9,0,9,0,0.0,0.0
1012,1824,26-09-2019 00:26:00,0,3401.0,3094.0,0.91,16.825,48,8,3,5,40,12,28,0,0.0,0.0
1012,1825,26-09-2019 00:28:00,0,3303.0,2959.0,0.896,16.29,17,0,0,0,17,2,15,0,0.0,0.0
1012,1826,26-09-2019 00:30:00,0,3334.0,2888.0,0.866,16.332,16,0,0,0,16,0,16,0,0.0,0.0
1012,1827,26-09-2019 00:32:00,0,3093.0,2805.0,0.907,15.291,31,3,0,3,28,2,26,0,0.0,0.0
1012,1828,26-09-2019 00:34:00,0,2992.0,2739.0,0.916,14.82,32,10,0,10,22,3,19,0,0.0,0.0
1012,1829,26-09-2019 00:36:00,0,3012.0,2672.0,0.887,14.826,38,18,6,12,20,9,11,0,0.0,0.0
1012,1830,26-09-2019 00:38:00,0,3009.5,2700.0,0.897,14.8465,7,0,0,0,7,0,7,0,0.0,0.0
1012,1831,26-09-2019 00:40:00,0,3007.0,2728.0,0.907,14.867,29,2,0,2,27,13,14,0,0.0,0.0
1012,1832,26-09-2019 00:42:00,0,2989.0,2783.0,0.931,14.858,8,0,0,0,8,3,5,0,0.0,0.0
1012,1833,26-09-2019 00:44:00,0,3013.0,2743.0,0.911,14.906,76,18,9,9,58,40,18,0,0.0,0.0
1012,1834,26-09-2019 00:46:00,0,2971.0,2861.0,0.963,14.874,22,2,0,2,20,8,12,0,0.0,0.01
1012,1835,26-09-2019 00:48:00,0,2983.0,2835.0,0.951,14.89,51,22,6,16,29,16,13,0,0.0,0.0
1012,1836,26-09-2019 00:50:00,0,2996.0,2779.0,0.928,14.881,0,0,0,0,0,0,0,0,0.0,0.0
1012,1837,26-09-2019 00:52:00,0,2976.0,2817.0,0.947,14.845,19,1,1,0,18,10,8,0,0.0,0.0
1012,1838,26-09-2019 00:54:00,0,2950.0,2950.0,1.0,14.889,24,1,0,1,23,4,19,0,0.0,0.0
1012,1839,26-09-2019 00:56:00,0,2995.0,2761.0,0.922,14.856,23,3,1,2,20,6,14,0,0.0,0.0
1012,1840,26-09-2019 00:58:00,0,2801.0,2570.0,0.918,13.88,90,31,11,20,59,27,32,1,0.0,0.0
1012,1841,26-09-2019 01:00:00,0,2999.0,2744.0,0.915,14.853,137,68,33,35,69,42,27,0,0.0,0.0
1012,1842,26-09-2019 01:02:00,0,3083.0,2895.0,0.939,15.352,191,120,78,42,71,34,37,1,0.0,0.0
1012,1843,26-09-2019 01:04:00,0,3292.0,3016.0,0.916,16.309,175,62,40,22,113,73,40,42,0.0,0.0
1012,1844,26-09-2019 01:06:00,0,3669.0,3390.0,0.924,18.207,153,60,31,29,93,60,33,25,0.0,0.0
1012,1845,26-09-2019 01:08:00,0,3666.0,3328.0,0.908,18.13,194,136,99,37,58,26,32,47,0.0,0.03
1012,1846,26-09-2019 01:10:00,0,3472.0,3215.0,0.926,17.241,346,161,129,32,185,145,40,118,0.01,0.01
1012,1847,26-09-2019 01:12:00,0,3815.0,3512.0,0.921,18.921,181,60,38,22,121,78,43,43,0.0,0.02
1012,1848,26-09-2019 01:14:00,0,4158.0,3809.0,0.916,20.601,254,107,72,35,147,109,38,69,0.0,0.03
1012,1849,26-09-2019 01:16:00,0,3886.0,3481.0,0.896,19.164,189,87,59,28,102,65,37,59,0.04,0.01
1012,1850,26-09-2019 01:18:00,0,4453.0,4020.0,0.903,21.996,143,16,6,10,127,73,54,15,0.0,0.06
1012,1851,26-09-2019 01:20:00,0,4436.0,4152.0,0.936,22.077,129,24,5,19,105,44,61,23,0.01,0.06
1012,1852,26-09-2019 01:22:00,0,4316.0,4033.0,0.934,21.471,127,29,10,19,98,50,48,13,0.0,0.04
1012,1853,26-09-2019 01:24:00,0,3761.0,3509.0,0.933,18.702,345,176,143,33,169,128,41,70,0.06,0.01
1012,1854,26-09-2019 01:26:00,0,4026.0,3832.0,0.952,20.105,275,147,117,30,128,91,37,92,0.05,0.0
1012,1855,26-09-2019 01:28:00,0,3701.0,3281.0,0.887,18.213,425,205,162,43,220,175,45,106,0.0,0.0
1012,1856,26-09-2019 01:30:00,0,3304.0,2963.0,0.897,16.3,369,157,132,25,212,150,62,156,0.01,0.12
1012,1857,26-09-2019 01:32:00,0,4791.0,4580.0,0.956,23.949,292,161,139,22,131,98,33,146,0.0,0.0
1012,1858,26-09-2019 01:34:00,0,4153.0,3830.0,0.922,20.604,55,30,14,16,25,10,15,1,0.0,0.0
1012,1859,26-09-2019 01:36:00,0,4075.0,3703.0,0.909,20.157,111,39,19,20,72,45,27,0,0.0,0.0
1012,1860,26-09-2019 01:38:00,0,4173.0,3694.0,0.885,20.532,86,62,35,27,24,10,14,0,0.01,0.0
1012,1861,26-09-2019 01:40:00,0,4065.0,3684.0,0.906,20.096,15,3,1,2,12,6,6,0,0.0,0.0
1012,1862,26-09-2019 01:42:00,0,3974.0,3632.0,0.914,19.68,9,3,0,3,6,2,4,0,0.0,0.0
1012,1863,26-09-2019 01:44:00,0,3890.0,3476.0,0.894,19.173,47,24,13,11,23,10,13,0,0.0,0.0
1012,1864,26-09-2019 01:46:00,0,3784.5,3456.0,0.914,18.737,8,0,0,0,8,0,8,0,0.0,0.0
1012,1865,26-09-2019 01:48:00,0,3679.0,3436.0,0.934,18.301,21,2,1,1,19,3,16,0,0.0,0.0
1012,1866,26-09-2019 01:50:00,0,3413.0,3368.0,0.987,17.176,24,1,0,1,23,5,18,0,0.0,0.0
1012,1867,26-09-2019 01:52:00,0,3496.0,3151.0,0.901,17.264,66,12,7,5,54,31,23,0,0.01,0.0
1012,1868,26-09-2019 01:54:00,0,3287.0,3103.0,0.944,16.387,8,0,0,0,8,3,5,0,0.0,0.0
1012,1869,26-09-2019 01:56:00,0,3301.0,2968.0,0.899,16.291,12,1,1,0,11,1,10,0,0.0,0.0
1012,1870,26-09-2019 01:58:00,0,3070.0,2946.0,0.96,15.356,11,0,0,0,11,1,10,0,0.0,0.0
1012,1871,26-09-2019 02:00:00,0,2998.0,2732.0,0.911,14.837,31,4,0,4,27,9,18,0,0.0,0.0
1012,1872,26-09-2019 02:02:00,0,2990.0,2760.0,0.923,14.838,29,21,2,19,8,1,7,0,0.0,0.0
1012,1873,26-09-2019 02:04:00,0,3021.0,2706.0,0.896,14.897,17,2,0,2,15,5,10,0,0.0,0.0
1012,1874,26-09-2019 02:06:00,0,3023.0,2685.0,0.888,14.884,10,0,0,0,10,0,10,0,0.0,0.0
1012,1875,26-09-2019 02:08:00,0,3016.0,2618.0,0.868,14.781,8,1,1,0,7,2,5,0,0.0,0.0
1012,1876,26-09-2019 02:10:00,0,3023.0,2604.0,0.861,14.793,35,8,5,3,27,9,18,0,0.0,0.0
1012,1877,26-09-2019 02:12:00,0,3027.0,2660.0,0.879,14.873,164,72,51,21,92,61,31,27,0.0,0.0
1012,1878,26-09-2019 02:14:00,0,3472.0,3203.0,0.923,17.223,83,14,2,12,69,35,34,21,0.0,0.0
1012,1879,26-09-2019 02:16:00,0,3977.0,3573.0,0.899,19.624,53,17,5,12,36,22,14,6,0.0,0.0
1012,1880,26-09-2019 02:18:00,0,3854.0,3631.0,0.942,19.206,127,16,3,13,111,60,51,16,0.0,0.01
1012,1881,26-09-2019 02:20:00,0,3759.5,3512.0,0.934,18.702,178,17,4,13,161,79,82,17,0.0,0.06
1012,1882,26-09-2019 02:22:00,0,3665.0,3393.0,0.926,18.198,242,71,56,15,171,114,57,36,0.03,0.01
1012,1883,26-09-2019 02:24:00,0,3482.0,3269.0,0.939,17.338,290,158,130,28,132,105,27,163,0.07,0.0
1012,1884,26-09-2019 02:26:00,0,3627.0,3452.0,0.952,18.111,348,196,158,38,152,124,28,112,0.0,0.08
1012,1885,26-09-2019 02:28:00,0,3624.0,3537.0,0.976,18.194,280,163,122,41,117,96,21,119,0.0,0.0
1012,1886,26-09-2019 02:30:00,0,3519.0,3141.0,0.892,17.344,447,243,199,44,204,156,48,75,0.04,0.0
1012,1887,26-09-2019 02:32:00,0,3476.0,3095.0,0.89,17.12,216,53,20,33,163,114,49,0,0.0,0.0
1012,1888,26-09-2019 02:34:00,0,3657.0,3457.0,0.945,18.234,203,59,23,36,144,86,58,0,0.0,0.0
1012,1889,26-09-2019 02:36:00,0,3963.0,3571.0,0.901,19.569,307,122,96,26,185,137,48,78,0.0,0.0
1012,1890,26-09-2019 02:38:00,0,4654.0,4214.0,0.905,23.002,144,11,0,11,133,80,53,5,0.0,0.0
1012,1891,26-09-2019 02:40:00,0,4617.0,4287.0,0.928,22.938,191,38,12,26,153,86,67,19,0.0,0.05
1012,1892,26-09-2019 02:42:00,0,4551.0,4137.0,0.909,22.51,254,104,74,30,150,100,50,83,0.07,0.02
1012,1893,26-09-2019 02:44:00,0,3745.0,3487.0,0.931,18.618,388,177,130,47,211,161,50,70,0.01,0.06
1012,1894,26-09-2019 02:46:00,0,4140.0,3896.0,0.941,20.622,330,132,95,37,198,136,62,31,0.05,0.05
1012,1895,26-09-2019 02:48:00,0,3953.0,3685.0,0.932,19.655,778,443,353,90,335,251,84,2,0.0,0.0
1012,1896,26-09-2019 02:50:00,0,4135.0,3859.0,0.933,20.565,530,254,191,63,276,220,56,6,0.0,0.0
1012,1897,26-09-2019 02:52:00,0,4161.0,3857.0,0.927,20.663,402,238,189,49,164,133,31,108,0.0,0.0
1012,1898,26-09-2019 02:54:00,0,4303.0,3989.0,0.927,21.3695,138,56,39,17,82,54,28,22,0.0,0.0
1012,1899,26-09-2019 02:56:00,0,4445.0,4121.0,0.927,22.076,571,304,244,60,267,205,62,59,0.02,0.0
1012,1900,26-09-2019 02:58:00,0,4128.0,3820.0,0.925,20.495,277,150,127,23,127,98,29,171,0.0,0.0
1012,1901,26-09-2019 03:00:00,0,4372.0,3984.0,0.911,21.637,303,103,69,34,200,138,62,16,0.0,0.0
1012,1902,26-09-2019 03:02:00,0,4129.0,3973.0,0.962,20.666,783,405,333,72,378,291,87,7,0.0,0.0
1012,1903,26-09-2019 03:04:00,0,3934.0,3724.0,0.947,19.621,393,205,160,45,188,147,41,99,0.0,0.0
1012,1904,26-09-2019 03:06:00,0,4038.0,3819.0,0.946,20.136,238,94,66,28,144,107,37,104,0.0,0.0
1012,1905,26-09-2019 03:08:00,0,3976.0,3590.0,0.903,19.64,574,310,238,72,264,191,73,1,0.0,0.0
1012,1906,26-09-2019 03:10:00,0,3921.0,3827.0,0.976,19.686,534,242,193,49,292,237,55,24,0.0,0.0
1012,1907,26-09-2019 03:12:00,0,4005.0,3457.0,0.863,19.607,854,497,415,82,357,280,77,17,0.0,0.0
1012,1908,26-09-2019 03:14:00,0,3793.0,3392.0,0.894,18.701,344,164,117,47,180,142,38,95,0.0,0.0
1012,1909,26-09-2019 03:16:00,0,3965.0,3564.0,0.899,19.567,62,30,15,15,32,10,22,0,0.0,0.0
1012,1910,26-09-2019 03:18:00,0,3788.0,3442.0,0.909,18.736,448,209,162,47,239,174,65,22,0.0,0.0
1012,1911,26-09-2019 03:20:00,0,3863.0,3540.0,0.916,19.137,505,181,129,52,324,267,57,14,0.0,0.0
1012,1912,26-09-2019 03:22:00,0,3674.0,3314.0,0.902,18.143,382,50,29,21,332,294,38,0,0.0,0.0
1012,1913,26-09-2019 03:24:00,0,3675.0,3394.0,0.923,18.237,410,30,12,18,380,339,41,0,0.0,0.0
1012,1914,26-09-2019 03:26:00,0,3686.0,3378.0,0.917,18.264,340,72,41,31,268,211,57,1,0.0,0.0
1012,1915,26-09-2019 03:28:00,0,3691.5,3350.0,0.908,18.2545,170,20,9,11,150,110,40,0,0.0,0.0
1012,1916,26-09-2019 03:30:00,0,3697.0,3322.0,0.899,18.245,236,102,60,42,134,84,50,0,0.0,0.0
1012,1917,26-09-2019 03:32:00,0,3695.0,3307.0,0.895,18.22,248,59,22,37,189,133,56,0,0.0,0.0
1012,1918,26-09-2019 03:34:00,0,3696.0,3307.0,0.895,18.222,254,67,21,46,187,139,48,0,0.0,0.0
1012,1919,26-09-2019 03:36:00,0,3574.0,3189.0,0.892,17.611,153,1,1,0,152,135,17,0,0.0,0.0
1012,1920,26-09-2019 03:38:00,0,3396.0,3019.0,0.889,16.722,65,0,0,0,65,59,6,0,0.0,0.0
1012,1921,26-09-2019 03:40:00,0,3341.0,2853.0,0.854,16.321,94,1,0,1,93,48,45,0,0.0,0.0
1012,1922,26-09-2019 03:42:00,0,3071.0,2935.0,0.956,15.349,65,5,1,4,60,51,9,0,0.0,0.0
1012,1923,26-09-2019 03:44:00,0,3035.0,2640.0,0.87,14.882,66,3,2,1,63,57,6,0,0.0,0.0
1012,1924,26-09-2019 03:46:00,0,3008.0,2712.0,0.902,14.856,55,0,0,0,55,49,6,0,0.0,0.0
1012,1925,26-09-2019 03:48:00,0,3029.0,2597.0,0.857,14.81,88,8,6,2,80,74,6,0,0.0,0.0
1012,1926,26-09-2019 03:50:00,0,3221.0,2800.0,0.869,15.791,57,1,0,1,56,52,4,0,0.0,0.0
1012,1927,26-09-2019 03:52:00,0,3126.0,2727.0,0.872,15.336,52,0,0,0,52,47,5,0,0.0,0.0
1012,1928,26-09-2019 03:54:00,0,2996.0,2764.0,0.923,14.863,72,5,3,2,67,58,9,0,0.0,0.0
1012,1929,26-09-2019 03:56:00,0,3028.0,2670.0,0.882,14.887,38,0,0,0,38,26,12,0,0.0,0.0
1012,1930,26-09-2019 03:58:00,0,2962.0,2424.0,0.818,14.354,91,15,8,7,76,44,32,0,0.0,0.0
1012,1931,26-09-2019 04:00:00,0,2834.0,2485.0,0.877,13.918,148,0,0,0,148,99,49,0,0.0,0.0
1012,1932,26-09-2019 04:02:00,0,2917.0,2584.5,0.886,14.354,149,4,1,3,145,121,24,0,0.0,0.0
1012,1933,26-09-2019 04:04:00,0,3000.0,2684.0,0.895,14.79,174,24,18,6,150,137,13,0,0.0,0.0
1012,1934,26-09-2019 04:06:00,0,2844.0,2377.0,0.836,13.835,83,3,0,3,80,69,11,0,0.0,0.0
1012,1935,26-09-2019 04:08:00,0,2812.0,2541.0,0.904,13.892,67,5,0,5,62,56,6,0,0.0,0.0
1012,1936,26-09-2019 04:10:00,0,2823.0,2486.0,0.88,13.876,69,1,0,1,68,60,8,0,0.0,0.0
1012,1937,26-09-2019 04:12:00,0,2811.0,2537.0,0.903,13.883,83,19,5,14,64,57,7,0,0.0,0.0
1012,1938,26-09-2019 04:14:00,0,2803.0,2572.0,0.918,13.891,85,18,3,15,67,60,7,0,0.0,0.0
1012,1939,26-09-2019 04:16:00,0,2846.0,2429.0,0.854,13.903,89,22,7,15,67,59,8,0,0.0,0.0
1012,1940,26-09-2019 04:18:00,0,2823.0,2500.0,0.886,13.89,104,9,5,4,95,86,9,0,0.0,0.0
1012,1941,26-09-2019 04:20:00,0,2838.0,2449.0,0.863,13.892,299,65,31,34,234,208,26,1,0.0,0.0
1012,1942,26-09-2019 04:22:00,0,3312.0,2901.0,0.876,16.26,250,81,60,21,169,99,70,21,0.0,0.0
1012,1943,26-09-2019 04:24:00,0,3472.0,3195.0,0.92,17.216,176,20,2,18,156,76,80,8,0.0,0.0
1012,1944,26-09-2019 04:26:00,0,3599.0,3271.0,0.909,17.803,321,139,98,41,182,128,54,101,0.0,0.0
1012,1945,26-09-2019 04:28:00,0,3331.0,2853.0,0.857,16.284,139,21,7,14,118,84,34,10,0.0,0.0
1012,1946,26-09-2019 04:30:00,0,3774.0,3473.0,0.92,18.717,313,117,88,29,196,137,59,91,0.0,0.06
1012,1947,26-09-2019 04:32:00,0,3494.0,3164.0,0.905,17.27,430,168,136,32,262,215,47,136,0.04,0.0
1012,1948,26-09-2019 04:34:00,0,3496.0,3124.0,0.894,17.232,357,106,75,31,251,210,41,108,0.06,0.0
1012,1949,26-09-2019 04:36:00,0,3602.0,3160.0,0.878,17.6895,145,30,13,17,115,87,28,0,0.0,0.0
1012,1950,26-09-2019 04:38:00,0,3708.0,3196.0,0.862,18.147,135,89,48,41,46,29,17,0,0.0,0.0
1012,1951,26-09-2019 04:40:00,0,3690.0,3312.0,0.898,18.207,104,69,34,35,35,11,24,0,0.0,0.0
1012,1952,26-09-2019 04:42:00,0,3786.0,3465.0,0.915,18.751,2,0,0,0,2,0,2,0,0.0,0.0
1012,1953,26-09-2019 04:44:00,0,3670.0,3371.0,0.918,18.193,0,0,0,0,0,0,0,0,0.0,0.0
1012,1954,26-09-2019 04:46:00,0,3694.0,3318.0,0.898,18.228,0,0,0,0,0,0,0,0,0.0,0.0
1012,1955,26-09-2019 04:48:00,0,3498.0,3139.0,0.897,17.258,1,0,0,0,1,0,1,0,0.0,0.0
1012,1956,26-09-2019 04:50:00,0,3399.0,3055.0,0.899,16.773,4,0,0,0,4,2,2,0,0.0,0.0
1012,1957,26-09-2019 04:52:00,0,3307.0,2935.0,0.888,16.28,4,0,0,0,4,1,3,0,0.0,0.0
1012,1958,26-09-2019 04:54:00,0,3204.0,2811.0,0.878,15.734,2,0,0,0,2,1,1,0,0.0,0.0
1012,1959,26-09-2019 04:56:00,0,3105.0,2822.0,0.909,15.358,65,9,3,6,56,48,8,0,0.0,0.0
1012,1960,26-09-2019 04:58:00,0,3093.0,2867.0,0.927,15.358,11,2,1,1,9,8,1,0,0.0,0.0
1012,1961,26-09-2019 05:00:00,0,3097.0,2840.0,0.917,15.345,19,13,8,5,6,1,5,0,0.0,0.0
1012,1962,26-09-2019 05:02:00,0,3034.0,2627.0,0.866,14.861,59,40,20,20,19,8,11,0,0.0,0.0
1012,1963,26-09-2019 05:04:00,0,3002.0,2766.0,0.921,14.888,118,72,29,43,46,21,25,13,0.0,0.0
1012,1964,26-09-2019 05:06:00,0,3321.0,2843.0,0.856,16.232,121,23,9,14,98,41,57,31,0.0,0.03
1012,1965,26-09-2019 05:08:00,0,3258.0,3135.0,0.962,16.307,120,11,2,9,109,42,67,20,0.0,0.02
1012,1966,26-09-2019 05:10:00,0,3415.5,3205.5,0.9395,17.0065,149,68,50,18,81,32,49,61,0.0,0.12
1012,1967,26-09-2019 05:12:00,0,3573.0,3276.0,0.917,17.706,325,142,101,41,183,121,62,87,0.01,0.0
1012,1968,26-09-2019 05:14:00,0,3490.0,3126.0,0.896,17.212,365,192,155,37,173,130,43,167,0.0,0.01
1012,1969,26-09-2019 05:16:00,0,3518.0,3124.0,0.888,17.318,354,131,101,30,223,154,69,60,0.0,0.0
1012,1970,26-09-2019 05:18:00,0,3520.0,2991.0,0.85,17.179,245,117,84,33,128,87,41,82,0.02,0.0
1012,1971,26-09-2019 05:20:00,0,3860.0,3564.0,0.923,19.155,279,170,133,37,109,83,26,104,0.0,0.0
1012,1972,26-09-2019 05:22:00,0,3677.0,3336.0,0.907,18.183,208,117,90,27,91,66,25,77,0.02,0.0
1012,1973,26-09-2019 05:24:00,0,3662.0,3447.0,0.941,18.244,254,132,97,35,122,97,25,102,0.0,0.0
1012,1974,26-09-2019 05:26:00,0,3867.0,3550.0,0.918,19.167,462,208,166,42,254,186,68,89,0.0,0.0
1012,1975,26-09-2019 05:28:00,0,3494.0,3131.0,0.896,17.232,303,124,96,28,179,129,50,70,0.0,0.0
1012,1976,26-09-2019 05:30:00,0,3984.0,3620.0,0.909,19.704,108,51,38,13,57,33,24,27,0.0,0.0
1012,1977,26-09-2019 05:32:00,0,3791.0,3447.0,0.909,18.751,145,22,10,12,123,73,50,0,0.0,0.0
1012,1978,26-09-2019 05:34:00,0,3703.0,3336.0,0.901,18.283,220,13,0,13,207,137,70,0,0.0,0.0
1012,1979,26-09-2019 05:36:00,0,3710.0,3295.0,0.888,18.266,169,16,2,14,153,103,50,0,0.0,0.0
1012,1980,26-09-2019 05:38:00,0,3681.0,3367.0,0.915,18.23,141,2,0,2,139,90,49,0,0.0,0.0
1012,1981,26-09-2019 05:40:00,0,3671.0,3383.0,0.922,18.211,114,27,16,11,87,47,40,0,0.0,0.0
1012,1982,26-09-2019 05:42:00,0,3730.0,3200.0,0.858,18.238,109,0,0,0,109,63,46,0,0.0,0.0
1012,1983,26-09-2019 05:44:00,0,3614.5,3152.0,0.8725,17.73,94,17,5,12,77,45,32,0,0.01,0.0
1012,1984,26-09-2019 05:46:00,0,3499.0,3104.0,0.887,17.222,176,54,27,27,122,69,53,0,0.0,0.0
1012,1985,26-09-2019 05:48:00,0,3528.0,3082.0,0.874,17.314,134,4,2,2,130,76,54,0,0.0,0.0
1012,1986,26-09-2019 05:50:00,0,3315.0,2915.0,0.879,16.288,38,1,0,1,37,13,24,0,0.0,0.0
1012,1987,26-09-2019 05:52:00,0,3326.0,2916.0,0.877,16.334,44,0,0,0,44,29,15,0,0.0,0.0
1012,1988,26-09-2019 05:54:00,0,2995.0,2712.0,0.906,14.802,43,5,3,2,38,18,20,0,0.0,0.0
1012,1989,26-09-2019 05:56:00,0,3032.0,2670.0,0.881,14.901,135,25,7,18,110,70,40,1,0.0,0.0
1012,1990,26-09-2019 05:58:00,0,2922.0,2533.0,0.867,14.316,197,52,24,28,145,95,50,0,0.0,0.0
1012,1991,26-09-2019 06:00:00,1,3034.0,2619.0,0.863,14.855,237,85,50,35,152,109,43,6,0.0,0.0
1012,1992,26-09-2019 06:02:00,1,3210.0,2800.0,0.872,15.749,191,99,86,13,92,77,15,112,0.0,0.0
1012,1993,26-09-2019 06:04:00,1,3322.0,2848.0,0.857,16.243,132,38,29,9,94,51,43,56,0.0,0.0
1012,1994,26-09-2019 06:06:00,1,3532.0,3065.0,0.868,17.309,183,55,37,18,128,55,73,25,0.0,0.01
1012,1995,26-09-2019 06:08:00,1,3488.0,3124.0,0.896,17.202,177,97,64,33,80,45,35,56,0.0,0.04
1012,1996,26-09-2019 06:10:00,1,3519.0,3010.0,0.855,17.199,275,129,100,29,146,99,47,96,0.0,0.0
1012,1997,26-09-2019 06:12:00,1,3710.0,3208.0,0.865,18.168,331,156,106,50,175,120,55,39,0.0,0.02
1012,1998,26-09-2019 06:14:00,1,3709.0,3283.0,0.885,18.246,187,29,17,12,158,110,48,3,0.02,0.01
1012,1999,26-09-2019 06:16:00,1,3603.0,3198.0,0.888,17.735,483,101,70,31,382,294,88,17,0.0,0.0
1012,2000,26-09-2019 06:18:00,1,3485.0,2999.0,0.8595,17.0515,389,125,84,41,264,192,72,8,0.0,0.01
1012,2001,26-09-2019 06:20:00,1,3367.0,2800.0,0.831,16.368,407,185,144,41,222,167,55,0,0.0,0.0
1012,2002,26-09-2019 06:22:00,1,3761.0,3055.0,0.812,18.2,252,116,82,34,136,96,40,59,0.0,0.0
1012,2003,26-09-2019 06:24:00,1,3720.0,3177.0,0.854,18.175,284,156,112,44,128,80,48,39,0.0,0.0
1012,2004,26-09-2019 06:26:00,1,3422.0,2929.0,0.856,16.726,174,59,44,15,115,66,49,3,0.0,0.0
1012,2005,26-09-2019 06:28:00,1,3538.0,2943.0,0.832,17.199,63,8,1,7,55,16,39,0,0.0,0.0
1012,2006,26-09-2019 06:30:00,1,3561.0,2894.0,0.812,17.236,73,5,1,4,68,37,31,0,0.0,0.01
1012,2007,26-09-2019 06:32:00,1,3544.0,2949.0,0.832,17.228,29,3,1,2,26,11,15,0,0.0,0.0
1012,2008,26-09-2019 06:34:00,1,3345.0,2858.0,0.855,16.342,0,0,0,0,0,0,0,0,0.0,0.0
1012,2009,26-09-2019 06:36:00,1,3365.0,2683.0,0.797,16.227,2,0,0,0,2,0,2,0,0.0,0.0
1012,2010,26-09-2019 06:38:00,1,3054.0,2578.0,0.844,14.885,51,3,1,2,48,15,33,0,0.0,0.0
1012,2011,26-09-2019 06:40:00,1,3066.0,2508.0,0.818,14.855,35,0,0,0,35,0,35,0,0.0,0.0
1012,2012,26-09-2019 06:42:00,1,2850.0,2403.0,0.843,13.89,52,0,0,0,52,0,52,0,0.0,0.0
1012,2013,26-09-2019 06:44:00,1,2881.0,2311.0,0.802,13.911,52,4,0,4,48,2,46,0,0.0,0.0
1012,2014,26-09-2019 06:46:00,1,2886.0,2247.0,0.779,13.857,44,2,1,1,42,8,34,0,0.0,0.0
1012,2015,26-09-2019 06:48:00,1,2674.0,2163.0,0.809,12.929,45,0,0,0,45,0,45,0,0.0,0.0
1012,2016,26-09-2019 06:50:00,1,2549.0,2188.0,0.858,12.467,66,9,2,7,57,17,40,0,0.0,0.0
1012,2017,26-09-2019 06:52:00,1,2555.0,2143.5,0.839,12.44,43,0,0,0,43,2,41,0,0.0,0.0
1012,2018,26-09-2019 06:54:00,1,2561.0,2099.0,0.82,12.413,39,1,1,0,38,2,36,0,0.0,0.0
1012,2019,26-09-2019 06:56:00,1,2548.0,2150.0,0.844,12.418,42,1,0,1,41,12,29,0,0.0,0.0
1012,2020,26-09-2019 06:58:00,1,2558.0,2098.0,0.82,12.401,20,3,1,2,17,7,10,0,0.0,0.0
1012,2021,26-09-2019 07:00:00,1,2538.0,2222.0,0.876,12.462,189,68,38,30,121,77,44,0,0.0,0.0
1012,2022,26-09-2019 07:02:00,1,2644.0,2246.0,0.849,12.905,157,18,1,17,139,112,27,0,0.0,0.0
1012,2023,26-09-2019 07:04:00,1,2646.0,2252.0,0.851,12.921,102,0,0,0,102,79,23,0,0.0,0.0
1012,2024,26-09-2019 07:06:00,1,2535.0,2231.0,0.88,12.458,47,1,0,1,46,7,39,0,0.0,0.0
1012,2025,26-09-2019 07:08:00,1,2588.0,2045.0,0.79,12.462,89,0,0,0,89,34,55,0,0.0,0.0
1012,2026,26-09-2019 07:10:00,1,2348.0,1964.0,0.837,11.424,62,0,0,0,62,19,43,0,0.0,0.0
1012,2027,26-09-2019 07:12:00,1,2462.0,2016.0,0.819,11.931,42,0,0,0,42,7,35,0,0.0,0.0
1012,2028,26-09-2019 07:14:00,1,2358.0,1968.0,0.835,11.469,62,0,0,0,62,17,45,0,0.0,0.0
1012,2029,26-09-2019 07:16:00,1,2475.0,2013.0,0.814,11.98,39,0,0,0,39,0,39,0,0.0,0.0
1012,2030,26-09-2019 07:18:00,1,2589.0,2032.0,0.785,12.45,66,10,6,4,56,13,43,0,0.0,0.0
1012,2031,26-09-2019 07:20:00,1,2582.0,2038.0,0.789,12.431,1,0,0,0,1,0,1,0,0.0,0.0
1012,2032,26-09-2019 07:22:00,1,2576.0,2081.0,0.808,12.452,3,0,0,0,3,0,3,0,0.0,0.0
1012,2033,26-09-2019 07:24:00,1,2561.0,2084.0,0.814,12.398,0,0,0,0,0,0,0,0,0.0,0.0
1012,2034,26-09-2019 07:26:00,1,2576.5,2040.5,0.792,12.4115,14,0,0,0,14,0,14,0,0.0,0.0
1012,2035,26-09-2019 07:28:00,1,2592.0,1997.0,0.77,12.425,4,0,0,0,4,0,4,0,0.0,0.0
1012,2036,26-09-2019 07:30:00,1,2612.0,1975.0,0.756,12.479,46,9,4,5,37,18,19,0,0.0,0.0
1012,2037,26-09-2019 07:32:00,1,2583.0,2026.0,0.784,12.419,5,0,0,0,5,3,2,0,0.0,0.0
1012,2038,26-09-2019 07:34:00,1,2594.0,2008.0,0.774,12.444,102,34,22,12,68,44,24,2,0.0,0.0
1012,2039,26-09-2019 07:36:00,1,2900.0,2197.0,0.758,13.861,165,68,48,20,97,63,34,47,0.0,0.0
1012,2040,26-09-2019 07:38:00,1,3099.0,2382.0,0.768,14.849,298,108,82,26,190,132,58,48,0.0,0.0
1012,2041,26-09-2019 07:40:00,1,2897.0,2201.0,0.76,13.852,228,47,23,24,181,126,55,0,0.0,0.0
1012,2042,26-09-2019 07:42:00,1,3099.0,2398.0,0.774,14.865,161,7,1,6,154,90,64,0,0.0,0.0
1012,2043,26-09-2019 07:44:00,1,3134.0,2309.0,0.737,14.906,165,6,4,2,159,109,50,0,0.0,0.0
1012,2044,26-09-2019 07:46:00,1,3070.0,2436.0,0.794,14.794,250,85,54,31,165,111,54,0,0.0,0.0
1012,2045,26-09-2019 07:48:00,1,2974.0,2361.0,0.794,14.332,353,135,94,41,218,158,60,26,0.0,0.03
1012,2046,26-09-2019 07:50:00,1,3092.0,2338.0,0.756,14.771,453,183,128,55,270,210,60,4,0.0,0.0
1012,2047,26-09-2019 07:52:00,1,3085.0,2390.0,0.775,14.8,137,51,34,17,86,47,39,7,0.0,0.0
1012,2048,26-09-2019 07:54:00,1,3067.0,2466.0,0.804,14.816,186,84,55,29,102,56,46,0,0.0,0.0
1012,2049,26-09-2019 07:56:00,1,3071.0,2455.0,0.8,14.819,588,313,232,81,275,206,69,8,0.0,0.0
1012,2050,26-09-2019 07:58:00,1,3107.0,2366.0,0.762,14.863,312,95,74,21,217,163,54,2,0.0,0.0
1012,2051,26-09-2019 08:00:00,1,3089.0,2436.5,0.789,14.87,308,127,92,35,181,138,43,105,0.0,0.0
1012,2052,26-09-2019 08:02:00,1,3071.0,2507.0,0.816,14.877,317,136,98,38,181,126,55,44,0.0,0.0
1012,2053,26-09-2019 08:04:00,1,3068.0,2444.0,0.797,14.793,683,337,254,83,346,258,88,3,0.0,0.06
1012,2054,26-09-2019 08:06:00,1,3065.0,2508.0,0.818,14.852,489,250,181,69,239,171,68,7,0.0,0.0
1012,2055,26-09-2019 08:08:00,1,3073.0,2454.0,0.798,14.826,508,198,143,55,310,233,77,0,0.0,0.0
1012,2056,26-09-2019 08:10:00,1,3069.0,2416.0,0.787,14.767,130,62,25,37,68,30,38,3,0.0,0.0
1012,2057,26-09-2019 08:12:00,1,3118.0,2341.0,0.751,14.876,157,31,9,22,126,69,57,0,0.0,0.0
1012,2058,26-09-2019 08:14:00,1,2994.0,2294.0,0.766,14.335,90,5,2,3,85,34,51,0,0.0,0.0
1012,2059,26-09-2019 08:16:00,1,2912.0,2185.0,0.75,13.894,162,1,0,1,161,101,60,0,0.0,0.0
1012,2060,26-09-2019 08:18:00,1,2907.0,2178.0,0.749,13.865,139,16,5,11,123,76,47,0,0.0,0.0
1012,2061,26-09-2019 08:20:00,1,2898.0,2242.0,0.774,13.901,149,42,21,21,107,54,53,0,0.0,0.0
1012,2062,26-09-2019 08:22:00,1,2868.0,2346.0,0.818,13.899,137,16,3,13,121,78,43,0,0.0,0.0
1012,2063,26-09-2019 08:24:00,1,3115.0,2367.0,0.76,14.894,173,18,7,11,155,98,57,0,0.0,0.0
1012,2064,26-09-2019 08:26:00,1,3105.0,2330.0,0.75,14.814,76,6,0,6,70,22,48,0,0.0,0.0
1012,2065,26-09-2019 08:28:00,1,2896.0,2253.0,0.778,13.906,40,1,1,0,39,0,39,0,0.0,0.0
1012,2066,26-09-2019 08:30:00,1,2937.0,2083.0,0.709,13.877,324,0,0,0,324,263,61,0,0.0,0.0
1012,2067,26-09-2019 08:32:00,1,2603.0,1955.0,0.751,12.419,211,2,1,1,209,166,43,0,0.0,0.0
1012,2068,26-09-2019 08:34:00,1,2556.0,1901.0,0.7435,12.1745,72,0,0,0,72,20,52,0,0.0,0.0
1012,2069,26-09-2019 08:36:00,1,2509.0,1847.0,0.736,11.93,70,0,0,0,70,25,45,0,0.0,0.0
1012,2070,26-09-2019 08:38:00,1,2624.0,1876.0,0.715,12.416,48,0,0,0,48,2,46,0,0.0,0.0
1012,2071,26-09-2019 08:40:00,1,2640.0,1902.0,0.721,12.509,212,1,0,1,211,142,69,0,0.0,0.0
1012,2072,26-09-2019 08:42:00,1,2611.0,1927.0,0.738,12.419,48,0,0,0,48,4,44,0,0.01,0.0
1012,2073,26-09-2019 08:44:00,1,2631.0,1862.0,0.708,12.43,195,6,0,6,189,128,61,0,0.0,0.0
1012,2074,26-09-2019 08:46:00,1,2395.0,1844.0,0.77,11.48,170,1,0,1,169,108,61,0,0.0,0.0
1012,2075,26-09-2019 08:48:00,1,2424.0,1740.0,0.718,11.477,247,2,0,2,245,206,39,0,0.0,0.0
1012,2076,26-09-2019 08:50:00,1,2438.0,1709.0,0.701,11.499,48,4,0,4,44,4,40,0,0.0,0.0
1012,2077,26-09-2019 08:52:00,1,2536.0,1786.0,0.704,11.968,42,1,0,1,41,0,41,0,0.0,0.0
1012,2078,26-09-2019 08:54:00,1,2418.0,1754.0,0.725,11.468,48,1,0,1,47,0,47,0,0.0,0.0
1012,2079,26-09-2019 08:56:00,1,2409.0,1772.0,0.735,11.455,40,0,0,0,40,0,40,0,0.0,0.0
1012,2080,26-09-2019 08:58:00,1,2646.0,1830.0,0.692,12.45,44,1,0,1,43,2,41,0,0.0,0.0
1012,2081,26-09-2019 09:00:00,1,2636.0,1815.0,0.688,12.395,29,0,0,0,29,0,29,0,0.0,0.0
1012,2082,26-09-2019 09:02:00,1,2655.0,1792.0,0.675,12.446,37,0,0,0,37,0,37,0,0.0,0.0
1012,2083,26-09-2019 09:04:00,1,2660.0,1774.0,0.667,12.443,47,5,1,4,42,0,42,0,0.0,0.0
1012,2084,26-09-2019 09:06:00,1,2652.0,1784.0,0.673,12.425,45,2,1,1,43,0,43,0,0.0,0.0
1012,2085,26-09-2019 09:08:00,1,2645.5,1802.5,0.6815,12.419,28,0,0,0,28,0,28,0,0.0,0.0
1012,2086,26-09-2019 09:10:00,1,2639.0,1821.0,0.69,12.413,105,22,13,9,83,53,30,0,0.0,0.0
1012,2087,26-09-2019 09:12:00,1,2654.0,1804.0,0.68,12.455,196,0,0,0,196,177,19,0,0.0,0.0
1012,2088,26-09-2019 09:14:00,1,2416.0,1765.0,0.731,11.472,3,0,0,0,3,3,0,0,0.0,0.0
1012,2089,26-09-2019 09:16:00,1,2422.0,1698.0,0.701,11.424,0,0,0,0,0,0,0,0,0.0,0.0
1012,2090,26-09-2019 09:18:00,1,2433.0,1691.0,0.695,11.457,17,2,1,1,15,14,1,0,0.0,0.0
1012,2091,26-09-2019 09:20:00,1,2440.0,1722.0,0.706,11.522,0,0,0,0,0,0,0,0,0.0,0.0
1012,2092,26-09-2019 09:22:00,1,2418.0,1751.0,0.724,11.467,0,0,0,0,0,0,0,0,0.0,0.0
1012,2093,26-09-2019 09:24:00,1,2438.0,1684.0,0.691,11.471,2,0,0,0,2,2,0,0,0.0,0.0
1012,2094,26-09-2019 09:26:00,1,2441.0,1708.0,0.7,11.508,2,0,0,0,2,0,2,0,0.0,0.0
1012,2095,26-09-2019 09:28:00,1,2438.0,1666.0,0.683,11.451,5,0,0,0,5,2,3,0,0.0,0.0
1012,2096,26-09-2019 09:30:00,1,2422.0,1690.0,0.698,11.414,1,0,0,0,1,0,1,0,0.0,0.0
1012,2097,26-09-2019 09:32:00,1,2438.0,1685.0,0.691,11.473,5,0,0,0,5,3,2,0,0.0,0.0
1012,2098,26-09-2019 09:34:00,1,2432.0,1697.0,0.698,11.461,65,7,3,4,58,16,42,0,0.0,0.0
1012,2099,26-09-2019 09:36:00,1,2407.0,1801.0,0.748,11.477,59,3,0,3,56,10,46,0,0.0,0.0
1012,2100,26-09-2019 09:38:00,1,2412.0,1764.0,0.731,11.456,72,7,2,5,65,18,47,0,0.0,0.0
1012,2101,26-09-2019 09:40:00,1,2440.0,1654.0,0.678,11.445,155,0,0,0,155,103,52,0,0.0,0.0
1012,2102,26-09-2019 09:42:00,1,2484.0,1699.5,0.684,11.669,180,22,5,17,158,102,56,0,0.0,0.0
1012,2103,26-09-2019 09:44:00,1,2528.0,1745.0,0.69,11.893,236,49,22,27,187,127,60,4,0.0,0.0
1012,2104,26-09-2019 09:46:00,1,2838.0,1991.0,0.702,13.388,179,45,23,22,134,86,48,36,0.0,0.0
1012,2105,26-09-2019 09:48:00,1,3112.0,2298.0,0.738,14.807,158,47,22,25,111,67,44,60,0.0,0.0
1012,2106,26-09-2019 09:50:00,1,3459.0,2454.0,0.71,16.347,253,103,73,30,150,98,52,40,0.0,0.0
1012,2107,26-09-2019 09:52:00,1,3105.0,2344.0,0.755,14.829,297,87,60,27,210,150,60,7,0.0,0.0
1012,2108,26-09-2019 09:54:00,1,3109.0,2343.0,0.754,14.844,214,44,24,20,170,105,65,0,0.0,0.0
1012,2109,26-09-2019 09:56:00,1,3120.0,2309.0,0.74,14.851,314,4,1,3,310,239,71,0,0.0,0.0
1012,2110,26-09-2019 09:58:00,1,2907.0,2209.0,0.76,13.899,38,6,1,5,32,0,32,0,0.0,0.0
1012,2111,26-09-2019 10:00:00,1,2924.0,2084.0,0.713,13.829,47,1,0,1,46,0,46,0,0.0,0.0
1012,2112,26-09-2019 10:02:00,1,2717.0,2030.0,0.747,12.953,54,3,0,3,51,13,38,0,0.0,0.0
1012,2113,26-09-2019 10:04:00,1,2616.0,1963.0,0.751,12.481,47,0,0,0,47,0,47,0,0.0,0.0
1012,2114,26-09-2019 10:06:00,1,2486.0,1880.0,0.756,11.875,69,0,0,0,69,20,49,0,0.0,0.0
1012,2115,26-09-2019 10:08:00,1,2409.0,1803.0,0.748,11.49,47,0,0,0,47,6,41,0,0.0,0.0
1012,2116,26-09-2019 10:10:00,1,2318.0,1705.0,0.735,11.02,95,4,3,1,91,42,49,0,0.0,0.0
1012,2117,26-09-2019 10:12:00,1,2291.0,1801.0,0.786,11.022,51,0,0,0,51,9,42,0,0.0,0.0
1012,2118,26-09-2019 10:14:00,1,2182.0,1755.0,0.804,10.54,42,0,0,0,42,0,42,0,0.0,0.0
1012,2119,26-09-2019 10:16:00,1,2194.0,1703.5,0.7765,10.531,114,0,0,0,114,59,55,0,0.0,0.0
1012,2120,26-09-2019 10:18:00,1,2206.0,1652.0,0.749,10.522,171,0,0,0,171,120,51,0,0.0,0.0
1012,2121,26-09-2019 10:20:00,1,2214.0,1621.0,0.732,10.517,48,0,0,0,48,0,48,0,0.0,0.0
1012,2122,26-09-2019 10:22:00,1,2199.0,1706.0,0.776,10.552,70,5,3,2,65,29,36,0,0.0,0.0
1012,2123,26-09-2019 10:24:00,1,2193.0,1705.0,0.777,10.529,289,0,0,0,289,249,40,0,0.0,0.0
1012,2124,26-09-2019 10:26:00,1,2184.0,1728.0,0.792,10.517,297,0,0,0,297,226,71,0,0.0,0.0
1012,2125,26-09-2019 10:28:00,1,2191.0,1691.0,0.772,10.503,44,0,0,0,44,0,44,0,0.0,0.0
1012,2126,26-09-2019 10:30:00,1,2200.0,1673.0,0.761,10.52,60,1,0,1,59,27,32,0,0.0,0.0
1012,2127,26-09-2019 10:32:00,1,2190.0,1685.0,0.77,10.494,64,6,4,2,58,7,51,0,0.0,0.0
1012,2128,26-09-2019 10:34:00,1,2205.0,1666.0,0.755,10.533,101,0,0,0,101,49,52,0,0.0,0.0
1012,2129,26-09-2019 10:36:00,1,2195.0,1722.0,0.785,10.554,51,0,0,0,51,8,43,0,0.0,0.0
1012,2130,26-09-2019 10:38:00,1,2198.0,1660.0,0.755,10.497,34,0,0,0,34,0,34,0,0.0,0.0
1012,2131,26-09-2019 10:40:00,1,2207.0,1617.0,0.732,10.485,121,14,9,5,107,55,52,0,0.0,0.0
1012,2132,26-09-2019 10:42:00,1,2194.0,1682.0,0.767,10.506,43,0,0,0,43,2,41,0,0.0,0.0
1012,2133,26-09-2019 10:44:00,1,2204.0,1682.0,0.763,10.547,168,1,0,1,167,116,51,0,0.0,0.0
1012,2134,26-09-2019 10:46:00,1,2196.0,1667.0,0.759,10.5,98,0,0,0,98,57,41,0,0.0,0.0
1012,2135,26-09-2019 10:48:00,1,2210.0,1643.0,0.744,10.528,70,0,0,0,70,26,44,0,0.0,0.0
1012,2136,26-09-2019 10:50:00,1,2303.5,1727.5,0.75,10.9895,144,25,17,8,119,69,50,0,0.0,0.0
1012,2137,26-09-2019 10:52:00,1,2397.0,1812.0,0.756,11.451,152,22,4,18,130,80,50,0,0.0,0.0
1012,2138,26-09-2019 10:54:00,1,2612.0,1910.0,0.731,12.406,41,0,0,0,41,2,39,0,0.0,0.0
1012,2139,26-09-2019 10:56:00,1,2605.0,1956.0,0.751,12.431,40,0,0,0,40,0,40,0,0.0,0.0
1012,2140,26-09-2019 10:58:00,1,2608.0,1956.0,0.75,12.441,82,5,3,2,77,35,42,0,0.0,0.0
1012,2141,26-09-2019 11:00:00,1,2616.0,1940.0,0.742,12.454,99,22,11,11,77,43,34,0,0.0,0.0
1012,2142,26-09-2019 11:02:00,1,2607.0,1942.0,0.745,12.42,210,23,6,17,187,130,57,0,0.0,0.0
1012,2143,26-09-2019 11:04:00,1,2614.0,1983.0,0.759,12.495,228,34,14,20,194,129,65,0,0.0,0.0
1012,2144,26-09-2019 11:06:00,1,2664.0,2148.0,0.807,12.874,279,95,73,22,184,133,51,42,0.0,0.0
1012,2145,26-09-2019 11:08:00,1,2889.0,2288.0,0.792,13.915,303,118,92,26,185,145,40,62,0.0,0.0
1012,2146,26-09-2019 11:10:00,1,2891.0,2213.0,0.766,13.842,434,195,145,50,239,181,58,13,0.0,0.0
1012,2147,26-09-2019 11:12:00,1,2910.0,2229.0,0.766,13.933,241,27,12,15,214,141,73,0,0.0,0.0
1012,2148,26-09-2019 11:14:00,1,2897.0,2149.0,0.742,13.791,52,2,1,1,50,11,39,0,0.0,0.0
1012,2149,26-09-2019 11:16:00,1,2956.0,2027.0,0.686,13.892,74,0,0,0,74,33,41,0,0.0,0.0
1012,2150,26-09-2019 11:18:00,1,2951.0,2107.0,0.714,13.96,226,15,1,14,211,140,71,0,0.0,0.0
1012,2151,26-09-2019 11:20:00,1,2916.0,2114.0,0.725,13.828,183,17,2,15,166,100,66,0,0.0,0.0
1012,2152,26-09-2019 11:22:00,1,2903.0,2164.0,0.745,13.835,86,20,6,14,66,21,45,0,0.0,0.0
1012,2153,26-09-2019 11:24:00,1,2805.5,2104.0,0.75,13.3845,49,1,0,1,48,6,42,0,0.01,0.0
1012,2154,26-09-2019 11:26:00,1,2708.0,2044.0,0.755,12.934,43,1,0,1,42,2,40,0,0.0,0.0
1012,2155,26-09-2019 11:28:00,1,2609.0,1917.0,0.735,12.402,77,0,0,0,77,28,49,0,0.0,0.0
1012,2156,26-09-2019 11:30:00,1,2636.0,1882.0,0.714,12.471,37,0,0,0,37,0,37,0,0.0,0.0
1012,2157,26-09-2019 11:32:00,1,2406.0,1791.0,0.744,11.462,39,0,0,0,39,0,39,0,0.0,0.0
1012,2158,26-09-2019 11:34:00,1,2427.0,1742.0,0.718,11.492,45,0,0,0,45,0,45,0,0.0,0.0
1012,2159,26-09-2019 11:36:00,1,2434.0,1713.0,0.704,11.487,48,0,0,0,48,6,42,0,0.0,0.0
1012,2160,26-09-2019 11:38:00,1,2413.0,1747.0,0.724,11.442,47,0,0,0,47,0,47,0,0.0,0.0
1012,2161,26-09-2019 11:40:00,1,2418.0,1725.0,0.713,11.439,54,5,3,2,49,0,49,0,0.0,0.0
1012,2162,26-09-2019 11:42:00,1,2425.0,1718.0,0.709,11.458,18,2,0,2,16,1,15,0,0.0,0.0
1012,2163,26-09-2019 11:44:00,1,2424.0,1706.0,0.704,11.442,41,7,5,2,34,13,21,0,0.0,0.0
1012,2164,26-09-2019 11:46:00,1,2414.0,1794.0,0.743,11.498,39,2,1,1,37,0,37,0,0.0,0.0
1012,2165,26-09-2019 11:48:00,1,2417.0,1791.0,0.741,11.508,50,6,0,6,44,0,44,0,0.0,0.0
1012,2166,26-09-2019 11:50:00,1,2526.0,1800.0,0.713,11.945,48,2,0,2,46,4,42,0,0.0,0.0
1012,2167,26-09-2019 11:52:00,1,2632.0,1835.0,0.697,12.403,42,0,0,0,42,2,40,0,0.0,0.0
1012,2168,26-09-2019 11:54:00,1,2410.0,1797.0,0.746,11.485,54,2,0,2,52,0,52,0,0.0,0.0
1012,2169,26-09-2019 11:56:00,1,2441.0,1728.0,0.708,11.529,44,1,0,1,43,0,43,0,0.0,0.0
1012,2170,26-09-2019 11:58:00,1,2440.5,1716.0,0.7035,11.515,39,0,0,0,39,0,39,0,0.0,0.0
1012,2171,26-09-2019 12:00:00,1,2440.0,1704.0,0.699,11.501,45,3,0,3,42,0,42,0,0.0,0.0
1012,2172,26-09-2019 12:02:00,1,2443.0,1698.0,0.695,11.505,63,3,0,3,60,15,45,0,0.0,0.0
1012,2173,26-09-2019 12:04:00,1,2423.0,1681.0,0.694,11.41,29,2,1,1,27,1,26,0,0.0,0.0
1012,2174,26-09-2019 12:06:00,1,2437.0,1655.0,0.679,11.434,18,1,0,1,17,1,16,0,0.0,0.0
1012,2175,26-09-2019 12:08:00,1,2337.0,1635.0,0.7,11.016,11,2,0,2,9,5,4,0,0.0,0.0
1012,2176,26-09-2019 12:10:00,1,2330.0,1603.0,0.688,10.956,5,1,0,1,4,2,2,0,0.0,0.0
1012,2177,26-09-2019 12:12:00,1,2343.0,1653.0,0.705,11.062,0,0,0,0,0,0,0,0,0.0,0.0
1012,2178,26-09-2019 12:14:00,1,2205.0,1630.0,0.739,10.493,0,0,0,0,0,0,0,0,0.0,0.0
1012,2179,26-09-2019 12:16:00,1,2438.0,1685.0,0.691,11.472,20,0,0,0,20,1,19,0,0.0,0.0
1012,2180,26-09-2019 12:18:00,1,2440.0,1711.0,0.701,11.507,11,3,2,1,8,2,6,0,0.0,0.0
1012,2181,26-09-2019 12:20:00,1,2436.0,1701.0,0.699,11.48,3,0,0,0,3,0,3,0,0.0,0.0
1012,2182,26-09-2019 12:22:00,1,2332.0,1638.0,0.702,11.002,3,0,0,0,3,2,1,0,0.0,0.0
1012,2183,26-09-2019 12:24:00,1,2218.0,1595.0,0.719,10.507,0,0,0,0,0,0,0,0,0.0,0.0
1012,2184,26-09-2019 12:26:00,1,2227.0,1574.0,0.707,10.518,86,25,15,10,61,34,27,0,0.0,0.0
1012,2185,26-09-2019 12:28:00,1,2321.0,1660.0,0.715,10.982,83,17,6,11,66,27,39,0,0.0,0.0
1012,2186,26-09-2019 12:30:00,1,2432.0,1725.0,0.709,11.491,96,14,7,7,82,31,51,0,0.0,0.0
1012,2187,26-09-2019 12:32:00,1,2428.0,1741.0,0.717,11.4945,30,7,1,6,23,2,21,0,0.0,0.0
1012,2188,26-09-2019 12:34:00,1,2424.0,1757.0,0.725,11.498,0,0,0,0,0,0,0,0,0.0,0.0
1012,2189,26-09-2019 12:36:00,1,2432.0,1715.0,0.705,11.483,2,0,0,0,2,0,2,0,0.0,0.0
1012,2190,26-09-2019 12:38:00,1,2450.0,1646.0,0.672,11.475,2,0,0,0,2,0,2,0,0.0,0.0
1012,2191,26-09-2019 12:40:00,1,2334.0,1659.0,0.711,11.035,20,15,6,9,5,0,5,0,0.0,0.0
1012,2192,26-09-2019 12:42:00,1,2207.0,1608.0,0.729,10.474,3,3,0,3,0,0,0,0,0.0,0.0
1012,2193,26-09-2019 12:44:00,1,2220.0,1575.0,0.71,10.491,22,10,5,5,12,0,12,0,0.0,0.0
1012,2194,26-09-2019 12:46:00,1,2230.0,1548.0,0.694,10.5,145,0,0,0,145,117,28,0,0.0,0.0
1012,2195,26-09-2019 12:48:00,1,2237.0,1545.0,0.691,10.525,24,13,5,8,11,8,3,0,0.0,0.0
1012,2196,26-09-2019 12:50:00,1,2218.0,1618.0,0.73,10.53,0,0,0,0,0,0,0,0,0.0,0.0
1012,2197,26-09-2019 12:52:00,1,2228.0,1567.0,0.703,10.513,60,16,9,7,44,13,31,0,0.0,0.0
1012,2198,26-09-2019 12:54:00,1,2437.0,1704.0,0.699,11.49,47,1,1,0,46,0,46,0,0.0,0.0
1012,2199,26-09-2019 12:56:00,1,2544.0,1792.0,0.704,12.007,49,0,0,0,49,0,49,0,0.0,0.0
1012,2200,26-09-2019 12:58:00,1,2516.0,1849.0,0.735,11.962,34,0,0,0,34,0,34,0,0.0,0.0
1012,2201,26-09-2019 13:00:00,1,2658.0,1781.0,0.67,12.447,41,0,0,0,41,0,41,0,0.0,0.0
1012,2202,26-09-2019 13:02:00,1,2642.0,1788.0,0.677,12.389,51,0,0,0,51,0,51,0,0.0,0.0
1012,2203,26-09-2019 13:04:00,1,2654.0,1793.0,0.676,12.442,43,1,0,1,42,0,42,0,0.0,0.0
1012,2204,26-09-2019 13:06:00,1,2654.0,1768.0,0.6665,12.415,48,0,0,0,48,0,48,0,0.0,0.0
1012,2205,26-09-2019 13:08:00,1,2654.0,1743.0,0.657,12.388,39,0,0,0,39,0,39,0,0.0,0.0
1012,2206,26-09-2019 13:10:00,1,2665.0,1736.0,0.651,12.423,49,0,0,0,49,4,45,0,0.0,0.0
1012,2207,26-09-2019 13:12:00,1,2761.0,1797.0,0.651,12.869,57,0,0,0,57,19,38,0,0.0,0.0
1012,2208,26-09-2019 13:14:00,1,2657.0,1777.0,0.669,12.436,72,0,0,0,72,23,49,0,0.0,0.0
1012,2209,26-09-2019 13:16:00,1,2653.0,1760.0,0.663,12.401,294,105,88,17,189,130,59,10,0.0,0.0
1012,2210,26-09-2019 13:18:00,1,2744.0,1870.0,0.681,12.882,66,0,0,0,66,15,51,0,0.0,0.0
1012,2211,26-09-2019 13:20:00,1,2648.0,1797.0,0.679,12.425,87,4,1,3,83,34,49,0,0.0,0.0
1012,2212,26-09-2019 13:22:00,1,2545.0,1738.0,0.683,11.954,57,0,0,0,57,10,47,0,0.0,0.0
1012,2213,26-09-2019 13:24:00,1,2540.0,1734.0,0.683,11.928,153,2,1,1,151,109,42,0,0.0,0.0
1012,2214,26-09-2019 13:26:00,1,2451.0,1652.0,0.674,11.485,66,2,0,2,64,16,48,0,0.0,0.0
1012,2215,26-09-2019 13:28:00,1,2328.0,1663.0,0.714,11.013,65,5,3,2,60,9,51,0,0.0,0.0
1012,2216,26-09-2019 13:30:00,1,2449.0,1650.0,0.674,11.477,68,11,5,6,57,16,41,0,0.0,0.0
1012,2217,26-09-2019 13:32:00,1,2567.0,1691.0,0.659,11.985,42,0,0,0,42,0,42,0,0.0,0.0
1012,2218,26-09-2019 13:34:00,1,2554.0,1711.0,0.67,11.958,41,0,0,0,41,0,41,0,0.0,0.0
1012,2219,26-09-2019 13:36:00,1,2543.0,1720.0,0.676,11.925,48,0,0,0,48,2,46,0,0.0,0.0
1012,2220,26-09-2019 13:38:00,1,2529.0,1747.0,0.691,11.898,46,0,0,0,46,0,46,0,0.0,0.0
1012,2221,26-09-2019 13:40:00,1,2475.0,1745.0,0.7055,11.684,38,1,1,0,37,0,37,0,0.0,0.0
1012,2222,26-09-2019 13:42:00,1,2421.0,1743.0,0.72,11.47,47,1,0,1,46,0,46,0,0.0,0.0
1012,2223,26-09-2019 13:44:00,1,2415.0,1726.0,0.715,11.426,49,0,0,0,49,3,46,0,0.0,0.0
1012,2224,26-09-2019 13:46:00,1,2419.0,1760.0,0.727,11.481,71,5,3,2,66,12,54,0,0.0,0.0
1012,2225,26-09-2019 13:48:00,1,2414.0,1785.0,0.74,11.488,51,3,1,2,48,2,46,0,0.0,0.0
1012,2226,26-09-2019 13:50:00,1,2424.0,1789.0,0.738,11.531,52,5,0,5,47,2,45,0,0.0,0.0
1012,2227,26-09-2019 13:52:00,1,2527.0,1788.0,0.708,11.937,48,1,0,1,47,0,47,0,0.01,0.0
1012,2228,26-09-2019 13:54:00,1,2428.0,1761.0,0.725,11.516,65,7,1,6,58,5,53,0,0.0,0.0
1012,2229,26-09-2019 13:56:00,1,2422.0,1750.0,0.723,11.481,74,3,0,3,71,25,46,0,0.0,0.0
1012,2230,26-09-2019 13:58:00,1,2433.0,1656.0,0.681,11.418,93,0,0,0,93,32,61,0,0.0,0.0
1012,2231,26-09-2019 14:00:00,1,2207.0,1608.0,0.729,10.476,88,20,3,17,68,24,44,0,0.0,0.0
1012,2232,26-09-2019 14:02:00,1,2209.0,1620.0,0.733,10.498,47,2,0,2,45,0,45,0,0.0,0.0
1012,2233,26-09-2019 14:04:00,1,2331.0,1649.0,0.707,11.009,76,7,2,5,69,28,41,0,0.0,0.0
1012,2234,26-09-2019 14:06:00,1,2219.0,1606.0,0.724,10.521,55,5,2,3,50,2,48,0,0.0,0.0
1012,2235,26-09-2019 14:08:00,1,2212.0,1604.0,0.725,10.491,98,18,11,7,80,28,52,0,0.0,0.0
1012,2236,26-09-2019 14:10:00,1,2221.0,1640.0,0.738,10.565,50,0,0,0,50,0,50,0,0.0,0.0
1012,2237,26-09-2019 14:12:00,1,2214.0,1628.0,0.735,10.527,45,0,0,0,45,0,45,0,0.0,0.0
1012,2238,26-09-2019 14:14:00,1,2321.0,1672.5,0.721,10.9985,106,17,9,8,89,40,49,0,0.0,0.0
1012,2239,26-09-2019 14:16:00,1,2428.0,1717.0,0.707,11.47,145,32,12,20,113,70,43,0,0.0,0.0
1012,2240,26-09-2019 14:18:00,1,2616.0,1909.0,0.73,12.42,70,15,1,14,55,17,38,0,0.0,0.0
1012,2241,26-09-2019 14:20:00,1,2717.0,1974.0,0.727,12.893,236,45,18,27,191,127,64,0,0.0,0.0
1012,2242,26-09-2019 14:22:00,1,2917.0,2089.0,0.716,13.807,188,52,20,32,136,85,51,1,0.0,0.0
1012,2243,26-09-2019 14:24:00,1,2931.0,2113.0,0.721,13.888,202,41,23,18,161,98,63,55,0.0,0.0
1012,2244,26-09-2019 14:26:00,1,3108.0,2344.0,0.754,14.842,120,24,11,13,96,48,48,48,0.0,0.0
1012,2245,26-09-2019 14:28:00,1,3323.0,2443.0,0.735,15.796,252,51,30,21,201,126,75,60,0.0,0.05
1012,2246,26-09-2019 14:30:00,1,3087.0,2412.0,0.781,14.833,391,146,106,40,245,184,61,83,0.0,0.0
1012,2247,26-09-2019 14:32:00,1,2906.0,2182.0,0.751,13.868,263,46,23,23,217,145,72,31,0.03,0.02
1012,2248,26-09-2019 14:34:00,1,3402.0,2613.0,0.768,16.298,324,179,142,37,145,125,20,164,0.04,0.0
1012,2249,26-09-2019 14:36:00,1,3387.0,2575.0,0.76,16.194,251,133,107,26,118,87,31,76,0.01,0.04
1012,2250,26-09-2019 14:38:00,1,2691.0,2080.0,0.773,12.904,402,123,82,41,279,212,67,35,0.0,0.0
1012,2251,26-09-2019 14:40:00,1,2893.0,2241.0,0.775,13.879,726,334,273,61,392,303,89,2,0.0,0.0
1012,2252,26-09-2019 14:42:00,1,3469.0,2761.0,0.796,16.726,771,437,343,94,334,268,66,5,0.0,0.05
1012,2253,26-09-2019 14:44:00,1,3574.0,2788.0,0.78,17.168,738,418,341,77,320,234,86,5,0.03,0.0
1012,2254,26-09-2019 14:46:00,1,3677.0,2958.0,0.804,17.762,132,43,35,8,89,70,19,0,0.01,0.0
1012,2255,26-09-2019 14:48:00,1,3528.0,2817.5,0.798,17.019,180,77,48,29,103,62,41,3,0.0,0.0
1012,2256,26-09-2019 14:50:00,1,3379.0,2677.0,0.792,16.276,490,224,170,54,266,203,63,7,0.0,0.0
1012,2257,26-09-2019 14:52:00,1,3068.0,2461.0,0.802,14.811,193,86,57,29,107,57,50,0,0.0,0.0
1012,2258,26-09-2019 14:54:00,1,3055.0,2494.0,0.816,14.8,213,29,4,25,184,122,62,0,0.0,0.0
1012,2259,26-09-2019 14:56:00,1,3161.0,2579.0,0.816,15.307,234,32,9,23,202,133,69,0,0.0,0.0
1012,2260,26-09-2019 14:58:00,1,3277.0,2604.0,0.795,15.794,200,18,0,18,182,111,71,0,0.0,0.0
1012,2261,26-09-2019 15:00:00,1,3386.0,2652.0,0.783,16.279,256,63,33,30,193,129,64,0,0.0,0.0
1012,2262,26-09-2019 15:02:00,1,3359.0,2691.0,0.801,16.213,165,34,14,20,131,72,59,0,0.0,0.0
1012,2263,26-09-2019 15:04:00,1,3377.0,2664.0,0.789,16.254,121,12,4,8,109,51,58,0,0.0,0.0
1012,2264,26-09-2019 15:06:00,1,3045.0,2519.0,0.827,14.785,314,29,2,27,285,206,79,0,0.0,0.0
1012,2265,26-09-2019 15:08:00,1,3397.0,2645.0,0.779,16.312,245,25,6,19,220,158,62,0,0.0,0.0
1012,2266,26-09-2019 15:10:00,1,3261.0,2654.0,0.814,15.785,57,4,1,3,53,6,47,0,0.0,0.0
1012,2267,26-09-2019 15:12:00,1,3079.0,2445.0,0.794,14.839,94,2,0,2,92,45,47,0,0.0,0.0
1012,2268,26-09-2019 15:14:00,1,2868.0,2301.0,0.802,13.847,92,11,5,6,81,39,42,0,0.0,0.0
1012,2269,26-09-2019 15:16:00,1,2892.0,2194.0,0.759,13.825,95,10,6,4,85,38,47,0,0.0,0.0
1012,2270,26-09-2019 15:18:00,1,2795.0,2182.0,0.781,13.428,46,3,2,1,43,5,38,0,0.0,0.0
1012,2271,26-09-2019 15:20:00,1,2798.0,2100.0,0.751,13.349,41,0,0,0,41,0,41,0,0.0,0.0
1012,2272,26-09-2019 15:22:00,1,2758.0,2068.0,0.75,13.156,108,8,2,6,100,56,44,0,0.0,0.0
1012,2273,26-09-2019 15:24:00,1,2718.0,2036.0,0.749,12.963,143,0,0,0,143,101,42,0,0.0,0.0
1012,2274,26-09-2019 15:26:00,1,2708.0,2039.0,0.753,12.926,151,2,1,1,149,99,50,0,0.0,0.0
1012,2275,26-09-2019 15:28:00,1,2600.0,1993.0,0.766,12.45,123,25,10,15,98,49,49,0,0.0,0.0
1012,2276,26-09-2019 15:30:00,1,2583.0,2037.0,0.789,12.433,90,16,0,16,74,20,54,0,0.0,0.0
1012,2277,26-09-2019 15:32:00,1,2600.0,2007.0,0.772,12.466,49,10,0,10,39,0,39,0,0.0,0.0
1012,2278,26-09-2019 15:34:00,1,2686.0,2032.0,0.757,12.833,43,0,0,0,43,0,43,0,0.0,0.0
1012,2279,26-09-2019 15:36:00,1,2823.0,2021.0,0.716,13.362,48,10,1,9,38,0,38,0,0.0,0.0
1012,2280,26-09-2019 15:38:00,1,2816.0,2060.0,0.732,13.377,64,12,5,7,52,10,42,0,0.0,0.0
1012,2281,26-09-2019 15:40:00,1,2825.0,2008.0,0.711,13.353,53,4,2,2,49,10,39,0,0.0,0.0
1012,2282,26-09-2019 15:42:00,1,2714.0,1978.0,0.729,12.884,64,15,1,14,49,6,43,0,0.0,0.0
1012,2283,26-09-2019 15:44:00,1,2728.0,1966.0,0.721,12.927,81,17,13,4,64,23,41,0,0.0,0.0
1012,2284,26-09-2019 15:46:00,1,2841.0,1993.0,0.702,13.399,52,0,0,0,52,14,38,0,0.0,0.0
1012,2285,26-09-2019 15:48:00,1,2734.0,1977.0,0.723,12.962,50,0,0,0,50,5,45,0,0.0,0.0
1012,2286,26-09-2019 15:50:00,1,2730.0,1952.0,0.715,12.917,114,9,2,7,105,61,44,0,0.0,0.0
1012,2287,26-09-2019 15:52:00,1,2716.0,1988.0,0.732,12.903,168,0,0,0,168,137,31,0,0.0,0.0
1012,2288,26-09-2019 15:54:00,1,2610.0,1918.0,0.735,12.406,191,30,15,15,161,108,53,0,0.0,0.0
1012,2289,26-09-2019 15:56:00,1,2726.5,1963.5,0.721,12.9165,86,1,0,1,85,37,48,0,0.0,0.0
1012,2290,26-09-2019 15:58:00,1,2843.0,2009.0,0.707,13.427,64,1,0,1,63,22,41,0,0.0,0.0
1012,2291,26-09-2019 16:00:00,1,2597.0,1946.0,0.749,12.388,49,2,1,1,47,0,47,0,0.0,0.0
1012,2292,26-09-2019 16:02:00,1,2624.0,1876.0,0.715,12.416,91,0,0,0,91,48,43,0,0.0,0.0
1012,2293,26-09-2019 16:04:00,1,2644.0,1851.0,0.7,12.467,123,22,11,11,101,59,42,0,0.0,0.0
1012,2294,26-09-2019 16:06:00,1,2708.0,2015.0,0.744,12.903,288,2,1,1,286,244,42,0,0.0,0.0
1012,2295,26-09-2019 16:08:00,1,2708.0,2022.0,0.746,12.91,45,0,0,0,45,8,37,0,0.0,0.0
1012,2296,26-09-2019 16:10:00,1,2718.0,2021.0,0.743,12.948,85,15,9,6,70,23,47,0,0.0,0.0
1012,2297,26-09-2019 16:12:00,1,2613.0,1973.0,0.755,12.48,38,0,0,0,38,0,38,0,0.0,0.0
1012,2298,26-09-2019 16:14:00,1,2612.0,1904.0,0.729,12.401,43,0,0,0,43,5,38,0,0.0,0.0
1012,2299,26-09-2019 16:16:00,1,2615.0,1899.0,0.726,12.408,40,0,0,0,40,0,40,0,0.0,0.0
1012,2300,26-09-2019 16:18:00,1,2614.0,1906.0,0.729,12.408,74,7,1,6,67,44,23,0,0.0,0.0
1012,2301,26-09-2019 16:20:00,1,2615.0,1894.0,0.724,12.4,43,4,0,4,39,4,35,0,0.0,0.0
1012,2302,26-09-2019 16:22:00,1,2606.0,1953.0,0.749,12.432,29,0,0,0,29,0,29,0,0.0,0.0
1012,2303,26-09-2019 16:24:00,1,2616.0,1923.0,0.735,12.438,65,4,0,4,61,15,46,0,0.0,0.0
1012,2304,26-09-2019 16:26:00,1,2632.0,1872.0,0.711,12.444,37,1,0,1,36,0,36,0,0.0,0.0
1012,2305,26-09-2019 16:28:00,1,2418.0,1762.0,0.729,11.479,56,5,3,2,51,16,35,0,0.0,0.0
1012,2306,26-09-2019 16:30:00,1,2416.5,1759.5,0.728,11.47,56,4,1,3,52,13,39,0,0.0,0.0
1012,2307,26-09-2019 16:32:00,1,2415.0,1757.0,0.727,11.461,36,0,0,0,36,0,36,0,0.0,0.0
1012,2308,26-09-2019 16:34:00,1,2424.0,1763.0,0.727,11.502,240,43,22,21,197,134,63,12,0.0,0.0
1012,2309,26-09-2019 16:36:00,1,3018.0,2271.0,0.752,14.404,156,21,1,20,135,79,56,22,0.0,0.0
1012,2310,26-09-2019 16:38:00,1,3080.0,2451.0,0.796,14.85,163,7,2,5,156,96,60,13,0.0,0.0
1012,2311,26-09-2019 16:40:00,1,3389.0,2578.0,0.761,16.208,189,16,3,13,173,108,65,21,0.01,0.09
1012,2312,26-09-2019 16:42:00,1,3364.0,2659.0,0.79,16.197,168,30,1,29,138,88,50,16,0.05,0.0
1012,2313,26-09-2019 16:44:00,1,3062.0,2483.0,0.811,14.815,754,316,252,64,438,368,70,39,0.0,0.03
1012,2314,26-09-2019 16:46:00,1,2682.0,2165.0,0.807,12.965,512,195,149,46,317,259,58,13,0.0,0.0
1012,2315,26-09-2019 16:48:00,1,2587.0,2047.0,0.791,12.459,186,62,24,38,124,64,60,0,0.0,0.0
1012,2316,26-09-2019 16:50:00,1,2895.0,2231.0,0.771,13.878,149,52,19,33,97,51,46,0,0.0,0.0
1012,2317,26-09-2019 16:52:00,1,3083.0,2430.0,0.788,14.837,187,61,30,31,126,68,58,0,0.0,0.0
1012,2318,26-09-2019 16:54:00,1,2869.0,2316.0,0.807,13.867,86,29,0,29,57,27,30,0,0.0,0.0
1012,2319,26-09-2019 16:56:00,1,3075.0,2495.0,0.811,14.876,160,66,30,36,94,56,38,0,0.0,0.0
1012,2320,26-09-2019 16:58:00,1,3035.0,2597.0,0.856,14.833,160,107,72,35,53,20,33,0,0.0,0.0
1012,2321,26-09-2019 17:00:00,1,3255.0,2716.0,0.834,15.831,613,261,202,59,352,265,87,6,0.01,0.0
1012,2322,26-09-2019 17:02:00,1,3525.0,3009.0,0.853,17.22,203,116,88,28,87,49,38,17,0.0,0.0
1012,2323,26-09-2019 17:04:00,1,3454.5,2877.0,0.832,16.7955,17,9,2,7,8,5,3,0,0.0,0.0
1012,2324,26-09-2019 17:06:00,1,3384.0,2745.0,0.811,16.371,141,35,9,26,106,64,42,3,0.0,0.0
1012,2325,26-09-2019 17:08:00,1,3434.0,2891.0,0.842,16.731,159,45,14,31,114,101,13,2,0.0,0.0
1012,2326,26-09-2019 17:10:00,1,3464.0,2782.0,0.803,16.726,75,53,28,25,22,20,2,0,0.0,0.0
1012,2327,26-09-2019 17:12:00,1,3260.0,2680.0,0.822,15.814,33,6,0,6,27,22,5,0,0.0,0.0
1012,2328,26-09-2019 17:14:00,1,3155.0,2622.0,0.831,15.335,1,0,0,0,1,0,1,0,0.0,0.0
1012,2329,26-09-2019 17:16:00,1,3186.0,2518.0,0.79,15.343,22,0,0,0,22,21,1,0,0.0,0.0
1012,2330,26-09-2019 17:18:00,1,2958.0,2446.0,0.827,14.362,19,14,6,8,5,0,5,0,0.0,0.0
1012,2331,26-09-2019 17:20:00,1,2987.0,2346.0,0.785,14.368,30,0,0,0,30,10,20,0,0.0,0.0
1012,2332,26-09-2019 17:22:00,1,2765.0,2251.0,0.814,13.388,38,0,0,0,38,0,38,0,0.0,0.0
1012,2333,26-09-2019 17:24:00,1,2657.0,2184.0,0.822,12.887,22,0,0,0,22,4,18,0,0.0,0.0
1012,2334,26-09-2019 17:26:00,1,2687.0,2152.0,0.801,12.972,3,0,0,0,3,0,3,0,0.0,0.0
1012,2335,26-09-2019 17:28:00,1,2679.0,2134.0,0.797,12.917,11,2,0,2,9,5,4,0,0.0,0.0
1012,2336,26-09-2019 17:30:00,1,2679.0,2142.0,0.8,12.926,5,4,1,3,1,1,0,0,0.0,0.0
1012,2337,26-09-2019 17:32:00,1,2693.0,2099.0,0.779,12.934,5,4,3,1,1,0,1,0,0.0,0.0
1012,2338,26-09-2019 17:34:00,1,2695.0,2098.0,0.779,12.941,6,0,0,0,6,0,6,0,0.0,0.0
1012,2339,26-09-2019 17:36:00,1,2675.0,2153.0,0.805,12.924,5,0,0,0,5,0,5,0,0.0,0.0
1012,2340,26-09-2019 17:38:00,1,2624.5,2124.0,0.8095,12.692,15,1,1,0,14,6,8,0,0.0,0.0
1012,2341,26-09-2019 17:40:00,1,2574.0,2095.0,0.814,12.46,4,0,0,0,4,0,4,0,0.0,0.0
1012,2342,26-09-2019 17:42:00,1,2359.0,2005.0,0.85,11.513,23,8,2,6,15,7,8,0,0.0,0.0
1012,2343,26-09-2019 17:44:00,1,2446.0,2060.0,0.842,11.919,163,37,10,27,126,75,51,0,0.0,0.0
1012,2344,26-09-2019 17:46:00,1,2859.0,2330.0,0.815,13.845,250,65,40,25,185,123,62,40,0.0,0.0
1012,2345,26-09-2019 17:48:00,1,3016.0,2697.0,0.894,14.868,244,22,4,18,222,164,58,18,0.0,0.0
1012,2346,26-09-2019 17:50:00,1,3341.0,2792.0,0.835,16.255,121,6,3,3,115,60,55,18,0.0,0.05
1012,2347,26-09-2019 17:52:00,1,3331.0,2818.0,0.846,16.246,255,45,27,18,210,153,57,39,0.05,0.04
1012,2348,26-09-2019 17:54:00,1,2819.0,2509.0,0.89,13.886,56,4,2,2,52,7,45,0,0.02,0.0
1012,2349,26-09-2019 17:56:00,1,2851.0,2346.0,0.823,13.83,41,0,0,0,41,0,41,0,0.0,0.0
1012,2350,26-09-2019 17:58:00,1,2643.0,2266.0,0.857,12.924,85,0,0,0,85,46,39,0,0.0,0.0
1012,2351,26-09-2019 18:00:00,0,2636.0,2284.0,0.866,12.913,285,64,52,12,221,155,66,3,0.0,0.0
1012,2352,26-09-2019 18:02:00,0,2990.0,2757.0,0.922,14.835,933,493,407,86,440,360,80,35,0.0,0.0
1012,2353,26-09-2019 18:04:00,0,3517.0,3108.0,0.884,17.3,522,204,159,45,318,249,69,86,0.0,0.0
1012,2354,26-09-2019 18:06:00,0,3520.0,3070.0,0.872,17.266,395,183,141,42,212,158,54,103,0.01,0.0
1012,2355,26-09-2019 18:08:00,0,3485.0,3186.0,0.914,17.259,537,292,237,55,245,186,59,121,0.02,0.0
1012,2356,26-09-2019 18:10:00,0,3723.0,3291.0,0.884,18.313,264,88,52,36,176,141,35,19,0.0,0.0
1012,2357,26-09-2019 18:12:00,0,3714.5,3260.5,0.878,18.245,459,180,139,41,279,244,35,93,0.03,0.0
1012,2358,26-09-2019 18:14:00,0,3706.0,3230.0,0.872,18.177,274,127,71,56,147,100,47,5,0.0,0.0
1012,2359,26-09-2019 18:16:00,0,3612.0,3160.0,0.875,17.73,241,52,20,32,189,130,59,0,0.0,0.0
1012,2360,26-09-2019 18:18:00,0,3483.0,3156.0,0.906,17.218,377,53,30,23,324,251,73,0,0.0,0.0
1012,2361,26-09-2019 18:20:00,0,3725.0,3203.0,0.86,18.223,204,43,19,24,161,106,55,0,0.0,0.0
1012,2362,26-09-2019 18:22:00,0,3678.0,3298.0,0.897,18.142,256,82,47,35,174,119,55,0,0.01,0.0
1012,2363,26-09-2019 18:24:00,0,3704.0,3312.0,0.894,18.262,421,171,128,43,250,185,65,18,0.0,0.0
1012,2364,26-09-2019 18:26:00,0,3998.0,3528.0,0.882,19.659,540,289,241,48,251,189,62,85,0.01,0.0
1012,2365,26-09-2019 18:28:00,0,3672.0,3347.0,0.911,18.173,107,32,4,28,75,37,38,0,0.0,0.0
1012,2366,26-09-2019 18:30:00,0,3619.0,3146.0,0.869,17.741,361,111,85,26,250,188,62,5,0.0,0.0
1012,2367,26-09-2019 18:32:00,0,3710.0,3212.0,0.866,18.173,530,235,183,52,295,224,71,73,0.0,0.0
1012,2368,26-09-2019 18:34:00,0,3732.0,3179.0,0.852,18.224,199,88,60,28,111,72,39,21,0.0,0.0
1012,2369,26-09-2019 18:36:00,0,3613.0,3085.0,0.854,17.649,384,200,161,39,184,138,46,81,0.0,0.0
1012,2370,26-09-2019 18:38:00,0,3627.0,3107.0,0.857,17.731,333,173,143,30,160,124,36,91,0.05,0.0
1012,2371,26-09-2019 18:40:00,0,3709.0,3208.0,0.865,18.166,396,199,160,39,197,161,36,67,0.0,0.0
1012,2372,26-09-2019 18:42:00,0,3748.0,3053.0,0.815,18.147,484,215,175,40,269,202,67,114,0.0,0.0
1012,2373,26-09-2019 18:44:00,0,3731.0,3114.0,0.835,18.147,279,173,141,32,106,75,31,179,0.0,0.0
1012,2374,26-09-2019 18:46:00,0,3742.5,3086.0,0.825,18.161,171,68,36,32,103,62,41,0,0.0,0.0
1012,2375,26-09-2019 18:48:00,0,3754.0,3058.0,0.815,18.175,190,84,52,32,106,65,41,15,0.0,0.0
1012,2376,26-09-2019 18:50:00,0,3540.0,2961.0,0.836,17.226,368,176,141,35,192,143,49,77,0.0,0.0
1012,2377,26-09-2019 18:52:00,0,3737.0,3076.0,0.823,18.129,194,96,76,20,98,65,33,81,0.0,0.0
1012,2378,26-09-2019 18:54:00,0,3777.0,3060.0,0.81,18.268,84,10,5,5,74,39,35,1,0.0,0.0
1012,2379,26-09-2019 18:56:00,0,3734.0,3048.0,0.816,18.086,178,96,72,24,82,53,29,16,0.08,0.0
1012,2380,26-09-2019 18:58:00,0,3382.0,2677.0,0.791,16.289,391,203,156,47,188,152,36,91,0.0,0.0
1012,2381,26-09-2019 19:00:00,0,3597.0,2806.0,0.78,17.281,303,170,128,42,133,103,30,117,0.0,0.0
1012,2382,26-09-2019 19:02:00,0,3693.0,2878.0,0.779,17.737,172,87,63,24,85,53,32,47,0.0,0.0
1012,2383,26-09-2019 19:04:00,0,3814.0,2870.0,0.752,18.204,190,76,45,31,114,71,43,4,0.0,0.0
1012,2384,26-09-2019 19:06:00,0,3594.0,2805.0,0.78,17.265,88,63,26,37,25,20,5,1,0.0,0.0
1012,2385,26-09-2019 19:08:00,0,3585.0,2760.0,0.77,17.181,235,79,54,25,156,138,18,5,0.14,0.0
1012,2386,26-09-2019 19:10:00,0,3795.0,2976.0,0.784,18.247,454,186,148,38,268,229,39,48,0.0,0.0
1012,2387,26-09-2019 19:12:00,0,3611.0,2734.0,0.757,17.256,279,130,93,37,149,125,24,68,0.0,0.0
1012,2388,26-09-2019 19:14:00,0,3586.0,2764.0,0.771,17.191,306,97,65,32,209,183,26,22,0.0,0.0
1012,2389,26-09-2019 19:16:00,0,3526.0,2671.0,0.758,16.848,224,81,54,27,143,129,14,66,0.0,0.0
1012,2390,26-09-2019 19:18:00,0,3591.0,2718.0,0.757,17.158,247,106,76,30,141,126,15,13,0.0,0.0
1012,2391,26-09-2019 19:20:00,0,3595.0,2729.5,0.7595,17.188,291,140,97,43,151,135,16,74,0.0,0.0
1012,2392,26-09-2019 19:22:00,0,3599.0,2741.0,0.762,17.218,278,94,74,20,184,168,16,56,0.0,0.0
1012,2393,26-09-2019 19:24:00,0,3604.0,2644.0,0.733,17.128,190,91,70,21,99,73,26,4,0.0,0.0
1012,2394,26-09-2019 19:26:00,0,3798.0,2864.0,0.754,18.135,145,86,60,26,59,33,26,35,0.0,0.0
1012,2395,26-09-2019 19:28:00,0,3401.0,2602.0,0.765,16.283,151,85,67,18,66,49,17,41,0.0,0.0
1012,2396,26-09-2019 19:30:00,0,3405.0,2523.0,0.741,16.209,154,103,76,27,51,23,28,51,0.0,0.0
1012,2397,26-09-2019 19:32:00,0,3640.0,2658.0,0.73,17.285,212,104,78,26,108,64,44,65,0.0,0.0
1012,2398,26-09-2019 19:34:00,0,3602.0,2735.0,0.759,17.221,403,181,140,41,222,195,27,85,0.0,0.0
1012,2399,26-09-2019 19:36:00,0,3504.0,2650.0,0.756,16.742,367,164,124,40,203,175,28,64,0.0,0.0
1012,2400,26-09-2019 19:38:00,0,3613.0,2652.0,0.734,17.173,328,64,40,24,264,242,22,1,0.0,0.0
1012,2401,26-09-2019 19:40:00,0,3628.0,2617.0,0.721,17.194,194,57,24,33,137,118,19,0,0.0,0.0
1012,2402,26-09-2019 19:42:00,0,3628.0,2625.0,0.724,17.203,340,85,46,39,255,221,34,0,0.0,0.0
1012,2403,26-09-2019 19:44:00,0,3646.0,2606.0,0.715,17.252,285,80,54,26,205,189,16,2,0.0,0.0
1012,2404,26-09-2019 19:46:00,0,3633.0,2596.0,0.715,17.191,117,0,0,0,117,109,8,0,0.0,0.0
1012,2405,26-09-2019 19:48:00,0,3457.0,2405.0,0.696,16.284,2,0,0,0,2,2,0,0,0.0,0.0
1012,2406,26-09-2019 19:50:00,0,3135.0,2239.0,0.714,14.832,1,0,0,0,1,0,1,0,0.0,0.0
1012,2407,26-09-2019 19:52:00,0,3033.0,2106.0,0.694,14.282,9,2,1,1,7,5,2,0,0.0,0.0
1012,2408,26-09-2019 19:54:00,0,2935.0,2036.5,0.694,13.8185,14,0,0,0,14,10,4,0,0.0,0.0
1012,2409,26-09-2019 19:56:00,0,2837.0,1967.0,0.694,13.355,0,0,0,0,0,0,0,0,0.0,0.0
1012,2410,26-09-2019 19:58:00,0,2633.0,1871.0,0.711,12.446,76,40,27,13,36,32,4,0,0.0,0.0
1012,2411,26-09-2019 20:00:00,0,2621.0,1863.0,0.711,12.39,17,3,2,1,14,13,1,0,0.0,0.0
1012,2412,26-09-2019 20:02:00,0,2645.0,1800.0,0.681,12.413,429,4,2,2,425,403,22,0,0.0,0.0
1012,2413,26-09-2019 20:04:00,0,2525.0,1753.0,0.694,11.891,357,18,11,7,339,309,30,0,0.0,0.0
1012,2414,26-09-2019 20:06:00,0,2642.0,1803.0,0.682,12.405,447,136,88,48,311,269,42,9,0.0,0.0
1012,2415,26-09-2019 20:08:00,0,3022.0,2181.0,0.722,14.324,691,332,278,54,359,322,37,108,0.0,0.0
1012,2416,26-09-2019 20:10:00,0,3129.0,2248.0,0.718,14.817,511,215,172,43,296,260,36,168,0.0,0.0
1012,2417,26-09-2019 20:12:00,0,3555.0,2455.0,0.691,16.726,502,194,154,40,308,274,34,118,0.0,0.0
1012,2418,26-09-2019 20:14:00,0,3659.0,2524.0,0.69,17.213,549,237,181,56,312,279,33,89,0.0,0.0
1012,2419,26-09-2019 20:16:00,0,3868.0,2662.0,0.688,18.188,661,235,173,62,426,386,40,17,0.0,0.0
1012,2420,26-09-2019 20:18:00,0,4049.0,2803.0,0.692,19.055,584,240,176,64,344,294,50,6,0.0,0.0
1012,2421,26-09-2019 20:20:00,0,4156.0,2938.0,0.707,19.629,625,314,234,80,311,238,73,19,0.0,0.0
1012,2422,26-09-2019 20:22:00,0,4045.0,2789.0,0.689,19.028,694,309,235,74,385,318,67,23,0.0,0.0
1012,2423,26-09-2019 20:24:00,0,3851.0,2731.0,0.709,18.196,474,179,135,44,295,233,62,47,0.0,0.0
1012,2424,26-09-2019 20:26:00,0,4039.0,2879.0,0.713,19.102,513,245,187,58,268,221,47,69,0.0,0.0
1012,2425,26-09-2019 20:28:00,0,4057.0,2842.0,0.7005,19.1325,274,152,100,52,122,77,45,9,0.0,0.0
1012,2426,26-09-2019 20:30:00,0,4075.0,2805.0,0.688,19.163,189,63,41,22,126,88,38,3,0.0,0.0
1012,2427,26-09-2019 20:32:00,0,3838.0,2754.0,0.717,18.173,289,162,120,42,127,89,38,35,0.0,0.0
1012,2428,26-09-2019 20:34:00,0,3943.0,2777.0,0.704,18.612,350,142,109,33,208,170,38,121,0.0,0.0
1012,2429,26-09-2019 20:36:00,0,3660.0,2483.0,0.679,17.169,142,71,34,37,71,21,50,10,0.0,0.0
1012,2430,26-09-2019 20:38:00,0,3164.0,2128.0,0.673,14.823,117,60,28,32,57,11,46,0,0.0,0.0
1012,2431,26-09-2019 20:40:00,0,3658.0,2533.0,0.692,17.219,266,121,91,30,145,99,46,44,0.0,0.0
1012,2432,26-09-2019 20:42:00,0,4158.0,2884.0,0.694,19.576,635,352,288,64,283,217,66,41,0.0,0.0
1012,2433,26-09-2019 20:44:00,0,3851.0,2680.0,0.696,18.14,476,185,134,51,291,230,61,86,0.0,0.0
1012,2434,26-09-2019 20:46:00,0,3857.0,2724.0,0.706,18.213,293,182,124,58,111,67,44,6,0.0,0.0
1012,2435,26-09-2019 20:48:00,0,4162.0,2892.0,0.695,19.602,500,264,204,60,236,175,61,105,0.0,0.0
1012,2436,26-09-2019 20:50:00,0,4361.0,3022.0,0.693,20.528,185,100,72,28,85,60,25,52,0.0,0.0
1012,2437,26-09-2019 20:52:00,0,4247.0,2971.0,0.7,20.022,244,127,91,36,117,84,33,2,0.0,0.0
1012,2438,26-09-2019 20:54:00,0,4143.0,2975.0,0.718,19.62,285,157,118,39,128,83,45,49,0.0,0.0
1012,2439,26-09-2019 20:56:00,0,3831.0,2698.0,0.704,18.08,385,206,176,30,179,141,38,118,0.0,0.0
1012,2440,26-09-2019 20:58:00,0,3853.0,2715.0,0.705,18.189,204,92,66,26,112,80,32,90,0.0,0.0
1012,2441,26-09-2019 21:00:00,0,4145.0,2927.0,0.706,19.573,387,238,195,43,149,101,48,70,0.0,0.0
1012,2442,26-09-2019 21:02:00,0,4258.5,2989.0,0.702,20.0895,534,316,247,69,218,158,60,34,0.0,0.0
1012,2443,26-09-2019 21:04:00,0,4372.0,3051.0,0.698,20.606,311,140,96,44,171,132,39,68,0.0,0.0
1012,2444,26-09-2019 21:06:00,0,4246.0,2974.0,0.7,20.022,178,61,36,25,117,71,46,3,0.0,0.0
1012,2445,26-09-2019 21:08:00,0,4178.0,2867.0,0.686,19.637,376,218,165,53,158,129,29,113,0.0,0.0
1012,2446,26-09-2019 21:10:00,0,4169.0,2882.0,0.691,19.618,158,87,66,21,71,54,17,77,0.0,0.0
1012,2447,26-09-2019 21:12:00,0,4269.0,2892.0,0.677,20.024,201,136,108,28,65,39,26,40,0.0,0.0
1012,2448,26-09-2019 21:14:00,0,3835.0,2796.0,0.729,18.207,140,85,49,36,55,38,17,0,0.0,0.0
1012,2449,26-09-2019 21:16:00,0,3942.0,2752.0,0.698,18.581,304,203,155,48,101,72,29,16,0.0,0.0
1012,2450,26-09-2019 21:18:00,0,4154.0,2984.0,0.718,19.673,260,119,86,33,141,105,36,7,0.0,0.0
1012,2451,26-09-2019 21:20:00,0,3849.0,2712.0,0.705,18.169,138,107,57,50,31,23,8,0,0.0,0.0
1012,2452,26-09-2019 21:22:00,0,3851.0,2717.0,0.706,18.183,202,128,84,44,74,54,20,21,0.0,0.0
1012,2453,26-09-2019 21:24:00,0,3949.0,2767.0,0.701,18.623,533,356,279,77,177,133,44,69,0.0,0.0
1012,2454,26-09-2019 21:26:00,0,4126.0,2959.0,0.717,19.534,330,195,136,59,135,99,36,9,0.0,0.0
1012,2455,26-09-2019 21:28:00,0,4181.0,2882.0,0.689,19.663,148,81,61,20,67,41,26,68,0.0,0.0
1012,2456,26-09-2019 21:30:00,0,3857.0,2710.0,0.703,18.196,204,92,67,25,112,77,35,39,0.0,0.0
1012,2457,26-09-2019 21:32:00,0,4043.0,2858.0,0.707,19.093,373,220,161,59,153,118,35,77,0.0,0.0
1012,2458,26-09-2019 21:34:00,0,4167.0,2901.0,0.696,19.632,326,162,117,45,164,115,49,8,0.0,0.0
1012,2459,26-09-2019 21:36:00,0,4021.0,2767.0,0.6875,18.907,166,81,46,35,85,53,32,47,0.0,0.0
1012,2460,26-09-2019 21:38:00,0,3875.0,2633.0,0.679,18.182,447,261,196,65,186,148,38,52,0.0,0.0
1012,2461,26-09-2019 21:40:00,0,4062.0,2778.0,0.684,19.082,245,111,75,36,134,97,37,22,0.0,0.0
1012,2462,26-09-2019 21:42:00,0,3870.0,2628.0,0.679,18.159,331,217,181,36,114,90,24,102,0.0,0.0
1012,2463,26-09-2019 21:44:00,0,3843.0,2744.0,0.714,18.182,398,217,162,55,181,133,48,110,0.0,0.0
1012,2464,26-09-2019 21:46:00,0,4047.0,2789.0,0.689,19.034,202,126,96,30,76,61,15,49,0.0,0.0
1012,2465,26-09-2019 21:48:00,0,4164.0,2830.0,0.68,19.542,326,142,100,42,184,141,43,72,0.0,0.0
1012,2466,26-09-2019 21:50:00,0,4190.0,2827.0,0.675,19.639,280,150,120,30,130,94,36,121,0.0,0.0
1012,2467,26-09-2019 21:52:00,0,3944.0,2748.0,0.697,18.581,440,257,197,60,183,139,44,80,0.0,0.0
1012,2468,26-09-2019 21:54:00,0,4262.0,2993.0,0.702,20.108,367,234,181,53,133,98,35,42,0.0,0.0
1012,2469,26-09-2019 21:56:00,0,4046.0,2797.0,0.691,19.037,230,158,110,48,72,49,23,57,0.0,0.0
1012,2470,26-09-2019 21:58:00,0,4160.0,2904.0,0.698,19.607,560,333,265,68,227,171,56,93,0.0,0.0
1012,2471,26-09-2019 22:00:00,0,4195.0,2776.0,0.662,19.604,201,102,70,32,99,72,27,87,0.0,0.0
1012,2472,26-09-2019 22:02:00,0,3840.0,2714.0,0.707,18.136,405,252,196,56,153,115,38,35,0.0,0.0
1012,2473,26-09-2019 22:04:00,0,3865.0,2673.0,0.692,18.188,210,122,84,38,88,57,31,26,0.0,0.0
1012,2474,26-09-2019 22:06:00,0,4180.0,2810.0,0.672,19.58,263,127,82,45,136,98,38,1,0.0,0.0
1012,2475,26-09-2019 22:08:00,0,3862.0,2657.0,0.688,18.159,241,159,121,38,82,58,24,39,0.0,0.0
1012,2476,26-09-2019 22:10:00,0,3866.0,2626.5,0.6795,18.14,161,97,78,19,64,45,19,70,0.0,0.0
1012,2477,26-09-2019 22:12:00,0,3870.0,2596.0,0.671,18.121,285,130,93,37,155,118,37,89,0.0,0.0
1012,2478,26-09-2019 22:14:00,0,4177.0,2862.0,0.685,19.627,598,403,327,76,195,151,44,91,0.0,0.0
1012,2479,26-09-2019 22:16:00,0,4167.0,2909.0,0.698,19.64,170,87,58,29,83,60,23,26,0.0,0.0
1012,2480,26-09-2019 22:18:00,0,3884.0,2590.0,0.667,18.17,304,124,90,34,180,125,55,54,0.0,0.0
1012,2481,26-09-2019 22:20:00,0,4184.0,2859.0,0.683,19.653,622,328,255,73,294,228,66,57,0.0,0.0
1012,2482,26-09-2019 22:22:00,0,3859.0,2628.0,0.681,18.113,185,104,62,42,81,61,20,47,0.0,0.0
1012,2483,26-09-2019 22:24:00,0,3854.0,2690.0,0.698,18.162,113,93,43,50,20,8,12,0,0.0,0.0
1012,2484,26-09-2019 22:26:00,0,3881.0,2645.0,0.682,18.222,117,76,39,37,41,17,24,0,0.0,0.0
1012,2485,26-09-2019 22:28:00,0,3961.0,2751.0,0.694,18.653,229,104,74,30,125,95,30,24,0.0,0.0
1012,2486,26-09-2019 22:30:00,0,3891.0,2586.0,0.665,18.195,473,237,180,57,236,183,53,118,0.0,0.0
1012,2487,26-09-2019 22:32:00,0,4075.0,2742.0,0.673,19.093,387,234,183,51,153,116,37,109,0.0,0.0
1012,2488,26-09-2019 22:34:00,0,3854.0,2645.0,0.686,18.115,306,160,125,35,146,117,29,38,0.0,0.0
1012,2489,26-09-2019 22:36:00,0,4064.0,2789.0,0.686,19.102,313,185,146,39,128,94,34,98,0.0,0.0
1012,2490,26-09-2019 22:38:00,0,3960.0,2700.0,0.682,18.594,408,278,231,47,130,101,29,97,0.0,0.0
1012,2491,26-09-2019 22:40:00,0,4166.0,2859.0,0.686,19.579,227,134,93,41,93,58,35,18,0.0,0.0
1012,2492,26-09-2019 22:42:00,0,4173.0,2908.0,0.697,19.661,454,259,204,55,195,148,47,124,0.0,0.0
1012,2493,26-09-2019 22:44:00,0,4018.5,2797.5,0.696,18.931,289,149,103,46,140,114,26,61,0.0,0.0
1012,2494,26-09-2019 22:46:00,0,3864.0,2687.0,0.695,18.201,287,132,86,46,155,120,35,56,0.0,0.0
1012,2495,26-09-2019 22:48:00,0,3874.0,2581.0,0.666,18.124,395,212,152,60,183,137,46,67,0.0,0.0
1012,2496,26-09-2019 22:50:00,0,4356.0,2997.0,0.688,20.483,368,197,155,42,171,130,41,91,0.0,0.0
1012,2497,26-09-2019 22:52:00,0,4040.0,2786.0,0.689,19.003,229,109,80,29,120,84,36,22,0.0,0.0
1012,2498,26-09-2019 22:54:00,0,4166.0,2824.0,0.678,19.543,213,145,108,37,68,49,19,50,0.0,0.0
1012,2499,26-09-2019 22:56:00,0,3855.0,2702.0,0.701,18.179,413,239,181,58,174,124,50,64,0.0,0.0
1012,2500,26-09-2019 22:58:00,0,3961.0,2752.0,0.695,18.654,372,193,147,46,179,133,46,46,0.0,0.0
1012,2501,26-09-2019 23:00:00,0,3964.0,2762.0,0.697,18.676,322,167,125,42,155,118,37,66,0.0,0.0
1012,2502,26-09-2019 23:02:00,0,3973.0,2689.0,0.677,18.632,265,134,102,32,131,86,45,54,0.0,0.0
1012,2503,26-09-2019 23:04:00,0,3854.0,2690.0,0.698,18.164,522,334,261,73,188,133,55,71,0.0,0.0
1012,2504,26-09-2019 23:06:00,0,4175.0,2859.0,0.685,19.616,437,239,171,68,198,140,58,28,0.0,0.0
1012,2505,26-09-2019 23:08:00,0,3655.0,2454.0,0.672,17.119,489,287,222,65,202,156,46,63,0.0,0.0
1012,2506,26-09-2019 23:10:00,0,4067.0,2745.0,0.675,19.065,308,179,122,57,129,86,43,1,0.0,0.0
1012,2507,26-09-2019 23:12:00,0,3877.0,2614.0,0.674,18.171,121,84,48,36,37,16,21,0,0.0,0.0
1012,2508,26-09-2019 23:14:00,0,3883.0,2540.0,0.654,18.11,101,70,38,32,31,9,22,11,0.0,0.0
1012,2509,26-09-2019 23:16:00,0,3880.0,2572.0,0.663,18.134,449,261,204,57,188,150,38,88,0.0,0.0
1012,2510,26-09-2019 23:18:00,0,3881.0,2593.5,0.6685,18.1615,442,248,194,54,194,158,36,137,0.0,0.0
1012,2511,26-09-2019 23:20:00,0,3882.0,2615.0,0.674,18.189,361,228,170,58,133,101,32,44,0.0,0.0
1012,2512,26-09-2019 23:22:00,0,3863.0,2683.0,0.695,18.19,52,15,5,10,37,23,14,24,0.0,0.0
1012,2513,26-09-2019 23:24:00,0,3862.0,2593.0,0.672,18.088,275,161,128,33,114,89,25,67,0.0,0.0
1012,2514,26-09-2019 23:26:00,0,3871.0,2622.0,0.677,18.154,694,360,282,78,334,267,67,10,0.0,0.0
1012,2515,26-09-2019 23:28:00,0,4185.0,2820.0,0.674,19.61,771,391,296,95,380,308,72,8,0.0,0.0
1012,2516,26-09-2019 23:30:00,0,4152.0,2819.0,0.679,19.482,455,259,195,64,196,147,49,8,0.0,0.0
1012,2517,26-09-2019 23:32:00,0,3874.0,2605.0,0.672,18.149,229,92,63,29,137,100,37,40,0.0,0.0
1012,2518,26-09-2019 23:34:00,0,4198.0,2731.0,0.65,19.563,394,248,191,57,146,115,31,52,0.0,0.0
1012,2519,26-09-2019 23:36:00,0,3970.0,2666.0,0.672,18.596,162,95,66,29,67,42,25,3,0.0,0.0
1012,2520,26-09-2019 23:38:00,0,3916.0,2504.0,0.639,18.202,220,130,96,34,90,66,24,23,0.0,0.0
1012,2521,26-09-2019 23:40:00,0,3786.0,2480.0,0.655,17.665,384,240,178,62,144,105,39,11,0.0,0.0
1012,2522,26-09-2019 23:42:00,0,4080.0,2711.0,0.664,19.076,268,175,144,31,93,74,19,163,0.0,0.0
1012,2523,26-09-2019 23:44:00,0,4168.0,2829.0,0.679,19.556,410,208,155,53,202,144,58,14,0.0,0.0
1012,2524,26-09-2019 23:46:00,0,3909.0,2516.0,0.643,18.189,141,44,30,14,97,53,44,29,0.0,0.0
1012,2525,26-09-2019 23:48:00,0,3654.0,2438.0,0.667,17.097,602,314,236,78,288,211,77,67,0.0,0.0
1012,2526,26-09-2019 23:50:00,0,4199.0,2753.0,0.655,19.594,493,253,201,52,240,180,60,69,0.0,0.0
1012,2527,26-09-2019 23:52:00,0,4188.0,2772.5,0.662,19.571,380,153,103,50,227,165,62,48,0.0,0.0
1012,2528,26-09-2019 23:54:00,0,4177.0,2792.0,0.669,19.548,437,236,186,50,201,156,45,102,0.0,0.0
1012,2529,26-09-2019 23:56:00,0,3986.0,2675.0,0.671,18.669,792,400,316,84,392,316,76,16,0.0,0.0
1012,2530,26-09-2019 23:58:00,0,4180.0,2837.0,0.679,19.612,732,336,253,83,396,325,71,8,0.0,0.0
1012,2531,27-09-2019 00:00:00,0,4179.0,2797.0,0.669,19.563,490,237,185,52,253,199,54,139,0.0,0.0
1012,2532,27-09-2019 00:02:00,0,4207.0,2714.0,0.645,19.579,347,164,122,42,183,132,51,69,0.0,0.0
1012,2533,27-09-2019 00:04:00,0,4228.0,2740.0,0.648,19.692,368,139,107,32,229,178,51,16,0.08,0.0
1012,2534,27-09-2019 00:06:00,0,3860.0,2609.0,0.676,18.098,254,132,101,31,122,77,45,69,0.0,0.0
1012,2535,27-09-2019 00:08:00,0,3898.0,2555.0,0.655,18.189,662,279,216,63,383,299,84,62,0.0,0.0
1012,2536,27-09-2019 00:10:00,0,4001.0,2674.0,0.668,18.728,234,88,61,27,146,98,48,28,0.0,0.0
1012,2537,27-09-2019 00:12:00,0,3799.0,2422.0,0.638,17.649,276,131,100,31,145,98,47,34,0.0,0.0
1012,2538,27-09-2019 00:14:00,0,4209.0,2712.0,0.644,19.587,659,315,241,74,344,269,75,14,0.0,0.0
1012,2539,27-09-2019 00:16:00,0,4288.0,2883.0,0.672,20.088,459,209,153,56,250,181,69,13,0.0,0.0
1012,2540,27-09-2019 00:18:00,0,3883.0,2600.0,0.669,18.179,148,54,31,23,94,58,36,38,0.0,0.0
1012,2541,27-09-2019 00:20:00,0,3964.0,2651.0,0.669,18.553,395,152,106,46,243,185,58,18,0.0,0.0
1012,2542,27-09-2019 00:22:00,0,3867.0,2644.0,0.684,18.164,440,227,168,59,213,157,56,54,0.0,0.0
1012,2543,27-09-2019 00:24:00,0,3975.0,2673.0,0.672,18.624,555,280,212,68,275,216,59,101,0.0,0.0
1012,2544,27-09-2019 00:26:00,0,3918.0,2659.0,0.6785,18.383,290,161,124,37,129,102,27,100,0.0,0.0
1012,2545,27-09-2019 00:28:00,0,3861.0,2645.0,0.685,18.142,258,159,121,38,99,83,16,108,0.0,0.0
1012,2546,27-09-2019 00:30:00,0,3875.0,2594.0,0.669,18.139,318,197,150,47,121,91,30,24,0.0,0.0
1012,2547,27-09-2019 00:32:00,0,3892.0,2591.0,0.666,18.203,337,203,157,46,134,104,30,88,0.0,0.0
1012,2548,27-09-2019 00:34:00,0,4198.0,2700.0,0.643,19.53,316,187,153,34,129,97,32,101,0.0,0.0
1012,2549,27-09-2019 00:36:00,0,3992.0,2679.0,0.671,18.694,254,140,100,40,114,84,30,32,0.0,0.0
1012,2550,27-09-2019 00:38:00,0,3786.0,2452.0,0.648,17.632,411,282,223,59,129,97,32,92,0.0,0.0
1012,2551,27-09-2019 00:40:00,0,4169.0,2819.0,0.676,19.548,432,178,133,45,254,201,53,1,0.0,0.0
1012,2552,27-09-2019 00:42:00,0,4214.0,2685.0,0.637,19.579,173,93,66,27,80,42,38,36,0.0,0.0
1012,2553,27-09-2019 00:44:00,0,3893.0,2544.0,0.653,18.157,307,179,133,46,128,101,27,67,0.01,0.0
1012,2554,27-09-2019 00:46:00,0,3804.0,2448.0,0.644,17.697,191,104,71,33,87,66,21,35,0.0,0.0
1012,2555,27-09-2019 00:48:00,0,3978.0,2624.0,0.659,18.581,81,29,17,12,52,27,25,1,0.0,0.0
1012,2556,27-09-2019 00:50:00,0,4001.0,2618.0,0.654,18.663,246,119,89,30,127,94,33,8,0.0,0.0
1012,2557,27-09-2019 00:52:00,0,3483.0,2258.0,0.648,16.224,68,15,2,13,53,31,22,19,0.0,0.0
1012,2558,27-09-2019 00:54:00,0,3285.0,2127.0,0.647,15.299,72,17,10,7,55,33,22,22,0.0,0.0
1012,2559,27-09-2019 00:56:00,0,3775.0,2436.0,0.645,17.571,111,57,34,23,54,29,25,5,0.0,0.0
1012,2560,27-09-2019 00:58:00,0,3909.0,2507.0,0.641,18.176,168,109,76,33,59,43,16,35,0.0,0.0
1012,2561,27-09-2019 01:00:00,0,3899.0,2528.0,0.648,18.162,459,237,176,61,222,172,50,16,0.0,0.0
1012,2562,27-09-2019 01:02:00,0,3889.0,2549.0,0.655,18.148,255,144,109,35,111,71,40,31,0.0,0.0
1012,2563,27-09-2019 01:04:00,0,3168.0,2105.0,0.664,14.813,182,117,84,33,65,38,27,37,0.0,0.0
1012,2564,27-09-2019 01:06:00,0,3698.0,2388.0,0.646,17.213,349,165,123,42,184,123,61,25,0.0,0.0
1012,2565,27-09-2019 01:08:00,0,3694.0,2403.0,0.651,17.216,213,85,58,27,128,78,50,37,0.05,0.0
1012,2566,27-09-2019 01:10:00,0,3482.0,2269.0,0.652,16.232,434,226,175,51,208,160,48,74,0.0,0.0
1012,2567,27-09-2019 01:12:00,0,3924.0,2497.0,0.636,18.226,248,105,69,36,143,94,49,0,0.0,0.0
1012,2568,27-09-2019 01:14:00,0,3495.0,2251.0,0.644,16.262,183,45,23,22,138,80,58,0,0.0,0.0
1012,2569,27-09-2019 01:16:00,0,3489.0,2278.0,0.653,16.268,111,35,18,17,76,36,40,6,0.0,0.0
1012,2570,27-09-2019 01:18:00,0,3501.0,2231.0,0.637,16.265,205,42,35,7,163,113,50,0,0.0,0.0
1012,2571,27-09-2019 01:20:00,0,3269.0,2195.0,0.671,15.309,387,217,175,42,170,133,37,117,0.0,0.0
1012,2572,27-09-2019 01:22:00,0,3472.0,2229.0,0.642,16.149,211,77,48,29,134,85,49,7,0.0,0.0
1012,2573,27-09-2019 01:24:00,0,3176.0,2076.0,0.654,14.813,87,46,16,30,41,11,30,1,0.0,0.0
1012,2574,27-09-2019 01:26:00,0,3178.0,2080.0,0.655,14.824,122,43,17,26,79,36,43,0,0.0,0.0
1012,2575,27-09-2019 01:28:00,0,3133.0,2192.0,0.7,14.773,178,85,61,24,93,47,46,0,0.0,0.0
1012,2576,27-09-2019 01:30:00,0,3178.0,2103.0,0.662,14.852,140,31,4,27,109,56,53,0,0.0,0.0
1012,2577,27-09-2019 01:32:00,0,3182.0,2078.0,0.653,14.837,473,221,166,55,252,203,49,43,0.0,0.0
1012,2578,27-09-2019 01:34:00,0,3337.0,2138.0,0.6415,15.515,327,167,122,45,160,123,37,3,0.0,0.0
1012,2579,27-09-2019 01:36:00,0,3492.0,2198.0,0.63,16.193,483,187,132,55,296,230,66,4,0.0,0.0
1012,2580,27-09-2019 01:38:00,0,3480.0,2252.0,0.647,16.206,438,254,181,73,184,134,50,5,0.0,0.0
1012,2581,27-09-2019 01:40:00,0,3499.0,2186.0,0.625,16.208,464,188,137,51,276,214,62,5,0.0,0.0
1012,2582,27-09-2019 01:42:00,0,3586.0,2339.0,0.652,16.718,429,209,153,56,220,171,49,13,0.0,0.0
1012,2583,27-09-2019 01:44:00,0,3192.0,2051.0,0.643,14.849,212,60,39,21,152,99,53,0,0.0,0.0
1012,2584,27-09-2019 01:46:00,0,2991.0,1862.0,0.622,13.847,145,35,13,22,110,67,43,0,0.0,0.0
1012,2585,27-09-2019 01:48:00,0,3189.0,2028.0,0.636,14.81,83,20,6,14,63,26,37,0,0.0,0.0
1012,2586,27-09-2019 01:50:00,0,2980.0,1923.0,0.645,13.87,50,18,2,16,32,0,32,0,0.0,0.0
1012,2587,27-09-2019 01:52:00,0,2982.0,1851.0,0.621,13.797,26,2,0,2,24,0,24,0,0.0,0.0
1012,2588,27-09-2019 01:54:00,0,3008.0,1780.0,0.592,13.824,31,2,0,2,29,0,29,0,0.0,0.0
1012,2589,27-09-2019 01:56:00,0,2662.0,1705.0,0.641,12.377,31,2,0,2,29,0,29,0,0.0,0.0
1012,2590,27-09-2019 01:58:00,0,2689.0,1641.0,0.61,12.414,29,1,0,1,28,0,28,0,0.0,0.0
1012,2591,27-09-2019 02:00:00,0,2604.0,1532.0,0.588,11.957,29,0,0,0,29,0,29,0,0.0,0.0
1012,2592,27-09-2019 02:02:00,0,2493.0,1482.0,0.594,11.464,51,15,7,8,36,7,29,0,0.0,0.0
1012,2593,27-09-2019 02:04:00,0,2482.0,1500.0,0.604,11.442,296,153,108,45,143,104,39,49,0.0,0.0
1012,2594,27-09-2019 02:06:00,0,2692.0,1654.0,0.614,12.44,381,205,151,54,176,127,49,47,0.0,0.0
1012,2595,27-09-2019 02:08:00,0,2942.0,1832.5,0.622,13.6215,328,132,96,36,196,151,45,35,0.0,0.0
1012,2596,27-09-2019 02:10:00,0,3192.0,2011.0,0.63,14.803,146,34,22,12,112,71,41,0,0.0,0.0
1012,2597,27-09-2019 02:12:00,0,2995.0,1900.0,0.634,13.906,526,242,183,59,284,210,74,7,0.0,0.0
1012,2598,27-09-2019 02:14:00,0,3170.0,2061.0,0.65,14.772,424,173,121,52,251,201,50,11,0.0,0.0
1012,2599,27-09-2019 02:16:00,0,3156.0,2110.0,0.668,14.772,551,274,219,55,277,220,57,9,0.0,0.0
1012,2600,27-09-2019 02:18:00,0,3181.0,2009.0,0.632,14.757,364,187,147,40,177,136,41,89,0.0,0.0
1012,2601,27-09-2019 02:20:00,0,3162.0,2107.0,0.666,14.79,224,58,44,14,166,114,52,24,0.0,0.0
1012,2602,27-09-2019 02:22:00,0,2967.0,1963.0,0.662,13.862,481,224,166,58,257,201,56,112,0.0,0.0
1012,2603,27-09-2019 02:24:00,0,3184.0,2011.0,0.632,14.774,476,206,156,50,270,219,51,84,0.0,0.0
1012,2604,27-09-2019 02:26:00,0,3680.0,2429.0,0.66,17.188,623,269,203,66,354,277,77,12,0.0,0.0
1012,2605,27-09-2019 02:28:00,0,3708.0,2353.0,0.635,17.217,396,198,143,55,198,141,57,6,0.0,0.0
1012,2606,27-09-2019 02:30:00,0,3282.0,2134.0,0.65,15.295,258,123,85,38,135,91,44,68,0.0,0.0
1012,2607,27-09-2019 02:32:00,0,2974.0,1906.0,0.641,13.827,117,58,21,37,59,22,37,0,0.0,0.0
1012,2608,27-09-2019 02:34:00,0,3290.0,2148.0,0.653,15.34,156,61,32,29,95,51,44,0,0.0,0.0
1012,2609,27-09-2019 02:36:00,0,3478.0,2214.0,0.636,16.156,275,123,79,44,152,98,54,14,0.0,0.0
1012,2610,27-09-2019 02:38:00,0,3505.0,2221.0,0.634,16.268,477,259,202,57,218,168,50,164,0.03,0.0
1012,2611,27-09-2019 02:40:00,0,3894.0,2515.0,0.646,18.128,438,206,159,47,232,173,59,27,0.0,0.0
1012,2612,27-09-2019 02:42:00,0,3684.0,2390.0,0.649,17.1615,324,180,129,51,144,109,35,107,0.01,0.0
1012,2613,27-09-2019 02:44:00,0,3474.0,2265.0,0.652,16.195,282,138,111,27,144,101,43,79,0.02,0.0
1012,2614,27-09-2019 02:46:00,0,3387.0,2179.0,0.643,15.758,129,43,18,25,86,41,45,3,0.0,0.0
1012,2615,27-09-2019 02:48:00,0,3497.0,2238.0,0.64,16.257,130,59,33,26,71,40,31,26,0.0,0.0
1012,2616,27-09-2019 02:50:00,0,3515.0,2213.0,0.63,16.301,359,158,111,47,201,144,57,32,0.02,0.0
1012,2617,27-09-2019 02:52:00,0,3708.0,2325.0,0.627,17.184,260,115,94,21,145,107,38,15,0.0,0.0
1012,2618,27-09-2019 02:54:00,0,3477.0,2253.0,0.648,16.195,182,53,29,24,129,74,55,0,0.0,0.0
1012,2619,27-09-2019 02:56:00,0,3182.0,2083.0,0.655,14.845,222,114,83,31,108,75,33,61,0.0,0.0
1012,2620,27-09-2019 02:58:00,0,3163.0,2137.0,0.676,14.829,70,37,21,16,33,19,14,10,0.0,0.0
1012,2621,27-09-2019 03:00:00,0,3162.0,2123.0,0.671,14.811,7,2,1,1,5,3,2,0,0.0,0.0
1012,2622,27-09-2019 03:02:00,0,3270.0,2138.0,0.654,15.249,18,17,0,17,1,0,1,0,0.0,0.0
1012,2623,27-09-2019 03:04:00,0,3192.0,2006.0,0.629,14.797,11,4,0,4,7,1,6,0,0.0,0.0
1012,2624,27-09-2019 03:06:00,0,3091.0,1937.0,0.627,14.324,46,28,21,7,18,9,9,0,0.0,0.0
1012,2625,27-09-2019 03:08:00,0,3006.0,1813.0,0.603,13.852,9,9,1,8,0,0,0,0,0.0,0.0
1012,2626,27-09-2019 03:10:00,0,2799.0,1697.0,0.606,12.909,3,2,0,2,1,0,1,0,0.0,0.0
1012,2627,27-09-2019 03:12:00,0,2698.0,1621.0,0.601,12.423,0,0,0,0,0,0,0,0,0.0,0.0
1012,2628,27-09-2019 03:14:00,0,2474.0,1535.0,0.621,11.448,4,0,0,0,4,2,2,0,0.0,0.0
1012,2629,27-09-2019 03:16:00,0,2378.5,1465.0,0.616,10.993,2,0,0,0,2,0,2,0,0.0,0.0
1012,2630,27-09-2019 03:18:00,0,2283.0,1395.0,0.611,10.538,9,0,0,0,9,0,9,0,0.0,0.0
1012,2631,27-09-2019 03:20:00,0,2175.0,1300.0,0.598,10.008,0,0,0,0,0,0,0,0,0.0,0.0
1012,2632,27-09-2019 03:22:00,0,2070.0,1237.0,0.597,9.528,9,1,1,0,8,0,8,0,0.0,0.0
1012,2633,27-09-2019 03:24:00,0,2061.0,1274.0,0.618,9.531,1,0,0,0,1,0,1,0,0.0,0.0
1012,2634,27-09-2019 03:26:00,0,1951.0,1251.0,0.641,9.072,1,0,0,0,1,0,1,0,0.0,0.0
1012,2635,27-09-2019 03:28:00,0,1968.0,1216.0,0.618,9.101,3,1,0,1,2,0,2,0,0.0,0.0
1012,2636,27-09-2019 03:30:00,0,1958.0,1178.0,0.602,9.017,3,0,0,0,3,0,3,0,0.0,0.0
1012,2637,27-09-2019 03:32:00,0,1970.0,1153.0,0.585,9.039,0,0,0,0,0,0,0,0,0.0,0.0
1012,2638,27-09-2019 03:34:00,0,1980.0,1175.0,0.593,9.103,1,0,0,0,1,0,1,0,0.0,0.0
1012,2639,27-09-2019 03:36:00,0,1981.0,1155.0,0.583,9.083,2,0,0,0,2,0,2,0,0.0,0.0
1012,2640,27-09-2019 03:38:00,0,1978.0,1158.0,0.585,9.076,2,0,0,0,2,0,2,0,0.0,0.0
1012,2641,27-09-2019 03:40:00,0,1985.0,1107.0,0.558,9.049,2,0,0,0,2,0,2,0,0.0,0.0
1012,2642,27-09-2019 03:42:00,0,1880.0,1095.0,0.582,8.62,2,0,0,0,2,0,2,0,0.0,0.0
1012,2643,27-09-2019 03:44:00,0,1873.0,1089.0,0.582,8.586,5,2,0,2,3,0,3,0,0.0,0.0
1012,2644,27-09-2019 03:46:00,0,1872.0,1087.0,0.581,8.578,2,0,0,0,2,0,2,0,0.0,0.0
1012,2645,27-09-2019 03:48:00,0,1763.0,1074.0,0.61,8.134,1,0,0,0,1,0,1,0,0.0,0.0
1012,2646,27-09-2019 03:50:00,0,1767.5,1050.0,0.5945,8.126,1,0,0,0,1,0,1,0,0.0,0.0
1012,2647,27-09-2019 03:52:00,0,1772.0,1026.0,0.579,8.118,0,0,0,0,0,0,0,0,0.0,0.0
1012,2648,27-09-2019 03:54:00,0,1773.0,1024.0,0.577,8.12,8,2,0,2,6,2,4,0,0.0,0.0
1012,2649,27-09-2019 03:56:00,0,1751.0,1095.0,0.625,8.112,0,0,0,0,0,0,0,0,0.0,0.0
1012,2650,27-09-2019 03:58:00,0,1870.0,1095.0,0.586,8.58,0,0,0,0,0,0,0,0,0.0,0.0
1012,2651,27-09-2019 04:00:00,0,1985.0,1110.0,0.559,9.049,0,0,0,0,0,0,0,0,0.0,0.0
1012,2652,27-09-2019 04:02:00,0,1991.0,1120.0,0.562,9.085,0,0,0,0,0,0,0,0,0.0,0.0
1012,2653,27-09-2019 04:04:00,0,1986.0,1129.0,0.569,9.074,0,0,0,0,0,0,0,0,0.0,0.0
1012,2654,27-09-2019 04:06:00,0,1977.0,1135.0,0.574,9.047,0,0,0,0,0,0,0,0,0.0,0.0
1012,2655,27-09-2019 04:08:00,0,1975.0,1139.0,0.577,9.042,83,33,10,23,50,25,25,0,0.0,0.0
1012,2656,27-09-2019 04:10:00,0,2165.0,1316.0,0.608,9.987,252,152,107,45,100,73,27,56,0.0,0.0
1012,2657,27-09-2019 04:12:00,0,2792.0,1724.0,0.618,12.911,149,95,72,23,54,32,22,47,0.0,0.0
1012,2658,27-09-2019 04:14:00,0,2780.0,1752.0,0.63,12.892,335,170,132,38,165,118,47,58,0.03,0.0
1012,2659,27-09-2019 04:16:00,0,3011.0,1831.0,0.608,13.892,334,178,134,44,156,116,40,73,0.0,0.0
1012,2660,27-09-2019 04:18:00,0,3211.0,1932.0,0.602,14.79,183,87,62,25,96,61,35,39,0.0,0.0
1012,2661,27-09-2019 04:20:00,0,3491.0,2161.0,0.619,16.148,355,169,134,35,186,145,41,139,0.0,0.0
1012,2662,27-09-2019 04:22:00,0,3518.0,2211.0,0.629,16.309,175,83,62,21,92,49,43,19,0.03,0.0
1012,2663,27-09-2019 04:24:00,0,3612.0,2271.5,0.629,16.7475,409,222,177,45,187,136,51,70,0.0,0.0
1012,2664,27-09-2019 04:26:00,0,3706.0,2332.0,0.629,17.186,275,156,118,38,119,83,36,97,0.0,0.0
1012,2665,27-09-2019 04:28:00,0,3888.0,2593.0,0.667,18.192,504,207,153,54,297,221,76,42,0.0,0.0
1012,2666,27-09-2019 04:30:00,0,3871.0,2552.0,0.659,18.079,203,87,53,34,116,71,45,21,0.0,0.0
1012,2667,27-09-2019 04:32:00,0,3922.0,2463.0,0.628,18.18,208,127,101,26,81,62,19,101,0.0,0.0
1012,2668,27-09-2019 04:34:00,0,4161.0,2869.0,0.689,19.572,343,199,156,43,144,111,33,55,0.0,0.0
1012,2669,27-09-2019 04:36:00,0,3894.0,2562.0,0.658,18.182,290,147,110,37,143,105,38,94,0.0,0.0
1012,2670,27-09-2019 04:38:00,0,3902.0,2490.0,0.638,18.13,248,129,92,37,119,85,34,60,0.04,0.0
1012,2671,27-09-2019 04:40:00,0,3722.0,2291.0,0.616,17.204,106,74,35,39,32,7,25,9,0.0,0.0
1012,2672,27-09-2019 04:42:00,0,3703.0,2372.0,0.641,17.217,480,297,229,68,183,131,52,91,0.0,0.0
1012,2673,27-09-2019 04:44:00,0,3884.0,2515.0,0.648,18.091,230,109,69,40,121,90,31,18,0.0,0.0
1012,2674,27-09-2019 04:46:00,0,3903.0,2518.0,0.645,18.168,198,126,94,32,72,59,13,95,0.0,0.0
1012,2675,27-09-2019 04:48:00,0,3909.0,2466.0,0.631,18.134,316,159,125,34,157,120,37,33,0.0,0.0
1012,2676,27-09-2019 04:50:00,0,3489.0,2245.0,0.643,16.232,161,62,34,28,99,59,40,7,0.0,0.0
1012,2677,27-09-2019 04:52:00,0,3495.0,2290.0,0.655,16.308,168,76,53,23,92,66,26,26,0.0,0.0
1012,2678,27-09-2019 04:54:00,0,3600.0,2237.0,0.622,16.662,424,211,166,45,213,163,50,6,0.0,0.0
1012,2679,27-09-2019 04:56:00,0,3499.0,2171.0,0.62,16.191,77,25,7,18,52,17,35,0,0.0,0.0
1012,2680,27-09-2019 04:58:00,0,3348.5,2056.5,0.6135,15.4705,90,29,2,27,61,31,30,0,0.0,0.0
1012,2681,27-09-2019 05:00:00,0,3198.0,1942.0,0.607,14.75,39,7,1,6,32,4,28,0,0.0,0.0
1012,2682,27-09-2019 05:02:00,0,3110.0,1886.0,0.607,14.341,49,0,0,0,49,18,31,0,0.0,0.0
1012,2683,27-09-2019 05:04:00,0,3021.0,1792.0,0.593,13.887,39,1,0,1,38,2,36,0,0.0,0.0
1012,2684,27-09-2019 05:06:00,0,2904.0,1715.0,0.59,13.342,26,0,0,0,26,0,26,0,0.0,0.0
1012,2685,27-09-2019 05:08:00,0,2697.0,1657.0,0.614,12.46,25,0,0,0,25,2,23,0,0.0,0.0
1012,2686,27-09-2019 05:10:00,0,2709.0,1591.0,0.587,12.435,23,0,0,0,23,0,23,0,0.0,0.0
1012,2687,27-09-2019 05:12:00,0,2489.0,1495.0,0.601,11.462,25,0,0,0,25,0,25,0,0.0,0.0
1012,2688,27-09-2019 05:14:00,0,2387.0,1414.0,0.592,10.969,23,0,0,0,23,0,23,0,0.0,0.0
1012,2689,27-09-2019 05:16:00,0,2525.0,1372.0,0.543,11.47,28,0,0,0,28,0,28,0,0.0,0.0
1012,2690,27-09-2019 05:18:00,0,2427.0,1313.0,0.541,11.016,33,0,0,0,33,0,33,0,0.0,0.0
1012,2691,27-09-2019 05:20:00,0,2313.0,1231.0,0.532,10.479,28,2,1,1,26,0,26,0,0.0,0.0
1012,2692,27-09-2019 05:22:00,0,2326.0,1194.0,0.513,10.488,28,0,0,0,28,0,28,0,0.0,0.0
1012,2693,27-09-2019 05:24:00,0,2334.0,1148.0,0.492,10.467,23,1,0,1,22,0,22,0,0.0,0.0
1012,2694,27-09-2019 05:26:00,0,2224.0,1108.0,0.498,9.989,29,1,0,1,28,0,28,0,0.0,0.0
1012,2695,27-09-2019 05:28:00,0,2127.0,1073.0,0.505,9.568,36,8,0,8,28,0,28,0,0.0,0.0
1012,2696,27-09-2019 05:30:00,0,2007.0,1045.0,0.521,9.064,34,2,0,2,32,0,32,0,0.0,0.0
1012,2697,27-09-2019 05:32:00,0,1993.0,1092.5,0.5485,9.062,119,47,27,20,72,30,42,0,0.0,0.0
1012,2698,27-09-2019 05:34:00,0,1979.0,1140.0,0.576,9.06,218,80,49,31,138,91,47,54,0.0,0.0
1012,2699,27-09-2019 05:36:00,0,2071.0,1256.0,0.607,9.55,267,168,128,40,99,74,25,97,0.0,0.0
1012,2700,27-09-2019 05:38:00,0,2264.0,1399.0,0.618,10.471,253,129,96,33,124,83,41,47,0.0,0.0
1012,2701,27-09-2019 05:40:00,0,2595.0,1573.0,0.606,11.968,70,12,8,4,58,25,33,2,0.0,0.0
1012,2702,27-09-2019 05:42:00,0,2803.0,1650.0,0.589,12.871,406,255,203,52,151,123,28,133,0.01,0.0
1012,2703,27-09-2019 05:44:00,0,3729.0,2251.0,0.604,17.188,176,79,57,22,97,66,31,18,0.0,0.0
1012,2704,27-09-2019 05:46:00,0,3508.0,2239.0,0.638,16.301,178,80,59,21,98,64,34,28,0.0,0.0
1012,2705,27-09-2019 05:48:00,0,3508.0,2137.0,0.609,16.188,282,130,99,31,152,107,45,9,0.0,0.0
1012,2706,27-09-2019 05:50:00,0,3328.0,1984.0,0.596,15.31,266,161,131,30,105,79,26,145,0.0,0.0
1012,2707,27-09-2019 05:52:00,0,3729.0,2292.0,0.615,17.229,77,47,26,21,30,19,11,4,0.0,0.0
1012,2708,27-09-2019 05:54:00,0,3503.0,2147.0,0.613,16.178,193,87,65,22,106,80,26,29,0.0,0.0
1012,2709,27-09-2019 05:56:00,0,3109.0,1911.0,0.615,14.366,152,82,62,20,70,42,28,4,0.0,0.0
1012,2710,27-09-2019 05:58:00,0,3262.0,2079.0,0.637,15.155,344,196,149,47,148,106,42,62,0.0,0.0
1012,2711,27-09-2019 06:00:00,1,3412.0,2106.0,0.617,15.776,446,244,184,60,202,150,52,32,0.0,0.0
1012,2712,27-09-2019 06:02:00,1,3300.0,2098.0,0.636,15.326,196,86,58,28,110,69,41,82,0.0,0.02
1012,2713,27-09-2019 06:04:00,1,3735.0,2258.0,0.605,17.219,102,31,21,10,71,31,40,41,0.0,0.07
1012,2714,27-09-2019 06:06:00,1,3884.5,2385.0,0.614,17.948,242,135,96,39,107,74,33,78,0.0,0.02
1012,2715,27-09-2019 06:08:00,1,4034.0,2512.0,0.623,18.677,132,45,22,23,87,49,38,64,0.0,0.0
1012,2716,27-09-2019 06:10:00,1,4102.0,2683.0,0.654,19.135,94,24,14,10,70,32,38,54,0.0,0.11
1012,2717,27-09-2019 06:12:00,1,4190.0,2759.0,0.659,19.565,152,40,24,16,112,61,51,62,0.0,0.0
1012,2718,27-09-2019 06:14:00,1,4381.0,2941.0,0.671,20.519,200,22,9,13,178,111,67,50,0.0,0.11
1012,2719,27-09-2019 06:16:00,1,4157.0,2886.0,0.694,19.575,231,24,8,16,207,118,89,34,0.0,0.05
1012,2720,27-09-2019 06:18:00,1,4250.0,3009.0,0.708,20.078,184,11,3,8,173,114,59,30,0.0,0.09
1012,2721,27-09-2019 06:20:00,1,4352.0,3086.0,0.709,20.567,265,77,53,24,188,115,73,42,0.0,0.38
1012,2722,27-09-2019 06:22:00,1,3651.0,2519.0,0.69,17.174,95,18,3,15,77,41,36,0,0.0,0.0
1012,2723,27-09-2019 06:24:00,1,3353.0,2261.0,0.674,15.713,235,69,49,20,166,108,58,19,0.01,0.0
1012,2724,27-09-2019 06:26:00,1,4105.0,3145.0,0.766,19.658,298,128,94,34,170,114,56,41,0.41,0.0
1012,2725,27-09-2019 06:28:00,1,4432.0,3193.0,0.72,20.997,161,37,30,7,124,68,56,0,0.0,0.01
1012,2726,27-09-2019 06:30:00,1,4436.0,3246.0,0.732,21.07,50,0,0,0,50,10,40,0,0.0,0.0
1012,2727,27-09-2019 06:32:00,1,4396.0,3279.0,0.746,20.952,118,27,15,12,91,43,48,2,0.18,0.0
1012,2728,27-09-2019 06:34:00,1,4402.0,3271.0,0.743,20.967,147,30,18,12,117,72,45,0,0.03,0.0
1012,2729,27-09-2019 06:36:00,1,4202.0,3253.0,0.774,20.157,239,119,88,31,120,75,45,42,0.06,0.0
1012,2730,27-09-2019 06:38:00,1,4193.0,3219.0,0.768,20.083,105,13,3,10,92,51,41,2,0.01,0.0
1012,2731,27-09-2019 06:40:00,1,3893.0,2988.5,0.768,18.646,208,66,44,22,142,95,47,55,0.13,0.01
1012,2732,27-09-2019 06:42:00,1,3593.0,2758.0,0.768,17.209,161,52,30,22,109,65,44,17,0.0,0.0
1012,2733,27-09-2019 06:44:00,1,3920.0,2903.0,0.74,18.661,248,88,61,27,160,107,53,16,0.05,0.05
1012,2734,27-09-2019 06:46:00,1,3796.0,2880.0,0.759,18.145,188,58,37,21,130,80,50,10,0.0,0.03
1012,2735,27-09-2019 06:48:00,1,4420.0,3312.0,0.749,21.083,268,84,58,26,184,122,62,46,0.01,0.0
1012,2736,27-09-2019 06:50:00,1,4367.0,3394.0,0.777,20.963,294,111,81,30,183,125,58,23,0.04,0.02
1012,2737,27-09-2019 06:52:00,1,3980.0,3115.0,0.783,19.129,185,62,35,27,123,81,42,33,0.0,0.0
1012,2738,27-09-2019 06:54:00,1,4569.0,3632.0,0.795,22.021,212,36,19,17,176,114,62,42,0.0,0.0
1012,2739,27-09-2019 06:56:00,1,4758.0,3857.0,0.811,23.015,206,36,15,21,170,106,64,35,0.1,0.0
1012,2740,27-09-2019 06:58:00,1,4370.0,3508.0,0.803,21.103,352,172,129,43,180,134,46,27,0.06,0.0
1012,2741,27-09-2019 07:00:00,1,4360.0,3555.0,0.815,21.116,230,58,27,31,172,116,56,46,0.01,0.0
1012,2742,27-09-2019 07:02:00,1,4534.0,3677.0,0.811,21.933,181,88,48,40,93,49,44,45,0.0,0.03
1012,2743,27-09-2019 07:04:00,1,4331.0,3592.0,0.829,21.042,159,40,16,24,119,78,41,40,0.0,0.0
1012,2744,27-09-2019 07:06:00,1,4624.0,3827.0,0.828,22.456,87,17,5,12,70,38,32,8,0.0,0.05
1012,2745,27-09-2019 07:08:00,1,4461.0,3618.0,0.811,21.581,420,164,124,40,256,206,50,20,0.09,0.08
1012,2746,27-09-2019 07:10:00,1,4342.0,3563.0,0.821,21.051,629,291,219,72,338,257,81,42,0.02,0.0
1012,2747,27-09-2019 07:12:00,1,3881.0,3089.0,0.796,18.713,670,337,275,62,333,259,74,0,0.03,0.0
1012,2748,27-09-2019 07:14:00,1,3633.0,2855.0,0.785,17.4755,211,21,5,16,190,148,42,0,0.0,0.0
1012,2749,27-09-2019 07:16:00,1,3385.0,2621.0,0.774,16.238,205,21,7,14,184,117,67,0,0.0,0.0
1012,2750,27-09-2019 07:18:00,1,3631.0,2668.0,0.735,17.26,49,0,0,0,49,10,39,0,0.0,0.0
1012,2751,27-09-2019 07:20:00,1,3624.0,2717.0,0.75,17.288,139,0,0,0,139,98,41,0,0.0,0.0
1012,2752,27-09-2019 07:22:00,1,3594.0,2742.0,0.763,17.195,152,3,0,3,149,87,62,0,0.0,0.0
1012,2753,27-09-2019 07:24:00,1,3602.0,2694.0,0.748,17.173,156,2,0,2,154,99,55,0,0.0,0.0
1012,2754,27-09-2019 07:26:00,1,3606.0,2748.0,0.762,17.252,79,0,0,0,79,31,48,0,0.0,0.0
1012,2755,27-09-2019 07:28:00,1,3599.0,2743.0,0.762,17.216,92,9,6,3,83,36,47,0,0.0,0.0
1012,2756,27-09-2019 07:30:00,1,3597.0,2722.0,0.757,17.187,53,0,0,0,53,10,43,0,0.0,0.0
1012,2757,27-09-2019 07:32:00,1,3626.0,2645.0,0.729,17.214,49,0,0,0,49,8,41,0,0.0,0.0
1012,2758,27-09-2019 07:34:00,1,3384.0,2594.0,0.767,16.204,68,2,0,2,66,24,42,0,0.0,0.0
1012,2759,27-09-2019 07:36:00,1,3415.0,2513.0,0.736,16.238,48,1,0,1,47,0,47,0,0.0,0.0
1012,2760,27-09-2019 07:38:00,1,3444.0,2456.0,0.713,16.288,46,0,0,0,46,0,46,0,0.0,0.0
1012,2761,27-09-2019 07:40:00,1,3212.0,2416.0,0.752,15.33,43,4,0,4,39,0,39,0,0.0,0.0
1012,2762,27-09-2019 07:42:00,1,3203.0,2469.0,0.771,15.352,43,0,0,0,43,0,43,0,0.0,0.0
1012,2763,27-09-2019 07:44:00,1,3209.0,2425.0,0.756,15.327,46,0,0,0,46,0,46,0,0.0,0.0
1012,2764,27-09-2019 07:46:00,1,3204.0,2374.0,0.741,15.252,41,0,0,0,41,0,41,0,0.0,0.0
1012,2765,27-09-2019 07:48:00,1,3032.0,2361.0,0.781,14.5605,54,0,0,0,54,4,50,0,0.0,0.0
1012,2766,27-09-2019 07:50:00,1,2860.0,2348.0,0.821,13.869,77,13,2,11,64,16,48,0,0.0,0.0
1012,2767,27-09-2019 07:52:00,1,2533.0,2246.0,0.887,12.467,72,10,6,4,62,18,44,0,0.0,0.0
1012,2768,27-09-2019 07:54:00,1,2548.0,2139.0,0.839,12.409,48,1,0,1,47,0,47,0,0.0,0.0
1012,2769,27-09-2019 07:56:00,1,2562.0,2117.0,0.826,12.439,40,0,0,0,40,0,40,0,0.0,0.0
1012,2770,27-09-2019 07:58:00,1,2556.0,2127.0,0.832,12.424,44,1,0,1,43,0,43,0,0.0,0.0
1012,2771,27-09-2019 08:00:00,1,2558.0,2132.0,0.833,12.439,43,0,0,0,43,0,43,0,0.0,0.0
1012,2772,27-09-2019 08:02:00,1,2557.0,2151.0,0.841,12.456,52,2,0,2,50,2,48,0,0.0,0.0
1012,2773,27-09-2019 08:04:00,1,2563.0,2152.0,0.84,12.48,226,89,62,27,137,83,54,14,0.0,0.0
1012,2774,27-09-2019 08:06:00,1,2749.0,2324.0,0.845,13.405,223,80,49,31,143,97,46,46,0.0,0.0
1012,2775,27-09-2019 08:08:00,1,3154.0,2689.0,0.853,15.405,82,13,3,10,69,52,17,18,0.0,0.0
1012,2776,27-09-2019 08:10:00,1,3486.0,3146.0,0.903,17.216,23,10,1,9,13,12,1,4,0.0,0.0
1012,2777,27-09-2019 08:12:00,1,3663.0,3380.0,0.923,18.175,82,17,5,12,65,44,21,12,0.0,0.0
1012,2778,27-09-2019 08:14:00,1,3713.0,3260.0,0.878,18.239,214,78,37,41,136,104,32,12,0.03,0.01
1012,2779,27-09-2019 08:16:00,1,3983.0,3576.0,0.898,19.651,171,26,8,18,145,102,43,11,0.0,0.05
1012,2780,27-09-2019 08:18:00,1,3987.0,3532.0,0.886,19.621,147,33,9,24,114,82,32,12,0.0,0.06
1012,2781,27-09-2019 08:20:00,1,4002.0,3618.0,0.904,19.772,373,135,88,47,238,176,62,29,0.07,0.05
1012,2782,27-09-2019 08:22:00,1,3765.5,3302.5,0.875,18.491,176,100,61,39,76,42,34,25,0.01,0.0
1012,2783,27-09-2019 08:24:00,1,3529.0,2987.0,0.846,17.21,215,58,26,32,157,105,52,16,0.0,0.04
1012,2784,27-09-2019 08:26:00,1,4048.0,3439.0,0.849,19.758,213,19,7,12,194,125,69,16,0.0,0.04
1012,2785,27-09-2019 08:28:00,1,4095.0,3528.0,0.862,20.039,98,10,3,7,88,42,46,24,0.0,0.02
1012,2786,27-09-2019 08:30:00,1,4188.0,3646.0,0.871,20.535,373,130,93,37,243,172,71,20,0.16,0.02
1012,2787,27-09-2019 08:32:00,1,3927.0,3364.0,0.857,19.197,728,359,292,67,369,292,77,9,0.01,0.0
1012,2788,27-09-2019 08:34:00,1,3217.0,2808.0,0.873,15.783,604,302,244,58,302,221,81,9,0.03,0.08
1012,2789,27-09-2019 08:36:00,1,4114.0,3548.0,0.862,20.139,162,30,12,18,132,71,61,15,0.01,0.0
1012,2790,27-09-2019 08:38:00,1,4278.0,3743.0,0.875,20.998,199,70,42,28,129,83,46,23,0.0,0.0
1012,2791,27-09-2019 08:40:00,1,3694.0,3259.0,0.882,18.164,252,89,51,38,163,112,51,33,0.0,0.0
1012,2792,27-09-2019 08:42:00,1,3600.0,3179.0,0.883,17.705,610,293,226,67,317,242,75,3,0.04,0.03
1012,2793,27-09-2019 08:44:00,1,3244.0,2722.0,0.839,15.797,748,433,356,77,315,241,74,16,0.0,0.0
1012,2794,27-09-2019 08:46:00,1,3788.0,3364.0,0.888,18.65,432,204,144,60,228,159,69,0,0.04,0.01
1012,2795,27-09-2019 08:48:00,1,3204.0,2853.0,0.89,15.784,471,248,195,53,223,168,55,6,0.0,0.0
1012,2796,27-09-2019 08:50:00,1,3066.0,2528.0,0.825,14.879,23,21,6,15,2,1,1,1,0.01,0.0
1012,2797,27-09-2019 08:52:00,1,3218.0,2779.0,0.863,15.756,72,8,4,4,64,20,44,0,0.0,0.0
1012,2798,27-09-2019 08:54:00,1,3221.0,2820.0,0.876,15.813,38,0,0,0,38,1,37,0,0.0,0.0
1012,2799,27-09-2019 08:56:00,1,3230.0,2801.5,0.8675,15.828,33,0,0,0,33,0,33,0,0.0,0.0
1012,2800,27-09-2019 08:58:00,1,3239.0,2783.0,0.859,15.843,40,0,0,0,40,0,40,0,0.0,0.0
1012,2801,27-09-2019 09:00:00,1,3230.0,2779.0,0.86,15.805,27,0,0,0,27,0,27,0,0.0,0.0
1012,2802,27-09-2019 09:02:00,1,3245.0,2752.0,0.848,15.833,34,0,0,0,34,0,34,0,0.0,0.0
1012,2803,27-09-2019 09:04:00,1,3129.0,2679.0,0.856,15.294,32,0,0,0,32,0,32,0,0.0,0.0
1012,2804,27-09-2019 09:06:00,1,3029.0,2676.0,0.884,14.895,36,0,0,0,36,0,36,0,0.0,0.0
1012,2805,27-09-2019 09:08:00,1,3035.0,2586.0,0.852,14.821,59,4,1,3,55,10,45,0,0.0,0.0
1012,2806,27-09-2019 09:10:00,1,2938.0,2562.0,0.872,14.414,7,0,0,0,7,0,7,0,0.0,0.0
1012,2807,27-09-2019 09:12:00,1,2831.0,2489.0,0.879,13.912,2,0,0,0,2,1,1,0,0.0,0.0
1012,2808,27-09-2019 09:14:00,1,2846.0,2416.0,0.849,13.889,37,3,1,2,34,3,31,0,0.0,0.0
1012,2809,27-09-2019 09:16:00,1,2647.0,2278.0,0.861,12.95,34,0,0,0,34,0,34,0,0.0,0.0
1012,2810,27-09-2019 09:18:00,1,2529.0,2209.0,0.874,12.41,35,0,0,0,35,0,35,0,0.0,0.0
1012,2811,27-09-2019 09:20:00,1,2534.0,2215.0,0.874,12.434,60,3,0,3,57,14,43,0,0.0,0.0
1012,2812,27-09-2019 09:22:00,1,2531.0,2194.0,0.867,12.401,97,2,0,2,95,66,29,0,0.0,0.0
1012,2813,27-09-2019 09:24:00,1,2557.0,2148.0,0.84,12.451,141,2,0,2,139,112,27,0,0.0,0.0
1012,2814,27-09-2019 09:26:00,1,2549.0,2178.0,0.854,12.452,135,0,0,0,135,92,43,0,0.0,0.0
1012,2815,27-09-2019 09:28:00,1,2579.0,2082.0,0.807,12.466,59,0,0,0,59,23,36,0,0.0,0.0
1012,2816,27-09-2019 09:30:00,1,2457.0,2067.0,0.843,11.968,35,1,0,1,34,2,32,0,0.0,0.0
1012,2817,27-09-2019 09:32:00,1,2335.0,2052.0,0.879,11.47,99,2,0,2,97,66,31,0,0.0,0.0
1012,2818,27-09-2019 09:34:00,1,2332.0,2034.0,0.872,11.44,36,0,0,0,36,1,35,0,0.0,0.0
1012,2819,27-09-2019 09:36:00,1,2352.0,2050.0,0.872,11.535,221,58,44,14,163,99,64,0,0.0,0.0
1012,2820,27-09-2019 09:38:00,1,2344.0,2026.0,0.865,11.477,62,2,0,2,60,27,33,0,0.0,0.0
1012,2821,27-09-2019 09:40:00,1,2345.0,2044.0,0.872,11.504,43,0,0,0,43,2,41,0,0.0,0.0
1012,2822,27-09-2019 09:42:00,1,2360.0,1998.0,0.847,11.511,43,2,0,2,41,4,37,0,0.0,0.0
1012,2823,27-09-2019 09:44:00,1,2359.0,2018.0,0.855,11.53,46,0,0,0,46,0,46,0,0.0,0.0
1012,2824,27-09-2019 09:46:00,1,2351.0,1996.0,0.849,11.474,31,0,0,0,31,0,31,0,0.0,0.0
1012,2825,27-09-2019 09:48:00,1,2367.0,1934.0,0.817,11.467,56,8,2,6,48,11,37,0,0.0,0.0
1012,2826,27-09-2019 09:50:00,1,2352.0,2004.0,0.852,11.485,157,45,15,30,112,69,43,3,0.0,0.0
1012,2827,27-09-2019 09:52:00,1,2526.0,2227.0,0.882,12.419,166,56,26,30,110,61,49,4,0.0,0.0
1012,2828,27-09-2019 09:54:00,1,2506.0,2338.0,0.933,12.462,11,2,2,0,9,3,6,0,0.0,0.0
1012,2829,27-09-2019 09:56:00,1,2559.0,2205.0,0.862,12.526,2,0,0,0,2,1,1,0,0.01,0.0
1012,2830,27-09-2019 09:58:00,1,2570.0,2108.0,0.82,12.459,1,0,0,0,1,0,1,0,0.0,0.0
1012,2831,27-09-2019 10:00:00,1,2353.0,2031.0,0.863,11.519,0,0,0,0,0,0,0,0,0.0,0.0
1012,2832,27-09-2019 10:02:00,1,2344.0,2048.0,0.874,11.503,1,0,0,0,1,0,1,0,0.0,0.0
1012,2833,27-09-2019 10:04:00,1,2340.0,2051.5,0.877,11.4915,4,1,1,0,3,1,2,0,0.0,0.0
1012,2834,27-09-2019 10:06:00,1,2336.0,2055.0,0.88,11.48,5,0,0,0,5,1,4,0,0.0,0.0
1012,2835,27-09-2019 10:08:00,1,2335.0,2083.0,0.892,11.508,2,0,0,0,2,0,2,0,0.0,0.0
1012,2836,27-09-2019 10:10:00,1,2342.0,2045.0,0.873,11.489,15,0,0,0,15,1,14,0,0.0,0.0
1012,2837,27-09-2019 10:12:00,1,2351.0,2014.0,0.857,11.493,33,0,0,0,33,15,18,0,0.0,0.0
1012,2838,27-09-2019 10:14:00,1,2359.0,1989.0,0.843,11.496,94,24,13,11,70,51,19,13,0.0,0.0
1012,2839,27-09-2019 10:16:00,1,2528.0,2246.0,0.888,12.448,26,17,3,14,9,7,2,11,0.0,0.0
1012,2840,27-09-2019 10:18:00,1,3012.0,2641.0,0.877,14.791,26,9,2,7,17,8,9,1,0.0,0.04
1012,2841,27-09-2019 10:20:00,1,3506.0,3110.0,0.887,17.258,98,24,3,21,74,49,25,11,0.0,0.02
1012,2842,27-09-2019 10:22:00,1,3472.0,3183.0,0.917,17.204,142,19,4,15,123,78,45,11,0.0,0.06
1012,2843,27-09-2019 10:24:00,1,3472.0,3190.0,0.919,17.213,164,12,0,12,152,94,58,5,0.0,0.04
1012,2844,27-09-2019 10:26:00,1,3502.0,3202.0,0.914,17.343,199,14,2,12,185,120,65,4,0.0,0.07
1012,2845,27-09-2019 10:28:00,1,3486.0,3164.0,0.907,17.239,168,25,15,10,143,107,36,4,0.05,0.0
1012,2846,27-09-2019 10:30:00,1,2984.0,2738.0,0.917,14.787,353,126,92,34,227,170,57,51,0.01,0.01
1012,2847,27-09-2019 10:32:00,1,3246.0,2774.0,0.855,15.859,199,53,32,21,146,95,51,24,0.0,0.03
1012,2848,27-09-2019 10:34:00,1,3683.0,3288.0,0.893,18.152,138,16,5,11,122,96,26,10,0.0,0.03
1012,2849,27-09-2019 10:36:00,1,3779.0,3440.0,0.91,18.697,278,99,69,30,179,136,43,17,0.09,0.04
1012,2850,27-09-2019 10:38:00,1,3155.0,2837.0,0.8965,15.5705,45,20,1,19,25,0,25,0,0.01,0.0
1012,2851,27-09-2019 10:40:00,1,2531.0,2234.0,0.883,12.444,138,8,4,4,130,100,30,0,0.0,0.0
1012,2852,27-09-2019 10:42:00,1,2543.0,2228.0,0.876,12.487,44,3,2,1,41,2,39,0,0.0,0.0
1012,2853,27-09-2019 10:44:00,1,2867.0,2303.0,0.803,13.846,49,1,1,0,48,4,44,0,0.0,0.0
1012,2854,27-09-2019 10:46:00,1,2948.0,2500.0,0.848,14.381,67,5,0,5,62,17,45,0,0.0,0.0
1012,2855,27-09-2019 10:48:00,1,3045.0,2594.0,0.852,14.869,31,0,0,0,31,3,28,0,0.0,0.0
1012,2856,27-09-2019 10:50:00,1,3029.0,2581.0,0.852,14.792,59,0,0,0,59,12,47,0,0.01,0.01
1012,2857,27-09-2019 10:52:00,1,2930.0,2561.0,0.874,14.378,68,8,5,3,60,17,43,0,0.01,0.0
1012,2858,27-09-2019 10:54:00,1,3040.0,2567.0,0.844,14.821,187,60,49,11,127,72,55,0,0.06,0.0
1012,2859,27-09-2019 10:56:00,1,2918.0,2558.0,0.877,14.33,41,0,0,0,41,0,41,0,0.0,0.0
1012,2860,27-09-2019 10:58:00,1,2923.0,2533.0,0.867,14.32,68,1,0,1,67,23,44,0,0.0,0.0
1012,2861,27-09-2019 11:00:00,1,2819.0,2521.0,0.894,13.898,53,1,0,1,52,14,38,0,0.0,0.0
1012,2862,27-09-2019 11:02:00,1,2825.0,2480.0,0.878,13.875,104,36,26,10,68,28,40,0,0.0,0.0
1012,2863,27-09-2019 11:04:00,1,2835.0,2407.0,0.849,13.833,121,7,4,3,114,70,44,0,0.0,0.0
1012,2864,27-09-2019 11:06:00,1,2857.0,2375.0,0.831,13.886,60,1,0,1,59,19,40,0,0.0,0.0
1012,2865,27-09-2019 11:08:00,1,2641.0,2316.0,0.877,12.971,109,1,0,1,108,73,35,0,0.0,0.0
1012,2866,27-09-2019 11:10:00,1,2527.0,2256.0,0.893,12.452,104,0,0,0,104,69,35,0,0.0,0.0
1012,2867,27-09-2019 11:12:00,1,2543.0,2211.0,0.87,12.4655,72,3,0,3,69,33,36,0,0.0,0.0
1012,2868,27-09-2019 11:14:00,1,2559.0,2166.0,0.847,12.479,43,0,0,0,43,4,39,0,0.0,0.0
1012,2869,27-09-2019 11:16:00,1,2555.0,2113.0,0.827,12.407,49,3,2,1,46,10,36,0,0.0,0.0
1012,2870,27-09-2019 11:18:00,1,2562.0,2119.0,0.827,12.44,48,0,0,0,48,0,48,0,0.0,0.0
1012,2871,27-09-2019 11:20:00,1,2453.0,2088.0,0.851,11.978,16,0,0,0,16,1,15,0,0.0,0.0
1012,2872,27-09-2019 11:22:00,1,2331.0,2062.0,0.885,11.468,256,60,47,13,196,143,53,0,0.0,0.0
1012,2873,27-09-2019 11:24:00,1,2515.0,2301.0,0.915,12.456,158,8,1,7,150,97,53,1,0.0,0.0
1012,2874,27-09-2019 11:26:00,1,2619.0,2318.0,0.885,12.884,73,9,1,8,64,37,27,0,0.0,0.0
1012,2875,27-09-2019 11:28:00,1,2548.0,2201.0,0.864,12.476,43,3,0,3,40,4,36,0,0.0,0.0
1012,2876,27-09-2019 11:30:00,1,2557.0,2158.0,0.844,12.465,47,0,0,0,47,12,35,0,0.0,0.0
1012,2877,27-09-2019 11:32:00,1,2574.0,2113.0,0.821,12.48,50,0,0,0,50,2,48,0,0.0,0.0
1012,2878,27-09-2019 11:34:00,1,2460.0,2070.0,0.841,11.985,52,5,4,1,47,10,37,0,0.0,0.0
1012,2879,27-09-2019 11:36:00,1,2551.0,2151.0,0.843,12.434,207,67,39,28,140,87,53,6,0.0,0.0
1012,2880,27-09-2019 11:38:00,1,2533.0,2265.0,0.894,12.488,55,13,0,13,42,0,42,0,0.0,0.0
1012,2881,27-09-2019 11:40:00,1,2529.0,2214.0,0.876,12.415,47,1,0,1,46,0,46,0,0.0,0.0
1012,2882,27-09-2019 11:42:00,1,2550.0,2124.0,0.833,12.399,49,1,0,1,48,14,34,0,0.0,0.0
1012,2883,27-09-2019 11:44:00,1,2448.0,2151.0,0.879,12.027,47,0,0,0,47,6,41,0,0.0,0.0
1012,2884,27-09-2019 11:46:00,1,2452.0,2139.0,0.8725,12.0285,55,1,0,1,54,16,38,0,0.0,0.0
1012,2885,27-09-2019 11:48:00,1,2456.0,2127.0,0.866,12.03,51,0,0,0,51,7,44,0,0.0,0.0
1012,2886,27-09-2019 11:50:00,1,2323.0,2116.0,0.911,11.496,57,0,0,0,57,10,47,0,0.0,0.0
1012,2887,27-09-2019 11:52:00,1,2332.0,2063.0,0.885,11.47,102,31,11,20,71,49,22,10,0.0,0.01
1012,2888,27-09-2019 11:54:00,1,3012.0,2709.0,0.899,14.867,32,8,2,6,24,18,6,9,0.0,0.02
1012,2889,27-09-2019 11:56:00,1,3495.0,3187.0,0.912,17.301,139,8,2,6,131,103,28,3,0.0,0.05
1012,2890,27-09-2019 11:58:00,1,3360.0,3122.0,0.929,16.693,102,12,3,9,90,60,30,2,0.0,0.08
1012,2891,27-09-2019 12:00:00,1,3477.0,3228.0,0.928,17.274,131,15,5,10,116,86,30,15,0.0,0.05
1012,2892,27-09-2019 12:02:00,1,3688.0,3374.0,0.915,18.267,71,9,5,4,62,37,25,4,0.0,0.02
1012,2893,27-09-2019 12:04:00,1,3474.0,3209.0,0.924,17.24,147,1,0,1,146,79,67,1,0.0,0.26
1012,2894,27-09-2019 12:06:00,1,3193.0,2894.0,0.907,15.783,76,4,2,2,72,20,52,0,0.0,0.0
1012,2895,27-09-2019 12:08:00,1,3156.0,3045.0,0.965,15.806,385,178,145,33,207,140,67,56,0.09,0.0
1012,2896,27-09-2019 12:10:00,1,3189.0,2911.0,0.913,15.787,555,278,233,45,277,217,60,3,0.04,0.01
1012,2897,27-09-2019 12:12:00,1,3200.0,2889.0,0.903,15.806,35,0,0,0,35,2,33,0,0.0,0.0
1012,2898,27-09-2019 12:14:00,1,3281.0,3008.0,0.917,16.259,49,10,3,7,39,12,27,0,0.0,0.0
1012,2899,27-09-2019 12:16:00,1,3488.0,3151.0,0.904,17.229,337,170,138,32,167,113,54,20,0.1,0.0
1012,2900,27-09-2019 12:18:00,1,3461.0,3207.0,0.927,17.187,536,258,198,60,278,205,73,17,0.12,0.0
1012,2901,27-09-2019 12:20:00,1,3521.0,3235.0,0.919,17.455,267,146,110,36,121,76,45,0,0.0,0.0
1012,2902,27-09-2019 12:22:00,1,3581.0,3263.0,0.911,17.723,560,270,209,61,290,215,75,3,0.0,0.26
1012,2903,27-09-2019 12:24:00,1,3460.0,3307.0,0.956,17.295,613,305,235,70,308,224,84,0,0.0,0.0
1012,2904,27-09-2019 12:26:00,1,3371.0,3120.0,0.926,16.736,797,417,327,90,380,299,81,11,0.03,0.0
1012,2905,27-09-2019 12:28:00,1,3457.0,3254.0,0.941,17.221,442,254,185,69,188,127,61,3,0.0,0.0
1012,2906,27-09-2019 12:30:00,1,3463.0,3256.0,0.94,17.249,661,329,252,77,332,255,77,7,0.04,0.0
1012,2907,27-09-2019 12:32:00,1,3678.0,3390.0,0.922,18.245,728,318,258,60,410,320,90,15,0.04,0.0
1012,2908,27-09-2019 12:34:00,1,3582.0,3317.0,0.926,17.787,66,45,11,34,21,9,12,0,0.02,0.0
1012,2909,27-09-2019 12:36:00,1,3491.0,3183.0,0.912,17.277,75,48,24,24,27,3,24,0,0.0,0.0
1012,2910,27-09-2019 12:38:00,1,3478.0,3214.0,0.924,17.261,46,23,5,18,23,2,21,0,0.0,0.0
1012,2911,27-09-2019 12:40:00,1,3589.0,3294.0,0.918,17.789,14,12,1,11,2,0,2,1,0.0,0.0
1012,2912,27-09-2019 12:42:00,1,3593.0,3187.0,0.887,17.683,81,32,4,28,49,21,28,0,0.0,0.0
1012,2913,27-09-2019 12:44:00,1,3707.0,3270.0,0.882,18.225,25,18,3,15,7,2,5,0,0.0,0.0
1012,2914,27-09-2019 12:46:00,1,3463.0,3239.0,0.935,17.228,0,0,0,0,0,0,0,0,0.0,0.0
1012,2915,27-09-2019 12:48:00,1,3495.0,3107.0,0.889,17.208,12,2,0,2,10,1,9,0,0.0,0.0
1012,2916,27-09-2019 12:50:00,1,3175.0,2936.0,0.925,15.759,12,4,2,2,8,4,4,0,0.0,0.0
1013,1,23-09-2019 11:40:00,1,4864.0,3668.0,0.754,23.226,203,108,75,33,95,59,36,33,0.01,0.0
1013,2,23-09-2019 11:42:00,1,4801.0,3527.0,0.735,22.823,227,113,80,33,114,75,39,17,0.0,0.0
1013,3,23-09-2019 11:44:00,1,4776.0,3502.0,0.733,22.694,97,48,24,24,49,28,21,4,0.0,0.0
1013,4,23-09-2019 11:46:00,1,4294.0,3157.0,0.735,20.414,26,13,1,12,13,2,11,0,0.0,0.0
1013,5,23-09-2019 11:48:00,1,4483.0,3267.0,0.729,21.28,139,61,30,31,78,47,31,2,0.0,0.0
1013,6,23-09-2019 11:50:00,1,4269.0,3227.0,0.756,20.394,101,34,16,18,67,30,37,0,0.0,0.0
1013,7,23-09-2019 11:52:00,1,4283.0,3159.0,0.738,20.371,8,2,0,2,6,2,4,0,0.0,0.0
1013,8,23-09-2019 11:54:00,1,4065.0,2997.0,0.737,19.335,25,1,0,1,24,4,20,0,0.0,0.0
1013,9,23-09-2019 11:56:00,1,3882.0,2862.0,0.737,18.463,76,21,4,17,55,31,24,2,0.0,0.0
1013,10,23-09-2019 11:58:00,1,3870.0,2869.0,0.741,18.425,98,46,21,25,52,27,25,2,0.0,0.0
1013,11,23-09-2019 12:00:00,1,3885.0,2851.0,0.734,18.464,21,2,1,1,19,5,14,0,0.0,0.0
1013,12,23-09-2019 12:02:00,1,3885.5,2852.0,0.734,18.467,78,32,10,22,46,20,26,1,0.0,0.0
1013,13,23-09-2019 12:04:00,1,3886.0,2853.0,0.734,18.47,258,137,100,37,121,77,44,10,0.0,0.0
1013,14,23-09-2019 12:06:00,1,3880.0,2854.0,0.735,18.449,219,115,91,24,104,72,32,10,0.0,0.0
1013,15,23-09-2019 12:08:00,1,3854.0,2889.0,0.75,18.383,147,96,52,44,51,40,11,2,0.0,0.0
1013,16,23-09-2019 12:10:00,1,3853.0,2911.0,0.756,18.403,39,26,0,26,13,9,4,0,0.0,0.0
1013,17,23-09-2019 12:12:00,1,3900.0,2880.0,0.738,18.557,65,41,25,16,24,1,23,0,0.0,0.0
1013,18,23-09-2019 12:14:00,1,3529.0,2751.0,0.78,16.951,21,11,3,8,10,4,6,0,0.0,0.0
1013,19,23-09-2019 12:16:00,1,3575.0,2604.0,0.728,16.969,2,1,0,1,1,0,1,0,0.0,0.0
1013,20,23-09-2019 12:18:00,1,3377.0,2457.0,0.728,16.027,0,0,0,0,0,0,0,0,0.0,0.0
1013,21,23-09-2019 12:20:00,1,3150.0,2319.0,0.736,14.979,69,37,18,19,32,10,22,0,0.0,0.0
1013,22,23-09-2019 12:22:00,1,3358.0,2532.0,0.754,16.034,259,140,108,32,119,85,34,26,0.03,0.0
1013,23,23-09-2019 12:24:00,1,3512.0,2746.0,0.782,16.876,116,69,48,21,47,30,17,92,0.0,0.0
1013,24,23-09-2019 12:26:00,1,3772.0,2836.0,0.752,18.003,117,63,35,28,54,26,28,0,0.0,0.0
1013,25,23-09-2019 12:28:00,1,3523.0,2742.0,0.778,16.918,71,52,26,26,19,0,19,0,0.0,0.0
1013,26,23-09-2019 12:30:00,1,3532.0,2722.0,0.771,16.928,106,81,44,37,25,6,19,0,0.0,0.0
1013,27,23-09-2019 12:32:00,1,3550.0,2676.0,0.754,16.952,134,69,52,17,65,42,23,7,0.0,0.0
1013,28,23-09-2019 12:34:00,1,3446.0,2614.0,0.759,16.474,253,153,112,41,100,69,31,14,0.0,0.0
1013,29,23-09-2019 12:36:00,1,3391.5,2610.5,0.77,16.254,71,40,30,10,31,14,17,3,0.0,0.0
1013,30,23-09-2019 12:38:00,1,3337.0,2607.0,0.781,16.034,3,0,0,0,3,0,3,0,0.0,0.0
1013,31,23-09-2019 12:40:00,1,3241.0,2460.0,0.759,15.494,0,0,0,0,0,0,0,0,0.0,0.0
1013,32,23-09-2019 12:42:00,1,3154.0,2329.0,0.739,15.005,6,3,0,3,3,0,3,0,0.0,0.0
1013,33,23-09-2019 12:44:00,1,2807.0,2229.0,0.794,13.528,1,0,0,0,1,0,1,0,0.0,0.0
1013,34,23-09-2019 12:46:00,1,2843.0,2180.0,0.767,13.617,7,2,0,2,5,2,3,0,0.0,0.0
1013,35,23-09-2019 12:48:00,1,2836.0,2142.0,0.755,13.544,37,1,0,1,36,16,20,0,0.0,0.0
1013,36,23-09-2019 12:50:00,1,2747.0,2086.0,0.759,13.131,35,0,0,0,35,2,33,0,0.0,0.0
1013,37,23-09-2019 12:52:00,1,2628.0,2052.0,0.781,12.627,13,0,0,0,13,2,11,0,0.0,0.0
1013,38,23-09-2019 12:54:00,1,2643.0,2044.0,0.773,12.675,6,0,0,0,6,3,3,0,0.0,0.0
1013,39,23-09-2019 12:56:00,1,2631.0,1981.0,0.753,12.56,26,6,1,5,20,11,9,0,0.0,0.0
1013,40,23-09-2019 12:58:00,1,2433.0,1872.0,0.769,11.659,24,9,0,9,15,1,14,0,0.0,0.0
1013,41,23-09-2019 13:00:00,1,2454.0,1775.0,0.723,11.635,34,29,0,29,5,4,1,0,0.0,0.0
1013,42,23-09-2019 13:02:00,1,2458.0,1763.0,0.717,11.635,3,3,0,3,0,0,0,0,0.0,0.0
1013,43,23-09-2019 13:04:00,1,2339.0,1720.0,0.736,11.119,0,0,0,0,0,0,0,0,0.0,0.0
1013,44,23-09-2019 13:06:00,1,2237.0,1689.0,0.755,10.684,75,29,9,20,46,17,29,0,0.0,0.0
1013,45,23-09-2019 13:08:00,1,2618.0,2089.0,0.798,12.627,212,116,70,46,96,59,37,9,0.0,0.0
1013,46,23-09-2019 13:10:00,1,2975.0,2306.0,0.7775,14.275,167,99,72,27,68,44,24,24,0.0,0.0
1013,47,23-09-2019 13:12:00,1,3332.0,2523.0,0.757,15.923,58,35,13,22,23,5,18,0,0.0,0.0
1013,48,23-09-2019 13:14:00,1,3267.0,2388.0,0.731,15.517,1,1,1,0,0,0,0,0,0.0,0.0
1013,49,23-09-2019 13:16:00,1,2931.0,2275.0,0.776,14.066,0,0,0,0,0,0,0,0,0.0,0.0
1013,50,23-09-2019 13:18:00,1,2952.0,2168.0,0.734,14.03,3,1,0,1,2,0,2,0,0.0,0.0
1013,51,23-09-2019 13:20:00,1,2737.0,2070.0,0.756,13.076,0,0,0,0,0,0,0,0,0.0,0.0
1013,52,23-09-2019 13:22:00,1,2656.0,1922.0,0.724,12.593,47,26,18,8,21,6,15,0,0.0,0.0
1013,53,23-09-2019 13:24:00,1,2747.0,2062.0,0.751,13.105,100,37,14,23,63,37,26,0,0.0,0.0
1013,54,23-09-2019 13:26:00,1,2960.0,2161.0,0.73,14.056,128,81,49,32,47,27,20,45,0.0,0.0
1013,55,23-09-2019 13:28:00,1,3146.0,2349.0,0.747,14.995,74,45,26,19,29,15,14,60,0.0,0.0
1013,56,23-09-2019 13:30:00,1,3260.0,2482.0,0.761,15.592,93,55,28,27,38,13,25,6,0.0,0.0
1013,57,23-09-2019 13:32:00,1,3237.0,2483.0,0.767,15.502,60,30,14,16,30,13,17,0,0.0,0.0
1013,58,23-09-2019 13:34:00,1,3165.0,2348.0,0.742,15.069,79,33,12,21,46,19,27,0,0.0,0.0
1013,59,23-09-2019 13:36:00,1,3271.0,2350.0,0.719,15.489,42,14,0,14,28,3,25,0,0.0,0.0
1013,60,23-09-2019 13:38:00,1,3268.0,2357.0,0.721,15.486,48,28,7,21,20,8,12,0,0.0,0.0
1013,61,23-09-2019 13:40:00,1,3055.0,2313.0,0.757,14.598,32,24,14,10,8,1,7,0,0.0,0.0
1013,62,23-09-2019 13:42:00,1,2954.0,2187.0,0.74,14.062,3,2,1,1,1,0,1,0,0.0,0.0
1013,63,23-09-2019 13:44:00,1,2920.0,2105.5,0.7205,13.837,0,0,0,0,0,0,0,0,0.0,0.0
1013,64,23-09-2019 13:46:00,1,2886.0,2024.0,0.701,13.612,2,2,0,2,0,0,0,0,0.0,0.0
1013,65,23-09-2019 13:48:00,1,2886.0,2011.0,0.697,13.597,1,1,0,1,0,0,0,0,0.0,0.0
1013,66,23-09-2019 13:50:00,1,2897.0,1974.0,0.681,13.601,2,2,0,2,0,0,0,0,0.0,0.0
1013,67,23-09-2019 13:52:00,1,2654.0,1875.0,0.706,12.535,63,48,13,35,15,12,3,0,0.0,0.0
1013,68,23-09-2019 13:54:00,1,2882.0,2019.0,0.701,13.592,9,9,0,9,0,0,0,0,0.0,0.0
1013,69,23-09-2019 13:56:00,1,2862.0,2074.0,0.725,13.571,3,3,1,2,0,0,0,0,0.0,0.0
1013,70,23-09-2019 13:58:00,1,2868.0,2052.0,0.715,13.573,0,0,0,0,0,0,0,0,0.0,0.0
1013,71,23-09-2019 14:00:00,1,2884.0,2014.0,0.698,13.592,3,3,0,3,0,0,0,0,0.0,0.0
1013,72,23-09-2019 14:02:00,1,2873.0,1994.0,0.694,13.528,0,0,0,0,0,0,0,0,0.0,0.0
1013,73,23-09-2019 14:04:00,1,2888.0,1977.0,0.684,13.57,4,2,0,2,2,0,2,0,0.0,0.0
1013,74,23-09-2019 14:06:00,1,2788.0,1964.0,0.704,13.16,4,2,0,2,2,0,2,0,0.0,0.0
1013,75,23-09-2019 14:08:00,1,2778.0,1937.0,0.697,13.091,0,0,0,0,0,0,0,0,0.0,0.0
1013,76,23-09-2019 14:10:00,1,2765.0,1924.0,0.696,13.025,0,0,0,0,0,0,0,0,0.0,0.0
1013,77,23-09-2019 14:12:00,1,2659.0,1927.0,0.725,12.61,32,16,6,10,16,11,5,0,0.0,0.0
1013,78,23-09-2019 14:14:00,1,2867.0,2038.0,0.711,13.554,101,59,38,21,42,25,17,0,0.0,0.0
1013,79,23-09-2019 14:16:00,1,2863.0,2079.0,0.726,13.584,4,0,0,0,4,0,4,0,0.0,0.0
1013,80,23-09-2019 14:18:00,1,2762.5,2009.5,0.7275,13.111,0,0,0,0,0,0,0,0,0.0,0.0
1013,81,23-09-2019 14:20:00,1,2662.0,1940.0,0.729,12.638,2,1,0,1,1,0,1,0,0.0,0.0
1013,82,23-09-2019 14:22:00,1,2655.0,1915.0,0.721,12.583,8,0,0,0,8,5,3,0,0.0,0.0
1013,83,23-09-2019 14:24:00,1,2664.0,1896.0,0.712,12.595,4,2,1,1,2,0,2,0,0.0,0.0
1013,84,23-09-2019 14:26:00,1,2661.0,1917.0,0.721,12.606,7,0,0,0,7,2,5,0,0.0,0.0
1013,85,23-09-2019 14:28:00,1,2678.0,1916.0,0.715,12.671,19,2,1,1,17,4,13,0,0.0,0.0
1013,86,23-09-2019 14:30:00,1,2658.0,1902.0,0.716,12.577,5,1,0,1,4,0,4,0,0.0,0.0
1013,87,23-09-2019 14:32:00,1,2661.0,1920.0,0.721,12.612,7,1,0,1,6,2,4,0,0.0,0.0
1013,88,23-09-2019 14:34:00,1,2655.0,1917.0,0.722,12.584,11,1,1,0,10,4,6,0,0.0,0.0
1013,89,23-09-2019 14:36:00,1,2674.0,1906.0,0.713,12.647,17,7,0,7,10,2,8,0,0.0,0.0
1013,90,23-09-2019 14:38:00,1,2671.0,1903.0,0.712,12.633,10,4,0,4,6,1,5,0,0.0,0.0
1013,91,23-09-2019 14:40:00,1,2670.0,1954.0,0.732,12.685,6,0,0,0,6,1,5,0,0.0,0.0
1013,92,23-09-2019 14:42:00,1,2653.0,1934.0,0.729,12.594,3,3,1,2,0,0,0,0,0.0,0.0
1013,93,23-09-2019 14:44:00,1,2658.0,1925.0,0.724,12.605,22,9,2,7,13,6,7,0,0.0,0.0
1013,94,23-09-2019 14:46:00,1,2653.0,1945.0,0.733,12.609,2,1,0,1,1,0,1,0,0.0,0.0
1013,95,23-09-2019 14:48:00,1,2874.0,2031.0,0.707,13.572,2,0,0,0,2,1,1,0,0.0,0.0
1013,96,23-09-2019 14:50:00,1,2864.0,2021.0,0.706,13.523,6,1,0,1,5,2,3,0,0.0,0.0
1013,97,23-09-2019 14:52:00,1,2860.5,2051.0,0.7175,13.5415,89,49,34,15,40,17,23,0,0.0,0.0
1013,98,23-09-2019 14:54:00,1,2857.0,2081.0,0.729,13.56,70,39,26,13,31,15,16,2,0.0,0.0
1013,99,23-09-2019 14:56:00,1,3042.0,2362.0,0.777,14.602,83,60,24,36,23,9,14,0,0.0,0.0
1013,100,23-09-2019 14:58:00,1,3264.0,2430.0,0.745,15.55,70,47,20,27,23,10,13,15,0.0,0.0
1013,101,23-09-2019 15:00:00,1,3345.0,2545.0,0.761,15.997,151,97,69,28,54,36,18,22,0.0,0.0
1013,102,23-09-2019 15:02:00,1,3375.0,2490.0,0.738,16.053,49,10,4,6,39,8,31,0,0.0,0.0
1013,103,23-09-2019 15:04:00,1,3036.0,2290.0,0.754,14.498,34,20,2,18,14,3,11,0,0.0,0.0
1013,104,23-09-2019 15:06:00,1,3055.0,2298.0,0.752,14.582,33,16,4,12,17,5,12,0,0.0,0.0
1013,105,23-09-2019 15:08:00,1,3144.0,2337.0,0.743,14.975,74,34,5,29,40,15,25,0,0.0,0.0
1013,106,23-09-2019 15:10:00,1,3041.0,2304.0,0.758,14.534,128,67,41,26,61,41,20,6,0.0,0.0
1013,107,23-09-2019 15:12:00,1,3362.0,2516.0,0.748,16.031,0,0,0,0,0,0,0,0,0.0,0.0
1013,108,23-09-2019 15:14:00,1,3141.0,2383.0,0.759,15.015,14,1,0,1,13,5,8,0,0.0,0.0
1013,109,23-09-2019 15:16:00,1,3075.0,2235.0,0.727,14.592,5,0,0,0,5,2,3,0,0.0,0.0
1013,110,23-09-2019 15:18:00,1,2863.0,2113.0,0.738,13.619,5,4,1,3,1,0,1,0,0.0,0.0
1013,111,23-09-2019 15:20:00,1,2870.0,2019.0,0.703,13.543,0,0,0,0,0,0,0,0,0.0,0.0
1013,112,23-09-2019 15:22:00,1,2643.0,1951.0,0.738,12.572,16,3,0,3,13,7,6,0,0.0,0.0
1013,113,23-09-2019 15:24:00,1,2753.0,2003.0,0.727,13.066,6,0,0,0,6,2,4,0,0.0,0.0
1013,114,23-09-2019 15:26:00,1,2801.0,2066.5,0.7375,13.3255,0,0,0,0,0,0,0,0,0.0,0.0
1013,115,23-09-2019 15:28:00,1,2849.0,2130.0,0.748,13.585,5,0,0,0,5,2,3,0,0.0,0.0
1013,116,23-09-2019 15:30:00,1,2865.0,2114.0,0.738,13.627,2,0,0,0,2,0,2,0,0.0,0.0
1013,117,23-09-2019 15:32:00,1,2851.0,2091.0,0.733,13.551,0,0,0,0,0,0,0,0,0.0,0.0
1013,118,23-09-2019 15:34:00,1,2854.0,2078.0,0.728,13.545,5,0,0,0,5,3,2,0,0.0,0.0
1013,119,23-09-2019 15:36:00,1,2867.0,2072.0,0.723,13.591,1,0,0,0,1,1,0,0,0.0,0.0
1013,120,23-09-2019 15:38:00,1,2642.0,1964.0,0.744,12.583,0,0,0,0,0,0,0,0,0.0,0.0
1013,121,23-09-2019 15:40:00,1,2672.0,1861.0,0.697,12.588,1,1,1,0,0,0,0,0,0.0,0.0
1013,122,23-09-2019 15:42:00,1,2450.0,1814.0,0.74,11.662,22,16,10,6,6,3,3,0,0.0,0.0
1013,123,23-09-2019 15:44:00,1,2671.0,1861.0,0.697,12.584,0,0,0,0,0,0,0,0,0.0,0.0
1013,124,23-09-2019 15:46:00,1,2653.0,1938.0,0.731,12.597,0,0,0,0,0,0,0,0,0.0,0.0
1013,125,23-09-2019 15:48:00,1,2639.0,1996.0,0.756,12.607,0,0,0,0,0,0,0,0,0.0,0.0
1013,126,23-09-2019 15:50:00,1,2655.0,1950.0,0.734,12.618,10,0,0,0,10,3,7,0,0.0,0.0
1013,127,23-09-2019 15:52:00,1,2324.0,1790.0,0.77,11.14,4,0,0,0,4,0,4,0,0.0,0.0
1013,128,23-09-2019 15:54:00,1,2351.0,1725.0,0.734,11.172,1,0,0,0,1,0,1,0,0.0,0.0
1013,129,23-09-2019 15:56:00,1,2338.0,1754.0,0.75,11.156,3,0,0,0,3,2,1,0,0.0,0.0
1013,130,23-09-2019 15:58:00,1,2353.0,1717.0,0.73,11.171,5,2,0,2,3,0,3,0,0.0,0.0
1013,131,23-09-2019 16:00:00,1,2519.0,1802.0,0.7165,11.9195,1,0,0,0,1,0,1,0,0.0,0.0
1013,132,23-09-2019 16:02:00,1,2685.0,1887.0,0.703,12.668,1,0,0,0,1,0,1,0,0.0,0.0
1013,133,23-09-2019 16:04:00,1,2653.0,1933.0,0.729,12.592,5,1,1,0,4,1,3,0,0.0,0.0
1013,134,23-09-2019 16:06:00,1,2845.0,2111.0,0.742,13.546,0,0,0,0,0,0,0,0,0.0,0.0
1013,135,23-09-2019 16:08:00,1,2852.0,2114.0,0.741,13.579,5,4,1,3,1,0,1,0,0.0,0.0
1013,136,23-09-2019 16:10:00,1,2840.0,2136.0,0.752,13.554,1,1,0,1,0,0,0,0,0.0,0.0
1013,137,23-09-2019 16:12:00,1,2862.0,2099.0,0.733,13.6,0,0,0,0,0,0,0,0,0.0,0.0
1013,138,23-09-2019 16:14:00,1,2868.0,2057.0,0.717,13.579,36,36,26,10,0,0,0,0,0.0,0.0
1013,139,23-09-2019 16:16:00,1,2748.0,2038.0,0.742,13.085,12,12,0,12,0,0,0,0,0.0,0.0
1013,140,23-09-2019 16:18:00,1,2749.0,2014.0,0.732,13.063,12,7,2,5,5,1,4,0,0.0,0.0
1013,141,23-09-2019 16:20:00,1,2644.0,1972.0,0.746,12.603,7,4,1,3,3,1,2,0,0.0,0.0
1013,142,23-09-2019 16:22:00,1,2639.0,2004.0,0.759,12.617,5,1,0,1,4,0,4,0,0.0,0.0
1013,143,23-09-2019 16:24:00,1,2644.0,1965.0,0.743,12.593,0,0,0,0,0,0,0,0,0.0,0.0
1013,144,23-09-2019 16:26:00,1,2642.0,1969.0,0.745,12.589,40,19,6,13,21,6,15,0,0.0,0.0
1013,145,23-09-2019 16:28:00,1,2868.0,2079.0,0.725,13.601,22,22,0,22,0,0,0,0,0.0,0.0
1013,146,23-09-2019 16:30:00,1,2753.0,2058.0,0.748,13.128,14,1,0,1,13,1,12,0,0.0,0.0
1013,147,23-09-2019 16:32:00,1,2624.0,2020.0,0.77,12.574,15,3,0,3,12,0,12,0,0.0,0.0
1013,148,23-09-2019 16:34:00,1,2635.0,2019.0,0.7665,12.617,12,0,0,0,12,0,12,0,0.0,0.0
1013,149,23-09-2019 16:36:00,1,2646.0,2018.0,0.763,12.66,11,0,0,0,11,0,11,0,0.0,0.0
1013,150,23-09-2019 16:38:00,1,2646.0,1984.0,0.75,12.624,22,1,0,1,21,5,16,0,0.0,0.0
1013,151,23-09-2019 16:40:00,1,2637.0,1953.0,0.741,12.551,3,0,0,0,3,0,3,0,0.0,0.0
1013,152,23-09-2019 16:42:00,1,2648.0,1961.0,0.741,12.604,1,0,0,0,1,0,1,0,0.0,0.0
1013,153,23-09-2019 16:44:00,1,2432.0,1847.0,0.759,11.628,30,14,9,5,16,8,8,0,0.0,0.0
1013,154,23-09-2019 16:46:00,1,2634.0,1993.0,0.757,12.583,97,75,33,42,22,4,18,0,0.0,0.0
1013,155,23-09-2019 16:48:00,1,2623.0,2035.0,0.776,12.586,90,54,31,23,36,12,24,0,0.0,0.0
1013,156,23-09-2019 16:50:00,1,3252.0,2441.0,0.751,15.515,213,123,87,36,90,60,30,33,0.0,0.0
1013,157,23-09-2019 16:52:00,1,3565.0,2669.0,0.749,17.0,51,26,16,10,25,17,8,51,0.04,0.0
1013,158,23-09-2019 16:54:00,1,3012.0,2425.0,0.805,14.553,210,140,111,29,70,52,18,78,0.0,0.0
1013,159,23-09-2019 16:56:00,1,3031.0,2374.0,0.783,14.572,66,51,22,29,15,8,7,24,0.0,0.0
1013,160,23-09-2019 16:58:00,1,3336.0,2590.0,0.776,16.012,65,53,28,25,12,4,8,48,0.0,0.0
1013,161,23-09-2019 17:00:00,1,3532.0,2781.0,0.787,16.993,108,81,44,37,27,9,18,34,0.0,0.03
1013,162,23-09-2019 17:02:00,1,3550.0,2657.0,0.748,16.927,201,103,73,30,98,70,28,19,0.0,0.0
1013,163,23-09-2019 17:04:00,1,2951.0,2221.0,0.753,14.087,120,60,34,26,60,31,29,1,0.0,0.0
1013,164,23-09-2019 17:06:00,1,3044.0,2328.0,0.765,14.572,75,43,22,21,32,12,20,0,0.0,0.0
1013,165,23-09-2019 17:08:00,1,3041.0,2353.0,0.774,14.587,127,91,51,40,36,11,25,0,0.0,0.0
1013,166,23-09-2019 17:10:00,1,3038.0,2378.0,0.783,14.602,70,43,18,25,27,5,22,0,0.0,0.0
1013,167,23-09-2019 17:12:00,1,3250.0,2441.0,0.751,15.508,30,20,6,14,10,1,9,0,0.0,0.0
1013,168,23-09-2019 17:14:00,1,3026.0,2366.0,0.782,14.54,2,2,0,2,0,0,0,0,0.0,0.0
1013,169,23-09-2019 17:16:00,1,3057.0,2273.0,0.744,14.563,3,3,0,3,0,0,0,0,0.0,0.0
1013,170,23-09-2019 17:18:00,1,2855.0,2128.0,0.746,13.605,4,4,0,4,0,0,0,0,0.0,0.0
1013,171,23-09-2019 17:20:00,1,2747.0,2019.0,0.735,13.058,0,0,0,0,0,0,0,0,0.0,0.0
1013,172,23-09-2019 17:22:00,1,2657.0,1934.0,0.728,12.61,7,1,0,1,6,3,3,0,0.0,0.0
1013,173,23-09-2019 17:24:00,1,2856.0,2064.0,0.723,13.538,3,0,0,0,3,0,3,0,0.0,0.0
1013,174,23-09-2019 17:26:00,1,2842.0,2178.0,0.766,13.611,0,0,0,0,0,0,0,0,0.0,0.0
1013,175,23-09-2019 17:28:00,1,2955.0,2212.0,0.748,14.092,1,0,0,0,1,0,1,0,0.0,0.0
1013,176,23-09-2019 17:30:00,1,2952.0,2219.0,0.752,14.088,2,2,0,2,0,0,0,0,0.0,0.0
1013,177,23-09-2019 17:32:00,1,3067.0,2225.0,0.725,14.548,3,1,0,1,2,2,0,0,0.0,0.0
1013,178,23-09-2019 17:34:00,1,2839.0,2199.0,0.774,13.622,0,0,0,0,0,0,0,0,0.0,0.0
1013,179,23-09-2019 17:36:00,1,2860.0,2121.0,0.742,13.617,0,0,0,0,0,0,0,0,0.0,0.0
1013,180,23-09-2019 17:38:00,1,2754.0,2007.0,0.729,13.072,33,16,8,8,17,6,11,0,0.0,0.0
1013,181,23-09-2019 17:40:00,1,2639.0,1992.0,0.755,12.605,22,18,5,13,4,1,3,0,0.0,0.0
1013,182,23-09-2019 17:42:00,1,2654.0,1953.5,0.7365,12.62,8,0,0,0,8,0,8,0,0.0,0.0
1013,183,23-09-2019 17:44:00,1,2669.0,1915.0,0.718,12.635,21,8,4,4,13,4,9,0,0.0,0.0
1013,184,23-09-2019 17:46:00,1,2750.0,2003.0,0.728,13.054,8,0,0,0,8,1,7,0,0.0,0.0
1013,185,23-09-2019 17:48:00,1,2643.0,1968.0,0.745,12.591,6,4,1,3,2,0,2,0,0.0,0.0
1013,186,23-09-2019 17:50:00,1,2871.0,2046.0,0.713,13.575,1,1,1,0,0,0,0,0,0.0,0.0
1013,187,23-09-2019 17:52:00,1,2863.0,2028.0,0.708,13.526,14,1,0,1,13,0,13,0,0.0,0.0
1013,188,23-09-2019 17:54:00,1,2879.0,2054.0,0.713,13.617,21,13,6,7,8,2,6,0,0.0,0.0
1013,189,23-09-2019 17:56:00,1,2753.0,1995.0,0.725,13.057,5,2,1,1,3,0,3,0,0.0,0.0
1013,190,23-09-2019 17:58:00,1,2761.0,1998.0,0.724,13.092,0,0,0,0,0,0,0,0,0.0,0.0
1013,191,23-09-2019 18:00:00,0,2642.0,1976.0,0.748,12.598,27,16,4,12,11,2,9,0,0.0,0.0
1013,192,23-09-2019 18:02:00,0,2650.0,1952.0,0.737,12.604,13,9,2,7,4,0,4,0,0.0,0.0
1013,193,23-09-2019 18:04:00,0,2660.0,1910.0,0.718,12.596,12,7,0,7,5,1,4,0,0.0,0.0
1013,194,23-09-2019 18:06:00,0,2658.0,1909.0,0.718,12.586,25,15,10,5,10,3,7,0,0.0,0.0
1013,195,23-09-2019 18:08:00,0,2761.0,2033.0,0.736,13.13,171,78,61,17,93,59,34,5,0.0,0.0
1013,196,23-09-2019 18:10:00,0,3066.0,2306.0,0.752,14.632,205,110,76,34,95,59,36,23,0.0,0.0
1013,197,23-09-2019 18:12:00,0,3527.0,2774.0,0.786,16.97,319,156,115,41,163,123,40,60,0.0,0.0
1013,198,23-09-2019 18:14:00,0,3527.0,2745.0,0.778,16.937,314,191,153,38,123,88,35,103,0.0,0.0
1013,199,23-09-2019 18:16:00,0,3537.5,2724.0,0.77,16.954,282,129,99,30,153,113,40,54,0.0,0.0
1013,200,23-09-2019 18:18:00,0,3548.0,2703.0,0.762,16.971,227,111,78,33,116,76,40,29,0.0,0.0
1013,201,23-09-2019 18:20:00,0,3837.0,2948.0,0.768,18.381,311,166,120,46,145,106,39,51,0.0,0.0
1013,202,23-09-2019 18:22:00,0,4042.0,3093.0,0.765,19.349,225,103,70,33,122,81,41,35,0.0,0.0
1013,203,23-09-2019 18:24:00,0,3766.0,2754.0,0.731,17.887,348,197,145,52,151,115,36,92,0.0,0.0
1013,204,23-09-2019 18:26:00,0,3761.0,2820.0,0.75,17.94,327,194,160,34,133,108,25,37,0.0,0.0
1013,205,23-09-2019 18:28:00,0,4105.0,3001.0,0.731,19.496,95,68,36,32,27,5,22,46,0.0,0.0
1013,206,23-09-2019 18:30:00,0,4273.0,3174.0,0.743,20.349,162,92,53,39,70,40,30,60,0.0,0.0
1013,207,23-09-2019 18:32:00,0,4452.0,3375.0,0.758,21.279,119,71,44,27,48,26,22,48,0.0,0.0
1013,208,23-09-2019 18:34:00,0,4283.0,3184.0,0.743,20.402,117,66,36,30,51,20,31,49,0.0,0.0
1013,209,23-09-2019 18:36:00,0,4255.0,3286.0,0.772,20.404,165,94,61,33,71,32,39,48,0.0,0.0
1013,210,23-09-2019 18:38:00,0,4338.0,3328.0,0.767,20.779,148,79,51,28,69,18,51,59,0.0,0.0
1013,211,23-09-2019 18:40:00,0,4446.0,3456.0,0.777,21.344,86,42,25,17,44,8,36,24,0.0,0.0
1013,212,23-09-2019 18:42:00,0,4021.0,3195.0,0.795,19.38,288,181,133,48,107,70,37,47,0.0,0.02
1013,213,23-09-2019 18:44:00,0,3610.0,2895.0,0.802,17.428,101,33,11,22,68,35,33,2,0.0,0.0
1013,214,23-09-2019 18:46:00,0,3322.0,2665.0,0.802,16.04,123,54,30,24,69,45,24,0,0.0,0.0
1013,215,23-09-2019 18:48:00,0,3356.0,2568.0,0.765,16.066,109,76,40,36,33,5,28,0,0.0,0.0
1013,216,23-09-2019 18:50:00,0,3663.0,2968.0,0.8065,17.7185,493,257,201,56,236,178,58,85,0.03,0.0
1013,217,23-09-2019 18:52:00,0,3970.0,3368.0,0.848,19.371,549,283,233,50,266,215,51,43,0.0,0.0
1013,218,23-09-2019 18:54:00,0,4901.0,4038.0,0.824,23.781,324,162,122,40,162,125,37,138,0.0,0.0
1013,219,23-09-2019 18:56:00,0,3787.0,3219.0,0.85,18.484,298,150,106,44,148,111,37,22,0.02,0.0
1013,220,23-09-2019 18:58:00,0,4169.0,3562.0,0.854,20.37,373,226,178,48,147,111,36,55,0.01,0.02
1013,221,23-09-2019 19:00:00,0,4477.0,3771.0,0.842,21.814,133,74,45,29,59,27,32,70,0.0,0.0
1013,222,23-09-2019 19:02:00,0,4781.0,3997.0,0.836,23.263,137,84,57,27,53,16,37,64,0.0,0.0
1013,223,23-09-2019 19:04:00,0,4389.0,3685.0,0.84,21.373,108,31,21,10,77,52,25,10,0.0,0.01
1013,224,23-09-2019 19:06:00,0,3589.0,3014.0,0.84,17.476,122,43,16,27,79,55,24,3,0.0,0.0
1013,225,23-09-2019 19:08:00,0,3283.0,2754.0,0.839,15.985,100,53,20,33,47,14,33,2,0.0,0.0
1013,226,23-09-2019 19:10:00,0,3400.0,2808.0,0.826,16.504,179,75,39,36,104,57,47,8,0.0,0.0
1013,227,23-09-2019 19:12:00,0,3678.0,3056.0,0.831,17.875,318,168,130,38,150,110,40,90,0.02,0.02
1013,228,23-09-2019 19:14:00,0,4342.0,3865.0,0.89,21.386,330,180,143,37,150,114,36,33,0.0,0.0
1013,229,23-09-2019 19:16:00,0,3772.0,3321.0,0.88,18.539,194,100,62,38,94,65,29,22,0.0,0.0
1013,230,23-09-2019 19:18:00,0,4449.0,3859.0,0.868,21.8,308,161,129,32,147,107,40,97,0.0,0.0
1013,231,23-09-2019 19:20:00,0,4135.0,3653.0,0.883,20.338,284,147,116,31,137,90,47,38,0.0,0.0
1013,232,23-09-2019 19:22:00,0,4050.0,3548.0,0.876,19.884,60,26,13,13,34,11,23,0,0.0,0.0
1013,233,23-09-2019 19:24:00,0,4021.0,3494.5,0.869,19.711,62,40,17,23,22,5,17,2,0.02,0.0
1013,234,23-09-2019 19:26:00,0,3992.0,3441.0,0.862,19.538,133,70,38,32,63,34,29,0,0.0,0.0
1013,235,23-09-2019 19:28:00,0,3977.0,3405.0,0.856,19.441,194,137,95,42,57,32,25,54,0.0,0.0
1013,236,23-09-2019 19:30:00,0,4757.0,4078.0,0.857,23.256,127,85,61,24,42,14,28,49,0.0,0.0
1013,237,23-09-2019 19:32:00,0,4872.0,4238.0,0.87,23.889,126,87,52,35,39,8,31,67,0.0,0.01
1013,238,23-09-2019 19:34:00,0,4647.0,4094.0,0.881,22.842,339,190,147,43,149,113,36,74,0.0,0.07
1013,239,23-09-2019 19:36:00,0,3943.0,3540.0,0.898,19.456,137,74,54,20,63,44,19,8,0.0,0.0
1013,240,23-09-2019 19:38:00,0,3682.0,3119.0,0.847,17.959,13,3,2,1,10,7,3,0,0.0,0.0
1013,241,23-09-2019 19:40:00,0,3483.0,2960.0,0.85,16.999,2,0,0,0,2,0,2,0,0.0,0.01
1013,242,23-09-2019 19:42:00,0,3273.0,2779.0,0.849,15.974,1,0,0,0,1,0,1,0,0.0,0.0
1013,243,23-09-2019 19:44:00,0,2952.0,2648.0,0.897,14.562,10,3,1,2,7,3,4,0,0.0,0.0
1013,244,23-09-2019 19:46:00,0,2969.0,2544.0,0.857,14.515,5,1,0,1,4,1,3,0,0.0,0.0
1013,245,23-09-2019 19:48:00,0,2874.0,2458.0,0.855,14.043,3,1,0,1,2,0,2,0,0.0,0.0
1013,246,23-09-2019 19:50:00,0,2782.0,2375.0,0.854,13.593,114,58,28,30,56,30,26,1,0.0,0.0
1013,247,23-09-2019 19:52:00,0,3730.0,3402.0,0.912,18.46,263,160,128,32,103,78,25,113,0.0,0.0
1013,248,23-09-2019 19:54:00,0,3929.0,3559.0,0.906,19.422,410,202,155,47,208,155,53,81,0.0,0.02
1013,249,23-09-2019 19:56:00,0,4313.0,3902.0,0.905,21.315,348,216,162,54,132,94,38,76,0.0,0.0
1013,250,23-09-2019 19:58:00,0,4337.0,3876.0,0.894,21.38,364,205,155,50,159,113,46,61,0.07,0.0
1013,251,23-09-2019 20:00:00,0,4361.0,3850.0,0.883,21.445,195,120,83,37,75,42,33,60,0.0,0.0
1013,252,23-09-2019 20:02:00,0,4322.0,3953.0,0.915,21.404,139,102,62,40,37,1,36,65,0.0,0.0
1013,253,23-09-2019 20:04:00,0,4551.0,4035.0,0.887,22.399,132,80,52,28,52,14,38,56,0.0,0.0
1013,254,23-09-2019 20:06:00,0,4615.0,4161.0,0.902,22.792,227,87,62,25,140,97,43,50,0.01,0.07
1013,255,23-09-2019 20:08:00,0,3939.0,3507.0,0.89,19.404,297,156,120,36,141,107,34,58,0.01,0.01
1013,256,23-09-2019 20:10:00,0,3543.0,3226.0,0.911,17.53,313,147,101,46,166,125,41,30,0.05,0.03
1013,257,23-09-2019 20:12:00,0,4648.0,4019.0,0.865,22.761,142,93,56,37,49,6,43,71,0.0,0.0
1013,258,23-09-2019 20:14:00,0,4587.0,4227.0,0.921,22.751,154,110,80,30,44,16,28,39,0.0,0.02
1013,259,23-09-2019 20:16:00,0,3645.0,3276.0,0.899,17.99,186,87,55,32,99,61,38,15,0.14,0.0
1013,260,23-09-2019 20:18:00,0,3608.0,3385.0,0.938,17.963,214,82,55,27,132,88,44,56,0.0,0.0
1013,261,23-09-2019 20:20:00,0,3426.0,3152.0,0.92,16.99,273,158,125,33,115,81,34,84,0.0,0.03
1013,262,23-09-2019 20:22:00,0,4002.0,3756.0,0.939,19.924,121,70,55,15,51,29,22,17,0.0,0.0
1013,263,23-09-2019 20:24:00,0,3442.0,3087.0,0.897,16.981,98,60,28,32,38,18,20,2,0.0,0.0
1013,264,23-09-2019 20:26:00,0,3414.0,3150.0,0.922,16.94,7,7,1,6,0,0,0,0,0.0,0.0
1013,265,23-09-2019 20:28:00,0,3227.0,2981.0,0.924,16.014,3,3,1,2,0,0,0,0,0.0,0.0
1013,266,23-09-2019 20:30:00,0,3268.0,2888.0,0.884,16.074,10,9,3,6,1,0,1,0,0.0,0.0
1013,267,23-09-2019 20:32:00,0,3157.5,2834.0,0.898,15.579,3,0,0,0,3,1,2,0,0.0,0.0
1013,268,23-09-2019 20:34:00,0,3047.0,2780.0,0.912,15.084,1,0,0,0,1,0,1,0,0.0,0.0
1013,269,23-09-2019 20:36:00,0,2935.0,2691.0,0.917,14.543,6,3,2,1,3,2,1,0,0.01,0.0
1013,270,23-09-2019 20:38:00,0,3045.0,2785.0,0.915,15.082,23,11,5,6,12,5,7,0,0.01,0.0
1013,271,23-09-2019 20:40:00,0,3261.0,2873.0,0.881,16.031,34,21,8,13,13,3,10,0,0.0,0.0
1013,272,23-09-2019 20:42:00,0,2936.0,2738.0,0.933,14.597,14,10,6,4,4,1,3,0,0.0,0.0
1013,273,23-09-2019 20:44:00,0,2930.0,2738.0,0.934,14.576,14,9,5,4,5,1,4,0,0.0,0.0
1013,274,23-09-2019 20:46:00,0,3138.0,2875.0,0.916,15.549,156,85,56,29,71,36,35,35,0.0,0.0
1013,275,23-09-2019 20:48:00,0,3902.0,3744.0,0.96,19.519,246,121,84,37,125,81,44,81,0.0,0.0
1013,276,23-09-2019 20:50:00,0,3906.0,3633.0,0.93,19.411,421,204,164,40,217,166,51,66,0.04,0.0
1013,277,23-09-2019 20:52:00,0,3889.0,3782.0,0.972,19.51,212,144,106,38,68,49,19,53,0.02,0.0
1013,278,23-09-2019 20:54:00,0,4593.0,4278.0,0.931,22.831,125,74,47,27,51,19,32,67,0.0,0.0
1013,279,23-09-2019 20:56:00,0,4563.0,4410.0,0.966,22.862,152,97,55,42,55,16,39,50,0.0,0.09
1013,280,23-09-2019 20:58:00,0,3906.0,3675.0,0.941,19.459,324,186,136,50,138,92,46,37,0.0,0.0
1013,281,23-09-2019 21:00:00,0,4004.0,3809.0,0.951,19.993,129,66,41,25,63,41,22,88,0.01,0.0
1013,282,23-09-2019 21:02:00,0,3403.0,3230.0,0.949,16.984,211,105,79,26,106,80,26,32,0.0,0.03
1013,283,23-09-2019 21:04:00,0,4196.0,3945.0,0.94,20.899,154,106,70,36,48,10,38,49,0.0,0.0
1013,284,23-09-2019 21:06:00,0,4342.0,4051.0,0.933,21.592,78,48,32,16,30,2,28,54,0.02,0.0
1013,285,23-09-2019 21:08:00,0,4488.0,4157.0,0.926,22.285,128,49,20,29,79,39,40,50,0.0,0.05
1013,286,23-09-2019 21:10:00,0,4757.0,4591.0,0.965,23.825,134,58,39,19,76,42,34,24,0.13,0.02
1013,287,23-09-2019 21:12:00,0,4116.0,3829.0,0.93,20.458,251,125,93,32,126,90,36,63,0.02,0.01
1013,288,23-09-2019 21:14:00,0,3890.0,3676.0,0.945,19.398,181,88,52,36,93,57,36,23,0.0,0.0
1013,289,23-09-2019 21:16:00,0,3573.0,3462.0,0.969,17.912,283,142,98,44,141,105,36,56,0.0,0.03
1013,290,23-09-2019 21:18:00,0,4277.0,4150.0,0.97,21.444,228,112,73,39,116,79,37,39,0.06,0.0
1013,291,23-09-2019 21:20:00,0,3591.0,3494.0,0.973,18.015,103,28,4,24,75,42,33,1,0.03,0.0
1013,292,23-09-2019 21:22:00,0,3617.0,3395.0,0.939,18.01,112,66,36,30,46,17,29,14,0.0,0.0
1013,293,23-09-2019 21:24:00,0,4280.0,4067.0,0.95,21.365,144,85,59,26,59,10,49,70,0.0,0.0
1013,294,23-09-2019 21:26:00,0,4744.0,4626.0,0.975,23.813,124,90,56,34,34,2,32,53,0.0,0.0
1013,295,23-09-2019 21:28:00,0,4733.0,4624.0,0.977,23.766,197,101,68,33,96,55,41,62,0.0,0.04
1013,296,23-09-2019 21:30:00,0,4746.0,4640.0,0.978,23.834,121,70,46,24,51,12,39,50,0.0,0.09
1013,297,23-09-2019 21:32:00,0,4716.0,4613.0,0.978,23.687,113,66,39,27,47,0,47,57,0.0,0.08
1013,298,23-09-2019 21:34:00,0,4748.0,4708.0,0.992,23.918,279,156,115,41,123,89,34,39,0.0,0.05
1013,299,23-09-2019 21:36:00,0,4260.0,4176.0,0.98,21.407,297,114,75,39,183,141,42,27,0.19,0.0
1013,300,23-09-2019 21:38:00,0,4279.0,4088.0,0.955,21.384,60,36,16,20,24,14,10,8,0.01,0.0
1013,301,23-09-2019 21:40:00,0,4132.5,3955.5,0.957,20.66,20,14,9,5,6,2,4,0,0.0,0.0
1013,302,23-09-2019 21:42:00,0,3986.0,3823.0,0.959,19.936,0,0,0,0,0,0,0,0,0.01,0.0
1013,303,23-09-2019 21:44:00,0,3903.0,3718.0,0.952,19.494,5,5,0,5,0,0,0,0,0.0,0.0
1013,304,23-09-2019 21:46:00,0,3578.0,3505.0,0.98,17.98,6,3,1,2,3,1,2,0,0.0,0.0
1013,305,23-09-2019 21:48:00,0,3394.0,3291.0,0.97,17.015,0,0,0,0,0,0,0,0,0.0,0.0
1013,306,23-09-2019 21:50:00,0,3196.0,3094.0,0.968,16.019,8,0,0,0,8,3,5,0,0.0,0.01
1013,307,23-09-2019 21:52:00,0,3238.0,2949.0,0.91,16.024,7,3,0,3,4,2,2,0,0.0,0.0
1013,308,23-09-2019 21:54:00,0,3021.0,2906.0,0.962,15.121,5,2,0,2,3,0,3,0,0.0,0.0
1013,309,23-09-2019 21:56:00,0,3116.0,2955.0,0.948,15.548,10,10,1,9,0,0,0,0,0.0,0.0
1013,310,23-09-2019 21:58:00,0,3013.0,2936.0,0.974,15.123,0,0,0,0,0,0,0,0,0.0,0.0
1013,311,23-09-2019 22:00:00,0,2996.0,2901.0,0.968,15.015,107,16,8,8,91,59,32,0,0.0,0.0
1013,312,23-09-2019 22:02:00,0,2897.0,2859.0,0.987,14.579,3,0,0,0,3,1,2,0,0.01,0.0
1013,313,23-09-2019 22:04:00,0,3005.0,2938.0,0.978,15.094,12,9,3,6,3,0,3,0,0.0,0.0
1013,314,23-09-2019 22:06:00,0,3003.0,2939.0,0.979,15.085,9,7,0,7,2,0,2,0,0.0,0.0
1013,315,23-09-2019 22:08:00,0,3080.0,3019.0,0.98,15.478,9,1,0,1,8,2,6,0,0.0,0.0
1013,316,23-09-2019 22:10:00,0,2989.0,2988.0,0.999,15.086,30,6,0,6,24,7,17,0,0.0,0.0
1013,317,23-09-2019 22:12:00,0,3201.0,3092.0,0.966,16.035,15,4,2,2,11,1,10,0,0.0,0.0
1013,318,23-09-2019 22:14:00,0,3151.0,3058.0,0.9705,15.8,14,3,0,3,11,5,6,0,0.0,0.0
1013,319,23-09-2019 22:16:00,0,3101.0,3024.0,0.975,15.565,6,1,0,1,5,4,1,0,0.0,0.0
1013,320,23-09-2019 22:18:00,0,2875.0,2968.0,1.033,14.613,86,43,30,13,43,31,12,12,0.0,0.0
1013,321,23-09-2019 22:20:00,0,3183.0,3249.0,1.021,16.138,302,167,132,35,135,98,37,55,0.0,0.0
1013,322,23-09-2019 22:22:00,0,3573.0,3544.0,0.992,18.001,173,120,71,49,53,28,25,10,0.01,0.0
1013,323,23-09-2019 22:24:00,0,3932.0,3967.0,1.009,19.882,229,107,77,30,122,84,38,51,0.0,0.0
1013,324,23-09-2019 22:26:00,0,3537.0,3639.0,1.029,17.963,130,77,45,32,53,27,26,57,0.01,0.0
1013,325,23-09-2019 22:28:00,0,4033.0,4058.0,1.006,20.384,88,54,29,25,34,0,34,55,0.0,0.08
1013,326,23-09-2019 22:30:00,0,4251.0,4208.0,0.99,21.406,108,60,33,27,48,1,47,59,0.0,0.24
1013,327,23-09-2019 22:32:00,0,4049.0,4010.0,0.99,20.393,0,0,0,0,0,0,0,0,0.01,0.03
1013,328,23-09-2019 22:34:00,0,4048.0,4063.0,1.004,20.449,75,45,25,20,30,13,17,5,0.0,0.03
1013,329,23-09-2019 22:36:00,0,4740.0,4685.0,0.988,23.862,195,118,91,27,77,54,23,25,0.12,0.0
1013,330,23-09-2019 22:38:00,0,3764.0,3706.0,0.984,18.934,323,170,130,40,153,114,39,46,0.09,0.0
1013,331,23-09-2019 22:40:00,0,4219.0,4311.0,1.022,21.396,307,148,107,41,159,118,41,21,0.0,0.08
1013,332,23-09-2019 22:42:00,0,4550.0,4499.0,0.989,22.907,258,141,112,29,117,90,27,30,0.0,0.0
1013,333,23-09-2019 22:44:00,0,3651.0,3652.0,1.0,18.426,162,71,47,24,91,65,26,31,0.0,0.0
1013,334,23-09-2019 22:46:00,0,3564.0,3515.0,0.986,17.931,197,123,84,39,74,45,29,60,0.21,0.0
1013,335,23-09-2019 22:48:00,0,4142.0,4134.5,0.9965,20.8945,143,91,59,32,52,9,43,58,0.0,0.0
1013,336,23-09-2019 22:50:00,0,4720.0,4754.0,1.007,23.858,115,73,38,35,42,4,38,59,0.0,0.0
1013,337,23-09-2019 22:52:00,0,4736.0,4629.0,0.977,23.783,174,122,78,44,52,17,35,79,0.0,0.0
1013,338,23-09-2019 22:54:00,0,4753.0,4650.0,0.978,23.874,132,91,56,35,41,2,39,60,0.0,0.0
1013,339,23-09-2019 22:56:00,0,4732.0,4672.0,0.987,23.816,171,126,84,42,45,12,33,45,0.0,0.05
1013,340,23-09-2019 22:58:00,0,4461.0,4373.0,0.98,22.418,112,54,42,12,58,31,27,3,0.06,0.01
1013,341,23-09-2019 23:00:00,0,3783.0,3701.0,0.978,19.001,106,69,32,37,37,13,24,0,0.0,0.0
1013,342,23-09-2019 23:02:00,0,3542.0,3600.0,1.016,17.941,36,27,0,27,9,0,9,0,0.0,0.0
1013,343,23-09-2019 23:04:00,0,3585.0,3531.0,0.985,18.036,87,40,10,30,47,23,24,0,0.01,0.0
1013,344,23-09-2019 23:06:00,0,4054.0,4016.0,0.991,20.418,434,176,135,41,258,193,65,35,0.0,0.13
1013,345,23-09-2019 23:08:00,0,4745.0,4693.0,0.989,23.891,398,96,70,26,302,243,59,13,0.0,0.0
1013,346,23-09-2019 23:10:00,0,3560.0,3574.0,1.004,17.982,281,113,77,36,168,125,43,22,0.13,0.0
1013,347,23-09-2019 23:12:00,0,4450.0,4358.0,0.98,22.356,188,133,98,35,55,27,28,69,0.0,0.0
1013,348,23-09-2019 23:14:00,0,4744.0,4685.0,0.988,23.877,154,100,69,31,54,11,43,103,0.0,0.0
1013,349,23-09-2019 23:16:00,0,5020.0,4985.0,0.993,25.299,133,81,47,34,52,11,41,68,0.0,0.0
1013,350,23-09-2019 23:18:00,0,5238.0,5016.0,0.958,26.19,123,54,33,21,69,24,45,54,0.0,0.0
1013,351,23-09-2019 23:20:00,0,4915.0,4824.0,0.982,24.706,128,73,49,24,55,25,30,29,0.0,0.0
1013,352,23-09-2019 23:22:00,0,4389.0,4327.5,0.987,22.0825,160,74,50,24,86,48,38,8,0.11,0.0
1013,353,23-09-2019 23:24:00,0,3863.0,3831.0,0.992,19.459,176,103,71,32,73,48,25,42,0.01,0.0
1013,354,23-09-2019 23:26:00,0,4954.0,4788.0,0.966,24.821,163,108,69,39,55,10,45,69,0.01,0.0
1013,355,23-09-2019 23:28:00,0,5241.0,5014.0,0.957,26.198,112,65,37,28,47,9,38,55,0.0,0.0
1013,356,23-09-2019 23:30:00,0,4724.0,4703.0,0.995,23.82,334,192,135,57,142,98,44,56,0.0,0.06
1013,357,23-09-2019 23:32:00,0,4576.0,4374.0,0.956,22.871,221,123,88,35,98,62,36,10,0.09,0.0
1013,358,23-09-2019 23:34:00,0,3943.0,3920.0,0.994,19.873,221,128,90,38,93,66,27,9,0.0,0.0
1013,359,23-09-2019 23:36:00,0,3678.0,3610.0,0.981,18.487,299,182,135,47,117,87,30,14,0.09,0.06
1013,360,23-09-2019 23:38:00,0,4633.0,4522.0,0.976,23.262,158,116,81,35,42,14,28,70,0.0,0.03
1013,361,23-09-2019 23:40:00,0,4842.0,4825.0,0.997,24.418,130,79,46,33,51,2,49,62,0.0,0.0
1013,362,23-09-2019 23:42:00,0,4877.0,4989.0,1.023,24.739,159,83,44,39,76,34,42,61,0.01,0.0
1013,363,23-09-2019 23:44:00,0,4717.0,4756.0,1.008,23.849,138,83,46,37,55,19,36,56,0.0,0.01
1013,364,23-09-2019 23:46:00,0,4530.0,4504.0,0.994,22.834,126,69,42,27,57,37,20,0,0.0,0.0
1013,365,23-09-2019 23:48:00,0,3857.0,3788.0,0.982,19.39,101,15,9,6,86,56,30,1,0.0,0.01
1013,366,23-09-2019 23:50:00,0,3784.0,3691.0,0.975,18.996,34,8,1,7,26,11,15,0,0.0,0.0
1013,367,23-09-2019 23:52:00,0,3892.0,3682.0,0.946,19.411,1,0,0,0,1,1,0,0,0.0,0.0
1013,368,23-09-2019 23:54:00,0,3582.0,3540.0,0.988,18.031,9,4,2,2,5,3,2,0,0.0,0.0
1013,369,23-09-2019 23:56:00,0,3502.0,3393.5,0.9685,17.554,0,0,0,0,0,0,0,0,0.0,0.0
1013,370,23-09-2019 23:58:00,0,3422.0,3247.0,0.949,17.077,6,5,3,2,1,1,0,0,0.0,0.0
1013,371,24-09-2019 00:00:00,0,3202.0,3108.0,0.971,16.056,1,0,0,0,1,1,0,0,0.0,0.02
1013,372,24-09-2019 00:02:00,0,2990.0,2969.0,0.993,15.068,5,2,1,1,3,2,1,0,0.0,0.0
1013,373,24-09-2019 00:04:00,0,2891.0,2919.0,1.01,14.622,10,0,0,0,10,5,5,0,0.0,0.0
1013,374,24-09-2019 00:06:00,0,2906.0,2811.0,0.967,14.563,3,0,0,0,3,0,3,0,0.0,0.0
1013,375,24-09-2019 00:08:00,0,2914.0,2826.0,0.97,14.609,42,23,12,11,19,11,8,0,0.0,0.0
1013,376,24-09-2019 00:10:00,0,2893.0,2873.0,0.993,14.579,4,3,0,3,1,0,1,0,0.0,0.0
1013,377,24-09-2019 00:12:00,0,2880.0,2889.0,1.003,14.546,1,0,0,0,1,0,1,0,0.0,0.0
1013,378,24-09-2019 00:14:00,0,2977.0,2984.0,1.002,15.033,5,2,0,2,3,3,0,0,0.0,0.0
1013,379,24-09-2019 00:16:00,0,3094.0,3031.0,0.98,15.544,13,6,0,6,7,1,6,0,0.0,0.0
1013,380,24-09-2019 00:18:00,0,3190.0,3114.0,0.976,16.016,12,8,0,8,4,1,3,0,0.0,0.0
1013,381,24-09-2019 00:20:00,0,3174.0,3201.0,1.008,16.049,7,2,0,2,5,2,3,0,0.0,0.0
1013,382,24-09-2019 00:22:00,0,3167.0,3201.0,1.011,16.02,23,8,5,3,15,11,4,0,0.0,0.0
1013,383,24-09-2019 00:24:00,0,3275.0,3313.0,1.011,16.57,10,9,1,8,1,1,0,0,0.01,0.01
1013,384,24-09-2019 00:26:00,0,3159.0,3229.0,1.022,16.021,14,10,1,9,4,2,2,0,0.0,0.0
1013,385,24-09-2019 00:28:00,0,3178.0,3166.0,0.996,16.026,1,0,0,0,1,0,1,0,0.0,0.0
1013,386,24-09-2019 00:30:00,0,3184.0,3171.5,0.996,16.0555,85,45,28,17,40,28,12,0,0.0,0.0
1013,387,24-09-2019 00:32:00,0,3190.0,3177.0,0.996,16.085,15,1,0,1,14,2,12,0,0.0,0.0
1013,388,24-09-2019 00:34:00,0,3080.0,3114.0,1.011,15.584,92,3,0,3,89,67,22,0,0.0,0.0
1013,389,24-09-2019 00:36:00,0,2853.0,3037.0,1.064,14.604,7,5,1,4,2,0,2,0,0.0,0.0
1013,390,24-09-2019 00:38:00,0,2870.0,2957.0,1.03,14.579,14,5,3,2,9,3,6,0,0.0,0.0
1013,391,24-09-2019 00:40:00,0,2879.0,2934.0,1.019,14.59,5,2,1,1,3,0,3,0,0.0,0.0
1013,392,24-09-2019 00:42:00,0,2887.0,2915.0,1.01,14.6,34,18,7,11,16,2,14,0,0.0,0.0
1013,393,24-09-2019 00:44:00,0,2869.0,3014.0,1.051,14.64,261,147,115,32,114,76,38,37,0.0,0.0
1013,394,24-09-2019 00:46:00,0,3555.0,3617.0,1.017,18.012,260,149,104,45,111,71,40,51,0.0,0.0
1013,395,24-09-2019 00:48:00,0,3456.0,3566.0,1.032,17.566,217,121,71,50,96,64,32,36,0.0,0.0
1013,396,24-09-2019 00:50:00,0,3547.0,3661.0,1.032,18.028,239,129,88,41,110,76,34,41,0.0,0.0
1013,397,24-09-2019 00:52:00,0,3541.0,3625.0,1.024,17.963,66,33,26,7,33,16,17,18,0.0,0.0
1013,398,24-09-2019 00:54:00,0,3539.0,3656.0,1.033,17.993,126,56,25,31,70,35,35,1,0.0,0.0
1013,399,24-09-2019 00:56:00,0,3531.0,3686.0,1.044,17.993,156,85,62,23,71,47,24,26,0.0,0.0
1013,400,24-09-2019 00:58:00,0,3837.0,3989.0,1.04,19.533,130,79,48,31,51,14,37,80,0.0,0.0
1013,401,24-09-2019 01:00:00,0,4233.0,4220.0,0.997,21.351,120,76,40,36,44,19,25,60,0.0,0.0
1013,402,24-09-2019 01:02:00,0,4221.0,4309.0,1.021,21.402,128,52,28,24,76,34,42,42,0.0,0.0
1013,403,24-09-2019 01:04:00,0,4392.5,4390.0,1.0005,22.1665,123,85,46,39,38,0,38,59,0.0,0.05
1013,404,24-09-2019 01:06:00,0,4564.0,4471.0,0.98,22.931,128,79,43,36,49,6,43,61,0.0,0.11
1013,405,24-09-2019 01:08:00,0,4518.0,4478.0,0.991,22.76,122,72,34,38,50,13,37,43,0.17,0.07
1013,406,24-09-2019 01:10:00,0,3857.0,3884.0,1.007,19.497,58,19,12,7,39,29,10,1,0.0,0.0
1013,407,24-09-2019 01:12:00,0,3871.0,3785.0,0.978,19.443,64,35,25,10,29,12,17,8,0.0,0.0
1013,408,24-09-2019 01:14:00,0,3359.0,3402.0,1.013,16.999,251,123,93,30,128,95,33,75,0.17,0.01
1013,409,24-09-2019 01:16:00,0,3642.0,3748.0,1.029,18.496,216,84,53,31,132,97,35,14,0.01,0.0
1013,410,24-09-2019 01:18:00,0,4269.0,4122.0,0.966,21.383,113,68,42,26,45,12,33,78,0.01,0.0
1013,411,24-09-2019 01:20:00,0,4626.0,4654.0,1.006,23.378,133,67,41,26,66,36,30,53,0.01,0.0
1013,412,24-09-2019 01:22:00,0,4692.0,4802.0,1.023,23.804,138,63,34,29,75,40,35,36,0.1,0.1
1013,413,24-09-2019 01:24:00,0,4542.0,4521.0,0.995,22.9,285,159,117,42,126,85,41,19,0.02,0.01
1013,414,24-09-2019 01:26:00,0,4753.0,4669.0,0.982,23.893,323,202,164,38,121,84,37,19,0.02,0.04
1013,415,24-09-2019 01:28:00,0,4553.0,4404.0,0.967,22.815,219,113,77,36,106,66,40,0,0.0,0.07
1013,416,24-09-2019 01:30:00,0,3755.0,3715.0,0.989,18.909,188,104,68,36,84,57,27,12,0.0,0.0
1013,417,24-09-2019 01:32:00,0,4654.0,4570.0,0.982,23.397,128,58,28,30,70,40,30,33,0.04,0.0
1013,418,24-09-2019 01:34:00,0,4519.0,4596.0,1.017,22.892,139,91,58,33,48,3,45,53,0.03,0.0
1013,419,24-09-2019 01:36:00,0,4926.0,4882.0,0.991,24.812,194,108,69,39,86,40,46,53,0.0,0.0
1013,420,24-09-2019 01:38:00,0,4143.5,4150.5,1.004,20.919,69,31,10,21,38,11,27,0,0.0,0.0
1013,421,24-09-2019 01:40:00,0,3361.0,3419.0,1.017,17.026,70,28,16,12,42,11,31,0,0.0,0.0
1013,422,24-09-2019 01:42:00,0,3371.0,3348.0,0.993,16.987,61,35,11,24,26,16,10,0,0.0,0.0
1013,423,24-09-2019 01:44:00,0,3866.0,3843.0,0.994,19.486,2,0,0,0,2,0,2,0,0.0,0.0
1013,424,24-09-2019 01:46:00,0,3849.0,3915.0,1.017,19.499,105,67,48,19,38,20,18,0,0.0,0.0
1013,425,24-09-2019 01:48:00,0,3851.0,3860.0,1.003,19.445,594,372,307,65,222,161,61,11,0.0,0.0
1013,426,24-09-2019 01:50:00,0,3577.0,3501.0,0.979,17.97,480,282,219,63,198,143,55,24,0.0,0.0
1013,427,24-09-2019 01:52:00,0,3845.0,3902.0,1.015,19.468,533,251,202,49,282,224,58,28,0.0,0.02
1013,428,24-09-2019 01:54:00,0,4223.0,4223.0,1.0,21.314,687,343,280,63,344,268,76,22,0.0,0.0
1013,429,24-09-2019 01:56:00,0,4050.0,4051.0,1.0,20.44,164,71,44,27,93,58,35,73,0.0,0.0
1013,430,24-09-2019 01:58:00,0,4231.0,4311.0,1.019,21.441,130,67,42,25,63,35,28,74,0.0,0.0
1013,431,24-09-2019 02:00:00,0,4335.0,4396.0,1.014,21.947,99,60,40,20,39,3,36,58,0.0,0.0
1013,432,24-09-2019 02:02:00,0,4341.0,4371.0,1.007,21.942,96,53,29,24,43,7,36,51,0.0,0.04
1013,433,24-09-2019 02:04:00,0,4459.0,4375.0,0.981,22.41,209,134,97,37,75,39,36,37,0.0,0.04
1013,434,24-09-2019 02:06:00,0,3529.0,3647.0,1.033,17.942,437,232,187,45,205,144,61,4,0.0,0.01
1013,435,24-09-2019 02:08:00,0,3590.0,3489.0,0.972,18.007,474,259,196,63,215,149,66,14,0.06,0.0
1013,436,24-09-2019 02:10:00,0,3288.0,3232.0,0.983,16.531,67,30,8,22,37,14,23,0,0.0,0.0
1013,437,24-09-2019 02:12:00,0,3484.5,3436.5,0.986,17.5315,82,36,15,21,46,25,21,0,0.0,0.0
1013,438,24-09-2019 02:14:00,0,3681.0,3641.0,0.989,18.532,3,1,0,1,2,2,0,0,0.0,0.0
1013,439,24-09-2019 02:16:00,0,3689.0,3561.0,0.965,18.476,13,0,0,0,13,4,9,0,0.01,0.0
1013,440,24-09-2019 02:18:00,0,3692.0,3545.0,0.96,18.472,0,0,0,0,0,0,0,0,0.01,0.01
1013,441,24-09-2019 02:20:00,0,3699.0,3516.0,0.951,18.466,18,11,7,4,7,2,5,0,0.0,0.0
1013,442,24-09-2019 02:22:00,0,3691.0,3579.0,0.97,18.505,7,3,2,1,4,1,3,0,0.0,0.0
1013,443,24-09-2019 02:24:00,0,3465.0,3419.0,0.987,17.436,9,7,3,4,2,2,0,0,0.0,0.0
1013,444,24-09-2019 02:26:00,0,3501.0,3339.0,0.954,17.489,17,7,0,7,10,2,8,0,0.0,0.0
1013,445,24-09-2019 02:28:00,0,3287.0,3249.0,0.988,16.549,24,8,6,2,16,9,7,0,0.0,0.0
1013,446,24-09-2019 02:30:00,0,3297.0,3173.0,0.962,16.504,35,8,4,4,27,10,17,0,0.0,0.0
1013,447,24-09-2019 02:32:00,0,2970.0,3012.0,1.014,15.034,0,0,0,0,0,0,0,0,0.0,0.0
1013,448,24-09-2019 02:34:00,0,3008.0,2933.0,0.975,15.097,7,5,0,5,2,1,1,0,0.0,0.0
1013,449,24-09-2019 02:36:00,0,3019.0,2921.0,0.967,15.127,2,0,0,0,2,2,0,0,0.0,0.0
1013,450,24-09-2019 02:38:00,0,2996.0,2917.0,0.974,15.035,4,2,1,1,2,1,1,0,0.0,0.0
1013,451,24-09-2019 02:40:00,0,3013.0,2906.0,0.965,15.087,10,9,4,5,1,0,1,0,0.0,0.0
1013,452,24-09-2019 02:42:00,0,2988.0,2967.0,0.993,15.059,7,5,1,4,2,2,0,0,0.0,0.0
1013,453,24-09-2019 02:44:00,0,3005.0,2949.0,0.982,15.104,16,15,1,14,1,1,0,0,0.0,0.0
1013,454,24-09-2019 02:46:00,0,2936.5,2954.5,1.007,14.8395,8,3,1,2,5,0,5,0,0.0,0.0
1013,455,24-09-2019 02:48:00,0,2868.0,2960.0,1.032,14.575,14,12,2,10,2,0,2,0,0.0,0.0
1013,456,24-09-2019 02:50:00,0,2871.0,2945.0,1.026,14.571,8,0,0,0,8,3,5,0,0.0,0.0
1013,457,24-09-2019 02:52:00,0,2882.0,2906.0,1.008,14.572,45,15,6,9,30,14,16,0,0.0,0.0
1013,458,24-09-2019 02:54:00,0,2904.0,2852.0,0.982,14.6,43,14,6,8,29,12,17,0,0.0,0.0
1013,459,24-09-2019 02:56:00,0,2899.0,2844.0,0.981,14.572,10,2,0,2,8,0,8,0,0.0,0.0
1013,460,24-09-2019 02:58:00,0,2902.0,2865.0,0.987,14.606,11,6,1,5,5,2,3,0,0.0,0.0
1013,461,24-09-2019 03:00:00,0,2792.0,2822.0,1.011,14.123,27,9,1,8,18,1,17,0,0.0,0.0
1013,462,24-09-2019 03:02:00,0,2671.0,2775.0,1.039,13.595,16,13,3,10,3,1,2,0,0.0,0.0
1013,463,24-09-2019 03:04:00,0,2671.0,2825.0,1.058,13.651,22,21,13,8,1,0,1,0,0.0,0.0
1013,464,24-09-2019 03:06:00,0,2676.0,2775.0,1.037,13.616,29,26,19,7,3,2,1,0,0.0,0.0
1013,465,24-09-2019 03:08:00,0,2686.0,2729.0,1.016,13.605,27,10,1,9,17,3,14,0,0.0,0.0
1013,466,24-09-2019 03:10:00,0,2697.0,2713.0,1.006,13.628,9,0,0,0,9,1,8,0,0.0,0.0
1013,467,24-09-2019 03:12:00,0,2700.0,2667.0,0.988,13.59,18,9,5,4,9,1,8,0,0.0,0.0
1013,468,24-09-2019 03:14:00,0,2692.0,2699.0,1.003,13.594,15,8,2,6,7,0,7,0,0.0,0.0
1013,469,24-09-2019 03:16:00,0,2711.0,2627.0,0.969,13.59,11,11,0,11,0,0,0,0,0.0,0.0
1013,470,24-09-2019 03:18:00,0,2712.0,2624.0,0.968,13.589,33,18,5,13,15,4,11,0,0.0,0.0
1013,471,24-09-2019 03:20:00,0,2609.5,2570.5,0.986,13.1265,2,2,0,2,0,0,0,0,0.0,0.0
1013,472,24-09-2019 03:22:00,0,2507.0,2517.0,1.004,12.664,4,0,0,0,4,2,2,0,0.0,0.0
1013,473,24-09-2019 03:24:00,0,2502.0,2456.0,0.982,12.576,10,5,0,5,5,2,3,0,0.0,0.0
1013,474,24-09-2019 03:26:00,0,2514.0,2531.0,1.007,12.707,0,0,0,0,0,0,0,0,0.0,0.0
1013,475,24-09-2019 03:28:00,0,2610.0,2580.0,0.989,13.138,0,0,0,0,0,0,0,0,0.0,0.0
1013,476,24-09-2019 03:30:00,0,2705.0,2613.0,0.966,13.55,31,13,7,6,18,9,9,0,0.0,0.01
1013,477,24-09-2019 03:32:00,0,2707.0,2645.0,0.977,13.593,10,7,1,6,3,1,2,0,0.0,0.0
1013,478,24-09-2019 03:34:00,0,2498.0,2561.0,1.025,12.676,2,1,1,0,1,1,0,0,0.0,0.0
1013,479,24-09-2019 03:36:00,0,2710.0,2652.0,0.979,13.611,77,52,38,14,25,16,9,1,0.0,0.0
1013,480,24-09-2019 03:38:00,0,2889.0,2885.0,0.999,14.575,6,6,0,6,0,0,0,0,0.0,0.0
1013,481,24-09-2019 03:40:00,0,2785.0,2832.0,1.017,14.106,0,0,0,0,0,0,0,0,0.0,0.0
1013,482,24-09-2019 03:42:00,0,2669.0,2787.0,1.044,13.6,5,0,0,0,5,1,4,0,0.0,0.0
1013,483,24-09-2019 03:44:00,0,2674.0,2750.0,1.028,13.581,1,0,0,0,1,0,1,0,0.0,0.0
1013,484,24-09-2019 03:46:00,0,2691.0,2779.0,1.033,13.678,2,0,0,0,2,2,0,0,0.0,0.0
1013,485,24-09-2019 03:48:00,0,2676.0,2752.0,1.028,13.588,3,1,1,0,2,0,2,0,0.0,0.0
1013,486,24-09-2019 03:50:00,0,2703.0,2709.0,1.002,13.648,27,20,2,18,7,2,5,0,0.0,0.0
1013,487,24-09-2019 03:52:00,0,2593.0,2609.0,1.006,13.106,10,0,0,0,10,5,5,0,0.0,0.0
1013,488,24-09-2019 03:54:00,0,2643.0,2647.5,1.002,13.3445,11,2,1,1,9,5,4,0,0.0,0.0
1013,489,24-09-2019 03:56:00,0,2693.0,2686.0,0.998,13.583,9,2,1,1,7,4,3,0,0.0,0.0
1013,490,24-09-2019 03:58:00,0,2699.0,2701.0,1.001,13.625,257,120,87,33,137,92,45,14,0.0,0.0
1013,491,24-09-2019 04:00:00,0,2881.0,2929.0,1.017,14.594,208,30,3,27,178,122,56,0,0.0,0.0
1013,492,24-09-2019 04:02:00,0,2861.0,3054.0,1.067,14.655,51,26,8,18,25,3,22,0,0.0,0.0
1013,493,24-09-2019 04:04:00,0,3070.0,3102.0,1.01,15.531,66,33,16,17,33,5,28,0,0.0,0.0
1013,494,24-09-2019 04:06:00,0,3084.0,3097.0,1.004,15.579,57,34,10,24,23,7,16,0,0.0,0.0
1013,495,24-09-2019 04:08:00,0,3189.0,3107.0,0.974,16.005,51,39,14,25,12,1,11,0,0.0,0.0
1013,496,24-09-2019 04:10:00,0,3191.0,3185.0,0.998,16.098,180,91,60,31,89,63,26,39,0.0,0.0
1013,497,24-09-2019 04:12:00,0,3570.0,3609.0,1.011,18.061,359,179,143,36,180,139,41,70,0.0,0.0
1013,498,24-09-2019 04:14:00,0,3563.0,3579.0,1.004,18.002,249,112,76,36,137,96,41,55,0.0,0.0
1013,499,24-09-2019 04:16:00,0,3342.0,3453.0,1.033,16.989,110,70,50,20,40,30,10,4,0.0,0.0
1013,500,24-09-2019 04:18:00,0,3374.0,3377.0,1.001,17.032,14,7,3,4,7,3,4,0,0.0,0.0
1013,501,24-09-2019 04:20:00,0,3382.0,3313.0,0.979,16.993,7,1,0,1,6,0,6,0,0.0,0.0
1013,502,24-09-2019 04:22:00,0,3279.0,3242.0,0.988,16.509,0,0,0,0,0,0,0,0,0.0,0.0
1013,503,24-09-2019 04:24:00,0,3193.0,3145.0,0.985,16.06,31,9,3,6,22,4,18,0,0.0,0.0
1013,504,24-09-2019 04:26:00,0,3199.0,3085.0,0.965,16.019,51,43,3,40,8,2,6,0,0.0,0.0
1013,505,24-09-2019 04:28:00,0,3244.5,3181.5,0.9805,16.3055,44,12,3,9,32,8,24,0,0.0,0.0
1013,506,24-09-2019 04:30:00,0,3290.0,3278.0,0.996,16.592,91,45,21,24,46,27,19,10,0.0,0.0
1013,507,24-09-2019 04:32:00,0,3182.0,3184.0,1.001,16.063,4,3,0,3,1,0,1,0,0.0,0.0
1013,508,24-09-2019 04:34:00,0,2880.0,2904.0,1.008,14.56,7,7,0,7,0,0,0,0,0.0,0.0
1013,509,24-09-2019 04:36:00,0,2914.0,2790.0,0.957,14.571,10,7,0,7,3,0,3,0,0.0,0.0
1013,510,24-09-2019 04:38:00,0,2694.0,2722.0,1.01,13.628,0,0,0,0,0,0,0,0,0.0,0.0
1013,511,24-09-2019 04:40:00,0,2711.0,2654.0,0.979,13.62,28,15,7,8,13,7,6,0,0.0,0.0
1013,512,24-09-2019 04:42:00,0,2722.0,2575.0,0.946,13.577,9,6,2,4,3,1,2,0,0.0,0.0
1013,513,24-09-2019 04:44:00,0,2513.0,2479.0,0.986,12.647,6,2,0,2,4,0,4,0,0.0,0.0
1013,514,24-09-2019 04:46:00,0,2517.0,2453.0,0.975,12.631,7,6,3,3,1,0,1,0,0.0,0.0
1013,515,24-09-2019 04:48:00,0,2532.0,2460.0,0.971,12.7,3,0,0,0,3,0,3,0,0.0,0.0
1013,516,24-09-2019 04:50:00,0,2516.0,2451.0,0.974,12.624,5,1,0,1,4,0,4,0,0.0,0.0
1013,517,24-09-2019 04:52:00,0,2510.0,2470.0,0.984,12.624,235,233,195,38,2,0,2,0,0.0,0.0
1013,518,24-09-2019 04:54:00,0,2615.0,2530.0,0.967,13.105,36,19,8,11,17,4,13,0,0.0,0.0
1013,519,24-09-2019 04:56:00,0,2721.0,2595.0,0.954,13.594,13,6,4,2,7,0,7,0,0.0,0.0
1013,520,24-09-2019 04:58:00,0,2733.0,2619.0,0.958,13.665,0,0,0,0,0,0,0,0,0.0,0.0
1013,521,24-09-2019 05:00:00,0,2725.0,2581.0,0.947,13.593,26,15,9,6,11,4,7,0,0.0,0.0
1013,522,24-09-2019 05:02:00,0,2720.5,2587.5,0.951,13.5815,10,4,1,3,6,1,5,0,0.0,0.0
1013,523,24-09-2019 05:04:00,0,2716.0,2594.0,0.955,13.57,3,1,0,1,2,0,2,0,0.01,0.0
1013,524,24-09-2019 05:06:00,0,2725.0,2600.0,0.954,13.616,32,17,6,11,15,7,8,0,0.0,0.0
1013,525,24-09-2019 05:08:00,0,2737.0,2526.0,0.923,13.579,38,30,10,20,8,1,7,0,0.0,0.0
1013,526,24-09-2019 05:10:00,0,2619.0,2521.0,0.963,13.109,244,136,94,42,108,74,34,52,0.0,0.0
1013,527,24-09-2019 05:12:00,0,2994.0,2940.0,0.982,15.053,154,91,53,38,63,29,34,68,0.0,0.0
1013,528,24-09-2019 05:14:00,0,3204.0,3134.0,0.978,16.093,118,72,35,37,46,12,34,48,0.0,0.0
1013,529,24-09-2019 05:16:00,0,3398.0,3311.0,0.974,17.052,129,94,54,40,35,1,34,63,0.0,0.01
1013,530,24-09-2019 05:18:00,0,3785.0,3635.0,0.96,18.936,82,44,26,18,38,0,38,51,0.0,0.0
1013,531,24-09-2019 05:20:00,0,3795.0,3674.0,0.968,19.019,135,54,36,18,81,42,39,29,0.0,0.08
1013,532,24-09-2019 05:22:00,0,3886.0,3739.0,0.962,19.449,125,45,23,22,80,37,43,34,0.0,0.0
1013,533,24-09-2019 05:24:00,0,3764.0,3643.0,0.968,18.865,137,73,48,25,64,24,40,44,0.0,0.11
1013,534,24-09-2019 05:26:00,0,3894.0,3734.0,0.959,19.475,246,130,95,35,116,67,49,49,0.0,0.03
1013,535,24-09-2019 05:28:00,0,3601.0,3399.0,0.944,17.951,52,27,14,13,25,10,15,4,0.09,0.0
1013,536,24-09-2019 05:30:00,0,4570.0,4366.0,0.955,22.838,247,113,78,35,134,96,38,26,0.06,0.03
1013,537,24-09-2019 05:32:00,0,3294.0,3164.0,0.96,16.482,308,171,120,51,137,93,44,85,0.0,0.0
1013,538,24-09-2019 05:34:00,0,4184.0,3980.0,0.951,20.89,88,54,36,18,34,23,11,20,0.19,0.0
1013,539,24-09-2019 05:36:00,0,3788.5,3651.5,0.965,18.9685,267,141,104,37,126,90,36,19,0.0,0.0
1013,540,24-09-2019 05:38:00,0,3393.0,3323.0,0.979,17.047,77,33,7,26,44,14,30,0,0.0,0.0
1013,541,24-09-2019 05:40:00,0,3563.0,3544.0,0.994,17.962,79,47,15,32,32,15,17,0,0.0,0.0
1013,542,24-09-2019 05:42:00,0,3559.0,3487.0,0.98,17.882,277,195,156,39,82,52,30,12,0.0,0.0
1013,543,24-09-2019 05:44:00,0,3784.0,3692.0,0.976,18.997,25,14,3,11,11,0,11,0,0.0,0.0
1013,544,24-09-2019 05:46:00,0,3613.0,3425.0,0.948,18.026,145,84,52,32,61,32,29,47,0.0,0.0
1013,545,24-09-2019 05:48:00,0,4259.0,4141.0,0.972,21.366,160,48,26,22,112,55,57,38,0.0,0.0
1013,546,24-09-2019 05:50:00,0,4576.0,4330.0,0.946,22.822,186,81,42,39,105,44,61,58,0.0,0.0
1013,547,24-09-2019 05:52:00,0,4579.0,4394.0,0.96,22.906,149,80,44,36,69,37,32,56,0.0,0.03
1013,548,24-09-2019 05:54:00,0,4461.0,4300.0,0.964,22.337,117,74,47,27,43,13,30,53,0.0,0.02
1013,549,24-09-2019 05:56:00,0,4186.0,4035.0,0.964,20.959,113,47,27,20,66,33,33,37,0.0,0.01
1013,550,24-09-2019 05:58:00,0,4271.0,4136.0,0.968,21.408,128,80,50,30,48,0,48,76,0.0,0.04
1013,551,24-09-2019 06:00:00,1,4460.0,4260.0,0.955,22.287,215,118,82,36,97,55,42,54,0.0,0.06
1013,552,24-09-2019 06:02:00,1,3768.0,3707.0,0.984,18.948,261,120,84,36,141,95,46,21,0.0,0.01
1013,553,24-09-2019 06:04:00,1,3970.0,3881.0,0.978,19.938,167,88,65,23,79,55,24,50,0.13,0.0
1013,554,24-09-2019 06:06:00,1,4087.0,3964.0,0.97,20.491,233,166,115,51,67,43,24,74,0.01,0.0
1013,555,24-09-2019 06:08:00,1,3949.0,3921.0,0.993,19.902,254,143,97,46,111,81,30,16,0.14,0.03
1013,556,24-09-2019 06:10:00,1,3775.5,3650.5,0.9655,18.9175,121,54,31,23,67,30,37,0,0.0,0.0
1013,557,24-09-2019 06:12:00,1,3602.0,3380.0,0.938,17.933,67,31,5,26,36,13,23,0,0.0,0.0
1013,558,24-09-2019 06:14:00,1,3381.0,3326.0,0.984,17.001,0,0,0,0,0,0,0,0,0.0,0.0
1013,559,24-09-2019 06:16:00,1,3508.0,3366.0,0.96,17.546,7,2,0,2,5,2,3,0,0.0,0.0
1013,560,24-09-2019 06:18:00,1,3413.0,3219.0,0.943,17.009,2,1,0,1,1,0,1,0,0.0,0.0
1013,561,24-09-2019 06:20:00,1,3402.0,3265.0,0.96,17.018,18,5,2,3,13,2,11,0,0.0,0.0
1013,562,24-09-2019 06:22:00,1,3313.0,3179.0,0.959,16.574,4,4,1,3,0,0,0,0,0.0,0.0
1013,563,24-09-2019 06:24:00,1,3211.0,3021.0,0.941,15.997,58,17,3,14,41,21,20,0,0.0,0.0
1013,564,24-09-2019 06:26:00,1,3199.0,3134.0,0.98,16.075,232,131,95,36,101,71,30,35,0.0,0.0
1013,565,24-09-2019 06:28:00,1,3609.0,3405.0,0.944,17.989,190,94,71,23,96,69,27,43,0.0,0.0
1013,566,24-09-2019 06:30:00,1,3566.0,3579.0,1.004,18.012,82,54,26,28,28,12,16,46,0.0,0.0
1013,567,24-09-2019 06:32:00,1,4095.0,3978.0,0.972,20.537,108,64,36,28,44,6,38,62,0.0,0.01
1013,568,24-09-2019 06:34:00,1,4059.0,3980.0,0.981,20.4,86,39,19,20,47,0,47,51,0.0,0.04
1013,569,24-09-2019 06:36:00,1,4250.0,4116.0,0.969,21.3,102,58,29,29,44,3,41,49,0.0,0.04
1013,570,24-09-2019 06:38:00,1,4248.0,4236.0,0.997,21.426,188,122,88,34,66,28,38,58,0.0,0.06
1013,571,24-09-2019 06:40:00,1,3365.0,3409.0,1.013,17.032,185,105,69,36,80,49,31,30,0.0,0.0
1013,572,24-09-2019 06:42:00,1,3878.0,3814.0,0.984,19.502,63,34,22,12,29,20,9,1,0.0,0.0
1013,573,24-09-2019 06:44:00,1,3924.5,3824.0,0.9745,19.6965,517,266,201,65,251,194,57,18,0.04,0.06
1013,574,24-09-2019 06:46:00,1,3971.0,3834.0,0.965,19.891,471,295,230,65,176,130,46,25,0.01,0.0
1013,575,24-09-2019 06:48:00,1,4084.0,3881.0,0.95,20.386,45,45,14,31,0,0,0,2,0.0,0.0
1013,576,24-09-2019 06:50:00,1,3684.0,3619.0,0.982,18.521,155,113,81,32,42,9,33,33,0.02,0.14
1013,577,24-09-2019 06:52:00,1,4257.0,4134.0,0.971,21.35,104,58,30,28,46,13,33,41,0.0,0.0
1013,578,24-09-2019 06:54:00,1,4491.0,4279.0,0.953,22.43,87,58,34,24,29,0,29,52,0.0,0.0
1013,579,24-09-2019 06:56:00,1,4574.0,4314.0,0.943,22.797,218,129,99,30,89,58,31,25,0.0,0.0
1013,580,24-09-2019 06:58:00,1,3580.0,3561.0,0.994,18.048,503,328,254,74,175,131,44,6,0.09,0.08
1013,581,24-09-2019 07:00:00,1,3860.0,3800.0,0.985,19.415,539,358,291,67,181,140,41,3,0.03,0.0
1013,582,24-09-2019 07:02:00,1,3385.0,3326.0,0.982,17.02,29,23,1,22,6,0,6,0,0.0,0.0
1013,583,24-09-2019 07:04:00,1,3314.0,3146.0,0.949,16.542,44,10,3,7,34,9,25,0,0.0,0.0
1013,584,24-09-2019 07:06:00,1,3564.0,3525.0,0.989,17.946,73,41,13,28,32,13,19,0,0.0,0.0
1013,585,24-09-2019 07:08:00,1,3583.0,3551.0,0.991,18.048,424,238,178,60,186,138,48,8,0.0,0.0
1013,586,24-09-2019 07:10:00,1,3886.0,3742.0,0.963,19.452,598,372,296,76,226,174,52,5,0.0,0.0
1013,587,24-09-2019 07:12:00,1,3872.0,3813.0,0.985,19.476,193,134,95,39,59,30,29,30,0.0,0.0
1013,588,24-09-2019 07:14:00,1,3553.0,3575.0,1.006,17.957,37,8,3,5,29,1,28,0,0.0,0.0
1013,589,24-09-2019 07:16:00,1,3918.0,3661.0,0.935,19.489,49,33,15,18,16,1,15,0,0.0,0.0
1013,590,24-09-2019 07:18:00,1,3769.5,3501.5,0.929,18.728,34,13,7,6,21,0,21,0,0.0,0.0
1013,591,24-09-2019 07:20:00,1,3621.0,3342.0,0.923,17.967,5,0,0,0,5,0,5,0,0.0,0.0
1013,592,24-09-2019 07:22:00,1,3436.0,3215.0,0.936,17.097,0,0,0,0,0,0,0,0,0.0,0.0
1013,593,24-09-2019 07:24:00,1,3326.0,3108.0,0.935,16.544,10,6,1,5,4,2,2,0,0.0,0.0
1013,594,24-09-2019 07:26:00,1,3210.0,3011.0,0.938,15.981,12,1,0,1,11,6,5,0,0.0,0.0
1013,595,24-09-2019 07:28:00,1,3112.0,2932.0,0.942,15.506,22,4,1,3,18,3,15,0,0.0,0.0
1013,596,24-09-2019 07:30:00,1,2890.0,2792.0,0.966,14.477,33,0,0,0,33,3,30,0,0.0,0.0
1013,597,24-09-2019 07:32:00,1,2940.0,2711.0,0.922,14.586,35,6,4,2,29,1,28,0,0.0,0.0
1013,598,24-09-2019 07:34:00,1,2726.0,2614.0,0.959,13.633,0,0,0,0,0,0,0,0,0.0,0.0
1013,599,24-09-2019 07:36:00,1,2740.0,2538.0,0.926,13.607,0,0,0,0,0,0,0,0,0.0,0.0
1013,600,24-09-2019 07:38:00,1,2749.0,2499.0,0.909,13.599,9,4,0,4,5,1,4,0,0.0,0.0
1013,601,24-09-2019 07:40:00,1,2758.0,2491.0,0.903,13.624,3,0,0,0,3,0,3,0,0.0,0.0
1013,602,24-09-2019 07:42:00,1,2644.0,2450.0,0.927,13.129,0,0,0,0,0,0,0,0,0.0,0.0
1013,603,24-09-2019 07:44:00,1,2521.0,2405.0,0.954,12.594,5,0,0,0,5,2,3,0,0.0,0.0
1013,604,24-09-2019 07:46:00,1,2528.0,2400.0,0.949,12.62,0,0,0,0,0,0,0,0,0.0,0.0
1013,605,24-09-2019 07:48:00,1,2538.0,2388.0,0.941,12.643,0,0,0,0,0,0,0,0,0.0,0.0
1013,606,24-09-2019 07:50:00,1,2541.0,2391.0,0.941,12.659,22,11,5,6,11,5,6,0,0.0,0.0
1013,607,24-09-2019 07:52:00,1,2626.0,2520.0,0.959,13.1355,1,1,0,1,0,0,0,0,0.0,0.0
1013,608,24-09-2019 07:54:00,1,2711.0,2649.0,0.977,13.612,0,0,0,0,0,0,0,0,0.0,0.0
1013,609,24-09-2019 07:56:00,1,2736.0,2553.0,0.933,13.607,0,0,0,0,0,0,0,0,0.0,0.0
1013,610,24-09-2019 07:58:00,1,2524.0,2428.0,0.962,12.632,0,0,0,0,0,0,0,0,0.0,0.0
1013,611,24-09-2019 08:00:00,1,2526.0,2439.0,0.966,12.651,0,0,0,0,0,0,0,0,0.0,0.0
1013,612,24-09-2019 08:02:00,1,2644.0,2473.0,0.935,13.155,0,0,0,0,0,0,0,0,0.0,0.0
1013,613,24-09-2019 08:04:00,1,2727.0,2537.0,0.93,13.552,29,15,11,4,14,5,9,0,0.0,0.0
1013,614,24-09-2019 08:06:00,1,2647.0,2427.0,0.917,13.117,6,0,0,0,6,0,6,0,0.0,0.0
1013,615,24-09-2019 08:08:00,1,2758.0,2447.0,0.887,13.577,0,0,0,0,0,0,0,0,0.0,0.0
1013,616,24-09-2019 08:10:00,1,2544.0,2360.0,0.928,12.636,24,11,2,9,13,7,6,0,0.0,0.0
1013,617,24-09-2019 08:12:00,1,2545.0,2371.0,0.932,12.653,6,4,1,3,2,0,2,0,0.0,0.0
1013,618,24-09-2019 08:14:00,1,2548.0,2351.0,0.923,12.642,4,4,0,4,0,0,0,0,0.0,0.0
1013,619,24-09-2019 08:16:00,1,2549.0,2355.0,0.924,12.652,0,0,0,0,0,0,0,0,0.0,0.0
1013,620,24-09-2019 08:18:00,1,2536.0,2358.0,0.93,12.601,0,0,0,0,0,0,0,0,0.0,0.0
1013,621,24-09-2019 08:20:00,1,2556.0,2315.0,0.905,12.635,1,1,0,1,0,0,0,0,0.0,0.0
1013,622,24-09-2019 08:22:00,1,2557.0,2266.0,0.886,12.582,0,0,0,0,0,0,0,0,0.0,0.0
1013,623,24-09-2019 08:24:00,1,2555.0,2274.0,0.89,12.582,2,0,0,0,2,1,1,0,0.0,0.0
1013,624,24-09-2019 08:26:00,1,2606.0,2308.5,0.886,12.8225,4,1,0,1,3,0,3,0,0.0,0.0
1013,625,24-09-2019 08:28:00,1,2657.0,2343.0,0.882,13.063,9,8,4,4,1,0,1,0,0.0,0.0
1013,626,24-09-2019 08:30:00,1,2655.0,2381.0,0.897,13.098,7,1,0,1,6,2,4,0,0.0,0.0
1013,627,24-09-2019 08:32:00,1,2760.0,2409.0,0.873,13.539,131,74,37,37,57,32,25,0,0.0,0.0
1013,628,24-09-2019 08:34:00,1,2926.0,2800.0,0.957,14.63,168,90,62,28,78,46,32,43,0.0,0.0
1013,629,24-09-2019 08:36:00,1,2905.0,2792.0,0.961,14.536,133,77,47,30,56,31,25,46,0.0,0.0
1013,630,24-09-2019 08:38:00,1,3410.0,3195.0,0.937,16.974,172,114,81,33,58,37,21,33,0.0,0.0
1013,631,24-09-2019 08:40:00,1,3431.0,3126.0,0.911,16.979,83,47,24,23,36,5,31,59,0.0,0.0
1013,632,24-09-2019 08:42:00,1,3617.0,3395.0,0.939,18.01,89,52,25,27,37,3,34,37,0.0,0.0
1013,633,24-09-2019 08:44:00,1,3914.0,3603.0,0.92,19.412,123,72,42,30,51,26,25,26,0.0,0.0
1013,634,24-09-2019 08:46:00,1,3709.0,3537.0,0.954,18.531,247,140,106,34,107,80,27,32,0.0,0.0
1013,635,24-09-2019 08:48:00,1,3007.0,2858.0,0.95,15.013,398,253,194,59,145,110,35,20,0.0,0.0
1013,636,24-09-2019 08:50:00,1,3903.0,3648.0,0.935,19.418,303,172,125,47,131,97,34,42,0.0,0.02
1013,637,24-09-2019 08:52:00,1,3438.0,3150.0,0.916,17.035,83,10,6,4,73,35,38,0,0.0,0.0
1013,638,24-09-2019 08:54:00,1,3259.0,2937.0,0.901,16.092,78,30,13,17,48,18,30,0,0.0,0.0
1013,639,24-09-2019 08:56:00,1,3239.0,2957.0,0.913,16.036,55,37,5,32,18,2,16,0,0.0,0.0
1013,640,24-09-2019 08:58:00,1,3409.0,3229.0,0.947,17.007,31,18,1,17,13,5,8,0,0.0,0.0
1013,641,24-09-2019 09:00:00,1,3322.0,3119.5,0.9385,16.543,0,0,0,0,0,0,0,0,0.0,0.0
1013,642,24-09-2019 09:02:00,1,3235.0,3010.0,0.93,16.079,1,0,0,0,1,1,0,0,0.0,0.0
1013,643,24-09-2019 09:04:00,1,3135.0,2907.0,0.927,15.572,0,0,0,0,0,0,0,0,0.0,0.0
1013,644,24-09-2019 09:06:00,1,2921.0,2784.0,0.953,14.592,1,0,0,0,1,1,0,0,0.0,0.0
1013,645,24-09-2019 09:08:00,1,2839.0,2644.0,0.931,14.113,0,0,0,0,0,0,0,0,0.01,0.0
1013,646,24-09-2019 09:10:00,1,2727.0,2546.0,0.934,13.564,5,3,0,3,2,0,2,0,0.0,0.0
1013,647,24-09-2019 09:12:00,1,2750.0,2517.0,0.915,13.623,161,85,57,28,76,41,35,15,0.0,0.0
1013,648,24-09-2019 09:14:00,1,2889.0,2903.0,1.005,14.594,176,114,85,29,62,41,21,19,0.0,0.0
1013,649,24-09-2019 09:16:00,1,3225.0,3045.0,0.944,16.076,120,60,42,18,60,35,25,13,0.0,0.0
1013,650,24-09-2019 09:18:00,1,2893.0,2924.0,1.011,14.634,2,1,1,0,1,0,1,0,0.0,0.0
1013,651,24-09-2019 09:20:00,1,2927.0,2761.0,0.943,14.588,0,0,0,0,0,0,0,0,0.0,0.0
1013,652,24-09-2019 09:22:00,1,2937.0,2715.0,0.924,14.579,2,0,0,0,2,0,2,0,0.0,0.0
1013,653,24-09-2019 09:24:00,1,2699.0,2662.0,0.986,13.582,6,0,0,0,6,0,6,0,0.0,0.0
1013,654,24-09-2019 09:26:00,1,2731.0,2587.0,0.947,13.624,6,0,0,0,6,2,4,0,0.0,0.0
1013,655,24-09-2019 09:28:00,1,2741.0,2531.0,0.923,13.6,3,0,0,0,3,1,2,0,0.0,0.0
1013,656,24-09-2019 09:30:00,1,2531.0,2428.0,0.959,12.658,2,1,1,0,1,0,1,0,0.0,0.0
1013,657,24-09-2019 09:32:00,1,2549.0,2357.0,0.925,12.655,2,0,0,0,2,0,2,0,0.0,0.0
1013,658,24-09-2019 09:34:00,1,2599.0,2392.0,0.9205,12.89,33,21,8,13,12,3,9,0,0.0,0.0
1013,659,24-09-2019 09:36:00,1,2649.0,2427.0,0.916,13.125,2,2,1,1,0,0,0,0,0.0,0.0
1013,660,24-09-2019 09:38:00,1,2533.0,2377.0,0.938,12.613,4,1,0,1,3,0,3,0,0.0,0.0
1013,661,24-09-2019 09:40:00,1,2544.0,2355.0,0.926,12.63,2,1,0,1,1,0,1,0,0.0,0.0
1013,662,24-09-2019 09:42:00,1,2535.0,2376.0,0.937,12.617,10,7,1,6,3,1,2,0,0.0,0.0
1013,663,24-09-2019 09:44:00,1,2548.0,2343.0,0.92,12.631,0,0,0,0,0,0,0,0,0.0,0.0
1013,664,24-09-2019 09:46:00,1,2572.0,2282.0,0.887,12.661,23,12,2,10,11,7,4,0,0.0,0.0
1013,665,24-09-2019 09:48:00,1,2568.0,2270.0,0.884,12.63,9,5,1,4,4,1,3,0,0.0,0.0
1013,666,24-09-2019 09:50:00,1,2561.0,2313.0,0.903,12.652,45,5,4,1,40,2,38,0,0.0,0.0
1013,667,24-09-2019 09:52:00,1,2537.0,2347.0,0.925,12.594,18,14,6,8,4,0,4,0,0.0,0.0
1013,668,24-09-2019 09:54:00,1,2785.0,2399.0,0.861,13.63,8,0,0,0,8,0,8,0,0.0,0.0
1013,669,24-09-2019 09:56:00,1,2658.0,2330.0,0.877,13.053,16,0,0,0,16,0,16,0,0.0,0.0
1013,670,24-09-2019 09:58:00,1,2797.0,2351.0,0.841,13.625,0,0,0,0,0,0,0,0,0.0,0.0
1013,671,24-09-2019 10:00:00,1,2795.0,2352.0,0.841,13.618,2,2,0,2,0,0,0,0,0.0,0.0
1013,672,24-09-2019 10:02:00,1,2794.0,2405.0,0.861,13.671,19,7,3,4,12,6,6,0,0.0,0.0
1013,673,24-09-2019 10:04:00,1,2772.0,2352.0,0.849,13.526,14,5,2,3,9,2,7,0,0.0,0.0
1013,674,24-09-2019 10:06:00,1,2682.0,2306.0,0.86,13.122,14,9,1,8,5,0,5,0,0.0,0.0
1013,675,24-09-2019 10:08:00,1,2622.0,2282.0,0.8705,12.858,20,1,1,0,19,0,19,0,0.0,0.0
1013,676,24-09-2019 10:10:00,1,2562.0,2258.0,0.881,12.594,47,16,9,7,31,6,25,0,0.0,0.0
1013,677,24-09-2019 10:12:00,1,2567.0,2249.0,0.876,12.605,0,0,0,0,0,0,0,0,0.0,0.0
1013,678,24-09-2019 10:14:00,1,2570.0,2239.0,0.871,12.603,12,10,4,6,2,0,2,0,0.0,0.0
1013,679,24-09-2019 10:16:00,1,2578.0,2229.0,0.865,12.623,19,10,4,6,9,3,6,0,0.0,0.0
1013,680,24-09-2019 10:18:00,1,2581.0,2194.0,0.85,12.596,1,1,0,1,0,0,0,0,0.0,0.0
1013,681,24-09-2019 10:20:00,1,2567.0,2258.0,0.879,12.616,10,4,1,3,6,2,4,0,0.0,0.0
1013,682,24-09-2019 10:22:00,1,2573.0,2267.0,0.881,12.647,1,0,0,0,1,0,1,0,0.0,0.0
1013,683,24-09-2019 10:24:00,1,2585.0,2211.0,0.855,12.633,65,38,15,23,27,11,16,0,0.0,0.0
1013,684,24-09-2019 10:26:00,1,2758.0,2476.0,0.898,13.609,116,64,35,29,52,30,22,0,0.0,0.0
1013,685,24-09-2019 10:28:00,1,2941.0,2649.0,0.901,14.521,197,115,77,38,82,50,32,60,0.0,0.0
1013,686,24-09-2019 10:30:00,1,3269.0,2847.0,0.871,16.031,98,49,18,31,49,0,49,46,0.0,0.0
1013,687,24-09-2019 10:32:00,1,3476.0,3057.0,0.88,17.079,83,46,21,25,37,9,28,50,0.0,0.0
1013,688,24-09-2019 10:34:00,1,3451.0,3045.0,0.882,16.968,278,159,119,40,119,82,37,36,0.0,0.0
1013,689,24-09-2019 10:36:00,1,3351.0,3017.0,0.901,16.542,349,230,176,54,119,90,29,12,0.0,0.0
1013,690,24-09-2019 10:38:00,1,3667.0,3203.0,0.874,17.994,244,162,133,29,82,54,28,10,0.0,0.02
1013,691,24-09-2019 10:40:00,1,3351.0,3002.0,0.896,16.527,519,297,235,62,222,173,49,32,0.0,0.0
1013,692,24-09-2019 10:42:00,1,3211.5,2833.5,0.8815,15.7905,153,95,57,38,58,34,24,15,0.1,0.0
1013,693,24-09-2019 10:44:00,1,3072.0,2665.0,0.867,15.054,745,414,335,79,331,257,74,15,0.0,0.0
1013,694,24-09-2019 10:46:00,1,3253.0,2858.0,0.879,15.979,327,174,122,52,153,106,47,2,0.0,0.0
1013,695,24-09-2019 10:48:00,1,3150.0,2803.0,0.89,15.515,608,377,304,73,231,171,60,7,0.0,0.0
1013,696,24-09-2019 10:50:00,1,3151.0,2798.0,0.888,15.513,95,61,29,32,34,16,18,0,0.0,0.0
1013,697,24-09-2019 10:52:00,1,3374.0,2858.0,0.847,16.459,34,16,3,13,18,2,16,0,0.0,0.0
1013,698,24-09-2019 10:54:00,1,3388.0,2961.0,0.874,16.627,46,23,6,17,23,0,23,0,0.0,0.0
1013,699,24-09-2019 10:56:00,1,3373.0,2916.0,0.864,16.519,39,25,5,20,14,3,11,0,0.0,0.0
1013,700,24-09-2019 10:58:00,1,3383.0,2869.0,0.848,16.507,12,10,4,6,2,0,2,0,0.0,0.0
1013,701,24-09-2019 11:00:00,1,3403.0,2862.0,0.841,16.576,17,0,0,0,17,1,16,0,0.0,0.0
1013,702,24-09-2019 11:02:00,1,3267.0,2834.0,0.867,16.01,4,0,0,0,4,2,2,0,0.0,0.0
1013,703,24-09-2019 11:04:00,1,3040.0,2748.0,0.904,15.02,1,0,0,0,1,0,1,0,0.0,0.0
1013,704,24-09-2019 11:06:00,1,3067.0,2705.0,0.882,15.08,4,0,0,0,4,0,4,0,0.0,0.0
1013,705,24-09-2019 11:08:00,1,2864.0,2546.0,0.889,14.104,3,1,0,1,2,0,2,0,0.0,0.0
1013,706,24-09-2019 11:10:00,1,2905.0,2380.0,0.82,14.08,5,4,0,4,1,0,1,0,0.0,0.0
1013,707,24-09-2019 11:12:00,1,2689.0,2289.0,0.851,13.13,0,0,0,0,0,0,0,0,0.0,0.0
1013,708,24-09-2019 11:14:00,1,2694.0,2239.0,0.831,13.094,14,11,2,9,3,0,3,0,0.0,0.0
1013,709,24-09-2019 11:16:00,1,2694.0,2233.0,0.829,13.0875,1,1,0,1,0,0,0,0,0.0,0.0
1013,710,24-09-2019 11:18:00,1,2694.0,2227.0,0.827,13.081,0,0,0,0,0,0,0,0,0.0,0.0
1013,711,24-09-2019 11:20:00,1,2717.0,2191.0,0.806,13.13,5,3,0,3,2,0,2,0,0.0,0.0
1013,712,24-09-2019 11:22:00,1,2696.0,2243.0,0.832,13.106,11,11,0,11,0,0,0,0,0.0,0.0
1013,713,24-09-2019 11:24:00,1,2684.0,2297.0,0.856,13.119,5,5,0,5,0,0,0,0,0.0,0.0
1013,714,24-09-2019 11:26:00,1,2697.0,2244.0,0.832,13.109,27,14,10,4,13,8,5,0,0.0,0.0
1013,715,24-09-2019 11:28:00,1,2696.0,2253.0,0.836,13.115,9,0,0,0,9,0,9,0,0.0,0.0
1013,716,24-09-2019 11:30:00,1,2925.0,2370.0,0.81,14.148,0,0,0,0,0,0,0,0,0.0,0.0
1013,717,24-09-2019 11:32:00,1,2905.0,2375.0,0.817,14.076,9,3,1,2,6,3,3,0,0.0,0.0
1013,718,24-09-2019 11:34:00,1,2913.0,2340.0,0.803,14.068,0,0,0,0,0,0,0,0,0.0,0.0
1013,719,24-09-2019 11:36:00,1,2929.0,2290.0,0.782,14.077,1,1,1,0,0,0,0,0,0.0,0.0
1013,720,24-09-2019 11:38:00,1,2933.0,2277.0,0.776,14.079,31,18,12,6,13,9,4,0,0.0,0.0
1013,721,24-09-2019 11:40:00,1,2909.0,2312.0,0.795,14.021,21,14,4,10,7,5,2,0,0.0,0.0
1013,722,24-09-2019 11:42:00,1,2925.0,2276.0,0.778,14.046,14,8,0,8,6,1,5,0,0.0,0.0
1013,723,24-09-2019 11:44:00,1,2939.0,2232.0,0.759,14.051,16,4,0,4,12,0,12,0,0.0,0.0
1013,724,24-09-2019 11:46:00,1,2712.0,2193.0,0.809,13.114,41,15,2,13,26,10,16,0,0.0,0.0
1013,725,24-09-2019 11:48:00,1,2825.0,2222.0,0.787,13.59,8,0,0,0,8,0,8,0,0.0,0.0
1013,726,24-09-2019 11:50:00,1,2778.0,2167.0,0.78,13.3435,16,0,0,0,16,7,9,0,0.0,0.0
1013,727,24-09-2019 11:52:00,1,2731.0,2112.0,0.773,13.097,11,6,5,1,5,2,3,0,0.0,0.0
1013,728,24-09-2019 11:54:00,1,2628.0,2050.0,0.78,12.624,0,0,0,0,0,0,0,0,0.0,0.0
1013,729,24-09-2019 11:56:00,1,2515.0,1997.0,0.794,12.122,106,54,18,36,52,19,33,0,0.0,0.0
1013,730,24-09-2019 11:58:00,1,2943.0,2259.0,0.768,14.096,173,108,81,27,65,33,32,42,0.0,0.0
1013,731,24-09-2019 12:00:00,1,3087.0,2615.0,0.847,15.057,73,42,18,24,31,5,26,53,0.0,0.0
1013,732,24-09-2019 12:02:00,1,3506.0,2871.0,0.819,16.995,59,35,10,25,24,9,15,46,0.0,0.0
1013,733,24-09-2019 12:04:00,1,3697.0,3063.0,0.828,17.958,130,68,42,26,62,27,35,54,0.0,0.04
1013,734,24-09-2019 12:06:00,1,3683.0,3101.0,0.842,17.943,598,342,269,73,256,199,57,41,0.0,0.01
1013,735,24-09-2019 12:08:00,1,3610.0,2969.0,0.822,17.512,425,256,199,57,169,134,35,3,0.0,0.01
1013,736,24-09-2019 12:10:00,1,3775.0,3209.0,0.85,18.426,430,268,211,57,162,106,56,5,0.0,0.0
1013,737,24-09-2019 12:12:00,1,3420.0,2741.0,0.801,16.511,66,38,7,31,28,10,18,0,0.0,0.0
1013,738,24-09-2019 12:14:00,1,3083.0,2588.0,0.84,15.011,53,40,16,24,13,1,12,0,0.0,0.0
1013,739,24-09-2019 12:16:00,1,3199.0,2650.0,0.829,15.539,22,22,6,16,0,0,0,0,0.0,0.0
1013,740,24-09-2019 12:18:00,1,3094.0,2611.0,0.844,15.08,2,2,0,2,0,0,0,0,0.0,0.0
1013,741,24-09-2019 12:20:00,1,3098.0,2543.0,0.821,15.023,0,0,0,0,0,0,0,0,0.0,0.0
1013,742,24-09-2019 12:22:00,1,3107.0,2486.0,0.8,14.995,12,11,7,4,1,0,1,0,0.0,0.0
1013,743,24-09-2019 12:24:00,1,2999.0,2454.0,0.819,14.533,8,3,2,1,5,1,4,0,0.0,0.0
1013,744,24-09-2019 12:26:00,1,2891.0,2422.0,0.838,14.071,3,1,0,1,2,0,2,0,0.0,0.0
1013,745,24-09-2019 12:28:00,1,2902.0,2396.0,0.826,14.089,0,0,0,0,0,0,0,0,0.01,0.02
1013,746,24-09-2019 12:30:00,1,2902.0,2373.0,0.818,14.06,0,0,0,0,0,0,0,0,0.0,0.0
1013,747,24-09-2019 12:32:00,1,2919.0,2345.0,0.803,14.097,7,5,1,4,2,0,2,0,0.0,0.0
1013,748,24-09-2019 12:34:00,1,2918.0,2314.0,0.793,14.057,0,0,0,0,0,0,0,0,0.0,0.0
1013,749,24-09-2019 12:36:00,1,2912.0,2322.0,0.797,14.045,2,1,0,1,1,1,0,0,0.0,0.0
1013,750,24-09-2019 12:38:00,1,2915.0,2331.0,0.799,14.068,15,10,6,4,5,3,2,0,0.0,0.0
1013,751,24-09-2019 12:40:00,1,2916.0,2359.0,0.809,14.102,15,15,2,13,0,0,0,0,0.0,0.0
1013,752,24-09-2019 12:42:00,1,2916.0,2348.0,0.805,14.09,9,7,3,4,2,0,2,0,0.0,0.0
1013,753,24-09-2019 12:44:00,1,2924.0,2327.0,0.796,14.099,10,8,3,5,2,0,2,0,0.0,0.0
1013,754,24-09-2019 12:46:00,1,2897.0,2323.0,0.802,13.987,19,11,2,9,8,0,8,0,0.0,0.0
1013,755,24-09-2019 12:48:00,1,2910.0,2337.0,0.803,14.052,4,3,1,2,1,0,1,0,0.0,0.0
1013,756,24-09-2019 12:50:00,1,2922.0,2338.0,0.8,14.101,8,5,2,3,3,0,3,0,0.0,0.0
1013,757,24-09-2019 12:52:00,1,2920.0,2319.0,0.794,14.072,15,10,8,2,5,4,1,0,0.0,0.0
1013,758,24-09-2019 12:54:00,1,3131.0,2449.0,0.782,15.046,22,12,8,4,10,5,5,0,0.0,0.0
1013,759,24-09-2019 12:56:00,1,3133.0,2454.0,0.783,15.062,2,2,1,1,0,0,0,0,0.0,0.0
1013,760,24-09-2019 12:58:00,1,3091.5,2372.0,0.767,14.8065,7,2,1,1,5,3,2,0,0.0,0.0
1013,761,24-09-2019 13:00:00,1,3050.0,2290.0,0.751,14.551,17,4,3,1,13,0,13,0,0.0,0.0
1013,762,24-09-2019 13:02:00,1,2952.0,2230.0,0.755,14.103,1,0,0,0,1,0,1,0,0.0,0.0
1013,763,24-09-2019 13:04:00,1,3057.0,2238.0,0.732,14.523,3,0,0,0,3,0,3,0,0.0,0.0
1013,764,24-09-2019 13:06:00,1,3058.0,2284.0,0.747,14.576,2,0,0,0,2,0,2,0,0.0,0.0
1013,765,24-09-2019 13:08:00,1,3044.0,2285.0,0.751,14.524,33,13,5,8,20,9,11,0,0.0,0.0
1013,766,24-09-2019 13:10:00,1,2826.0,2211.0,0.782,13.584,9,9,0,9,0,0,0,0,0.0,0.0
1013,767,24-09-2019 13:12:00,1,2873.0,2099.0,0.731,13.643,19,13,5,8,6,2,4,0,0.0,0.0
1013,768,24-09-2019 13:14:00,1,2843.0,2146.0,0.755,13.577,5,3,1,2,2,1,1,0,0.0,0.0
1013,769,24-09-2019 13:16:00,1,2836.0,2165.0,0.763,13.572,0,0,0,0,0,0,0,0,0.0,0.0
1013,770,24-09-2019 13:18:00,1,2837.0,2180.0,0.768,13.593,9,0,0,0,9,2,7,0,0.0,0.0
1013,771,24-09-2019 13:20:00,1,2939.0,2220.0,0.755,14.04,16,2,0,2,14,6,8,0,0.0,0.0
1013,772,24-09-2019 13:22:00,1,3046.0,2254.0,0.74,14.497,2,0,0,0,2,0,2,0,0.0,0.0
1013,773,24-09-2019 13:24:00,1,3045.0,2287.0,0.751,14.53,12,5,2,3,7,2,5,0,0.0,0.0
1013,774,24-09-2019 13:26:00,1,3036.0,2324.0,0.765,14.537,9,3,1,2,6,5,1,0,0.0,0.0
1013,775,24-09-2019 13:28:00,1,3037.0,2298.0,0.757,14.51,3,0,0,0,3,1,2,0,0.0,0.0
1013,776,24-09-2019 13:30:00,1,3064.0,2260.0,0.738,14.575,9,5,3,2,4,2,2,0,0.0,0.0
1013,777,24-09-2019 13:32:00,1,3063.0,2260.5,0.738,14.572,5,0,0,0,5,4,1,0,0.0,0.0
1013,778,24-09-2019 13:34:00,1,3062.0,2261.0,0.738,14.569,80,50,18,32,30,8,22,0,0.0,0.0
1013,779,24-09-2019 13:36:00,1,3258.0,2428.0,0.745,15.525,79,45,14,31,34,10,24,0,0.0,0.0
1013,780,24-09-2019 13:38:00,1,3249.0,2433.0,0.749,15.494,177,114,79,35,63,36,27,11,0.0,0.0
1013,781,24-09-2019 13:40:00,1,3238.0,2464.0,0.761,15.485,121,77,54,23,44,28,16,43,0.0,0.0
1013,782,24-09-2019 13:42:00,1,3306.0,2669.0,0.807,15.98,93,49,32,17,44,28,16,20,0.0,0.0
1013,783,24-09-2019 13:44:00,1,3149.0,2430.0,0.772,15.1,53,44,17,27,9,3,6,0,0.0,0.0
1013,784,24-09-2019 13:46:00,1,3238.0,2496.0,0.771,15.521,54,41,11,30,13,6,7,0,0.0,0.0
1013,785,24-09-2019 13:48:00,1,3230.0,2492.0,0.772,15.487,79,43,11,32,36,7,29,0,0.0,0.0
1013,786,24-09-2019 13:50:00,1,3232.0,2511.0,0.777,15.517,71,12,6,6,59,34,25,0,0.0,0.0
1013,787,24-09-2019 13:52:00,1,3217.0,2519.0,0.783,15.464,166,64,41,23,102,65,37,0,0.0,0.0
1013,788,24-09-2019 13:54:00,1,3447.0,2690.0,0.78,16.56,256,141,109,32,115,80,35,6,0.0,0.0
1013,789,24-09-2019 13:56:00,1,3549.0,2678.0,0.755,16.95,46,22,13,9,24,12,12,0,0.0,0.0
1013,790,24-09-2019 13:58:00,1,3221.0,2551.0,0.792,15.513,8,5,0,5,3,1,2,0,0.0,0.0
1013,791,24-09-2019 14:00:00,1,3130.0,2403.0,0.768,14.992,0,0,0,0,0,0,0,0,0.0,0.0
1013,792,24-09-2019 14:02:00,1,3052.0,2281.0,0.747,14.552,0,0,0,0,0,0,0,0,0.0,0.0
1013,793,24-09-2019 14:04:00,1,2845.0,2198.0,0.773,13.643,12,10,1,9,2,0,2,0,0.0,0.0
1013,794,24-09-2019 14:06:00,1,2853.5,2117.0,0.742,13.5865,6,6,0,6,0,0,0,0,0.0,0.0
1013,795,24-09-2019 14:08:00,1,2862.0,2036.0,0.711,13.53,17,12,3,9,5,2,3,0,0.0,0.0
1013,796,24-09-2019 14:10:00,1,2871.0,2069.0,0.721,13.604,2,1,0,1,1,0,1,0,0.0,0.0
1013,797,24-09-2019 14:12:00,1,2847.0,2141.0,0.752,13.588,2,0,0,0,2,0,2,0,0.0,0.0
1013,798,24-09-2019 14:14:00,1,2819.0,2165.0,0.768,13.505,1,0,0,0,1,0,1,0,0.0,0.0
1013,799,24-09-2019 14:16:00,1,2949.0,2189.0,0.742,14.044,5,0,0,0,5,1,4,0,0.0,0.0
1013,800,24-09-2019 14:18:00,1,2946.0,2186.0,0.742,14.026,0,0,0,0,0,0,0,0,0.0,0.0
1013,801,24-09-2019 14:20:00,1,2962.0,2176.0,0.735,14.08,15,10,6,4,5,2,3,0,0.0,0.0
1013,802,24-09-2019 14:22:00,1,2856.0,2105.0,0.737,13.583,23,10,5,5,13,8,5,0,0.0,0.0
1013,803,24-09-2019 14:24:00,1,2865.0,2112.0,0.737,13.626,1,1,0,1,0,0,0,0,0.0,0.0
1013,804,24-09-2019 14:26:00,1,2759.0,2005.0,0.727,13.093,14,6,0,6,8,2,6,0,0.0,0.0
1013,805,24-09-2019 14:28:00,1,2630.0,1973.0,0.75,12.548,7,0,0,0,7,0,7,0,0.0,0.0
1013,806,24-09-2019 14:30:00,1,2665.0,1973.0,0.74,12.686,0,0,0,0,0,0,0,0,0.0,0.0
1013,807,24-09-2019 14:32:00,1,2536.0,1934.0,0.763,12.132,11,6,2,4,5,3,2,0,0.0,0.0
1013,808,24-09-2019 14:34:00,1,2755.0,2015.0,0.732,13.085,6,1,0,1,5,1,4,0,0.0,0.0
1013,809,24-09-2019 14:36:00,1,2869.0,2036.0,0.71,13.557,7,4,0,4,3,0,3,0,0.0,0.0
1013,810,24-09-2019 14:38:00,1,2860.0,2085.0,0.729,13.578,0,0,0,0,0,0,0,0,0.0,0.0
1013,811,24-09-2019 14:40:00,1,2808.5,2065.0,0.7355,13.3525,5,5,2,3,0,0,0,0,0.0,0.0
1013,812,24-09-2019 14:42:00,1,2757.0,2045.0,0.742,13.127,8,4,1,3,4,2,2,0,0.0,0.0
1013,813,24-09-2019 14:44:00,1,2752.0,2047.0,0.744,13.111,12,0,0,0,12,0,12,0,0.0,0.0
1013,814,24-09-2019 14:46:00,1,2739.0,2052.0,0.749,13.066,19,7,5,2,12,2,10,0,0.0,0.0
1013,815,24-09-2019 14:48:00,1,2742.0,2081.0,0.759,13.108,12,6,0,6,6,3,3,0,0.0,0.0
1013,816,24-09-2019 14:50:00,1,2719.0,2145.0,0.789,13.087,1,0,0,0,1,0,1,0,0.0,0.0
1013,817,24-09-2019 14:52:00,1,2723.0,2165.0,0.795,13.126,0,0,0,0,0,0,0,0,0.0,0.0
1013,818,24-09-2019 14:54:00,1,2719.0,2135.0,0.785,13.078,18,11,6,5,7,3,4,0,0.0,0.0
1013,819,24-09-2019 14:56:00,1,2740.0,2054.0,0.75,13.071,15,0,0,0,15,1,14,0,0.0,0.0
1013,820,24-09-2019 14:58:00,1,2522.0,2008.0,0.796,12.162,4,2,1,1,2,0,2,0,0.0,0.0
1013,821,24-09-2019 15:00:00,1,2633.0,2022.0,0.768,12.614,0,0,0,0,0,0,0,0,0.0,0.0
1013,822,24-09-2019 15:02:00,1,2529.0,1985.0,0.785,12.16,8,4,1,3,4,0,4,0,0.0,0.0
1013,823,24-09-2019 15:04:00,1,2731.0,2067.0,0.757,13.051,3,2,0,2,1,1,0,0,0.0,0.0
1013,824,24-09-2019 15:06:00,1,2730.0,2106.0,0.771,13.089,2,1,0,1,1,0,1,0,0.0,0.0
1013,825,24-09-2019 15:08:00,1,2722.0,2134.0,0.784,13.087,0,0,0,0,0,0,0,0,0.0,0.0
1013,826,24-09-2019 15:10:00,1,2716.0,2131.0,0.785,13.061,7,4,3,1,3,0,3,0,0.0,0.0
1013,827,24-09-2019 15:12:00,1,2729.0,2140.0,0.784,13.123,5,0,0,0,5,4,1,0,0.0,0.0
1013,828,24-09-2019 15:14:00,1,2788.0,2123.0,0.762,13.335,2,2,1,1,0,0,0,0,0.0,0.0
1013,829,24-09-2019 15:16:00,1,2847.0,2106.0,0.74,13.547,10,8,4,4,2,2,0,0,0.0,0.0
1013,830,24-09-2019 15:18:00,1,2841.0,2154.0,0.758,13.579,2,2,1,1,0,0,0,0,0.0,0.0
1013,831,24-09-2019 15:20:00,1,2844.0,2113.0,0.743,13.546,8,8,1,7,0,0,0,0,0.0,0.0
1013,832,24-09-2019 15:22:00,1,2870.0,2080.0,0.725,13.61,3,3,2,1,0,0,0,0,0.0,0.0
1013,833,24-09-2019 15:24:00,1,2843.0,2137.0,0.752,13.569,55,34,20,14,21,11,10,0,0.0,0.0
1013,834,24-09-2019 15:26:00,1,3070.0,2225.0,0.725,14.56,8,5,1,4,3,0,3,0,0.01,0.0
1013,835,24-09-2019 15:28:00,1,2842.0,2196.0,0.773,13.63,1,1,0,1,0,0,0,0,0.0,0.0
1013,836,24-09-2019 15:30:00,1,2843.0,2117.0,0.745,13.546,2,2,0,2,0,0,0,0,0.0,0.0
1013,837,24-09-2019 15:32:00,1,2851.0,2122.0,0.744,13.581,7,7,1,6,0,0,0,0,0.0,0.0
1013,838,24-09-2019 15:34:00,1,2857.0,2149.0,0.752,13.636,6,0,0,0,6,1,5,0,0.0,0.0
1013,839,24-09-2019 15:36:00,1,2856.0,2111.0,0.739,13.589,3,0,0,0,3,0,3,0,0.0,0.0
1013,840,24-09-2019 15:38:00,1,2859.0,2106.0,0.737,13.595,7,5,0,5,2,0,2,0,0.0,0.0
1013,841,24-09-2019 15:40:00,1,2851.0,2104.0,0.738,13.563,5,1,0,1,4,0,4,0,0.0,0.0
1013,842,24-09-2019 15:42:00,1,2828.0,2166.0,0.766,13.542,6,1,1,0,5,1,4,0,0.0,0.0
1013,843,24-09-2019 15:44:00,1,3061.0,2266.0,0.74,14.569,0,0,0,0,0,0,0,0,0.0,0.0
1013,844,24-09-2019 15:46:00,1,2948.0,2232.0,0.757,14.087,1,0,0,0,1,0,1,0,0.0,0.0
1013,845,24-09-2019 15:48:00,1,2898.0,2187.0,0.7545,13.841,14,0,0,0,14,6,8,0,0.0,0.0
1013,846,24-09-2019 15:50:00,1,2848.0,2142.0,0.752,13.595,12,0,0,0,12,1,11,0,0.0,0.0
1013,847,24-09-2019 15:52:00,1,2829.0,2174.0,0.769,13.552,2,0,0,0,2,1,1,0,0.0,0.0
1013,848,24-09-2019 15:54:00,1,2823.0,2234.0,0.791,13.598,47,3,0,3,44,16,28,0,0.0,0.0
1013,849,24-09-2019 15:56:00,1,3047.0,2324.0,0.763,14.577,31,9,3,6,22,8,14,0,0.0,0.0
1013,850,24-09-2019 15:58:00,1,3016.0,2401.0,0.796,14.54,109,54,31,23,55,37,18,13,0.0,0.0
1013,851,24-09-2019 16:00:00,1,3130.0,2452.0,0.783,15.048,147,96,74,22,51,30,21,49,0.0,0.0
1013,852,24-09-2019 16:02:00,1,2999.0,2410.0,0.803,14.483,25,16,10,6,9,2,7,53,0.0,0.0
1013,853,24-09-2019 16:04:00,1,3218.0,2582.0,0.802,15.539,110,61,40,21,49,34,15,39,0.0,0.0
1013,854,24-09-2019 16:06:00,1,3206.0,2636.0,0.822,15.552,119,88,66,22,31,12,19,46,0.01,0.06
1013,855,24-09-2019 16:08:00,1,3726.0,3001.0,0.805,18.003,170,90,63,27,80,51,29,75,0.02,0.0
1013,856,24-09-2019 16:10:00,1,3547.0,2716.0,0.766,16.985,572,329,253,76,243,187,56,9,0.0,0.03
1013,857,24-09-2019 16:12:00,1,3534.0,2720.0,0.77,16.936,317,199,161,38,118,90,28,11,0.0,0.0
1013,858,24-09-2019 16:14:00,1,3498.0,2871.0,0.821,16.959,257,156,121,35,101,73,28,20,0.0,0.0
1013,859,24-09-2019 16:16:00,1,3290.0,2698.0,0.82,15.952,90,79,47,32,11,6,5,1,0.0,0.0
1013,860,24-09-2019 16:18:00,1,3315.0,2711.0,0.818,16.063,89,29,5,24,60,22,38,0,0.0,0.0
1013,861,24-09-2019 16:20:00,1,3523.0,2841.0,0.807,17.025,75,22,3,19,53,34,19,0,0.0,0.0
1013,862,24-09-2019 16:22:00,1,3521.5,2822.5,0.802,16.998,84,38,4,34,46,6,40,0,0.0,0.0
1013,863,24-09-2019 16:24:00,1,3520.0,2804.0,0.797,16.971,5,0,0,0,5,1,4,0,0.0,0.0
1013,864,24-09-2019 16:26:00,1,3194.0,2678.0,0.838,15.551,6,6,1,5,0,0,0,0,0.0,0.0
1013,865,24-09-2019 16:28:00,1,3237.0,2549.0,0.787,15.575,0,0,0,0,0,0,0,0,0.0,0.0
1013,866,24-09-2019 16:30:00,1,3022.0,2409.0,0.797,14.575,15,10,1,9,5,2,3,0,0.0,0.0
1013,867,24-09-2019 16:32:00,1,3039.0,2337.0,0.769,14.56,0,0,0,0,0,0,0,0,0.0,0.0
1013,868,24-09-2019 16:34:00,1,2919.0,2313.0,0.793,14.061,2,1,0,1,1,1,0,0,0.0,0.0
1013,869,24-09-2019 16:36:00,1,2812.0,2285.0,0.812,13.611,0,0,0,0,0,0,0,0,0.0,0.0
1013,870,24-09-2019 16:38:00,1,2821.0,2213.0,0.785,13.565,0,0,0,0,0,0,0,0,0.0,0.0
1013,871,24-09-2019 16:40:00,1,2825.0,2152.0,0.762,13.515,2,2,1,1,0,0,0,0,0.0,0.0
1013,872,24-09-2019 16:42:00,1,2849.0,2134.0,0.749,13.587,4,1,0,1,3,0,3,0,0.0,0.0
1013,873,24-09-2019 16:44:00,1,2825.0,2204.0,0.78,13.571,4,0,0,0,4,1,3,0,0.0,0.0
1013,874,24-09-2019 16:46:00,1,2835.0,2230.0,0.786,13.64,3,0,0,0,3,0,3,0,0.0,0.0
1013,875,24-09-2019 16:48:00,1,2834.0,2193.0,0.774,13.595,2,0,0,0,2,0,2,0,0.0,0.0
1013,876,24-09-2019 16:50:00,1,2838.0,2190.0,0.772,13.607,2,0,0,0,2,0,2,0,0.0,0.0
1013,877,24-09-2019 16:52:00,1,2835.0,2161.0,0.763,13.561,0,0,0,0,0,0,0,0,0.0,0.0
1013,878,24-09-2019 16:54:00,1,2841.0,2116.0,0.745,13.536,2,0,0,0,2,0,2,0,0.0,0.0
1013,879,24-09-2019 16:56:00,1,2848.5,2123.0,0.7455,13.574,3,0,0,0,3,0,3,0,0.0,0.0
1013,880,24-09-2019 16:58:00,1,2856.0,2130.0,0.746,13.612,14,0,0,0,14,0,14,0,0.0,0.0
1013,881,24-09-2019 17:00:00,1,2853.0,2105.0,0.738,13.57,4,4,1,3,0,0,0,0,0.0,0.0
1013,882,24-09-2019 17:02:00,1,2744.0,2081.0,0.758,13.114,7,7,2,5,0,0,0,0,0.0,0.0
1013,883,24-09-2019 17:04:00,1,2847.0,2148.0,0.754,13.596,0,0,0,0,0,0,0,0,0.0,0.0
1013,884,24-09-2019 17:06:00,1,2824.0,2226.0,0.788,13.592,30,16,5,11,14,6,8,0,0.0,0.0
1013,885,24-09-2019 17:08:00,1,3044.0,2342.0,0.769,14.588,102,40,9,31,62,24,38,0,0.0,0.0
1013,886,24-09-2019 17:10:00,1,3122.0,2454.0,0.786,15.018,38,9,2,7,29,10,19,0,0.0,0.0
1013,887,24-09-2019 17:12:00,1,3010.0,2424.0,0.805,14.543,66,20,7,13,46,16,30,0,0.0,0.0
1013,888,24-09-2019 17:14:00,1,3238.0,2530.0,0.781,15.558,80,32,10,22,48,22,26,0,0.0,0.0
1013,889,24-09-2019 17:16:00,1,3197.0,2672.0,0.836,15.555,58,16,3,13,42,16,26,0,0.0,0.0
1013,890,24-09-2019 17:18:00,1,3414.0,2720.0,0.797,16.462,105,69,40,29,36,17,19,68,0.0,0.0
1013,891,24-09-2019 17:20:00,1,3300.0,2725.0,0.826,16.018,248,102,68,34,146,103,43,57,0.0,0.0
1013,892,24-09-2019 17:22:00,1,3522.0,2806.0,0.797,16.984,204,120,85,35,84,52,32,52,0.0,0.0
1013,893,24-09-2019 17:24:00,1,3421.0,2734.0,0.799,16.506,171,79,37,42,92,49,43,3,0.0,0.0
1013,894,24-09-2019 17:26:00,1,3546.0,2750.0,0.775,17.016,61,31,10,21,30,17,13,0,0.0,0.0
1013,895,24-09-2019 17:28:00,1,3543.0,2735.0,0.772,16.987,20,12,0,12,8,1,7,0,0.0,0.0
1013,896,24-09-2019 17:30:00,1,3395.5,2624.0,0.773,16.283,44,12,0,12,32,18,14,0,0.0,0.0
1013,897,24-09-2019 17:32:00,1,3248.0,2513.0,0.774,15.579,6,4,1,3,2,0,2,0,0.0,0.0
1013,898,24-09-2019 17:34:00,1,3127.0,2404.0,0.769,14.982,33,0,0,0,33,23,10,0,0.0,0.0
1013,899,24-09-2019 17:36:00,1,3043.0,2332.0,0.766,14.572,15,4,0,4,11,4,7,0,0.0,0.0
1013,900,24-09-2019 17:38:00,1,3052.0,2248.0,0.737,14.515,0,0,0,0,0,0,0,0,0.0,0.0
1013,901,24-09-2019 17:40:00,1,3059.0,2243.0,0.733,14.537,2,2,1,1,0,0,0,0,0.0,0.0
1013,902,24-09-2019 17:42:00,1,3138.0,2372.0,0.756,14.989,2,2,0,2,0,0,0,0,0.0,0.0
1013,903,24-09-2019 17:44:00,1,3260.0,2444.0,0.749,15.552,5,4,0,4,1,1,0,0,0.0,0.0
1013,904,24-09-2019 17:46:00,1,3253.0,2441.0,0.751,15.519,8,0,0,0,8,0,8,0,0.0,0.0
1013,905,24-09-2019 17:48:00,1,3243.0,2479.0,0.764,15.522,11,5,0,5,6,2,4,0,0.0,0.0
1013,906,24-09-2019 17:50:00,1,3241.0,2429.0,0.749,15.458,21,12,4,8,9,3,6,0,0.0,0.0
1013,907,24-09-2019 17:52:00,1,3250.0,2425.0,0.746,15.491,97,53,35,18,44,27,17,2,0.0,0.0
1013,908,24-09-2019 17:54:00,1,3264.0,2438.0,0.747,15.561,82,57,21,36,25,8,17,48,0.0,0.0
1013,909,24-09-2019 17:56:00,1,3789.0,2792.0,0.737,18.022,201,103,74,29,98,70,28,79,0.0,0.0
1013,910,24-09-2019 17:58:00,1,3070.0,2262.0,0.737,14.6,139,90,65,25,49,33,16,53,0.0,0.0
1013,911,24-09-2019 18:00:00,0,3267.0,2413.0,0.738,15.544,123,56,37,19,67,36,31,43,0.02,0.0
1013,912,24-09-2019 18:02:00,0,4133.0,3192.0,0.772,19.817,234,130,94,36,104,65,39,53,0.0,0.01
1013,913,24-09-2019 18:04:00,0,4129.5,3241.0,0.7845,19.858,280,132,90,42,148,93,55,46,0.0,0.02
1013,914,24-09-2019 18:06:00,0,4126.0,3290.0,0.797,19.899,289,199,149,50,90,56,34,76,0.0,0.0
1013,915,24-09-2019 18:08:00,0,3899.0,3248.0,0.833,18.957,214,108,79,29,106,73,33,26,0.0,0.0
1013,916,24-09-2019 18:10:00,0,3413.0,2754.0,0.807,16.496,152,68,41,27,84,59,25,8,0.0,0.0
1013,917,24-09-2019 18:12:00,0,3498.0,2847.0,0.814,16.934,53,33,14,19,20,6,14,0,0.0,0.0
1013,918,24-09-2019 18:14:00,0,3611.0,2931.0,0.812,17.474,101,56,32,24,45,18,27,0,0.0,0.0
1013,919,24-09-2019 18:16:00,0,3604.0,3010.0,0.835,17.53,174,72,49,23,102,57,45,22,0.0,0.02
1013,920,24-09-2019 18:18:00,0,4277.0,3695.0,0.864,20.941,134,59,37,22,75,36,39,43,0.0,0.0
1013,921,24-09-2019 18:20:00,0,4447.0,3869.0,0.87,21.804,93,32,19,13,61,16,45,35,0.0,0.05
1013,922,24-09-2019 18:22:00,0,4437.0,3853.0,0.868,21.746,118,51,22,29,67,26,41,29,0.0,0.07
1013,923,24-09-2019 18:24:00,0,4161.0,3682.0,0.885,20.471,161,82,66,16,79,52,27,19,0.16,0.0
1013,924,24-09-2019 18:26:00,0,3380.0,2896.0,0.857,16.522,19,5,3,2,14,9,5,0,0.0,0.0
1013,925,24-09-2019 18:28:00,0,3066.0,2713.0,0.885,15.085,1,1,1,0,0,0,0,0,0.0,0.0
1013,926,24-09-2019 18:30:00,0,3052.0,2735.0,0.896,15.052,2,2,1,1,0,0,0,0,0.0,0.0
1013,927,24-09-2019 18:32:00,0,3163.0,2802.0,0.886,15.564,43,33,7,26,10,5,5,0,0.0,0.01
1013,928,24-09-2019 18:34:00,0,3285.0,2843.0,0.866,16.092,75,31,13,18,44,19,25,0,0.0,0.0
1013,929,24-09-2019 18:36:00,0,3730.0,3370.0,0.903,18.425,140,85,37,48,55,21,34,0,0.0,0.0
1013,930,24-09-2019 18:38:00,0,4087.0,3679.0,0.9,20.175,169,81,58,23,88,49,39,38,0.0,0.0
1013,931,24-09-2019 18:40:00,0,4444.0,3988.0,0.897,21.925,218,94,67,27,124,82,42,44,0.01,0.04
1013,932,24-09-2019 18:42:00,0,4132.0,3801.0,0.92,20.49,207,93,69,24,114,87,27,75,0.0,0.01
1013,933,24-09-2019 18:44:00,0,3523.0,3292.0,0.934,17.525,121,54,40,14,67,45,22,28,0.0,0.0
1013,934,24-09-2019 18:46:00,0,3043.0,2729.0,0.897,15.011,2,2,1,1,0,0,0,0,0.0,0.0
1013,935,24-09-2019 18:48:00,0,2850.0,2584.0,0.907,14.091,2,2,1,1,0,0,0,0,0.0,0.0
1013,936,24-09-2019 18:50:00,0,2956.0,2655.0,0.898,14.585,0,0,0,0,0,0,0,0,0.0,0.0
1013,937,24-09-2019 18:52:00,0,3049.0,2759.0,0.905,15.069,10,10,0,10,0,0,0,0,0.0,0.0
1013,938,24-09-2019 18:54:00,0,3241.0,2899.0,0.895,15.978,0,0,0,0,0,0,0,0,0.0,0.0
1013,939,24-09-2019 18:56:00,0,3339.0,3011.0,0.902,16.488,2,2,0,2,0,0,0,0,0.0,0.0
1013,940,24-09-2019 18:58:00,0,3326.0,3056.0,0.919,16.49,112,61,36,25,51,23,28,0,0.0,0.0
1013,941,24-09-2019 19:00:00,0,3625.0,3414.0,0.942,18.063,138,59,35,24,79,44,35,20,0.0,0.0
1013,942,24-09-2019 19:02:00,0,3967.0,3884.0,0.979,19.928,89,15,8,7,74,37,37,42,0.0,0.05
1013,943,24-09-2019 19:04:00,0,4284.0,4111.0,0.96,21.429,192,105,72,33,87,48,39,61,0.0,0.0
1013,944,24-09-2019 19:06:00,0,3655.0,3650.0,0.999,18.443,135,72,41,31,63,42,21,4,0.0,0.0
1013,945,24-09-2019 19:08:00,0,3500.0,3330.0,0.951,17.478,116,55,25,30,61,26,35,2,0.0,0.0
1013,946,24-09-2019 19:10:00,0,3990.0,3805.0,0.954,19.935,121,50,25,25,71,41,30,37,0.1,0.0
1013,947,24-09-2019 19:12:00,0,4341.0,4103.5,0.946,21.647,150,58,37,21,92,46,46,47,0.0,0.01
1013,948,24-09-2019 19:14:00,0,4692.0,4402.0,0.938,23.359,113,32,17,15,81,48,33,57,0.0,0.0
1013,949,24-09-2019 19:16:00,0,4588.0,4335.0,0.945,22.878,120,71,43,28,49,19,30,50,0.0,0.0
1013,950,24-09-2019 19:18:00,0,4371.0,4128.0,0.944,21.79,191,82,52,30,109,67,42,61,0.14,0.1
1013,951,24-09-2019 19:20:00,0,3507.0,3368.0,0.96,17.548,53,20,14,6,33,18,15,20,0.02,0.01
1013,952,24-09-2019 19:22:00,0,3113.0,2974.0,0.955,15.558,182,103,67,36,79,50,29,35,0.0,0.0
1013,953,24-09-2019 19:24:00,0,4387.0,4138.0,0.943,21.865,106,40,16,24,66,28,38,50,0.0,0.0
1013,954,24-09-2019 19:26:00,0,4680.0,4453.0,0.952,23.368,113,58,34,24,55,12,43,59,0.0,0.02
1013,955,24-09-2019 19:28:00,0,4370.0,4233.0,0.968,21.905,95,42,22,20,53,16,37,45,0.0,0.07
1013,956,24-09-2019 19:30:00,0,4868.0,4611.0,0.947,24.283,76,16,1,15,60,18,42,30,0.0,0.04
1013,957,24-09-2019 19:32:00,0,4871.0,4642.0,0.953,24.333,160,71,53,18,89,57,32,19,0.08,0.04
1013,958,24-09-2019 19:34:00,0,3486.0,3352.0,0.962,17.445,362,184,144,40,178,129,49,38,0.06,0.0
1013,959,24-09-2019 19:36:00,0,4389.0,4186.0,0.954,21.928,426,193,143,50,233,180,53,44,0.0,0.0
1013,960,24-09-2019 19:38:00,0,4268.0,4126.0,0.967,21.385,168,103,77,26,65,45,20,37,0.0,0.0
1013,961,24-09-2019 19:40:00,0,3688.0,3543.0,0.961,18.452,266,134,82,52,132,90,42,12,0.0,0.0
1013,962,24-09-2019 19:42:00,0,3492.0,3367.0,0.964,17.486,48,35,6,29,13,5,8,0,0.0,0.0
1013,963,24-09-2019 19:44:00,0,3491.0,3403.0,0.975,17.524,80,39,18,21,41,11,30,0,0.0,0.0
1013,964,24-09-2019 19:46:00,0,3694.5,3523.5,0.955,18.459,53,18,8,10,35,11,24,0,0.0,0.0
1013,965,24-09-2019 19:48:00,0,3898.0,3644.0,0.935,19.394,0,0,0,0,0,0,0,0,0.0,0.0
1013,966,24-09-2019 19:50:00,0,3696.0,3547.0,0.96,18.49,1,1,0,1,0,0,0,0,0.0,0.0
1013,967,24-09-2019 19:52:00,0,3700.0,3527.0,0.953,18.482,0,0,0,0,0,0,0,0,0.0,0.0
1013,968,24-09-2019 19:54:00,0,3701.0,3563.0,0.963,18.527,0,0,0,0,0,0,0,0,0.0,0.0
1013,969,24-09-2019 19:56:00,0,3683.0,3571.0,0.97,18.466,11,9,5,4,2,1,1,0,0.0,0.0
1013,970,24-09-2019 19:58:00,0,3510.0,3363.0,0.958,17.554,5,4,1,3,1,1,0,0,0.0,0.0
1013,971,24-09-2019 20:00:00,0,3474.0,3390.0,0.976,17.438,2,1,0,1,1,0,1,0,0.0,0.0
1013,972,24-09-2019 20:02:00,0,3487.0,3384.0,0.97,17.487,10,8,3,5,2,0,2,0,0.0,0.0
1013,973,24-09-2019 20:04:00,0,3457.0,3479.0,1.006,17.473,97,46,30,16,51,28,23,7,0.0,0.0
1013,974,24-09-2019 20:06:00,0,3674.0,3634.0,0.989,18.5,83,35,16,19,48,7,41,50,0.0,0.0
1013,975,24-09-2019 20:08:00,0,4376.0,4177.0,0.954,21.866,76,22,9,13,54,13,41,22,0.0,0.04
1013,976,24-09-2019 20:10:00,0,4352.0,4269.0,0.981,21.874,95,47,16,31,48,6,42,54,0.0,0.0
1013,977,24-09-2019 20:12:00,0,4133.0,4159.0,1.006,20.888,111,57,33,24,54,18,36,58,0.0,0.04
1013,978,24-09-2019 20:14:00,0,4363.0,4264.0,0.977,21.908,148,101,70,31,47,27,20,48,0.0,0.08
1013,979,24-09-2019 20:16:00,0,3768.0,3737.0,0.992,18.982,342,192,146,46,150,108,42,30,0.05,0.07
1013,980,24-09-2019 20:18:00,0,3974.0,3853.0,0.969,19.924,198,91,51,40,107,74,33,13,0.0,0.0
1013,981,24-09-2019 20:20:00,0,3637.0,3521.5,0.968,18.2285,125,60,31,29,65,35,30,26,0.0,0.0
1013,982,24-09-2019 20:22:00,0,3300.0,3190.0,0.967,16.533,179,105,80,25,74,51,23,28,0.0,0.0
1013,983,24-09-2019 20:24:00,0,4746.0,4710.0,0.992,23.914,243,89,70,19,154,115,39,26,0.1,0.0
1013,984,24-09-2019 20:26:00,0,3512.0,3340.0,0.951,17.535,111,72,53,19,39,21,18,62,0.0,0.0
1013,985,24-09-2019 20:28:00,0,3308.0,3143.0,0.95,16.513,118,34,18,16,84,56,28,0,0.0,0.0
1013,986,24-09-2019 20:30:00,0,3988.0,3885.0,0.974,20.015,41,11,2,9,30,11,19,0,0.0,0.0
1013,987,24-09-2019 20:32:00,0,4178.0,4037.0,0.966,20.929,65,24,19,5,41,24,17,0,0.0,0.0
1013,988,24-09-2019 20:34:00,0,4067.0,3984.0,0.98,20.434,9,2,1,1,7,2,5,0,0.0,0.0
1013,989,24-09-2019 20:36:00,0,3974.0,3885.0,0.978,19.96,0,0,0,0,0,0,0,0,0.0,0.0
1013,990,24-09-2019 20:38:00,0,3787.0,3735.0,0.986,19.056,15,7,5,2,8,4,4,0,0.0,0.0
1013,991,24-09-2019 20:40:00,0,3671.0,3664.0,0.998,18.52,136,61,38,23,75,39,36,29,0.0,0.0
1013,992,24-09-2019 20:42:00,0,4366.0,4264.0,0.977,21.923,108,42,19,23,66,24,42,51,0.0,0.0
1013,993,24-09-2019 20:44:00,0,4659.0,4492.0,0.964,23.33,101,48,17,31,53,3,50,56,0.0,0.0
1013,994,24-09-2019 20:46:00,0,4650.0,4521.0,0.972,23.327,103,52,30,22,51,19,32,46,0.0,0.03
1013,995,24-09-2019 20:48:00,0,4559.0,4422.0,0.97,22.859,50,19,4,15,31,9,22,29,0.0,0.05
1013,996,24-09-2019 20:50:00,0,4866.0,4719.0,0.97,24.395,217,137,95,42,80,45,35,49,0.01,0.06
1013,997,24-09-2019 20:52:00,0,4151.0,4055.0,0.977,20.842,338,194,147,47,144,114,30,73,0.12,0.01
1013,998,24-09-2019 20:54:00,0,3817.0,3712.5,0.9725,19.148,180,81,55,26,99,72,27,64,0.0,0.0
1013,999,24-09-2019 20:56:00,0,3483.0,3370.0,0.968,17.454,117,64,49,15,53,26,27,26,0.01,0.0
1013,1000,24-09-2019 20:58:00,0,3502.0,3341.0,0.954,17.494,215,144,103,41,71,42,29,24,0.0,0.0
1013,1001,24-09-2019 21:00:00,0,3509.0,3307.0,0.942,17.485,210,126,95,31,84,62,22,66,0.0,0.0
1013,1002,24-09-2019 21:02:00,0,4370.0,4199.0,0.961,21.865,168,105,72,33,63,40,23,8,0.07,0.0
1013,1003,24-09-2019 21:04:00,0,4149.0,4122.0,0.994,20.911,290,152,106,46,138,88,50,41,0.0,0.0
1013,1004,24-09-2019 21:06:00,0,4644.0,4519.0,0.973,23.3,66,31,12,19,35,3,32,57,0.0,0.03
1013,1005,24-09-2019 21:08:00,0,5041.0,4892.0,0.971,25.276,89,28,13,15,61,25,36,57,0.0,0.08
1013,1006,24-09-2019 21:10:00,0,5327.0,5183.0,0.973,26.727,179,89,62,27,90,72,18,26,0.0,0.03
1013,1007,24-09-2019 21:12:00,0,3981.0,3869.0,0.972,19.969,189,81,60,21,108,73,35,44,0.0,0.01
1013,1008,24-09-2019 21:14:00,0,4204.0,3974.0,0.945,20.961,123,68,36,32,55,32,23,18,0.11,0.0
1013,1009,24-09-2019 21:16:00,0,5307.0,5234.0,0.986,26.704,330,205,155,50,125,94,31,60,0.0,0.0
1013,1010,24-09-2019 21:18:00,0,4158.0,4035.0,0.97,20.849,93,64,42,22,29,17,12,58,0.0,0.0
1013,1011,24-09-2019 21:20:00,0,3407.0,3227.0,0.947,16.998,112,60,36,24,52,31,21,17,0.01,0.0
1013,1012,24-09-2019 21:22:00,0,3313.0,3141.0,0.948,16.529,151,57,37,20,94,61,33,5,0.0,0.0
1013,1013,24-09-2019 21:24:00,0,3525.0,3256.0,0.924,17.494,235,137,99,38,98,69,29,33,0.02,0.0
1013,1014,24-09-2019 21:26:00,0,4448.0,4387.0,0.986,22.38,206,122,89,33,84,52,32,22,0.01,0.0
1013,1015,24-09-2019 21:28:00,0,4321.0,4214.0,0.975,21.688,105,46,23,23,59,31,28,0,0.0,0.0
1013,1016,24-09-2019 21:30:00,0,4194.0,4041.0,0.964,20.996,184,87,54,33,97,54,43,15,0.0,0.0
1013,1017,24-09-2019 21:32:00,0,4263.0,4095.0,0.961,21.328,68,29,8,21,39,20,19,0,0.0,0.0
1013,1018,24-09-2019 21:34:00,0,3950.0,3891.0,0.985,19.871,11,2,0,2,9,6,3,0,0.01,0.01
1013,1019,24-09-2019 21:36:00,0,3998.0,3748.0,0.938,19.901,11,2,0,2,9,3,6,0,0.0,0.0
1013,1020,24-09-2019 21:38:00,0,3958.0,3898.0,0.985,19.911,30,5,0,5,25,10,15,0,0.0,0.0
1013,1021,24-09-2019 21:40:00,0,3662.0,3668.0,1.002,18.49,101,0,0,0,101,55,46,0,0.0,0.0
1013,1022,24-09-2019 21:42:00,0,3487.0,3437.0,0.986,17.544,16,3,0,3,13,3,10,0,0.0,0.0
1013,1023,24-09-2019 21:44:00,0,3516.0,3259.0,0.927,17.461,15,6,3,3,9,5,4,0,0.0,0.0
1013,1024,24-09-2019 21:46:00,0,3305.0,3193.0,0.966,16.557,6,2,0,2,4,2,2,0,0.0,0.0
1013,1025,24-09-2019 21:48:00,0,3314.0,3126.0,0.943,16.518,2,1,0,1,1,0,1,0,0.0,0.0
1013,1026,24-09-2019 21:50:00,0,3313.0,3143.0,0.949,16.533,4,1,0,1,3,2,1,0,0.0,0.0
1013,1027,24-09-2019 21:52:00,0,3329.0,3116.0,0.936,16.566,20,9,4,5,11,6,5,0,0.0,0.0
1013,1028,24-09-2019 21:54:00,0,3298.0,3191.0,0.967,16.527,174,60,27,33,114,67,47,5,0.0,0.0
1013,1029,24-09-2019 21:56:00,0,3695.0,3522.0,0.953,18.456,148,77,46,31,71,46,25,10,0.0,0.0
1013,1030,24-09-2019 21:58:00,0,3647.0,3651.0,1.001,18.409,250,143,107,36,107,79,28,66,0.0,0.01
1013,1031,24-09-2019 22:00:00,0,3674.0,3651.0,0.994,18.516,240,130,98,32,110,73,37,45,0.0,0.0
1013,1032,24-09-2019 22:02:00,0,3728.0,3672.5,0.9855,18.753,282,103,78,25,179,142,37,16,0.0,0.0
1013,1033,24-09-2019 22:04:00,0,3782.0,3694.0,0.977,18.99,225,142,98,44,83,65,18,18,0.0,0.0
1013,1034,24-09-2019 22:06:00,0,4152.0,4153.0,1.0,20.956,153,75,49,26,78,53,25,40,0.0,0.0
1013,1035,24-09-2019 22:08:00,0,3678.0,3611.0,0.982,18.49,48,17,0,17,31,7,24,9,0.0,0.0
1013,1036,24-09-2019 22:10:00,0,3689.0,3535.0,0.958,18.449,165,106,81,25,59,41,18,48,0.0,0.0
1013,1037,24-09-2019 22:12:00,0,3775.0,3671.0,0.973,18.937,202,110,70,40,92,56,36,22,0.0,0.0
1013,1038,24-09-2019 22:14:00,0,3698.0,3514.0,0.95,18.46,181,103,67,36,78,40,38,2,0.0,0.0
1013,1039,24-09-2019 22:16:00,0,3914.0,3622.0,0.925,19.432,78,44,26,18,34,14,20,43,0.0,0.0
1013,1040,24-09-2019 22:18:00,0,4010.0,3726.0,0.929,19.925,90,50,37,13,40,16,24,72,0.0,0.0
1013,1041,24-09-2019 22:20:00,0,4106.0,3839.0,0.935,20.426,93,46,33,13,47,26,21,43,0.0,0.46
1013,1042,24-09-2019 22:22:00,0,3703.0,3460.0,0.934,18.419,2,2,1,1,0,0,0,0,0.0,0.01
1013,1043,24-09-2019 22:24:00,0,3250.0,2951.0,0.908,16.074,44,33,11,22,11,9,2,11,0.0,0.0
1013,1044,24-09-2019 22:26:00,0,3326.0,3106.0,0.934,16.543,213,112,80,32,101,67,34,26,0.12,0.02
1013,1045,24-09-2019 22:28:00,0,3906.0,3652.0,0.935,19.433,290,154,109,45,136,93,43,32,0.0,0.0
1013,1046,24-09-2019 22:30:00,0,3982.0,3791.0,0.952,19.887,179,76,51,25,103,72,31,32,0.0,0.0
1013,1047,24-09-2019 22:32:00,0,3902.0,3623.0,0.928,19.385,123,83,63,20,40,28,12,12,0.0,0.0
1013,1048,24-09-2019 22:34:00,0,4174.0,3960.0,0.949,20.831,247,182,135,47,65,45,20,10,0.14,0.0
1013,1049,24-09-2019 22:36:00,0,4018.0,3881.5,0.967,20.129,124,51,39,12,73,39,34,5,0.0,0.0
1013,1050,24-09-2019 22:38:00,0,3862.0,3803.0,0.985,19.427,63,28,14,14,35,15,20,7,0.0,0.0
1013,1051,24-09-2019 22:40:00,0,4083.0,3933.0,0.963,20.443,267,142,101,41,125,95,30,57,0.13,0.0
1013,1052,24-09-2019 22:42:00,0,4087.0,3948.0,0.966,20.475,208,150,111,39,58,39,19,94,0.0,0.0
1013,1053,24-09-2019 22:44:00,0,3959.0,3898.0,0.985,19.912,232,145,114,31,87,62,25,66,0.04,0.0
1013,1054,24-09-2019 22:46:00,0,4259.0,4122.0,0.968,21.344,127,93,59,34,34,6,28,50,0.0,0.0
1013,1055,24-09-2019 22:48:00,0,4467.0,4324.0,0.968,22.386,96,35,18,17,61,24,37,46,0.01,0.0
1013,1056,24-09-2019 22:50:00,0,4480.0,4326.0,0.966,22.438,92,46,31,15,46,13,33,48,0.01,0.27
1013,1057,24-09-2019 22:52:00,0,3541.0,3643.0,1.029,17.986,0,0,0,0,0,0,0,0,0.0,0.01
1013,1058,24-09-2019 22:54:00,0,3408.0,3239.0,0.95,17.013,14,2,1,1,12,8,4,0,0.0,0.0
1013,1059,24-09-2019 22:56:00,0,3579.0,3510.0,0.981,17.985,245,96,72,24,149,103,46,11,0.1,0.0
1013,1060,24-09-2019 22:58:00,0,4241.0,4244.0,1.001,21.407,230,107,79,28,123,84,39,12,0.01,0.0
1013,1061,24-09-2019 23:00:00,0,3859.0,3852.0,0.998,19.469,361,185,140,45,176,130,46,13,0.0,0.0
1013,1062,24-09-2019 23:02:00,0,4265.0,4197.0,0.984,21.452,188,107,87,20,81,56,25,14,0.13,0.0
1013,1063,24-09-2019 23:04:00,0,4068.0,3984.0,0.979,20.439,41,16,5,11,25,11,14,0,0.0,0.0
1013,1064,24-09-2019 23:06:00,0,4151.0,4052.0,0.976,20.842,41,16,7,9,25,2,23,0,0.01,0.01
1013,1065,24-09-2019 23:08:00,0,4245.0,4189.0,0.987,21.363,5,5,0,5,0,0,0,0,0.0,0.0
1013,1066,24-09-2019 23:10:00,0,4208.5,4138.0,0.9835,21.162,68,40,22,18,28,11,17,0,0.0,0.0
1013,1067,24-09-2019 23:12:00,0,4172.0,4087.0,0.98,20.961,73,42,14,28,31,11,20,0,0.0,0.0
1013,1068,24-09-2019 23:14:00,0,3840.0,3889.0,1.013,19.434,12,4,0,4,8,1,7,0,0.0,0.0
1013,1069,24-09-2019 23:16:00,0,3886.0,3774.0,0.971,19.489,8,6,3,3,2,2,0,0,0.0,0.0
1013,1070,24-09-2019 23:18:00,0,3545.0,3641.0,1.027,17.998,9,5,3,2,4,1,3,0,0.0,0.0
1013,1071,24-09-2019 23:20:00,0,3347.0,3396.0,1.015,16.946,1,0,0,0,1,0,1,0,0.0,0.0
1013,1072,24-09-2019 23:22:00,0,3420.0,3247.0,0.95,17.07,3,2,0,2,1,0,1,0,0.0,0.0
1013,1073,24-09-2019 23:24:00,0,3183.0,3178.0,0.998,16.06,0,0,0,0,0,0,0,0,0.01,0.0
1013,1074,24-09-2019 23:26:00,0,3201.0,3155.0,0.986,16.103,0,0,0,0,0,0,0,0,0.0,0.0
1013,1075,24-09-2019 23:28:00,0,3200.0,3069.0,0.959,16.005,0,0,0,0,0,0,0,0,0.0,0.0
1013,1076,24-09-2019 23:30:00,0,3095.0,3023.0,0.977,15.541,6,6,1,5,0,0,0,0,0.0,0.0
1013,1077,24-09-2019 23:32:00,0,3089.0,3019.0,0.977,15.514,0,0,0,0,0,0,0,0,0.0,0.0
1013,1078,24-09-2019 23:34:00,0,2979.0,2982.0,1.001,15.038,3,3,1,2,0,0,0,0,0.0,0.0
1013,1079,24-09-2019 23:36:00,0,2876.0,2990.0,1.04,14.64,11,3,2,1,8,2,6,0,0.0,0.0
1013,1080,24-09-2019 23:38:00,0,2866.0,2998.0,1.046,14.611,22,11,3,8,11,6,5,0,0.0,0.0
1013,1081,24-09-2019 23:40:00,0,3195.0,3142.0,0.984,16.066,269,147,106,41,122,89,33,74,0.0,0.0
1013,1082,24-09-2019 23:42:00,0,3361.0,3421.0,1.018,17.029,130,79,56,23,51,28,23,24,0.0,0.0
1013,1083,24-09-2019 23:44:00,0,3501.5,3587.5,1.0245,17.767,173,83,45,38,90,50,40,47,0.0,0.0
1013,1084,24-09-2019 23:46:00,0,3642.0,3754.0,1.031,18.505,196,88,51,37,108,67,41,19,0.0,0.0
1013,1085,24-09-2019 23:48:00,0,3861.0,3838.0,0.994,19.463,164,69,52,17,95,68,27,28,0.0,0.0
1013,1086,24-09-2019 23:50:00,0,3975.0,3892.0,0.979,19.971,275,153,114,39,122,84,38,74,0.0,0.0
1013,1087,24-09-2019 23:52:00,0,3856.0,3843.0,0.997,19.448,188,86,63,23,102,79,23,30,0.0,0.0
1013,1088,24-09-2019 23:54:00,0,3966.0,3835.0,0.967,19.872,70,36,18,18,34,6,28,63,0.0,0.0
1013,1089,24-09-2019 23:56:00,0,4143.0,4132.0,0.997,20.896,62,32,15,17,30,7,23,59,0.0,0.06
1013,1090,24-09-2019 23:58:00,0,4343.0,4317.0,0.994,21.891,143,80,48,32,63,28,35,65,0.0,0.05
1013,1091,25-09-2019 00:00:00,0,4460.0,4395.0,0.985,22.437,240,115,72,43,125,87,38,30,0.11,0.11
1013,1092,25-09-2019 00:02:00,0,3573.0,3545.0,0.992,18.001,180,106,81,25,74,47,27,62,0.0,0.0
1013,1093,25-09-2019 00:04:00,0,4331.0,4275.0,0.987,21.795,105,53,30,23,52,25,27,37,0.01,0.0
1013,1094,25-09-2019 00:06:00,0,4343.0,4278.0,0.985,21.848,115,64,43,21,51,27,24,8,0.08,0.0
1013,1095,25-09-2019 00:08:00,0,3481.0,3464.0,0.995,17.549,166,95,69,26,71,50,21,19,0.0,0.0
1013,1096,25-09-2019 00:10:00,0,4354.0,4326.0,0.994,21.942,112,58,29,29,54,19,35,51,0.0,0.0
1013,1097,25-09-2019 00:12:00,0,4838.0,4708.0,0.973,24.273,111,60,36,24,51,24,27,41,0.0,0.02
1013,1098,25-09-2019 00:14:00,0,4165.0,4026.0,0.967,20.867,251,135,98,37,116,77,39,19,0.09,0.0
1013,1099,25-09-2019 00:16:00,0,3672.0,3628.0,0.988,18.486,199,112,86,26,87,54,33,42,0.0,0.0
1013,1100,25-09-2019 00:18:00,0,4103.5,4074.5,0.9925,20.6785,183,107,82,25,76,48,28,91,0.01,0.0
1013,1101,25-09-2019 00:20:00,0,4535.0,4521.0,0.997,22.871,104,58,37,21,46,22,24,58,0.0,0.01
1013,1102,25-09-2019 00:22:00,0,4749.0,4679.0,0.985,23.892,93,70,47,23,23,9,14,39,0.0,0.05
1013,1103,25-09-2019 00:24:00,0,4050.0,4122.0,1.018,20.521,384,204,164,40,180,127,53,35,0.12,0.01
1013,1104,25-09-2019 00:26:00,0,4253.0,4169.0,0.98,21.373,136,62,33,29,74,36,38,50,0.0,0.0
1013,1105,25-09-2019 00:28:00,0,4702.0,4818.0,1.025,23.86,173,105,69,36,68,42,26,22,0.0,0.04
1013,1106,25-09-2019 00:30:00,0,3559.0,3556.0,0.999,17.959,64,35,10,25,29,9,20,1,0.0,0.0
1013,1107,25-09-2019 00:32:00,0,3587.0,3488.0,0.972,17.995,67,38,11,27,29,8,21,0,0.0,0.0
1013,1108,25-09-2019 00:34:00,0,3772.0,3696.0,0.98,18.953,35,15,0,15,20,6,14,0,0.0,0.01
1013,1109,25-09-2019 00:36:00,0,3588.0,3539.0,0.986,18.056,0,0,0,0,0,0,0,0,0.0,0.0
1013,1110,25-09-2019 00:38:00,0,3585.0,3499.0,0.976,17.998,3,3,0,3,0,0,0,0,0.0,0.0
1013,1111,25-09-2019 00:40:00,0,3479.0,3441.0,0.989,17.518,0,0,0,0,0,0,0,0,0.0,0.0
1013,1112,25-09-2019 00:42:00,0,3466.0,3473.0,1.002,17.5,11,4,0,4,7,1,6,0,0.0,0.0
1013,1113,25-09-2019 00:44:00,0,3563.0,3597.0,1.01,18.02,9,2,0,2,7,0,7,0,0.0,0.0
1013,1114,25-09-2019 00:46:00,0,3566.0,3577.0,1.003,18.012,22,12,7,5,10,6,4,0,0.0,0.0
1013,1115,25-09-2019 00:48:00,0,3544.0,3564.0,1.006,17.909,18,0,0,0,18,0,18,0,0.0,0.01
1013,1116,25-09-2019 00:50:00,0,3460.0,3547.0,1.025,17.56,128,50,31,19,78,47,31,0,0.0,0.0
1013,1117,25-09-2019 00:52:00,0,3553.0,3647.5,1.0265,18.0375,272,149,107,42,123,82,41,22,0.0,0.0
1013,1118,25-09-2019 00:54:00,0,3646.0,3748.0,1.028,18.515,272,152,106,46,120,88,32,17,0.0,0.0
1013,1119,25-09-2019 00:56:00,0,3751.0,3807.0,1.015,18.992,211,117,86,31,94,68,26,79,0.0,0.0
1013,1120,25-09-2019 00:58:00,0,3278.0,3279.0,1.0,16.547,173,105,83,22,68,43,25,58,0.0,0.0
1013,1121,25-09-2019 01:00:00,0,3942.0,3946.0,1.001,19.899,296,136,103,33,160,112,48,13,0.0,0.0
1013,1122,25-09-2019 01:02:00,0,3862.0,3800.0,0.984,19.425,268,126,83,43,142,104,38,41,0.0,0.0
1013,1123,25-09-2019 01:04:00,0,3956.0,3924.0,0.992,19.931,185,98,66,32,87,63,24,31,0.05,0.0
1013,1124,25-09-2019 01:06:00,0,4161.0,4116.0,0.989,20.95,160,76,43,33,84,53,31,21,0.01,0.0
1013,1125,25-09-2019 01:08:00,0,3970.0,3817.0,0.961,19.869,234,114,83,31,120,85,35,15,0.0,0.0
1013,1126,25-09-2019 01:10:00,0,3938.0,3960.0,1.006,19.9,102,56,30,26,46,20,26,51,0.0,0.0
1013,1127,25-09-2019 01:12:00,0,4328.0,4361.0,1.008,21.879,312,176,143,33,136,102,34,63,0.0,0.01
1013,1128,25-09-2019 01:14:00,0,3646.0,3652.0,1.002,18.408,104,48,28,20,56,14,42,44,0.0,0.02
1013,1129,25-09-2019 01:16:00,0,4645.0,4576.0,0.985,23.369,81,45,27,18,36,8,28,47,0.01,0.06
1013,1130,25-09-2019 01:18:00,0,4655.0,4476.0,0.962,23.296,102,53,27,26,49,21,28,43,0.0,0.02
1013,1131,25-09-2019 01:20:00,0,4456.0,4329.0,0.971,22.349,94,57,30,27,37,4,33,51,0.0,0.11
1013,1132,25-09-2019 01:22:00,0,4445.0,4401.0,0.99,22.385,156,76,53,23,80,48,32,33,0.0,0.03
1013,1133,25-09-2019 01:24:00,0,3707.0,3505.0,0.946,18.484,219,111,78,33,108,76,32,18,0.13,0.0
1013,1134,25-09-2019 01:26:00,0,3933.0,3825.0,0.9715,19.729,202,92,56,36,110,81,29,3,0.0,0.0
1013,1135,25-09-2019 01:28:00,0,4159.0,4145.0,0.997,20.974,206,114,83,31,92,66,26,6,0.0,0.0
1013,1136,25-09-2019 01:30:00,0,3555.0,3499.0,0.984,17.882,100,42,23,19,58,30,28,0,0.0,0.0
1013,1137,25-09-2019 01:32:00,0,3750.0,3742.0,0.998,18.919,13,4,0,4,9,2,7,0,0.0,0.0
1013,1138,25-09-2019 01:34:00,0,3955.0,3955.0,1.0,19.96,95,52,29,23,43,17,26,0,0.0,0.0
1013,1139,25-09-2019 01:36:00,0,3857.0,3855.0,0.999,19.465,15,8,6,2,7,1,6,0,0.0,0.0
1013,1140,25-09-2019 01:38:00,0,3851.0,3858.0,1.002,19.442,1,0,0,0,1,0,1,0,0.0,0.0
1013,1141,25-09-2019 01:40:00,0,3758.0,3729.0,0.992,18.934,2,2,1,1,0,0,0,0,0.0,0.0
1013,1142,25-09-2019 01:42:00,0,3559.0,3576.0,1.005,17.98,1,1,0,1,0,0,0,0,0.01,0.01
1013,1143,25-09-2019 01:44:00,0,3584.0,3504.0,0.978,18.0,1,1,1,0,0,0,0,0,0.0,0.0
1013,1144,25-09-2019 01:46:00,0,3352.0,3385.0,1.01,16.956,21,20,3,17,1,1,0,0,0.0,0.0
1013,1145,25-09-2019 01:48:00,0,3275.0,3293.0,1.006,16.55,0,0,0,0,0,0,0,0,0.0,0.0
1013,1146,25-09-2019 01:50:00,0,3177.0,3227.0,1.016,16.089,10,6,3,3,4,1,3,0,0.0,0.0
1013,1147,25-09-2019 01:52:00,0,3160.0,3266.0,1.033,16.065,26,15,6,9,11,5,6,0,0.0,0.0
1013,1148,25-09-2019 01:54:00,0,3173.0,3282.0,1.034,16.136,5,5,1,4,0,0,0,0,0.0,0.0
1013,1149,25-09-2019 01:56:00,0,3159.0,3295.0,1.043,16.092,43,43,0,43,0,0,0,0,0.01,0.0
1013,1150,25-09-2019 01:58:00,0,3157.0,3212.0,1.017,15.996,4,0,0,0,4,1,3,0,0.0,0.0
1013,1151,25-09-2019 02:00:00,0,3122.0,3148.0,1.008,15.786,26,0,0,0,26,0,26,0,0.0,0.0
1013,1152,25-09-2019 02:02:00,0,3087.0,3084.0,0.999,15.576,7,0,0,0,7,0,7,0,0.0,0.0
1013,1153,25-09-2019 02:04:00,0,2968.0,3042.0,1.025,15.062,0,0,0,0,0,0,0,0,0.0,0.0
1013,1154,25-09-2019 02:06:00,0,3084.0,3113.0,1.009,15.599,3,1,0,1,2,0,2,0,0.0,0.0
1013,1155,25-09-2019 02:08:00,0,2838.0,3042.0,1.072,14.55,10,2,0,2,8,0,8,0,0.0,0.0
1013,1156,25-09-2019 02:10:00,0,2884.0,2943.0,1.021,14.621,4,0,0,0,4,0,4,0,0.0,0.0
1013,1157,25-09-2019 02:12:00,0,2784.0,2821.0,1.013,14.093,6,3,2,1,3,0,3,0,0.0,0.0
1013,1158,25-09-2019 02:14:00,0,2693.0,2753.0,1.022,13.659,0,0,0,0,0,0,0,0,0.0,0.0
1013,1159,25-09-2019 02:16:00,0,2685.0,2693.0,1.003,13.561,0,0,0,0,0,0,0,0,0.0,0.0
1013,1160,25-09-2019 02:18:00,0,2693.0,2687.0,0.998,13.585,12,12,0,12,0,0,0,0,0.0,0.0
1013,1161,25-09-2019 02:20:00,0,2687.0,2742.0,1.02,13.622,27,15,8,7,12,7,5,0,0.0,0.0
1013,1162,25-09-2019 02:22:00,0,2657.0,2841.0,1.069,13.614,16,0,0,0,16,0,16,0,0.0,0.0
1013,1163,25-09-2019 02:24:00,0,2677.0,2815.0,1.051,13.665,31,5,2,3,26,0,26,0,0.0,0.0
1013,1164,25-09-2019 02:26:00,0,2707.0,2700.0,0.997,13.656,24,3,0,3,21,0,21,0,0.0,0.0
1013,1165,25-09-2019 02:28:00,0,2685.0,2750.0,1.024,13.624,340,189,148,41,151,114,37,20,0.0,0.0
1013,1166,25-09-2019 02:30:00,0,3076.0,3131.0,1.018,15.585,50,12,2,10,38,9,29,38,0.0,0.03
1013,1167,25-09-2019 02:32:00,0,3439.0,3581.0,1.041,17.514,116,51,31,20,65,42,23,24,0.0,0.01
1013,1168,25-09-2019 02:34:00,0,3412.0,3474.0,1.018,17.289,300,185,137,48,115,76,39,58,0.0,0.0
1013,1169,25-09-2019 02:36:00,0,3385.0,3367.0,0.995,17.064,173,101,67,34,72,44,28,19,0.08,0.0
1013,1170,25-09-2019 02:38:00,0,3523.0,3700.0,1.05,17.978,104,56,31,25,48,34,14,49,0.0,0.0
1013,1171,25-09-2019 02:40:00,0,3353.0,3473.0,1.036,17.055,56,17,5,12,39,15,24,2,0.0,0.0
1013,1172,25-09-2019 02:42:00,0,3507.0,3758.0,1.072,17.976,142,60,36,24,82,39,43,68,0.0,0.0
1013,1173,25-09-2019 02:44:00,0,4027.0,4122.0,1.024,20.428,103,31,2,29,72,23,49,49,0.0,0.0
1013,1174,25-09-2019 02:46:00,0,4217.0,4354.0,1.032,21.436,49,10,3,7,39,4,35,36,0.0,0.13
1013,1175,25-09-2019 02:48:00,0,4319.0,4431.0,1.026,21.921,90,29,4,25,61,20,41,46,0.0,0.06
1013,1176,25-09-2019 02:50:00,0,4241.0,4281.0,1.01,21.448,292,166,126,40,126,88,38,25,0.0,0.0
1013,1177,25-09-2019 02:52:00,0,3550.0,3566.0,1.004,17.935,428,223,171,52,205,150,55,32,0.09,0.01
1013,1178,25-09-2019 02:54:00,0,3665.0,3650.0,0.996,18.48,352,181,139,42,171,124,47,12,0.0,0.1
1013,1179,25-09-2019 02:56:00,0,4508.0,4580.0,1.016,22.832,170,82,56,26,88,52,36,13,0.14,0.0
1013,1180,25-09-2019 02:58:00,0,3755.0,3779.0,1.006,18.977,69,34,20,14,35,20,15,4,0.0,0.0
1013,1181,25-09-2019 03:00:00,0,3558.0,3621.0,1.018,18.027,129,80,60,20,49,25,24,50,0.0,0.0
1013,1182,25-09-2019 03:02:00,0,4325.0,4395.0,1.016,21.904,45,32,22,10,13,2,11,38,0.0,0.0
1013,1183,25-09-2019 03:04:00,0,4554.0,4455.0,0.978,22.874,160,109,84,25,51,37,14,95,0.0,0.03
1013,1184,25-09-2019 03:06:00,0,3828.0,3984.0,1.041,19.493,253,133,89,44,120,75,45,12,0.19,0.01
1013,1185,25-09-2019 03:08:00,0,3846.5,3882.5,1.0095,19.454,49,18,7,11,31,16,15,0,0.0,0.0
1013,1186,25-09-2019 03:10:00,0,3865.0,3781.0,0.978,19.415,70,28,8,20,42,8,34,0,0.0,0.0
1013,1187,25-09-2019 03:12:00,0,3839.0,3887.0,1.013,19.428,74,37,21,16,37,17,20,0,0.0,0.0
1013,1188,25-09-2019 03:14:00,0,3758.0,3722.0,0.99,18.928,52,11,4,7,41,21,20,0,0.0,0.0
1013,1189,25-09-2019 03:16:00,0,3882.0,3784.0,0.975,19.484,1,1,0,1,0,0,0,0,0.0,0.0
1013,1190,25-09-2019 03:18:00,0,3524.0,3654.0,1.037,17.929,0,0,0,0,0,0,0,0,0.0,0.0
1013,1191,25-09-2019 03:20:00,0,3568.0,3506.0,0.983,17.94,6,1,1,0,5,4,1,0,0.0,0.0
1013,1192,25-09-2019 03:22:00,0,3370.0,3350.0,0.994,16.986,0,0,0,0,0,0,0,0,0.0,0.0
1013,1193,25-09-2019 03:24:00,0,3162.0,3274.0,1.035,16.082,3,3,0,3,0,0,0,0,0.0,0.0
1013,1194,25-09-2019 03:26:00,0,3168.0,3220.0,1.016,16.048,0,0,0,0,0,0,0,0,0.0,0.0
1013,1195,25-09-2019 03:28:00,0,3184.0,3166.0,0.995,16.049,4,4,0,4,0,0,0,0,0.0,0.0
1013,1196,25-09-2019 03:30:00,0,3189.0,3189.0,1.0,16.097,5,2,0,2,3,1,2,0,0.0,0.0
1013,1197,25-09-2019 03:32:00,0,3175.0,3166.0,0.997,16.013,9,7,5,2,2,2,0,0,0.0,0.0
1013,1198,25-09-2019 03:34:00,0,3176.0,3208.0,1.01,16.063,5,3,1,2,2,1,1,0,0.0,0.0
1013,1199,25-09-2019 03:36:00,0,3070.0,3115.0,1.015,15.546,1,1,0,1,0,0,0,0,0.0,0.0
1013,1200,25-09-2019 03:38:00,0,2974.0,3073.0,1.034,15.119,33,15,7,8,18,7,11,0,0.0,0.0
1013,1201,25-09-2019 03:40:00,0,2880.0,2925.0,1.016,14.587,0,0,0,0,0,0,0,0,0.0,0.0
1013,1202,25-09-2019 03:42:00,0,2945.5,2913.5,0.99,14.831,20,12,7,5,8,2,6,0,0.0,0.0
1013,1203,25-09-2019 03:44:00,0,3011.0,2902.0,0.964,15.075,5,1,0,1,4,0,4,0,0.0,0.0
1013,1204,25-09-2019 03:46:00,0,2997.0,2936.0,0.98,15.059,24,4,0,4,20,0,20,0,0.0,0.0
1013,1205,25-09-2019 03:48:00,0,3005.0,2958.0,0.984,15.113,16,1,1,0,15,2,13,0,0.0,0.0
1013,1206,25-09-2019 03:50:00,0,2979.0,2981.0,1.001,15.036,51,11,0,11,40,17,23,0,0.0,0.0
1013,1207,25-09-2019 03:52:00,0,3000.0,2959.0,0.986,15.095,32,10,5,5,22,12,10,0,0.0,0.0
1013,1208,25-09-2019 03:54:00,0,2992.0,2928.0,0.978,15.03,22,3,0,3,19,6,13,0,0.0,0.0
1013,1209,25-09-2019 03:56:00,0,3000.0,2929.0,0.976,15.06,15,4,1,3,11,2,9,0,0.0,0.0
1013,1210,25-09-2019 03:58:00,0,3008.0,2915.0,0.969,15.077,22,12,7,5,10,6,4,0,0.0,0.0
1013,1211,25-09-2019 04:00:00,0,3001.0,2922.0,0.974,15.058,14,1,0,1,13,1,12,0,0.0,0.0
1013,1212,25-09-2019 04:02:00,0,3015.0,2902.0,0.963,15.092,6,4,2,2,2,1,1,0,0.0,0.0
1013,1213,25-09-2019 04:04:00,0,3011.0,2920.0,0.97,15.097,0,0,0,0,0,0,0,0,0.0,0.0
1013,1214,25-09-2019 04:06:00,0,3005.0,2900.0,0.965,15.049,7,2,1,1,5,4,1,0,0.0,0.0
1013,1215,25-09-2019 04:08:00,0,2973.0,3017.0,1.015,15.052,0,0,0,0,0,0,0,0,0.0,0.0
1013,1216,25-09-2019 04:10:00,0,2964.0,3038.0,1.025,15.041,16,10,3,7,6,2,4,0,0.0,0.0
1013,1217,25-09-2019 04:12:00,0,3016.0,2913.0,0.966,15.109,13,7,2,5,6,1,5,0,0.0,0.0
1013,1218,25-09-2019 04:14:00,0,2804.0,2776.0,0.99,14.122,7,7,0,7,0,0,0,0,0.0,0.0
1013,1219,25-09-2019 04:16:00,0,2908.5,2842.0,0.9775,14.607,92,46,22,24,46,20,26,0,0.0,0.0
1013,1220,25-09-2019 04:18:00,0,3013.0,2908.0,0.965,15.092,110,49,22,27,61,24,37,0,0.0,0.0
1013,1221,25-09-2019 04:20:00,0,3272.0,3283.0,1.003,16.525,136,66,34,32,70,32,38,0,0.0,0.0
1013,1222,25-09-2019 04:22:00,0,3469.0,3493.0,1.007,17.535,183,106,77,29,77,47,30,35,0.0,0.03
1013,1223,25-09-2019 04:24:00,0,3652.0,3688.0,1.01,18.473,74,39,24,15,35,7,28,20,0.0,0.01
1013,1224,25-09-2019 04:26:00,0,3960.0,3919.0,0.99,19.939,48,20,13,7,28,17,11,4,0.0,0.35
1013,1225,25-09-2019 04:28:00,0,3467.0,3495.0,1.008,17.531,52,29,2,27,23,1,22,0,0.0,0.01
1013,1226,25-09-2019 04:30:00,0,3596.0,3502.0,0.974,18.047,37,18,0,18,19,0,19,0,0.0,0.0
1013,1227,25-09-2019 04:32:00,0,3668.0,3619.0,0.987,18.459,395,216,167,49,179,128,51,30,0.05,0.0
1013,1228,25-09-2019 04:34:00,0,4162.0,4082.0,0.981,20.916,476,282,221,61,194,136,58,28,0.09,0.0
1013,1229,25-09-2019 04:36:00,0,3929.0,4008.0,1.02,19.917,535,308,244,64,227,174,53,31,0.01,0.03
1013,1230,25-09-2019 04:38:00,0,4166.0,4064.0,0.975,20.912,591,371,307,64,220,164,56,15,0.0,0.0
1013,1231,25-09-2019 04:40:00,0,4161.0,4065.0,0.977,20.895,396,225,176,49,171,131,40,9,0.0,0.01
1013,1232,25-09-2019 04:42:00,0,4138.0,4138.0,1.0,20.884,301,122,93,29,179,139,40,12,0.06,0.0
1013,1233,25-09-2019 04:44:00,0,3972.0,3901.0,0.982,19.968,142,84,69,15,58,43,15,0,0.0,0.0
1013,1234,25-09-2019 04:46:00,0,3962.0,3942.0,0.995,19.972,196,107,79,28,89,49,40,0,0.0,0.0
1013,1235,25-09-2019 04:48:00,0,3948.0,3941.0,0.998,19.92,373,187,139,48,186,140,46,7,0.1,0.0
1013,1236,25-09-2019 04:50:00,0,3997.0,3992.5,0.9985,20.17,431,217,163,54,214,163,51,8,0.0,0.0
1013,1237,25-09-2019 04:52:00,0,4046.0,4044.0,0.999,20.42,502,306,231,75,196,144,52,11,0.0,0.01
1013,1238,25-09-2019 04:54:00,0,4039.0,4110.0,1.018,20.464,217,146,118,28,71,40,31,0,0.0,0.0
1013,1239,25-09-2019 04:56:00,0,3828.0,3921.0,1.024,19.424,66,30,5,25,36,2,34,0,0.01,0.0
1013,1240,25-09-2019 04:58:00,0,3859.0,3835.0,0.994,19.449,38,21,4,17,17,0,17,0,0.0,0.0
1013,1241,25-09-2019 05:00:00,0,3845.0,3908.0,1.016,19.475,69,55,30,25,14,6,8,0,0.0,0.0
1013,1242,25-09-2019 05:02:00,0,3843.0,3855.0,1.003,19.408,30,13,6,7,17,1,16,0,0.0,0.0
1013,1243,25-09-2019 05:04:00,0,3747.0,3721.0,0.993,18.883,1,0,0,0,1,0,1,0,0.0,0.0
1013,1244,25-09-2019 05:06:00,0,3561.0,3578.0,1.005,17.991,5,1,1,0,4,2,2,0,0.0,0.0
1013,1245,25-09-2019 05:08:00,0,3355.0,3450.0,1.028,17.04,2,0,0,0,2,0,2,0,0.0,0.0
1013,1246,25-09-2019 05:10:00,0,3375.0,3343.0,0.991,16.998,6,2,1,1,4,3,1,0,0.0,0.0
1013,1247,25-09-2019 05:12:00,0,3394.0,3295.0,0.971,17.02,4,3,0,3,1,1,0,0,0.0,0.0
1013,1248,25-09-2019 05:14:00,0,3150.0,3262.0,1.036,16.021,0,0,0,0,0,0,0,0,0.0,0.0
1013,1249,25-09-2019 05:16:00,0,3166.0,3250.0,1.026,16.073,3,3,0,3,0,0,0,0,0.0,0.0
1013,1250,25-09-2019 05:18:00,0,3184.0,3161.0,0.993,16.043,11,9,2,7,2,2,0,0,0.0,0.0
1013,1251,25-09-2019 05:20:00,0,3180.0,3217.0,1.011,16.091,5,5,1,4,0,0,0,0,0.0,0.0
1013,1252,25-09-2019 05:22:00,0,2964.0,3083.0,1.04,15.091,4,3,0,3,1,0,1,0,0.0,0.0
1013,1253,25-09-2019 05:24:00,0,2958.5,3076.0,1.0395,15.0615,6,4,0,4,2,0,2,0,0.0,0.0
1013,1254,25-09-2019 05:26:00,0,2953.0,3069.0,1.039,15.032,47,23,11,12,24,14,10,1,0.01,0.0
1013,1255,25-09-2019 05:28:00,0,2961.0,3107.0,1.049,15.105,0,0,0,0,0,0,0,0,0.0,0.0
1013,1256,25-09-2019 05:30:00,0,2853.0,3020.0,1.059,14.583,3,1,1,0,2,0,2,0,0.0,0.0
1013,1257,25-09-2019 05:32:00,0,2869.0,2990.0,1.042,14.614,3,0,0,0,3,0,3,0,0.0,0.0
1013,1258,25-09-2019 05:34:00,0,2871.0,2912.0,1.014,14.538,2,0,0,0,2,1,1,0,0.0,0.0
1013,1259,25-09-2019 05:36:00,0,2885.0,2885.0,1.0,14.562,5,0,0,0,5,1,4,0,0.0,0.0
1013,1260,25-09-2019 05:38:00,0,2863.0,2986.0,1.043,14.585,0,0,0,0,0,0,0,0,0.0,0.0
1013,1261,25-09-2019 05:40:00,0,2865.0,3023.0,1.055,14.635,10,1,0,1,9,3,6,0,0.0,0.0
1013,1262,25-09-2019 05:42:00,0,2873.0,2985.0,1.039,14.624,1,0,0,0,1,0,1,0,0.0,0.0
1013,1263,25-09-2019 05:44:00,0,2860.0,2976.0,1.04,14.564,203,116,87,29,87,56,31,31,0.0,0.0
1013,1264,25-09-2019 05:46:00,0,3078.0,3098.0,1.007,15.556,141,81,57,24,60,39,21,43,0.0,0.0
1013,1265,25-09-2019 05:48:00,0,3139.0,3321.0,1.058,16.044,328,152,114,38,176,123,53,75,0.0,0.0
1013,1266,25-09-2019 05:50:00,0,3148.0,3276.0,1.04,16.031,83,54,36,18,29,19,10,12,0.0,0.0
1013,1267,25-09-2019 05:52:00,0,3571.0,3620.0,1.014,18.078,176,101,68,33,75,44,31,35,0.0,0.0
1013,1268,25-09-2019 05:54:00,0,3347.0,3471.0,1.037,17.031,317,199,152,47,118,94,24,62,0.0,0.01
1013,1269,25-09-2019 05:56:00,0,3366.0,3406.0,1.012,17.034,364,167,118,49,197,145,52,17,0.0,0.0
1013,1270,25-09-2019 05:58:00,0,3503.5,3562.5,1.0165,17.748,109,62,41,21,47,25,22,31,0.0,0.0
1013,1271,25-09-2019 06:00:00,1,3641.0,3719.0,1.021,18.462,201,117,85,32,84,56,28,53,0.0,0.0
1013,1272,25-09-2019 06:02:00,1,3864.0,3838.0,0.993,19.473,168,97,66,31,71,45,26,29,0.0,0.0
1013,1273,25-09-2019 06:04:00,1,3847.0,3859.0,1.003,19.43,74,41,19,22,33,3,30,59,0.0,0.0
1013,1274,25-09-2019 06:06:00,1,3833.0,3959.0,1.033,19.484,241,134,96,38,107,72,35,23,0.0,0.0
1013,1275,25-09-2019 06:08:00,1,3378.0,3409.0,1.009,17.085,68,24,13,11,44,20,24,0,0.0,0.0
1013,1276,25-09-2019 06:10:00,1,3586.0,3482.0,0.971,17.983,372,200,151,49,172,126,46,12,0.0,0.0
1013,1277,25-09-2019 06:12:00,1,3829.0,3946.0,1.031,19.455,202,121,90,31,81,53,28,29,0.06,0.02
1013,1278,25-09-2019 06:14:00,1,3556.0,3668.0,1.032,18.069,182,94,66,28,88,50,38,0,0.0,0.0
1013,1279,25-09-2019 06:16:00,1,3538.0,3637.0,1.028,17.964,179,105,67,38,74,43,31,8,0.01,0.0
1013,1280,25-09-2019 06:18:00,1,3559.0,3557.0,1.0,17.959,25,12,4,8,13,2,11,0,0.0,0.0
1013,1281,25-09-2019 06:20:00,1,3364.0,3364.0,1.0,16.978,3,2,1,1,1,1,0,0,0.0,0.0
1013,1282,25-09-2019 06:22:00,1,3296.0,3241.0,0.983,16.574,18,14,8,6,4,1,3,0,0.0,0.0
1013,1283,25-09-2019 06:24:00,1,3189.0,3175.0,0.996,16.078,0,0,0,0,0,0,0,0,0.0,0.0
1013,1284,25-09-2019 06:26:00,1,3205.0,3086.0,0.963,16.044,17,15,7,8,2,0,2,0,0.0,0.0
1013,1285,25-09-2019 06:28:00,1,3179.0,3139.0,0.987,16.002,2,2,0,2,0,0,0,0,0.0,0.0
1013,1286,25-09-2019 06:30:00,1,3210.0,3071.0,0.957,16.047,0,0,0,0,0,0,0,0,0.0,0.0
1013,1287,25-09-2019 06:32:00,1,3045.0,3018.0,0.9935,15.3375,19,4,2,2,15,1,14,0,0.0,0.0
1013,1288,25-09-2019 06:34:00,1,2880.0,2965.0,1.03,14.628,11,0,0,0,11,0,11,0,0.0,0.0
1013,1289,25-09-2019 06:36:00,1,2904.0,2873.0,0.989,14.623,2,0,0,0,2,0,2,0,0.0,0.0
1013,1290,25-09-2019 06:38:00,1,2914.0,2816.0,0.966,14.598,6,3,0,3,3,1,2,0,0.0,0.0
1013,1291,25-09-2019 06:40:00,1,2723.0,2648.0,0.972,13.662,0,0,0,0,0,0,0,0,0.0,0.0
1013,1292,25-09-2019 06:42:00,1,2730.0,2555.0,0.936,13.584,4,3,1,2,1,0,1,0,0.0,0.0
1013,1293,25-09-2019 06:44:00,1,2627.0,2523.0,0.96,13.144,13,2,0,2,11,0,11,0,0.0,0.0
1013,1294,25-09-2019 06:46:00,1,2525.0,2477.0,0.981,12.692,20,1,0,1,19,0,19,0,0.0,0.0
1013,1295,25-09-2019 06:48:00,1,2520.0,2423.0,0.961,12.613,28,12,4,8,16,2,14,0,0.0,0.0
1013,1296,25-09-2019 06:50:00,1,2517.0,2467.0,0.98,12.647,78,52,20,32,26,13,13,0,0.0,0.0
1013,1297,25-09-2019 06:52:00,1,2699.0,2710.0,1.004,13.636,181,123,78,45,58,29,29,16,0.01,0.0
1013,1298,25-09-2019 06:54:00,1,2897.0,2895.0,0.999,14.62,117,84,58,26,33,16,17,37,0.0,0.0
1013,1299,25-09-2019 06:56:00,1,3173.0,3175.0,1.001,16.017,168,103,75,28,65,45,20,28,0.0,0.0
1013,1300,25-09-2019 06:58:00,1,3223.0,3046.0,0.945,16.072,240,120,90,30,120,91,29,105,0.0,0.0
1013,1301,25-09-2019 07:00:00,1,3397.0,3260.0,0.959,16.994,165,91,57,34,74,33,41,36,0.0,0.0
1013,1302,25-09-2019 07:02:00,1,3597.0,3460.0,0.962,18.004,121,76,37,39,45,15,30,51,0.0,0.02
1013,1303,25-09-2019 07:04:00,1,3618.0,3421.0,0.946,18.042,92,35,15,20,57,29,28,0,0.0,0.0
1013,1304,25-09-2019 07:06:00,1,3312.5,3157.0,0.954,16.546,120,80,50,30,40,26,14,0,0.0,0.0
1013,1305,25-09-2019 07:08:00,1,3007.0,2893.0,0.962,15.05,34,33,12,21,1,0,1,0,0.0,0.0
1013,1306,25-09-2019 07:10:00,1,2909.0,2853.0,0.981,14.622,23,16,1,15,7,2,5,0,0.0,0.0
1013,1307,25-09-2019 07:12:00,1,3125.0,2920.0,0.934,15.546,7,2,0,2,5,0,5,0,0.0,0.0
1013,1308,25-09-2019 07:14:00,1,3245.0,2986.0,0.92,16.092,0,0,0,0,0,0,0,0,0.0,0.0
1013,1309,25-09-2019 07:16:00,1,3112.0,2917.0,0.938,15.489,7,5,0,5,2,1,1,0,0.0,0.0
1013,1310,25-09-2019 07:18:00,1,2935.0,2796.0,0.952,14.661,2,0,0,0,2,1,1,0,0.0,0.0
1013,1311,25-09-2019 07:20:00,1,2713.0,2631.0,0.97,13.6,4,0,0,0,4,0,4,0,0.0,0.0
1013,1312,25-09-2019 07:22:00,1,2739.0,2559.0,0.934,13.625,8,6,1,5,2,0,2,0,0.0,0.01
1013,1313,25-09-2019 07:24:00,1,2744.0,2510.0,0.915,13.592,3,3,1,2,0,0,0,0,0.0,0.0
1013,1314,25-09-2019 07:26:00,1,2513.0,2464.0,0.98,12.631,0,0,0,0,0,0,0,0,0.0,0.0
1013,1315,25-09-2019 07:28:00,1,2523.0,2479.0,0.983,12.684,0,0,0,0,0,0,0,0,0.0,0.0
1013,1316,25-09-2019 07:30:00,1,2762.0,2535.0,0.918,13.691,6,2,0,2,4,2,2,0,0.0,0.0
1013,1317,25-09-2019 07:32:00,1,2694.0,2665.0,0.989,13.564,13,0,0,0,13,1,12,0,0.0,0.0
1013,1318,25-09-2019 07:34:00,1,2908.0,2860.0,0.984,14.623,0,0,0,0,0,0,0,0,0.0,0.0
1013,1319,25-09-2019 07:36:00,1,2893.0,2868.0,0.991,14.572,5,0,0,0,5,3,2,0,0.0,0.0
1013,1320,25-09-2019 07:38:00,1,3117.0,2959.0,0.949,15.558,0,0,0,0,0,0,0,0,0.0,0.0
1013,1321,25-09-2019 07:40:00,1,3176.0,2954.5,0.9305,15.784,0,0,0,0,0,0,0,0,0.0,0.0
1013,1322,25-09-2019 07:42:00,1,3235.0,2950.0,0.912,16.01,37,11,9,2,26,14,12,0,0.0,0.0
1013,1323,25-09-2019 07:44:00,1,3248.0,2936.0,0.904,16.049,1,0,0,0,1,0,1,0,0.0,0.0
1013,1324,25-09-2019 07:46:00,1,3051.0,2757.0,0.904,15.075,0,0,0,0,0,0,0,0,0.0,0.0
1013,1325,25-09-2019 07:48:00,1,2953.0,2656.0,0.9,14.574,0,0,0,0,0,0,0,0,0.0,0.0
1013,1326,25-09-2019 07:50:00,1,2850.0,2632.0,0.924,14.141,17,6,3,3,11,8,3,0,0.0,0.0
1013,1327,25-09-2019 07:52:00,1,2845.0,2578.0,0.906,14.062,12,8,2,6,4,2,2,0,0.0,0.0
1013,1328,25-09-2019 07:54:00,1,2858.0,2508.0,0.878,14.036,10,4,1,3,6,2,4,0,0.0,0.0
1013,1329,25-09-2019 07:56:00,1,2860.0,2564.0,0.896,14.109,28,11,5,6,17,9,8,0,0.0,0.0
1013,1330,25-09-2019 07:58:00,1,2682.0,2311.0,0.862,13.128,8,2,1,1,6,0,6,0,0.0,0.0
1013,1331,25-09-2019 08:00:00,1,2684.0,2335.0,0.87,13.159,0,0,0,0,0,0,0,0,0.0,0.0
1013,1332,25-09-2019 08:02:00,1,2891.0,2413.0,0.835,14.061,0,0,0,0,0,0,0,0,0.0,0.0
1013,1333,25-09-2019 08:04:00,1,2874.0,2473.0,0.861,14.06,5,1,1,0,4,3,1,0,0.0,0.0
1013,1334,25-09-2019 08:06:00,1,2853.0,2553.0,0.895,14.065,3,3,1,2,0,0,0,0,0.0,0.0
1013,1335,25-09-2019 08:08:00,1,3057.0,2726.0,0.892,15.062,2,2,1,1,0,0,0,0,0.01,0.0
1013,1336,25-09-2019 08:10:00,1,3076.0,2686.0,0.873,15.094,1,1,1,0,0,0,0,0,0.0,0.0
1013,1337,25-09-2019 08:12:00,1,2863.0,2527.0,0.883,14.077,2,2,1,1,0,0,0,0,0.0,0.0
1013,1338,25-09-2019 08:14:00,1,2712.5,2438.0,0.9,13.3855,6,5,2,3,1,1,0,0,0.0,0.0
1013,1339,25-09-2019 08:16:00,1,2562.0,2349.0,0.917,12.694,46,37,26,11,9,5,4,0,0.0,0.0
1013,1340,25-09-2019 08:18:00,1,2977.0,2584.0,0.868,14.588,133,89,59,30,44,23,21,9,0.0,0.0
1013,1341,25-09-2019 08:20:00,1,3450.0,3060.0,0.887,16.981,224,141,110,31,83,57,26,68,0.0,0.0
1013,1342,25-09-2019 08:22:00,1,3448.0,3093.0,0.897,17.011,271,122,89,33,149,114,35,41,0.0,0.0
1013,1343,25-09-2019 08:24:00,1,3519.0,3217.0,0.914,17.428,53,22,10,12,31,2,29,5,0.0,0.0
1013,1344,25-09-2019 08:26:00,1,3633.0,3313.0,0.912,17.982,175,82,53,29,93,50,43,49,0.0,0.0
1013,1345,25-09-2019 08:28:00,1,3616.0,3400.0,0.94,18.009,126,77,48,29,49,14,35,39,0.0,0.0
1013,1346,25-09-2019 08:30:00,1,3929.0,3549.0,0.903,19.411,324,161,110,51,163,108,55,21,0.0,0.01
1013,1347,25-09-2019 08:32:00,1,3408.0,3190.0,0.936,16.961,488,251,198,53,237,178,59,4,0.0,0.03
1013,1348,25-09-2019 08:34:00,1,3633.0,3393.0,0.934,18.068,172,66,43,23,106,70,36,1,0.0,0.0
1013,1349,25-09-2019 08:36:00,1,3338.0,3027.0,0.907,16.501,74,35,12,23,39,19,20,0,0.0,0.0
1013,1350,25-09-2019 08:38:00,1,3480.0,3049.0,0.876,17.087,36,16,5,11,20,7,13,0,0.0,0.0
1013,1351,25-09-2019 08:40:00,1,3423.0,3188.0,0.931,17.017,74,51,24,27,23,4,19,0,0.0,0.0
1013,1352,25-09-2019 08:42:00,1,3413.0,3176.0,0.931,16.961,23,13,1,12,10,0,10,0,0.0,0.0
1013,1353,25-09-2019 08:44:00,1,3363.0,3049.0,0.907,16.624,6,1,0,1,5,0,5,0,0.0,0.0
1013,1354,25-09-2019 08:46:00,1,3256.0,2857.0,0.878,15.992,17,4,1,3,13,1,12,0,0.0,0.0
1013,1355,25-09-2019 08:48:00,1,3109.5,2728.0,0.8775,15.2705,9,8,2,6,1,0,1,0,0.0,0.0
1013,1356,25-09-2019 08:50:00,1,2963.0,2599.0,0.877,14.549,15,15,0,15,0,0,0,0,0.0,0.0
1013,1357,25-09-2019 08:52:00,1,2761.0,2495.0,0.904,13.64,33,24,3,21,9,0,9,0,0.0,0.0
1013,1358,25-09-2019 08:54:00,1,2756.0,2448.0,0.888,13.568,82,46,21,25,36,17,19,0,0.0,0.0
1013,1359,25-09-2019 08:56:00,1,2840.0,2587.0,0.911,14.056,0,0,0,0,0,0,0,0,0.0,0.0
1013,1360,25-09-2019 08:58:00,1,2742.0,2542.0,0.927,13.619,0,0,0,0,0,0,0,0,0.0,0.0
1013,1361,25-09-2019 09:00:00,1,2763.0,2431.0,0.88,13.579,0,0,0,0,0,0,0,0,0.0,0.0
1013,1362,25-09-2019 09:02:00,1,2669.0,2389.0,0.895,13.159,0,0,0,0,0,0,0,0,0.0,0.0
1013,1363,25-09-2019 09:04:00,1,2664.0,2352.0,0.883,13.101,2,2,1,1,0,0,0,0,0.0,0.0
1013,1364,25-09-2019 09:06:00,1,2555.0,2303.0,0.901,12.617,15,3,2,1,12,2,10,0,0.0,0.0
1013,1365,25-09-2019 09:08:00,1,2776.0,2397.0,0.863,13.59,0,0,0,0,0,0,0,0,0.0,0.0
1013,1366,25-09-2019 09:10:00,1,2773.0,2392.0,0.863,13.575,8,3,1,2,5,3,2,0,0.0,0.0
1013,1367,25-09-2019 09:12:00,1,2803.0,2390.0,0.852,13.691,6,0,0,0,6,0,6,0,0.0,0.0
1013,1368,25-09-2019 09:14:00,1,2673.0,2313.0,0.865,13.093,5,2,1,1,3,2,1,0,0.0,0.0
1013,1369,25-09-2019 09:16:00,1,2570.0,2245.0,0.873,12.613,2,1,0,1,1,0,1,0,0.0,0.0
1013,1370,25-09-2019 09:18:00,1,2578.0,2233.0,0.866,12.631,1,1,0,1,0,0,0,0,0.0,0.0
1013,1371,25-09-2019 09:20:00,1,2569.0,2251.0,0.876,12.615,5,3,0,3,2,0,2,0,0.0,0.0
1013,1372,25-09-2019 09:22:00,1,2568.5,2244.0,0.8735,12.6045,1,0,0,0,1,0,1,0,0.0,0.0
1013,1373,25-09-2019 09:24:00,1,2568.0,2237.0,0.871,12.594,0,0,0,0,0,0,0,0,0.0,0.0
1013,1374,25-09-2019 09:26:00,1,2577.0,2214.0,0.859,12.604,6,4,1,3,2,0,2,0,0.0,0.0
1013,1375,25-09-2019 09:28:00,1,2569.0,2259.0,0.879,12.621,15,10,2,8,5,1,4,0,0.0,0.0
1013,1376,25-09-2019 09:30:00,1,2707.0,2262.0,0.835,13.171,3,3,0,3,0,0,0,0,0.0,0.0
1013,1377,25-09-2019 09:32:00,1,2597.0,2171.0,0.836,12.634,7,5,1,4,2,0,2,0,0.0,0.0
1013,1378,25-09-2019 09:34:00,1,2614.0,2124.0,0.813,12.652,9,6,0,6,3,0,3,0,0.0,0.0
1013,1379,25-09-2019 09:36:00,1,2378.0,2078.0,0.874,11.669,7,7,0,7,0,0,0,0,0.0,0.0
1013,1380,25-09-2019 09:38:00,1,2269.0,2022.0,0.891,11.179,13,7,4,3,6,5,1,0,0.0,0.0
1013,1381,25-09-2019 09:40:00,1,2264.0,2002.0,0.884,11.138,8,3,2,1,5,4,1,0,0.0,0.0
1013,1382,25-09-2019 09:42:00,1,2279.0,2015.0,0.884,11.212,4,2,1,1,2,1,1,0,0.0,0.0
1013,1383,25-09-2019 09:44:00,1,2266.0,2013.0,0.889,11.156,34,11,4,7,23,13,10,0,0.0,0.0
1013,1384,25-09-2019 09:46:00,1,2260.0,2017.0,0.892,11.138,46,15,0,15,31,13,18,0,0.0,0.0
1013,1385,25-09-2019 09:48:00,1,2692.0,2260.0,0.839,13.11,299,189,132,57,110,76,34,22,0.0,0.0
1013,1386,25-09-2019 09:50:00,1,2891.0,2486.0,0.86,14.142,121,87,60,27,34,18,16,96,0.0,0.0
1013,1387,25-09-2019 09:52:00,1,3298.0,2789.0,0.846,16.082,131,77,56,21,54,39,15,30,0.0,0.0
1013,1388,25-09-2019 09:54:00,1,3070.0,2687.0,0.875,15.07,246,156,124,32,90,67,23,43,0.0,0.0
1013,1389,25-09-2019 09:56:00,1,3093.0,2601.0,0.841,15.0655,78,32,14,18,46,21,25,0,0.0,0.0
1013,1390,25-09-2019 09:58:00,1,3116.0,2515.0,0.807,15.061,17,10,5,5,7,0,7,0,0.0,0.0
1013,1391,25-09-2019 10:00:00,1,3125.0,2497.0,0.799,15.075,32,18,5,13,14,4,10,0,0.0,0.0
1013,1392,25-09-2019 10:02:00,1,3092.0,2619.0,0.847,15.084,12,2,0,2,10,0,10,0,0.0,0.0
1013,1393,25-09-2019 10:04:00,1,3411.0,2747.0,0.805,16.481,63,18,8,10,45,25,20,0,0.0,0.0
1013,1394,25-09-2019 10:06:00,1,3401.0,2812.0,0.827,16.514,300,161,123,38,139,84,55,8,0.0,0.0
1013,1395,25-09-2019 10:08:00,1,3407.0,2827.0,0.83,16.555,120,59,42,17,61,35,26,0,0.0,0.0
1013,1396,25-09-2019 10:10:00,1,3402.0,2764.0,0.812,16.465,96,53,22,31,43,13,30,0,0.0,0.0
1013,1397,25-09-2019 10:12:00,1,3400.0,2790.0,0.821,16.487,122,60,32,28,62,34,28,0,0.0,0.0
1013,1398,25-09-2019 10:14:00,1,3396.0,2792.0,0.822,16.471,72,35,18,17,37,11,26,0,0.0,0.0
1013,1399,25-09-2019 10:16:00,1,3415.0,2757.0,0.807,16.509,50,34,0,34,16,1,15,0,0.0,0.0
1013,1400,25-09-2019 10:18:00,1,3416.0,2721.0,0.797,16.472,35,26,0,26,9,0,9,0,0.0,0.0
1013,1401,25-09-2019 10:20:00,1,3092.0,2587.0,0.837,15.045,0,0,0,0,0,0,0,0,0.0,0.0
1013,1402,25-09-2019 10:22:00,1,2902.0,2416.0,0.832,14.107,0,0,0,0,0,0,0,0,0.0,0.0
1013,1403,25-09-2019 10:24:00,1,2936.0,2289.0,0.779,14.104,3,3,0,3,0,0,0,0,0.0,0.0
1013,1404,25-09-2019 10:26:00,1,2812.0,2256.0,0.802,13.578,3,0,0,0,3,0,3,0,0.0,0.0
1013,1405,25-09-2019 10:28:00,1,2922.0,2277.0,0.779,14.033,12,2,0,2,10,0,10,0,0.0,0.0
1013,1406,25-09-2019 10:30:00,1,2917.5,2302.0,0.789,14.0425,0,0,0,0,0,0,0,0,0.0,0.0
1013,1407,25-09-2019 10:32:00,1,2913.0,2327.0,0.799,14.052,14,3,0,3,11,0,11,0,0.0,0.0
1013,1408,25-09-2019 10:34:00,1,2922.0,2336.0,0.799,14.098,0,0,0,0,0,0,0,0,0.01,0.0
1013,1409,25-09-2019 10:36:00,1,2907.0,2318.0,0.797,14.022,2,1,0,1,1,0,1,0,0.0,0.0
1013,1410,25-09-2019 10:38:00,1,2953.0,2275.0,0.77,14.154,9,1,0,1,8,2,6,0,0.0,0.0
1013,1411,25-09-2019 10:40:00,1,2932.0,2227.0,0.759,14.018,7,6,2,4,1,0,1,0,0.0,0.0
1013,1412,25-09-2019 10:42:00,1,2835.0,2182.0,0.77,13.586,10,10,7,3,0,0,0,0,0.0,0.0
1013,1413,25-09-2019 10:44:00,1,2726.0,2125.0,0.78,13.092,24,11,5,6,13,3,10,0,0.0,0.0
1013,1414,25-09-2019 10:46:00,1,2848.0,2182.0,0.766,13.635,0,0,0,0,0,0,0,0,0.0,0.0
1013,1415,25-09-2019 10:48:00,1,2727.0,2138.0,0.784,13.11,13,0,0,0,13,2,11,0,0.0,0.0
1013,1416,25-09-2019 10:50:00,1,2744.0,2104.0,0.766,13.142,13,4,1,3,9,3,6,0,0.0,0.0
1013,1417,25-09-2019 10:52:00,1,2717.0,2103.0,0.774,13.034,2,1,0,1,1,0,1,0,0.0,0.0
1013,1418,25-09-2019 10:54:00,1,2736.0,2088.0,0.763,13.092,2,0,0,0,2,2,0,0,0.0,0.0
1013,1419,25-09-2019 10:56:00,1,2731.0,2075.0,0.76,13.056,0,0,0,0,0,0,0,0,0.0,0.0
1013,1420,25-09-2019 10:58:00,1,2759.0,2032.0,0.737,13.121,15,10,5,5,5,3,2,0,0.0,0.0
1013,1421,25-09-2019 11:00:00,1,2771.0,1995.0,0.72,13.126,1,1,0,1,0,0,0,0,0.0,0.0
1013,1422,25-09-2019 11:02:00,1,2658.0,1954.0,0.735,12.635,1,1,0,1,0,0,0,0,0.0,0.0
1013,1423,25-09-2019 11:04:00,1,2763.0,1997.5,0.7235,13.0975,0,0,0,0,0,0,0,0,0.0,0.0
1013,1424,25-09-2019 11:06:00,1,2868.0,2041.0,0.712,13.56,43,22,13,9,21,12,9,4,0.0,0.0
1013,1425,25-09-2019 11:08:00,1,2870.0,2075.0,0.723,13.607,0,0,0,0,0,0,0,0,0.0,0.0
1013,1426,25-09-2019 11:10:00,1,2885.0,2012.0,0.697,13.597,24,16,6,10,8,4,4,0,0.0,0.0
1013,1427,25-09-2019 11:12:00,1,2870.0,2018.0,0.703,13.544,0,0,0,0,0,0,0,0,0.0,0.0
1013,1428,25-09-2019 11:14:00,1,2862.0,2085.0,0.729,13.585,2,2,1,1,0,0,0,0,0.0,0.0
1013,1429,25-09-2019 11:16:00,1,3087.0,2150.0,0.696,14.542,9,9,0,9,0,0,0,0,0.0,0.0
1013,1430,25-09-2019 11:18:00,1,3069.0,2157.0,0.703,14.482,4,4,0,4,0,0,0,0,0.0,0.0
1013,1431,25-09-2019 11:20:00,1,3074.0,2221.0,0.722,14.57,15,15,0,15,0,0,0,0,0.0,0.0
1013,1432,25-09-2019 11:22:00,1,3075.0,2181.0,0.709,14.53,1,1,0,1,0,0,0,0,0.0,0.0
1013,1433,25-09-2019 11:24:00,1,3085.0,2124.0,0.689,14.506,1,1,0,1,0,0,0,0,0.0,0.0
1013,1434,25-09-2019 11:26:00,1,2970.0,2112.0,0.711,14.038,0,0,0,0,0,0,0,0,0.0,0.0
1013,1435,25-09-2019 11:28:00,1,2866.0,2083.0,0.727,13.598,4,4,2,2,0,0,0,0,0.0,0.0
1013,1436,25-09-2019 11:30:00,1,2849.0,2058.0,0.722,13.505,0,0,0,0,0,0,0,0,0.0,0.0
1013,1437,25-09-2019 11:32:00,1,2875.0,2050.0,0.713,13.598,22,10,7,3,12,5,7,0,0.0,0.0
1013,1438,25-09-2019 11:34:00,1,2864.0,2071.0,0.723,13.577,0,0,0,0,0,0,0,0,0.0,0.0
1013,1439,25-09-2019 11:36:00,1,2871.0,2036.0,0.709,13.567,0,0,0,0,0,0,0,0,0.0,0.0
1013,1440,25-09-2019 11:38:00,1,2874.0,2037.0,0.709,13.579,16,7,4,3,9,4,5,0,0.0,0.0
1013,1441,25-09-2019 11:40:00,1,2877.0,2038.0,0.709,13.591,2,1,1,0,1,0,1,0,0.0,0.0
1013,1442,25-09-2019 11:42:00,1,2659.0,1932.0,0.727,12.616,12,5,0,5,7,2,5,0,0.0,0.0
1013,1443,25-09-2019 11:44:00,1,2551.0,1874.0,0.735,12.127,0,0,0,0,0,0,0,0,0.0,0.0
1013,1444,25-09-2019 11:46:00,1,2556.0,1855.0,0.726,12.125,7,2,0,2,5,2,3,0,0.0,0.0
1013,1445,25-09-2019 11:48:00,1,2555.0,1866.0,0.73,12.133,0,0,0,0,0,0,0,0,0.0,0.0
1013,1446,25-09-2019 11:50:00,1,2558.0,1887.0,0.738,12.169,0,0,0,0,0,0,0,0,0.0,0.0
1013,1447,25-09-2019 11:52:00,1,2662.0,1920.0,0.721,12.615,13,9,4,5,4,2,2,0,0.0,0.0
1013,1448,25-09-2019 11:54:00,1,2887.0,1996.0,0.692,13.585,9,5,4,1,4,0,4,0,0.0,0.0
1013,1449,25-09-2019 11:56:00,1,2869.0,2018.0,0.703,13.537,1,0,0,0,1,0,1,0,0.0,0.0
1013,1450,25-09-2019 11:58:00,1,2857.0,2114.0,0.74,13.596,0,0,0,0,0,0,0,0,0.0,0.0
1013,1451,25-09-2019 12:00:00,1,2849.0,2120.0,0.744,13.571,37,13,9,4,24,15,9,0,0.0,0.0
1013,1452,25-09-2019 12:02:00,1,2965.0,2124.0,0.716,14.034,4,1,0,1,3,0,3,0,0.01,0.0
1013,1453,25-09-2019 12:04:00,1,2868.0,2072.0,0.723,13.596,0,0,0,0,0,0,0,0,0.0,0.0
1013,1454,25-09-2019 12:06:00,1,2877.0,1997.0,0.694,13.547,13,5,2,3,8,4,4,0,0.0,0.0
1013,1455,25-09-2019 12:08:00,1,2766.0,1979.0,0.715,13.09,2,1,0,1,1,0,1,0,0.0,0.0
1013,1456,25-09-2019 12:10:00,1,2769.0,1955.0,0.706,13.073,7,4,0,4,3,2,1,0,0.0,0.0
1013,1457,25-09-2019 12:12:00,1,2824.5,1996.5,0.707,13.339,3,3,1,2,0,0,0,0,0.0,0.0
1013,1458,25-09-2019 12:14:00,1,2880.0,2038.0,0.708,13.605,16,10,6,4,6,2,4,0,0.0,0.0
1013,1459,25-09-2019 12:16:00,1,2846.0,2096.0,0.736,13.535,9,7,2,5,2,1,1,0,0.0,0.0
1013,1460,25-09-2019 12:18:00,1,2978.0,2125.0,0.713,14.088,12,12,2,10,0,0,0,0,0.0,0.0
1013,1461,25-09-2019 12:20:00,1,2975.0,2142.0,0.72,14.093,4,1,0,1,3,1,2,0,0.0,0.0
1013,1462,25-09-2019 12:22:00,1,3092.0,2174.0,0.703,14.589,0,0,0,0,0,0,0,0,0.0,0.0
1013,1463,25-09-2019 12:24:00,1,3064.0,2155.0,0.703,14.46,131,58,25,33,73,34,39,0,0.0,0.0
1013,1464,25-09-2019 12:26:00,1,3053.0,2245.0,0.736,14.514,51,15,2,13,36,11,25,0,0.0,0.0
1013,1465,25-09-2019 12:28:00,1,3159.0,2350.0,0.744,15.049,103,51,33,18,52,26,26,0,0.0,0.0
1013,1466,25-09-2019 12:30:00,1,3241.0,2452.0,0.757,15.487,57,27,2,25,30,3,27,0,0.0,0.0
1013,1467,25-09-2019 12:32:00,1,3346.0,2531.0,0.756,15.987,275,171,128,43,104,63,41,67,0.0,0.0
1013,1468,25-09-2019 12:34:00,1,3542.0,2703.0,0.763,16.948,84,38,21,17,46,4,42,52,0.0,0.0
1013,1469,25-09-2019 12:36:00,1,3852.0,2938.0,0.763,18.431,248,125,96,29,123,84,39,56,0.0,0.02
1013,1470,25-09-2019 12:38:00,1,3575.0,2651.0,0.742,17.023,201,69,45,24,132,91,41,4,0.0,0.01
1013,1471,25-09-2019 12:40:00,1,3554.0,2740.0,0.771,17.036,430,233,184,49,197,138,59,7,0.0,0.0
1013,1472,25-09-2019 12:42:00,1,3756.0,2805.0,0.747,17.906,181,88,60,28,93,55,38,25,0.06,0.0
1013,1473,25-09-2019 12:44:00,1,3542.0,2753.0,0.777,17.005,471,286,217,69,185,128,57,12,0.01,0.0
1013,1474,25-09-2019 12:46:00,1,3749.5,2879.5,0.7685,17.9625,95,67,33,34,28,0,28,31,0.0,0.05
1013,1475,25-09-2019 12:48:00,1,3957.0,3006.0,0.76,18.92,67,32,15,17,35,1,34,59,0.0,0.04
1013,1476,25-09-2019 12:50:00,1,3713.0,2994.0,0.806,17.944,182,109,76,33,73,44,29,28,0.01,0.02
1013,1477,25-09-2019 12:52:00,1,3631.0,2872.0,0.791,17.484,640,397,319,78,243,183,60,2,0.0,0.0
1013,1478,25-09-2019 12:54:00,1,3549.0,2724.0,0.768,16.998,707,452,359,93,255,187,68,7,0.08,0.0
1013,1479,25-09-2019 12:56:00,1,3515.0,2794.0,0.795,16.942,273,162,122,40,111,90,21,7,0.01,0.0
1013,1480,25-09-2019 12:58:00,1,3529.0,2766.0,0.784,16.969,121,67,30,37,54,28,26,0,0.0,0.0
1013,1481,25-09-2019 13:00:00,1,3525.0,2837.0,0.805,17.031,69,32,16,16,37,13,24,0,0.0,0.0
1013,1482,25-09-2019 13:02:00,1,3507.0,2881.0,0.822,17.006,53,24,10,14,29,11,18,0,0.0,0.0
1013,1483,25-09-2019 13:04:00,1,3510.0,2856.0,0.814,16.99,45,26,2,24,19,1,18,0,0.0,0.0
1013,1484,25-09-2019 13:06:00,1,3490.0,2929.0,0.839,16.992,38,23,3,20,15,7,8,0,0.0,0.0
1013,1485,25-09-2019 13:08:00,1,3605.0,2984.0,0.828,17.509,88,59,24,35,29,8,21,0,0.01,0.0
1013,1486,25-09-2019 13:10:00,1,3489.0,2955.0,0.847,17.018,28,22,0,22,6,0,6,0,0.0,0.0
1013,1487,25-09-2019 13:12:00,1,3513.0,2873.0,0.818,17.023,7,7,1,6,0,0,0,0,0.0,0.0
1013,1488,25-09-2019 13:14:00,1,3294.0,2755.0,0.836,16.028,0,0,0,0,0,0,0,0,0.0,0.0
1013,1489,25-09-2019 13:16:00,1,3203.0,2617.0,0.817,15.515,3,1,0,1,2,1,1,0,0.0,0.0
1013,1490,25-09-2019 13:18:00,1,2972.0,2513.0,0.845,14.494,0,0,0,0,0,0,0,0,0.0,0.0
1013,1491,25-09-2019 13:20:00,1,3035.5,2538.5,0.836,14.7725,10,5,0,5,5,3,2,0,0.0,0.0
1013,1492,25-09-2019 13:22:00,1,3099.0,2564.0,0.827,15.051,2,2,0,2,0,0,0,0,0.0,0.0
1013,1493,25-09-2019 13:24:00,1,3110.0,2554.0,0.821,15.08,13,13,0,13,0,0,0,0,0.0,0.0
1013,1494,25-09-2019 13:26:00,1,3011.0,2398.0,0.797,14.519,0,0,0,0,0,0,0,0,0.0,0.0
1013,1495,25-09-2019 13:28:00,1,2797.0,2315.0,0.828,13.584,1,1,0,1,0,0,0,0,0.0,0.0
1013,1496,25-09-2019 13:30:00,1,2796.0,2304.0,0.824,13.567,0,0,0,0,0,0,0,0,0.0,0.0
1013,1497,25-09-2019 13:32:00,1,2920.0,2346.0,0.803,14.102,0,0,0,0,0,0,0,0,0.0,0.0
1013,1498,25-09-2019 13:34:00,1,2920.0,2350.0,0.805,14.106,0,0,0,0,0,0,0,0,0.0,0.01
1013,1499,25-09-2019 13:36:00,1,3023.0,2356.0,0.779,14.52,0,0,0,0,0,0,0,0,0.0,0.0
1013,1500,25-09-2019 13:38:00,1,2919.0,2358.0,0.808,14.112,0,0,0,0,0,0,0,0,0.0,0.0
1013,1501,25-09-2019 13:40:00,1,2916.0,2345.0,0.804,14.084,10,3,2,1,7,5,2,0,0.0,0.0
1013,1502,25-09-2019 13:42:00,1,3011.0,2411.0,0.801,14.532,0,0,0,0,0,0,0,0,0.0,0.0
1013,1503,25-09-2019 13:44:00,1,2997.0,2482.0,0.828,14.556,0,0,0,0,0,0,0,0,0.0,0.0
1013,1504,25-09-2019 13:46:00,1,3229.0,2544.0,0.788,15.54,0,0,0,0,0,0,0,0,0.01,0.0
1013,1505,25-09-2019 13:48:00,1,3114.0,2516.0,0.808,15.053,25,11,6,5,14,8,6,0,0.0,0.0
1013,1506,25-09-2019 13:50:00,1,2990.0,2472.0,0.827,14.516,272,126,85,41,146,91,55,16,0.0,0.0
1013,1507,25-09-2019 13:52:00,1,3229.0,2593.0,0.803,15.592,70,49,19,30,21,0,21,46,0.0,0.04
1013,1508,25-09-2019 13:54:00,1,3254.5,2681.0,0.8235,15.79,161,131,94,37,30,2,28,54,0.0,0.04
1013,1509,25-09-2019 13:56:00,1,3280.0,2769.0,0.844,15.988,538,347,275,72,191,148,43,24,0.02,0.02
1013,1510,25-09-2019 13:58:00,1,3179.0,2728.0,0.858,15.547,615,350,293,57,265,199,66,3,0.0,0.0
1013,1511,25-09-2019 14:00:00,1,3497.0,2864.0,0.819,16.95,585,275,212,63,310,240,70,1,0.06,0.02
1013,1512,25-09-2019 14:02:00,1,3687.0,3114.0,0.845,17.974,235,134,90,44,101,74,27,2,0.01,0.02
1013,1513,25-09-2019 14:04:00,1,3173.0,2768.0,0.872,15.565,49,37,8,29,12,7,5,0,0.01,0.0
1013,1514,25-09-2019 14:06:00,1,3177.0,2715.0,0.855,15.523,47,34,9,25,13,1,12,0,0.0,0.0
1013,1515,25-09-2019 14:08:00,1,3390.0,2866.0,0.845,16.531,99,38,5,33,61,27,34,0,0.0,0.0
1013,1516,25-09-2019 14:10:00,1,3385.0,2868.0,0.847,16.512,64,25,10,15,39,10,29,0,0.0,0.0
1013,1517,25-09-2019 14:12:00,1,3160.0,2823.0,0.893,15.577,26,16,5,11,10,2,8,0,0.0,0.0
1013,1518,25-09-2019 14:14:00,1,3274.0,2824.0,0.863,16.027,9,2,1,1,7,0,7,0,0.0,0.0
1013,1519,25-09-2019 14:16:00,1,3165.0,2745.0,0.867,15.508,8,3,1,2,5,2,3,0,0.0,0.0
1013,1520,25-09-2019 14:18:00,1,3189.0,2661.0,0.834,15.511,0,0,0,0,0,0,0,0,0.0,0.0
1013,1521,25-09-2019 14:20:00,1,3092.0,2588.0,0.837,15.049,11,7,0,7,4,2,2,0,0.0,0.0
1013,1522,25-09-2019 14:22:00,1,2985.0,2554.0,0.856,14.59,5,1,0,1,4,2,2,0,0.0,0.0
1013,1523,25-09-2019 14:24:00,1,2988.0,2504.0,0.838,14.547,11,1,0,1,10,2,8,0,0.0,0.0
1013,1524,25-09-2019 14:26:00,1,2989.0,2506.0,0.839,14.55,2,1,0,1,1,0,1,0,0.0,0.0
1013,1525,25-09-2019 14:28:00,1,2984.5,2547.0,0.854,14.5775,11,3,0,3,8,0,8,0,0.0,0.0
1013,1526,25-09-2019 14:30:00,1,2980.0,2588.0,0.869,14.605,18,11,3,8,7,3,4,0,0.0,0.0
1013,1527,25-09-2019 14:32:00,1,2976.0,2610.0,0.877,14.614,1,1,0,1,0,0,0,0,0.0,0.0
1013,1528,25-09-2019 14:34:00,1,3196.0,2678.0,0.838,15.558,2,0,0,0,2,1,1,0,0.0,0.0
1013,1529,25-09-2019 14:36:00,1,3179.0,2687.0,0.845,15.501,3,0,0,0,3,0,3,0,0.0,0.0
1013,1530,25-09-2019 14:38:00,1,3197.0,2655.0,0.83,15.536,2,0,0,0,2,0,2,0,0.0,0.0
1013,1531,25-09-2019 14:40:00,1,2976.0,2583.0,0.868,14.584,14,8,2,6,6,2,4,0,0.0,0.0
1013,1532,25-09-2019 14:42:00,1,2987.0,2557.0,0.856,14.598,0,0,0,0,0,0,0,0,0.0,0.0
1013,1533,25-09-2019 14:44:00,1,2982.0,2536.0,0.85,14.557,14,8,5,3,6,3,3,0,0.0,0.0
1013,1534,25-09-2019 14:46:00,1,3001.0,2454.0,0.818,14.54,6,1,0,1,5,1,4,0,0.0,0.0
1013,1535,25-09-2019 14:48:00,1,3020.0,2392.0,0.792,14.547,0,0,0,0,0,0,0,0,0.0,0.0
1013,1536,25-09-2019 14:50:00,1,2991.0,2477.0,0.828,14.529,5,3,1,2,2,1,1,0,0.0,0.0
1013,1537,25-09-2019 14:52:00,1,2999.0,2487.0,0.829,14.57,11,0,0,0,11,2,9,0,0.0,0.0
1013,1538,25-09-2019 14:54:00,1,3009.0,2397.0,0.797,14.51,2,0,0,0,2,0,2,0,0.0,0.0
1013,1539,25-09-2019 14:56:00,1,2807.0,2317.0,0.825,13.626,0,0,0,0,0,0,0,0,0.0,0.0
1013,1540,25-09-2019 14:58:00,1,2828.0,2204.0,0.779,13.585,7,0,0,0,7,2,5,0,0.0,0.0
1013,1541,25-09-2019 15:00:00,1,2722.0,2168.0,0.796,13.125,2,0,0,0,2,0,2,0,0.0,0.0
1013,1542,25-09-2019 15:02:00,1,2766.0,2241.0,0.8095,13.38,27,9,4,5,18,10,8,0,0.0,0.0
1013,1543,25-09-2019 15:04:00,1,2810.0,2314.0,0.823,13.635,0,0,0,0,0,0,0,0,0.0,0.0
1013,1544,25-09-2019 15:06:00,1,3018.0,2395.0,0.793,14.544,2,2,0,2,0,0,0,0,0.0,0.0
1013,1545,25-09-2019 15:08:00,1,2996.0,2467.0,0.823,14.535,21,11,7,4,10,6,4,0,0.0,0.0
1013,1546,25-09-2019 15:10:00,1,2986.0,2505.0,0.839,14.539,8,0,0,0,8,1,7,0,0.0,0.0
1013,1547,25-09-2019 15:12:00,1,3006.0,2427.0,0.807,14.531,0,0,0,0,0,0,0,0,0.0,0.0
1013,1548,25-09-2019 15:14:00,1,3023.0,2445.0,0.809,14.619,8,0,0,0,8,3,5,0,0.0,0.0
1013,1549,25-09-2019 15:16:00,1,2996.0,2465.0,0.823,14.532,22,3,1,2,19,4,15,0,0.0,0.0
1013,1550,25-09-2019 15:18:00,1,3019.0,2380.0,0.788,14.531,13,3,1,2,10,1,9,0,0.0,0.0
1013,1551,25-09-2019 15:20:00,1,2807.0,2268.0,0.808,13.573,9,2,2,0,7,0,7,0,0.0,0.0
1013,1552,25-09-2019 15:22:00,1,2823.0,2256.0,0.799,13.621,0,0,0,0,0,0,0,0,0.0,0.0
1013,1553,25-09-2019 15:24:00,1,2804.0,2310.0,0.824,13.607,0,0,0,0,0,0,0,0,0.0,0.0
1013,1554,25-09-2019 15:26:00,1,2832.0,2215.0,0.782,13.611,56,36,20,16,20,9,11,0,0.0,0.0
1013,1555,25-09-2019 15:28:00,1,2824.0,2204.0,0.781,13.567,83,23,6,17,60,28,32,0,0.0,0.0
1013,1556,25-09-2019 15:30:00,1,3024.0,2359.0,0.78,14.527,142,62,27,35,80,49,31,1,0.0,0.0
1013,1557,25-09-2019 15:32:00,1,3168.0,2774.0,0.876,15.555,175,112,68,44,63,18,45,77,0.0,0.0
1013,1558,25-09-2019 15:34:00,1,3689.0,3068.0,0.832,17.933,125,97,51,46,28,0,28,60,0.0,0.0
1013,1559,25-09-2019 15:36:00,1,3675.0,3117.0,0.8485,17.93,109,78,39,39,31,2,29,36,0.0,0.04
1013,1560,25-09-2019 15:38:00,1,3661.0,3166.0,0.865,17.927,279,121,91,30,158,112,46,33,0.0,0.04
1013,1561,25-09-2019 15:40:00,1,3493.0,2930.0,0.839,17.008,320,170,118,52,150,110,40,28,0.0,0.01
1013,1562,25-09-2019 15:42:00,1,3375.0,2880.0,0.853,16.486,446,253,194,59,193,137,56,8,0.1,0.0
1013,1563,25-09-2019 15:44:00,1,3473.0,2968.0,0.855,16.971,301,170,119,51,131,93,38,14,0.0,0.0
1013,1564,25-09-2019 15:46:00,1,3384.0,2858.0,0.845,16.495,286,192,146,46,94,58,36,0,0.0,0.0
1013,1565,25-09-2019 15:48:00,1,3656.0,3244.0,0.887,17.996,84,43,23,20,41,19,22,3,0.01,0.0
1013,1566,25-09-2019 15:50:00,1,3464.0,3076.0,0.888,17.052,38,19,7,12,19,7,12,0,0.0,0.0
1013,1567,25-09-2019 15:52:00,1,3576.0,3096.0,0.866,17.515,20,11,3,8,9,4,5,0,0.0,0.0
1013,1568,25-09-2019 15:54:00,1,3471.0,2994.0,0.863,16.989,5,1,0,1,4,2,2,0,0.0,0.0
1013,1569,25-09-2019 15:56:00,1,3133.0,2835.0,0.905,15.483,1,0,0,0,1,0,1,0,0.0,0.0
1013,1570,25-09-2019 15:58:00,1,3182.0,2702.0,0.849,15.53,7,5,4,1,2,0,2,0,0.0,0.0
1013,1571,25-09-2019 16:00:00,1,2983.0,2570.0,0.862,14.596,3,0,0,0,3,0,3,0,0.0,0.0
1013,1572,25-09-2019 16:02:00,1,2770.0,2452.0,0.885,13.627,0,0,0,0,0,0,0,0,0.0,0.0
1013,1573,25-09-2019 16:04:00,1,2787.0,2391.0,0.858,13.629,0,0,0,0,0,0,0,0,0.0,0.0
1013,1574,25-09-2019 16:06:00,1,2802.0,2322.0,0.829,13.609,39,22,10,12,17,6,11,0,0.0,0.0
1013,1575,25-09-2019 16:08:00,1,2676.0,2310.0,0.863,13.1,13,3,0,3,10,5,5,0,0.0,0.0
1013,1576,25-09-2019 16:10:00,1,2780.5,2377.0,0.855,13.587,0,0,0,0,0,0,0,0,0.0,0.0
1013,1577,25-09-2019 16:12:00,1,2885.0,2444.0,0.847,14.074,16,5,4,1,11,5,6,0,0.0,0.0
1013,1578,25-09-2019 16:14:00,1,2872.0,2466.0,0.859,14.046,4,2,0,2,2,0,2,0,0.0,0.0
1013,1579,25-09-2019 16:16:00,1,3109.0,2556.0,0.822,15.081,1,1,0,1,0,0,0,0,0.01,0.0
1013,1580,25-09-2019 16:18:00,1,3096.0,2597.0,0.839,15.075,3,3,0,3,0,0,0,0,0.0,0.0
1013,1581,25-09-2019 16:20:00,1,3077.0,2617.0,0.851,15.019,2,1,0,1,1,0,1,0,0.0,0.0
1013,1582,25-09-2019 16:22:00,1,3101.0,2563.0,0.827,15.055,21,14,10,4,7,5,2,0,0.0,0.0
1013,1583,25-09-2019 16:24:00,1,3082.0,2598.0,0.843,15.02,1,1,1,0,0,0,0,0,0.0,0.0
1013,1584,25-09-2019 16:26:00,1,3111.0,2509.0,0.807,15.034,4,4,2,2,0,0,0,0,0.0,0.0
1013,1585,25-09-2019 16:28:00,1,3000.0,2490.0,0.83,14.577,5,1,0,1,4,0,4,0,0.0,0.0
1013,1586,25-09-2019 16:30:00,1,3114.0,2501.0,0.803,15.039,9,7,1,6,2,0,2,0,0.0,0.0
1013,1587,25-09-2019 16:32:00,1,2889.0,2439.0,0.844,14.081,11,5,1,4,6,3,3,0,0.0,0.0
1013,1588,25-09-2019 16:34:00,1,2902.0,2359.0,0.813,14.045,7,2,1,1,5,0,5,0,0.0,0.0
1013,1589,25-09-2019 16:36:00,1,2916.0,2320.0,0.796,14.057,24,12,1,11,12,0,12,0,0.0,0.0
1013,1590,25-09-2019 16:38:00,1,2939.0,2306.0,0.785,14.134,0,0,0,0,0,0,0,0,0.0,0.0
1013,1591,25-09-2019 16:40:00,1,2809.0,2285.0,0.814,13.597,12,7,2,5,5,0,5,0,0.0,0.0
1013,1592,25-09-2019 16:42:00,1,2930.0,2320.0,0.792,14.112,12,5,2,3,7,0,7,0,0.0,0.0
1013,1593,25-09-2019 16:44:00,1,2866.5,2311.5,0.807,13.8535,2,1,0,1,1,0,1,0,0.0,0.0
1013,1594,25-09-2019 16:46:00,1,2803.0,2303.0,0.822,13.595,2,0,0,0,2,0,2,0,0.0,0.0
1013,1595,25-09-2019 16:48:00,1,2920.0,2324.0,0.796,14.079,53,19,12,7,34,19,15,0,0.0,0.0
1013,1596,25-09-2019 16:50:00,1,3090.0,2600.0,0.841,15.052,86,36,11,25,50,26,24,0,0.0,0.0
1013,1597,25-09-2019 16:52:00,1,3203.0,2663.0,0.831,15.57,138,60,41,19,78,46,32,0,0.0,0.0
1013,1598,25-09-2019 16:54:00,1,3267.0,2821.0,0.863,15.995,91,64,38,26,27,2,25,0,0.0,0.0
1013,1599,25-09-2019 16:56:00,1,3370.0,2939.0,0.872,16.532,238,163,106,57,75,38,37,55,0.0,0.0
1013,1600,25-09-2019 16:58:00,1,3769.0,3191.0,0.847,18.383,161,94,53,41,67,20,47,62,0.0,0.0
1013,1601,25-09-2019 17:00:00,1,3735.0,3298.0,0.883,18.368,100,55,25,30,45,4,41,46,0.0,0.01
1013,1602,25-09-2019 17:02:00,1,3971.0,3401.0,0.856,19.412,227,126,93,33,101,65,36,51,0.0,0.08
1013,1603,25-09-2019 17:04:00,1,3562.0,3066.0,0.861,17.429,252,136,109,27,116,77,39,4,0.0,0.0
1013,1604,25-09-2019 17:06:00,1,3296.0,2768.0,0.84,16.051,57,37,20,17,20,2,18,0,0.0,0.0
1013,1605,25-09-2019 17:08:00,1,3288.0,2772.0,0.843,16.025,30,20,5,15,10,1,9,0,0.0,0.0
1013,1606,25-09-2019 17:10:00,1,3283.0,2744.0,0.836,15.975,10,9,3,6,1,0,1,0,0.0,0.0
1013,1607,25-09-2019 17:12:00,1,3290.0,2734.0,0.831,15.992,2,1,0,1,1,0,1,0,0.0,0.0
1013,1608,25-09-2019 17:14:00,1,3274.0,2770.0,0.846,15.967,16,11,6,5,5,0,5,0,0.0,0.0
1013,1609,25-09-2019 17:16:00,1,3302.0,2743.0,0.831,16.048,15,13,2,11,2,0,2,0,0.0,0.0
1013,1610,25-09-2019 17:18:00,1,3241.0,2720.5,0.8395,15.781,4,2,1,1,2,0,2,0,0.0,0.0
1013,1611,25-09-2019 17:20:00,1,3180.0,2698.0,0.848,15.514,0,0,0,0,0,0,0,0,0.0,0.0
1013,1612,25-09-2019 17:22:00,1,3177.0,2686.0,0.845,15.49,169,88,46,42,81,37,44,0,0.0,0.0
1013,1613,25-09-2019 17:24:00,1,3301.0,2728.0,0.826,16.027,135,97,51,46,38,12,26,0,0.01,0.01
1013,1614,25-09-2019 17:26:00,1,3350.0,2935.0,0.876,16.448,32,24,6,18,8,2,6,0,0.0,0.0
1013,1615,25-09-2019 17:28:00,1,3266.0,2888.0,0.884,16.066,46,22,3,19,24,6,18,0,0.0,0.0
1013,1616,25-09-2019 17:30:00,1,3569.0,3017.0,0.845,17.405,17,14,3,11,3,2,1,0,0.0,0.0
1013,1617,25-09-2019 17:32:00,1,3567.0,3125.0,0.876,17.515,97,47,19,28,50,26,24,0,0.0,0.0
1013,1618,25-09-2019 17:34:00,1,3549.0,3113.0,0.877,17.428,159,105,67,38,54,30,24,16,0.0,0.0
1013,1619,25-09-2019 17:36:00,1,3781.0,3296.0,0.872,18.547,101,60,32,28,41,8,33,41,0.0,0.0
1013,1620,25-09-2019 17:38:00,1,3864.0,3378.0,0.874,18.965,115,87,44,43,28,0,28,29,0.0,0.01
1013,1621,25-09-2019 17:40:00,1,3976.0,3354.0,0.844,19.378,240,140,90,50,100,60,40,31,0.0,0.05
1013,1622,25-09-2019 17:42:00,1,3579.0,3076.0,0.86,17.509,3,3,0,3,0,0,0,0,0.0,0.0
1013,1623,25-09-2019 17:44:00,1,3389.0,2928.0,0.864,16.592,2,2,0,2,0,0,0,0,0.0,0.0
1013,1624,25-09-2019 17:46:00,1,3257.0,2839.0,0.872,15.977,0,0,0,0,0,0,0,0,0.0,0.0
1013,1625,25-09-2019 17:48:00,1,3266.0,2829.0,0.866,15.998,18,18,0,18,0,0,0,0,0.0,0.0
1013,1626,25-09-2019 17:50:00,1,3262.0,2886.0,0.885,16.049,23,17,7,10,6,5,1,0,0.0,0.0
1013,1627,25-09-2019 17:52:00,1,3284.0,2806.0,0.855,16.047,0,0,0,0,0,0,0,0,0.0,0.0
1013,1628,25-09-2019 17:54:00,1,3306.0,2726.0,0.825,16.045,33,20,7,13,13,5,8,0,0.0,0.0
1013,1629,25-09-2019 17:56:00,1,3277.0,2813.0,0.858,16.026,4,3,0,3,1,0,1,0,0.0,0.0
1013,1630,25-09-2019 17:58:00,1,3245.0,2884.0,0.889,15.979,41,21,1,20,20,0,20,0,0.0,0.0
1013,1631,25-09-2019 18:00:00,0,3278.0,2792.0,0.852,16.008,70,35,20,15,35,9,26,0,0.0,0.0
1013,1632,25-09-2019 18:02:00,0,3489.0,2998.0,0.859,17.065,370,191,153,38,179,128,51,110,0.0,0.0
1013,1633,25-09-2019 18:04:00,0,3771.0,3249.0,0.862,18.455,330,188,143,45,142,95,47,59,0.0,0.0
1013,1634,25-09-2019 18:06:00,0,3969.0,3449.0,0.869,19.458,173,69,48,21,104,60,44,49,0.0,0.0
1013,1635,25-09-2019 18:08:00,0,4269.0,3631.0,0.85,20.841,76,13,4,9,63,12,51,32,0.0,0.04
1013,1636,25-09-2019 18:10:00,0,4251.0,3738.0,0.879,20.887,217,124,91,33,93,46,47,84,0.0,0.03
1013,1637,25-09-2019 18:12:00,0,3946.0,3390.0,0.859,19.3,288,140,96,44,148,107,41,42,0.08,0.01
1013,1638,25-09-2019 18:14:00,0,3774.0,3310.0,0.877,18.536,226,102,74,28,124,83,41,46,0.0,0.0
1013,1639,25-09-2019 18:16:00,0,3936.0,3546.0,0.901,19.433,134,71,41,30,63,34,29,1,0.0,0.0
1013,1640,25-09-2019 18:18:00,0,4274.0,3681.0,0.861,20.915,52,24,4,20,28,14,14,0,0.0,0.0
1013,1641,25-09-2019 18:20:00,0,4230.0,3745.0,0.885,20.812,65,32,14,18,33,6,27,0,0.0,0.0
1013,1642,25-09-2019 18:22:00,0,4252.0,3696.0,0.869,20.844,76,43,19,24,33,13,20,0,0.0,0.0
1013,1643,25-09-2019 18:24:00,0,4349.0,3816.0,0.877,21.361,327,146,105,41,181,131,50,71,0.01,0.0
1013,1644,25-09-2019 18:26:00,0,4504.0,3917.5,0.87,22.083,107,17,2,15,90,43,47,36,0.0,0.0
1013,1645,25-09-2019 18:28:00,0,4659.0,4019.0,0.863,22.805,238,125,95,30,113,78,35,69,0.07,0.04
1013,1646,25-09-2019 18:30:00,0,4373.0,3748.0,0.857,21.378,207,143,95,48,64,25,39,42,0.01,0.0
1013,1647,25-09-2019 18:32:00,0,4629.0,4106.0,0.887,22.785,61,15,2,13,46,10,36,14,0.0,0.06
1013,1648,25-09-2019 18:34:00,0,4878.0,4202.0,0.861,23.87,163,51,24,27,112,61,51,28,0.0,0.05
1013,1649,25-09-2019 18:36:00,0,4266.0,3663.0,0.858,20.865,170,74,55,19,96,61,35,20,0.0,0.0
1013,1650,25-09-2019 18:38:00,0,3791.0,3189.0,0.841,18.468,390,184,142,42,206,150,56,41,0.0,0.0
1013,1651,25-09-2019 18:40:00,0,3969.0,3457.0,0.871,19.464,256,131,95,36,125,87,38,42,0.0,0.05
1013,1652,25-09-2019 18:42:00,0,4626.0,4125.0,0.892,22.792,99,39,26,13,60,13,47,31,0.0,0.0
1013,1653,25-09-2019 18:44:00,0,4635.0,4087.0,0.882,22.786,355,173,127,46,182,140,42,17,0.12,0.08
1013,1654,25-09-2019 18:46:00,0,3932.0,3527.0,0.897,19.395,123,67,30,37,56,27,29,1,0.0,0.0
1013,1655,25-09-2019 18:48:00,0,4256.0,3757.0,0.883,20.927,70,35,17,18,35,14,21,0,0.0,0.0
1013,1656,25-09-2019 18:50:00,0,4244.0,3727.0,0.878,20.849,24,8,3,5,16,9,7,0,0.0,0.0
1013,1657,25-09-2019 18:52:00,0,3928.0,3578.0,0.911,19.435,0,0,0,0,0,0,0,0,0.0,0.0
1013,1658,25-09-2019 18:54:00,0,4027.0,3650.0,0.906,19.908,1,0,0,0,1,0,1,0,0.0,0.0
1013,1659,25-09-2019 18:56:00,0,3955.0,3532.0,0.893,19.494,8,7,4,3,1,0,1,0,0.0,0.0
1013,1660,25-09-2019 18:58:00,0,3963.0,3482.0,0.879,19.469,4,2,1,1,2,1,1,0,0.0,0.0
1013,1661,25-09-2019 19:00:00,0,3786.0,3452.5,0.914,18.7385,157,89,49,40,68,38,30,1,0.0,0.01
1013,1662,25-09-2019 19:02:00,0,3609.0,3423.0,0.949,18.008,242,131,87,44,111,67,44,33,0.0,0.0
1013,1663,25-09-2019 19:04:00,0,4311.0,3990.0,0.926,21.403,90,26,5,21,64,27,37,24,0.0,0.0
1013,1664,25-09-2019 19:06:00,0,4103.0,3842.0,0.936,20.42,104,24,12,12,80,35,45,38,0.01,0.0
1013,1665,25-09-2019 19:08:00,0,4483.0,4202.0,0.937,22.314,136,34,22,12,102,48,54,44,0.0,0.03
1013,1666,25-09-2019 19:10:00,0,4477.0,4328.0,0.967,22.432,91,21,9,12,70,31,39,39,0.0,0.09
1013,1667,25-09-2019 19:12:00,0,4777.0,4490.0,0.94,23.792,255,119,90,29,136,97,39,34,0.07,0.04
1013,1668,25-09-2019 19:14:00,0,4270.0,4036.0,0.945,21.293,422,204,161,43,218,163,55,95,0.01,0.01
1013,1669,25-09-2019 19:16:00,0,3598.0,3431.0,0.954,17.972,247,165,125,40,82,56,26,51,0.0,0.01
1013,1670,25-09-2019 19:18:00,0,4576.0,4372.0,0.955,22.87,200,111,85,26,89,68,21,15,0.0,0.0
1013,1671,25-09-2019 19:20:00,0,3311.0,3085.0,0.932,16.462,54,29,20,9,25,14,11,5,0.0,0.0
1013,1672,25-09-2019 19:22:00,0,4116.0,3823.0,0.929,20.45,241,174,115,59,67,33,34,49,0.0,0.0
1013,1673,25-09-2019 19:24:00,0,4800.0,4426.0,0.922,23.811,93,39,17,22,54,17,37,35,0.0,0.05
1013,1674,25-09-2019 19:26:00,0,4991.0,4654.0,0.932,24.818,99,16,5,11,83,33,50,32,0.0,0.06
1013,1675,25-09-2019 19:28:00,0,4980.0,4675.0,0.939,24.797,104,50,32,18,54,30,24,42,0.1,0.03
1013,1676,25-09-2019 19:30:00,0,3806.0,3564.0,0.936,18.941,54,27,23,4,27,15,12,1,0.01,0.0
1013,1677,25-09-2019 19:32:00,0,3411.0,3250.0,0.953,17.038,161,76,42,34,85,46,39,0,0.0,0.0
1013,1678,25-09-2019 19:34:00,0,3901.5,3662.0,0.9405,19.426,107,77,40,37,30,6,24,0,0.01,0.0
1013,1679,25-09-2019 19:36:00,0,4392.0,4074.0,0.928,21.814,195,93,71,22,102,61,41,35,0.0,0.0
1013,1680,25-09-2019 19:38:00,0,4436.0,4024.0,0.907,21.932,390,211,167,44,179,144,35,106,0.08,0.0
1013,1681,25-09-2019 19:40:00,0,4107.0,3803.0,0.926,20.393,230,151,107,44,79,43,36,40,0.01,0.0
1013,1682,25-09-2019 19:42:00,0,5303.0,4901.0,0.924,26.318,111,25,0,25,86,32,54,31,0.0,0.0
1013,1683,25-09-2019 19:44:00,0,5291.0,4955.0,0.937,26.331,82,10,0,10,72,15,57,32,0.0,0.05
1013,1684,25-09-2019 19:46:00,0,5065.0,4832.0,0.954,25.305,164,72,57,15,92,55,37,33,0.0,0.05
1013,1685,25-09-2019 19:48:00,0,4183.0,3948.0,0.944,20.851,85,33,24,9,52,32,20,5,0.0,0.0
1013,1686,25-09-2019 19:50:00,0,3910.0,3727.0,0.953,19.53,34,21,15,6,13,1,12,0,0.0,0.0
1013,1687,25-09-2019 19:52:00,0,4168.0,3963.0,0.951,20.809,106,28,14,14,78,39,39,0,0.0,0.01
1013,1688,25-09-2019 19:54:00,0,4556.0,4321.0,0.948,22.734,35,24,6,18,11,4,7,0,0.0,0.0
1013,1689,25-09-2019 19:56:00,0,4787.0,4466.0,0.933,23.805,21,7,0,7,14,3,11,0,0.0,0.0
1013,1690,25-09-2019 19:58:00,0,4603.0,4296.0,0.933,22.891,1,0,0,0,1,1,0,0,0.0,0.0
1013,1691,25-09-2019 20:00:00,0,4409.0,4095.0,0.929,21.906,2,2,0,2,0,0,0,0,0.0,0.0
1013,1692,25-09-2019 20:02:00,0,4194.0,3960.0,0.944,20.908,12,10,5,5,2,1,1,0,0.0,0.0
1013,1693,25-09-2019 20:04:00,0,4131.0,3824.0,0.926,20.509,0,0,0,0,0,0,0,0,0.0,0.01
1013,1694,25-09-2019 20:06:00,0,3891.0,3708.0,0.953,19.435,14,10,7,3,4,2,2,0,0.0,0.0
1013,1695,25-09-2019 20:08:00,0,3690.5,3531.5,0.957,18.45,0,0,0,0,0,0,0,0,0.0,0.0
1013,1696,25-09-2019 20:10:00,0,3490.0,3355.0,0.961,17.465,9,3,2,1,6,6,0,0,0.0,0.0
1013,1697,25-09-2019 20:12:00,0,3597.0,3381.0,0.94,17.917,56,28,16,12,28,19,9,0,0.0,0.0
1013,1698,25-09-2019 20:14:00,0,3395.0,3248.0,0.957,16.972,2,2,0,2,0,0,0,0,0.0,0.0
1013,1699,25-09-2019 20:16:00,0,3202.0,3150.0,0.983,16.104,18,9,6,3,9,4,5,0,0.0,0.0
1013,1700,25-09-2019 20:18:00,0,3379.0,3327.0,0.985,16.996,201,114,75,39,87,35,52,37,0.0,0.0
1013,1701,25-09-2019 20:20:00,0,4056.0,3900.0,0.961,20.299,258,135,103,32,123,73,50,56,0.0,0.0
1013,1702,25-09-2019 20:22:00,0,4057.0,4014.0,0.989,20.427,72,9,1,8,63,12,51,15,0.0,0.06
1013,1703,25-09-2019 20:24:00,0,4037.0,4021.0,0.996,20.357,128,34,9,25,94,41,53,17,0.0,0.01
1013,1704,25-09-2019 20:26:00,0,4456.0,4405.0,0.989,22.432,112,23,1,22,89,38,51,21,0.01,0.0
1013,1705,25-09-2019 20:28:00,0,4480.0,4269.0,0.953,22.376,167,86,59,27,81,54,27,13,0.06,0.06
1013,1706,25-09-2019 20:30:00,0,3789.0,3629.0,0.958,18.946,91,37,15,22,54,23,31,18,0.0,0.0
1013,1707,25-09-2019 20:32:00,0,3614.0,3400.0,0.941,18.004,204,124,93,31,80,46,34,49,0.0,0.01
1013,1708,25-09-2019 20:34:00,0,4390.0,4205.0,0.958,21.952,241,174,118,56,67,22,45,31,0.01,0.02
1013,1709,25-09-2019 20:36:00,0,4960.0,4811.0,0.97,24.869,95,22,8,14,73,16,57,21,0.0,0.01
1013,1710,25-09-2019 20:38:00,0,4855.0,4689.0,0.966,24.321,152,26,3,23,126,72,54,8,0.0,0.0
1013,1711,25-09-2019 20:40:00,0,4944.0,4807.0,0.972,24.8,148,52,27,25,96,55,41,18,0.0,0.42
1013,1712,25-09-2019 20:42:00,0,4275.0,4122.0,0.9625,21.4065,2,0,0,0,2,0,2,0,0.0,0.0
1013,1713,25-09-2019 20:44:00,0,3606.0,3437.0,0.953,18.013,263,135,103,32,128,92,36,59,0.16,0.0
1013,1714,25-09-2019 20:46:00,0,4758.0,4582.0,0.963,23.819,305,168,123,45,137,108,29,133,0.0,0.01
1013,1715,25-09-2019 20:48:00,0,4724.0,4628.0,0.98,23.735,234,143,104,39,91,63,28,41,0.08,0.0
1013,1716,25-09-2019 20:50:00,0,4080.0,4015.0,0.984,20.52,249,122,89,33,127,96,31,60,0.0,0.0
1013,1717,25-09-2019 20:52:00,0,4365.0,4265.0,0.977,21.918,208,110,85,25,98,66,32,56,0.0,0.1
1013,1718,25-09-2019 20:54:00,0,4912.0,4909.0,1.0,24.786,350,216,169,47,134,98,36,74,0.0,0.0
1013,1719,25-09-2019 20:56:00,0,3755.0,3717.0,0.99,18.907,15,15,0,15,0,0,0,0,0.01,0.0
1013,1720,25-09-2019 20:58:00,0,3577.0,3463.0,0.968,17.928,261,147,109,38,114,77,37,26,0.11,0.0
1013,1721,25-09-2019 21:00:00,0,4560.0,4448.0,0.975,22.892,190,96,62,34,94,60,34,48,0.08,0.0
1013,1722,25-09-2019 21:02:00,0,4942.0,4818.0,0.975,24.806,191,109,87,22,82,53,29,28,0.01,0.0
1013,1723,25-09-2019 21:04:00,0,4087.0,3917.0,0.959,20.438,173,46,21,25,127,99,28,0,0.0,0.0
1013,1724,25-09-2019 21:06:00,0,4489.0,4254.0,0.948,22.397,160,59,36,23,101,74,27,3,0.01,0.0
1013,1725,25-09-2019 21:08:00,0,4851.0,4704.0,0.97,24.322,218,91,59,32,127,97,30,23,0.0,0.0
1013,1726,25-09-2019 21:10:00,0,5123.0,5080.0,0.992,25.807,163,96,66,30,67,54,13,64,0.0,0.0
1013,1727,25-09-2019 21:12:00,0,4295.0,4089.0,0.952,21.45,137,61,47,14,76,43,33,16,0.0,0.0
1013,1728,25-09-2019 21:14:00,0,4934.0,4817.0,0.976,24.771,222,106,82,24,116,83,33,60,0.0,0.0
1013,1729,25-09-2019 21:16:00,0,4929.5,4824.5,0.9785,24.762,306,133,101,32,173,130,43,70,0.0,0.0
1013,1730,25-09-2019 21:18:00,0,4925.0,4832.0,0.981,24.753,161,89,63,26,72,44,28,28,0.03,0.0
1013,1731,25-09-2019 21:20:00,0,4927.0,4823.0,0.979,24.75,357,233,175,58,124,92,32,52,0.01,0.0
1013,1732,25-09-2019 21:22:00,0,4949.0,4779.0,0.966,24.789,220,189,125,64,31,4,27,41,0.0,0.0
1013,1733,25-09-2019 21:24:00,0,4954.0,4809.0,0.971,24.841,86,49,35,14,37,15,22,11,0.0,0.0
1013,1734,25-09-2019 21:26:00,0,3781.0,3697.0,0.978,18.99,36,16,10,6,20,12,8,0,0.0,0.0
1013,1735,25-09-2019 21:28:00,0,3514.0,3317.0,0.944,17.518,85,33,23,10,52,39,13,2,0.0,0.0
1013,1736,25-09-2019 21:30:00,0,3819.0,3537.0,0.926,18.964,99,45,18,27,54,19,35,4,0.0,0.0
1013,1737,25-09-2019 21:32:00,0,4275.0,4108.0,0.961,21.392,208,85,57,28,123,85,38,15,0.0,0.0
1013,1738,25-09-2019 21:34:00,0,4459.0,4375.0,0.981,22.41,248,142,103,39,106,77,29,51,0.0,0.0
1013,1739,25-09-2019 21:36:00,0,4362.0,4322.0,0.991,21.972,18,10,5,5,8,5,3,0,0.0,0.0
1013,1740,25-09-2019 21:38:00,0,4071.0,3927.0,0.965,20.388,56,29,13,16,27,16,11,0,0.0,0.0
1013,1741,25-09-2019 21:40:00,0,4367.0,4222.0,0.967,21.881,106,56,22,34,50,18,32,1,0.0,0.0
1013,1742,25-09-2019 21:42:00,0,4472.0,4287.0,0.959,22.365,181,93,58,35,88,53,35,20,0.0,0.0
1013,1743,25-09-2019 21:44:00,0,4462.0,4357.0,0.977,22.402,328,200,157,43,128,90,38,54,0.0,0.0
1013,1744,25-09-2019 21:46:00,0,4743.0,4678.0,0.986,23.867,168,87,55,32,81,39,42,39,0.01,0.0
1013,1745,25-09-2019 21:48:00,0,4899.0,4953.0,1.011,24.783,128,54,33,21,74,24,50,47,0.0,0.0
1013,1746,25-09-2019 21:50:00,0,4925.0,4853.5,0.9855,24.7765,111,37,19,18,74,32,42,43,0.0,0.06
1013,1747,25-09-2019 21:52:00,0,4951.0,4754.0,0.96,24.77,124,74,44,30,50,34,16,55,0.0,0.01
1013,1748,25-09-2019 21:54:00,0,3783.0,3622.0,0.958,18.915,235,147,106,41,88,63,25,57,0.06,0.03
1013,1749,25-09-2019 21:56:00,0,4862.0,4694.0,0.965,24.353,226,132,95,37,94,55,39,81,0.01,0.0
1013,1750,25-09-2019 21:58:00,0,5150.0,4969.0,0.965,25.792,305,175,137,38,130,94,36,28,0.04,0.03
1013,1751,25-09-2019 22:00:00,0,4746.0,4693.0,0.989,23.895,262,155,117,38,107,74,33,97,0.0,0.0
1013,1752,25-09-2019 22:02:00,0,4371.0,4221.0,0.966,21.892,200,102,64,38,98,65,33,57,0.0,0.0
1013,1753,25-09-2019 22:04:00,0,3869.0,3804.0,0.983,19.456,194,107,81,26,87,52,35,47,0.0,0.0
1013,1754,25-09-2019 22:06:00,0,5143.0,5024.0,0.977,25.825,102,43,23,20,59,18,41,60,0.08,0.0
1013,1755,25-09-2019 22:08:00,0,4750.0,4597.0,0.968,23.806,333,171,117,54,162,124,38,84,0.02,0.01
1013,1756,25-09-2019 22:10:00,0,4185.0,4051.0,0.968,20.973,180,91,57,34,89,51,38,40,0.0,0.0
1013,1757,25-09-2019 22:12:00,0,5154.0,4976.0,0.965,25.816,114,31,11,20,83,39,44,41,0.01,0.03
1013,1758,25-09-2019 22:14:00,0,5204.0,5131.0,0.986,26.184,115,65,41,24,50,21,29,61,0.0,0.0
1013,1759,25-09-2019 22:16:00,0,5145.0,4980.0,0.968,25.785,241,120,88,32,121,88,33,26,0.0,0.07
1013,1760,25-09-2019 22:18:00,0,3759.0,3667.0,0.975,18.87,195,95,69,26,100,67,33,20,0.12,0.0
1013,1761,25-09-2019 22:20:00,0,4785.0,4488.0,0.938,23.822,144,72,44,28,72,47,25,23,0.01,0.03
1013,1762,25-09-2019 22:22:00,0,4748.0,4556.0,0.96,23.75,255,159,119,40,96,61,35,61,0.0,0.0
1013,1763,25-09-2019 22:24:00,0,4928.0,4814.5,0.9765,24.7455,144,43,22,21,101,52,49,52,0.0,0.0
1013,1764,25-09-2019 22:26:00,0,5108.0,5073.0,0.993,25.741,136,64,39,25,72,54,18,24,0.0,0.0
1013,1765,25-09-2019 22:28:00,0,4004.0,3826.0,0.956,20.01,229,88,59,29,141,105,36,13,0.07,0.0
1013,1766,25-09-2019 22:30:00,0,4743.0,4570.0,0.964,23.745,269,139,105,34,130,91,39,7,0.0,0.0
1013,1767,25-09-2019 22:32:00,0,3990.0,3811.0,0.955,19.938,96,68,28,40,28,10,18,3,0.0,0.0
1013,1768,25-09-2019 22:34:00,0,4075.0,3944.0,0.968,20.421,78,62,24,38,16,4,12,0,0.0,0.01
1013,1769,25-09-2019 22:36:00,0,4281.0,4057.0,0.948,21.359,96,85,46,39,11,2,9,0,0.01,0.0
1013,1770,25-09-2019 22:38:00,0,4278.0,4152.0,0.971,21.453,1,1,0,1,0,0,0,0,0.0,0.0
1013,1771,25-09-2019 22:40:00,0,4181.0,4018.0,0.961,20.923,0,0,0,0,0,0,0,0,0.0,0.0
1013,1772,25-09-2019 22:42:00,0,4075.0,3930.0,0.964,20.408,10,7,5,2,3,0,3,0,0.0,0.0
1013,1773,25-09-2019 22:44:00,0,3876.0,3799.0,0.98,19.478,7,5,1,4,2,1,1,0,0.0,0.0
1013,1774,25-09-2019 22:46:00,0,3792.0,3666.0,0.967,18.997,30,0,0,0,30,0,30,0,0.0,0.0
1013,1775,25-09-2019 22:48:00,0,3573.0,3539.0,0.99,17.997,14,4,2,2,10,4,6,0,0.0,0.0
1013,1776,25-09-2019 22:50:00,0,3598.0,3451.0,0.959,17.995,9,9,4,5,0,0,0,0,0.0,0.0
1013,1777,25-09-2019 22:52:00,0,3613.0,3398.0,0.941,17.996,13,13,5,8,0,0,0,0,0.0,0.0
1013,1778,25-09-2019 22:54:00,0,3500.0,3372.0,0.963,17.524,11,11,6,5,0,0,0,0,0.0,0.0
1013,1779,25-09-2019 22:56:00,0,3496.0,3363.0,0.962,17.497,3,3,0,3,0,0,0,0,0.0,0.0
1013,1780,25-09-2019 22:58:00,0,3557.0,3389.0,0.953,17.766,67,45,21,24,22,16,6,0,0.0,0.0
1013,1781,25-09-2019 23:00:00,0,3618.0,3415.0,0.944,18.035,8,8,3,5,0,0,0,0,0.0,0.0
1013,1782,25-09-2019 23:02:00,0,3480.0,3374.0,0.97,17.446,4,4,0,4,0,0,0,0,0.0,0.0
1013,1783,25-09-2019 23:04:00,0,3496.0,3399.0,0.972,17.538,1,1,0,1,0,0,0,0,0.0,0.0
1013,1784,25-09-2019 23:06:00,0,3369.0,3366.0,0.999,17.001,0,0,0,0,0,0,0,0,0.0,0.0
1013,1785,25-09-2019 23:08:00,0,3490.0,3397.0,0.973,17.511,3,3,1,2,0,0,0,0,0.0,0.01
1013,1786,25-09-2019 23:10:00,0,3582.0,3442.0,0.961,17.924,25,20,12,8,5,3,2,0,0.0,0.0
1013,1787,25-09-2019 23:12:00,0,3484.0,3423.0,0.982,17.517,1,1,0,1,0,0,0,0,0.0,0.0
1013,1788,25-09-2019 23:14:00,0,3370.0,3323.0,0.986,16.958,9,3,1,2,6,2,4,0,0.0,0.0
1013,1789,25-09-2019 23:16:00,0,3081.0,3081.0,1.0,15.551,2,1,0,1,1,1,0,0,0.0,0.0
1013,1790,25-09-2019 23:18:00,0,3100.0,3018.0,0.974,15.555,182,105,67,38,77,48,29,7,0.0,0.0
1013,1791,25-09-2019 23:20:00,0,3579.0,3506.0,0.98,17.984,166,101,64,37,65,26,39,50,0.0,0.0
1013,1792,25-09-2019 23:22:00,0,3763.0,3770.0,1.002,19.001,240,127,85,42,113,75,38,55,0.0,0.02
1013,1793,25-09-2019 23:24:00,0,3574.0,3517.0,0.984,17.975,197,82,60,22,115,68,47,50,0.0,0.0
1013,1794,25-09-2019 23:26:00,0,4257.0,4154.0,0.976,21.372,95,21,5,16,74,23,51,45,0.0,0.06
1013,1795,25-09-2019 23:28:00,0,4550.0,4489.0,0.987,22.898,135,51,29,22,84,26,58,35,0.0,0.08
1013,1796,25-09-2019 23:30:00,0,4035.0,4110.0,1.019,20.446,171,77,57,20,94,59,35,16,0.05,0.0
1013,1797,25-09-2019 23:32:00,0,4134.5,4157.0,1.006,20.8905,377,165,119,46,212,163,49,84,0.01,0.02
1013,1798,25-09-2019 23:34:00,0,4234.0,4204.0,0.993,21.335,299,140,103,37,159,115,44,74,0.1,0.03
1013,1799,25-09-2019 23:36:00,0,4456.0,4367.0,0.98,22.391,105,24,5,19,81,24,57,35,0.0,0.0
1013,1800,25-09-2019 23:38:00,0,4934.0,4793.0,0.971,24.747,121,27,9,18,94,38,56,37,0.0,0.06
1013,1801,25-09-2019 23:40:00,0,4546.0,4493.0,0.988,22.885,372,195,146,49,177,132,45,54,0.0,0.0
1013,1802,25-09-2019 23:42:00,0,4650.0,4503.0,0.968,23.306,538,264,206,58,274,207,67,46,0.14,0.0
1013,1803,25-09-2019 23:44:00,0,3790.0,3692.0,0.974,19.02,375,224,166,58,151,117,34,18,0.0,0.0
1013,1804,25-09-2019 23:46:00,0,4373.0,4229.0,0.967,21.913,356,153,109,44,203,133,70,32,0.01,0.05
1013,1805,25-09-2019 23:48:00,0,5122.0,5040.0,0.984,25.76,125,53,31,22,72,26,46,46,0.0,0.0
1013,1806,25-09-2019 23:50:00,0,4560.0,4441.0,0.974,22.881,168,124,85,39,44,21,23,55,0.0,0.04
1013,1807,25-09-2019 23:52:00,0,4553.0,4486.0,0.985,22.903,486,266,201,65,220,164,56,36,0.13,0.05
1013,1808,25-09-2019 23:54:00,0,4273.0,4131.0,0.967,21.409,104,66,40,26,38,18,20,2,0.0,0.0
1013,1809,25-09-2019 23:56:00,0,4073.0,3948.0,0.969,20.418,58,34,8,26,24,7,17,0,0.0,0.0
1013,1810,25-09-2019 23:58:00,0,4066.0,3945.0,0.97,20.389,268,147,108,39,121,78,43,44,0.0,0.0
1013,1811,26-09-2019 00:00:00,0,3762.0,3702.0,0.984,18.921,485,254,202,52,231,171,60,61,0.0,0.0
1013,1812,26-09-2019 00:02:00,0,4869.0,4722.0,0.97,24.411,97,32,11,21,65,15,50,45,0.0,0.03
1013,1813,26-09-2019 00:04:00,0,5230.0,5155.0,0.986,26.312,137,50,27,23,87,41,46,58,0.01,0.04
1013,1814,26-09-2019 00:06:00,0,4702.0,4596.5,0.977,23.6135,544,306,242,64,238,179,59,13,0.14,0.0
1013,1815,26-09-2019 00:08:00,0,4174.0,4038.0,0.968,20.915,482,278,218,60,204,154,50,15,0.0,0.04
1013,1816,26-09-2019 00:10:00,0,4922.0,4938.0,1.003,24.861,139,71,45,26,68,46,22,35,0.0,0.0
1013,1817,26-09-2019 00:12:00,0,4839.0,4683.0,0.968,24.249,196,143,102,41,53,8,45,74,0.01,0.0
1013,1818,26-09-2019 00:14:00,0,4714.0,4679.0,0.993,23.752,335,191,146,45,144,104,40,83,0.0,0.0
1013,1819,26-09-2019 00:16:00,0,4490.0,4306.0,0.959,22.458,141,54,25,29,87,48,39,0,0.0,0.0
1013,1820,26-09-2019 00:18:00,0,4174.0,4053.0,0.971,20.932,46,31,11,20,15,5,10,0,0.0,0.0
1013,1821,26-09-2019 00:20:00,0,4099.0,3839.0,0.936,20.4,2,2,0,2,0,0,0,0,0.0,0.0
1013,1822,26-09-2019 00:22:00,0,3789.0,3653.0,0.964,18.972,5,3,0,3,2,1,1,0,0.0,0.0
1013,1823,26-09-2019 00:24:00,0,3815.0,3543.0,0.929,18.953,6,1,1,0,5,1,4,0,0.0,0.0
1013,1824,26-09-2019 00:26:00,0,3998.0,3787.0,0.947,19.944,4,2,0,2,2,0,2,0,0.0,0.0
1013,1825,26-09-2019 00:28:00,0,3784.0,3618.0,0.956,18.914,21,12,5,7,9,6,3,0,0.0,0.0
1013,1826,26-09-2019 00:30:00,0,3592.0,3484.0,0.97,18.008,0,0,0,0,0,0,0,0,0.0,0.0
1013,1827,26-09-2019 00:32:00,0,3503.0,3347.0,0.955,17.508,2,2,2,0,0,0,0,0,0.0,0.0
1013,1828,26-09-2019 00:34:00,0,3405.0,3213.0,0.944,16.971,2,2,0,2,0,0,0,0,0.0,0.0
1013,1829,26-09-2019 00:36:00,0,3424.0,3159.0,0.922,16.987,4,4,0,4,0,0,0,0,0.0,0.0
1013,1830,26-09-2019 00:38:00,0,3313.0,3124.0,0.943,16.51,11,6,1,5,5,2,3,0,0.0,0.0
1013,1831,26-09-2019 00:40:00,0,3255.5,3109.5,0.9555,16.269,3,0,0,0,3,0,3,0,0.0,0.0
1013,1832,26-09-2019 00:42:00,0,3198.0,3095.0,0.968,16.028,21,4,2,2,17,2,15,0,0.0,0.0
1013,1833,26-09-2019 00:44:00,0,3099.0,3081.0,0.994,15.621,5,1,0,1,4,2,2,0,0.0,0.0
1013,1834,26-09-2019 00:46:00,0,3087.0,3093.0,1.002,15.587,58,19,8,11,39,22,17,0,0.0,0.0
1013,1835,26-09-2019 00:48:00,0,3375.0,3342.0,0.99,16.998,154,39,10,29,115,64,51,0,0.0,0.0
1013,1836,26-09-2019 00:50:00,0,3573.0,3535.0,0.989,17.99,260,119,82,37,141,87,54,30,0.0,0.0
1013,1837,26-09-2019 00:52:00,0,3563.0,3564.0,1.0,17.982,199,89,69,20,110,77,33,12,0.0,0.0
1013,1838,26-09-2019 00:54:00,0,3585.0,3471.0,0.968,17.967,0,0,0,0,0,0,0,0,0.0,0.0
1013,1839,26-09-2019 00:56:00,0,3398.0,3244.0,0.955,16.981,1,0,0,0,1,0,1,0,0.0,0.0
1013,1840,26-09-2019 00:58:00,0,3197.0,3109.0,0.972,16.037,0,0,0,0,0,0,0,0,0.0,0.0
1013,1841,26-09-2019 01:00:00,0,3097.0,3037.0,0.981,15.562,0,0,0,0,0,0,0,0,0.0,0.0
1013,1842,26-09-2019 01:02:00,0,3111.0,2976.0,0.956,15.553,2,0,0,0,2,0,2,0,0.0,0.0
1013,1843,26-09-2019 01:04:00,0,2899.0,2873.0,0.991,14.604,3,2,0,2,1,0,1,0,0.0,0.0
1013,1844,26-09-2019 01:06:00,0,2915.0,2812.0,0.965,14.597,5,0,0,0,5,0,5,0,0.0,0.0
1013,1845,26-09-2019 01:08:00,0,2919.0,2790.0,0.956,14.588,13,1,0,1,12,0,12,0,0.0,0.0
1013,1846,26-09-2019 01:10:00,0,2907.0,2828.0,0.973,14.583,1,1,0,1,0,0,0,0,0.0,0.0
1013,1847,26-09-2019 01:12:00,0,3013.0,2859.0,0.949,15.035,65,27,16,11,38,22,16,0,0.0,0.0
1013,1848,26-09-2019 01:14:00,0,3153.0,3060.5,0.97,15.8105,1,1,1,0,0,0,0,0,0.0,0.0
1013,1849,26-09-2019 01:16:00,0,3293.0,3262.0,0.991,16.586,0,0,0,0,0,0,0,0,0.0,0.0
1013,1850,26-09-2019 01:18:00,0,3274.0,3281.0,1.002,16.533,19,5,2,3,14,10,4,0,0.0,0.0
1013,1851,26-09-2019 01:20:00,0,3164.0,3208.0,1.014,16.016,1,1,1,0,0,0,0,0,0.0,0.0
1013,1852,26-09-2019 01:22:00,0,2985.0,2984.0,0.999,15.065,10,9,0,9,1,1,0,0,0.0,0.0
1013,1853,26-09-2019 01:24:00,0,2987.0,2938.0,0.984,15.02,11,1,0,1,10,4,6,0,0.0,0.0
1013,1854,26-09-2019 01:26:00,0,3007.0,2927.0,0.974,15.087,2,2,0,2,0,0,0,0,0.0,0.0
1013,1855,26-09-2019 01:28:00,0,2795.0,2860.0,1.023,14.179,1,1,0,1,0,0,0,0,0.0,0.0
1013,1856,26-09-2019 01:30:00,0,2771.0,2837.0,1.024,14.059,12,7,1,6,5,1,4,0,0.0,0.0
1013,1857,26-09-2019 01:32:00,0,2774.0,2833.0,1.021,14.066,7,0,0,0,7,1,6,0,0.0,0.0
1013,1858,26-09-2019 01:34:00,0,2899.0,2854.0,0.985,14.58,1,0,0,0,1,0,1,0,0.0,0.0
1013,1859,26-09-2019 01:36:00,0,2779.0,2847.0,1.024,14.1,35,7,5,2,28,13,15,1,0.0,0.0
1013,1860,26-09-2019 01:38:00,0,2989.0,2979.0,0.997,15.073,78,31,7,24,47,21,26,0,0.0,0.0
1013,1861,26-09-2019 01:40:00,0,3306.0,3220.0,0.974,16.589,22,3,2,1,19,1,18,0,0.0,0.0
1013,1862,26-09-2019 01:42:00,0,3251.0,3313.0,1.019,16.476,98,56,19,37,42,12,30,1,0.0,0.0
1013,1863,26-09-2019 01:44:00,0,3454.0,3443.0,0.997,17.419,132,30,15,15,102,53,49,0,0.0,0.0
1013,1864,26-09-2019 01:46:00,0,3630.0,3775.0,1.04,18.483,162,113,68,45,49,28,21,8,0.0,0.04
1013,1865,26-09-2019 01:48:00,0,3940.5,4001.0,1.017,19.956,286,135,94,41,151,101,50,66,0.0,0.04
1013,1866,26-09-2019 01:50:00,0,4251.0,4227.0,0.994,21.429,111,17,0,17,94,35,59,40,0.0,0.0
1013,1867,26-09-2019 01:52:00,0,4328.0,4368.0,1.009,21.887,298,167,135,32,131,73,58,65,0.0,0.0
1013,1868,26-09-2019 01:54:00,0,4048.0,4012.0,0.991,20.39,219,101,67,34,118,76,42,70,0.0,0.02
1013,1869,26-09-2019 01:56:00,0,4043.0,4052.0,1.002,20.416,230,87,63,24,143,83,60,48,0.13,0.0
1013,1870,26-09-2019 01:58:00,0,4654.0,4496.0,0.966,23.316,96,15,4,11,81,16,65,44,0.0,0.0
1013,1871,26-09-2019 02:00:00,0,4661.0,4476.0,0.96,23.32,142,29,8,21,113,53,60,54,0.02,0.0
1013,1872,26-09-2019 02:02:00,0,4665.0,4480.0,0.96,23.34,111,15,0,15,96,51,45,47,0.0,0.14
1013,1873,26-09-2019 02:04:00,0,4430.0,4386.0,0.99,22.308,91,48,20,28,43,18,25,58,0.0,0.0
1013,1874,26-09-2019 02:06:00,0,4670.0,4488.0,0.961,23.368,380,240,186,54,140,103,37,70,0.09,0.13
1013,1875,26-09-2019 02:08:00,0,4159.0,4059.0,0.976,20.88,417,178,134,44,239,180,59,32,0.11,0.0
1013,1876,26-09-2019 02:10:00,0,4634.0,4475.0,0.966,23.211,414,213,165,48,201,150,51,23,0.0,0.05
1013,1877,26-09-2019 02:12:00,0,4261.0,4162.0,0.977,21.397,293,189,149,40,104,82,22,119,0.01,0.0
1013,1878,26-09-2019 02:14:00,0,4644.0,4543.0,0.978,23.326,244,142,114,28,102,63,39,63,0.01,0.0
1013,1879,26-09-2019 02:16:00,0,4634.0,4521.0,0.976,23.263,151,90,66,24,61,25,36,51,0.0,0.0
1013,1880,26-09-2019 02:18:00,0,4665.0,4424.0,0.948,23.276,66,41,21,20,25,0,25,51,0.0,0.0
1013,1881,26-09-2019 02:20:00,0,4658.0,4511.0,0.968,23.347,31,29,16,13,2,0,2,27,0.0,0.63
1013,1882,26-09-2019 02:22:00,0,4609.0,4437.0,0.9625,23.071,0,0,0,0,0,0,0,0,0.0,0.0
1013,1883,26-09-2019 02:24:00,0,4560.0,4363.0,0.957,22.795,220,94,57,37,126,84,42,5,0.12,0.0
1013,1884,26-09-2019 02:26:00,0,4113.0,3811.0,0.926,20.424,160,87,59,28,73,43,30,0,0.0,0.0
1013,1885,26-09-2019 02:28:00,0,4278.0,4118.0,0.963,21.413,649,386,314,72,263,194,69,11,0.03,0.0
1013,1886,26-09-2019 02:30:00,0,4574.0,4465.0,0.976,22.966,306,144,106,38,162,113,49,52,0.08,0.0
1013,1887,26-09-2019 02:32:00,0,4263.0,4164.0,0.977,21.407,624,299,212,87,325,252,73,12,0.0,0.0
1013,1888,26-09-2019 02:34:00,0,4393.0,4187.0,0.953,21.943,977,461,352,109,516,458,58,27,0.0,0.01
1013,1889,26-09-2019 02:36:00,0,4789.0,4480.0,0.936,23.827,815,423,337,86,392,338,54,19,0.0,0.0
1013,1890,26-09-2019 02:38:00,0,4836.0,4645.0,0.96,24.195,505,253,190,63,252,186,66,32,0.11,0.05
1013,1891,26-09-2019 02:40:00,0,4264.0,4174.0,0.979,21.422,789,490,398,92,299,210,89,19,0.0,0.0
1013,1892,26-09-2019 02:42:00,0,4383.0,4233.0,0.966,21.956,413,266,201,65,147,109,38,44,0.0,0.0
1013,1893,26-09-2019 02:44:00,0,4579.0,4369.0,0.954,22.878,572,341,268,73,231,170,61,30,0.0,0.0
1013,1894,26-09-2019 02:46:00,0,4476.0,4300.0,0.961,22.395,769,436,348,88,333,254,79,4,0.0,0.0
1013,1895,26-09-2019 02:48:00,0,4495.0,4218.0,0.938,22.379,642,363,292,71,279,214,65,16,0.0,0.0
1013,1896,26-09-2019 02:50:00,0,4272.0,4065.0,0.952,21.331,54,40,8,32,14,2,12,0,0.01,0.0
1013,1897,26-09-2019 02:52:00,0,4280.0,4063.0,0.949,21.36,318,162,117,45,156,111,45,16,0.0,0.0
1013,1898,26-09-2019 02:54:00,0,4284.0,4138.0,0.966,21.46,84,42,28,14,42,14,28,0,0.0,0.0
1013,1899,26-09-2019 02:56:00,0,4326.0,4178.0,0.966,21.6695,51,38,2,36,13,1,12,0,0.0,0.0
1013,1900,26-09-2019 02:58:00,0,4368.0,4218.0,0.966,21.879,49,27,5,22,22,0,22,0,0.01,0.0
1013,1901,26-09-2019 03:00:00,0,4129.0,4132.0,1.001,20.841,5,2,0,2,3,3,0,0,0.0,0.0
1013,1902,26-09-2019 03:02:00,0,3982.0,3945.0,0.991,20.055,4,1,0,1,3,1,2,0,0.0,0.0
1013,1903,26-09-2019 03:04:00,0,3644.0,3697.0,1.015,18.45,20,5,2,3,15,4,11,0,0.0,0.0
1013,1904,26-09-2019 03:06:00,0,3474.0,3484.0,1.003,17.546,14,7,2,5,7,6,1,0,0.0,0.0
1013,1905,26-09-2019 03:08:00,0,3512.0,3355.0,0.955,17.551,1,1,0,1,0,0,0,0,0.0,0.0
1013,1906,26-09-2019 03:10:00,0,3297.0,3234.0,0.981,16.569,2,2,1,1,0,0,0,0,0.0,0.0
1013,1907,26-09-2019 03:12:00,0,3299.0,3139.0,0.952,16.472,3,3,2,1,0,0,0,0,0.0,0.0
1013,1908,26-09-2019 03:14:00,0,3289.0,3175.0,0.965,16.473,0,0,0,0,0,0,0,0,0.0,0.0
1013,1909,26-09-2019 03:16:00,0,3295.0,3194.0,0.969,16.518,2,2,0,2,0,0,0,0,0.0,0.0
1013,1910,26-09-2019 03:18:00,0,3317.0,3151.0,0.95,16.56,13,13,0,13,0,0,0,0,0.0,0.0
1013,1911,26-09-2019 03:20:00,0,3189.0,3089.0,0.969,15.984,8,8,3,5,0,0,0,0,0.0,0.0
1013,1912,26-09-2019 03:22:00,0,3327.0,3156.0,0.949,16.601,3,3,0,3,0,0,0,0,0.0,0.0
1013,1913,26-09-2019 03:24:00,0,3194.0,3107.0,0.973,16.024,11,9,0,9,2,0,2,0,0.0,0.0
1013,1914,26-09-2019 03:26:00,0,3298.0,3133.0,0.95,16.464,17,7,1,6,10,4,6,0,0.0,0.0
1013,1915,26-09-2019 03:28:00,0,3296.0,3246.0,0.985,16.581,16,0,0,0,16,2,14,0,0.0,0.0
1013,1916,26-09-2019 03:30:00,0,3194.5,3154.0,0.9875,16.0775,8,0,0,0,8,1,7,0,0.0,0.0
1013,1917,26-09-2019 03:32:00,0,3093.0,3062.0,0.99,15.574,2,1,1,0,1,1,0,0,0.0,0.0
1013,1918,26-09-2019 03:34:00,0,3085.0,3072.0,0.996,15.555,0,0,0,0,0,0,0,0,0.0,0.0
1013,1919,26-09-2019 03:36:00,0,3209.0,3111.0,0.969,16.088,37,17,9,8,20,15,5,0,0.0,0.0
1013,1920,26-09-2019 03:38:00,0,3087.0,3052.0,0.989,15.541,61,0,0,0,61,45,16,0,0.0,0.0
1013,1921,26-09-2019 03:40:00,0,3309.0,3149.0,0.952,16.523,5,0,0,0,5,0,5,0,0.0,0.0
1013,1922,26-09-2019 03:42:00,0,3434.0,3192.0,0.929,17.065,20,0,0,0,20,0,20,0,0.0,0.0
1013,1923,26-09-2019 03:44:00,0,3390.0,3276.0,0.967,16.982,8,1,0,1,7,2,5,0,0.0,0.0
1013,1924,26-09-2019 03:46:00,0,3404.0,3248.0,0.954,17.007,8,8,1,7,0,0,0,0,0.0,0.0
1013,1925,26-09-2019 03:48:00,0,3435.0,3182.0,0.926,17.057,146,95,74,21,51,40,11,4,0.0,0.0
1013,1926,26-09-2019 03:50:00,0,3589.0,3441.0,0.959,17.95,139,96,73,23,43,31,12,16,0.0,0.0
1013,1927,26-09-2019 03:52:00,0,3383.0,3350.0,0.99,17.038,214,101,75,26,113,80,33,53,0.0,0.0
1013,1928,26-09-2019 03:54:00,0,3592.0,3481.0,0.969,18.007,585,256,202,54,329,247,82,3,0.0,0.0
1013,1929,26-09-2019 03:56:00,0,3682.0,3526.0,0.958,18.409,217,117,81,36,100,62,38,13,0.0,0.0
1013,1930,26-09-2019 03:58:00,0,3794.0,3650.0,0.962,18.989,379,172,130,42,207,162,45,32,0.11,0.0
1013,1931,26-09-2019 04:00:00,0,3808.0,3582.0,0.941,18.968,14,14,0,14,0,0,0,0,0.0,0.0
1013,1932,26-09-2019 04:02:00,0,3804.0,3542.0,0.931,18.909,150,72,56,16,78,54,24,10,0.01,0.0
1013,1933,26-09-2019 04:04:00,0,3702.0,3490.0,0.943,18.45,55,29,3,26,26,6,20,0,0.0,0.0
1013,1934,26-09-2019 04:06:00,0,3600.0,3438.0,0.955,17.991,40,21,2,19,19,3,16,0,0.0,0.0
1013,1935,26-09-2019 04:08:00,0,3807.0,3576.0,0.939,18.959,103,35,10,25,68,33,35,0,0.0,0.0
1013,1936,26-09-2019 04:10:00,0,3768.0,3692.0,0.98,18.931,11,0,0,0,11,0,11,0,0.0,0.0
1013,1937,26-09-2019 04:12:00,0,3818.0,3619.0,0.948,19.051,0,0,0,0,0,0,0,0,0.0,0.0
1013,1938,26-09-2019 04:14:00,0,3694.0,3540.0,0.958,18.473,0,0,0,0,0,0,0,0,0.0,0.0
1013,1939,26-09-2019 04:16:00,0,3598.0,3464.0,0.963,18.012,9,6,2,4,3,1,2,0,0.0,0.0
1013,1940,26-09-2019 04:18:00,0,3380.0,3317.0,0.981,16.989,0,0,0,0,0,0,0,0,0.0,0.0
1013,1941,26-09-2019 04:20:00,0,3398.0,3265.0,0.961,17.001,1,1,0,1,0,0,0,0,0.0,0.0
1013,1942,26-09-2019 04:22:00,0,3435.0,3235.0,0.942,17.114,2,2,0,2,0,0,0,0,0.0,0.0
1013,1943,26-09-2019 04:24:00,0,3311.0,3168.0,0.957,16.551,24,14,6,8,10,5,5,0,0.0,0.0
1013,1944,26-09-2019 04:26:00,0,3430.0,3200.0,0.933,17.055,5,2,2,0,3,3,0,0,0.0,0.0
1013,1945,26-09-2019 04:28:00,0,3085.0,3079.0,0.998,15.565,22,8,2,6,14,1,13,0,0.0,0.0
1013,1946,26-09-2019 04:30:00,0,3084.0,3120.0,1.012,15.604,41,16,10,6,25,7,18,0,0.0,0.0
1013,1947,26-09-2019 04:32:00,0,3377.0,3329.0,0.986,16.991,4,2,0,2,2,0,2,0,0.0,0.0
1013,1948,26-09-2019 04:34:00,0,3597.0,3454.0,0.96,17.995,7,3,1,2,4,0,4,0,0.0,0.0
1013,1949,26-09-2019 04:36:00,0,3595.0,3445.0,0.958,17.978,4,3,1,2,1,0,1,0,0.0,0.0
1013,1950,26-09-2019 04:38:00,0,3544.0,3411.5,0.9625,17.7395,0,0,0,0,0,0,0,0,0.0,0.0
1013,1951,26-09-2019 04:40:00,0,3493.0,3378.0,0.967,17.501,186,93,66,27,93,53,40,6,0.0,0.0
1013,1952,26-09-2019 04:42:00,0,3403.0,3240.0,0.952,16.995,166,95,59,36,71,41,30,0,0.0,0.0
1013,1953,26-09-2019 04:44:00,0,3402.0,3302.0,0.971,17.058,166,60,35,25,106,62,44,1,0.0,0.0
1013,1954,26-09-2019 04:46:00,0,3676.0,3576.0,0.973,18.443,373,202,155,47,171,121,50,61,0.0,0.0
1013,1955,26-09-2019 04:48:00,0,3879.0,3815.0,0.983,19.508,199,117,78,39,82,56,26,20,0.0,0.0
1013,1956,26-09-2019 04:50:00,0,3785.0,3670.0,0.97,18.976,265,130,95,35,135,86,49,7,0.0,0.0
1013,1957,26-09-2019 04:52:00,0,3808.0,3614.0,0.949,19.003,282,147,103,44,135,96,39,47,0.12,0.0
1013,1958,26-09-2019 04:54:00,0,3751.0,3701.0,0.987,18.875,175,115,89,26,60,43,17,125,0.01,0.0
1013,1959,26-09-2019 04:56:00,0,3992.0,3871.0,0.97,20.014,351,219,162,57,132,91,41,112,0.0,0.0
1013,1960,26-09-2019 04:58:00,0,3878.0,3815.0,0.984,19.502,451,269,212,57,182,144,38,129,0.04,0.0
1013,1961,26-09-2019 05:00:00,0,4069.0,3957.0,0.972,20.413,248,122,91,31,126,82,44,73,0.0,0.0
1013,1962,26-09-2019 05:02:00,0,4178.0,4037.0,0.966,20.932,467,223,170,53,244,189,55,49,0.01,0.0
1013,1963,26-09-2019 05:04:00,0,4086.0,3952.0,0.967,20.472,292,173,124,49,119,93,26,77,0.0,0.0
1013,1964,26-09-2019 05:06:00,0,4037.0,3953.0,0.979,20.283,204,123,97,26,81,69,12,84,0.0,0.0
1013,1965,26-09-2019 05:08:00,0,4072.0,3964.0,0.973,20.431,340,220,164,56,120,89,31,31,0.0,0.0
1013,1966,26-09-2019 05:10:00,0,4297.0,4073.0,0.948,21.439,637,356,280,76,281,218,63,28,0.0,0.0
1013,1967,26-09-2019 05:12:00,0,4296.5,4064.0,0.946,21.4275,251,102,67,35,149,110,39,114,0.01,0.0
1013,1968,26-09-2019 05:14:00,0,4296.0,4055.0,0.944,21.416,343,197,145,52,146,103,43,22,0.0,0.0
1013,1969,26-09-2019 05:16:00,0,4121.0,3870.0,0.939,20.519,197,88,58,30,109,72,37,0,0.0,0.0
1013,1970,26-09-2019 05:18:00,0,4089.0,3893.0,0.952,20.421,458,253,199,54,205,149,56,15,0.0,0.0
1013,1971,26-09-2019 05:20:00,0,4094.0,3847.0,0.94,20.39,72,47,23,24,25,14,11,3,0.0,0.0
1013,1972,26-09-2019 05:22:00,0,4084.0,3881.0,0.95,20.389,162,101,74,27,61,39,22,49,0.0,0.0
1013,1973,26-09-2019 05:24:00,0,3782.0,3720.0,0.984,19.018,376,214,159,55,162,124,38,13,0.0,0.0
1013,1974,26-09-2019 05:26:00,0,4105.0,3833.0,0.934,20.418,378,203,159,44,175,130,45,19,0.0,0.0
1013,1975,26-09-2019 05:28:00,0,4118.0,3843.0,0.933,20.48,207,134,96,38,73,43,30,0,0.0,0.0
1013,1976,26-09-2019 05:30:00,0,3998.0,3735.0,0.934,19.887,616,341,277,64,275,214,61,14,0.0,0.0
1013,1977,26-09-2019 05:32:00,0,3900.0,3748.0,0.961,19.514,465,264,198,66,201,148,53,32,0.0,0.01
1013,1978,26-09-2019 05:34:00,0,3782.0,3673.0,0.971,18.967,132,48,27,21,84,46,38,5,0.0,0.0
1013,1979,26-09-2019 05:36:00,0,3908.0,3738.0,0.956,19.537,239,146,105,41,93,70,23,52,0.0,0.0
1013,1980,26-09-2019 05:38:00,0,3760.0,3679.0,0.978,18.886,147,67,37,30,80,44,36,0,0.0,0.0
1013,1981,26-09-2019 05:40:00,0,3822.0,3572.0,0.935,19.012,62,22,6,16,40,21,19,0,0.0,0.0
1013,1982,26-09-2019 05:42:00,0,3622.0,3397.0,0.938,18.032,110,21,2,19,89,68,21,0,0.0,0.0
1013,1983,26-09-2019 05:44:00,0,3622.0,3408.0,0.941,18.042,17,8,2,6,9,1,8,0,0.0,0.0
1013,1984,26-09-2019 05:46:00,0,3529.5,3303.0,0.936,17.5615,4,2,0,2,2,1,1,0,0.0,0.0
1013,1985,26-09-2019 05:48:00,0,3437.0,3198.0,0.931,17.081,2,1,0,1,1,0,1,0,0.0,0.0
1013,1986,26-09-2019 05:50:00,0,3358.0,2974.0,0.886,16.522,2,1,0,1,1,0,1,0,0.0,0.0
1013,1987,26-09-2019 05:52:00,0,3157.0,2855.0,0.904,15.6,7,1,0,1,6,3,3,0,0.0,0.0
1013,1988,26-09-2019 05:54:00,0,3161.0,2755.0,0.872,15.503,1,0,0,0,1,0,1,0,0.0,0.0
1013,1989,26-09-2019 05:56:00,0,2957.0,2665.0,0.901,14.603,10,0,0,0,10,4,6,0,0.0,0.0
1013,1990,26-09-2019 05:58:00,0,2963.0,2631.0,0.888,14.587,19,8,6,2,11,4,7,0,0.0,0.0
1013,1991,26-09-2019 06:00:00,1,2765.0,2496.0,0.903,13.658,34,12,6,6,22,11,11,0,0.0,0.0
1013,1992,26-09-2019 06:02:00,1,2845.0,2521.0,0.886,14.0,32,4,2,2,28,12,16,0,0.0,0.0
1013,1993,26-09-2019 06:04:00,1,2745.0,2491.0,0.907,13.573,17,8,0,8,9,4,5,0,0.0,0.0
1013,1994,26-09-2019 06:06:00,1,2885.0,2511.0,0.871,14.147,7,0,0,0,7,1,6,0,0.0,0.0
1013,1995,26-09-2019 06:08:00,1,2951.0,2606.0,0.883,14.513,3,1,1,0,2,2,0,0,0.0,0.0
1013,1996,26-09-2019 06:10:00,1,2884.0,2520.0,0.874,14.151,2,0,0,0,2,1,1,0,0.0,0.0
1013,1997,26-09-2019 06:12:00,1,2873.0,2508.0,0.873,14.099,9,1,0,1,8,4,4,0,0.0,0.0
1013,1998,26-09-2019 06:14:00,1,2875.0,2511.0,0.873,14.108,26,0,0,0,26,0,26,0,0.0,0.0
1013,1999,26-09-2019 06:16:00,1,2757.0,2449.0,0.888,13.573,27,0,0,0,27,3,24,0,0.0,0.0
1013,2000,26-09-2019 06:18:00,1,2881.0,2488.0,0.864,14.107,0,0,0,0,0,0,0,0,0.0,0.0
1013,2001,26-09-2019 06:20:00,1,2933.0,2530.0,0.863,14.3585,34,0,0,0,34,17,17,0,0.0,0.0
1013,2002,26-09-2019 06:22:00,1,2985.0,2572.0,0.862,14.61,8,1,0,1,7,5,2,0,0.0,0.0
1013,2003,26-09-2019 06:24:00,1,2957.0,2578.0,0.872,14.505,46,7,4,3,39,14,25,0,0.0,0.0
1013,2004,26-09-2019 06:26:00,1,3179.0,2763.0,0.869,15.583,51,19,6,13,32,15,17,0,0.0,0.0
1013,2005,26-09-2019 06:28:00,1,3165.0,2794.0,0.883,15.562,15,3,0,3,12,1,11,0,0.0,0.0
1013,2006,26-09-2019 06:30:00,1,3166.0,2775.0,0.876,15.548,2,2,1,1,0,0,0,0,0.0,0.0
1013,2007,26-09-2019 06:32:00,1,3183.0,2727.0,0.857,15.56,120,66,48,18,54,33,21,3,0.0,0.0
1013,2008,26-09-2019 06:34:00,1,3165.0,2803.0,0.885,15.575,103,76,50,26,27,12,15,42,0.0,0.0
1013,2009,26-09-2019 06:36:00,1,3640.0,3210.0,0.882,17.894,226,139,91,48,87,56,31,26,0.0,0.0
1013,2010,26-09-2019 06:38:00,1,3379.0,2939.0,0.87,16.568,106,37,18,19,69,39,30,2,0.0,0.0
1013,2011,26-09-2019 06:40:00,1,3483.0,3001.0,0.862,17.045,224,114,83,31,110,81,29,23,0.0,0.0
1013,2012,26-09-2019 06:42:00,1,3673.0,3169.0,0.863,17.979,151,49,28,21,102,61,41,43,0.0,0.08
1013,2013,26-09-2019 06:44:00,1,4146.0,3602.0,0.869,20.323,95,31,14,17,64,35,29,29,0.0,0.0
1013,2014,26-09-2019 06:46:00,1,3739.0,3335.0,0.892,18.423,214,105,78,27,109,75,34,95,0.0,0.0
1013,2015,26-09-2019 06:48:00,1,3453.0,3082.0,0.893,17.017,316,174,139,35,142,103,39,1,0.0,0.0
1013,2016,26-09-2019 06:50:00,1,3450.0,3051.0,0.884,16.97,356,137,96,41,219,160,59,14,0.0,0.0
1013,2017,26-09-2019 06:52:00,1,3860.0,3411.0,0.884,18.986,302,143,103,40,159,111,48,26,0.07,0.0
1013,2018,26-09-2019 06:54:00,1,3889.0,3500.5,0.9,19.1985,227,130,94,36,97,63,34,39,0.03,0.0
1013,2019,26-09-2019 06:56:00,1,3918.0,3590.0,0.916,19.411,418,253,203,50,165,103,62,5,0.0,0.0
1013,2020,26-09-2019 06:58:00,1,3630.0,3327.0,0.916,17.985,288,178,143,35,110,63,47,0,0.0,0.0
1013,2021,26-09-2019 07:00:00,1,3618.0,3319.0,0.917,17.931,537,362,289,73,175,119,56,1,0.0,0.0
1013,2022,26-09-2019 07:02:00,1,3732.0,3350.0,0.897,18.414,52,21,7,14,31,21,10,0,0.0,0.0
1013,2023,26-09-2019 07:04:00,1,3650.0,3260.0,0.893,17.991,425,219,163,56,206,155,51,0,0.0,0.0
1013,2024,26-09-2019 07:06:00,1,3632.0,3293.0,0.907,17.955,580,312,245,67,268,200,68,14,0.0,0.0
1013,2025,26-09-2019 07:08:00,1,3643.0,3269.0,0.897,17.974,259,139,96,43,120,80,40,0,0.0,0.0
1013,2026,26-09-2019 07:10:00,1,3663.0,3262.0,0.89,18.042,200,86,53,33,114,69,45,0,0.0,0.0
1013,2027,26-09-2019 07:12:00,1,3657.0,3190.0,0.872,17.94,162,30,15,15,132,81,51,1,0.0,0.0
1013,2028,26-09-2019 07:14:00,1,3452.0,3115.0,0.902,17.05,123,8,3,5,115,84,31,0,0.0,0.0
1013,2029,26-09-2019 07:16:00,1,3482.0,3006.0,0.863,17.048,128,26,3,23,102,58,44,0,0.0,0.0
1013,2030,26-09-2019 07:18:00,1,3447.0,3052.0,0.885,16.958,15,11,1,10,4,1,3,0,0.0,0.0
1013,2031,26-09-2019 07:20:00,1,3471.0,2944.0,0.848,16.937,15,0,0,0,15,3,12,0,0.0,0.0
1013,2032,26-09-2019 07:22:00,1,3168.0,2778.0,0.877,15.557,39,5,1,4,34,14,20,0,0.0,0.0
1013,2033,26-09-2019 07:24:00,1,3072.0,2634.0,0.857,15.019,38,6,0,6,32,13,19,0,0.0,0.0
1013,2034,26-09-2019 07:26:00,1,2980.0,2546.0,0.854,14.562,30,0,0,0,30,15,15,0,0.0,0.0
1013,2035,26-09-2019 07:28:00,1,2883.5,2470.0,0.8565,14.097,31,3,0,3,28,17,11,0,0.0,0.0
1013,2036,26-09-2019 07:30:00,1,2787.0,2394.0,0.859,13.632,23,3,0,3,20,14,6,0,0.0,0.0
1013,2037,26-09-2019 07:32:00,1,2796.0,2331.0,0.834,13.595,15,0,0,0,15,8,7,0,0.0,0.0
1013,2038,26-09-2019 07:34:00,1,2804.0,2259.0,0.806,13.549,55,1,0,1,54,24,30,0,0.0,0.0
1013,2039,26-09-2019 07:36:00,1,2809.0,2261.0,0.805,13.57,26,2,0,2,24,9,15,0,0.0,0.0
1013,2040,26-09-2019 07:38:00,1,2588.0,2176.0,0.841,12.605,11,2,0,2,9,0,9,0,0.0,0.0
1013,2041,26-09-2019 07:40:00,1,2498.0,2082.0,0.833,12.147,25,1,0,1,24,12,12,0,0.0,0.0
1013,2042,26-09-2019 07:42:00,1,2510.0,2019.0,0.804,12.127,13,0,0,0,13,10,3,0,0.0,0.0
1013,2043,26-09-2019 07:44:00,1,2509.0,2016.0,0.803,12.12,22,0,0,0,22,10,12,0,0.0,0.0
1013,2044,26-09-2019 07:46:00,1,2507.0,2064.0,0.823,12.161,60,0,0,0,60,22,38,0,0.0,0.0
1013,2045,26-09-2019 07:48:00,1,2621.0,2093.0,0.799,12.643,33,1,0,1,32,14,18,0,0.0,0.0
1013,2046,26-09-2019 07:50:00,1,2730.0,2161.0,0.792,13.147,6,0,0,0,6,0,6,0,0.0,0.0
1013,2047,26-09-2019 07:52:00,1,2615.0,2126.0,0.813,12.657,21,2,0,2,19,9,10,0,0.0,0.0
1013,2048,26-09-2019 07:54:00,1,2611.0,2104.0,0.806,12.616,125,8,0,8,117,77,40,0,0.0,0.0
1013,2049,26-09-2019 07:56:00,1,2495.0,2077.0,0.832,12.128,82,7,0,7,75,28,47,0,0.0,0.0
1013,2050,26-09-2019 07:58:00,1,2598.0,2126.0,0.818,12.59,67,7,1,6,60,30,30,0,0.0,0.0
1013,2051,26-09-2019 08:00:00,1,2804.0,2319.0,0.827,13.616,29,0,0,0,29,0,29,0,0.0,0.0
1013,2052,26-09-2019 08:02:00,1,2822.0,2236.0,0.7925,13.594,35,0,0,0,35,13,22,0,0.0,0.0
1013,2053,26-09-2019 08:04:00,1,2840.0,2153.0,0.758,13.572,22,0,0,0,22,10,12,0,0.0,0.0
1013,2054,26-09-2019 08:06:00,1,2735.0,2094.0,0.766,13.095,43,14,2,12,29,17,12,0,0.0,0.0
1013,2055,26-09-2019 08:08:00,1,2732.0,2109.0,0.772,13.1,19,0,0,0,19,17,2,0,0.0,0.0
1013,2056,26-09-2019 08:10:00,1,2742.0,2062.0,0.752,13.089,19,0,0,0,19,18,1,0,0.0,0.0
1013,2057,26-09-2019 08:12:00,1,2620.0,2044.0,0.78,12.585,32,6,2,4,26,18,8,0,0.0,0.0
1013,2058,26-09-2019 08:14:00,1,2742.0,2086.0,0.761,13.113,15,2,0,2,13,7,6,0,0.0,0.0
1013,2059,26-09-2019 08:16:00,1,2742.0,2063.0,0.753,13.088,19,1,0,1,18,11,7,0,0.0,0.0
1013,2060,26-09-2019 08:18:00,1,2865.0,2115.0,0.738,13.628,18,3,0,3,15,4,11,0,0.0,0.0
1013,2061,26-09-2019 08:20:00,1,2858.0,2111.0,0.739,13.598,28,6,2,4,22,4,18,0,0.0,0.0
1013,2062,26-09-2019 08:22:00,1,2740.0,2086.0,0.761,13.106,31,9,5,4,22,12,10,0,0.0,0.0
1013,2063,26-09-2019 08:24:00,1,2934.0,2258.0,0.77,14.059,1,0,0,0,1,0,1,0,0.0,0.0
1013,2064,26-09-2019 08:26:00,1,3043.0,2301.0,0.756,14.538,12,3,1,2,9,0,9,0,0.0,0.0
1013,2065,26-09-2019 08:28:00,1,3054.0,2286.0,0.749,14.563,77,26,11,15,51,28,23,0,0.0,0.0
1013,2066,26-09-2019 08:30:00,1,3023.0,2348.0,0.777,14.509,211,102,71,31,109,79,30,12,0.0,0.0
1013,2067,26-09-2019 08:32:00,1,3245.0,2462.0,0.759,15.511,145,93,64,29,52,35,17,61,0.0,0.0
1013,2068,26-09-2019 08:34:00,1,3202.0,2609.0,0.815,15.503,210,123,93,30,87,68,19,72,0.0,0.0
1013,2069,26-09-2019 08:36:00,1,3465.5,2756.0,0.7965,16.705,264,153,117,36,111,73,38,58,0.0,0.0
1013,2070,26-09-2019 08:38:00,1,3729.0,2903.0,0.778,17.907,104,51,29,22,53,26,27,41,0.0,0.0
1013,2071,26-09-2019 08:40:00,1,3695.0,3001.0,0.812,17.883,85,44,20,24,41,10,31,41,0.0,0.0
1013,2072,26-09-2019 08:42:00,1,3710.0,3000.0,0.809,17.939,169,81,59,22,88,60,28,26,0.0,0.0
1013,2073,26-09-2019 08:44:00,1,3215.0,2646.0,0.823,15.596,285,135,98,37,150,97,53,2,0.0,0.0
1013,2074,26-09-2019 08:46:00,1,3219.0,2573.0,0.799,15.53,570,261,203,58,309,240,69,13,0.0,0.0
1013,2075,26-09-2019 08:48:00,1,3314.0,2667.0,0.805,16.008,589,372,299,73,217,162,55,6,0.05,0.0
1013,2076,26-09-2019 08:50:00,1,3697.0,3066.0,0.829,17.961,437,254,192,62,183,143,40,15,0.02,0.0
1013,2077,26-09-2019 08:52:00,1,3681.0,3102.0,0.843,17.938,317,170,142,28,147,108,39,42,0.0,0.0
1013,2078,26-09-2019 08:54:00,1,3536.0,2813.0,0.796,17.046,166,62,40,22,104,64,40,0,0.0,0.0
1013,2079,26-09-2019 08:56:00,1,3519.0,2809.0,0.798,16.975,112,11,3,8,101,58,43,0,0.0,0.0
1013,2080,26-09-2019 08:58:00,1,3510.0,2862.0,0.815,17.0,108,54,19,35,54,30,24,0,0.0,0.0
1013,2081,26-09-2019 09:00:00,1,3494.0,2891.0,0.828,16.966,57,10,4,6,47,24,23,0,0.0,0.0
1013,2082,26-09-2019 09:02:00,1,3505.0,2830.0,0.808,16.942,54,4,0,4,50,22,28,0,0.0,0.0
1013,2083,26-09-2019 09:04:00,1,3167.0,2746.0,0.867,15.517,13,0,0,0,13,12,1,0,0.0,0.0
1013,2084,26-09-2019 09:06:00,1,3222.0,2636.0,0.818,15.614,21,9,3,6,12,5,7,0,0.0,0.0
1013,2085,26-09-2019 09:08:00,1,2993.0,2455.0,0.82,14.511,0,0,0,0,0,0,0,0,0.0,0.0
1013,2086,26-09-2019 09:10:00,1,2897.5,2370.0,0.818,14.04,0,0,0,0,0,0,0,0,0.0,0.0
1013,2087,26-09-2019 09:12:00,1,2802.0,2285.0,0.816,13.569,19,5,3,2,14,7,7,0,0.0,0.0
1013,2088,26-09-2019 09:14:00,1,3033.0,2368.0,0.781,14.574,15,1,1,0,14,3,11,0,0.0,0.0
1013,2089,26-09-2019 09:16:00,1,2987.0,2524.0,0.845,14.564,2,0,0,0,2,0,2,0,0.0,0.0
1013,2090,26-09-2019 09:18:00,1,3205.0,2584.0,0.806,15.491,4,2,0,2,2,0,2,0,0.0,0.0
1013,2091,26-09-2019 09:20:00,1,3102.0,2547.0,0.821,15.041,1,0,0,0,1,0,1,0,0.0,0.0
1013,2092,26-09-2019 09:22:00,1,3096.0,2516.0,0.813,14.986,15,5,3,2,10,2,8,0,0.0,0.0
1013,2093,26-09-2019 09:24:00,1,2995.0,2502.0,0.835,14.57,36,14,8,6,22,11,11,0,0.0,0.0
1013,2094,26-09-2019 09:26:00,1,3010.0,2439.0,0.81,14.56,0,0,0,0,0,0,0,0,0.01,0.0
1013,2095,26-09-2019 09:28:00,1,3035.0,2357.0,0.777,14.567,10,8,4,4,2,0,2,0,0.0,0.0
1013,2096,26-09-2019 09:30:00,1,3039.0,2415.0,0.795,14.649,0,0,0,0,0,0,0,0,0.0,0.0
1013,2097,26-09-2019 09:32:00,1,3038.0,2339.0,0.77,14.558,28,6,3,3,22,16,6,0,0.0,0.0
1013,2098,26-09-2019 09:34:00,1,2828.0,2242.0,0.793,13.624,11,0,0,0,11,2,9,0,0.0,0.0
1013,2099,26-09-2019 09:36:00,1,2817.0,2218.0,0.788,13.554,2,0,0,0,2,0,2,0,0.0,0.0
1013,2100,26-09-2019 09:38:00,1,2934.0,2273.0,0.775,14.076,2,1,0,1,1,1,0,0,0.0,0.0
1013,2101,26-09-2019 09:40:00,1,2815.0,2260.0,0.803,13.595,20,3,2,1,17,13,4,0,0.0,0.0
1013,2102,26-09-2019 09:42:00,1,2931.0,2245.0,0.766,14.036,12,0,0,0,12,9,3,0,0.0,0.0
1013,2103,26-09-2019 09:44:00,1,2884.5,2202.0,0.7635,13.804,591,0,0,0,591,520,71,0,0.0,0.0
1013,2104,26-09-2019 09:46:00,1,2838.0,2159.0,0.761,13.572,211,3,0,3,208,185,23,0,0.0,0.0
1013,2105,26-09-2019 09:48:00,1,2936.0,2243.0,0.764,14.05,43,0,0,0,43,15,28,0,0.0,0.0
1013,2106,26-09-2019 09:50:00,1,2931.0,2229.0,0.761,14.019,37,2,1,1,35,8,27,0,0.0,0.0
1013,2107,26-09-2019 09:52:00,1,2837.0,2195.0,0.774,13.61,59,9,0,9,50,14,36,0,0.0,0.0
1013,2108,26-09-2019 09:54:00,1,2854.0,2122.0,0.743,13.596,42,2,1,1,40,6,34,0,0.0,0.0
1013,2109,26-09-2019 09:56:00,1,2859.0,2079.0,0.727,13.567,44,9,1,8,35,9,26,0,0.0,0.0
1013,2110,26-09-2019 09:58:00,1,2850.0,2118.0,0.743,13.574,52,4,0,4,48,14,34,0,0.0,0.0
1013,2111,26-09-2019 10:00:00,1,2832.0,2188.0,0.772,13.582,36,0,0,0,36,21,15,0,0.0,0.0
1013,2112,26-09-2019 10:02:00,1,2943.0,2221.0,0.755,14.053,40,1,0,1,39,13,26,0,0.0,0.0
1013,2113,26-09-2019 10:04:00,1,2833.0,2189.0,0.773,13.585,60,4,0,4,56,18,38,0,0.0,0.0
1013,2114,26-09-2019 10:06:00,1,2836.0,2168.0,0.765,13.574,57,0,0,0,57,9,48,0,0.0,0.0
1013,2115,26-09-2019 10:08:00,1,2841.0,2173.0,0.765,13.601,50,0,0,0,50,11,39,0,0.0,0.0
1013,2116,26-09-2019 10:10:00,1,2838.0,2134.0,0.752,13.543,66,12,8,4,54,19,35,3,0.0,0.0
1013,2117,26-09-2019 10:12:00,1,2834.0,2181.0,0.77,13.579,140,31,9,22,109,74,35,0,0.0,0.0
1013,2118,26-09-2019 10:14:00,1,2826.0,2218.0,0.785,13.589,125,32,11,21,93,62,31,2,0.0,0.0
1013,2119,26-09-2019 10:16:00,1,3019.0,2400.0,0.795,14.552,94,32,14,18,62,36,26,0,0.0,0.0
1013,2120,26-09-2019 10:18:00,1,3171.5,2525.5,0.7965,15.2915,78,32,10,22,46,20,26,0,0.0,0.0
1013,2121,26-09-2019 10:20:00,1,3324.0,2651.0,0.798,16.031,194,24,10,14,170,128,42,0,0.0,0.0
1013,2122,26-09-2019 10:22:00,1,3308.0,2674.0,0.808,15.995,197,74,51,23,123,89,34,18,0.0,0.0
1013,2123,26-09-2019 10:24:00,1,3519.0,2837.0,0.806,17.004,289,172,128,44,117,81,36,48,0.0,0.0
1013,2124,26-09-2019 10:26:00,1,3531.0,2804.0,0.794,17.016,186,93,56,37,93,56,37,3,0.0,0.0
1013,2125,26-09-2019 10:28:00,1,3546.0,2745.0,0.774,17.011,232,140,113,27,92,59,33,0,0.0,0.0
1013,2126,26-09-2019 10:30:00,1,3419.0,2665.0,0.779,16.421,45,25,1,24,20,2,18,0,0.0,0.0
1013,2127,26-09-2019 10:32:00,1,3326.0,2651.0,0.797,16.042,46,22,0,22,24,3,21,0,0.0,0.0
1013,2128,26-09-2019 10:34:00,1,3203.0,2585.0,0.807,15.483,52,2,0,2,50,14,36,0,0.0,0.0
1013,2129,26-09-2019 10:36:00,1,3127.0,2440.0,0.78,15.023,7,0,0,0,7,1,6,0,0.0,0.0
1013,2130,26-09-2019 10:38:00,1,3042.0,2294.0,0.754,14.526,6,0,0,0,6,0,6,0,0.0,0.0
1013,2131,26-09-2019 10:40:00,1,2837.0,2162.0,0.762,13.571,2,0,0,0,2,0,2,0,0.0,0.0
1013,2132,26-09-2019 10:42:00,1,2627.0,2064.0,0.786,12.637,4,0,0,0,4,0,4,0,0.0,0.0
1013,2133,26-09-2019 10:44:00,1,2522.0,1995.0,0.791,12.145,14,0,0,0,14,7,7,0,0.0,0.0
1013,2134,26-09-2019 10:46:00,1,2512.0,1984.0,0.79,12.094,7,0,0,0,7,7,0,0,0.0,0.0
1013,2135,26-09-2019 10:48:00,1,2534.0,1958.0,0.772,12.152,10,0,0,0,10,10,0,0,0.0,0.0
1013,2136,26-09-2019 10:50:00,1,2538.0,1936.0,0.763,12.145,0,0,0,0,0,0,0,0,0.0,0.0
1013,2137,26-09-2019 10:52:00,1,2545.5,1908.5,0.75,12.143,11,0,0,0,11,5,6,0,0.0,0.0
1013,2138,26-09-2019 10:54:00,1,2553.0,1881.0,0.737,12.141,9,0,0,0,9,9,0,0,0.0,0.0
1013,2139,26-09-2019 10:56:00,1,2545.0,1878.0,0.738,12.106,14,5,1,4,9,8,1,0,0.0,0.0
1013,2140,26-09-2019 10:58:00,1,2538.0,1929.0,0.76,12.135,63,2,1,1,61,26,35,0,0.0,0.0
1013,2141,26-09-2019 11:00:00,1,2636.0,2003.0,0.76,12.604,22,0,0,0,22,20,2,0,0.0,0.0
1013,2142,26-09-2019 11:02:00,1,2869.0,2063.0,0.719,13.59,138,0,0,0,138,126,12,0,0.0,0.0
1013,2143,26-09-2019 11:04:00,1,2866.0,2052.0,0.716,13.564,33,0,0,0,33,0,33,0,0.0,0.0
1013,2144,26-09-2019 11:06:00,1,2868.0,2067.0,0.721,13.588,26,0,0,0,26,0,26,0,0.0,0.0
1013,2145,26-09-2019 11:08:00,1,2854.0,2075.0,0.727,13.544,33,0,0,0,33,0,33,0,0.0,0.0
1013,2146,26-09-2019 11:10:00,1,2867.0,2076.0,0.724,13.594,12,2,1,1,10,2,8,0,0.0,0.0
1013,2147,26-09-2019 11:12:00,1,2861.0,2083.0,0.728,13.578,1,0,0,0,1,0,1,0,0.0,0.0
1013,2148,26-09-2019 11:14:00,1,2873.0,2043.0,0.711,13.582,7,3,0,3,4,3,1,0,0.0,0.0
1013,2149,26-09-2019 11:16:00,1,2648.0,1977.0,0.747,12.623,3,0,0,0,3,0,3,0,0.0,0.0
1013,2150,26-09-2019 11:18:00,1,2532.0,1933.0,0.763,12.118,34,0,0,0,34,19,15,0,0.0,0.0
1013,2151,26-09-2019 11:20:00,1,2524.0,1913.0,0.758,12.064,30,0,0,0,30,7,23,0,0.0,0.0
1013,2152,26-09-2019 11:22:00,1,2552.0,1857.0,0.728,12.113,23,4,2,2,19,2,17,0,0.0,0.0
1013,2153,26-09-2019 11:24:00,1,2558.0,1829.0,0.715,12.104,36,6,0,6,30,14,16,0,0.0,0.0
1013,2154,26-09-2019 11:26:00,1,2502.0,1820.5,0.728,11.8735,69,0,0,0,69,50,19,0,0.0,0.0
1013,2155,26-09-2019 11:28:00,1,2446.0,1812.0,0.741,11.643,28,2,0,2,26,20,6,0,0.0,0.0
1013,2156,26-09-2019 11:30:00,1,2554.0,1820.0,0.713,12.076,55,16,9,7,39,23,16,0,0.0,0.0
1013,2157,26-09-2019 11:32:00,1,2541.0,1908.0,0.751,12.124,27,0,0,0,27,5,22,0,0.0,0.0
1013,2158,26-09-2019 11:34:00,1,2554.0,1862.0,0.729,12.126,45,11,4,7,34,25,9,0,0.0,0.0
1013,2159,26-09-2019 11:36:00,1,2656.0,1960.0,0.738,12.633,21,0,0,0,21,14,7,0,0.0,0.0
1013,2160,26-09-2019 11:38:00,1,2525.0,1961.0,0.777,12.119,42,1,1,0,41,13,28,0,0.0,0.0
1013,2161,26-09-2019 11:40:00,1,2868.0,2071.0,0.722,13.591,2,1,0,1,1,0,1,0,0.0,0.0
1013,2162,26-09-2019 11:42:00,1,2872.0,2061.0,0.718,13.597,24,3,1,2,21,0,21,0,0.0,0.0
1013,2163,26-09-2019 11:44:00,1,2534.0,1893.0,0.747,12.081,13,0,0,0,13,0,13,0,0.0,0.0
1013,2164,26-09-2019 11:46:00,1,2444.0,1796.0,0.735,11.619,22,1,0,1,21,0,21,0,0.0,0.0
1013,2165,26-09-2019 11:48:00,1,2331.0,1740.0,0.746,11.111,9,1,0,1,8,0,8,0,0.0,0.0
1013,2166,26-09-2019 11:50:00,1,2350.0,1755.0,0.747,11.203,27,0,0,0,27,0,27,0,0.0,0.0
1013,2167,26-09-2019 11:52:00,1,2350.0,1715.0,0.73,11.158,21,0,0,0,21,0,21,0,0.0,0.0
1013,2168,26-09-2019 11:54:00,1,2357.0,1668.0,0.708,11.132,13,0,0,0,13,1,12,0,0.0,0.0
1013,2169,26-09-2019 11:56:00,1,2376.0,1670.0,0.703,11.209,68,4,2,2,64,39,25,0,0.0,0.0
1013,2170,26-09-2019 11:58:00,1,2371.0,1659.0,0.7,11.178,37,0,0,0,37,14,23,0,0.0,0.0
1013,2171,26-09-2019 12:00:00,1,2365.0,1658.5,0.7015,11.1535,33,0,0,0,33,18,15,0,0.0,0.0
1013,2172,26-09-2019 12:02:00,1,2359.0,1658.0,0.703,11.129,16,0,0,0,16,2,14,0,0.0,0.0
1013,2173,26-09-2019 12:04:00,1,2356.0,1693.0,0.718,11.159,26,1,1,0,25,13,12,0,0.0,0.0
1013,2174,26-09-2019 12:06:00,1,2336.0,1729.0,0.74,11.118,27,1,0,1,26,3,23,0,0.0,0.0
1013,2175,26-09-2019 12:08:00,1,2336.0,1784.0,0.764,11.18,19,0,0,0,19,0,19,0,0.0,0.0
1013,2176,26-09-2019 12:10:00,1,2575.0,1803.0,0.7,12.14,17,0,0,0,17,0,17,0,0.0,0.0
1013,2177,26-09-2019 12:12:00,1,2576.0,1821.0,0.707,12.165,18,0,0,0,18,0,18,0,0.0,0.0
1013,2178,26-09-2019 12:14:00,1,2552.0,1818.0,0.712,12.07,33,6,3,3,27,15,12,0,0.0,0.0
1013,2179,26-09-2019 12:16:00,1,2542.0,1921.0,0.756,12.144,25,1,0,1,24,11,13,0,0.0,0.0
1013,2180,26-09-2019 12:18:00,1,2545.0,1925.0,0.756,12.16,26,0,0,0,26,14,12,0,0.0,0.0
1013,2181,26-09-2019 12:20:00,1,2533.0,1900.0,0.75,12.086,34,4,1,3,30,10,20,0,0.0,0.0
1013,2182,26-09-2019 12:22:00,1,2658.0,1999.0,0.752,12.686,198,22,6,16,176,117,59,1,0.0,0.0
1013,2183,26-09-2019 12:24:00,1,2846.0,2108.0,0.741,13.548,159,66,36,30,93,71,22,1,0.0,0.0
1013,2184,26-09-2019 12:26:00,1,3056.0,2215.0,0.725,14.494,192,40,19,21,152,109,43,16,0.0,0.0
1013,2185,26-09-2019 12:28:00,1,3257.0,2475.0,0.76,15.572,265,130,97,33,135,92,43,64,0.0,0.0
1013,2186,26-09-2019 12:30:00,1,3571.0,2645.0,0.741,16.998,142,80,44,36,62,36,26,33,0.0,0.0
1013,2187,26-09-2019 12:32:00,1,3659.0,2793.0,0.763,17.51,208,92,60,32,116,85,31,14,0.03,0.0
1013,2188,26-09-2019 12:34:00,1,3663.0,2762.0,0.754,17.491,215,110,81,29,105,76,29,97,0.0,0.0
1013,2189,26-09-2019 12:36:00,1,3667.0,2731.0,0.745,17.472,366,222,181,41,144,105,39,48,0.0,0.0
1013,2190,26-09-2019 12:38:00,1,3438.0,2607.0,0.758,16.433,281,63,40,23,218,171,47,9,0.0,0.0
1013,2191,26-09-2019 12:40:00,1,3358.0,2518.0,0.75,16.02,69,24,8,16,45,25,20,0,0.0,0.0
1013,2192,26-09-2019 12:42:00,1,3342.0,2511.0,0.751,15.95,138,32,0,32,106,71,35,0,0.0,0.0
1013,2193,26-09-2019 12:44:00,1,3355.0,2534.0,0.755,16.025,128,32,1,31,96,53,43,0,0.0,0.0
1013,2194,26-09-2019 12:46:00,1,3360.0,2550.0,0.759,16.062,101,57,25,32,44,20,24,0,0.0,0.0
1013,2195,26-09-2019 12:48:00,1,3678.0,2698.0,0.734,17.479,100,62,30,32,38,10,28,0,0.0,0.0
1013,2196,26-09-2019 12:50:00,1,3437.0,2625.0,0.764,16.45,22,18,5,13,4,1,3,0,0.0,0.0
1013,2197,26-09-2019 12:52:00,1,3347.0,2575.0,0.769,16.04,7,0,0,0,7,0,7,0,0.0,0.01
1013,2198,26-09-2019 12:54:00,1,3366.0,2476.0,0.736,16.005,9,1,1,0,8,0,8,0,0.0,0.0
1013,2199,26-09-2019 12:56:00,1,3150.0,2416.0,0.767,15.087,5,0,0,0,5,0,5,0,0.0,0.0
1013,2200,26-09-2019 12:58:00,1,3148.0,2347.0,0.745,15.004,4,0,0,0,4,0,4,0,0.0,0.0
1013,2201,26-09-2019 13:00:00,1,3167.0,2323.0,0.733,15.052,6,0,0,0,6,0,6,0,0.0,0.0
1013,2202,26-09-2019 13:02:00,1,3169.0,2288.0,0.722,15.019,17,8,0,8,9,0,9,0,0.0,0.0
1013,2203,26-09-2019 13:04:00,1,3181.0,2252.0,0.708,15.028,32,6,2,4,26,3,23,0,0.0,0.0
1013,2204,26-09-2019 13:06:00,1,3068.0,2228.0,0.726,14.553,17,2,0,2,15,8,7,0,0.0,0.0
1013,2205,26-09-2019 13:08:00,1,3021.0,2188.5,0.7245,14.3265,26,4,2,2,22,11,11,0,0.0,0.0
1013,2206,26-09-2019 13:10:00,1,2974.0,2149.0,0.723,14.1,22,4,1,3,18,3,15,0,0.0,0.0
1013,2207,26-09-2019 13:12:00,1,2966.0,2134.0,0.72,14.05,11,1,0,1,10,2,8,0,0.0,0.0
1013,2208,26-09-2019 13:14:00,1,2966.0,2140.0,0.721,14.055,3,0,0,0,3,0,3,0,0.0,0.0
1013,2209,26-09-2019 13:16:00,1,2967.0,2095.0,0.706,14.012,30,9,4,5,21,11,10,0,0.0,0.0
1013,2210,26-09-2019 13:18:00,1,2984.0,2052.0,0.688,14.028,15,0,0,0,15,8,7,0,0.0,0.0
1013,2211,26-09-2019 13:20:00,1,2882.0,2028.0,0.704,13.599,3,0,0,0,3,0,3,0,0.0,0.0
1013,2212,26-09-2019 13:22:00,1,2873.0,2035.0,0.708,13.575,5,0,0,0,5,0,5,0,0.0,0.0
1013,2213,26-09-2019 13:24:00,1,2982.0,2068.0,0.693,14.04,19,2,0,2,17,5,12,0,0.0,0.0
1013,2214,26-09-2019 13:26:00,1,2974.0,2097.0,0.705,14.039,6,1,0,1,5,3,2,0,0.0,0.0
1013,2215,26-09-2019 13:28:00,1,2966.0,2108.0,0.711,14.022,6,0,0,0,6,0,6,0,0.0,0.0
1013,2216,26-09-2019 13:30:00,1,2977.0,2098.0,0.705,14.053,48,8,3,5,40,17,23,0,0.0,0.0
1013,2217,26-09-2019 13:32:00,1,3201.0,2210.0,0.691,15.058,19,3,0,3,16,7,9,0,0.0,0.0
1013,2218,26-09-2019 13:34:00,1,3199.0,2236.0,0.699,15.082,14,2,0,2,12,6,6,0,0.0,0.0
1013,2219,26-09-2019 13:36:00,1,3077.0,2194.0,0.713,14.554,18,5,3,2,13,5,8,0,0.0,0.0
1013,2220,26-09-2019 13:38:00,1,3074.0,2185.0,0.711,14.532,48,24,14,10,24,15,9,0,0.0,0.0
1013,2221,26-09-2019 13:40:00,1,3183.0,2200.0,0.691,14.979,24,6,3,3,18,10,8,0,0.0,0.0
1013,2222,26-09-2019 13:42:00,1,3070.5,2174.0,0.7085,14.5055,5,0,0,0,5,2,3,0,0.0,0.0
1013,2223,26-09-2019 13:44:00,1,2958.0,2148.0,0.726,14.032,4,1,0,1,3,2,1,0,0.0,0.0
1013,2224,26-09-2019 13:46:00,1,2988.0,2101.0,0.703,14.099,4,0,0,0,4,1,3,0,0.0,0.0
1013,2225,26-09-2019 13:48:00,1,2977.0,2075.0,0.697,14.029,5,0,0,0,5,1,4,0,0.0,0.0
1013,2226,26-09-2019 13:50:00,1,2985.0,2063.0,0.691,14.044,5,0,0,0,5,1,4,0,0.0,0.0
1013,2227,26-09-2019 13:52:00,1,2984.0,2063.0,0.692,14.042,26,8,3,5,18,7,11,0,0.0,0.0
1013,2228,26-09-2019 13:54:00,1,2964.0,2114.0,0.713,14.02,9,0,0,0,9,8,1,0,0.0,0.0
1013,2229,26-09-2019 13:56:00,1,2997.0,2060.0,0.687,14.091,48,9,5,4,39,26,13,0,0.0,0.0
1013,2230,26-09-2019 13:58:00,1,2985.0,2109.0,0.706,14.096,39,0,0,0,39,2,37,0,0.0,0.0
1013,2231,26-09-2019 14:00:00,1,2952.0,2160.0,0.732,14.022,55,0,0,0,55,13,42,0,0.0,0.0
1013,2232,26-09-2019 14:02:00,1,2961.0,2171.0,0.733,14.071,56,0,0,0,56,28,28,0,0.0,0.0
1013,2233,26-09-2019 14:04:00,1,2967.0,2133.0,0.719,14.054,50,0,0,0,50,20,30,0,0.0,0.0
1013,2234,26-09-2019 14:06:00,1,2965.0,2154.0,0.727,14.069,17,0,0,0,17,0,17,0,0.0,0.0
1013,2235,26-09-2019 14:08:00,1,2960.0,2174.0,0.734,14.07,14,0,0,0,14,3,11,0,0.0,0.0
1013,2236,26-09-2019 14:10:00,1,2966.0,2157.0,0.727,14.075,17,0,0,0,17,5,12,0,0.0,0.0
1013,2237,26-09-2019 14:12:00,1,2968.0,2137.0,0.72,14.061,9,0,0,0,9,1,8,0,0.0,0.0
1013,2238,26-09-2019 14:14:00,1,2980.0,2095.0,0.703,14.062,80,6,1,5,74,54,20,0,0.0,0.0
1013,2239,26-09-2019 14:16:00,1,2981.5,2090.0,0.701,14.061,114,3,0,3,111,93,18,0,0.0,0.0
1013,2240,26-09-2019 14:18:00,1,2983.0,2085.0,0.699,14.06,34,3,1,2,31,9,22,0,0.0,0.0
1013,2241,26-09-2019 14:20:00,1,2987.0,2085.0,0.698,14.076,7,4,1,3,3,0,3,0,0.0,0.0
1013,2242,26-09-2019 14:22:00,1,2877.0,2040.0,0.709,13.594,17,1,0,1,16,0,16,0,0.0,0.0
1013,2243,26-09-2019 14:24:00,1,2630.0,1967.0,0.748,12.54,36,0,0,0,36,0,36,0,0.0,0.0
1013,2244,26-09-2019 14:26:00,1,2652.0,1931.0,0.728,12.588,39,0,0,0,39,9,30,0,0.0,0.0
1013,2245,26-09-2019 14:28:00,1,2664.0,1930.0,0.724,12.633,17,0,0,0,17,0,17,0,0.0,0.0
1013,2246,26-09-2019 14:30:00,1,2676.0,1911.0,0.714,12.659,165,48,21,27,117,76,41,0,0.0,0.0
1013,2247,26-09-2019 14:32:00,1,2758.0,2027.0,0.735,13.11,184,24,7,17,160,97,63,1,0.0,0.0
1013,2248,26-09-2019 14:34:00,1,2970.0,2118.0,0.713,14.048,104,23,12,11,81,47,34,0,0.0,0.0
1013,2249,26-09-2019 14:36:00,1,3168.0,2286.0,0.722,15.012,122,56,30,26,66,38,28,0,0.0,0.0
1013,2250,26-09-2019 14:38:00,1,3188.0,2320.0,0.728,15.129,107,31,16,15,76,38,38,0,0.0,0.0
1013,2251,26-09-2019 14:40:00,1,3146.0,2367.0,0.752,15.015,117,21,8,13,96,59,37,0,0.0,0.0
1013,2252,26-09-2019 14:42:00,1,3136.0,2416.0,0.77,15.029,177,32,11,21,145,91,54,0,0.0,0.0
1013,2253,26-09-2019 14:44:00,1,3135.0,2430.0,0.775,15.042,194,97,67,30,97,53,44,43,0.0,0.0
1013,2254,26-09-2019 14:46:00,1,3319.0,2600.0,0.783,15.955,115,45,23,22,70,36,34,43,0.0,0.0
1013,2255,26-09-2019 14:48:00,1,3965.0,3010.0,0.759,18.954,119,32,13,19,87,25,62,26,0.0,0.05
1013,2256,26-09-2019 14:50:00,1,3669.5,2739.0,0.745,17.491,316,169,122,47,147,109,38,27,0.0,0.01
1013,2257,26-09-2019 14:52:00,1,3374.0,2468.0,0.731,16.028,594,318,244,74,276,202,74,7,0.0,0.0
1013,2258,26-09-2019 14:54:00,1,3322.0,2594.0,0.781,15.96,523,299,221,78,224,164,60,35,0.0,0.04
1013,2259,26-09-2019 14:56:00,1,3371.0,2437.0,0.723,15.981,805,438,364,74,367,289,78,7,0.0,0.0
1013,2260,26-09-2019 14:58:00,1,3652.0,2759.0,0.755,17.446,837,511,425,86,326,235,91,14,0.0,0.0
1013,2261,26-09-2019 15:00:00,1,3657.0,2720.0,0.744,17.419,263,139,100,39,124,84,40,6,0.0,0.0
1013,2262,26-09-2019 15:02:00,1,3563.0,2721.0,0.764,17.051,180,36,11,25,144,104,40,1,0.0,0.0
1013,2263,26-09-2019 15:04:00,1,3437.0,2685.0,0.781,16.515,223,13,0,13,210,161,49,0,0.0,0.0
1013,2264,26-09-2019 15:06:00,1,3545.0,2728.0,0.77,16.988,147,22,4,18,125,83,42,1,0.0,0.0
1013,2265,26-09-2019 15:08:00,1,3643.0,2817.0,0.773,17.472,136,44,27,17,92,65,27,0,0.0,0.0
1013,2266,26-09-2019 15:10:00,1,3523.0,2783.0,0.79,16.961,8,1,0,1,7,5,2,0,0.0,0.0
1013,2267,26-09-2019 15:12:00,1,3324.0,2664.0,0.801,16.048,40,5,1,4,35,6,29,0,0.0,0.0
1013,2268,26-09-2019 15:14:00,1,3225.0,2550.0,0.791,15.529,37,0,0,0,37,5,32,0,0.0,0.0
1013,2269,26-09-2019 15:16:00,1,3140.0,2421.0,0.771,15.053,41,4,2,2,37,24,13,0,0.0,0.0
1013,2270,26-09-2019 15:18:00,1,2916.0,2308.0,0.792,14.043,5,2,0,2,3,1,2,0,0.0,0.0
1013,2271,26-09-2019 15:20:00,1,2940.0,2261.0,0.769,14.086,18,0,0,0,18,7,11,0,0.0,0.0
1013,2272,26-09-2019 15:22:00,1,2937.0,2258.0,0.769,14.074,25,0,0,0,25,5,20,0,0.0,0.0
1013,2273,26-09-2019 15:24:00,1,2980.5,2283.5,0.7665,14.2735,69,1,0,1,68,36,32,0,0.0,0.0
1013,2274,26-09-2019 15:26:00,1,3024.0,2309.0,0.764,14.473,41,4,2,2,37,24,13,0,0.0,0.0
1013,2275,26-09-2019 15:28:00,1,3051.0,2323.0,0.761,14.593,13,1,0,1,12,8,4,0,0.0,0.0
1013,2276,26-09-2019 15:30:00,1,2912.0,2297.0,0.789,14.017,4,0,0,0,4,4,0,0,0.0,0.0
1013,2277,26-09-2019 15:32:00,1,2924.0,2306.0,0.789,14.072,43,1,0,1,42,20,22,0,0.0,0.0
1013,2278,26-09-2019 15:34:00,1,2927.0,2262.0,0.773,14.039,31,1,0,1,30,7,23,0,0.0,0.0
1013,2279,26-09-2019 15:36:00,1,2957.0,2176.0,0.736,14.059,20,1,0,1,19,2,17,0,0.0,0.0
1013,2280,26-09-2019 15:38:00,1,2834.0,2131.0,0.752,13.527,23,13,3,10,10,3,7,0,0.0,0.0
1013,2281,26-09-2019 15:40:00,1,2857.0,2163.0,0.757,13.65,23,11,0,11,12,5,7,0,0.0,0.0
1013,2282,26-09-2019 15:42:00,1,2732.0,2103.0,0.77,13.091,6,0,0,0,6,2,4,0,0.0,0.0
1013,2283,26-09-2019 15:44:00,1,2849.0,2121.0,0.745,13.572,14,1,0,1,13,8,5,0,0.0,0.0
1013,2284,26-09-2019 15:46:00,1,2951.0,2169.0,0.735,14.031,21,5,1,4,16,6,10,0,0.0,0.0
1013,2285,26-09-2019 15:48:00,1,2969.0,2157.0,0.727,14.087,3,2,1,1,1,0,1,0,0.0,0.0
1013,2286,26-09-2019 15:50:00,1,2968.0,2146.0,0.723,14.07,43,9,5,4,34,11,23,0,0.0,0.0
1013,2287,26-09-2019 15:52:00,1,2963.0,2185.0,0.737,14.095,37,16,0,16,21,9,12,0,0.0,0.0
1013,2288,26-09-2019 15:54:00,1,2746.0,2077.0,0.756,13.119,25,1,0,1,24,9,15,0,0.0,0.0
1013,2289,26-09-2019 15:56:00,1,2626.0,2064.0,0.786,12.633,25,0,0,0,25,2,23,0,0.0,0.0
1013,2290,26-09-2019 15:58:00,1,2793.0,2134.0,0.7655,13.3675,9,2,1,1,7,5,2,0,0.0,0.0
1013,2291,26-09-2019 16:00:00,1,2960.0,2204.0,0.745,14.102,4,0,0,0,4,1,3,0,0.0,0.0
1013,2292,26-09-2019 16:02:00,1,2943.0,2249.0,0.764,14.085,1,0,0,0,1,0,1,0,0.0,0.0
1013,2293,26-09-2019 16:04:00,1,2948.0,2259.0,0.766,14.115,1,0,0,0,1,0,1,0,0.0,0.0
1013,2294,26-09-2019 16:06:00,1,2937.0,2240.0,0.763,14.051,85,36,32,4,49,38,11,2,0.0,0.0
1013,2295,26-09-2019 16:08:00,1,2942.0,2257.0,0.767,14.093,9,0,0,0,9,4,5,0,0.0,0.0
1013,2296,26-09-2019 16:10:00,1,2946.0,2182.0,0.741,14.025,1,0,0,0,1,0,1,0,0.0,0.0
1013,2297,26-09-2019 16:12:00,1,2967.0,2141.0,0.721,14.06,2,0,0,0,2,2,0,0,0.0,0.0
1013,2298,26-09-2019 16:14:00,1,2974.0,2137.0,0.718,14.084,14,2,0,2,12,3,9,0,0.0,0.0
1013,2299,26-09-2019 16:16:00,1,2953.0,2187.0,0.741,14.056,33,1,0,1,32,6,26,0,0.0,0.0
1013,2300,26-09-2019 16:18:00,1,2936.0,2252.0,0.767,14.062,53,8,4,4,45,32,13,0,0.0,0.0
1013,2301,26-09-2019 16:20:00,1,3149.0,2358.0,0.749,15.019,174,43,28,15,131,87,44,0,0.0,0.0
1013,2302,26-09-2019 16:22:00,1,3344.0,2559.0,0.765,16.011,48,17,0,17,31,10,21,0,0.0,0.0
1013,2303,26-09-2019 16:24:00,1,3353.0,2553.0,0.761,16.037,121,70,35,35,51,25,26,0,0.0,0.0
1013,2304,26-09-2019 16:26:00,1,3321.0,2612.0,0.787,15.979,40,12,3,9,28,10,18,0,0.0,0.0
1013,2305,26-09-2019 16:28:00,1,3322.0,2604.0,0.784,15.973,100,40,13,27,60,31,29,0,0.0,0.0
1013,2306,26-09-2019 16:30:00,1,3338.0,2554.0,0.765,15.98,175,45,10,35,130,86,44,1,0.0,0.0
1013,2307,26-09-2019 16:32:00,1,3485.0,2696.5,0.7735,16.717,154,60,34,26,94,48,46,30,0.0,0.0
1013,2308,26-09-2019 16:34:00,1,3632.0,2839.0,0.782,17.454,77,16,7,9,61,14,47,36,0.0,0.0
1013,2309,26-09-2019 16:36:00,1,3635.0,2840.0,0.781,17.467,232,86,62,24,146,92,54,38,0.0,0.01
1013,2310,26-09-2019 16:38:00,1,3821.0,3055.0,0.799,18.438,533,279,223,56,254,185,69,20,0.0,0.03
1013,2311,26-09-2019 16:40:00,1,3323.0,2659.0,0.8,16.039,521,268,208,60,253,198,55,20,0.06,0.0
1013,2312,26-09-2019 16:42:00,1,3651.0,2788.0,0.764,17.473,491,249,193,56,242,182,60,17,0.0,0.01
1013,2313,26-09-2019 16:44:00,1,3337.0,2609.0,0.782,16.038,135,66,38,28,69,41,28,0,0.0,0.0
1013,2314,26-09-2019 16:46:00,1,3331.0,2602.0,0.781,16.004,18,2,0,2,16,5,11,0,0.0,0.0
1013,2315,26-09-2019 16:48:00,1,3126.0,2490.0,0.796,15.072,10,0,0,0,10,0,10,0,0.0,0.0
1013,2316,26-09-2019 16:50:00,1,3148.0,2409.0,0.765,15.069,18,8,1,7,10,2,8,0,0.0,0.0
1013,2317,26-09-2019 16:52:00,1,3147.0,2371.0,0.753,15.026,7,0,0,0,7,0,7,0,0.01,0.0
1013,2318,26-09-2019 16:54:00,1,3032.0,2359.0,0.778,14.56,8,4,1,3,4,2,2,0,0.0,0.0
1013,2319,26-09-2019 16:56:00,1,3025.0,2378.0,0.786,14.552,2,0,0,0,2,0,2,0,0.0,0.0
1013,2320,26-09-2019 16:58:00,1,2911.0,2332.0,0.801,14.05,8,1,0,1,7,0,7,0,0.0,0.0
1013,2321,26-09-2019 17:00:00,1,3023.0,2372.0,0.785,14.538,7,0,0,0,7,0,7,0,0.0,0.0
1013,2322,26-09-2019 17:02:00,1,3148.0,2409.0,0.765,15.073,8,1,0,1,7,0,7,0,0.0,0.0
1013,2323,26-09-2019 17:04:00,1,3128.0,2431.0,0.777,15.016,6,0,0,0,6,0,6,0,0.0,0.0
1013,2324,26-09-2019 17:06:00,1,3080.5,2415.5,0.784,14.8115,12,0,0,0,12,0,12,0,0.0,0.0
1013,2325,26-09-2019 17:08:00,1,3033.0,2400.0,0.791,14.607,11,1,0,1,10,3,7,0,0.0,0.0
1013,2326,26-09-2019 17:10:00,1,3122.0,2444.0,0.783,15.007,16,0,0,0,16,6,10,0,0.0,0.0
1013,2327,26-09-2019 17:12:00,1,3142.0,2410.0,0.767,15.049,26,7,4,3,19,11,8,0,0.01,0.0
1013,2328,26-09-2019 17:14:00,1,3122.0,2478.0,0.794,15.044,40,17,1,16,23,8,15,0,0.0,0.0
1013,2329,26-09-2019 17:16:00,1,3116.0,2462.0,0.79,15.002,79,16,4,12,63,39,24,0,0.0,0.0
1013,2330,26-09-2019 17:18:00,1,3111.0,2537.0,0.816,15.066,74,38,4,34,36,16,20,0,0.0,0.0
1013,2331,26-09-2019 17:20:00,1,3209.0,2608.0,0.813,15.532,81,39,19,20,42,24,18,0,0.0,0.0
1013,2332,26-09-2019 17:22:00,1,3303.0,2686.0,0.813,15.988,47,15,2,13,32,16,16,0,0.0,0.0
1013,2333,26-09-2019 17:24:00,1,3211.0,2576.0,0.802,15.505,11,5,1,4,6,1,5,0,0.0,0.0
1013,2334,26-09-2019 17:26:00,1,3127.0,2441.0,0.78,15.024,14,3,0,3,11,0,11,0,0.0,0.0
1013,2335,26-09-2019 17:28:00,1,3142.0,2416.0,0.769,15.053,17,9,0,9,8,0,8,0,0.0,0.0
1013,2336,26-09-2019 17:30:00,1,3041.0,2369.0,0.779,14.603,12,5,0,5,7,0,7,0,0.0,0.0
1013,2337,26-09-2019 17:32:00,1,3050.0,2324.0,0.762,14.591,14,5,0,5,9,0,9,0,0.0,0.0
1013,2338,26-09-2019 17:34:00,1,3163.0,2360.0,0.746,15.075,5,0,0,0,5,0,5,0,0.0,0.0
1013,2339,26-09-2019 17:36:00,1,3169.0,2283.0,0.72,15.013,152,51,31,20,101,60,41,23,0.0,0.0
1013,2340,26-09-2019 17:38:00,1,3875.0,2908.0,0.751,18.486,146,14,6,8,132,67,65,17,0.0,0.04
1013,2341,26-09-2019 17:40:00,1,3803.0,2914.5,0.767,18.2095,266,128,92,36,138,82,56,30,0.0,0.06
1013,2342,26-09-2019 17:42:00,1,3731.0,2921.0,0.783,17.933,121,28,7,21,93,46,47,29,0.0,0.0
1013,2343,26-09-2019 17:44:00,1,3907.0,3205.0,0.82,18.942,170,69,52,17,101,54,47,71,0.07,0.02
1013,2344,26-09-2019 17:46:00,1,3708.0,3078.0,0.83,18.019,108,41,27,14,67,31,36,20,0.0,0.01
1013,2345,26-09-2019 17:48:00,1,3187.0,2713.0,0.851,15.562,81,26,6,20,55,25,30,0,0.0,0.01
1013,2346,26-09-2019 17:50:00,1,3187.0,2672.0,0.838,15.516,12,8,3,5,4,3,1,0,0.0,0.0
1013,2347,26-09-2019 17:52:00,1,3404.0,2786.0,0.819,16.496,10,5,4,1,5,2,3,0,0.0,0.0
1013,2348,26-09-2019 17:54:00,1,3174.0,2778.0,0.875,15.582,17,5,4,1,12,2,10,0,0.0,0.0
1013,2349,26-09-2019 17:56:00,1,3175.0,2788.0,0.878,15.595,29,13,9,4,16,6,10,0,0.0,0.0
1013,2350,26-09-2019 17:58:00,1,3187.0,2750.0,0.863,15.602,21,15,6,9,6,2,4,0,0.0,0.0
1013,2351,26-09-2019 18:00:00,0,3165.0,2797.0,0.884,15.568,64,41,27,14,23,13,10,10,0.0,0.0
1013,2352,26-09-2019 18:02:00,0,3738.0,3362.0,0.899,18.45,398,259,206,53,139,108,31,21,0.0,0.0
1013,2353,26-09-2019 18:04:00,0,3811.0,3543.0,0.93,18.937,352,259,195,64,93,66,27,97,0.0,0.0
1013,2354,26-09-2019 18:06:00,0,3822.0,3548.0,0.928,18.986,259,166,118,48,93,58,35,46,0.01,0.0
1013,2355,26-09-2019 18:08:00,0,3831.0,3474.0,0.907,18.938,192,67,37,30,125,80,45,7,0.0,0.0
1013,2356,26-09-2019 18:10:00,0,3836.0,3483.0,0.908,18.97,154,79,36,43,75,45,30,0,0.0,0.0
1013,2357,26-09-2019 18:12:00,0,3809.0,3544.0,0.93,18.932,117,51,23,28,66,32,34,1,0.0,0.0
1013,2358,26-09-2019 18:14:00,0,3965.5,3643.0,0.919,19.6575,295,164,121,43,131,96,35,38,0.0,0.0
1013,2359,26-09-2019 18:16:00,0,4122.0,3742.0,0.908,20.383,540,324,254,70,216,168,48,76,0.06,0.0
1013,2360,26-09-2019 18:18:00,0,4149.0,3677.0,0.886,20.417,290,141,98,43,149,115,34,43,0.0,0.0
1013,2361,26-09-2019 18:20:00,0,3827.0,3533.0,0.923,18.991,398,214,161,53,184,147,37,62,0.0,0.0
1013,2362,26-09-2019 18:22:00,0,3937.0,3567.0,0.906,19.462,199,108,67,41,91,58,33,22,0.0,0.0
1013,2363,26-09-2019 18:24:00,0,3840.0,3467.0,0.903,18.968,223,107,89,18,116,87,29,32,0.0,0.0
1013,2364,26-09-2019 18:26:00,0,3952.0,3523.0,0.892,19.47,302,192,140,52,110,79,31,36,0.0,0.0
1013,2365,26-09-2019 18:28:00,0,4182.0,3562.0,0.852,20.422,451,289,221,68,162,121,41,26,0.0,0.0
1013,2366,26-09-2019 18:30:00,0,4069.0,3492.0,0.858,19.899,177,123,77,46,54,25,29,8,0.0,0.0
1013,2367,26-09-2019 18:32:00,0,3860.0,3362.0,0.871,18.93,634,365,295,70,269,211,58,95,0.0,0.0
1013,2368,26-09-2019 18:34:00,0,3868.0,3312.0,0.856,18.906,107,63,32,31,44,22,22,0,0.0,0.0
1013,2369,26-09-2019 18:36:00,0,3891.0,3285.0,0.844,18.967,121,77,49,28,44,28,16,10,0.0,0.0
1013,2370,26-09-2019 18:38:00,0,4289.0,3511.0,0.819,20.787,245,153,110,43,92,66,26,20,0.0,0.0
1013,2371,26-09-2019 18:40:00,0,3494.0,2951.0,0.845,17.032,201,159,101,58,42,25,17,12,0.0,0.0
1013,2372,26-09-2019 18:42:00,0,3889.0,3258.0,0.838,18.928,377,272,212,60,105,75,30,22,0.0,0.0
1013,2373,26-09-2019 18:44:00,0,3807.0,3132.0,0.823,18.467,457,266,210,56,191,154,37,71,0.0,0.0
1013,2374,26-09-2019 18:46:00,0,3700.0,3042.0,0.822,17.948,74,35,14,21,39,20,19,3,0.0,0.0
1013,2375,26-09-2019 18:48:00,0,3764.5,3055.5,0.812,18.2165,156,71,38,33,85,60,25,2,0.0,0.0
1013,2376,26-09-2019 18:50:00,0,3829.0,3069.0,0.802,18.485,364,250,201,49,114,82,32,26,0.0,0.0
1013,2377,26-09-2019 18:52:00,0,3820.0,3107.0,0.813,18.49,423,222,163,59,201,146,55,45,0.0,0.0
1013,2378,26-09-2019 18:54:00,0,3809.0,3080.0,0.809,18.416,374,284,254,30,90,56,34,13,0.0,0.0
1013,2379,26-09-2019 18:56:00,0,3628.0,2816.0,0.776,17.414,370,267,236,31,103,63,40,16,0.0,0.0
1013,2380,26-09-2019 18:58:00,0,3649.0,2822.0,0.773,17.503,107,62,57,5,45,22,23,0,0.0,0.0
1013,2381,26-09-2019 19:00:00,0,3433.0,2700.0,0.786,16.518,265,197,176,21,68,30,38,0,0.0,0.0
1013,2382,26-09-2019 19:02:00,0,3861.0,2981.0,0.772,18.514,335,285,238,47,50,33,17,8,0.0,0.0
1013,2383,26-09-2019 19:04:00,0,4056.0,3101.0,0.764,19.416,471,340,272,68,131,97,34,73,0.0,0.0
1013,2384,26-09-2019 19:06:00,0,3838.0,3004.0,0.783,18.449,521,293,229,64,228,181,47,31,0.02,0.0
1013,2385,26-09-2019 19:08:00,0,4032.0,3157.0,0.783,19.383,489,289,215,74,200,140,60,28,0.0,0.0
1013,2386,26-09-2019 19:10:00,0,3840.0,2941.0,0.766,18.385,180,106,62,44,74,42,32,1,0.0,0.0
1013,2387,26-09-2019 19:12:00,0,3847.0,2998.0,0.779,18.475,77,41,25,16,36,23,13,0,0.0,0.0
1013,2388,26-09-2019 19:14:00,0,3639.0,2822.0,0.775,17.463,12,5,3,2,7,2,5,0,0.0,0.0
1013,2389,26-09-2019 19:16:00,0,3561.0,2686.0,0.754,17.004,23,16,6,10,7,2,5,0,0.01,0.0
1013,2390,26-09-2019 19:18:00,0,3329.0,2556.0,0.768,15.948,23,17,6,11,6,0,6,0,0.0,0.0
1013,2391,26-09-2019 19:20:00,0,3259.0,2412.0,0.74,15.511,17,8,5,3,9,2,7,0,0.0,0.0
1013,2392,26-09-2019 19:22:00,0,3118.5,2282.0,0.7315,14.8135,17,11,6,5,6,0,6,0,0.0,0.0
1013,2393,26-09-2019 19:24:00,0,2978.0,2152.0,0.723,14.116,14,10,2,8,4,0,4,0,0.0,0.0
1013,2394,26-09-2019 19:26:00,0,2848.0,2060.0,0.723,13.504,14,8,2,6,6,0,6,0,0.0,0.0
1013,2395,26-09-2019 19:28:00,0,2636.0,2013.0,0.764,12.613,24,17,0,17,7,0,7,0,0.0,0.0
1013,2396,26-09-2019 19:30:00,0,2644.0,1980.0,0.749,12.608,3,2,1,1,1,0,1,0,0.0,0.0
1013,2397,26-09-2019 19:32:00,0,2761.0,2017.0,0.73,13.112,432,279,208,71,153,113,40,37,0.0,0.0
1013,2398,26-09-2019 19:34:00,0,3389.0,2424.0,0.715,16.038,145,82,54,28,63,41,22,0,0.0,0.0
1013,2399,26-09-2019 19:36:00,0,3455.0,2565.0,0.742,16.455,139,110,68,42,29,14,15,13,0.0,0.0
1013,2400,26-09-2019 19:38:00,0,3148.0,2377.0,0.755,15.034,341,210,165,45,131,90,41,38,0.03,0.0
1013,2401,26-09-2019 19:40:00,0,3690.0,2652.0,0.719,17.477,350,236,212,24,114,75,39,34,0.0,0.0
1013,2402,26-09-2019 19:42:00,0,3766.0,2798.0,0.743,17.936,589,417,335,82,172,136,36,43,0.0,0.0
1013,2403,26-09-2019 19:44:00,0,3974.0,2910.0,0.732,18.88,326,179,141,38,147,104,43,19,0.0,0.0
1013,2404,26-09-2019 19:46:00,0,3866.0,2877.0,0.744,18.42,550,385,298,87,165,130,35,55,0.0,0.0
1013,2405,26-09-2019 19:48:00,0,3875.0,2841.0,0.733,18.413,381,238,191,47,143,106,37,96,0.0,0.0
1013,2406,26-09-2019 19:50:00,0,3885.0,2843.0,0.732,18.454,459,271,209,62,188,139,49,140,0.0,0.0
1013,2407,26-09-2019 19:52:00,0,4085.0,2943.0,0.721,19.354,380,243,185,58,137,108,29,26,0.0,0.0
1013,2408,26-09-2019 19:54:00,0,4175.0,3123.0,0.748,19.908,347,254,188,66,93,71,22,45,0.0,0.0
1013,2409,26-09-2019 19:56:00,0,4129.5,3069.5,0.7435,19.6695,145,65,43,22,80,46,34,2,0.0,0.0
1013,2410,26-09-2019 19:58:00,0,4084.0,3016.0,0.739,19.431,404,286,230,56,118,83,35,20,0.0,0.0
1013,2411,26-09-2019 20:00:00,0,3886.0,2798.0,0.72,18.409,247,181,118,63,66,44,22,56,0.0,0.0
1013,2412,26-09-2019 20:02:00,0,3885.0,2784.0,0.717,18.391,399,206,164,42,193,138,55,74,0.03,0.0
1013,2413,26-09-2019 20:04:00,0,3785.0,2733.0,0.722,17.939,379,152,111,41,227,166,61,29,0.0,0.0
1013,2414,26-09-2019 20:06:00,0,4095.0,2955.0,0.722,19.406,340,233,176,57,107,81,26,81,0.0,0.0
1013,2415,26-09-2019 20:08:00,0,4084.0,3009.0,0.737,19.421,428,266,204,62,162,120,42,56,0.0,0.0
1013,2416,26-09-2019 20:10:00,0,3880.0,2854.0,0.736,18.447,134,100,67,33,34,17,17,16,0.0,0.0
1013,2417,26-09-2019 20:12:00,0,3891.0,2813.0,0.723,18.445,490,280,215,65,210,152,58,76,0.0,0.0
1013,2418,26-09-2019 20:14:00,0,4085.0,2958.0,0.724,19.371,402,264,202,62,138,100,38,95,0.0,0.0
1013,2419,26-09-2019 20:16:00,0,4080.0,2956.0,0.724,19.351,159,86,55,31,73,57,16,41,0.0,0.0
1013,2420,26-09-2019 20:18:00,0,3698.0,2571.0,0.695,17.416,469,282,224,58,187,132,55,53,0.0,0.0
1013,2421,26-09-2019 20:20:00,0,4109.0,2890.0,0.703,19.392,333,177,126,51,156,111,45,53,0.1,0.0
1013,2422,26-09-2019 20:22:00,0,4086.0,2936.0,0.719,19.352,325,183,135,48,142,114,28,15,0.0,0.0
1013,2423,26-09-2019 20:24:00,0,3901.0,2738.0,0.702,18.402,70,47,24,23,23,4,19,1,0.0,0.0
1013,2424,26-09-2019 20:26:00,0,3898.0,2736.0,0.702,18.388,432,248,192,56,184,152,32,84,0.0,0.0
1013,2425,26-09-2019 20:28:00,0,4103.0,2886.0,0.703,19.362,418,268,223,45,150,96,54,71,0.0,0.0
1013,2426,26-09-2019 20:30:00,0,3994.0,2843.5,0.712,18.886,516,334,270,64,182,132,50,45,0.0,0.0
1013,2427,26-09-2019 20:32:00,0,3885.0,2801.0,0.721,18.41,174,98,59,39,76,50,26,20,0.0,0.0
1013,2428,26-09-2019 20:34:00,0,3907.0,2775.0,0.71,18.467,357,221,167,54,136,92,44,12,0.0,0.0
1013,2429,26-09-2019 20:36:00,0,3991.0,2872.0,0.72,18.905,362,197,141,56,165,108,57,16,0.0,0.0
1013,2430,26-09-2019 20:38:00,0,4101.0,2882.0,0.703,19.35,592,445,360,85,147,106,41,25,0.0,0.0
1013,2431,26-09-2019 20:40:00,0,4109.0,2923.0,0.711,19.426,146,76,47,29,70,49,21,10,0.0,0.0
1013,2432,26-09-2019 20:42:00,0,3909.0,2711.0,0.694,18.402,430,339,272,67,91,62,29,66,0.0,0.0
1013,2433,26-09-2019 20:44:00,0,3911.0,2803.0,0.717,18.514,256,133,98,35,123,85,38,9,0.0,0.0
1013,2434,26-09-2019 20:46:00,0,3913.0,2776.0,0.709,18.492,330,206,169,37,124,90,34,22,0.0,0.0
1013,2435,26-09-2019 20:48:00,0,3668.0,2668.0,0.727,17.407,129,101,68,33,28,15,13,41,0.0,0.0
1013,2436,26-09-2019 20:50:00,0,3688.0,2605.0,0.706,17.417,291,184,137,47,107,81,26,43,0.0,0.0
1013,2437,26-09-2019 20:52:00,0,3989.0,2838.0,0.711,18.858,498,344,265,79,154,121,33,70,0.0,0.0
1013,2438,26-09-2019 20:54:00,0,3684.0,2666.0,0.724,17.467,498,349,278,71,149,116,33,81,0.0,0.0
1013,2439,26-09-2019 20:56:00,0,4135.0,2833.0,0.685,19.43,395,244,177,67,151,111,40,25,0.04,0.0
1013,2440,26-09-2019 20:58:00,0,3671.0,2634.0,0.717,17.381,266,171,118,53,95,74,21,37,0.01,0.0
1013,2441,26-09-2019 21:00:00,0,3706.0,2597.0,0.701,17.476,177,126,82,44,51,23,28,6,0.0,0.0
1013,2442,26-09-2019 21:02:00,0,3916.0,2667.0,0.681,18.382,306,223,181,42,83,59,24,34,0.0,0.0
1013,2443,26-09-2019 21:04:00,0,3911.5,2713.5,0.6935,18.417,465,257,203,54,208,152,56,106,0.03,0.0
1013,2444,26-09-2019 21:06:00,0,3907.0,2760.0,0.706,18.452,479,313,255,58,166,128,38,97,0.0,0.0
1013,2445,26-09-2019 21:08:00,0,4000.0,2816.0,0.704,18.88,508,328,268,60,180,139,41,77,0.0,0.0
1013,2446,26-09-2019 21:10:00,0,3919.0,2721.0,0.694,18.452,265,78,47,31,187,133,54,33,0.0,0.0
1013,2447,26-09-2019 21:12:00,0,3868.0,2762.0,0.714,18.301,453,265,198,67,188,135,53,26,0.0,0.0
1013,2448,26-09-2019 21:14:00,0,4323.0,3025.0,0.7,20.381,485,271,199,72,214,165,49,112,0.02,0.0
1013,2449,26-09-2019 21:16:00,0,3896.0,2767.0,0.71,18.415,187,132,92,40,55,23,32,29,0.0,0.0
1013,2450,26-09-2019 21:18:00,0,3879.0,2801.0,0.722,18.385,233,143,103,40,90,59,31,51,0.0,0.0
1013,2451,26-09-2019 21:20:00,0,3905.0,2735.0,0.7,18.416,158,103,60,43,55,43,12,10,0.0,0.0
1013,2452,26-09-2019 21:22:00,0,3895.0,2766.0,0.71,18.411,651,352,282,70,299,239,60,109,0.0,0.0
1013,2453,26-09-2019 21:24:00,0,3896.0,2768.0,0.711,18.414,102,56,26,30,46,36,10,33,0.0,0.0
1013,2454,26-09-2019 21:26:00,0,3908.0,2701.0,0.691,18.387,344,191,144,47,153,114,39,49,0.0,0.0
1013,2455,26-09-2019 21:28:00,0,3811.0,2647.0,0.694,17.948,457,288,211,77,169,125,44,18,0.0,0.0
1013,2456,26-09-2019 21:30:00,0,4120.0,2832.0,0.687,19.367,298,171,124,47,127,91,36,63,0.02,0.0
1013,2457,26-09-2019 21:32:00,0,3939.0,2677.0,0.68,18.483,174,140,95,45,34,17,17,3,0.0,0.0
1013,2458,26-09-2019 21:34:00,0,3923.0,2709.0,0.691,18.457,191,141,89,52,50,33,17,5,0.0,0.0
1013,2459,26-09-2019 21:36:00,0,4127.0,2899.0,0.702,19.471,762,594,475,119,168,122,46,62,0.0,0.0
1013,2460,26-09-2019 21:38:00,0,4119.5,2849.0,0.6915,19.386,166,123,73,50,43,26,17,33,0.0,0.0
1013,2461,26-09-2019 21:40:00,0,4112.0,2799.0,0.681,19.301,343,248,190,58,95,70,25,55,0.0,0.0
1013,2462,26-09-2019 21:42:00,0,3818.0,2647.0,0.693,17.976,165,120,82,38,45,36,9,35,0.0,0.0
1013,2463,26-09-2019 21:44:00,0,3895.0,2756.0,0.708,18.396,354,218,163,55,136,96,40,43,0.0,0.0
1013,2464,26-09-2019 21:46:00,0,3926.0,2705.0,0.689,18.465,533,411,336,75,122,84,38,40,0.09,0.0
1013,2465,26-09-2019 21:48:00,0,4113.0,2931.0,0.713,19.452,361,225,170,55,136,99,37,69,0.05,0.0
1013,2466,26-09-2019 21:50:00,0,3925.0,2700.0,0.688,18.454,148,96,69,27,52,42,10,30,0.0,0.0
1013,2467,26-09-2019 21:52:00,0,4314.0,2999.0,0.695,20.317,196,132,88,44,64,45,19,2,0.0,0.0
1013,2468,26-09-2019 21:54:00,0,3884.0,2783.0,0.716,18.385,437,273,212,61,164,134,30,60,0.0,0.0
1013,2469,26-09-2019 21:56:00,0,3902.0,2704.0,0.693,18.369,287,163,121,42,124,91,33,27,0.0,0.0
1013,2470,26-09-2019 21:58:00,0,3924.0,2665.0,0.679,18.411,266,190,146,44,76,64,12,65,0.0,0.0
1013,2471,26-09-2019 22:00:00,0,3919.0,2677.0,0.683,18.408,219,145,86,59,74,46,28,0,0.0,0.0
1013,2472,26-09-2019 22:02:00,0,3935.0,2681.0,0.681,18.471,271,143,108,35,128,92,36,13,0.0,0.0
1013,2473,26-09-2019 22:04:00,0,3691.0,2534.0,0.687,17.35,165,81,58,23,84,50,34,41,0.0,0.0
1013,2474,26-09-2019 22:06:00,0,3897.0,2725.0,0.699,18.372,335,142,104,38,193,148,45,26,0.0,0.0
1013,2475,26-09-2019 22:08:00,0,3702.0,2586.0,0.699,17.451,532,309,239,70,223,170,53,38,0.0,0.0
1013,2476,26-09-2019 22:10:00,0,3918.0,2773.0,0.708,18.507,179,92,69,23,87,60,27,43,0.02,0.0
1013,2477,26-09-2019 22:12:00,0,3809.5,2694.0,0.7075,17.9935,52,19,9,10,33,15,18,24,0.0,0.0
1013,2478,26-09-2019 22:14:00,0,3701.0,2615.0,0.707,17.48,198,95,70,25,103,77,26,27,0.0,0.0
1013,2479,26-09-2019 22:16:00,0,3902.0,2721.0,0.697,18.387,169,92,62,30,77,53,24,38,0.0,0.0
1013,2480,26-09-2019 22:18:00,0,3694.0,2622.0,0.71,17.458,356,180,142,38,176,135,41,64,0.08,0.0
1013,2481,26-09-2019 22:20:00,0,3881.0,2773.0,0.715,18.363,240,138,94,44,102,76,26,24,0.0,0.0
1013,2482,26-09-2019 22:22:00,0,3702.0,2636.0,0.712,17.504,529,307,251,56,222,171,51,110,0.0,0.0
1013,2483,26-09-2019 22:24:00,0,3921.0,2711.0,0.692,18.452,481,270,197,73,211,165,46,100,0.01,0.0
1013,2484,26-09-2019 22:26:00,0,3897.0,2786.0,0.715,18.437,369,215,166,49,154,114,40,139,0.0,0.0
1013,2485,26-09-2019 22:28:00,0,3919.0,2671.0,0.682,18.4,147,99,64,35,48,16,32,21,0.0,0.0
1013,2486,26-09-2019 22:30:00,0,3929.0,2732.0,0.695,18.505,231,158,116,42,73,51,22,40,0.01,0.0
1013,2487,26-09-2019 22:32:00,0,3917.0,2663.0,0.68,18.38,227,110,71,39,117,86,31,13,0.0,0.0
1013,2488,26-09-2019 22:34:00,0,3906.0,2725.0,0.698,18.407,241,156,123,33,85,72,13,50,0.0,0.0
1013,2489,26-09-2019 22:36:00,0,4018.0,2787.0,0.694,18.918,604,420,333,87,184,132,52,31,0.0,0.0
1013,2490,26-09-2019 22:38:00,0,3902.0,2739.0,0.702,18.406,316,131,106,25,185,134,51,51,0.0,0.0
1013,2491,26-09-2019 22:40:00,0,3908.0,2736.0,0.7,18.428,476,296,238,58,180,135,45,50,0.0,0.0
1013,2492,26-09-2019 22:42:00,0,3913.0,2679.0,0.685,18.386,157,73,45,28,84,59,25,56,0.0,0.0
1013,2493,26-09-2019 22:44:00,0,3902.0,2749.0,0.705,18.417,47,10,5,5,37,14,23,2,0.0,0.0
1013,2494,26-09-2019 22:46:00,0,3899.5,2754.0,0.7065,18.413,84,35,20,15,49,32,17,21,0.0,0.0
1013,2495,26-09-2019 22:48:00,0,3897.0,2759.0,0.708,18.409,481,272,203,69,209,158,51,48,0.0,0.0
1013,2496,26-09-2019 22:50:00,0,3696.0,2554.0,0.691,17.39,211,117,87,30,94,62,32,40,0.0,0.0
1013,2497,26-09-2019 22:52:00,0,3706.0,2574.0,0.695,17.451,99,91,67,24,8,5,3,20,0.0,0.0
1013,2498,26-09-2019 22:54:00,0,3919.0,2723.0,0.695,18.455,324,170,131,39,154,112,42,43,0.0,0.0
1013,2499,26-09-2019 22:56:00,0,3919.0,2650.0,0.676,18.374,526,280,211,69,246,189,57,101,0.05,0.0
1013,2500,26-09-2019 22:58:00,0,3912.0,2697.0,0.689,18.398,424,219,183,36,205,154,51,74,0.04,0.0
1013,2501,26-09-2019 23:00:00,0,3912.0,2742.0,0.701,18.45,454,291,232,59,163,121,42,83,0.0,0.0
1013,2502,26-09-2019 23:02:00,0,4117.0,2799.0,0.68,19.32,682,449,345,104,233,180,53,16,0.0,0.0
1013,2503,26-09-2019 23:04:00,0,3906.0,2762.0,0.707,18.448,493,284,229,55,209,163,46,80,0.0,0.0
1013,2504,26-09-2019 23:06:00,0,4109.0,2809.0,0.684,19.301,398,185,137,48,213,161,52,50,0.07,0.0
1013,2505,26-09-2019 23:08:00,0,3830.0,2637.0,0.688,18.011,62,51,22,29,11,5,6,11,0.0,0.0
1013,2506,26-09-2019 23:10:00,0,3800.0,2615.0,0.688,17.867,349,194,152,42,155,123,32,58,0.01,0.0
1013,2507,26-09-2019 23:12:00,0,3904.0,2714.0,0.695,18.387,368,222,174,48,146,115,31,67,0.02,0.0
1013,2508,26-09-2019 23:14:00,0,3711.0,2560.0,0.69,17.456,46,31,13,18,15,1,14,14,0.0,0.0
1013,2509,26-09-2019 23:16:00,0,3919.0,2673.0,0.682,18.402,48,33,13,20,15,12,3,33,0.0,0.0
1013,2510,26-09-2019 23:18:00,0,3813.0,2648.0,0.694,17.956,429,287,238,49,142,113,29,52,0.0,0.0
1013,2511,26-09-2019 23:20:00,0,3762.5,2579.0,0.685,17.6815,178,112,83,29,66,53,13,35,0.0,0.0
1013,2512,26-09-2019 23:22:00,0,3712.0,2510.0,0.676,17.407,183,104,82,22,79,50,29,18,0.0,0.0
1013,2513,26-09-2019 23:24:00,0,3930.0,2670.0,0.679,18.441,259,98,66,32,161,123,38,43,0.07,0.0
1013,2514,26-09-2019 23:26:00,0,3730.0,2494.0,0.669,17.457,131,94,45,49,37,23,14,1,0.0,0.0
1013,2515,26-09-2019 23:28:00,0,3721.0,2503.0,0.673,17.433,392,185,146,39,207,161,46,25,0.0,0.0
1013,2516,26-09-2019 23:30:00,0,3708.0,2549.0,0.687,17.431,245,157,116,41,88,73,15,12,0.0,0.0
1013,2517,26-09-2019 23:32:00,0,3633.0,2447.0,0.674,17.023,132,101,66,35,31,20,11,8,0.0,0.0
1013,2518,26-09-2019 23:34:00,0,4027.0,2765.0,0.687,18.929,77,38,22,16,39,26,13,6,0.0,0.0
1013,2519,26-09-2019 23:36:00,0,3796.0,2668.0,0.703,17.913,507,320,254,66,187,146,41,89,0.0,0.0
1013,2520,26-09-2019 23:38:00,0,3382.0,2374.0,0.702,15.953,427,263,187,76,164,123,41,80,0.0,0.0
1013,2521,26-09-2019 23:40:00,0,3716.0,2571.0,0.692,17.489,354,196,152,44,158,115,43,66,0.0,0.0
1013,2522,26-09-2019 23:42:00,0,3718.0,2538.0,0.683,17.459,153,51,32,19,102,68,34,11,0.0,0.0
1013,2523,26-09-2019 23:44:00,0,3727.0,2541.0,0.682,17.497,754,551,456,95,203,156,47,50,0.03,0.0
1013,2524,26-09-2019 23:46:00,0,3918.0,2696.0,0.688,18.422,745,561,459,102,184,139,45,20,0.0,0.0
1013,2525,26-09-2019 23:48:00,0,4005.0,2765.0,0.69,18.84,787,568,458,110,219,164,55,28,0.0,0.0
1013,2526,26-09-2019 23:50:00,0,4109.0,2932.0,0.714,19.437,543,344,271,73,199,154,45,21,0.0,0.0
1013,2527,26-09-2019 23:52:00,0,4527.0,3122.0,0.69,21.295,439,368,294,74,71,54,17,25,0.0,0.0
1013,2528,26-09-2019 23:54:00,0,4070.5,2799.0,0.6875,19.1375,421,239,192,47,182,140,42,15,0.0,0.0
1013,2529,26-09-2019 23:56:00,0,3614.0,2476.0,0.685,16.98,83,30,17,13,53,31,22,14,0.0,0.0
1013,2530,26-09-2019 23:58:00,0,3937.0,2647.0,0.672,18.445,328,205,155,50,123,91,32,65,0.01,0.0
1013,2531,27-09-2019 00:00:00,0,4323.0,2968.0,0.687,20.32,667,546,441,105,121,86,35,18,0.01,0.0
1013,2532,27-09-2019 00:02:00,0,4102.0,2900.0,0.707,19.375,303,148,101,47,155,107,48,1,0.0,0.0
1013,2533,27-09-2019 00:04:00,0,3909.0,2662.0,0.681,18.348,35,25,12,13,10,4,6,1,0.0,0.0
1013,2534,27-09-2019 00:06:00,0,3932.0,2668.0,0.678,18.446,416,211,162,49,205,165,40,21,0.01,0.0
1013,2535,27-09-2019 00:08:00,0,3930.0,2662.0,0.677,18.432,413,309,243,66,104,79,25,21,0.0,0.0
1013,2536,27-09-2019 00:10:00,0,3612.0,2467.0,0.683,16.964,149,62,31,31,87,45,42,24,0.0,0.0
1013,2537,27-09-2019 00:12:00,0,3520.0,2402.0,0.682,16.529,205,113,85,28,92,73,19,46,0.09,0.0
1013,2538,27-09-2019 00:14:00,0,3723.0,2547.0,0.684,17.49,232,96,67,29,136,94,42,2,0.0,0.0
1013,2539,27-09-2019 00:16:00,0,3612.0,2449.0,0.678,16.942,127,59,32,27,68,46,22,27,0.0,0.0
1013,2540,27-09-2019 00:18:00,0,3605.0,2454.0,0.681,16.919,286,145,108,37,141,102,39,62,0.0,0.0
1013,2541,27-09-2019 00:20:00,0,3726.0,2472.0,0.663,17.419,64,51,30,21,13,10,3,0,0.0,0.0
1013,2542,27-09-2019 00:22:00,0,3503.0,2427.0,0.693,16.49,330,219,168,51,111,85,26,41,0.0,0.0
1013,2543,27-09-2019 00:24:00,0,3804.0,2593.0,0.682,17.857,541,413,326,87,128,93,35,26,0.0,0.0
1013,2544,27-09-2019 00:26:00,0,3935.0,2659.0,0.676,18.447,200,124,95,29,76,50,26,12,0.0,0.0
1013,2545,27-09-2019 00:28:00,0,3767.5,2558.5,0.6795,17.676,59,30,16,14,29,13,16,12,0.0,0.0
1013,2546,27-09-2019 00:30:00,0,3600.0,2458.0,0.683,16.905,129,64,51,13,65,46,19,19,0.0,0.0
1013,2547,27-09-2019 00:32:00,0,3485.0,2426.0,0.696,16.417,194,100,66,34,94,68,26,0,0.0,0.0
1013,2548,27-09-2019 00:34:00,0,3267.0,2392.0,0.732,15.523,316,164,119,45,152,123,29,54,0.05,0.0
1013,2549,27-09-2019 00:36:00,0,3495.0,2475.0,0.708,16.511,152,73,51,22,79,54,25,3,0.01,0.0
1013,2550,27-09-2019 00:38:00,0,3280.0,2384.0,0.727,15.563,35,14,4,10,21,10,11,0,0.0,0.0
1013,2551,27-09-2019 00:40:00,0,3302.0,2294.0,0.695,15.55,66,37,14,23,29,13,16,1,0.0,0.0
1013,2552,27-09-2019 00:42:00,0,3385.0,2414.0,0.713,16.011,103,43,26,17,60,31,29,0,0.0,0.0
1013,2553,27-09-2019 00:44:00,0,3263.0,2382.0,0.73,15.495,27,7,2,5,20,3,17,0,0.0,0.0
1013,2554,27-09-2019 00:46:00,0,3183.0,2246.0,0.706,15.027,1,1,0,1,0,0,0,0,0.0,0.0
1013,2555,27-09-2019 00:48:00,0,3080.0,2186.0,0.71,14.556,20,0,0,0,20,2,18,0,0.0,0.0
1013,2556,27-09-2019 00:50:00,0,2868.0,2063.0,0.719,13.586,17,0,0,0,17,2,15,0,0.0,0.0
1013,2557,27-09-2019 00:52:00,0,2783.0,1938.0,0.696,13.109,8,0,0,0,8,0,8,0,0.0,0.0
1013,2558,27-09-2019 00:54:00,0,2571.0,1809.0,0.703,12.134,30,1,0,1,29,2,27,0,0.0,0.0
1013,2559,27-09-2019 00:56:00,0,2472.0,1725.0,0.698,11.648,3,0,0,0,3,0,3,0,0.0,0.0
1013,2560,27-09-2019 00:58:00,0,2353.0,1668.0,0.709,11.118,15,4,1,3,11,0,11,0,0.0,0.0
1013,2561,27-09-2019 01:00:00,0,2365.0,1648.0,0.697,11.144,43,1,0,1,42,7,35,0,0.0,0.0
1013,2562,27-09-2019 01:02:00,0,2378.5,1609.0,0.6765,11.153,30,0,0,0,30,1,29,0,0.0,0.0
1013,2563,27-09-2019 01:04:00,0,2392.0,1570.0,0.656,11.162,41,6,4,2,35,17,18,0,0.01,0.0
1013,2564,27-09-2019 01:06:00,0,2388.0,1577.0,0.661,11.155,37,0,0,0,37,28,9,0,0.0,0.0
1013,2565,27-09-2019 01:08:00,0,2279.0,1540.0,0.676,10.685,4,0,0,0,4,1,3,0,0.0,0.0
1013,2566,27-09-2019 01:10:00,0,2290.0,1486.0,0.649,10.667,14,0,0,0,14,0,14,0,0.0,0.0
1013,2567,27-09-2019 01:12:00,0,2306.0,1456.0,0.632,10.699,47,2,1,1,45,43,2,0,0.0,0.0
1013,2568,27-09-2019 01:14:00,0,2295.0,1451.0,0.632,10.651,275,134,90,44,141,100,41,19,0.01,0.0
1013,2569,27-09-2019 01:16:00,0,2677.0,1813.0,0.677,12.554,429,231,182,49,198,152,46,36,0.0,0.0
1013,2570,27-09-2019 01:18:00,0,3020.0,1982.0,0.656,14.093,357,176,129,47,181,136,45,24,0.0,0.0
1013,2571,27-09-2019 01:20:00,0,3432.0,2269.0,0.661,16.035,419,242,189,53,177,133,44,58,0.0,0.0
1013,2572,27-09-2019 01:22:00,0,3182.0,2230.0,0.701,15.006,266,101,59,42,165,116,49,10,0.0,0.0
1013,2573,27-09-2019 01:24:00,0,3316.0,2230.0,0.672,15.536,395,217,168,49,178,129,49,89,0.0,0.0
1013,2574,27-09-2019 01:26:00,0,3374.0,2386.0,0.707,15.937,502,248,199,49,254,208,46,55,0.1,0.0
1013,2575,27-09-2019 01:28:00,0,3618.0,2451.0,0.678,16.97,365,191,135,56,174,131,43,87,0.01,0.0
1013,2576,27-09-2019 01:30:00,0,3739.0,2479.0,0.663,17.477,229,139,104,35,90,69,21,43,0.04,0.0
1013,2577,27-09-2019 01:32:00,0,3712.0,2530.0,0.682,17.428,358,188,143,45,170,133,37,34,0.0,0.0
1013,2578,27-09-2019 01:34:00,0,4016.0,2782.0,0.693,18.904,165,94,60,34,71,44,27,77,0.0,0.0
1013,2579,27-09-2019 01:36:00,0,3976.5,2723.0,0.685,18.6825,311,177,132,45,134,100,34,51,0.0,0.0
1013,2580,27-09-2019 01:38:00,0,3937.0,2664.0,0.677,18.461,267,111,81,30,156,122,34,65,0.0,0.0
1013,2581,27-09-2019 01:40:00,0,3712.0,2536.0,0.683,17.432,103,34,11,23,69,30,39,0,0.0,0.0
1013,2582,27-09-2019 01:42:00,0,3820.0,2584.0,0.677,17.912,221,120,81,39,101,77,24,39,0.0,0.0
1013,2583,27-09-2019 01:44:00,0,3907.0,2728.0,0.698,18.414,247,136,93,43,111,82,29,37,0.04,0.0
1013,2584,27-09-2019 01:46:00,0,3736.0,2491.0,0.667,17.48,375,176,127,49,199,153,46,50,0.0,0.0
1013,2585,27-09-2019 01:48:00,0,3727.0,2470.0,0.663,17.421,291,224,170,54,67,55,12,49,0.0,0.0
1013,2586,27-09-2019 01:50:00,0,3723.0,2521.0,0.677,17.46,105,36,19,17,69,41,28,3,0.0,0.0
1013,2587,27-09-2019 01:52:00,0,3630.0,2424.0,0.668,16.988,78,46,18,28,32,22,10,0,0.0,0.0
1013,2588,27-09-2019 01:54:00,0,3410.0,2348.0,0.689,16.034,2,2,1,1,0,0,0,0,0.0,0.0
1013,2589,27-09-2019 01:56:00,0,3186.0,2193.0,0.688,14.983,0,0,0,0,0,0,0,0,0.0,0.0
1013,2590,27-09-2019 01:58:00,0,3227.0,2076.0,0.643,15.016,0,0,0,0,0,0,0,0,0.0,0.0
1013,2591,27-09-2019 02:00:00,0,3016.0,1981.0,0.657,14.078,1,1,1,0,0,0,0,0,0.0,0.0
1013,2592,27-09-2019 02:02:00,0,2795.0,1890.0,0.676,13.104,0,0,0,0,0,0,0,0,0.0,0.0
1013,2593,27-09-2019 02:04:00,0,2691.0,1816.0,0.675,12.614,0,0,0,0,0,0,0,0,0.0,0.0
1013,2594,27-09-2019 02:06:00,0,2709.0,1755.0,0.648,12.617,0,0,0,0,0,0,0,0,0.0,0.0
1013,2595,27-09-2019 02:08:00,0,2478.0,1698.0,0.685,11.644,0,0,0,0,0,0,0,0,0.0,0.0
1013,2596,27-09-2019 02:10:00,0,2521.0,1758.5,0.6975,11.881,53,34,11,23,19,11,8,0,0.0,0.0
1013,2597,27-09-2019 02:12:00,0,2564.0,1819.0,0.71,12.118,324,212,156,56,112,87,25,28,0.02,0.0
1013,2598,27-09-2019 02:14:00,0,2568.0,1821.0,0.709,12.137,212,127,93,34,85,58,27,24,0.0,0.0
1013,2599,27-09-2019 02:16:00,0,2773.0,1919.0,0.692,13.052,53,38,26,12,15,12,3,3,0.0,0.0
1013,2600,27-09-2019 02:18:00,0,2890.0,1969.0,0.681,13.565,286,146,105,41,140,103,37,7,0.0,0.0
1013,2601,27-09-2019 02:20:00,0,2548.0,1880.0,0.738,12.12,17,4,3,1,13,7,6,0,0.0,0.0
1013,2602,27-09-2019 02:22:00,0,2577.0,1777.0,0.69,12.121,61,27,10,17,34,11,23,3,0.0,0.0
1013,2603,27-09-2019 02:24:00,0,2663.0,1888.0,0.709,12.581,84,39,15,24,45,21,24,0,0.0,0.0
1013,2604,27-09-2019 02:26:00,0,2655.0,1915.0,0.721,12.581,7,5,1,4,2,0,2,0,0.0,0.0
1013,2605,27-09-2019 02:28:00,0,2564.0,1848.0,0.721,12.148,1,1,0,1,0,0,0,0,0.0,0.0
1013,2606,27-09-2019 02:30:00,0,2584.0,1779.0,0.688,12.151,18,18,0,18,0,0,0,0,0.0,0.0
1013,2607,27-09-2019 02:32:00,0,2350.0,1721.0,0.733,11.165,3,1,0,1,2,1,1,0,0.0,0.0
1013,2608,27-09-2019 02:34:00,0,2353.0,1698.0,0.722,11.152,0,0,0,0,0,0,0,0,0.0,0.0
1013,2609,27-09-2019 02:36:00,0,2366.0,1636.0,0.692,11.133,7,2,1,1,5,2,3,0,0.0,0.0
1013,2610,27-09-2019 02:38:00,0,2375.0,1583.0,0.666,11.111,8,6,1,5,2,0,2,0,0.0,0.0
1013,2611,27-09-2019 02:40:00,0,2158.0,1543.0,0.715,10.211,0,0,0,0,0,0,0,0,0.0,0.0
1013,2612,27-09-2019 02:42:00,0,2162.0,1500.0,0.694,10.178,7,4,0,4,3,2,1,0,0.0,0.0
1013,2613,27-09-2019 02:44:00,0,2235.0,1460.5,0.655,10.423,4,3,0,3,1,0,1,0,0.0,0.0
1013,2614,27-09-2019 02:46:00,0,2308.0,1421.0,0.616,10.668,15,15,0,15,0,0,0,0,0.0,0.0
1013,2615,27-09-2019 02:48:00,0,2070.0,1369.0,0.661,9.671,6,3,0,3,3,3,0,0,0.0,0.0
1013,2616,27-09-2019 02:50:00,0,1968.0,1344.0,0.683,9.241,17,17,0,17,0,0,0,0,0.0,0.0
1013,2617,27-09-2019 02:52:00,0,1971.0,1320.0,0.67,9.227,21,21,0,21,0,0,0,0,0.0,0.0
1013,2618,27-09-2019 02:54:00,0,1970.0,1334.0,0.677,9.238,1,1,0,1,0,0,0,0,0.0,0.0
1013,2619,27-09-2019 02:56:00,0,1966.0,1315.0,0.669,9.201,15,15,0,15,0,0,0,0,0.0,0.0
1013,2620,27-09-2019 02:58:00,0,1961.0,1321.0,0.674,9.188,17,17,0,17,0,0,0,0,0.0,0.0
1013,2621,27-09-2019 03:00:00,0,1963.0,1348.0,0.687,9.226,271,167,135,32,104,80,24,19,0.0,0.0
1013,2622,27-09-2019 03:02:00,0,2284.0,1523.0,0.667,10.684,148,103,67,36,45,29,16,40,0.0,0.0
1013,2623,27-09-2019 03:04:00,0,2497.0,1655.0,0.663,11.669,315,153,110,43,162,117,45,103,0.0,0.0
1013,2624,27-09-2019 03:06:00,0,2673.0,1889.0,0.707,12.623,170,129,92,37,41,27,14,7,0.0,0.0
1013,2625,27-09-2019 03:08:00,0,3701.0,2592.0,0.7,17.452,53,14,7,7,39,23,16,6,0.05,0.0
1013,2626,27-09-2019 03:10:00,0,3183.0,2246.0,0.706,15.028,332,175,132,43,157,117,40,60,0.0,0.0
1013,2627,27-09-2019 03:12:00,0,3215.0,2130.0,0.663,15.025,291,221,155,66,70,47,23,60,0.0,0.0
1013,2628,27-09-2019 03:14:00,0,3394.0,2357.0,0.694,15.982,103,57,30,27,46,34,12,6,0.0,0.0
1013,2629,27-09-2019 03:16:00,0,3229.0,2122.0,0.657,15.072,266,157,120,37,109,82,27,10,0.0,0.0
1013,2630,27-09-2019 03:18:00,0,3206.5,2195.0,0.6845,15.064,224,117,86,31,107,82,25,61,0.0,0.0
1013,2631,27-09-2019 03:20:00,0,3184.0,2268.0,0.712,15.056,350,154,110,44,196,149,47,26,0.0,0.0
1013,2632,27-09-2019 03:22:00,0,3088.0,2177.0,0.705,14.579,181,95,56,39,86,57,29,4,0.0,0.0
1013,2633,27-09-2019 03:24:00,0,3190.0,2204.0,0.691,15.007,181,91,70,21,90,63,27,42,0.0,0.0
1013,2634,27-09-2019 03:26:00,0,3290.0,2342.0,0.712,15.557,174,76,58,18,98,68,30,9,0.0,0.0
1013,2635,27-09-2019 03:28:00,0,3612.0,2441.0,0.676,16.936,344,205,156,49,139,106,33,22,0.0,0.0
1013,2636,27-09-2019 03:30:00,0,3497.0,2449.0,0.7,16.491,206,129,91,38,77,58,19,39,0.02,0.0
1013,2637,27-09-2019 03:32:00,0,3287.0,2265.0,0.689,15.46,48,28,13,15,20,7,13,0,0.0,0.0
1013,2638,27-09-2019 03:34:00,0,3073.0,2189.0,0.712,14.532,25,9,6,3,16,7,9,0,0.0,0.0
1013,2639,27-09-2019 03:36:00,0,3099.0,2061.0,0.665,14.492,40,0,0,0,40,0,40,0,0.0,0.0
1013,2640,27-09-2019 03:38:00,0,2882.0,1992.0,0.691,13.559,45,0,0,0,45,0,45,0,0.0,0.0
1013,2641,27-09-2019 03:40:00,0,2780.0,1905.0,0.685,13.063,40,0,0,0,40,0,40,0,0.0,0.0
1013,2642,27-09-2019 03:42:00,0,2552.0,1836.0,0.719,12.087,2,0,0,0,2,0,2,0,0.0,0.0
1013,2643,27-09-2019 03:44:00,0,2586.0,1770.0,0.685,12.148,25,0,0,0,25,4,21,0,0.0,0.0
1013,2644,27-09-2019 03:46:00,0,2475.0,1714.0,0.693,11.65,41,0,0,0,41,0,41,0,0.0,0.0
1013,2645,27-09-2019 03:48:00,0,2369.0,1636.0,0.691,11.145,42,0,0,0,42,13,29,0,0.0,0.0
1013,2646,27-09-2019 03:50:00,0,2390.0,1578.0,0.66,11.166,50,4,0,4,46,8,38,0,0.0,0.0
1013,2647,27-09-2019 03:52:00,0,2280.0,1539.5,0.676,10.6885,2,1,0,1,1,1,0,0,0.0,0.0
1013,2648,27-09-2019 03:54:00,0,2170.0,1501.0,0.692,10.211,16,3,2,1,13,2,11,0,0.0,0.0
1013,2649,27-09-2019 03:56:00,0,2166.0,1463.0,0.675,10.154,21,0,0,0,21,0,21,0,0.0,0.0
1013,2650,27-09-2019 03:58:00,0,2177.0,1435.0,0.659,10.165,28,0,0,0,28,0,28,0,0.0,0.0
1013,2651,27-09-2019 04:00:00,0,2067.0,1411.0,0.683,9.707,116,44,11,33,72,31,41,0,0.0,0.0
1013,2652,27-09-2019 04:02:00,0,2161.0,1490.0,0.69,10.162,229,121,92,29,108,81,27,13,0.0,0.0
1013,2653,27-09-2019 04:04:00,0,2376.0,1619.0,0.682,11.153,105,45,20,25,60,28,32,3,0.0,0.0
1013,2654,27-09-2019 04:06:00,0,2365.0,1701.0,0.719,11.201,270,161,121,40,109,73,36,51,0.0,0.0
1013,2655,27-09-2019 04:08:00,0,2464.0,1759.0,0.714,11.657,42,14,4,10,28,17,11,1,0.0,0.0
1013,2656,27-09-2019 04:10:00,0,2357.0,1669.0,0.708,11.134,1,1,0,1,0,0,0,0,0.0,0.0
1013,2657,27-09-2019 04:12:00,0,2258.0,1570.0,0.695,10.634,0,0,0,0,0,0,0,0,0.0,0.0
1013,2658,27-09-2019 04:14:00,0,2163.0,1525.0,0.705,10.211,23,8,2,6,15,6,9,0,0.0,0.0
1013,2659,27-09-2019 04:16:00,0,2268.0,1568.0,0.691,10.673,0,0,0,0,0,0,0,0,0.0,0.0
1013,2660,27-09-2019 04:18:00,0,2152.0,1548.0,0.719,10.194,0,0,0,0,0,0,0,0,0.0,0.0
1013,2661,27-09-2019 04:20:00,0,2156.0,1518.0,0.704,10.177,0,0,0,0,0,0,0,0,0.0,0.0
1013,2662,27-09-2019 04:22:00,0,2165.0,1483.0,0.685,10.173,22,0,0,0,22,1,21,0,0.0,0.0
1013,2663,27-09-2019 04:24:00,0,2184.0,1458.0,0.668,10.218,21,0,0,0,21,0,21,0,0.0,0.0
1013,2664,27-09-2019 04:26:00,0,2006.0,1408.0,0.7055,9.4625,29,10,5,5,19,6,13,0,0.0,0.0
1013,2665,27-09-2019 04:28:00,0,1828.0,1358.0,0.743,8.707,0,0,0,0,0,0,0,0,0.0,0.0
1013,2666,27-09-2019 04:30:00,0,1858.0,1279.0,0.688,8.736,53,1,0,1,52,33,19,0,0.0,0.0
1013,2667,27-09-2019 04:32:00,0,1858.0,1277.0,0.687,8.736,17,0,0,0,17,0,17,0,0.0,0.0
1013,2668,27-09-2019 04:34:00,0,1853.0,1288.0,0.695,8.725,51,1,1,0,50,37,13,0,0.0,0.0
1013,2669,27-09-2019 04:36:00,0,1848.0,1311.0,0.709,8.735,27,1,0,1,26,21,5,0,0.0,0.0
1013,2670,27-09-2019 04:38:00,0,1857.0,1300.0,0.7,8.757,35,6,0,6,29,23,6,0,0.0,0.0
1013,2671,27-09-2019 04:40:00,0,1847.0,1290.0,0.698,8.706,18,5,0,5,13,10,3,0,0.0,0.0
1013,2672,27-09-2019 04:42:00,0,1851.0,1295.0,0.699,8.726,6,0,0,0,6,0,6,0,0.0,0.0
1013,2673,27-09-2019 04:44:00,0,1858.0,1277.0,0.687,8.735,84,15,2,13,69,23,46,0,0.0,0.0
1013,2674,27-09-2019 04:46:00,0,1953.0,1358.0,0.696,9.197,150,42,12,30,108,73,35,0,0.0,0.0
1013,2675,27-09-2019 04:48:00,0,2381.0,1582.0,0.664,11.132,115,56,28,28,59,32,27,4,0.0,0.0
1013,2676,27-09-2019 04:50:00,0,3101.0,2132.0,0.688,14.579,220,122,84,38,98,64,34,15,0.0,0.0
1013,2677,27-09-2019 04:52:00,0,3094.0,2131.0,0.689,14.55,301,184,143,41,117,87,30,70,0.0,0.0
1013,2678,27-09-2019 04:54:00,0,3071.0,2207.0,0.719,14.542,275,159,128,31,116,83,33,46,0.0,0.0
1013,2679,27-09-2019 04:56:00,0,3293.0,2312.0,0.702,15.535,194,108,76,32,86,58,28,30,0.0,0.0
1013,2680,27-09-2019 04:58:00,0,3382.0,2412.0,0.713,15.997,316,172,125,47,144,108,36,94,0.0,0.0
1013,2681,27-09-2019 05:00:00,0,3492.5,2448.0,0.7015,16.471,222,157,116,41,65,51,14,35,0.0,0.0
1013,2682,27-09-2019 05:02:00,0,3603.0,2484.0,0.69,16.945,208,127,90,37,81,63,18,49,0.0,0.0
1013,2683,27-09-2019 05:04:00,0,3267.0,2382.0,0.729,15.509,350,217,173,44,133,94,39,58,0.19,0.0
1013,2684,27-09-2019 05:06:00,0,3692.0,2614.0,0.708,17.441,273,145,115,30,128,98,30,33,0.04,0.0
1013,2685,27-09-2019 05:08:00,0,3385.0,2396.0,0.708,15.99,191,138,95,43,53,33,20,23,0.0,0.0
1013,2686,27-09-2019 05:10:00,0,3276.0,2367.0,0.723,15.529,280,174,129,45,106,75,31,121,0.0,0.0
1013,2687,27-09-2019 05:12:00,0,3275.0,2384.0,0.728,15.543,68,27,17,10,41,15,26,3,0.02,0.0
1013,2688,27-09-2019 05:14:00,0,3308.0,2272.0,0.687,15.55,19,14,0,14,5,0,5,0,0.0,0.0
1013,2689,27-09-2019 05:16:00,0,3317.0,2222.0,0.67,15.529,62,14,6,8,48,22,26,0,0.0,0.0
1013,2690,27-09-2019 05:18:00,0,3296.0,2243.0,0.681,15.471,29,16,10,6,13,6,7,0,0.0,0.0
1013,2691,27-09-2019 05:20:00,0,3378.0,2429.0,0.719,15.998,183,112,83,29,71,56,15,14,0.0,0.0
1013,2692,27-09-2019 05:22:00,0,3081.0,2217.0,0.719,14.595,23,8,7,1,15,9,6,0,0.0,0.0
1013,2693,27-09-2019 05:24:00,0,3108.0,2108.0,0.678,14.581,0,0,0,0,0,0,0,0,0.0,0.0
1013,2694,27-09-2019 05:26:00,0,2882.0,1987.0,0.69,13.554,0,0,0,0,0,0,0,0,0.0,0.0
1013,2695,27-09-2019 05:28:00,0,2681.0,1883.0,0.703,12.649,3,3,0,3,0,0,0,0,0.0,0.0
1013,2696,27-09-2019 05:30:00,0,2573.0,1776.0,0.69,12.105,2,2,0,2,0,0,0,0,0.0,0.0
1013,2697,27-09-2019 05:32:00,0,2473.0,1703.0,0.689,11.632,0,0,0,0,0,0,0,0,0.0,0.0
1013,2698,27-09-2019 05:34:00,0,2433.5,1629.5,0.6695,11.3935,4,4,0,4,0,0,0,0,0.0,0.0
1013,2699,27-09-2019 05:36:00,0,2394.0,1556.0,0.65,11.155,0,0,0,0,0,0,0,0,0.0,0.0
1013,2700,27-09-2019 05:38:00,0,2165.0,1504.0,0.695,10.196,27,13,6,7,14,12,2,0,0.0,0.0
1013,2701,27-09-2019 05:40:00,0,2161.0,1509.0,0.699,10.186,7,1,0,1,6,2,4,0,0.0,0.0
1013,2702,27-09-2019 05:42:00,0,2148.0,1545.0,0.719,10.175,13,0,0,0,13,0,13,0,0.0,0.0
1013,2703,27-09-2019 05:44:00,0,2150.0,1519.0,0.706,10.153,2,0,0,0,2,0,2,0,0.0,0.0
1013,2704,27-09-2019 05:46:00,0,2170.0,1482.0,0.683,10.19,0,0,0,0,0,0,0,0,0.0,0.0
1013,2705,27-09-2019 05:48:00,0,2187.0,1436.0,0.657,10.206,1,0,0,0,1,0,1,0,0.0,0.0
1013,2706,27-09-2019 05:50:00,0,2067.0,1395.0,0.675,9.687,4,0,0,0,4,0,4,0,0.0,0.0
1013,2707,27-09-2019 05:52:00,0,1950.0,1359.0,0.697,9.188,0,0,0,0,0,0,0,0,0.0,0.0
1013,2708,27-09-2019 05:54:00,0,1839.0,1332.0,0.724,8.722,0,0,0,0,0,0,0,0,0.0,0.0
1013,2709,27-09-2019 05:56:00,0,1842.0,1299.0,0.705,8.695,1,0,0,0,1,0,1,0,0.0,0.0
1013,2710,27-09-2019 05:58:00,0,1864.0,1258.0,0.675,8.738,0,0,0,0,0,0,0,0,0.0,0.0
1013,2711,27-09-2019 06:00:00,1,1760.0,1214.0,0.69,8.278,33,12,5,7,21,12,9,0,0.0,0.01
1013,2712,27-09-2019 06:02:00,1,1845.0,1280.0,0.694,8.688,230,150,109,41,80,49,31,43,0.0,0.02
1013,2713,27-09-2019 06:04:00,1,2475.0,1730.0,0.699,11.669,175,134,94,40,41,20,21,23,0.0,0.0
1013,2714,27-09-2019 06:06:00,1,3094.0,2103.0,0.68,14.519,111,52,28,24,59,15,44,49,0.0,0.0
1013,2715,27-09-2019 06:08:00,1,3447.0,2420.5,0.7,16.262,179,112,73,39,67,30,37,55,0.0,0.03
1013,2716,27-09-2019 06:10:00,1,3800.0,2738.0,0.72,18.005,83,27,1,26,56,22,34,63,0.0,0.0
1013,2717,27-09-2019 06:12:00,1,4184.0,3100.0,0.741,19.917,58,15,3,12,43,12,31,50,0.0,0.18
1013,2718,27-09-2019 06:14:00,1,4242.0,3275.0,0.772,20.34,71,8,4,4,63,19,44,44,0.0,0.02
1013,2719,27-09-2019 06:16:00,1,4380.0,3345.0,0.764,20.96,303,167,132,35,136,84,52,59,0.17,0.05
1013,2720,27-09-2019 06:18:00,1,4232.0,3285.0,0.776,20.311,90,51,30,21,39,18,21,30,0.0,0.05
1013,2721,27-09-2019 06:20:00,1,4248.0,3267.0,0.769,20.356,351,150,118,32,201,145,56,33,0.24,0.04
1013,2722,27-09-2019 06:22:00,1,4447.0,3390.0,0.762,21.275,138,73,43,30,65,23,42,41,0.0,0.01
1013,2723,27-09-2019 06:24:00,1,4227.0,3418.0,0.808,20.44,200,94,46,48,106,63,43,49,0.0,0.0
1013,2724,27-09-2019 06:26:00,1,4436.0,3472.0,0.783,21.321,221,111,74,37,110,70,40,51,0.13,0.09
1013,2725,27-09-2019 06:28:00,1,4933.0,3941.0,0.799,23.8,84,20,4,16,64,27,37,24,0.0,0.03
1013,2726,27-09-2019 06:30:00,1,4609.0,3782.0,0.821,22.347,107,41,4,37,66,32,34,27,0.0,0.04
1013,2727,27-09-2019 06:32:00,1,4203.0,3456.0,0.822,20.387,186,115,79,36,71,27,44,53,0.18,0.03
1013,2728,27-09-2019 06:34:00,1,4507.0,3704.0,0.822,21.86,132,85,49,36,47,31,16,30,0.0,0.02
1013,2729,27-09-2019 06:36:00,1,4412.0,3684.0,0.835,21.464,401,191,155,36,210,158,52,89,0.12,0.04
1013,2730,27-09-2019 06:38:00,1,4581.0,3833.0,0.837,22.293,131,49,21,28,82,40,42,45,0.01,0.0
1013,2731,27-09-2019 06:40:00,1,4576.0,3902.0,0.853,22.35,145,52,26,26,93,54,39,31,0.09,0.08
1013,2732,27-09-2019 06:42:00,1,4580.5,3876.5,0.8465,22.34,98,28,6,22,70,40,30,32,0.01,0.0
1013,2733,27-09-2019 06:44:00,1,4585.0,3851.0,0.84,22.33,133,46,21,25,87,46,41,44,0.0,0.02
1013,2734,27-09-2019 06:46:00,1,5079.0,4397.0,0.866,24.879,114,39,9,30,75,47,28,23,0.06,0.08
1013,2735,27-09-2019 06:48:00,1,4550.0,3915.0,0.86,22.26,326,201,163,38,125,83,42,43,0.05,0.15
1013,2736,27-09-2019 06:50:00,1,4390.0,3698.0,0.842,21.392,258,121,83,38,137,91,46,44,0.01,0.02
1013,2737,27-09-2019 06:52:00,1,4589.0,3912.0,0.852,22.411,390,157,119,38,233,180,53,33,0.09,0.0
1013,2738,27-09-2019 06:54:00,1,4369.0,3757.0,0.86,21.372,151,92,51,41,59,26,33,50,0.0,0.0
1013,2739,27-09-2019 06:56:00,1,4553.0,4037.0,0.887,22.409,82,55,25,30,27,0,27,61,0.0,0.0
1013,2740,27-09-2019 06:58:00,1,4850.0,4256.0,0.878,23.821,72,38,24,14,34,9,25,49,0.0,0.0
1013,2741,27-09-2019 07:00:00,1,4640.0,4103.0,0.884,22.823,147,67,45,22,80,50,30,21,0.09,0.0
1013,2742,27-09-2019 07:02:00,1,3877.0,3365.0,0.868,19.001,22,11,2,9,11,2,9,0,0.01,0.0
1013,2743,27-09-2019 07:04:00,1,3657.0,3196.0,0.874,17.947,48,27,5,22,21,3,18,0,0.0,0.0
1013,2744,27-09-2019 07:06:00,1,3669.0,3161.0,0.862,17.957,66,28,9,19,38,20,18,0,0.0,0.0
1013,2745,27-09-2019 07:08:00,1,3661.0,3236.0,0.884,18.005,153,18,6,12,135,93,42,0,0.0,0.0
1013,2746,27-09-2019 07:10:00,1,3775.0,3265.0,0.865,18.489,11,2,0,2,9,3,6,0,0.0,0.0
1013,2747,27-09-2019 07:12:00,1,3654.0,3215.0,0.88,17.958,0,0,0,0,0,0,0,0,0.0,0.0
1013,2748,27-09-2019 07:14:00,1,3693.0,3199.0,0.866,18.092,15,3,0,3,12,8,4,0,0.0,0.0
1013,2749,27-09-2019 07:16:00,1,3575.0,3111.5,0.8705,17.53,2,1,0,1,1,1,0,0,0.0,0.0
1013,2750,27-09-2019 07:18:00,1,3457.0,3024.0,0.875,16.968,0,0,0,0,0,0,0,0,0.0,0.0
1013,2751,27-09-2019 07:20:00,1,3499.0,2909.0,0.831,17.006,23,4,1,3,19,12,7,0,0.0,0.0
1013,2752,27-09-2019 07:22:00,1,3146.0,2801.0,0.89,15.495,28,0,0,0,28,22,6,0,0.0,0.0
1013,2753,27-09-2019 07:24:00,1,3175.0,2729.0,0.86,15.53,2,0,0,0,2,0,2,0,0.0,0.0
1013,2754,27-09-2019 07:26:00,1,3090.0,2651.0,0.858,15.111,0,0,0,0,0,0,0,0,0.0,0.0
1013,2755,27-09-2019 07:28:00,1,2975.0,2575.0,0.866,14.571,80,28,9,19,52,30,22,0,0.0,0.0
1013,2756,27-09-2019 07:30:00,1,2966.0,2615.0,0.882,14.581,8,1,0,1,7,0,7,0,0.0,0.0
1013,2757,27-09-2019 07:32:00,1,2864.0,2514.0,0.878,14.067,2,0,0,0,2,0,2,0,0.0,0.0
1013,2758,27-09-2019 07:34:00,1,2772.0,2429.0,0.876,13.61,9,0,0,0,9,0,9,0,0.0,0.0
1013,2759,27-09-2019 07:36:00,1,2795.0,2387.0,0.854,13.655,28,0,0,0,28,0,28,0,0.0,0.0
1013,2760,27-09-2019 07:38:00,1,2680.0,2308.0,0.861,13.115,29,2,1,1,27,6,21,0,0.0,0.0
1013,2761,27-09-2019 07:40:00,1,2665.0,2348.0,0.881,13.102,0,0,0,0,0,0,0,0,0.0,0.0
1013,2762,27-09-2019 07:42:00,1,2760.0,2449.0,0.887,13.585,2,0,0,0,2,1,1,0,0.0,0.0
1013,2763,27-09-2019 07:44:00,1,2760.0,2484.0,0.9,13.625,8,0,0,0,8,2,6,0,0.0,0.0
1013,2764,27-09-2019 07:46:00,1,2845.0,2570.0,0.903,14.054,15,0,0,0,15,0,15,0,0.0,0.0
1013,2765,27-09-2019 07:48:00,1,2862.0,2576.0,0.9,14.128,8,0,0,0,8,0,8,0,0.0,0.0
1013,2766,27-09-2019 07:50:00,1,2805.0,2569.5,0.9165,13.896,8,1,0,1,7,0,7,0,0.0,0.0
1013,2767,27-09-2019 07:52:00,1,2748.0,2563.0,0.933,13.664,6,2,2,0,4,1,3,0,0.0,0.0
1013,2768,27-09-2019 07:54:00,1,2756.0,2515.0,0.913,13.641,1,0,0,0,1,0,1,0,0.0,0.0
1013,2769,27-09-2019 07:56:00,1,2678.0,2358.0,0.881,13.162,16,1,1,0,15,8,7,0,0.0,0.0
1013,2770,27-09-2019 07:58:00,1,2558.0,2300.0,0.899,12.626,33,4,1,3,29,3,26,0,0.0,0.0
1013,2771,27-09-2019 08:00:00,1,2447.0,2250.0,0.92,12.131,39,2,0,2,37,1,36,0,0.0,0.0
1013,2772,27-09-2019 08:02:00,1,2459.0,2243.0,0.912,12.172,77,29,10,19,48,28,20,0,0.0,0.0
1013,2773,27-09-2019 08:04:00,1,2644.0,2428.0,0.918,13.107,147,78,47,31,69,50,19,22,0.02,0.0
1013,2774,27-09-2019 08:06:00,1,3148.0,2881.0,0.915,15.592,217,151,119,32,66,43,23,24,0.0,0.05
1013,2775,27-09-2019 08:08:00,1,3134.0,2902.0,0.926,15.563,202,96,56,40,106,63,43,41,0.0,0.0
1013,2776,27-09-2019 08:10:00,1,3421.0,3196.0,0.934,17.018,142,91,64,27,51,29,22,67,0.0,0.02
1013,2777,27-09-2019 08:12:00,1,3594.0,3387.0,0.942,17.911,189,119,78,41,70,28,42,55,0.0,0.0
1013,2778,27-09-2019 08:14:00,1,3812.0,3584.0,0.94,18.989,72,25,12,13,47,14,33,51,0.0,0.04
1013,2779,27-09-2019 08:16:00,1,3918.0,3651.0,0.932,19.48,75,17,5,12,58,20,38,32,0.0,0.03
1013,2780,27-09-2019 08:18:00,1,4123.0,3844.0,0.932,20.502,86,25,5,20,61,21,40,38,0.0,0.12
1013,2781,27-09-2019 08:20:00,1,4109.0,3875.0,0.943,20.478,342,147,104,43,195,142,53,20,0.09,0.0
1013,2782,27-09-2019 08:22:00,1,3998.0,3737.0,0.935,19.891,140,67,50,17,73,49,24,15,0.1,0.0
1013,2783,27-09-2019 08:24:00,1,4087.0,3833.5,0.938,20.3465,205,62,45,17,143,95,48,24,0.02,0.0
1013,2784,27-09-2019 08:26:00,1,4176.0,3930.0,0.941,20.802,101,21,0,21,80,54,26,21,0.0,0.05
1013,2785,27-09-2019 08:28:00,1,4203.0,3967.0,0.944,20.95,84,19,1,18,65,33,32,26,0.0,0.05
1013,2786,27-09-2019 08:30:00,1,4205.0,3917.0,0.932,20.902,397,202,147,55,195,141,54,18,0.15,0.03
1013,2787,27-09-2019 08:32:00,1,3695.0,3573.0,0.967,18.513,689,334,267,67,355,272,83,57,0.06,0.0
1013,2788,27-09-2019 08:34:00,1,3312.0,3157.0,0.953,16.545,67,17,9,8,50,31,19,0,0.0,0.0
1013,2789,27-09-2019 08:36:00,1,3324.0,3112.0,0.936,16.543,204,71,28,43,133,79,54,0,0.0,0.0
1013,2790,27-09-2019 08:38:00,1,3324.0,3096.0,0.931,16.526,136,36,15,21,100,66,34,0,0.0,0.0
1013,2791,27-09-2019 08:40:00,1,3423.0,3179.0,0.929,17.008,21,1,1,0,20,4,16,0,0.0,0.0
1013,2792,27-09-2019 08:42:00,1,3332.0,3094.0,0.929,16.554,13,1,0,1,12,0,12,0,0.0,0.0
1013,2793,27-09-2019 08:44:00,1,3231.0,2994.0,0.927,16.044,16,0,0,0,16,0,16,0,0.0,0.0
1013,2794,27-09-2019 08:46:00,1,3016.0,2892.0,0.959,15.085,28,5,0,5,23,7,16,0,0.0,0.0
1013,2795,27-09-2019 08:48:00,1,3042.0,2760.0,0.907,15.042,5,1,0,1,4,0,4,0,0.0,0.0
1013,2796,27-09-2019 08:50:00,1,2850.0,2601.0,0.913,14.107,42,9,5,4,33,3,30,0,0.0,0.0
1013,2797,27-09-2019 08:52:00,1,2747.0,2526.0,0.92,13.619,19,17,0,17,2,0,2,0,0.01,0.0
1013,2798,27-09-2019 08:54:00,1,2837.0,2612.0,0.921,14.069,13,4,0,4,9,2,7,0,0.0,0.0
1013,2799,27-09-2019 08:56:00,1,2832.0,2632.0,0.929,14.071,32,6,3,3,26,6,20,0,0.0,0.0
1013,2800,27-09-2019 08:58:00,1,2794.5,2560.0,0.916,13.8435,2,1,1,0,1,0,1,0,0.0,0.0
1013,2801,27-09-2019 09:00:00,1,2757.0,2488.0,0.903,13.616,0,0,0,0,0,0,0,0,0.0,0.0
1013,2802,27-09-2019 09:02:00,1,2762.0,2451.0,0.887,13.594,20,5,2,3,15,1,14,0,0.0,0.0
1013,2803,27-09-2019 09:04:00,1,2760.0,2434.0,0.882,13.571,44,16,7,9,28,18,10,0,0.0,0.0
1013,2804,27-09-2019 09:06:00,1,2747.0,2503.0,0.911,13.593,23,1,1,0,22,0,22,0,0.0,0.0
1013,2805,27-09-2019 09:08:00,1,2774.0,2450.0,0.883,13.641,42,4,0,4,38,0,38,0,0.0,0.0
1013,2806,27-09-2019 09:10:00,1,2652.0,2396.0,0.903,13.101,20,5,0,5,15,0,15,0,0.0,0.0
1013,2807,27-09-2019 09:12:00,1,2547.0,2339.0,0.919,12.624,30,9,4,5,21,12,9,0,0.0,0.0
1013,2808,27-09-2019 09:14:00,1,2550.0,2340.0,0.918,12.637,10,0,0,0,10,4,6,0,0.0,0.0
1013,2809,27-09-2019 09:16:00,1,2655.0,2395.0,0.902,13.113,2,0,0,0,2,0,2,0,0.0,0.0
1013,2810,27-09-2019 09:18:00,1,2437.0,2315.0,0.95,12.163,7,2,1,1,5,0,5,0,0.0,0.0
1013,2811,27-09-2019 09:20:00,1,2460.0,2199.0,0.894,12.127,25,3,0,3,22,0,22,0,0.0,0.0
1013,2812,27-09-2019 09:22:00,1,2344.0,2164.0,0.924,11.63,20,0,0,0,20,0,20,0,0.0,0.0
1013,2813,27-09-2019 09:24:00,1,2243.0,2122.0,0.946,11.185,23,7,2,5,16,7,9,0,0.0,0.0
1013,2814,27-09-2019 09:26:00,1,2245.0,2145.0,0.956,11.218,1,1,0,1,0,0,0,0,0.0,0.0
1013,2815,27-09-2019 09:28:00,1,2457.0,2201.0,0.896,12.116,30,2,0,2,28,15,13,0,0.0,0.0
1013,2816,27-09-2019 09:30:00,1,2435.0,2274.0,0.934,12.111,61,23,7,16,38,24,14,0,0.01,0.0
1013,2817,27-09-2019 09:32:00,1,2678.0,2522.5,0.9415,13.343,171,107,81,26,64,42,22,28,0.0,0.0
1013,2818,27-09-2019 09:34:00,1,2921.0,2771.0,0.949,14.575,245,99,77,22,146,101,45,33,0.0,0.0
1013,2819,27-09-2019 09:36:00,1,2896.0,2848.0,0.983,14.564,148,94,61,33,54,31,23,39,0.0,0.06
1013,2820,27-09-2019 09:38:00,1,3401.0,3277.0,0.964,17.027,213,116,86,30,97,56,41,31,0.0,0.0
1013,2821,27-09-2019 09:40:00,1,3418.0,3160.0,0.925,16.967,86,2,2,0,84,37,47,35,0.0,0.03
1013,2822,27-09-2019 09:42:00,1,3878.0,3741.0,0.965,19.421,96,11,1,10,85,53,32,25,0.0,0.03
1013,2823,27-09-2019 09:44:00,1,4090.0,3900.0,0.953,20.43,53,12,0,12,41,19,22,10,0.0,0.1
1013,2824,27-09-2019 09:46:00,1,3994.0,3797.0,0.951,19.94,70,18,1,17,52,19,33,41,0.0,0.0
1013,2825,27-09-2019 09:48:00,1,4012.0,3783.0,0.943,19.996,106,52,26,26,54,32,22,8,0.13,0.09
1013,2826,27-09-2019 09:50:00,1,3101.0,2940.0,0.948,15.471,3,2,1,1,1,0,1,0,0.0,0.0
1013,2827,27-09-2019 09:52:00,1,2956.0,2664.0,0.901,14.598,2,1,1,0,1,0,1,0,0.0,0.0
1013,2828,27-09-2019 09:54:00,1,2945.0,2709.0,0.92,14.6,0,0,0,0,0,0,0,0,0.0,0.0
1013,2829,27-09-2019 09:56:00,1,2932.0,2701.0,0.921,14.541,32,18,9,9,14,8,6,0,0.0,0.0
1013,2830,27-09-2019 09:58:00,1,2941.0,2649.0,0.901,14.519,31,0,0,0,31,0,31,0,0.0,0.0
1013,2831,27-09-2019 10:00:00,1,2962.0,2645.0,0.893,14.598,31,0,0,0,31,0,31,0,0.0,0.0
1013,2832,27-09-2019 10:02:00,1,2950.0,2609.0,0.884,14.512,18,1,0,1,17,2,15,0,0.0,0.0
1013,2833,27-09-2019 10:04:00,1,2950.0,2656.0,0.9,14.565,15,10,1,9,5,3,2,0,0.0,0.0
1013,2834,27-09-2019 10:06:00,1,2950.0,2655.5,0.9,14.5625,38,30,0,30,8,3,5,0,0.0,0.0
1013,2835,27-09-2019 10:08:00,1,2950.0,2655.0,0.9,14.56,8,2,0,2,6,4,2,0,0.01,0.0
1013,2836,27-09-2019 10:10:00,1,2953.0,2708.0,0.917,14.631,48,18,10,8,30,16,14,0,0.0,0.0
1013,2837,27-09-2019 10:12:00,1,2946.0,2670.0,0.906,14.563,82,0,0,0,82,68,14,0,0.0,0.0
1013,2838,27-09-2019 10:14:00,1,2965.0,2630.0,0.887,14.593,126,44,33,11,82,55,27,0,0.0,0.0
1013,2839,27-09-2019 10:16:00,1,2930.0,2742.0,0.936,14.58,10,0,0,0,10,3,7,0,0.0,0.0
1013,2840,27-09-2019 10:18:00,1,2960.0,2676.0,0.904,14.627,0,0,0,0,0,0,0,0,0.0,0.0
1013,2841,27-09-2019 10:20:00,1,2721.0,2600.0,0.956,13.6,20,2,2,0,18,1,17,0,0.0,0.0
1013,2842,27-09-2019 10:22:00,1,2733.0,2526.0,0.924,13.566,165,67,51,16,98,56,42,6,0.0,0.0
1013,2843,27-09-2019 10:24:00,1,2830.0,2647.0,0.935,14.079,3,0,0,0,3,1,2,0,0.0,0.0
1013,2844,27-09-2019 10:26:00,1,2825.0,2677.0,0.948,14.095,13,4,0,4,9,4,5,0,0.0,0.0
1013,2845,27-09-2019 10:28:00,1,2824.0,2668.0,0.945,14.079,13,3,3,0,10,5,5,0,0.0,0.0
1013,2846,27-09-2019 10:30:00,1,2724.0,2549.0,0.936,13.554,14,0,0,0,14,1,13,0,0.0,0.0
1013,2847,27-09-2019 10:32:00,1,2757.0,2496.0,0.906,13.626,4,0,0,0,4,0,4,0,0.0,0.0
1013,2848,27-09-2019 10:34:00,1,2645.0,2456.0,0.928,13.14,61,21,11,10,40,27,13,0,0.0,0.0
1013,2849,27-09-2019 10:36:00,1,2736.0,2538.0,0.927,13.59,122,46,42,4,76,56,20,6,0.0,0.0
1013,2850,27-09-2019 10:38:00,1,2625.0,2443.0,0.931,13.046,7,0,0,0,7,0,7,0,0.0,0.0
1013,2851,27-09-2019 10:40:00,1,2526.5,2399.0,0.9505,12.6095,10,0,0,0,10,1,9,0,0.0,0.0
1013,2852,27-09-2019 10:42:00,1,2428.0,2355.0,0.97,12.173,7,6,0,6,1,1,0,0,0.0,0.0
1013,2853,27-09-2019 10:44:00,1,2437.0,2346.0,0.963,12.196,5,4,2,2,1,0,1,0,0.0,0.0
1013,2854,27-09-2019 10:46:00,1,2534.0,2390.0,0.943,12.629,7,0,0,0,7,2,5,0,0.0,0.0
1013,2855,27-09-2019 10:48:00,1,2638.0,2437.0,0.924,13.092,25,0,0,0,25,9,16,0,0.0,0.0
1013,2856,27-09-2019 10:50:00,1,2648.0,2447.0,0.924,13.143,144,49,12,37,95,45,50,0,0.0,0.0
1013,2857,27-09-2019 10:52:00,1,2837.0,2634.0,0.928,14.095,154,37,15,22,117,88,29,0,0.0,0.0
1013,2858,27-09-2019 10:54:00,1,2906.0,2874.0,0.989,14.632,91,25,10,15,66,36,30,1,0.0,0.0
1013,2859,27-09-2019 10:56:00,1,3130.0,2917.0,0.932,15.56,85,24,5,19,61,30,31,0,0.0,0.0
1013,2860,27-09-2019 10:58:00,1,3103.0,3022.0,0.974,15.569,199,55,29,26,144,93,51,0,0.0,0.0
1013,2861,27-09-2019 11:00:00,1,3088.0,3032.0,0.982,15.525,149,59,36,23,90,54,36,11,0.0,0.0
1013,2862,27-09-2019 11:02:00,1,3619.0,3430.0,0.948,18.056,59,9,0,9,50,9,41,37,0.0,0.0
1013,2863,27-09-2019 11:04:00,1,3788.0,3687.0,0.973,19.007,86,35,24,11,51,36,15,8,0.0,0.39
1013,2864,27-09-2019 11:06:00,1,3209.0,3049.0,0.95,16.018,3,3,0,3,0,0,0,0,0.0,0.0
1013,2865,27-09-2019 11:08:00,1,3460.0,3090.0,0.893,17.054,15,15,2,13,0,0,0,2,0.0,0.0
1013,2866,27-09-2019 11:10:00,1,3629.0,3321.0,0.915,17.977,86,51,23,28,35,17,18,4,0.0,0.0
1013,2867,27-09-2019 11:12:00,1,3994.0,3789.0,0.949,19.932,185,84,64,20,101,78,23,32,0.12,0.0
1013,2868,27-09-2019 11:14:00,1,3891.0,3745.0,0.963,19.4765,616,289,233,56,327,247,80,16,0.16,0.0
1013,2869,27-09-2019 11:16:00,1,3788.0,3701.0,0.977,19.021,200,130,101,29,70,46,24,1,0.06,0.0
1013,2870,27-09-2019 11:18:00,1,3778.0,3707.0,0.981,18.99,764,443,358,85,321,243,78,16,0.01,0.0
1013,2871,27-09-2019 11:20:00,1,4183.0,3980.0,0.951,20.887,421,187,138,49,234,176,58,6,0.0,0.06
1013,2872,27-09-2019 11:22:00,1,3688.0,3520.0,0.954,18.427,77,54,8,46,23,14,9,0,0.0,0.0
1013,2873,27-09-2019 11:24:00,1,3604.0,3474.0,0.964,18.045,82,24,5,19,58,26,32,0,0.0,0.0
1013,2874,27-09-2019 11:26:00,1,3577.0,3453.0,0.965,17.914,63,32,0,32,31,7,24,0,0.0,0.0
1013,2875,27-09-2019 11:28:00,1,3716.0,3504.0,0.943,18.522,1,0,0,0,1,0,1,0,0.0,0.0
1013,2876,27-09-2019 11:30:00,1,3481.0,3382.0,0.971,17.46,6,0,0,0,6,0,6,0,0.01,0.0
1013,2877,27-09-2019 11:32:00,1,3513.0,3316.0,0.944,17.511,5,1,0,1,4,2,2,0,0.0,0.0
1013,2878,27-09-2019 11:34:00,1,3305.0,3218.0,0.974,16.585,0,0,0,0,0,0,0,0,0.0,0.0
1013,2879,27-09-2019 11:36:00,1,3317.0,3088.0,0.931,16.487,60,22,11,11,38,6,32,0,0.0,0.0
1013,2880,27-09-2019 11:38:00,1,3108.0,2986.0,0.961,15.549,14,14,1,13,0,0,0,0,0.0,0.0
1013,2881,27-09-2019 11:40:00,1,3027.0,2856.0,0.943,15.089,23,23,0,23,0,0,0,0,0.0,0.0
1013,2882,27-09-2019 11:42:00,1,2807.0,2734.0,0.974,14.088,25,13,5,8,12,10,2,0,0.0,0.0
1013,2883,27-09-2019 11:44:00,1,2823.0,2683.0,0.95,14.093,9,0,0,0,9,1,8,0,0.0,0.0
1013,2884,27-09-2019 11:46:00,1,2829.0,2644.0,0.935,14.073,0,0,0,0,0,0,0,0,0.0,0.0
1013,2885,27-09-2019 11:48:00,1,2778.5,2633.5,0.948,13.863,42,13,7,6,29,20,9,0,0.0,0.0
1013,2886,27-09-2019 11:50:00,1,2728.0,2623.0,0.961,13.653,130,18,7,11,112,60,52,0,0.0,0.0
1013,2887,27-09-2019 11:52:00,1,2804.0,2743.0,0.978,14.083,144,69,39,30,75,53,22,0,0.0,0.0
1013,2888,27-09-2019 11:54:00,1,3017.0,2922.0,0.969,15.121,101,37,13,24,64,31,33,0,0.0,0.0
1013,2889,27-09-2019 11:56:00,1,3017.0,2906.0,0.963,15.103,22,0,0,0,22,0,22,0,0.0,0.0
1013,2890,27-09-2019 11:58:00,1,2913.0,2819.0,0.968,14.599,3,0,0,0,3,2,1,0,0.0,0.0
1013,2891,27-09-2019 12:00:00,1,2828.0,2743.0,0.97,14.18,0,0,0,0,0,0,0,0,0.0,0.0
1013,2892,27-09-2019 12:02:00,1,2824.0,2652.0,0.939,14.062,20,9,5,4,11,6,5,0,0.0,0.0
1013,2893,27-09-2019 12:04:00,1,2719.0,2625.0,0.965,13.62,36,19,5,14,17,6,11,0,0.01,0.0
1013,2894,27-09-2019 12:06:00,1,2619.0,2545.0,0.971,13.137,8,4,0,4,4,2,2,0,0.0,0.0
1013,2895,27-09-2019 12:08:00,1,2634.0,2480.0,0.942,13.125,55,25,13,12,30,17,13,0,0.0,0.0
1013,2896,27-09-2019 12:10:00,1,2618.0,2568.0,0.981,13.159,47,16,4,12,31,8,23,0,0.0,0.0
1013,2897,27-09-2019 12:12:00,1,2620.0,2548.0,0.972,13.145,7,1,0,1,6,2,4,0,0.0,0.0
1013,2898,27-09-2019 12:14:00,1,2615.0,2502.0,0.957,13.075,72,29,21,8,43,28,15,0,0.0,0.0
1013,2899,27-09-2019 12:16:00,1,2601.0,2598.0,0.999,13.124,244,150,109,41,94,69,25,6,0.0,0.0
1013,2900,27-09-2019 12:18:00,1,2783.0,2774.0,0.997,14.038,0,0,0,0,0,0,0,0,0.0,0.0
1013,2901,27-09-2019 12:20:00,1,2802.0,2748.0,0.981,14.083,0,0,0,0,0,0,0,0,0.0,0.0
1013,2902,27-09-2019 12:22:00,1,2870.5,2744.5,0.957,14.348,0,0,0,0,0,0,0,0,0.0,0.0
1013,2903,27-09-2019 12:24:00,1,2939.0,2741.0,0.933,14.613,47,20,7,13,27,13,14,0,0.0,0.0
1013,2904,27-09-2019 12:26:00,1,2832.0,2682.0,0.947,14.128,5,1,0,1,4,0,4,0,0.0,0.0
1013,2905,27-09-2019 12:28:00,1,2731.0,2550.0,0.934,13.583,0,0,0,0,0,0,0,0,0.0,0.0
1013,2906,27-09-2019 12:30:00,1,2755.0,2484.0,0.902,13.604,9,0,0,0,9,1,8,0,0.0,0.0
1013,2907,27-09-2019 12:32:00,1,2641.0,2465.0,0.933,13.132,7,0,0,0,7,0,7,0,0.0,0.0
1013,2908,27-09-2019 12:34:00,1,2650.0,2426.0,0.915,13.127,19,12,3,9,7,2,5,0,0.0,0.0
1013,2909,27-09-2019 12:36:00,1,2532.0,2434.0,0.961,12.672,7,0,0,0,7,0,7,0,0.0,0.0
1013,2910,27-09-2019 12:38:00,1,2534.0,2405.0,0.949,12.647,16,0,0,0,16,0,16,0,0.0,0.0
1013,2911,27-09-2019 12:40:00,1,2417.0,2356.0,0.975,12.132,15,0,0,0,15,0,15,0,0.0,0.0
1013,2912,27-09-2019 12:42:00,1,2434.0,2314.0,0.951,12.151,3,0,0,0,3,1,2,0,0.0,0.0
1013,2913,27-09-2019 12:44:00,1,2444.0,2275.0,0.931,12.146,20,4,1,3,16,1,15,0,0.0,0.0
1013,2914,27-09-2019 12:46:00,1,2436.0,2309.0,0.948,12.156,11,7,0,7,4,0,4,0,0.0,0.0
1013,2915,27-09-2019 12:48:00,1,2433.0,2291.0,0.941,12.123,49,23,13,10,26,11,15,3,0.0,0.0
1013,2916,27-09-2019 12:50:00,1,2435.0,2289.0,0.94,12.127,16,1,1,0,15,1,14,0,0.0,0.0
1014,1,23-09-2019 11:40:00,1,3660.0,2742.0,0.749,17.458,0,0,0,0,0,0,0,41,0.02,0.0
1014,2,23-09-2019 11:42:00,1,3641.0,2836.0,0.779,17.486,0,0,0,0,0,0,0,61,0.02,0.02
1014,3,23-09-2019 11:44:00,1,3560.0,2681.0,0.753,16.993,225,137,106,31,88,64,24,41,0.0,0.0
1014,4,23-09-2019 11:46:00,1,3482.0,2487.0,0.714,16.473,42,26,4,22,16,0,16,0,0.0,0.0
1014,5,23-09-2019 11:48:00,1,3169.0,2385.0,0.753,15.126,85,43,15,28,42,0,42,0,0.0,0.0
1014,6,23-09-2019 11:50:00,1,3075.0,2267.0,0.737,14.627,111,79,54,25,32,8,24,1,0.0,0.0
1014,7,23-09-2019 11:52:00,1,3080.0,2322.0,0.754,14.707,437,281,212,69,156,113,43,10,0.0,0.0
1014,8,23-09-2019 11:54:00,1,3179.0,2356.0,0.741,15.134,225,167,118,49,58,35,23,48,0.0,0.0
1014,9,23-09-2019 11:56:00,1,2861.0,2174.0,0.76,13.68,401,276,215,61,125,82,43,36,0.0,0.0
1014,10,23-09-2019 11:58:00,1,2900.0,2092.0,0.722,13.741,435,293,222,71,142,102,40,9,0.0,0.0
1014,11,23-09-2019 12:00:00,1,2870.0,2121.0,0.739,13.655,482,279,223,56,203,148,55,23,0.0,0.0
1014,12,23-09-2019 12:02:00,1,2692.0,1987.0,0.738,12.808,192,133,98,35,59,34,25,92,0.0,0.0
1014,13,23-09-2019 12:04:00,1,2699.5,1942.5,0.7195,12.787,202,147,114,33,55,35,20,93,0.0,0.0
1014,14,23-09-2019 12:06:00,1,2707.0,1898.0,0.701,12.766,130,110,77,33,20,9,11,13,0.0,0.0
1014,15,23-09-2019 12:08:00,1,2897.0,2070.0,0.715,13.709,182,113,85,28,69,43,26,5,0.0,0.0
1014,16,23-09-2019 12:10:00,1,2680.0,1986.0,0.741,12.76,46,25,9,16,21,0,21,0,0.0,0.0
1014,17,23-09-2019 12:12:00,1,2684.0,1968.0,0.733,12.756,10,7,0,7,3,0,3,0,0.0,0.0
1014,18,23-09-2019 12:14:00,1,2587.0,1888.0,0.73,12.283,0,0,0,0,0,0,0,0,0.0,0.0
1014,19,23-09-2019 12:16:00,1,2382.0,1724.0,0.724,11.294,14,7,5,2,7,0,7,0,0.0,0.0
1014,20,23-09-2019 12:18:00,1,2172.0,1625.0,0.748,10.359,0,0,0,0,0,0,0,0,0.0,0.0
1014,21,23-09-2019 12:20:00,1,2087.0,1505.0,0.721,9.888,3,2,0,2,1,0,1,0,0.0,0.0
1014,22,23-09-2019 12:22:00,1,2106.0,1462.0,0.694,9.919,0,0,0,0,0,0,0,0,0.0,0.0
1014,23,23-09-2019 12:24:00,1,1880.0,1390.0,0.74,8.945,41,31,14,17,10,0,10,11,0.0,0.0
1014,24,23-09-2019 12:26:00,1,2075.0,1612.0,0.777,9.959,212,129,92,37,83,54,29,64,0.0,0.01
1014,25,23-09-2019 12:28:00,1,2701.0,1916.0,0.709,12.763,238,153,113,40,85,57,28,100,0.0,0.0
1014,26,23-09-2019 12:30:00,1,2404.0,1686.0,0.701,11.339,106,79,52,27,27,10,17,6,0.0,0.0
1014,27,23-09-2019 12:32:00,1,2372.0,1783.0,0.752,11.321,440,278,217,61,162,112,50,4,0.0,0.0
1014,28,23-09-2019 12:34:00,1,2395.0,1689.0,0.705,11.308,346,204,146,58,142,114,28,40,0.0,0.0
1014,29,23-09-2019 12:36:00,1,2381.0,1787.0,0.751,11.358,313,135,99,36,178,132,46,42,0.0,0.01
1014,30,23-09-2019 12:38:00,1,2389.5,1747.5,0.7315,11.3495,342,202,155,47,140,99,41,16,0.0,0.0
1014,31,23-09-2019 12:40:00,1,2398.0,1708.0,0.712,11.341,18,18,5,13,0,0,0,3,0.0,0.0
1014,32,23-09-2019 12:42:00,1,2384.0,1753.0,0.735,11.334,20,20,8,12,0,0,0,0,0.0,0.0
1014,33,23-09-2019 12:44:00,1,2079.0,1538.0,0.74,9.894,1,1,0,1,0,0,0,0,0.0,0.0
1014,34,23-09-2019 12:46:00,1,1879.0,1423.0,0.757,8.979,4,4,2,2,0,0,0,0,0.0,0.0
1014,35,23-09-2019 12:48:00,1,1913.0,1296.0,0.677,8.971,1,1,0,1,0,0,0,0,0.0,0.0
1014,36,23-09-2019 12:50:00,1,1681.0,1237.0,0.736,7.992,3,3,0,3,0,0,0,0,0.0,0.0
1014,37,23-09-2019 12:52:00,1,1696.0,1223.0,0.721,8.036,4,4,2,2,0,0,0,0,0.0,0.0
1014,38,23-09-2019 12:54:00,1,1805.0,1237.0,0.686,8.481,2,0,0,0,2,1,1,0,0.0,0.0
1014,39,23-09-2019 12:56:00,1,1577.0,1191.0,0.755,7.531,0,0,0,0,0,0,0,0,0.0,0.0
1014,40,23-09-2019 12:58:00,1,1591.0,1145.0,0.719,7.536,0,0,0,0,0,0,0,0,0.0,0.0
1014,41,23-09-2019 13:00:00,1,1582.0,1168.0,0.738,7.525,3,0,0,0,3,0,3,0,0.0,0.0
1014,42,23-09-2019 13:02:00,1,1591.0,1172.0,0.737,7.568,0,0,0,0,0,0,0,0,0.0,0.0
1014,43,23-09-2019 13:04:00,1,1604.0,1086.0,0.677,7.524,4,2,2,0,2,1,1,0,0.0,0.0
1014,44,23-09-2019 13:06:00,1,1598.0,1116.0,0.698,7.531,0,0,0,0,0,0,0,0,0.0,0.0
1014,45,23-09-2019 13:08:00,1,1601.0,1137.0,0.71,7.568,1,1,1,0,0,0,0,0,0.0,0.0
1014,46,23-09-2019 13:10:00,1,1594.0,1151.0,0.722,7.556,2,2,1,1,0,0,0,0,0.0,0.0
1014,47,23-09-2019 13:12:00,1,1737.0,1287.5,0.74,8.27,24,19,8,11,5,0,5,0,0.0,0.0
1014,48,23-09-2019 13:14:00,1,1880.0,1424.0,0.758,8.984,200,127,90,37,73,44,29,60,0.0,0.0
1014,49,23-09-2019 13:16:00,1,2364.0,1781.0,0.754,11.285,101,51,36,15,50,27,23,59,0.0,0.0
1014,50,23-09-2019 13:18:00,1,2482.0,1824.0,0.735,11.799,103,61,41,20,42,4,38,55,0.0,0.0
1014,51,23-09-2019 13:20:00,1,2369.0,1794.0,0.757,11.322,298,190,137,53,108,68,40,79,0.0,0.0
1014,52,23-09-2019 13:22:00,1,2699.0,1937.0,0.718,12.778,373,212,163,49,161,119,42,58,0.0,0.0
1014,53,23-09-2019 13:24:00,1,2684.0,2005.0,0.747,12.794,415,223,180,43,192,141,51,63,0.0,0.0
1014,54,23-09-2019 13:26:00,1,2076.0,1559.0,0.751,9.905,54,33,19,14,21,4,17,29,0.0,0.0
1014,55,23-09-2019 13:28:00,1,1565.0,1259.0,0.805,7.558,37,17,0,17,20,0,20,6,0.0,0.0
1014,56,23-09-2019 13:30:00,1,1868.0,1437.0,0.769,8.951,18,2,0,2,16,0,16,1,0.0,0.0
1014,57,23-09-2019 13:32:00,1,1889.0,1388.0,0.735,8.98,42,21,12,9,21,0,21,1,0.0,0.0
1014,58,23-09-2019 13:34:00,1,2099.0,1510.0,0.719,9.942,17,6,0,6,11,0,11,0,0.0,0.0
1014,59,23-09-2019 13:36:00,1,1882.0,1380.0,0.733,8.945,1,1,0,1,0,0,0,0,0.0,0.0
1014,60,23-09-2019 13:38:00,1,1787.0,1296.0,0.725,8.474,2,2,1,1,0,0,0,0,0.0,0.0
1014,61,23-09-2019 13:40:00,1,1587.0,1192.0,0.751,7.573,12,12,0,12,0,0,0,0,0.0,0.0
1014,62,23-09-2019 13:42:00,1,1575.0,1188.0,0.754,7.523,7,7,5,2,0,0,0,0,0.0,0.0
1014,63,23-09-2019 13:44:00,1,1586.0,1169.0,0.737,7.542,1,1,1,0,0,0,0,0,0.0,0.0
1014,64,23-09-2019 13:46:00,1,1687.0,1242.5,0.7365,8.0225,0,0,0,0,0,0,0,0,0.0,0.0
1014,65,23-09-2019 13:48:00,1,1788.0,1316.0,0.736,8.503,0,0,0,0,0,0,0,0,0.0,0.0
1014,66,23-09-2019 13:50:00,1,1901.0,1322.0,0.695,8.952,7,3,0,3,4,0,4,0,0.0,0.0
1014,67,23-09-2019 13:52:00,1,1793.0,1307.0,0.729,8.51,0,0,0,0,0,0,0,0,0.0,0.0
1014,68,23-09-2019 13:54:00,1,1894.0,1321.0,0.697,8.926,0,0,0,0,0,0,0,0,0.0,0.0
1014,69,23-09-2019 13:56:00,1,1907.0,1321.0,0.693,8.976,8,5,2,3,3,0,3,0,0.0,0.0
1014,70,23-09-2019 13:58:00,1,1902.0,1334.0,0.702,8.971,0,0,0,0,0,0,0,0,0.0,0.0
1014,71,23-09-2019 14:00:00,1,1893.0,1370.0,0.724,8.978,1,1,0,1,0,0,0,0,0.0,0.0
1014,72,23-09-2019 14:02:00,1,1917.0,1316.0,0.687,9.009,13,10,2,8,3,0,3,0,0.0,0.0
1014,73,23-09-2019 14:04:00,1,1986.0,1456.0,0.733,9.438,475,354,278,76,121,84,37,31,0.0,0.0
1014,74,23-09-2019 14:06:00,1,2360.0,1820.0,0.771,11.315,294,233,178,55,61,29,32,19,0.0,0.0
1014,75,23-09-2019 14:08:00,1,2702.0,1931.0,0.715,12.786,66,43,23,20,23,12,11,0,0.0,0.0
1014,76,23-09-2019 14:10:00,1,2275.0,1727.0,0.759,10.876,125,59,41,18,66,43,23,76,0.0,0.0
1014,77,23-09-2019 14:12:00,1,2345.0,1878.0,0.801,11.318,262,144,103,41,118,81,37,53,0.0,0.0
1014,78,23-09-2019 14:14:00,1,2065.0,1601.0,0.775,9.909,98,87,57,30,11,5,6,6,0.0,0.0
1014,79,23-09-2019 14:16:00,1,2363.0,1817.0,0.769,11.32,371,294,229,65,77,45,32,34,0.0,0.0
1014,80,23-09-2019 14:18:00,1,2353.0,1862.0,0.791,11.333,435,265,215,50,170,122,48,27,0.0,0.01
1014,81,23-09-2019 14:20:00,1,2164.5,1684.0,0.7765,10.393,164,89,55,34,75,53,22,0,0.0,0.0
1014,82,23-09-2019 14:22:00,1,1976.0,1506.0,0.762,9.453,0,0,0,0,0,0,0,0,0.0,0.0
1014,83,23-09-2019 14:24:00,1,1897.0,1342.0,0.707,8.96,0,0,0,0,0,0,0,0,0.0,0.0
1014,84,23-09-2019 14:26:00,1,1676.0,1282.0,0.765,8.022,0,0,0,0,0,0,0,0,0.0,0.0
1014,85,23-09-2019 14:28:00,1,1588.0,1176.0,0.741,7.558,0,0,0,0,0,0,0,0,0.0,0.0
1014,86,23-09-2019 14:30:00,1,1603.0,1132.0,0.706,7.571,0,0,0,0,0,0,0,0,0.0,0.0
1014,87,23-09-2019 14:32:00,1,1603.0,1105.0,0.69,7.539,2,2,1,1,0,0,0,0,0.0,0.0
1014,88,23-09-2019 14:34:00,1,1604.0,1116.0,0.695,7.557,8,8,2,6,0,0,0,0,0.0,0.0
1014,89,23-09-2019 14:36:00,1,1607.0,1108.0,0.69,7.558,6,6,0,6,0,0,0,0,0.0,0.0
1014,90,23-09-2019 14:38:00,1,1596.0,1110.0,0.695,7.518,0,0,0,0,0,0,0,0,0.0,0.0
1014,91,23-09-2019 14:40:00,1,1612.0,1089.0,0.675,7.559,1,1,0,1,0,0,0,0,0.0,0.0
1014,92,23-09-2019 14:42:00,1,1600.0,1131.0,0.707,7.555,5,5,2,3,0,0,0,0,0.0,0.0
1014,93,23-09-2019 14:44:00,1,1585.0,1151.0,0.726,7.52,0,0,0,0,0,0,0,0,0.0,0.0
1014,94,23-09-2019 14:46:00,1,1590.0,1205.0,0.758,7.599,0,0,0,0,0,0,0,0,0.0,0.0
1014,95,23-09-2019 14:48:00,1,1577.0,1226.0,0.777,7.569,5,5,2,3,0,0,0,0,0.0,0.0
1014,96,23-09-2019 14:50:00,1,1575.0,1221.0,0.775,7.559,5,5,0,5,0,0,0,0,0.0,0.0
1014,97,23-09-2019 14:52:00,1,1591.0,1158.0,0.728,7.55,1,1,0,1,0,0,0,0,0.0,0.0
1014,98,23-09-2019 14:54:00,1,1738.0,1277.5,0.7345,8.261,0,0,0,0,0,0,0,0,0.0,0.0
1014,99,23-09-2019 14:56:00,1,1885.0,1397.0,0.741,8.972,11,11,2,9,0,0,0,0,0.0,0.0
1014,100,23-09-2019 14:58:00,1,1900.0,1364.0,0.718,8.996,11,11,0,11,0,0,0,0,0.0,0.0
1014,101,23-09-2019 15:00:00,1,1788.0,1323.0,0.74,8.51,4,4,2,2,0,0,0,0,0.0,0.0
1014,102,23-09-2019 15:02:00,1,1859.0,1477.0,0.795,8.96,3,3,2,1,0,0,0,0,0.0,0.0
1014,103,23-09-2019 15:04:00,1,2058.0,1608.0,0.781,9.89,1,1,0,1,0,0,0,0,0.0,0.0
1014,104,23-09-2019 15:06:00,1,1877.0,1406.0,0.749,8.952,0,0,0,0,0,0,0,0,0.0,0.0
1014,105,23-09-2019 15:08:00,1,1569.0,1258.0,0.801,7.575,3,2,0,2,1,1,0,0,0.0,0.0
1014,106,23-09-2019 15:10:00,1,1565.0,1234.0,0.789,7.531,15,13,2,11,2,0,2,0,0.0,0.0
1014,107,23-09-2019 15:12:00,1,1797.0,1321.0,0.735,8.543,30,19,2,17,11,0,11,0,0.0,0.0
1014,108,23-09-2019 15:14:00,1,2562.0,1930.0,0.753,12.23,139,103,69,34,36,18,18,54,0.0,0.0
1014,109,23-09-2019 15:16:00,1,1956.0,1551.0,0.793,9.423,69,69,35,34,0,0,0,1,0.0,0.0
1014,110,23-09-2019 15:18:00,1,2067.0,1622.0,0.784,9.942,20,20,4,16,0,0,0,0,0.0,0.0
1014,111,23-09-2019 15:20:00,1,2357.0,1838.0,0.78,11.32,28,28,9,19,0,0,0,1,0.0,0.0
1014,112,23-09-2019 15:22:00,1,2652.0,2036.0,0.768,12.704,31,31,15,16,0,0,0,1,0.0,0.0
1014,113,23-09-2019 15:24:00,1,2659.0,2094.0,0.787,12.793,45,44,10,34,1,0,1,0,0.0,0.0
1014,114,23-09-2019 15:26:00,1,2651.0,2067.0,0.78,12.735,14,14,3,11,0,0,0,0,0.0,0.0
1014,115,23-09-2019 15:28:00,1,2160.0,1692.5,0.785,10.385,1,1,0,1,0,0,0,0,0.0,0.0
1014,116,23-09-2019 15:30:00,1,1669.0,1318.0,0.79,8.035,0,0,0,0,0,0,0,0,0.0,0.0
1014,117,23-09-2019 15:32:00,1,1580.0,1199.0,0.759,7.551,0,0,0,0,0,0,0,0,0.0,0.0
1014,118,23-09-2019 15:34:00,1,1587.0,1155.0,0.728,7.533,1,1,0,1,0,0,0,0,0.0,0.0
1014,119,23-09-2019 15:36:00,1,1590.0,1156.0,0.727,7.547,11,10,4,6,1,1,0,0,0.0,0.0
1014,120,23-09-2019 15:38:00,1,1588.0,1193.0,0.751,7.576,0,0,0,0,0,0,0,0,0.0,0.0
1014,121,23-09-2019 15:40:00,1,1567.0,1210.0,0.772,7.516,0,0,0,0,0,0,0,0,0.0,0.0
1014,122,23-09-2019 15:42:00,1,1581.0,1186.0,0.75,7.543,0,0,0,0,0,0,0,0,0.0,0.0
1014,123,23-09-2019 15:44:00,1,1594.0,1176.0,0.738,7.582,6,6,4,2,0,0,0,0,0.0,0.0
1014,124,23-09-2019 15:46:00,1,1875.0,1424.0,0.76,8.964,3,0,0,0,3,0,3,0,0.0,0.0
1014,125,23-09-2019 15:48:00,1,2089.0,1538.0,0.736,9.935,1,0,0,0,1,0,1,0,0.0,0.0
1014,126,23-09-2019 15:50:00,1,1785.0,1324.0,0.742,8.498,11,11,6,5,0,0,0,0,0.0,0.0
1014,127,23-09-2019 15:52:00,1,1560.0,1287.0,0.825,7.57,0,0,0,0,0,0,0,0,0.0,0.0
1014,128,23-09-2019 15:54:00,1,1791.0,1315.0,0.734,8.515,6,6,3,3,0,0,0,0,0.0,0.0
1014,129,23-09-2019 15:56:00,1,1782.0,1333.0,0.748,8.499,0,0,0,0,0,0,0,0,0.0,0.0
1014,130,23-09-2019 15:58:00,1,1888.0,1355.0,0.717,8.941,0,0,0,0,0,0,0,0,0.0,0.0
1014,131,23-09-2019 16:00:00,1,2068.0,1582.0,0.765,9.898,5,5,4,1,0,0,0,0,0.0,0.0
1014,132,23-09-2019 16:02:00,1,2164.0,1662.0,0.768,10.365,1,1,0,1,0,0,0,0,0.0,0.0
1014,133,23-09-2019 16:04:00,1,2260.0,1742.0,0.771,10.832,5,4,2,2,1,0,1,0,0.0,0.0
1014,134,23-09-2019 16:06:00,1,2053.0,1672.0,0.815,9.94,5,5,4,1,0,0,0,0,0.0,0.0
1014,135,23-09-2019 16:08:00,1,1777.0,1354.0,0.762,8.5,7,7,4,3,0,0,0,0,0.0,0.0
1014,136,23-09-2019 16:10:00,1,1567.0,1262.0,0.805,7.569,5,5,1,4,0,0,0,0,0.0,0.0
1014,137,23-09-2019 16:12:00,1,1567.0,1254.0,0.8,7.563,2,2,0,2,0,0,0,0,0.0,0.0
1014,138,23-09-2019 16:14:00,1,1784.0,1333.0,0.747,8.505,14,14,2,12,0,0,0,0,0.0,0.0
1014,139,23-09-2019 16:16:00,1,1888.0,1398.0,0.74,8.987,13,13,4,9,0,0,0,0,0.0,0.0
1014,140,23-09-2019 16:18:00,1,1857.0,1496.0,0.806,8.973,5,5,1,4,0,0,0,0,0.0,0.0
1014,141,23-09-2019 16:20:00,1,2071.0,1599.0,0.772,9.931,7,7,2,5,0,0,0,0,0.0,0.0
1014,142,23-09-2019 16:22:00,1,2070.0,1573.0,0.76,9.896,1,1,0,1,0,0,0,0,0.0,0.0
1014,143,23-09-2019 16:24:00,1,1853.0,1494.0,0.807,8.954,0,0,0,0,0,0,0,0,0.0,0.0
1014,144,23-09-2019 16:26:00,1,1888.0,1392.0,0.737,8.982,2,2,0,2,0,0,0,0,0.0,0.0
1014,145,23-09-2019 16:28:00,1,1549.0,1280.0,0.827,7.519,0,0,0,0,0,0,0,0,0.0,0.0
1014,146,23-09-2019 16:30:00,1,1669.0,1308.0,0.784,8.024,1,1,0,1,0,0,0,0,0.0,0.0
1014,147,23-09-2019 16:32:00,1,1777.0,1349.0,0.759,8.494,12,12,7,5,0,0,0,0,0.0,0.0
1014,148,23-09-2019 16:34:00,1,1880.0,1438.0,0.765,9.001,33,33,10,23,0,0,0,1,0.0,0.0
1014,149,23-09-2019 16:36:00,1,2014.0,1599.5,0.7925,9.707,142,124,90,34,18,6,12,11,0.0,0.0
1014,150,23-09-2019 16:38:00,1,2148.0,1761.0,0.82,10.413,381,223,168,55,158,106,52,46,0.0,0.0
1014,151,23-09-2019 16:40:00,1,2358.0,1836.0,0.779,11.323,82,63,40,23,19,13,6,32,0.0,0.0
1014,152,23-09-2019 16:42:00,1,1866.0,1484.0,0.795,8.996,59,40,17,23,19,2,17,7,0.0,0.0
1014,153,23-09-2019 16:44:00,1,1771.0,1379.0,0.778,8.505,12,12,3,9,0,0,0,2,0.0,0.0
1014,154,23-09-2019 16:46:00,1,1953.0,1559.0,0.798,9.421,29,29,9,20,0,0,0,10,0.0,0.0
1014,155,23-09-2019 16:48:00,1,2020.0,1720.0,0.851,9.862,14,11,6,5,3,0,3,0,0.0,0.0
1014,156,23-09-2019 16:50:00,1,1962.0,1543.0,0.787,9.439,2,1,0,1,1,0,1,0,0.0,0.0
1014,157,23-09-2019 16:52:00,1,1775.0,1351.0,0.761,8.492,1,1,1,0,0,0,0,0,0.0,0.0
1014,158,23-09-2019 16:54:00,1,1586.0,1188.0,0.749,7.564,6,6,0,6,0,0,0,0,0.0,0.0
1014,159,23-09-2019 16:56:00,1,1605.0,1138.0,0.709,7.583,2,2,0,2,0,0,0,0,0.0,0.0
1014,160,23-09-2019 16:58:00,1,1594.0,1136.0,0.713,7.537,13,9,5,4,4,0,4,0,0.0,0.0
1014,161,23-09-2019 17:00:00,1,1584.0,1183.0,0.747,7.549,1,0,0,0,1,0,1,0,0.0,0.0
1014,162,23-09-2019 17:02:00,1,1579.0,1198.0,0.759,7.547,3,1,0,1,2,0,2,0,0.0,0.0
1014,163,23-09-2019 17:04:00,1,1560.0,1303.0,0.835,7.59,0,0,0,0,0,0,0,0,0.0,0.0
1014,164,23-09-2019 17:06:00,1,1880.0,1393.0,0.741,8.947,0,0,0,0,0,0,0,0,0.0,0.0
1014,165,23-09-2019 17:08:00,1,1880.0,1422.0,0.756,8.983,0,0,0,0,0,0,0,0,0.0,0.0
1014,166,23-09-2019 17:10:00,1,1876.0,1437.0,0.766,8.983,1,1,0,1,0,0,0,0,0.0,0.0
1014,167,23-09-2019 17:12:00,1,1872.0,1452.0,0.776,8.983,0,0,0,0,0,0,0,0,0.0,0.0
1014,168,23-09-2019 17:14:00,1,1885.0,1412.0,0.749,8.99,0,0,0,0,0,0,0,0,0.0,0.0
1014,169,23-09-2019 17:16:00,1,1884.0,1394.0,0.74,8.967,12,11,7,4,1,0,1,0,0.0,0.0
1014,170,23-09-2019 17:18:00,1,1564.0,1294.0,0.827,7.596,0,0,0,0,0,0,0,0,0.0,0.0
1014,171,23-09-2019 17:20:00,1,1586.0,1162.0,0.733,7.535,3,3,2,1,0,0,0,0,0.0,0.0
1014,172,23-09-2019 17:22:00,1,1594.0,1160.0,0.728,7.566,0,0,0,0,0,0,0,0,0.0,0.0
1014,173,23-09-2019 17:24:00,1,1569.0,1230.0,0.784,7.544,0,0,0,0,0,0,0,0,0.0,0.0
1014,174,23-09-2019 17:26:00,1,1565.0,1249.0,0.798,7.549,14,14,4,10,0,0,0,0,0.0,0.0
1014,175,23-09-2019 17:28:00,1,1567.0,1271.0,0.811,7.583,4,4,0,4,0,0,0,0,0.0,0.0
1014,176,23-09-2019 17:30:00,1,1558.0,1290.0,0.828,7.565,1,1,0,1,0,0,0,0,0.0,0.0
1014,177,23-09-2019 17:32:00,1,1546.0,1288.0,0.833,7.518,2,2,1,1,0,0,0,0,0.0,0.0
1014,178,23-09-2019 17:34:00,1,1560.0,1293.0,0.829,7.578,1,1,0,1,0,0,0,0,0.0,0.0
1014,179,23-09-2019 17:36:00,1,1557.0,1279.0,0.821,7.551,1,1,0,1,0,0,0,0,0.0,0.0
1014,180,23-09-2019 17:38:00,1,1586.0,1156.0,0.729,7.529,0,0,0,0,0,0,0,0,0.0,0.0
1014,181,23-09-2019 17:40:00,1,1491.0,1108.0,0.743,7.101,11,9,6,3,2,0,2,1,0.0,0.0
1014,182,23-09-2019 17:42:00,1,1595.0,1167.0,0.732,7.575,0,0,0,0,0,0,0,0,0.0,0.0
1014,183,23-09-2019 17:44:00,1,1581.5,1211.5,0.7665,7.5715,6,6,3,3,0,0,0,1,0.0,0.0
1014,184,23-09-2019 17:46:00,1,1568.0,1256.0,0.801,7.568,8,8,3,5,0,0,0,0,0.0,0.0
1014,185,23-09-2019 17:48:00,1,1668.0,1323.0,0.794,8.035,4,4,1,3,0,0,0,0,0.0,0.0
1014,186,23-09-2019 17:50:00,1,1766.0,1339.0,0.759,8.439,12,12,3,9,0,0,0,0,0.0,0.0
1014,187,23-09-2019 17:52:00,1,1780.0,1340.0,0.753,8.496,2,2,0,2,0,0,0,0,0.0,0.0
1014,188,23-09-2019 17:54:00,1,1563.0,1287.0,0.823,7.581,56,47,24,23,9,0,9,3,0.0,0.0
1014,189,23-09-2019 17:56:00,1,1543.0,1291.0,0.837,7.51,1,0,0,0,1,1,0,0,0.0,0.0
1014,190,23-09-2019 17:58:00,1,1576.0,1236.0,0.784,7.577,0,0,0,0,0,0,0,0,0.0,0.0
1014,191,23-09-2019 18:00:00,0,1564.0,1237.0,0.791,7.533,0,0,0,0,0,0,0,0,0.0,0.0
1014,192,23-09-2019 18:02:00,0,1563.0,1244.0,0.796,7.534,0,0,0,0,0,0,0,0,0.0,0.0
1014,193,23-09-2019 18:04:00,0,1554.0,1310.0,0.843,7.571,3,3,1,2,0,0,0,0,0.0,0.0
1014,194,23-09-2019 18:06:00,0,1558.0,1289.0,0.827,7.567,2,2,0,2,0,0,0,0,0.0,0.0
1014,195,23-09-2019 18:08:00,0,1559.0,1243.0,0.798,7.517,2,2,1,1,0,0,0,0,0.0,0.0
1014,196,23-09-2019 18:10:00,0,1564.0,1273.0,0.814,7.574,2,1,1,0,1,1,0,0,0.0,0.0
1014,197,23-09-2019 18:12:00,0,1563.0,1268.0,0.811,7.564,200,115,86,29,85,56,29,52,0.0,0.0
1014,198,23-09-2019 18:14:00,0,1850.0,1497.0,0.809,8.948,73,68,34,34,5,0,5,16,0.0,0.0
1014,199,23-09-2019 18:16:00,0,2042.0,1718.0,0.841,9.949,59,59,25,34,0,0,0,11,0.0,0.0
1014,200,23-09-2019 18:18:00,0,2367.0,1837.0,0.784,11.3605,64,47,18,29,17,0,17,3,0.0,0.0
1014,201,23-09-2019 18:20:00,0,2692.0,1956.0,0.727,12.772,262,177,129,48,85,47,38,114,0.0,0.0
1014,202,23-09-2019 18:22:00,0,2783.0,2020.0,0.726,13.201,152,93,56,37,59,6,53,60,0.0,0.0
1014,203,23-09-2019 18:24:00,0,2762.0,2082.0,0.754,13.189,309,189,153,36,120,69,51,162,0.0,0.0
1014,204,23-09-2019 18:26:00,0,2903.0,2089.0,0.72,13.75,202,149,106,43,53,24,29,67,0.0,0.0
1014,205,23-09-2019 18:28:00,0,2991.0,2144.0,0.717,14.159,287,172,131,41,115,77,38,123,0.0,0.0
1014,206,23-09-2019 18:30:00,0,2964.0,2220.0,0.749,14.138,127,89,58,31,38,9,29,60,0.0,0.0
1014,207,23-09-2019 18:32:00,0,2779.0,2097.0,0.755,13.271,112,90,65,25,22,11,11,18,0.0,0.0
1014,208,23-09-2019 18:34:00,0,2258.0,1758.0,0.779,10.845,223,135,103,32,88,59,29,81,0.0,0.0
1014,209,23-09-2019 18:36:00,0,2882.0,2082.0,0.722,13.659,160,99,67,32,61,27,34,54,0.0,0.0
1014,210,23-09-2019 18:38:00,0,2967.0,2240.0,0.755,14.172,140,70,40,30,70,41,29,40,0.0,0.0
1014,211,23-09-2019 18:40:00,0,3061.0,2316.0,0.757,14.625,164,116,88,28,48,14,34,62,0.0,0.0
1014,212,23-09-2019 18:42:00,0,3065.0,2396.0,0.782,14.727,167,116,87,29,51,15,36,60,0.0,0.0
1014,213,23-09-2019 18:44:00,0,2932.0,2316.0,0.79,14.118,261,180,139,41,81,51,30,47,0.0,0.01
1014,214,23-09-2019 18:46:00,0,2942.0,2305.0,0.783,14.143,361,206,153,53,155,115,40,111,0.0,0.03
1014,215,23-09-2019 18:48:00,0,2768.0,2121.0,0.766,13.255,377,206,166,40,171,141,30,167,0.0,0.0
1014,216,23-09-2019 18:50:00,0,2756.0,2085.0,0.756,13.168,215,145,117,28,70,41,29,48,0.0,0.0
1014,217,23-09-2019 18:52:00,0,2862.5,2205.0,0.7695,13.7205,144,88,43,45,56,37,19,23,0.0,0.0
1014,218,23-09-2019 18:54:00,0,2969.0,2325.0,0.783,14.273,101,68,38,30,33,20,13,28,0.0,0.0
1014,219,23-09-2019 18:56:00,0,2950.0,2224.0,0.754,14.085,301,188,135,53,113,85,28,143,0.0,0.0
1014,220,23-09-2019 18:58:00,0,2787.0,2093.0,0.751,13.299,239,140,100,40,99,62,37,60,0.0,0.0
1014,221,23-09-2019 19:00:00,0,3217.0,2580.0,0.802,15.531,181,122,81,41,59,14,45,60,0.0,0.0
1014,222,23-09-2019 19:02:00,0,3244.0,2566.0,0.791,15.624,131,98,64,34,33,8,25,52,0.0,0.0
1014,223,23-09-2019 19:04:00,0,3333.0,2649.0,0.795,16.064,217,163,120,43,54,6,48,61,0.0,0.0
1014,224,23-09-2019 19:06:00,0,3018.0,2466.0,0.817,14.622,181,138,94,44,43,10,33,54,0.0,0.1
1014,225,23-09-2019 19:08:00,0,2911.0,2494.0,0.857,14.229,337,192,156,36,145,112,33,103,0.0,0.0
1014,226,23-09-2019 19:10:00,0,3407.0,2767.0,0.812,16.488,306,202,148,54,104,69,35,93,0.0,0.0
1014,227,23-09-2019 19:12:00,0,2999.0,2522.0,0.841,14.609,187,128,84,44,59,9,50,66,0.0,0.0
1014,228,23-09-2019 19:14:00,0,3225.0,2645.0,0.82,15.636,178,138,104,34,40,13,27,59,0.0,0.0
1014,229,23-09-2019 19:16:00,0,2725.0,2231.0,0.819,13.205,321,198,148,50,123,77,46,86,0.0,0.0
1014,230,23-09-2019 19:18:00,0,3003.0,2579.0,0.859,14.686,285,172,126,46,113,76,37,82,0.0,0.0
1014,231,23-09-2019 19:20:00,0,2903.0,2465.0,0.849,14.167,132,97,62,35,35,4,31,51,0.0,0.4
1014,232,23-09-2019 19:22:00,0,3184.0,2711.0,0.852,15.547,49,28,15,13,21,2,19,9,0.0,0.0
1014,233,23-09-2019 19:24:00,0,2898.0,2486.0,0.858,14.169,1,0,0,0,1,0,1,0,0.0,0.0
1014,234,23-09-2019 19:26:00,0,2891.5,2488.5,0.861,14.146,0,0,0,0,0,0,0,0,0.0,0.0
1014,235,23-09-2019 19:28:00,0,2885.0,2491.0,0.864,14.123,225,124,82,42,101,64,37,32,0.0,0.0
1014,236,23-09-2019 19:30:00,0,2875.0,2580.0,0.897,14.185,412,213,166,47,199,153,46,135,0.0,0.0
1014,237,23-09-2019 19:32:00,0,2886.0,2561.0,0.887,14.207,111,77,57,20,34,21,13,23,0.0,0.0
1014,238,23-09-2019 19:34:00,0,2429.0,2054.0,0.845,11.846,24,23,10,13,1,0,1,5,0.0,0.0
1014,239,23-09-2019 19:36:00,0,2101.0,1894.0,0.901,10.377,40,30,12,18,10,2,8,7,0.0,0.0
1014,240,23-09-2019 19:38:00,0,2102.0,1963.0,0.934,10.456,52,52,20,32,0,0,0,5,0.0,0.0
1014,241,23-09-2019 19:40:00,0,2425.0,2065.0,0.852,11.839,49,43,15,28,6,0,6,0,0.0,0.0
1014,242,23-09-2019 19:42:00,0,2720.0,2314.0,0.851,13.28,174,87,63,24,87,56,31,88,0.0,0.0
1014,243,23-09-2019 19:44:00,0,2667.0,2417.0,0.906,13.186,227,130,105,25,97,62,35,75,0.0,0.0
1014,244,23-09-2019 19:46:00,0,2683.0,2355.0,0.878,13.177,318,107,77,30,211,181,30,38,0.0,0.0
1014,245,23-09-2019 19:48:00,0,2613.0,2244.0,0.859,12.78,68,50,38,12,18,15,3,14,0.0,0.0
1014,246,23-09-2019 19:50:00,0,2101.0,1910.0,0.909,10.393,12,11,2,9,1,1,0,0,0.0,0.0
1014,247,23-09-2019 19:52:00,0,1926.0,1719.0,0.892,9.49,0,0,0,0,0,0,0,0,0.02,0.0
1014,248,23-09-2019 19:54:00,0,1723.0,1547.0,0.898,8.502,4,0,0,0,4,0,4,0,0.0,0.0
1014,249,23-09-2019 19:56:00,0,1634.0,1459.0,0.893,8.053,1,0,0,0,1,0,1,0,0.0,0.0
1014,250,23-09-2019 19:58:00,0,1735.0,1511.0,0.871,8.507,20,15,6,9,5,0,5,0,0.0,0.0
1014,251,23-09-2019 20:00:00,0,1831.5,1619.5,0.8835,9.008,13,13,2,11,0,0,0,0,0.0,0.0
1014,252,23-09-2019 20:02:00,0,1928.0,1728.0,0.896,9.509,4,3,0,3,1,0,1,0,0.0,0.0
1014,253,23-09-2019 20:04:00,0,1922.0,1699.0,0.884,9.455,1,1,0,1,0,0,0,0,0.0,0.0
1014,254,23-09-2019 20:06:00,0,1917.0,1674.0,0.874,9.405,8,7,2,5,1,0,1,0,0.0,0.0
1014,255,23-09-2019 20:08:00,0,1833.0,1599.0,0.872,8.994,17,9,6,3,8,4,4,0,0.01,0.0
1014,256,23-09-2019 20:10:00,0,1637.0,1472.0,0.899,8.08,3,3,1,2,0,0,0,0,0.0,0.0
1014,257,23-09-2019 20:12:00,0,1829.0,1600.0,0.875,8.977,0,0,0,0,0,0,0,0,0.0,0.0
1014,258,23-09-2019 20:14:00,0,1709.0,1573.0,0.921,8.474,55,19,9,10,36,3,33,0,0.0,0.0
1014,259,23-09-2019 20:16:00,0,1908.0,1736.0,0.91,9.439,222,134,97,37,88,65,23,23,0.0,0.0
1014,260,23-09-2019 20:18:00,0,1890.0,1810.0,0.958,9.45,62,47,18,29,15,0,15,1,0.0,0.0
1014,261,23-09-2019 20:20:00,0,2082.0,2035.0,0.977,10.458,39,30,6,24,9,1,8,7,0.0,0.0
1014,262,23-09-2019 20:22:00,0,2575.0,2355.0,0.915,12.753,158,102,67,35,56,35,21,37,0.0,0.0
1014,263,23-09-2019 20:24:00,0,2356.0,2285.0,0.97,11.811,279,146,115,31,133,100,33,159,0.0,0.0
1014,264,23-09-2019 20:26:00,0,3025.0,2846.0,0.941,15.071,309,152,117,35,157,116,41,124,0.01,0.0
1014,265,23-09-2019 20:28:00,0,3108.0,3005.0,0.967,15.573,288,120,86,34,168,122,46,16,0.0,0.0
1014,266,23-09-2019 20:30:00,0,2867.0,2671.0,0.932,14.254,184,114,84,30,70,4,66,74,0.0,0.0
1014,267,23-09-2019 20:32:00,0,3228.0,3045.0,0.943,16.09,136,95,65,30,41,5,36,55,0.0,0.0
1014,268,23-09-2019 20:34:00,0,3227.5,3055.0,0.9465,16.0985,146,107,71,36,39,12,27,53,0.0,0.0
1014,269,23-09-2019 20:36:00,0,3227.0,3065.0,0.95,16.107,186,89,60,29,97,48,49,34,0.0,0.0
1014,270,23-09-2019 20:38:00,0,3312.0,3181.0,0.96,16.57,260,134,91,43,126,78,48,89,0.2,0.0
1014,271,23-09-2019 20:40:00,0,3226.0,3069.0,0.951,16.108,123,94,69,25,29,3,26,29,0.0,0.0
1014,272,23-09-2019 20:42:00,0,2464.0,2343.0,0.951,12.3,256,154,119,35,102,77,25,59,0.0,0.01
1014,273,23-09-2019 20:44:00,0,2720.0,2753.0,1.012,13.762,131,80,50,30,51,13,38,43,0.01,0.02
1014,274,23-09-2019 20:46:00,0,3322.0,3079.0,0.927,16.496,106,67,44,23,39,2,37,47,0.0,0.08
1014,275,23-09-2019 20:48:00,0,2252.0,2262.0,1.005,11.375,239,145,102,43,94,67,27,41,0.15,0.0
1014,276,23-09-2019 20:50:00,0,3032.0,2893.0,0.954,15.148,240,116,85,31,124,88,36,98,0.03,0.0
1014,277,23-09-2019 20:52:00,0,2646.0,2562.0,0.968,13.26,133,82,52,30,51,19,32,35,0.0,0.1
1014,278,23-09-2019 20:54:00,0,3031.0,2845.0,0.939,15.09,179,126,82,44,53,0,53,75,0.0,0.0
1014,279,23-09-2019 20:56:00,0,3325.0,3112.0,0.936,16.546,208,156,110,46,52,8,44,73,0.0,0.0
1014,280,23-09-2019 20:58:00,0,3009.0,2924.0,0.972,15.094,308,178,133,45,130,71,59,65,0.02,0.0
1014,281,23-09-2019 21:00:00,0,2933.0,2873.0,0.979,14.735,353,198,156,42,155,113,42,122,0.06,0.0
1014,282,23-09-2019 21:02:00,0,3008.0,2951.0,0.981,15.12,136,87,59,28,49,6,43,71,0.04,0.0
1014,283,23-09-2019 21:04:00,0,3032.0,2915.0,0.961,15.175,107,64,43,21,43,11,32,60,0.0,0.0
1014,284,23-09-2019 21:06:00,0,3024.0,2872.0,0.95,15.095,118,75,48,27,43,0,43,47,0.0,0.0
1014,285,23-09-2019 21:08:00,0,3130.0,2974.0,0.9505,15.626,151,108,74,34,43,0,43,57,0.0,0.02
1014,286,23-09-2019 21:10:00,0,3236.0,3076.0,0.951,16.157,198,103,80,23,95,48,47,41,0.04,0.08
1014,287,23-09-2019 21:12:00,0,2723.0,2682.0,0.985,13.697,235,95,74,21,140,109,31,38,0.03,0.0
1014,288,23-09-2019 21:14:00,0,2940.0,2805.0,0.954,14.687,163,111,77,34,52,13,39,60,0.0,0.0
1014,289,23-09-2019 21:16:00,0,3116.0,3035.0,0.974,15.636,40,19,15,4,21,1,20,25,0.0,0.44
1014,290,23-09-2019 21:18:00,0,2710.0,2713.0,1.001,13.683,169,79,58,21,90,69,21,6,0.0,0.01
1014,291,23-09-2019 21:20:00,0,2821.0,2802.0,0.993,14.217,236,112,79,33,124,82,42,30,0.12,0.02
1014,292,23-09-2019 21:22:00,0,2269.0,2222.0,0.979,11.401,417,167,129,38,250,215,35,55,0.0,0.01
1014,293,23-09-2019 21:24:00,0,2992.0,3034.0,1.014,15.148,273,194,142,52,79,53,26,35,0.0,0.0
1014,294,23-09-2019 21:26:00,0,3004.0,2990.0,0.995,15.147,455,138,104,34,317,272,45,111,0.0,0.0
1014,295,23-09-2019 21:28:00,0,2575.0,2401.0,0.933,12.803,180,89,68,21,91,72,19,94,0.03,0.0
1014,296,23-09-2019 21:30:00,0,2754.0,2556.0,0.928,13.682,18,18,1,17,0,0,0,0,0.0,0.01
1014,297,23-09-2019 21:32:00,0,2554.0,2496.0,0.977,12.827,377,180,147,33,197,164,33,23,0.06,0.0
1014,298,23-09-2019 21:34:00,0,2838.0,2713.0,0.956,14.184,451,195,153,42,256,205,51,67,0.04,0.0
1014,299,23-09-2019 21:36:00,0,3028.0,2955.0,0.976,15.199,813,309,236,73,504,454,50,5,0.03,0.0
1014,300,23-09-2019 21:38:00,0,2634.0,2547.0,0.967,13.199,296,124,94,30,172,128,44,37,0.05,0.0
1014,301,23-09-2019 21:40:00,0,2796.0,2879.0,1.03,14.204,304,181,138,43,123,83,40,75,0.02,0.01
1014,302,23-09-2019 21:42:00,0,3057.5,3047.0,0.9995,15.4195,92,7,5,2,85,52,33,0,0.02,0.0
1014,303,23-09-2019 21:44:00,0,3319.0,3215.0,0.969,16.635,98,7,2,5,91,55,36,3,0.0,0.0
1014,304,23-09-2019 21:46:00,0,2914.0,2901.0,0.996,14.693,425,140,100,40,285,239,46,9,0.05,0.0
1014,305,23-09-2019 21:48:00,0,2638.0,2545.0,0.965,13.211,432,152,116,36,280,232,48,8,0.0,0.02
1014,306,23-09-2019 21:50:00,0,2821.0,2835.0,1.005,14.253,105,56,31,25,49,36,13,3,0.04,0.0
1014,307,23-09-2019 21:52:00,0,1992.0,1878.0,0.942,9.928,42,42,23,19,0,0,0,0,0.0,0.0
1014,308,23-09-2019 21:54:00,0,2004.0,1891.0,0.944,9.987,58,52,22,30,6,2,4,3,0.0,0.0
1014,309,23-09-2019 21:56:00,0,2477.0,2292.0,0.925,12.297,39,34,13,21,5,2,3,0,0.0,0.0
1014,310,23-09-2019 21:58:00,0,2593.0,2329.0,0.898,12.795,19,11,8,3,8,2,6,0,0.0,0.0
1014,311,23-09-2019 22:00:00,0,2560.0,2362.0,0.922,12.703,10,7,5,2,3,1,2,0,0.0,0.0
1014,312,23-09-2019 22:02:00,0,2301.0,2073.0,0.901,11.36,10,5,3,2,5,1,4,0,0.02,0.0
1014,313,23-09-2019 22:04:00,0,1956.0,2025.0,1.035,9.948,0,0,0,0,0,0,0,0,0.0,0.0
1014,314,23-09-2019 22:06:00,0,1984.0,1907.0,0.961,9.928,2,0,0,0,2,1,1,0,0.0,0.0
1014,315,23-09-2019 22:08:00,0,1992.0,1859.0,0.933,9.906,1,0,0,0,1,0,1,0,0.0,0.0
1014,316,23-09-2019 22:10:00,0,1780.0,1818.0,1.022,9.025,11,0,0,0,11,0,11,0,0.0,0.0
1014,317,23-09-2019 22:12:00,0,1998.0,1853.0,0.927,9.924,8,0,0,0,8,0,8,0,0.0,0.0
1014,318,23-09-2019 22:14:00,0,1974.0,1952.0,0.989,9.937,0,0,0,0,0,0,0,0,0.0,0.0
1014,319,23-09-2019 22:16:00,0,2021.0,2002.0,0.991,10.178,0,0,0,0,0,0,0,0,0.0,0.0
1014,320,23-09-2019 22:18:00,0,2068.0,2052.0,0.993,10.419,1,1,0,1,0,0,0,0,0.0,0.0
1014,321,23-09-2019 22:20:00,0,2096.0,1945.0,0.928,10.412,9,6,4,2,3,1,2,0,0.0,0.0
1014,322,23-09-2019 22:22:00,0,2085.0,2018.0,0.967,10.45,0,0,0,0,0,0,0,0,0.0,0.0
1014,323,23-09-2019 22:24:00,0,2091.0,1965.0,0.94,10.415,1,1,1,0,0,0,0,0,0.0,0.0
1014,324,23-09-2019 22:26:00,0,2097.0,1970.0,0.94,10.444,26,23,13,10,3,0,3,0,0.0,0.0
1014,325,23-09-2019 22:28:00,0,2338.0,2359.0,1.009,11.822,403,223,184,39,180,136,44,69,0.0,0.0
1014,326,23-09-2019 22:30:00,0,2640.0,2529.0,0.958,13.2,225,83,58,25,142,107,35,71,0.0,0.0
1014,327,23-09-2019 22:32:00,0,2565.0,2458.0,0.958,12.827,375,237,182,55,138,104,34,0,0.0,0.0
1014,328,23-09-2019 22:34:00,0,2629.0,2621.0,0.997,13.259,741,443,357,86,298,224,74,1,0.0,0.0
1014,329,23-09-2019 22:36:00,0,2629.0,2621.0,0.997,13.261,373,217,172,45,156,107,49,117,0.0,0.0
1014,330,23-09-2019 22:38:00,0,2718.0,2655.0,0.977,13.649,431,236,191,45,195,152,43,26,0.0,0.0
1014,331,23-09-2019 22:40:00,0,2743.0,2664.0,0.971,13.758,263,143,99,44,120,81,39,14,0.0,0.06
1014,332,23-09-2019 22:42:00,0,2838.0,2709.0,0.955,14.181,314,164,117,47,150,107,43,61,0.0,0.0
1014,333,23-09-2019 22:44:00,0,2640.0,2539.0,0.962,13.211,39,31,13,18,8,0,8,8,0.0,0.0
1014,334,23-09-2019 22:46:00,0,2668.0,2531.0,0.949,13.313,48,34,9,25,14,2,12,9,0.04,0.0
1014,335,23-09-2019 22:48:00,0,2753.0,2607.0,0.947,13.733,64,37,21,16,27,2,25,1,0.0,0.0
1014,336,23-09-2019 22:50:00,0,2557.5,2450.5,0.959,12.789,0,0,0,0,0,0,0,0,0.0,0.0
1014,337,23-09-2019 22:52:00,0,2362.0,2294.0,0.971,11.845,5,5,1,4,0,0,0,0,0.0,0.0
1014,338,23-09-2019 22:54:00,0,2368.0,2228.0,0.941,11.797,2,2,0,2,0,0,0,0,0.0,0.0
1014,339,23-09-2019 22:56:00,0,2378.0,2253.0,0.947,11.862,10,5,0,5,5,0,5,0,0.0,0.0
1014,340,23-09-2019 22:58:00,0,2271.0,2151.0,0.947,11.329,0,0,0,0,0,0,0,0,0.0,0.0
1014,341,23-09-2019 23:00:00,0,2057.0,2052.0,0.998,10.378,28,17,8,9,11,0,11,0,0.0,0.0
1014,342,23-09-2019 23:02:00,0,2080.0,2064.0,0.993,10.479,10,10,0,10,0,0,0,0,0.0,0.0
1014,343,23-09-2019 23:04:00,0,2068.0,2012.0,0.973,10.377,4,4,0,4,0,0,0,0,0.0,0.0
1014,344,23-09-2019 23:06:00,0,2083.0,1961.0,0.941,10.38,0,0,0,0,0,0,0,0,0.0,0.0
1014,345,23-09-2019 23:08:00,0,1867.0,1909.0,1.023,9.47,9,7,5,2,2,0,2,0,0.0,0.0
1014,346,23-09-2019 23:10:00,0,1877.0,1873.0,0.998,9.469,0,0,0,0,0,0,0,0,0.0,0.0
1014,347,23-09-2019 23:12:00,0,1904.0,1808.0,0.95,9.504,25,19,16,3,6,2,4,0,0.0,0.0
1014,348,23-09-2019 23:14:00,0,1887.0,1817.0,0.963,9.444,1,1,0,1,0,0,0,0,0.0,0.0
1014,349,23-09-2019 23:16:00,0,1896.0,1814.0,0.957,9.477,49,39,31,8,10,1,9,5,0.0,0.0
1014,350,23-09-2019 23:18:00,0,1882.0,1841.0,0.978,9.452,135,64,41,23,71,49,22,24,0.0,0.0
1014,351,23-09-2019 23:20:00,0,1883.0,1864.0,0.99,9.484,4,4,1,3,0,0,0,0,0.0,0.0
1014,352,23-09-2019 23:22:00,0,1896.0,1821.0,0.96,9.486,0,0,0,0,0,0,0,0,0.0,0.0
1014,353,23-09-2019 23:24:00,0,1899.0,1805.0,0.95,9.4805,2,2,0,2,0,0,0,0,0.0,0.0
1014,354,23-09-2019 23:26:00,0,1902.0,1789.0,0.94,9.475,4,4,0,4,0,0,0,0,0.0,0.0
1014,355,23-09-2019 23:28:00,0,1895.0,1772.0,0.935,9.428,6,4,3,1,2,0,2,0,0.0,0.0
1014,356,23-09-2019 23:30:00,0,1894.0,1764.0,0.931,9.417,0,0,0,0,0,0,0,0,0.0,0.0
1014,357,23-09-2019 23:32:00,0,1807.0,1726.0,0.955,9.03,32,31,18,13,1,0,1,0,0.0,0.0
1014,358,23-09-2019 23:34:00,0,1797.0,1674.0,0.932,8.933,0,0,0,0,0,0,0,0,0.0,0.0
1014,359,23-09-2019 23:36:00,0,1577.0,1646.0,1.044,8.036,7,5,2,3,2,0,2,0,0.0,0.0
1014,360,23-09-2019 23:38:00,0,1907.0,1716.0,0.9,9.412,0,0,0,0,0,0,0,0,0.0,0.0
1014,361,23-09-2019 23:40:00,0,1917.0,1729.0,0.902,9.467,9,5,0,5,4,0,4,0,0.0,0.0
1014,362,23-09-2019 23:42:00,0,1909.0,1749.0,0.916,9.457,8,8,0,8,0,0,0,0,0.0,0.0
1014,363,23-09-2019 23:44:00,0,1893.0,1793.0,0.947,9.443,10,5,0,5,5,0,5,0,0.0,0.0
1014,364,23-09-2019 23:46:00,0,1912.0,1732.0,0.906,9.449,3,3,1,2,0,0,0,0,0.0,0.0
1014,365,23-09-2019 23:48:00,0,1803.0,1704.0,0.945,8.989,0,0,0,0,0,0,0,0,0.0,0.0
1014,366,23-09-2019 23:50:00,0,1911.0,1732.0,0.906,9.448,36,30,14,16,6,0,6,0,0.0,0.0
1014,367,23-09-2019 23:52:00,0,1878.0,1885.0,1.004,9.484,24,21,5,16,3,1,2,1,0.0,0.0
1014,368,23-09-2019 23:54:00,0,2073.0,2017.0,0.973,10.402,50,36,17,19,14,2,12,3,0.0,0.0
1014,369,23-09-2019 23:56:00,0,2162.0,2182.0,1.009,10.935,100,75,33,42,25,4,21,21,0.0,0.0
1014,370,23-09-2019 23:58:00,0,2210.5,2206.5,0.9985,11.153,126,86,59,27,40,16,24,41,0.0,0.0
1014,371,24-09-2019 00:00:00,0,2259.0,2231.0,0.988,11.371,85,49,26,23,36,2,34,57,0.0,0.0
1014,372,24-09-2019 00:02:00,0,2583.0,2405.0,0.931,12.839,136,76,46,30,60,2,58,62,0.0,0.0
1014,373,24-09-2019 00:04:00,0,2668.0,2425.0,0.909,13.197,134,93,59,34,41,6,35,56,0.0,0.0
1014,374,24-09-2019 00:06:00,0,2639.0,2572.0,0.975,13.244,85,60,40,20,25,3,22,65,0.01,0.0
1014,375,24-09-2019 00:08:00,0,2639.0,2555.0,0.968,13.228,158,100,63,37,58,11,47,55,0.0,0.0
1014,376,24-09-2019 00:10:00,0,2818.0,2834.0,1.006,14.24,260,160,123,37,100,48,52,64,0.0,0.0
1014,377,24-09-2019 00:12:00,0,2920.0,2850.0,0.976,14.658,277,155,120,35,122,97,25,120,0.0,0.0
1014,378,24-09-2019 00:14:00,0,2653.0,2475.0,0.933,13.194,274,164,127,37,110,74,36,108,0.02,0.0
1014,379,24-09-2019 00:16:00,0,2832.0,2755.0,0.973,14.208,116,71,43,28,45,7,38,64,0.0,0.0
1014,380,24-09-2019 00:18:00,0,3122.0,3066.0,0.982,15.696,186,138,104,34,48,22,26,80,0.03,0.0
1014,381,24-09-2019 00:20:00,0,2907.0,2826.0,0.972,14.584,251,170,120,50,81,48,33,107,0.0,0.07
1014,382,24-09-2019 00:22:00,0,2837.0,2795.0,0.985,14.273,96,73,44,29,23,2,21,32,0.0,0.0
1014,383,24-09-2019 00:24:00,0,3328.0,3113.0,0.935,16.559,336,214,168,46,122,79,43,62,0.0,0.0
1014,384,24-09-2019 00:26:00,0,2822.0,2787.0,0.988,14.203,321,196,155,41,125,93,32,163,0.0,0.0
1014,385,24-09-2019 00:28:00,0,2831.0,2677.0,0.945,14.119,155,105,75,30,50,13,37,50,0.1,0.0
1014,386,24-09-2019 00:30:00,0,3344.0,3069.0,0.918,16.573,148,94,69,25,54,24,30,73,0.0,0.0
1014,387,24-09-2019 00:32:00,0,3392.0,3105.5,0.9155,16.8025,127,94,71,23,33,7,26,53,0.02,0.0
1014,388,24-09-2019 00:34:00,0,3440.0,3142.0,0.913,17.032,190,140,99,41,50,4,46,71,0.0,0.0
1014,389,24-09-2019 00:36:00,0,3116.0,3020.0,0.969,15.621,115,74,49,25,41,15,26,7,0.0,0.0
1014,390,24-09-2019 00:38:00,0,3020.0,2868.0,0.95,15.075,157,101,80,21,56,44,12,67,0.0,0.0
1014,391,24-09-2019 00:40:00,0,3179.0,2846.0,0.895,15.675,127,79,54,25,48,10,38,55,0.0,0.0
1014,392,24-09-2019 00:42:00,0,3509.0,3319.0,0.946,17.5,78,35,20,15,43,10,33,24,0.02,0.0
1014,393,24-09-2019 00:44:00,0,2857.0,2671.0,0.935,14.213,109,43,35,8,66,34,32,24,0.0,0.0
1014,394,24-09-2019 00:46:00,0,3107.0,3039.0,0.978,15.607,314,193,150,43,121,89,32,64,0.0,0.03
1014,395,24-09-2019 00:48:00,0,2866.0,2601.0,0.908,14.172,193,105,77,28,88,68,20,76,0.0,0.0
1014,396,24-09-2019 00:50:00,0,2888.0,2610.0,0.904,14.27,353,203,156,47,150,105,45,72,0.0,0.0
1014,397,24-09-2019 00:52:00,0,2764.0,2546.0,0.921,13.709,240,150,112,38,90,63,27,43,0.0,0.0
1014,398,24-09-2019 00:54:00,0,3143.0,2951.0,0.939,15.651,144,93,68,25,51,0,51,55,0.0,0.0
1014,399,24-09-2019 00:56:00,0,3245.0,3033.0,0.935,16.143,147,104,67,37,43,5,38,50,0.0,0.0
1014,400,24-09-2019 00:58:00,0,2818.0,2808.0,0.996,14.211,164,100,69,31,64,41,23,60,0.0,0.04
1014,401,24-09-2019 01:00:00,0,2836.0,2681.0,0.945,14.14,87,68,42,26,19,9,10,7,0.07,0.0
1014,402,24-09-2019 01:02:00,0,2776.0,2528.0,0.91,13.737,101,69,42,27,32,5,27,30,0.01,0.0
1014,403,24-09-2019 01:04:00,0,2839.0,2756.0,0.971,14.236,157,116,76,40,41,8,33,63,0.0,0.0
1014,404,24-09-2019 01:06:00,0,2862.0,2668.0,0.9325,14.2305,206,129,94,35,77,41,36,44,0.05,0.03
1014,405,24-09-2019 01:08:00,0,2885.0,2580.0,0.894,14.225,346,209,159,50,137,97,40,73,0.0,0.0
1014,406,24-09-2019 01:10:00,0,2364.0,2295.0,0.971,11.855,29,27,8,19,2,1,1,1,0.0,0.0
1014,407,24-09-2019 01:12:00,0,1882.0,1823.0,0.968,9.434,53,51,28,23,2,2,0,1,0.0,0.0
1014,408,24-09-2019 01:14:00,0,2090.0,1942.0,0.929,10.384,68,62,29,33,6,0,6,2,0.01,0.0
1014,409,24-09-2019 01:16:00,0,2411.0,2174.0,0.902,11.905,62,35,17,18,27,1,26,32,0.0,0.0
1014,410,24-09-2019 01:18:00,0,2663.0,2479.0,0.931,13.237,92,70,50,20,22,10,12,23,0.0,0.0
1014,411,24-09-2019 01:20:00,0,2392.0,2133.0,0.892,11.785,14,12,4,8,2,1,1,0,0.04,0.0
1014,412,24-09-2019 01:22:00,0,2102.0,1931.0,0.919,10.42,1,1,0,1,0,0,0,0,0.01,0.0
1014,413,24-09-2019 01:24:00,0,2007.0,1820.0,0.907,9.923,0,0,0,0,0,0,0,0,0.0,0.0
1014,414,24-09-2019 01:26:00,0,2015.0,1826.0,0.906,9.96,10,10,1,9,0,0,0,0,0.0,0.0
1014,415,24-09-2019 01:28:00,0,2125.0,1852.0,0.871,10.423,3,3,0,3,0,0,0,0,0.0,0.0
1014,416,24-09-2019 01:30:00,0,2008.0,1835.0,0.914,9.941,0,0,0,0,0,0,0,0,0.0,0.0
1014,417,24-09-2019 01:32:00,0,2121.0,1825.0,0.86,10.377,245,167,113,54,78,46,32,8,0.0,0.0
1014,418,24-09-2019 01:34:00,0,2409.0,2170.0,0.901,11.895,456,346,264,82,110,74,36,39,0.01,0.0
1014,419,24-09-2019 01:36:00,0,2353.0,2276.0,0.967,11.792,165,100,71,29,65,33,32,103,0.0,0.0
1014,420,24-09-2019 01:38:00,0,2688.0,2423.0,0.902,13.273,157,102,68,34,55,19,36,61,0.0,0.0
1014,421,24-09-2019 01:40:00,0,2788.0,2506.5,0.8995,13.7595,102,81,48,33,21,0,21,46,0.0,0.03
1014,422,24-09-2019 01:42:00,0,2888.0,2590.0,0.897,14.246,178,145,100,45,33,0,33,53,0.0,0.05
1014,423,24-09-2019 01:44:00,0,3059.0,2810.0,0.919,15.161,160,126,78,48,34,4,30,44,0.0,0.07
1014,424,24-09-2019 01:46:00,0,2834.0,2730.0,0.964,14.187,133,98,69,29,35,5,30,35,0.0,0.0
1014,425,24-09-2019 01:48:00,0,2688.0,2368.0,0.881,13.213,455,282,215,67,173,124,49,44,0.0,0.14
1014,426,24-09-2019 01:50:00,0,2785.0,2511.0,0.902,13.752,361,227,190,37,134,104,30,97,0.05,0.0
1014,427,24-09-2019 01:52:00,0,2673.0,2388.0,0.893,13.176,145,87,61,26,58,19,39,90,0.0,0.0
1014,428,24-09-2019 01:54:00,0,2859.0,2662.0,0.931,14.211,57,37,16,21,20,3,17,16,0.0,0.0
1014,429,24-09-2019 01:56:00,0,2819.0,2749.0,0.975,14.148,161,134,88,46,27,0,27,51,0.0,0.0
1014,430,24-09-2019 01:58:00,0,2851.0,2660.0,0.933,14.178,129,87,63,24,42,0,42,53,0.0,0.03
1014,431,24-09-2019 02:00:00,0,3039.0,2866.0,0.943,15.147,187,110,72,38,77,11,66,87,0.0,0.06
1014,432,24-09-2019 02:02:00,0,2850.0,2629.0,0.922,14.14,155,123,91,32,32,18,14,46,0.06,0.01
1014,433,24-09-2019 02:04:00,0,2675.0,2467.0,0.922,13.272,221,135,100,35,86,52,34,23,0.1,0.02
1014,434,24-09-2019 02:06:00,0,2098.0,1929.0,0.919,10.403,57,37,22,15,20,0,20,0,0.0,0.0
1014,435,24-09-2019 02:08:00,0,1908.0,1767.0,0.926,9.474,68,50,27,23,18,0,18,0,0.0,0.0
1014,436,24-09-2019 02:10:00,0,2076.0,1978.0,0.953,10.367,23,7,2,5,16,0,16,0,0.0,0.0
1014,437,24-09-2019 02:12:00,0,2000.0,1815.0,0.907,9.89,0,0,0,0,0,0,0,0,0.0,0.0
1014,438,24-09-2019 02:14:00,0,2110.5,1856.5,0.881,10.3705,1,1,0,1,0,0,0,0,0.0,0.0
1014,439,24-09-2019 02:16:00,0,2221.0,1898.0,0.855,10.851,6,6,1,5,0,0,0,0,0.02,0.0
1014,440,24-09-2019 02:18:00,0,2232.0,1920.0,0.86,10.92,0,0,0,0,0,0,0,0,0.0,0.0
1014,441,24-09-2019 02:20:00,0,2232.0,1895.0,0.849,10.89,322,254,201,53,68,38,30,0,0.0,0.01
1014,442,24-09-2019 02:22:00,0,2758.0,2551.0,0.925,13.689,481,316,245,71,165,114,51,15,0.05,0.01
1014,443,24-09-2019 02:24:00,0,2771.0,2521.0,0.91,13.709,579,377,294,83,202,148,54,26,0.0,0.0
1014,444,24-09-2019 02:26:00,0,2753.0,2580.0,0.937,13.704,91,69,40,29,22,4,18,7,0.0,0.0
1014,445,24-09-2019 02:28:00,0,2740.0,2589.0,0.945,13.662,252,188,138,50,64,33,31,43,0.0,0.0
1014,446,24-09-2019 02:30:00,0,2929.0,2865.0,0.978,14.711,104,71,47,24,33,11,22,58,0.0,0.0
1014,447,24-09-2019 02:32:00,0,2471.0,2285.0,0.924,12.266,149,87,58,29,62,36,26,53,0.0,0.0
1014,448,24-09-2019 02:34:00,0,2789.0,2410.0,0.864,13.656,177,148,103,45,29,4,25,35,0.0,0.0
1014,449,24-09-2019 02:36:00,0,2179.0,2100.0,0.964,10.91,411,278,216,62,133,95,38,12,0.0,0.0
1014,450,24-09-2019 02:38:00,0,3061.0,2852.0,0.932,15.217,406,276,206,70,130,94,36,19,0.0,0.09
1014,451,24-09-2019 02:40:00,0,2097.0,1919.0,0.915,10.389,37,22,9,13,15,9,6,1,0.0,0.0
1014,452,24-09-2019 02:42:00,0,2043.0,1715.0,0.839,9.948,0,0,0,0,0,0,0,0,0.0,0.0
1014,453,24-09-2019 02:44:00,0,2229.0,1870.0,0.839,10.851,0,0,0,0,0,0,0,0,0.0,0.0
1014,454,24-09-2019 02:46:00,0,2193.0,1987.0,0.906,10.839,0,0,0,0,0,0,0,0,0.0,0.0
1014,455,24-09-2019 02:48:00,0,2210.5,1939.5,0.8775,10.8565,0,0,0,0,0,0,0,0,0.0,0.0
1014,456,24-09-2019 02:50:00,0,2228.0,1892.0,0.849,10.874,12,9,4,5,3,0,3,0,0.0,0.0
1014,457,24-09-2019 02:52:00,0,2210.0,1991.0,0.901,10.912,1,0,0,0,1,0,1,0,0.0,0.0
1014,458,24-09-2019 02:54:00,0,2183.0,2073.0,0.95,10.895,7,2,0,2,5,0,5,0,0.0,0.0
1014,459,24-09-2019 02:56:00,0,2189.0,1971.0,0.901,10.806,0,0,0,0,0,0,0,0,0.0,0.0
1014,460,24-09-2019 02:58:00,0,2225.0,1951.0,0.877,10.927,9,5,0,5,4,0,4,0,0.0,0.0
1014,461,24-09-2019 03:00:00,0,2229.0,1922.0,0.862,10.909,3,2,0,2,1,0,1,0,0.0,0.0
1014,462,24-09-2019 03:02:00,0,1997.0,1837.0,0.92,9.901,0,0,0,0,0,0,0,0,0.0,0.0
1014,463,24-09-2019 03:04:00,0,2032.0,1779.0,0.875,9.976,0,0,0,0,0,0,0,0,0.0,0.0
1014,464,24-09-2019 03:06:00,0,1813.0,1633.0,0.901,8.951,0,0,0,0,0,0,0,0,0.0,0.0
1014,465,24-09-2019 03:08:00,0,1723.0,1580.0,0.917,8.539,0,0,0,0,0,0,0,0,0.0,0.0
1014,466,24-09-2019 03:10:00,0,1719.0,1583.0,0.921,8.524,0,0,0,0,0,0,0,0,0.0,0.0
1014,467,24-09-2019 03:12:00,0,1709.0,1602.0,0.937,8.507,0,0,0,0,0,0,0,0,0.0,0.0
1014,468,24-09-2019 03:14:00,0,1728.0,1534.0,0.888,8.505,0,0,0,0,0,0,0,0,0.0,0.0
1014,469,24-09-2019 03:16:00,0,1748.0,1476.0,0.844,8.52,4,4,0,4,0,0,0,0,0.0,0.0
1014,470,24-09-2019 03:18:00,0,1731.0,1491.0,0.861,8.471,12,12,0,12,0,0,0,0,0.0,0.0
1014,471,24-09-2019 03:20:00,0,1724.0,1578.0,0.915,8.541,21,19,8,11,2,0,2,0,0.0,0.0
1014,472,24-09-2019 03:22:00,0,1798.0,1713.0,0.951,8.982,8,8,4,4,0,0,0,0,0.0,0.0
1014,473,24-09-2019 03:24:00,0,1872.0,1848.0,0.987,9.423,2,1,0,1,1,0,1,0,0.0,0.0
1014,474,24-09-2019 03:26:00,0,1887.0,1871.0,0.991,9.507,0,0,0,0,0,0,0,0,0.0,0.0
1014,475,24-09-2019 03:28:00,0,1990.0,1876.0,0.942,9.919,4,4,0,4,0,0,0,0,0.0,0.0
1014,476,24-09-2019 03:30:00,0,2101.0,1937.0,0.922,10.421,1,1,0,1,0,0,0,0,0.0,0.0
1014,477,24-09-2019 03:32:00,0,2096.0,1957.0,0.934,10.426,3,3,0,3,0,0,0,0,0.0,0.0
1014,478,24-09-2019 03:34:00,0,2098.0,1884.0,0.898,10.351,0,0,0,0,0,0,0,0,0.0,0.0
1014,479,24-09-2019 03:36:00,0,1898.0,1857.0,0.978,9.533,30,22,12,10,8,0,8,0,0.0,0.0
1014,480,24-09-2019 03:38:00,0,2103.0,1891.0,0.899,10.381,0,0,0,0,0,0,0,0,0.0,0.0
1014,481,24-09-2019 03:40:00,0,2102.0,1946.0,0.926,10.436,18,18,0,18,0,0,0,3,0.0,0.0
1014,482,24-09-2019 03:42:00,0,2076.0,2048.0,0.986,10.447,30,30,12,18,0,0,0,0,0.0,0.0
1014,483,24-09-2019 03:44:00,0,2380.0,2151.0,0.904,11.76,35,31,6,25,4,2,2,0,0.0,0.0
1014,484,24-09-2019 03:46:00,0,2293.0,2166.0,0.945,11.431,121,73,44,29,48,36,12,11,0.0,0.0
1014,485,24-09-2019 03:48:00,0,2150.0,2107.0,0.98,10.804,9,7,0,7,2,1,1,0,0.0,0.0
1014,486,24-09-2019 03:50:00,0,2091.0,1983.0,0.949,10.432,10,10,0,10,0,0,0,0,0.0,0.0
1014,487,24-09-2019 03:52:00,0,1995.0,1874.0,0.939,9.935,5,5,1,4,0,0,0,0,0.0,0.0
1014,488,24-09-2019 03:54:00,0,2101.0,1885.0,0.897,10.363,1,1,0,1,0,0,0,0,0.0,0.0
1014,489,24-09-2019 03:56:00,0,2060.0,1821.0,0.8835,10.1325,1,1,0,1,0,0,0,0,0.0,0.0
1014,490,24-09-2019 03:58:00,0,2019.0,1757.0,0.87,9.902,14,14,6,8,0,0,0,0,0.0,0.0
1014,491,24-09-2019 04:00:00,0,1942.0,1655.0,0.853,9.483,15,15,0,15,0,0,0,0,0.0,0.0
1014,492,24-09-2019 04:02:00,0,1727.0,1561.0,0.904,8.533,7,7,3,4,0,0,0,0,0.0,0.0
1014,493,24-09-2019 04:04:00,0,1725.0,1560.0,0.905,8.522,5,0,0,0,5,0,5,0,0.0,0.0
1014,494,24-09-2019 04:06:00,0,1942.0,1609.0,0.828,9.432,0,0,0,0,0,0,0,0,0.0,0.0
1014,495,24-09-2019 04:08:00,0,1946.0,1623.0,0.834,9.466,0,0,0,0,0,0,0,0,0.0,0.0
1014,496,24-09-2019 04:10:00,0,1729.0,1569.0,0.907,8.55,0,0,0,0,0,0,0,0,0.0,0.0
1014,497,24-09-2019 04:12:00,0,1739.0,1486.0,0.854,8.498,3,3,1,2,0,0,0,0,0.0,0.0
1014,498,24-09-2019 04:14:00,0,1740.0,1461.0,0.84,8.472,30,28,12,16,2,1,1,0,0.0,0.0
1014,499,24-09-2019 04:16:00,0,1740.0,1529.0,0.879,8.548,12,11,8,3,1,0,1,0,0.0,0.0
1014,500,24-09-2019 04:18:00,0,1710.0,1567.0,0.916,8.472,0,0,0,0,0,0,0,0,0.0,0.0
1014,501,24-09-2019 04:20:00,0,1959.0,1603.0,0.818,9.492,164,128,81,47,36,21,15,34,0.0,0.0
1014,502,24-09-2019 04:22:00,0,2001.0,1829.0,0.914,9.909,470,296,230,66,174,120,54,25,0.0,0.0
1014,503,24-09-2019 04:24:00,0,2235.0,1906.0,0.853,10.916,86,34,26,8,52,24,28,0,0.0,0.0
1014,504,24-09-2019 04:26:00,0,2238.0,1888.0,0.843,10.907,56,38,20,18,18,0,18,0,0.0,0.0
1014,505,24-09-2019 04:28:00,0,2303.0,2053.0,0.892,11.346,34,26,8,18,8,0,8,0,0.0,0.0
1014,506,24-09-2019 04:30:00,0,2193.0,2030.5,0.928,10.889,17,14,1,13,3,0,3,0,0.0,0.0
1014,507,24-09-2019 04:32:00,0,2083.0,2008.0,0.964,10.432,0,0,0,0,0,0,0,0,0.0,0.0
1014,508,24-09-2019 04:34:00,0,2007.0,1799.0,0.896,9.901,1,1,1,0,0,0,0,0,0.0,0.0
1014,509,24-09-2019 04:36:00,0,1936.0,1689.0,0.872,9.499,0,0,0,0,0,0,0,0,0.0,0.0
1014,510,24-09-2019 04:38:00,0,1829.0,1593.0,0.871,8.971,7,7,4,3,0,0,0,0,0.0,0.0
1014,511,24-09-2019 04:40:00,0,1734.0,1535.0,0.885,8.533,9,9,3,6,0,0,0,0,0.0,0.0
1014,512,24-09-2019 04:42:00,0,1655.0,1373.0,0.83,8.041,8,8,4,4,0,0,0,0,0.0,0.0
1014,513,24-09-2019 04:44:00,0,1639.0,1443.0,0.88,8.056,0,0,0,0,0,0,0,0,0.0,0.0
1014,514,24-09-2019 04:46:00,0,1639.0,1444.0,0.881,8.058,11,11,5,6,0,0,0,0,0.0,0.0
1014,515,24-09-2019 04:48:00,0,1629.0,1461.0,0.897,8.036,4,4,2,2,0,0,0,0,0.0,0.0
1014,516,24-09-2019 04:50:00,0,1630.0,1456.0,0.893,8.034,1,1,0,1,0,0,0,0,0.0,0.0
1014,517,24-09-2019 04:52:00,0,1637.0,1449.0,0.885,8.053,32,32,6,26,0,0,0,0,0.0,0.0
1014,518,24-09-2019 04:54:00,0,1733.0,1498.0,0.864,8.486,10,10,4,6,0,0,0,0,0.0,0.0
1014,519,24-09-2019 04:56:00,0,1853.0,1541.0,0.832,9.009,8,8,5,3,0,0,0,0,0.0,0.0
1014,520,24-09-2019 04:58:00,0,1843.0,1537.0,0.834,8.964,16,16,5,11,0,0,0,0,0.0,0.0
1014,521,24-09-2019 05:00:00,0,1952.0,1597.0,0.818,9.46,13,13,4,9,0,0,0,0,0.0,0.0
1014,522,24-09-2019 05:02:00,0,1938.0,1643.0,0.847,9.456,7,7,2,5,0,0,0,0,0.0,0.0
1014,523,24-09-2019 05:04:00,0,1950.0,1600.5,0.8205,9.456,0,0,0,0,0,0,0,0,0.0,0.0
1014,524,24-09-2019 05:06:00,0,1962.0,1558.0,0.794,9.456,48,36,13,23,12,0,12,0,0.0,0.0
1014,525,24-09-2019 05:08:00,0,1927.0,1625.0,0.844,9.39,92,51,35,16,41,3,38,42,0.0,0.0
1014,526,24-09-2019 05:10:00,0,2145.0,1818.0,0.848,10.462,84,45,20,25,39,2,37,41,0.0,0.0
1014,527,24-09-2019 05:12:00,0,2326.0,1971.0,0.848,11.346,126,88,63,25,38,4,34,46,0.0,0.0
1014,528,24-09-2019 05:14:00,0,2408.0,2100.0,0.872,11.812,153,131,87,44,22,0,22,35,0.0,0.0
1014,529,24-09-2019 05:16:00,0,2723.0,2268.0,0.833,13.24,126,101,68,33,25,0,25,37,0.0,0.04
1014,530,24-09-2019 05:18:00,0,2508.0,2147.0,0.856,12.259,122,91,60,31,31,2,29,53,0.0,0.02
1014,531,24-09-2019 05:20:00,0,2813.0,2460.0,0.875,13.807,156,125,89,36,31,0,31,40,0.0,0.1
1014,532,24-09-2019 05:22:00,0,2688.0,2363.0,0.879,13.208,35,24,15,9,11,0,11,9,0.0,0.08
1014,533,24-09-2019 05:24:00,0,2618.0,2220.0,0.848,12.772,181,106,69,37,75,51,24,61,0.0,0.0
1014,534,24-09-2019 05:26:00,0,2707.0,2372.0,0.876,13.293,313,202,158,44,111,86,25,107,0.0,0.03
1014,535,24-09-2019 05:28:00,0,3052.0,2747.0,0.9,15.068,154,89,61,28,65,40,25,78,0.03,0.04
1014,536,24-09-2019 05:30:00,0,2292.0,2064.0,0.9,11.316,523,358,283,75,165,120,45,46,0.0,0.0
1014,537,24-09-2019 05:32:00,0,2385.0,2204.0,0.924,11.837,448,313,247,66,135,87,48,21,0.06,0.0
1014,538,24-09-2019 05:34:00,0,2861.0,2553.0,0.892,14.1,227,143,107,36,84,49,35,32,0.02,0.0
1014,539,24-09-2019 05:36:00,0,3059.0,2769.0,0.905,15.119,123,88,59,29,35,2,33,48,0.03,0.0
1014,540,24-09-2019 05:38:00,0,2835.5,2509.5,0.8835,13.95,31,20,12,8,11,1,10,5,0.0,0.0
1014,541,24-09-2019 05:40:00,0,2612.0,2250.0,0.862,12.781,101,67,41,26,34,13,21,0,0.03,0.0
1014,542,24-09-2019 05:42:00,0,2581.0,2317.0,0.898,12.735,16,15,5,10,1,0,1,0,0.0,0.0
1014,543,24-09-2019 05:44:00,0,1713.0,1618.0,0.945,8.541,34,34,10,24,0,0,0,5,0.0,0.0
1014,544,24-09-2019 05:46:00,0,2075.0,2013.0,0.97,10.406,58,58,32,26,0,0,0,3,0.0,0.0
1014,545,24-09-2019 05:48:00,0,2078.0,1970.0,0.948,10.369,24,24,10,14,0,0,0,0,0.0,0.0
1014,546,24-09-2019 05:50:00,0,2122.0,1871.0,0.882,10.432,0,0,0,0,0,0,0,0,0.0,0.0
1014,547,24-09-2019 05:52:00,0,2114.0,1834.0,0.868,10.358,4,4,2,2,0,0,0,0,0.0,0.0
1014,548,24-09-2019 05:54:00,0,2114.0,1912.0,0.904,10.446,5,5,4,1,0,0,0,0,0.0,0.0
1014,549,24-09-2019 05:56:00,0,2179.0,2018.0,0.926,10.818,0,0,0,0,0,0,0,0,0.0,0.0
1014,550,24-09-2019 05:58:00,0,2388.0,2174.0,0.91,11.814,12,9,3,6,3,2,1,0,0.06,0.0
1014,551,24-09-2019 06:00:00,1,2377.0,2260.0,0.951,11.868,2,2,1,1,0,0,0,0,0.0,0.0
1014,552,24-09-2019 06:02:00,1,2071.0,2064.0,0.997,10.443,44,29,15,14,15,4,11,12,0.0,0.0
1014,553,24-09-2019 06:04:00,1,2366.0,2279.0,0.963,11.845,227,139,106,33,88,70,18,61,0.0,0.0
1014,554,24-09-2019 06:06:00,1,2648.0,2516.0,0.95,13.217,167,94,70,24,73,42,31,118,0.0,0.0
1014,555,24-09-2019 06:08:00,1,2668.0,2497.0,0.936,13.279,97,64,44,20,33,2,31,43,0.0,0.0
1014,556,24-09-2019 06:10:00,1,2859.0,2574.0,0.9,14.115,123,72,46,26,51,0,51,46,0.0,0.0
1014,557,24-09-2019 06:12:00,1,2899.0,2700.5,0.931,14.4125,119,75,47,28,44,0,44,44,0.0,0.03
1014,558,24-09-2019 06:14:00,1,2939.0,2827.0,0.962,14.71,112,90,62,28,22,0,22,33,0.0,0.05
1014,559,24-09-2019 06:16:00,1,2848.0,2686.0,0.943,14.195,241,142,106,36,99,72,27,23,0.0,0.0
1014,560,24-09-2019 06:18:00,1,2690.0,2387.0,0.887,13.24,295,175,138,37,120,95,25,52,0.08,0.0
1014,561,24-09-2019 06:20:00,1,2844.0,2616.0,0.92,14.1,274,160,127,33,114,77,37,33,0.03,0.02
1014,562,24-09-2019 06:22:00,1,2400.0,2213.0,0.922,11.905,164,92,69,23,72,44,28,30,0.05,0.0
1014,563,24-09-2019 06:24:00,1,2853.0,2698.0,0.945,14.229,60,30,15,15,30,4,26,65,0.0,0.0
1014,564,24-09-2019 06:26:00,1,2660.0,2534.0,0.952,13.286,149,89,63,26,60,32,28,62,0.0,0.0
1014,565,24-09-2019 06:28:00,1,2660.0,2487.0,0.935,13.232,143,88,66,22,55,34,21,48,0.0,0.0
1014,566,24-09-2019 06:30:00,1,2678.0,2402.0,0.897,13.212,82,42,22,20,40,0,40,79,0.0,0.0
1014,567,24-09-2019 06:32:00,1,2658.0,2535.0,0.954,13.277,109,59,35,24,50,16,34,49,0.02,0.0
1014,568,24-09-2019 06:34:00,1,2874.0,2595.0,0.903,14.198,189,117,80,37,72,35,37,54,0.0,0.07
1014,569,24-09-2019 06:36:00,1,1983.0,1860.0,0.938,9.873,85,75,43,32,10,7,3,7,0.0,0.0
1014,570,24-09-2019 06:38:00,1,2686.0,2416.0,0.899,13.257,126,98,67,31,28,12,16,42,0.0,0.0
1014,571,24-09-2019 06:40:00,1,2160.0,2105.0,0.975,10.839,64,52,28,24,12,7,5,10,0.0,0.0
1014,572,24-09-2019 06:42:00,1,2090.0,1980.0,0.947,10.427,39,38,11,27,1,0,1,0,0.0,0.0
1014,573,24-09-2019 06:44:00,1,2110.0,1879.0,0.891,10.393,34,25,6,19,9,1,8,0,0.04,0.0
1014,574,24-09-2019 06:46:00,1,2217.5,1939.0,0.8755,10.8835,1,1,0,1,0,0,0,0,0.0,0.0
1014,575,24-09-2019 06:48:00,1,2325.0,1999.0,0.86,11.374,0,0,0,0,0,0,0,0,0.0,0.0
1014,576,24-09-2019 06:50:00,1,2306.0,2022.0,0.877,11.323,12,12,4,8,0,0,0,0,0.0,0.0
1014,577,24-09-2019 06:52:00,1,2302.0,2014.0,0.875,11.301,3,3,1,2,0,0,0,0,0.0,0.0
1014,578,24-09-2019 06:54:00,1,2092.0,1967.0,0.94,10.419,7,6,3,3,1,1,0,0,0.0,0.0
1014,579,24-09-2019 06:56:00,1,2103.0,1929.0,0.917,10.421,6,6,2,4,0,0,0,0,0.0,0.0
1014,580,24-09-2019 06:58:00,1,2101.0,1891.0,0.9,10.37,4,4,0,4,0,0,0,0,0.0,0.0
1014,581,24-09-2019 07:00:00,1,2118.0,1873.0,0.884,10.42,7,7,2,5,0,0,0,0,0.0,0.0
1014,582,24-09-2019 07:02:00,1,2122.0,1849.0,0.871,10.408,3,3,1,2,0,0,0,0,0.0,0.0
1014,583,24-09-2019 07:04:00,1,2123.0,1823.0,0.859,10.383,0,0,0,0,0,0,0,0,0.0,0.0
1014,584,24-09-2019 07:06:00,1,1897.0,1749.0,0.922,9.412,11,7,5,2,4,2,2,0,0.0,0.0
1014,585,24-09-2019 07:08:00,1,1912.0,1757.0,0.919,9.478,0,0,0,0,0,0,0,0,0.0,0.0
1014,586,24-09-2019 07:10:00,1,2011.0,1795.0,0.892,9.912,1,1,0,1,0,0,0,0,0.0,0.0
1014,587,24-09-2019 07:12:00,1,2132.0,1831.0,0.859,10.429,1,1,0,1,0,0,0,0,0.0,0.0
1014,588,24-09-2019 07:14:00,1,2115.0,1859.0,0.879,10.389,0,0,0,0,0,0,0,0,0.0,0.0
1014,589,24-09-2019 07:16:00,1,2126.0,1814.0,0.853,10.383,4,1,0,1,3,0,3,0,0.0,0.0
1014,590,24-09-2019 07:18:00,1,1918.0,1722.0,0.898,9.465,3,3,0,3,0,0,0,0,0.0,0.0
1014,591,24-09-2019 07:20:00,1,1917.0,1733.5,0.9045,9.474,2,2,0,2,0,0,0,0,0.0,0.0
1014,592,24-09-2019 07:22:00,1,1916.0,1745.0,0.911,9.483,3,0,0,0,3,0,3,0,0.0,0.0
1014,593,24-09-2019 07:24:00,1,1803.0,1708.0,0.948,8.994,0,0,0,0,0,0,0,0,0.0,0.0
1014,594,24-09-2019 07:26:00,1,1819.0,1646.0,0.905,8.988,12,10,4,6,2,0,2,0,0.0,0.0
1014,595,24-09-2019 07:28:00,1,1815.0,1676.0,0.923,9.007,6,4,1,3,2,0,2,0,0.0,0.0
1014,596,24-09-2019 07:30:00,1,1911.0,1712.0,0.896,9.423,0,0,0,0,0,0,0,0,0.0,0.0
1014,597,24-09-2019 07:32:00,1,1810.0,1674.0,0.925,8.985,11,8,1,7,3,0,3,0,0.0,0.0
1014,598,24-09-2019 07:34:00,1,1822.0,1673.0,0.918,9.031,1,0,0,0,1,0,1,0,0.0,0.0
1014,599,24-09-2019 07:36:00,1,1806.0,1661.0,0.92,8.956,13,6,3,3,7,0,7,0,0.0,0.0
1014,600,24-09-2019 07:38:00,1,2040.0,1737.0,0.851,9.961,68,45,20,25,23,4,19,33,0.0,0.0
1014,601,24-09-2019 07:40:00,1,1998.0,1855.0,0.929,9.924,63,19,8,11,44,0,44,71,0.0,0.0
1014,602,24-09-2019 07:42:00,1,1992.0,1904.0,0.956,9.955,115,53,43,10,62,9,53,61,0.0,0.0
1014,603,24-09-2019 07:44:00,1,2317.0,1997.0,0.862,11.341,129,70,51,19,59,1,58,82,0.0,0.0
1014,604,24-09-2019 07:46:00,1,1974.0,1922.0,0.974,9.907,203,114,89,25,89,41,48,78,0.0,0.0
1014,605,24-09-2019 07:48:00,1,2493.0,2189.0,0.878,12.248,148,101,65,36,47,0,47,53,0.0,0.0
1014,606,24-09-2019 07:50:00,1,2606.0,2266.0,0.87,12.775,30,9,5,4,21,1,20,23,0.0,0.0
1014,607,24-09-2019 07:52:00,1,2306.0,2033.0,0.881,11.337,127,85,56,29,42,1,41,42,0.0,0.0
1014,608,24-09-2019 07:54:00,1,2493.0,2179.5,0.8745,12.2365,128,93,59,34,35,2,33,39,0.0,0.02
1014,609,24-09-2019 07:56:00,1,2680.0,2326.0,0.868,13.136,251,178,137,41,73,45,28,21,0.0,0.0
1014,610,24-09-2019 07:58:00,1,1927.0,1708.0,0.887,9.483,19,19,4,15,0,0,0,0,0.0,0.0
1014,611,24-09-2019 08:00:00,1,2095.0,1948.0,0.93,10.412,61,58,31,27,3,0,3,0,0.0,0.0
1014,612,24-09-2019 08:02:00,1,2106.0,1867.0,0.887,10.363,31,26,15,11,5,0,5,0,0.0,0.0
1014,613,24-09-2019 08:04:00,1,2311.0,1983.0,0.858,11.301,214,163,119,44,51,27,24,0,0.0,0.0
1014,614,24-09-2019 08:06:00,1,2616.0,2218.0,0.848,12.762,187,133,95,38,54,22,32,43,0.0,0.0
1014,615,24-09-2019 08:08:00,1,2719.0,2338.0,0.86,13.301,72,40,20,20,32,0,32,65,0.0,0.0
1014,616,24-09-2019 08:10:00,1,2721.0,2262.0,0.831,13.226,341,212,157,55,129,80,49,36,0.0,0.0
1014,617,24-09-2019 08:12:00,1,2186.0,2024.0,0.926,10.853,349,263,193,70,86,53,33,15,0.0,0.0
1014,618,24-09-2019 08:14:00,1,2435.0,2022.0,0.83,11.835,144,62,46,16,82,47,35,45,0.0,0.0
1014,619,24-09-2019 08:16:00,1,2415.0,2095.0,0.867,11.833,168,108,68,40,60,36,24,55,0.0,0.0
1014,620,24-09-2019 08:18:00,1,2134.0,1811.0,0.849,10.413,26,26,3,23,0,0,0,0,0.0,0.0
1014,621,24-09-2019 08:20:00,1,2102.0,1912.0,0.91,10.398,39,37,10,27,2,1,1,5,0.0,0.0
1014,622,24-09-2019 08:22:00,1,2108.0,1899.0,0.901,10.407,3,3,0,3,0,0,0,0,0.0,0.0
1014,623,24-09-2019 08:24:00,1,1915.0,1725.0,0.901,9.456,2,2,0,2,0,0,0,0,0.0,0.0
1014,624,24-09-2019 08:26:00,1,1925.0,1712.0,0.889,9.48,3,3,0,3,0,0,0,0,0.0,0.0
1014,625,24-09-2019 08:28:00,1,2036.0,1748.0,0.86,9.9565,1,1,1,0,0,0,0,0,0.0,0.0
1014,626,24-09-2019 08:30:00,1,2147.0,1784.0,0.831,10.433,9,3,0,3,6,1,5,0,0.0,0.0
1014,627,24-09-2019 08:32:00,1,1912.0,1742.0,0.911,9.463,5,3,0,3,2,0,2,0,0.0,0.0
1014,628,24-09-2019 08:34:00,1,1929.0,1650.0,0.855,9.428,1,1,0,1,0,0,0,0,0.0,0.0
1014,629,24-09-2019 08:36:00,1,1841.0,1541.0,0.837,8.959,9,9,4,5,0,0,0,0,0.0,0.0
1014,630,24-09-2019 08:38:00,1,1968.0,1548.0,0.786,9.469,0,0,0,0,0,0,0,0,0.0,0.0
1014,631,24-09-2019 08:40:00,1,1845.0,1523.0,0.826,8.955,1,1,1,0,0,0,0,0,0.0,0.0
1014,632,24-09-2019 08:42:00,1,1966.0,1511.0,0.769,9.42,6,6,0,6,0,0,0,0,0.0,0.0
1014,633,24-09-2019 08:44:00,1,1963.0,1535.0,0.782,9.433,10,4,2,2,6,0,6,0,0.0,0.0
1014,634,24-09-2019 08:46:00,1,1965.0,1533.0,0.78,9.439,1,1,0,1,0,0,0,0,0.0,0.0
1014,635,24-09-2019 08:48:00,1,1965.0,1517.0,0.772,9.423,4,3,0,3,1,0,1,0,0.0,0.0
1014,636,24-09-2019 08:50:00,1,1960.0,1540.0,0.786,9.426,15,9,4,5,6,1,5,0,0.0,0.0
1014,637,24-09-2019 08:52:00,1,1962.0,1530.0,0.78,9.425,0,0,0,0,0,0,0,0,0.0,0.0
1014,638,24-09-2019 08:54:00,1,1978.0,1501.0,0.759,9.454,9,1,0,1,8,0,8,0,0.0,0.0
1014,639,24-09-2019 08:56:00,1,1970.0,1471.0,0.747,9.392,23,3,0,3,20,0,20,0,0.0,0.0
1014,640,24-09-2019 08:58:00,1,1870.0,1460.0,0.781,8.985,0,0,0,0,0,0,0,0,0.0,0.0
1014,641,24-09-2019 09:00:00,1,1866.0,1449.0,0.776,8.956,0,0,0,0,0,0,0,0,0.0,0.0
1014,642,24-09-2019 09:02:00,1,1874.5,1447.5,0.772,8.988,0,0,0,0,0,0,0,0,0.0,0.0
1014,643,24-09-2019 09:04:00,1,1883.0,1446.0,0.768,9.02,0,0,0,0,0,0,0,0,0.0,0.0
1014,644,24-09-2019 09:06:00,1,1651.0,1367.0,0.828,8.018,5,1,0,1,4,0,4,0,0.0,0.0
1014,645,24-09-2019 09:08:00,1,1661.0,1382.0,0.832,8.075,3,0,0,0,3,0,3,0,0.0,0.0
1014,646,24-09-2019 09:10:00,1,1752.0,1393.0,0.795,8.446,0,0,0,0,0,0,0,0,0.0,0.0
1014,647,24-09-2019 09:12:00,1,1767.0,1390.0,0.787,8.502,19,8,6,2,11,0,11,0,0.0,0.0
1014,648,24-09-2019 09:14:00,1,1871.0,1401.0,0.749,8.923,0,0,0,0,0,0,0,0,0.0,0.0
1014,649,24-09-2019 09:16:00,1,1874.0,1465.0,0.782,9.006,0,0,0,0,0,0,0,0,0.0,0.0
1014,650,24-09-2019 09:18:00,1,1992.0,1457.0,0.731,9.462,0,0,0,0,0,0,0,0,0.0,0.0
1014,651,24-09-2019 09:20:00,1,1862.0,1444.0,0.776,8.934,0,0,0,0,0,0,0,0,0.0,0.0
1014,652,24-09-2019 09:22:00,1,1877.0,1439.0,0.767,8.99,7,5,1,4,2,1,1,0,0.01,0.0
1014,653,24-09-2019 09:24:00,1,1973.0,1507.0,0.764,9.441,2,2,0,2,0,0,0,0,0.0,0.0
1014,654,24-09-2019 09:26:00,1,1994.0,1442.0,0.723,9.454,7,7,0,7,0,0,0,0,0.0,0.0
1014,655,24-09-2019 09:28:00,1,1768.0,1381.0,0.781,8.495,0,0,0,0,0,0,0,0,0.0,0.0
1014,656,24-09-2019 09:30:00,1,1776.0,1390.0,0.782,8.536,0,0,0,0,0,0,0,0,0.0,0.0
1014,657,24-09-2019 09:32:00,1,1656.0,1386.0,0.837,8.058,0,0,0,0,0,0,0,0,0.0,0.0
1014,658,24-09-2019 09:34:00,1,1653.0,1372.0,0.83,8.03,12,12,2,10,0,0,0,0,0.0,0.0
1014,659,24-09-2019 09:36:00,1,1772.0,1379.0,0.7815,8.5085,30,30,0,30,0,0,0,0,0.0,0.0
1014,660,24-09-2019 09:38:00,1,1891.0,1386.0,0.733,8.987,7,7,0,7,0,0,0,0,0.0,0.0
1014,661,24-09-2019 09:40:00,1,1987.0,1427.0,0.718,9.408,0,0,0,0,0,0,0,0,0.0,0.0
1014,662,24-09-2019 09:42:00,1,2003.0,1424.0,0.711,9.47,4,1,0,1,3,1,2,0,0.0,0.0
1014,663,24-09-2019 09:44:00,1,1873.0,1386.0,0.74,8.916,5,3,1,2,2,0,2,0,0.0,0.0
1014,664,24-09-2019 09:46:00,1,1896.0,1383.0,0.729,9.0,4,4,2,2,0,0,0,0,0.0,0.0
1014,665,24-09-2019 09:48:00,1,1881.0,1394.0,0.741,8.956,92,79,34,45,13,0,13,1,0.0,0.0
1014,666,24-09-2019 09:50:00,1,2084.0,1524.0,0.731,9.896,92,72,48,24,20,1,19,13,0.0,0.0
1014,667,24-09-2019 09:52:00,1,2281.0,1716.0,0.752,10.889,66,25,11,14,41,0,41,60,0.0,0.0
1014,668,24-09-2019 09:54:00,1,2254.0,1760.0,0.781,10.831,66,38,22,16,28,2,26,55,0.0,0.0
1014,669,24-09-2019 09:56:00,1,2261.0,1763.0,0.78,10.862,54,36,23,13,18,2,16,33,0.0,0.0
1014,670,24-09-2019 09:58:00,1,2251.0,1816.0,0.807,10.878,256,119,92,27,137,102,35,30,0.0,0.0
1014,671,24-09-2019 10:00:00,1,1876.0,1396.0,0.744,8.936,215,100,66,34,115,82,33,60,0.0,0.0
1014,672,24-09-2019 10:02:00,1,2270.0,1732.0,0.763,10.864,205,111,89,22,94,74,20,114,0.0,0.0
1014,673,24-09-2019 10:04:00,1,2278.0,1678.0,0.737,10.832,392,255,199,56,137,103,34,49,0.0,0.0
1014,674,24-09-2019 10:06:00,1,2263.0,1759.0,0.778,10.862,261,132,100,32,129,90,39,9,0.0,0.0
1014,675,24-09-2019 10:08:00,1,2374.0,1833.0,0.772,11.383,338,221,175,46,117,84,33,31,0.0,0.0
1014,676,24-09-2019 10:10:00,1,2480.0,1869.5,0.7545,11.8405,104,56,38,18,48,0,48,71,0.0,0.0
1014,677,24-09-2019 10:12:00,1,2586.0,1906.0,0.737,12.298,80,42,26,16,38,4,34,51,0.0,0.0
1014,678,24-09-2019 10:14:00,1,2566.0,1935.0,0.754,12.253,132,88,56,32,44,0,44,61,0.0,0.01
1014,679,24-09-2019 10:16:00,1,2898.0,2093.0,0.722,13.736,127,69,44,25,58,0,58,56,0.0,0.0
1014,680,24-09-2019 10:18:00,1,2758.0,2091.0,0.758,13.18,100,60,43,17,40,19,21,8,0.0,0.04
1014,681,24-09-2019 10:20:00,1,2763.0,2074.0,0.751,13.182,372,202,151,51,170,125,45,26,0.0,0.0
1014,682,24-09-2019 10:22:00,1,2090.0,1540.0,0.737,9.94,32,29,6,23,3,1,2,3,0.0,0.0
1014,683,24-09-2019 10:24:00,1,1786.0,1296.0,0.725,8.474,20,11,3,8,9,1,8,0,0.0,0.0
1014,684,24-09-2019 10:26:00,1,2080.0,1500.0,0.721,9.856,37,10,2,8,27,0,27,0,0.0,0.0
1014,685,24-09-2019 10:28:00,1,2075.0,1573.0,0.758,9.915,6,4,1,3,2,0,2,0,0.0,0.0
1014,686,24-09-2019 10:30:00,1,2098.0,1516.0,0.723,9.945,0,0,0,0,0,0,0,0,0.0,0.0
1014,687,24-09-2019 10:32:00,1,2086.0,1562.0,0.749,9.95,6,5,4,1,1,0,1,0,0.0,0.0
1014,688,24-09-2019 10:34:00,1,2277.0,1690.0,0.742,10.844,0,0,0,0,0,0,0,0,0.0,0.0
1014,689,24-09-2019 10:36:00,1,2263.0,1750.0,0.773,10.853,0,0,0,0,0,0,0,0,0.0,0.0
1014,690,24-09-2019 10:38:00,1,2071.0,1590.0,0.768,9.921,4,4,1,3,0,0,0,0,0.0,0.0
1014,691,24-09-2019 10:40:00,1,1755.0,1440.0,0.821,8.508,1,1,0,1,0,0,0,0,0.0,0.0
1014,692,24-09-2019 10:42:00,1,1759.0,1408.0,0.8,8.49,0,0,0,0,0,0,0,0,0.0,0.0
1014,693,24-09-2019 10:44:00,1,1870.0,1446.5,0.775,8.9695,0,0,0,0,0,0,0,0,0.0,0.0
1014,694,24-09-2019 10:46:00,1,1981.0,1485.0,0.75,9.449,3,3,0,3,0,0,0,0,0.0,0.0
1014,695,24-09-2019 10:48:00,1,2077.0,1573.0,0.757,9.926,1,1,0,1,0,0,0,0,0.0,0.0
1014,696,24-09-2019 10:50:00,1,2051.0,1677.0,0.818,9.94,20,17,6,11,3,2,1,0,0.0,0.0
1014,697,24-09-2019 10:52:00,1,2265.0,1704.0,0.752,10.812,7,4,2,2,3,0,3,0,0.0,0.0
1014,698,24-09-2019 10:54:00,1,2285.0,1731.0,0.757,10.921,0,0,0,0,0,0,0,0,0.0,0.0
1014,699,24-09-2019 10:56:00,1,2058.0,1644.0,0.799,9.929,0,0,0,0,0,0,0,0,0.0,0.0
1014,700,24-09-2019 10:58:00,1,2070.0,1569.0,0.758,9.891,0,0,0,0,0,0,0,0,0.0,0.0
1014,701,24-09-2019 11:00:00,1,1984.0,1486.0,0.749,9.462,0,0,0,0,0,0,0,0,0.0,0.0
1014,702,24-09-2019 11:02:00,1,1766.0,1389.0,0.787,8.495,6,3,0,3,3,0,3,0,0.0,0.0
1014,703,24-09-2019 11:04:00,1,1769.0,1394.0,0.788,8.514,0,0,0,0,0,0,0,0,0.0,0.0
1014,704,24-09-2019 11:06:00,1,1755.0,1407.0,0.802,8.472,0,0,0,0,0,0,0,0,0.0,0.0
1014,705,24-09-2019 11:08:00,1,1783.0,1380.0,0.774,8.552,1,1,1,0,0,0,0,0,0.0,0.0
1014,706,24-09-2019 11:10:00,1,1760.0,1400.0,0.796,8.487,0,0,0,0,0,0,0,0,0.0,0.0
1014,707,24-09-2019 11:12:00,1,1756.0,1392.0,0.793,8.462,0,0,0,0,0,0,0,0,0.0,0.0
1014,708,24-09-2019 11:14:00,1,1779.0,1391.0,0.782,8.551,0,0,0,0,0,0,0,0,0.0,0.0
1014,709,24-09-2019 11:16:00,1,1769.0,1374.0,0.777,8.49,0,0,0,0,0,0,0,0,0.0,0.0
1014,710,24-09-2019 11:18:00,1,1766.5,1376.5,0.7795,8.4835,0,0,0,0,0,0,0,0,0.0,0.0
1014,711,24-09-2019 11:20:00,1,1764.0,1379.0,0.782,8.477,0,0,0,0,0,0,0,0,0.0,0.0
1014,712,24-09-2019 11:22:00,1,1782.0,1341.0,0.752,8.506,13,10,6,4,3,0,3,0,0.0,0.0
1014,713,24-09-2019 11:24:00,1,1765.0,1369.0,0.776,8.468,3,3,2,1,0,0,0,0,0.0,0.0
1014,714,24-09-2019 11:26:00,1,1784.0,1368.0,0.767,8.544,0,0,0,0,0,0,0,0,0.0,0.0
1014,715,24-09-2019 11:28:00,1,1790.0,1296.0,0.724,8.489,0,0,0,0,0,0,0,0,0.0,0.0
1014,716,24-09-2019 11:30:00,1,1792.0,1272.0,0.71,8.469,2,2,1,1,0,0,0,0,0.0,0.0
1014,717,24-09-2019 11:32:00,1,1767.0,1391.0,0.787,8.504,35,19,9,10,16,0,16,0,0.0,0.0
1014,718,24-09-2019 11:34:00,1,2074.0,1544.0,0.745,9.881,3,0,0,0,3,0,3,0,0.0,0.0
1014,719,24-09-2019 11:36:00,1,2290.0,1664.0,0.727,10.867,31,26,7,19,5,0,5,3,0.0,0.0
1014,720,24-09-2019 11:38:00,1,2281.0,1751.0,0.768,10.927,268,179,136,43,89,63,26,16,0.0,0.0
1014,721,24-09-2019 11:40:00,1,2255.0,1785.0,0.792,10.861,518,386,301,85,132,89,43,54,0.0,0.0
1014,722,24-09-2019 11:42:00,1,2049.0,1650.0,0.805,9.901,155,115,87,28,40,13,27,0,0.0,0.0
1014,723,24-09-2019 11:44:00,1,2263.0,1748.0,0.772,10.852,303,183,141,42,120,102,18,7,0.0,0.0
1014,724,24-09-2019 11:46:00,1,2254.0,1847.0,0.819,10.927,72,29,21,8,43,17,26,25,0.0,0.0
1014,725,24-09-2019 11:48:00,1,2278.0,1673.0,0.734,10.83,25,23,6,17,2,0,2,5,0.0,0.0
1014,726,24-09-2019 11:50:00,1,2260.0,1718.0,0.76,10.805,8,8,1,7,0,0,0,2,0.0,0.0
1014,727,24-09-2019 11:52:00,1,2255.0,1735.0,0.7695,10.8045,12,12,1,11,0,0,0,2,0.0,0.0
1014,728,24-09-2019 11:54:00,1,2250.0,1752.0,0.779,10.804,12,11,1,10,1,0,1,0,0.0,0.0
1014,729,24-09-2019 11:56:00,1,2262.0,1807.0,0.799,10.913,43,43,13,30,0,0,0,0,0.0,0.0
1014,730,24-09-2019 11:58:00,1,2252.0,1772.0,0.787,10.834,3,2,2,0,1,0,1,0,0.0,0.0
1014,731,24-09-2019 12:00:00,1,2169.0,1669.0,0.77,10.395,0,0,0,0,0,0,0,0,0.0,0.0
1014,732,24-09-2019 12:02:00,1,2073.0,1531.0,0.738,9.864,9,9,4,5,0,0,0,0,0.0,0.0
1014,733,24-09-2019 12:04:00,1,1979.0,1461.0,0.739,9.414,0,0,0,0,0,0,0,0,0.0,0.0
1014,734,24-09-2019 12:06:00,1,1778.0,1387.0,0.78,8.541,0,0,0,0,0,0,0,0,0.0,0.0
1014,735,24-09-2019 12:08:00,1,1783.0,1309.0,0.734,8.474,0,0,0,0,0,0,0,0,0.0,0.0
1014,736,24-09-2019 12:10:00,1,1801.0,1268.0,0.704,8.502,2,2,0,2,0,0,0,0,0.0,0.0
1014,737,24-09-2019 12:12:00,1,1788.0,1292.0,0.723,8.478,1,1,0,1,0,0,0,0,0.0,0.0
1014,738,24-09-2019 12:14:00,1,1803.0,1277.0,0.709,8.517,3,3,0,3,0,0,0,0,0.0,0.0
1014,739,24-09-2019 12:16:00,1,1791.0,1261.0,0.704,8.454,0,0,0,0,0,0,0,0,0.0,0.0
1014,740,24-09-2019 12:18:00,1,1800.0,1309.0,0.727,8.543,2,2,1,1,0,0,0,0,0.0,0.0
1014,741,24-09-2019 12:20:00,1,1773.0,1325.0,0.748,8.452,6,6,5,1,0,0,0,0,0.0,0.0
1014,742,24-09-2019 12:22:00,1,2005.0,1426.0,0.711,9.478,0,0,0,0,0,0,0,0,0.0,0.0
1014,743,24-09-2019 12:24:00,1,2000.0,1415.0,0.707,9.448,0,0,0,0,0,0,0,0,0.0,0.0
1014,744,24-09-2019 12:26:00,1,2060.5,1419.0,0.689,9.6895,11,0,0,0,11,1,10,0,0.0,0.0
1014,745,24-09-2019 12:28:00,1,2121.0,1423.0,0.671,9.931,12,0,0,0,12,0,12,0,0.0,0.0
1014,746,24-09-2019 12:30:00,1,2223.0,1405.0,0.632,10.313,0,0,0,0,0,0,0,0,0.0,0.0
1014,747,24-09-2019 12:32:00,1,1905.0,1325.0,0.695,8.974,0,0,0,0,0,0,0,0,0.0,0.0
1014,748,24-09-2019 12:34:00,1,1916.0,1262.0,0.659,8.948,184,126,89,37,58,35,23,6,0.0,0.0
1014,749,24-09-2019 12:36:00,1,2218.0,1486.0,0.67,10.384,91,42,24,18,49,28,21,18,0.0,0.02
1014,750,24-09-2019 12:38:00,1,2190.0,1593.0,0.727,10.394,168,132,98,34,36,27,9,32,0.0,0.0
1014,751,24-09-2019 12:40:00,1,2303.0,1626.0,0.706,10.873,218,143,107,36,75,53,22,19,0.0,0.0
1014,752,24-09-2019 12:42:00,1,2200.0,1514.0,0.688,10.345,50,48,18,30,2,1,1,1,0.0,0.0
1014,753,24-09-2019 12:44:00,1,2309.0,1643.0,0.711,10.918,63,44,26,18,19,0,19,2,0.0,0.0
1014,754,24-09-2019 12:46:00,1,2279.0,1652.0,0.725,10.811,16,16,8,8,0,0,0,0,0.0,0.0
1014,755,24-09-2019 12:48:00,1,2403.0,1726.0,0.718,11.378,31,31,17,14,0,0,0,0,0.0,0.0
1014,756,24-09-2019 12:50:00,1,2401.0,1681.0,0.7,11.32,0,0,0,0,0,0,0,0,0.0,0.0
1014,757,24-09-2019 12:52:00,1,2188.0,1572.0,0.719,10.362,1,1,0,1,0,0,0,0,0.0,0.0
1014,758,24-09-2019 12:54:00,1,2119.0,1448.0,0.683,9.953,0,0,0,0,0,0,0,0,0.0,0.0
1014,759,24-09-2019 12:56:00,1,1889.0,1351.0,0.715,8.94,1,1,0,1,0,0,0,0,0.0,0.0
1014,760,24-09-2019 12:58:00,1,1912.0,1323.0,0.692,8.999,0,0,0,0,0,0,0,0,0.0,0.0
1014,761,24-09-2019 13:00:00,1,1845.5,1346.5,0.731,8.762,1,1,0,1,0,0,0,0,0.0,0.0
1014,762,24-09-2019 13:02:00,1,1779.0,1370.0,0.77,8.525,0,0,0,0,0,0,0,0,0.0,0.0
1014,763,24-09-2019 13:04:00,1,1779.0,1360.0,0.765,8.517,1,1,0,1,0,0,0,0,0.0,0.0
1014,764,24-09-2019 13:06:00,1,1772.0,1334.0,0.753,8.457,0,0,0,0,0,0,0,0,0.0,0.0
1014,765,24-09-2019 13:08:00,1,1788.0,1305.0,0.73,8.489,5,5,2,3,0,0,0,0,0.0,0.0
1014,766,24-09-2019 13:10:00,1,1795.0,1260.0,0.702,8.468,2,2,1,1,0,0,0,0,0.0,0.0
1014,767,24-09-2019 13:12:00,1,1805.0,1272.0,0.705,8.521,0,0,0,0,0,0,0,0,0.0,0.0
1014,768,24-09-2019 13:14:00,1,1780.0,1337.0,0.751,8.494,3,3,0,3,0,0,0,0,0.0,0.0
1014,769,24-09-2019 13:16:00,1,1900.0,1360.0,0.715,8.993,0,0,0,0,0,0,0,0,0.0,0.0
1014,770,24-09-2019 13:18:00,1,1783.0,1342.0,0.753,8.51,9,9,0,9,0,0,0,0,0.0,0.0
1014,771,24-09-2019 13:20:00,1,1902.0,1357.0,0.714,8.997,1,1,0,1,0,0,0,0,0.0,0.0
1014,772,24-09-2019 13:22:00,1,1785.0,1346.0,0.754,8.522,3,3,0,3,0,0,0,0,0.0,0.0
1014,773,24-09-2019 13:24:00,1,1788.0,1313.0,0.734,8.498,0,0,0,0,0,0,0,0,0.0,0.0
1014,774,24-09-2019 13:26:00,1,1798.0,1279.0,0.711,8.502,6,6,2,4,0,0,0,0,0.0,0.0
1014,775,24-09-2019 13:28:00,1,1777.0,1309.0,0.737,8.45,2,2,0,2,0,0,0,0,0.0,0.0
1014,776,24-09-2019 13:30:00,1,1793.0,1321.0,0.737,8.529,0,0,0,0,0,0,0,0,0.0,0.0
1014,777,24-09-2019 13:32:00,1,1792.0,1261.0,0.703,8.458,3,3,0,3,0,0,0,0,0.0,0.0
1014,778,24-09-2019 13:34:00,1,1844.0,1290.5,0.6995,8.6955,1,1,0,1,0,0,0,0,0.0,0.0
1014,779,24-09-2019 13:36:00,1,1896.0,1320.0,0.696,8.933,9,8,3,5,1,0,1,0,0.0,0.0
1014,780,24-09-2019 13:38:00,1,1917.0,1295.0,0.675,8.987,0,0,0,0,0,0,0,0,0.0,0.0
1014,781,24-09-2019 13:40:00,1,1913.0,1295.0,0.677,8.972,5,5,0,5,0,0,0,0,0.0,0.0
1014,782,24-09-2019 13:42:00,1,1897.0,1360.0,0.717,8.981,9,6,0,6,3,0,3,0,0.0,0.0
1014,783,24-09-2019 13:44:00,1,1898.0,1364.0,0.719,8.99,2,2,0,2,0,0,0,0,0.0,0.0
1014,784,24-09-2019 13:46:00,1,1896.0,1371.0,0.723,8.988,2,2,0,2,0,0,0,0,0.0,0.0
1014,785,24-09-2019 13:48:00,1,1999.0,1362.0,0.682,9.383,0,0,0,0,0,0,0,0,0.0,0.0
1014,786,24-09-2019 13:50:00,1,1896.0,1355.0,0.715,8.97,19,14,6,8,5,0,5,0,0.0,0.0
1014,787,24-09-2019 13:52:00,1,2013.0,1385.0,0.688,9.466,56,40,8,32,16,0,16,0,0.0,0.0
1014,788,24-09-2019 13:54:00,1,2199.0,1542.0,0.701,10.372,7,7,2,5,0,0,0,0,0.0,0.0
1014,789,24-09-2019 13:56:00,1,2181.0,1619.0,0.742,10.386,37,26,10,16,11,0,11,0,0.01,0.0
1014,790,24-09-2019 13:58:00,1,2197.0,1592.0,0.725,10.42,49,37,11,26,12,1,11,1,0.0,0.0
1014,791,24-09-2019 14:00:00,1,2185.0,1621.0,0.742,10.404,62,52,28,24,10,1,9,0,0.0,0.0
1014,792,24-09-2019 14:02:00,1,2190.0,1608.0,0.734,10.41,96,80,63,17,16,6,10,9,0.0,0.0
1014,793,24-09-2019 14:04:00,1,2389.0,1659.0,0.694,11.25,0,0,0,0,0,0,0,0,0.0,0.0
1014,794,24-09-2019 14:06:00,1,2207.0,1567.0,0.71,10.432,1,1,1,0,0,0,0,0,0.0,0.0
1014,795,24-09-2019 14:08:00,1,2041.5,1482.5,0.7275,9.685,0,0,0,0,0,0,0,0,0.0,0.0
1014,796,24-09-2019 14:10:00,1,1876.0,1398.0,0.745,8.938,0,0,0,0,0,0,0,0,0.0,0.0
1014,797,24-09-2019 14:12:00,1,1893.0,1350.0,0.713,8.954,2,2,0,2,0,0,0,0,0.0,0.0
1014,798,24-09-2019 14:14:00,1,1904.0,1317.0,0.692,8.959,0,0,0,0,0,0,0,0,0.0,0.0
1014,799,24-09-2019 14:16:00,1,1934.0,1261.0,0.652,9.018,14,14,0,14,0,0,0,0,0.0,0.0
1014,800,24-09-2019 14:18:00,1,1922.0,1266.0,0.659,8.976,0,0,0,0,0,0,0,0,0.0,0.0
1014,801,24-09-2019 14:20:00,1,1909.0,1287.0,0.674,8.947,0,0,0,0,0,0,0,0,0.0,0.0
1014,802,24-09-2019 14:22:00,1,1933.0,1255.0,0.649,9.006,2,2,0,2,0,0,0,0,0.0,0.0
1014,803,24-09-2019 14:24:00,1,1918.0,1265.0,0.66,8.958,1,1,0,1,0,0,0,0,0.0,0.0
1014,804,24-09-2019 14:26:00,1,1917.0,1284.0,0.67,8.976,0,0,0,0,0,0,0,0,0.0,0.0
1014,805,24-09-2019 14:28:00,1,1898.0,1299.0,0.684,8.918,13,9,5,4,4,0,4,0,0.0,0.0
1014,806,24-09-2019 14:30:00,1,1906.0,1287.0,0.675,8.937,3,2,0,2,1,0,1,0,0.0,0.0
1014,807,24-09-2019 14:32:00,1,1900.0,1311.0,0.69,8.937,1,0,0,0,1,0,1,0,0.0,0.0
1014,808,24-09-2019 14:34:00,1,1905.0,1318.0,0.692,8.966,1,0,0,0,1,0,1,0,0.0,0.0
1014,809,24-09-2019 14:36:00,1,1919.0,1285.0,0.67,8.984,10,9,0,9,1,0,1,0,0.0,0.0
1014,810,24-09-2019 14:38:00,1,1929.0,1234.0,0.64,8.968,12,6,0,6,6,0,6,0,0.0,0.0
1014,811,24-09-2019 14:40:00,1,1926.0,1253.0,0.651,8.974,15,15,0,15,0,0,0,0,0.0,0.0
1014,812,24-09-2019 14:42:00,1,1912.5,1287.5,0.6735,8.96,15,15,0,15,0,0,0,0,0.0,0.0
1014,813,24-09-2019 14:44:00,1,1899.0,1322.0,0.696,8.946,2,2,0,2,0,0,0,0,0.0,0.0
1014,814,24-09-2019 14:46:00,1,1896.0,1323.0,0.698,8.936,4,4,0,4,0,0,0,0,0.0,0.0
1014,815,24-09-2019 14:48:00,1,1914.0,1306.0,0.682,8.989,0,0,0,0,0,0,0,0,0.0,0.0
1014,816,24-09-2019 14:50:00,1,1887.0,1335.0,0.708,8.912,6,5,5,0,1,0,1,0,0.0,0.0
1014,817,24-09-2019 14:52:00,1,2024.0,1376.0,0.68,9.5,0,0,0,0,0,0,0,0,0.0,0.0
1014,818,24-09-2019 14:54:00,1,1885.0,1332.0,0.707,8.903,0,0,0,0,0,0,0,0,0.0,0.0
1014,819,24-09-2019 14:56:00,1,1916.0,1250.0,0.652,8.935,2,0,0,0,2,0,2,0,0.0,0.0
1014,820,24-09-2019 14:58:00,1,1937.0,1222.0,0.631,8.987,0,0,0,0,0,0,0,0,0.0,0.0
1014,821,24-09-2019 15:00:00,1,1929.0,1218.0,0.632,8.95,0,0,0,0,0,0,0,0,0.0,0.0
1014,822,24-09-2019 15:02:00,1,1929.0,1230.0,0.638,8.961,16,16,3,13,0,0,0,0,0.0,0.0
1014,823,24-09-2019 15:04:00,1,1895.0,1345.0,0.71,8.957,30,28,4,24,2,0,2,0,0.0,0.0
1014,824,24-09-2019 15:06:00,1,2110.0,1465.0,0.695,9.935,37,31,11,20,6,2,4,1,0.0,0.0
1014,825,24-09-2019 15:08:00,1,2221.0,1468.0,0.661,10.376,106,97,55,42,9,1,8,1,0.0,0.0
1014,826,24-09-2019 15:10:00,1,2222.0,1465.0,0.659,10.377,15,15,1,14,0,0,0,0,0.0,0.0
1014,827,24-09-2019 15:12:00,1,2094.0,1474.0,0.704,9.881,39,36,13,23,3,1,2,0,0.0,0.0
1014,828,24-09-2019 15:14:00,1,2216.0,1487.0,0.671,10.376,222,147,106,41,75,41,34,41,0.0,0.0
1014,829,24-09-2019 15:16:00,1,2305.0,1578.0,0.684,10.829,215,132,103,29,83,48,35,102,0.0,0.0
1014,830,24-09-2019 15:18:00,1,2394.0,1669.0,0.697,11.282,97,58,39,19,39,2,37,46,0.0,0.0
1014,831,24-09-2019 15:20:00,1,2618.0,1816.0,0.694,12.327,122,83,54,29,39,5,34,56,0.0,0.0
1014,832,24-09-2019 15:22:00,1,2917.0,2001.0,0.686,13.711,139,103,70,33,36,2,34,47,0.0,0.03
1014,833,24-09-2019 15:24:00,1,2896.0,2061.0,0.712,13.693,183,126,85,41,57,2,55,71,0.0,0.0
1014,834,24-09-2019 15:26:00,1,2972.0,2204.0,0.742,14.152,131,86,57,29,45,13,32,54,0.0,0.0
1014,835,24-09-2019 15:28:00,1,2656.0,2038.0,0.767,12.722,389,266,212,54,123,90,33,80,0.02,0.04
1014,836,24-09-2019 15:30:00,1,2992.0,2184.0,0.73,14.205,88,48,35,13,40,24,16,33,0.05,0.0
1014,837,24-09-2019 15:32:00,1,2204.0,1524.0,0.691,10.371,147,61,33,28,86,54,32,2,0.0,0.0
1014,838,24-09-2019 15:34:00,1,1923.0,1253.0,0.652,8.963,369,246,195,51,123,86,37,11,0.0,0.0
1014,839,24-09-2019 15:36:00,1,2284.0,1715.0,0.751,10.899,346,276,210,66,70,48,22,4,0.0,0.03
1014,840,24-09-2019 15:38:00,1,2167.0,1686.0,0.778,10.405,247,215,162,53,32,12,20,0,0.0,0.0
1014,841,24-09-2019 15:40:00,1,2574.0,1965.0,0.764,12.319,534,338,256,82,196,154,42,35,0.0,0.0
1014,842,24-09-2019 15:42:00,1,2566.0,1925.0,0.75,12.241,315,220,168,52,95,67,28,23,0.0,0.0
1014,843,24-09-2019 15:44:00,1,2974.0,2235.0,0.751,14.193,151,91,64,27,60,26,34,12,0.03,0.0
1014,844,24-09-2019 15:46:00,1,2669.0,2054.0,0.77,12.79,5,5,0,5,0,0,0,0,0.0,0.0
1014,845,24-09-2019 15:48:00,1,2640.0,2078.0,0.787,12.704,24,13,4,9,11,0,11,1,0.01,0.01
1014,846,24-09-2019 15:50:00,1,2537.0,2007.5,0.7915,12.2195,14,14,2,12,0,0,0,0,0.0,0.0
1014,847,24-09-2019 15:52:00,1,2434.0,1937.0,0.796,11.735,13,13,1,12,0,0,0,0,0.0,0.0
1014,848,24-09-2019 15:54:00,1,2376.0,1833.0,0.771,11.392,10,7,0,7,3,0,3,0,0.0,0.0
1014,849,24-09-2019 15:56:00,1,2257.0,1721.0,0.762,10.8,11,10,0,10,1,0,1,0,0.0,0.0
1014,850,24-09-2019 15:58:00,1,2174.0,1638.0,0.753,10.379,0,0,0,0,0,0,0,0,0.0,0.0
1014,851,24-09-2019 16:00:00,1,2068.0,1582.0,0.765,9.899,6,4,2,2,2,0,2,0,0.0,0.0
1014,852,24-09-2019 16:02:00,1,2084.0,1553.0,0.745,9.929,16,5,2,3,11,0,11,0,0.0,0.0
1014,853,24-09-2019 16:04:00,1,1975.0,1535.0,0.777,9.479,37,1,0,1,36,0,36,0,0.0,0.0
1014,854,24-09-2019 16:06:00,1,1964.0,1531.0,0.78,9.434,8,4,1,3,4,0,4,0,0.0,0.0
1014,855,24-09-2019 16:08:00,1,2080.0,1567.0,0.753,9.929,9,9,1,8,0,0,0,0,0.0,0.0
1014,856,24-09-2019 16:10:00,1,2191.0,1607.0,0.733,10.411,20,12,0,12,8,0,8,0,0.0,0.0
1014,857,24-09-2019 16:12:00,1,2191.0,1588.0,0.725,10.391,16,14,2,12,2,0,2,0,0.0,0.0
1014,858,24-09-2019 16:14:00,1,2091.0,1534.0,0.734,9.937,2,1,1,0,1,0,1,0,0.0,0.0
1014,859,24-09-2019 16:16:00,1,1853.0,1478.0,0.798,8.937,3,3,0,3,0,0,0,0,0.0,0.0
1014,860,24-09-2019 16:18:00,1,1868.0,1481.0,0.793,8.998,7,7,2,5,0,0,0,0,0.0,0.0
1014,861,24-09-2019 16:20:00,1,1874.0,1483.0,0.791,9.024,10,2,1,1,8,0,8,0,0.0,0.0
1014,862,24-09-2019 16:22:00,1,1868.0,1471.0,0.787,8.99,6,2,0,2,4,0,4,0,0.0,0.0
1014,863,24-09-2019 16:24:00,1,1866.0,1468.5,0.787,8.9785,0,0,0,0,0,0,0,0,0.0,0.0
1014,864,24-09-2019 16:26:00,1,1864.0,1466.0,0.787,8.967,4,4,1,3,0,0,0,0,0.0,0.0
1014,865,24-09-2019 16:28:00,1,1896.0,1385.0,0.731,9.004,6,1,0,1,5,0,5,0,0.0,0.0
1014,866,24-09-2019 16:30:00,1,1890.0,1375.0,0.728,8.968,17,11,2,9,6,0,6,1,0.0,0.0
1014,867,24-09-2019 16:32:00,1,1862.0,1458.0,0.783,8.949,5,2,0,2,3,0,3,0,0.0,0.0
1014,868,24-09-2019 16:34:00,1,2099.0,1521.0,0.725,9.953,4,0,0,0,4,0,4,0,0.0,0.0
1014,869,24-09-2019 16:36:00,1,2194.0,1538.0,0.701,10.346,3,2,1,1,1,0,1,0,0.0,0.0
1014,870,24-09-2019 16:38:00,1,2095.0,1513.0,0.722,9.93,3,1,0,1,2,0,2,0,0.0,0.0
1014,871,24-09-2019 16:40:00,1,2099.0,1504.0,0.716,9.937,2,1,0,1,1,0,1,0,0.0,0.0
1014,872,24-09-2019 16:42:00,1,2200.0,1503.0,0.683,10.332,2,1,0,1,1,0,1,0,0.0,0.0
1014,873,24-09-2019 16:44:00,1,2206.0,1542.0,0.699,10.397,2,0,0,0,2,0,2,0,0.0,0.0
1014,874,24-09-2019 16:46:00,1,2206.0,1531.0,0.694,10.386,11,4,2,2,7,0,7,0,0.0,0.0
1014,875,24-09-2019 16:48:00,1,2105.0,1497.0,0.711,9.953,19,15,8,7,4,0,4,0,0.0,0.0
1014,876,24-09-2019 16:50:00,1,2197.0,1541.0,0.701,10.364,3,3,2,1,0,0,0,0,0.0,0.0
1014,877,24-09-2019 16:52:00,1,2107.0,1491.0,0.708,9.955,18,13,7,6,5,2,3,0,0.0,0.0
1014,878,24-09-2019 16:54:00,1,1972.0,1460.0,0.74,9.387,0,0,0,0,0,0,0,0,0.0,0.0
1014,879,24-09-2019 16:56:00,1,2098.0,1475.0,0.703,9.899,2,0,0,0,2,0,2,0,0.0,0.0
1014,880,24-09-2019 16:58:00,1,2034.5,1459.5,0.718,9.6325,0,0,0,0,0,0,0,0,0.0,0.0
1014,881,24-09-2019 17:00:00,1,1971.0,1444.0,0.733,9.366,0,0,0,0,0,0,0,0,0.0,0.0
1014,882,24-09-2019 17:02:00,1,1894.0,1406.0,0.742,9.019,43,33,10,23,10,0,10,1,0.0,0.0
1014,883,24-09-2019 17:04:00,1,2084.0,1506.0,0.723,9.877,20,20,0,20,0,0,0,0,0.0,0.0
1014,884,24-09-2019 17:06:00,1,2178.0,1598.0,0.733,10.351,33,29,10,19,4,2,2,1,0.0,0.0
1014,885,24-09-2019 17:08:00,1,2168.0,1692.0,0.78,10.417,222,130,106,24,92,56,36,51,0.0,0.0
1014,886,24-09-2019 17:10:00,1,2148.0,1711.0,0.797,10.358,209,144,109,35,65,36,29,120,0.0,0.0
1014,887,24-09-2019 17:12:00,1,2389.0,1788.0,0.748,11.391,114,64,40,24,50,1,49,75,0.0,0.0
1014,888,24-09-2019 17:14:00,1,2688.0,1989.0,0.74,12.794,122,79,50,29,43,2,41,43,0.0,0.0
1014,889,24-09-2019 17:16:00,1,2880.0,2141.0,0.743,13.719,168,127,90,37,41,0,41,50,0.0,0.11
1014,890,24-09-2019 17:18:00,1,2336.0,1886.0,0.808,11.292,6,0,0,0,6,1,5,0,0.0,0.02
1014,891,24-09-2019 17:20:00,1,2382.0,1746.0,0.733,11.318,153,122,87,35,31,10,21,19,0.0,0.0
1014,892,24-09-2019 17:22:00,1,2379.0,1776.0,0.746,11.339,527,321,260,61,206,161,45,102,0.0,0.03
1014,893,24-09-2019 17:24:00,1,2176.0,1632.0,0.75,10.381,225,150,113,37,75,49,26,9,0.0,0.0
1014,894,24-09-2019 17:26:00,1,2566.0,1974.0,0.769,12.297,238,143,112,31,95,62,33,12,0.0,0.0
1014,895,24-09-2019 17:28:00,1,2177.0,1674.0,0.769,10.433,38,25,12,13,13,0,13,0,0.0,0.0
1014,896,24-09-2019 17:30:00,1,2198.0,1557.0,0.708,10.385,17,1,1,0,16,0,16,0,0.0,0.0
1014,897,24-09-2019 17:32:00,1,2092.0,1538.5,0.7365,9.9455,7,0,0,0,7,0,7,0,0.0,0.0
1014,898,24-09-2019 17:34:00,1,1986.0,1520.0,0.765,9.506,2,0,0,0,2,0,2,0,0.0,0.0
1014,899,24-09-2019 17:36:00,1,2084.0,1519.0,0.729,9.892,7,4,3,1,3,0,3,0,0.0,0.0
1014,900,24-09-2019 17:38:00,1,2093.0,1527.0,0.73,9.936,0,0,0,0,0,0,0,0,0.0,0.0
1014,901,24-09-2019 17:40:00,1,2091.0,1538.0,0.736,9.94,1,0,0,0,1,0,1,0,0.0,0.0
1014,902,24-09-2019 17:42:00,1,2160.0,1632.0,0.756,10.318,0,0,0,0,0,0,0,0,0.0,0.0
1014,903,24-09-2019 17:44:00,1,2153.0,1771.0,0.823,10.443,0,0,0,0,0,0,0,0,0.0,0.0
1014,904,24-09-2019 17:46:00,1,2353.0,1822.0,0.774,11.288,0,0,0,0,0,0,0,0,0.0,0.0
1014,905,24-09-2019 17:48:00,1,2364.0,1854.0,0.784,11.367,1,0,0,0,1,0,1,0,0.0,0.0
1014,906,24-09-2019 17:50:00,1,2365.0,1864.0,0.788,11.382,12,8,4,4,4,0,4,0,0.0,0.0
1014,907,24-09-2019 17:52:00,1,2135.0,1746.0,0.818,10.346,30,16,10,6,14,0,14,0,0.02,0.0
1014,908,24-09-2019 17:54:00,1,2351.0,1901.0,0.809,11.367,24,9,6,3,15,0,15,0,0.0,0.0
1014,909,24-09-2019 17:56:00,1,2162.0,1661.0,0.768,10.358,0,0,0,0,0,0,0,0,0.0,0.0
1014,910,24-09-2019 17:58:00,1,2071.0,1640.0,0.792,9.976,6,5,2,3,1,0,1,0,0.0,0.0
1014,911,24-09-2019 18:00:00,0,2147.0,1757.0,0.818,10.404,39,23,4,19,16,1,15,5,0.0,0.0
1014,912,24-09-2019 18:02:00,0,2606.0,2274.0,0.873,12.785,400,224,194,30,176,132,44,91,0.0,0.0
1014,913,24-09-2019 18:04:00,0,2907.0,2461.0,0.847,14.177,458,251,212,39,207,157,50,117,0.0,0.0
1014,914,24-09-2019 18:06:00,0,2951.0,2537.0,0.8595,14.4355,152,104,70,34,48,1,47,74,0.0,0.0
1014,915,24-09-2019 18:08:00,0,2995.0,2613.0,0.872,14.694,126,96,57,39,30,2,28,44,0.0,0.06
1014,916,24-09-2019 18:10:00,0,2794.0,2463.0,0.882,13.735,238,135,106,29,103,59,44,49,0.0,0.05
1014,917,24-09-2019 18:12:00,0,2820.0,2321.0,0.823,13.681,408,217,170,47,191,157,34,169,0.0,0.01
1014,918,24-09-2019 18:14:00,0,2788.0,2408.0,0.863,13.652,282,157,121,36,125,101,24,119,0.0,0.0
1014,919,24-09-2019 18:16:00,0,2803.0,2425.0,0.865,13.728,235,142,112,30,93,56,37,42,0.09,0.0
1014,920,24-09-2019 18:18:00,0,2796.0,2405.0,0.86,13.677,151,94,69,25,57,6,51,60,0.01,0.0
1014,921,24-09-2019 18:20:00,0,3262.0,2917.0,0.894,16.081,105,70,49,21,35,0,35,33,0.01,0.05
1014,922,24-09-2019 18:22:00,0,3058.0,2742.0,0.897,15.083,96,66,39,27,30,2,28,32,0.0,0.05
1014,923,24-09-2019 18:24:00,0,3279.0,2845.0,0.868,16.068,140,100,68,32,40,1,39,44,0.0,0.07
1014,924,24-09-2019 18:26:00,0,3261.0,2927.0,0.898,16.09,204,89,72,17,115,82,33,25,0.12,0.02
1014,925,24-09-2019 18:28:00,0,2596.0,2319.0,0.893,12.795,56,38,27,11,18,3,15,7,0.0,0.0
1014,926,24-09-2019 18:30:00,0,2009.0,1800.0,0.896,9.907,64,46,19,27,18,0,18,4,0.0,0.0
1014,927,24-09-2019 18:32:00,0,2034.0,1763.0,0.867,9.966,74,55,27,28,19,1,18,0,0.0,0.0
1014,928,24-09-2019 18:34:00,0,2707.0,2301.0,0.85,13.214,171,92,63,29,79,63,16,56,0.0,0.02
1014,929,24-09-2019 18:36:00,0,3467.0,3040.0,0.877,17.028,318,175,139,36,143,103,40,150,0.01,0.0
1014,930,24-09-2019 18:38:00,0,3544.0,3118.0,0.88,17.414,172,76,52,24,96,68,28,113,0.14,0.0
1014,931,24-09-2019 18:40:00,0,3546.0,3175.5,0.8955,17.4855,109,67,39,28,42,2,40,49,0.04,0.0
1014,932,24-09-2019 18:42:00,0,3548.0,3233.0,0.911,17.557,46,26,15,11,20,0,20,20,0.0,0.14
1014,933,24-09-2019 18:44:00,0,2970.0,2670.0,0.899,14.657,16,12,4,8,4,0,4,17,0.0,0.0
1014,934,24-09-2019 18:46:00,0,3248.0,2936.0,0.904,16.047,222,114,97,17,108,80,28,58,0.03,0.01
1014,935,24-09-2019 18:48:00,0,3545.0,3178.0,0.897,17.487,287,172,142,30,115,89,26,121,0.0,0.01
1014,936,24-09-2019 18:50:00,0,2792.0,2417.0,0.866,13.678,359,184,143,41,175,127,48,36,0.0,0.0
1014,937,24-09-2019 18:52:00,0,2940.0,2799.0,0.952,14.683,273,129,99,30,144,110,34,134,0.09,0.02
1014,938,24-09-2019 18:54:00,0,3261.0,2897.0,0.888,16.057,182,85,49,36,97,57,40,25,0.0,0.0
1014,939,24-09-2019 18:56:00,0,2507.0,2224.0,0.887,12.34,118,77,58,19,41,25,16,70,0.0,0.0
1014,940,24-09-2019 18:58:00,0,2969.0,2670.0,0.899,14.655,84,39,20,19,45,6,39,13,0.0,0.07
1014,941,24-09-2019 19:00:00,0,2951.0,2720.0,0.922,14.637,26,8,3,5,18,2,16,32,0.0,0.0
1014,942,24-09-2019 19:02:00,0,2952.0,2724.0,0.923,14.645,58,44,30,14,14,6,8,46,0.0,0.23
1014,943,24-09-2019 19:04:00,0,2774.0,2493.0,0.899,13.687,7,6,0,6,1,0,1,0,0.0,0.02
1014,944,24-09-2019 19:06:00,0,2790.0,2457.0,0.881,13.711,1,0,0,0,1,0,1,0,0.0,0.01
1014,945,24-09-2019 19:08:00,0,3247.0,2978.0,0.917,16.089,127,68,50,18,59,43,16,47,0.1,0.0
1014,946,24-09-2019 19:10:00,0,3362.0,3063.0,0.911,16.637,270,152,122,30,118,89,29,99,0.11,0.05
1014,947,24-09-2019 19:12:00,0,2470.0,2241.0,0.907,12.213,202,102,66,36,100,74,26,28,0.0,0.0
1014,948,24-09-2019 19:14:00,0,2726.0,2427.5,0.892,13.4285,173,145,97,48,28,11,17,1,0.0,0.0
1014,949,24-09-2019 19:16:00,0,2982.0,2614.0,0.877,14.644,62,46,19,27,16,4,12,21,0.0,0.0
1014,950,24-09-2019 19:18:00,0,2952.0,2743.0,0.929,14.669,56,40,20,20,16,5,11,10,0.0,0.0
1014,951,24-09-2019 19:20:00,0,2490.0,2176.0,0.874,12.218,23,14,9,5,9,2,7,0,0.03,0.0
1014,952,24-09-2019 19:22:00,0,2518.0,2211.0,0.878,12.37,5,2,1,1,3,1,2,0,0.0,0.0
1014,953,24-09-2019 19:24:00,0,2293.0,2088.0,0.911,11.344,3,3,0,3,0,0,0,0,0.0,0.0
1014,954,24-09-2019 19:26:00,0,2414.0,2099.0,0.869,11.835,6,3,1,2,3,1,2,0,0.0,0.0
1014,955,24-09-2019 19:28:00,0,2407.0,2114.0,0.878,11.825,2,0,0,0,2,0,2,0,0.0,0.0
1014,956,24-09-2019 19:30:00,0,2510.0,2178.0,0.868,12.301,1,0,0,0,1,0,1,0,0.0,0.0
1014,957,24-09-2019 19:32:00,0,2510.0,2168.0,0.864,12.29,0,0,0,0,0,0,0,0,0.0,0.0
1014,958,24-09-2019 19:34:00,0,2516.0,2185.0,0.868,12.333,6,4,1,3,2,0,2,0,0.0,0.0
1014,959,24-09-2019 19:36:00,0,2468.0,2347.0,0.951,12.323,18,11,6,5,7,2,5,0,0.0,0.0
1014,960,24-09-2019 19:38:00,0,2487.0,2260.0,0.909,12.299,8,1,0,1,7,1,6,0,0.0,0.0
1014,961,24-09-2019 19:40:00,0,2378.0,2183.0,0.918,11.787,16,0,0,0,16,0,16,0,0.0,0.0
1014,962,24-09-2019 19:42:00,0,2177.0,2072.0,0.951,10.872,14,14,8,6,0,0,0,0,0.0,0.0
1014,963,24-09-2019 19:44:00,0,2381.0,2217.0,0.931,11.836,12,12,7,5,0,0,0,0,0.0,0.0
1014,964,24-09-2019 19:46:00,0,2482.0,2286.0,0.921,12.309,5,0,0,0,5,1,4,0,0.0,0.0
1014,965,24-09-2019 19:48:00,0,2321.0,2209.5,0.9545,11.5905,1,0,0,0,1,0,1,0,0.0,0.0
1014,966,24-09-2019 19:50:00,0,2160.0,2133.0,0.988,10.872,3,0,0,0,3,0,3,0,0.0,0.0
1014,967,24-09-2019 19:52:00,0,2194.0,2022.0,0.922,10.882,1,0,0,0,1,0,1,0,0.0,0.0
1014,968,24-09-2019 19:54:00,0,2217.0,1969.0,0.888,10.913,17,9,4,5,8,0,8,0,0.0,0.0
1014,969,24-09-2019 19:56:00,0,2198.0,1973.0,0.898,10.843,14,13,4,9,1,1,0,0,0.0,0.0
1014,970,24-09-2019 19:58:00,0,2181.0,2082.0,0.954,10.9,36,26,9,17,10,0,10,0,0.0,0.0
1014,971,24-09-2019 20:00:00,0,2189.0,2089.0,0.954,10.936,46,41,22,19,5,2,3,0,0.0,0.0
1014,972,24-09-2019 20:02:00,0,2475.0,2260.0,0.913,12.254,32,24,9,15,8,3,5,2,0.0,0.0
1014,973,24-09-2019 20:04:00,0,2459.0,2388.0,0.971,12.334,99,63,27,36,36,21,15,7,0.0,0.0
1014,974,24-09-2019 20:06:00,0,2751.0,2660.0,0.967,13.784,146,75,61,14,71,48,23,105,0.0,0.0
1014,975,24-09-2019 20:08:00,0,2660.0,2470.0,0.928,13.216,345,185,149,36,160,124,36,68,0.03,0.0
1014,976,24-09-2019 20:10:00,0,2780.0,2472.0,0.889,13.69,156,86,68,18,70,23,47,66,0.0,0.0
1014,977,24-09-2019 20:12:00,0,2759.0,2585.0,0.937,13.731,255,144,118,26,111,69,42,109,0.04,0.0
1014,978,24-09-2019 20:14:00,0,2586.0,2372.0,0.917,12.815,63,38,26,12,25,15,10,52,0.0,0.0
1014,979,24-09-2019 20:16:00,0,2863.0,2601.0,0.908,14.162,120,64,40,24,56,2,54,73,0.02,0.0
1014,980,24-09-2019 20:18:00,0,3144.0,2886.0,0.918,15.583,164,102,72,30,62,17,45,58,0.08,0.0
1014,981,24-09-2019 20:20:00,0,2948.0,2808.0,0.953,14.723,122,65,34,31,57,11,46,69,0.0,0.0
1014,982,24-09-2019 20:22:00,0,2765.0,2586.0,0.934,13.7565,154,107,90,17,47,27,20,55,0.01,0.0
1014,983,24-09-2019 20:24:00,0,2582.0,2364.0,0.915,12.79,127,73,50,23,54,11,43,60,0.01,0.02
1014,984,24-09-2019 20:26:00,0,3326.0,3081.0,0.926,16.517,137,95,54,41,42,0,42,70,0.0,0.0
1014,985,24-09-2019 20:28:00,0,3050.0,2902.0,0.952,15.229,250,120,96,24,130,82,48,144,0.06,0.03
1014,986,24-09-2019 20:30:00,0,3244.0,3018.0,0.93,16.123,153,89,59,30,64,16,48,92,0.0,0.0
1014,987,24-09-2019 20:32:00,0,3524.0,3259.0,0.925,17.491,145,88,63,25,57,3,54,60,0.01,0.05
1014,988,24-09-2019 20:34:00,0,2762.0,2596.0,0.94,13.755,145,89,68,21,56,38,18,82,0.0,0.01
1014,989,24-09-2019 20:36:00,0,3152.0,2935.0,0.931,15.669,316,163,129,34,153,119,34,110,0.08,0.0
1014,990,24-09-2019 20:38:00,0,3396.0,3194.0,0.94,16.917,239,141,102,39,98,54,44,41,0.03,0.0
1014,991,24-09-2019 20:40:00,0,3734.0,3430.0,0.919,18.51,141,96,69,27,45,2,43,54,0.0,0.0
1014,992,24-09-2019 20:42:00,0,3554.0,3226.0,0.908,17.572,128,99,67,32,29,0,29,48,0.0,0.12
1014,993,24-09-2019 20:44:00,0,3535.0,3252.0,0.92,17.529,181,139,93,46,42,4,38,63,0.0,0.03
1014,994,24-09-2019 20:46:00,0,3526.0,3199.0,0.907,17.433,95,44,35,9,51,26,25,33,0.07,0.06
1014,995,24-09-2019 20:48:00,0,2865.0,2665.0,0.93,14.239,15,10,6,4,5,4,1,0,0.0,0.0
1014,996,24-09-2019 20:50:00,0,2185.0,2046.0,0.936,10.874,61,41,14,27,20,4,16,1,0.0,0.0
1014,997,24-09-2019 20:52:00,0,2130.0,1861.0,0.874,10.455,41,32,7,25,9,0,9,1,0.0,0.0
1014,998,24-09-2019 20:54:00,0,2195.0,1998.0,0.91,10.859,102,69,43,26,33,13,20,15,0.0,0.0
1014,999,24-09-2019 20:56:00,0,2875.5,2591.0,0.9025,14.1975,293,173,139,34,120,82,38,95,0.05,0.01
1014,1000,24-09-2019 20:58:00,0,3556.0,3184.0,0.895,17.536,125,81,56,25,44,3,41,79,0.0,0.04
1014,1001,24-09-2019 21:00:00,0,3742.0,3392.0,0.906,18.498,96,70,38,32,26,2,24,33,0.0,0.03
1014,1002,24-09-2019 21:02:00,0,3720.0,3416.0,0.918,18.439,117,77,52,25,40,2,38,47,0.0,0.11
1014,1003,24-09-2019 21:04:00,0,3702.0,3492.0,0.943,18.453,103,59,41,18,44,16,28,67,0.16,0.02
1014,1004,24-09-2019 21:06:00,0,2956.0,2794.0,0.945,14.741,128,86,64,22,42,29,13,25,0.01,0.03
1014,1005,24-09-2019 21:08:00,0,2771.0,2482.0,0.896,13.667,167,84,56,28,83,31,52,75,0.0,0.0
1014,1006,24-09-2019 21:10:00,0,3217.0,3063.0,0.952,16.067,402,202,161,41,200,153,47,92,0.0,0.0
1014,1007,24-09-2019 21:12:00,0,3529.0,3301.0,0.935,17.56,152,81,56,25,71,35,36,42,0.06,0.0
1014,1008,24-09-2019 21:14:00,0,3240.0,3043.0,0.939,16.133,188,112,90,22,76,43,33,117,0.01,0.0
1014,1009,24-09-2019 21:16:00,0,3672.0,3589.0,0.977,18.44,199,143,107,36,56,36,20,107,0.0,0.04
1014,1010,24-09-2019 21:18:00,0,3736.0,3390.0,0.907,18.471,162,110,75,35,52,2,50,59,0.0,0.0
1014,1011,24-09-2019 21:20:00,0,3524.0,3257.0,0.924,17.49,249,151,115,36,98,45,53,34,0.08,0.03
1014,1012,24-09-2019 21:22:00,0,2949.0,2798.0,0.949,14.716,208,119,90,29,89,56,33,9,0.01,0.0
1014,1013,24-09-2019 21:24:00,0,2849.0,2656.0,0.932,14.166,120,70,58,12,50,28,22,53,0.01,0.0
1014,1014,24-09-2019 21:26:00,0,3551.0,3224.0,0.908,17.56,160,109,65,44,51,0,51,63,0.0,0.0
1014,1015,24-09-2019 21:28:00,0,3623.0,3370.0,0.93,18.003,93,53,32,21,40,3,37,48,0.0,0.03
1014,1016,24-09-2019 21:30:00,0,3190.5,2944.5,0.9215,15.8295,86,66,52,14,20,3,17,8,0.0,0.01
1014,1017,24-09-2019 21:32:00,0,2758.0,2519.0,0.913,13.656,232,149,125,24,83,54,29,62,0.08,0.0
1014,1018,24-09-2019 21:34:00,0,3518.0,3322.0,0.944,17.539,67,25,17,8,42,11,31,55,0.05,0.0
1014,1019,24-09-2019 21:36:00,0,3527.0,3311.0,0.939,17.563,148,96,63,33,52,2,50,57,0.0,0.02
1014,1020,24-09-2019 21:38:00,0,3743.0,3373.0,0.901,18.483,137,79,43,36,58,6,52,56,0.0,0.04
1014,1021,24-09-2019 21:40:00,0,3734.0,3369.0,0.902,18.441,145,97,60,37,48,5,43,57,0.0,0.06
1014,1022,24-09-2019 21:42:00,0,3533.0,3256.0,0.922,17.524,352,174,132,42,178,120,58,16,0.07,0.08
1014,1023,24-09-2019 21:44:00,0,3140.0,2909.0,0.926,15.593,262,160,124,36,102,77,25,76,0.0,0.0
1014,1024,24-09-2019 21:46:00,0,3564.0,3149.0,0.884,17.529,163,80,51,29,83,60,23,44,0.06,0.0
1014,1025,24-09-2019 21:48:00,0,2934.0,2795.0,0.953,14.655,233,115,82,33,118,87,31,29,0.0,0.0
1014,1026,24-09-2019 21:50:00,0,2292.0,2123.0,0.926,11.381,449,364,290,74,85,48,37,0,0.0,0.0
1014,1027,24-09-2019 21:52:00,0,2769.0,2496.0,0.901,13.674,731,538,441,97,193,134,59,7,0.0,0.0
1014,1028,24-09-2019 21:54:00,0,3349.0,3104.0,0.927,16.632,467,315,255,60,152,105,47,106,0.05,0.0
1014,1029,24-09-2019 21:56:00,0,3215.0,3003.0,0.934,15.991,101,58,41,17,43,0,43,60,0.0,0.0
1014,1030,24-09-2019 21:58:00,0,3271.0,2926.0,0.894,16.127,34,18,12,6,16,0,16,43,0.0,0.0
1014,1031,24-09-2019 22:00:00,0,2927.0,2818.0,0.963,14.652,73,41,28,13,32,4,28,69,0.0,0.0
1014,1032,24-09-2019 22:02:00,0,3225.0,3037.0,0.942,16.068,144,85,58,27,59,0,59,89,0.0,0.0
1014,1033,24-09-2019 22:04:00,0,3378.5,3169.5,0.9385,16.8205,104,65,46,19,39,2,37,63,0.0,0.06
1014,1034,24-09-2019 22:06:00,0,3532.0,3302.0,0.935,17.573,123,57,44,13,66,26,40,78,0.05,0.02
1014,1035,24-09-2019 22:08:00,0,3220.0,2987.0,0.928,15.993,190,108,83,25,82,45,37,40,0.02,0.04
1014,1036,24-09-2019 22:10:00,0,3563.0,3180.0,0.893,17.557,187,107,74,33,80,22,58,81,0.0,0.05
1014,1037,24-09-2019 22:12:00,0,3135.0,2912.0,0.929,15.575,308,171,143,28,137,109,28,138,0.0,0.01
1014,1038,24-09-2019 22:14:00,0,3242.0,3000.0,0.925,16.096,445,222,184,38,223,181,42,187,0.09,0.0
1014,1039,24-09-2019 22:16:00,0,2864.0,2616.0,0.913,14.182,223,123,96,27,100,82,18,98,0.0,0.0
1014,1040,24-09-2019 22:18:00,0,2976.0,2708.0,0.91,14.724,168,83,50,33,85,39,46,82,0.01,0.01
1014,1041,24-09-2019 22:20:00,0,3716.0,3462.0,0.932,18.475,127,86,63,23,41,0,41,76,0.0,0.09
1014,1042,24-09-2019 22:22:00,0,3715.0,3430.0,0.923,18.433,106,62,46,16,44,10,34,41,0.06,0.05
1014,1043,24-09-2019 22:24:00,0,3237.0,2994.0,0.925,16.07,168,116,77,39,52,24,28,0,0.01,0.04
1014,1044,24-09-2019 22:26:00,0,2512.0,2218.0,0.883,12.352,79,67,28,39,12,2,10,0,0.0,0.0
1014,1045,24-09-2019 22:28:00,0,2948.0,2690.0,0.913,14.593,61,41,23,18,20,4,16,1,0.0,0.0
1014,1046,24-09-2019 22:30:00,0,2977.0,2678.0,0.9,14.694,30,11,2,9,19,1,18,0,0.0,0.0
1014,1047,24-09-2019 22:32:00,0,2973.0,2665.0,0.897,14.662,55,28,5,23,27,0,27,1,0.02,0.0
1014,1048,24-09-2019 22:34:00,0,2952.0,2759.0,0.935,14.683,57,43,21,22,14,5,9,0,0.03,0.0
1014,1049,24-09-2019 22:36:00,0,3275.0,2918.0,0.891,16.135,2,0,0,0,2,0,2,0,0.0,0.0
1014,1050,24-09-2019 22:38:00,0,2990.5,2623.5,0.876,14.6885,0,0,0,0,0,0,0,0,0.0,0.0
1014,1051,24-09-2019 22:40:00,0,2706.0,2329.0,0.861,13.242,6,5,3,2,1,0,1,0,0.0,0.0
1014,1052,24-09-2019 22:42:00,0,2705.0,2316.0,0.856,13.223,1,1,0,1,0,0,0,0,0.0,0.0
1014,1053,24-09-2019 22:44:00,0,2489.0,2306.0,0.926,12.362,5,1,1,0,4,1,3,0,0.0,0.0
1014,1054,24-09-2019 22:46:00,0,2476.0,2240.0,0.905,12.235,3,0,0,0,3,0,3,0,0.0,0.0
1014,1055,24-09-2019 22:48:00,0,2485.0,2296.0,0.924,12.335,8,3,2,1,5,0,5,0,0.0,0.0
1014,1056,24-09-2019 22:50:00,0,2769.0,2484.0,0.897,13.66,2,1,0,1,1,0,1,0,0.0,0.0
1014,1057,24-09-2019 22:52:00,0,2759.0,2605.0,0.944,13.756,81,62,44,18,19,8,11,0,0.0,0.0
1014,1058,24-09-2019 22:54:00,0,2941.0,2691.0,0.915,14.566,333,206,160,46,127,86,41,46,0.0,0.0
1014,1059,24-09-2019 22:56:00,0,2916.0,2904.0,0.996,14.702,235,123,106,17,112,80,32,124,0.0,0.0
1014,1060,24-09-2019 22:58:00,0,2921.0,2793.0,0.956,14.6,115,50,38,12,65,37,28,103,0.0,0.0
1014,1061,24-09-2019 23:00:00,0,2937.0,2872.0,0.978,14.751,181,101,75,26,80,45,35,78,0.0,0.0
1014,1062,24-09-2019 23:02:00,0,2910.0,2824.0,0.97,14.59,67,40,28,12,27,15,12,89,0.0,0.0
1014,1063,24-09-2019 23:04:00,0,2759.0,2605.0,0.944,13.755,140,77,56,21,63,25,38,60,0.0,0.26
1014,1064,24-09-2019 23:06:00,0,2755.0,2516.0,0.913,13.64,48,0,0,0,48,0,48,0,0.0,0.01
1014,1065,24-09-2019 23:08:00,0,2936.0,2822.0,0.961,14.693,162,73,64,9,89,57,32,95,0.02,0.0
1014,1066,24-09-2019 23:10:00,0,3076.0,2786.0,0.906,15.205,349,191,150,41,158,117,41,36,0.07,0.02
1014,1067,24-09-2019 23:12:00,0,3080.0,2946.0,0.9565,15.3975,825,497,399,98,328,242,86,11,0.0,0.0
1014,1068,24-09-2019 23:14:00,0,3084.0,3106.0,1.007,15.59,551,273,209,64,278,214,64,16,0.02,0.01
1014,1069,24-09-2019 23:16:00,0,3140.0,2984.0,0.95,15.674,446,235,181,54,211,156,55,106,0.0,0.02
1014,1070,24-09-2019 23:18:00,0,2810.0,2751.0,0.979,14.119,273,115,81,34,158,123,35,47,0.01,0.0
1014,1071,24-09-2019 23:20:00,0,2839.0,2747.0,0.968,14.225,235,129,92,37,106,83,23,50,0.0,0.0
1014,1072,24-09-2019 23:22:00,0,3330.0,3175.0,0.953,16.636,466,289,219,70,177,131,46,17,0.0,0.0
1014,1073,24-09-2019 23:24:00,0,2841.0,2752.0,0.969,14.242,6,3,1,2,3,0,3,1,0.02,0.0
1014,1074,24-09-2019 23:26:00,0,2925.0,2875.0,0.983,14.707,186,115,92,23,71,54,17,55,0.09,0.0
1014,1075,24-09-2019 23:28:00,0,2908.0,2925.0,1.006,14.695,149,103,73,30,46,27,19,42,0.01,0.0
1014,1076,24-09-2019 23:30:00,0,2816.0,2728.0,0.969,14.115,68,59,13,46,9,2,7,0,0.0,0.0
1014,1077,24-09-2019 23:32:00,0,2825.0,2812.0,0.995,14.243,102,84,36,48,18,5,13,1,0.0,0.0
1014,1078,24-09-2019 23:34:00,0,3138.0,2960.0,0.943,15.64,57,40,10,30,17,1,16,0,0.0,0.0
1014,1079,24-09-2019 23:36:00,0,3037.0,2914.0,0.96,15.192,53,47,26,21,6,0,6,0,0.0,0.0
1014,1080,24-09-2019 23:38:00,0,2905.0,2860.0,0.985,14.61,59,52,25,27,7,2,5,0,0.0,0.0
1014,1081,24-09-2019 23:40:00,0,3025.0,2910.0,0.962,15.138,6,6,0,6,0,0,0,0,0.0,0.0
1014,1082,24-09-2019 23:42:00,0,2818.0,2786.0,0.989,14.185,4,3,1,2,1,0,1,0,0.02,0.0
1014,1083,24-09-2019 23:44:00,0,2631.0,2556.0,0.972,13.195,0,0,0,0,0,0,0,0,0.0,0.0
1014,1084,24-09-2019 23:46:00,0,2552.0,2450.5,0.96,12.768,0,0,0,0,0,0,0,0,0.0,0.0
1014,1085,24-09-2019 23:48:00,0,2473.0,2345.0,0.948,12.341,32,16,6,10,16,2,14,0,0.0,0.0
1014,1086,24-09-2019 23:50:00,0,2454.0,2327.0,0.948,12.246,304,175,127,48,129,85,44,1,0.0,0.0
1014,1087,24-09-2019 23:52:00,0,2788.0,2478.0,0.889,13.728,171,133,98,35,38,22,16,38,0.0,0.0
1014,1088,24-09-2019 23:54:00,0,2751.0,2618.0,0.952,13.737,429,292,241,51,137,94,43,56,0.0,0.0
1014,1089,24-09-2019 23:56:00,0,2779.0,2466.0,0.887,13.677,386,250,192,58,136,91,45,15,0.0,0.0
1014,1090,24-09-2019 23:58:00,0,2785.0,2486.0,0.893,13.725,498,358,284,74,140,87,53,21,0.0,0.0
1014,1091,25-09-2019 00:00:00,0,2771.0,2542.0,0.917,13.732,208,112,81,31,96,66,30,11,0.0,0.03
1014,1092,25-09-2019 00:02:00,0,2771.0,2487.0,0.897,13.673,62,53,24,29,9,2,7,3,0.0,0.0
1014,1093,25-09-2019 00:04:00,0,2775.0,2545.0,0.917,13.753,62,33,12,21,29,1,28,1,0.0,0.0
1014,1094,25-09-2019 00:06:00,0,2761.0,2617.0,0.948,13.775,45,28,5,23,17,1,16,1,0.03,0.0
1014,1095,25-09-2019 00:08:00,0,2963.0,2738.0,0.924,14.706,17,9,1,8,8,2,6,0,0.0,0.0
1014,1096,25-09-2019 00:10:00,0,2761.0,2586.0,0.937,13.739,0,0,0,0,0,0,0,0,0.0,0.0
1014,1097,25-09-2019 00:12:00,0,2675.0,2428.0,0.908,13.227,2,0,0,0,2,0,2,0,0.0,0.0
1014,1098,25-09-2019 00:14:00,0,2479.0,2306.0,0.93,12.321,14,8,6,2,6,0,6,0,0.0,0.0
1014,1099,25-09-2019 00:16:00,0,2390.0,2161.0,0.904,11.807,2,2,1,1,0,0,0,0,0.0,0.0
1014,1100,25-09-2019 00:18:00,0,2284.0,2165.0,0.948,11.394,1,1,1,0,0,0,0,0,0.0,0.0
1014,1101,25-09-2019 00:20:00,0,2282.5,2160.0,0.9465,11.383,0,0,0,0,0,0,0,0,0.0,0.0
1014,1102,25-09-2019 00:22:00,0,2281.0,2155.0,0.945,11.372,29,16,9,7,13,4,9,0,0.0,0.0
1014,1103,25-09-2019 00:24:00,0,2385.0,2147.0,0.9,11.774,0,0,0,0,0,0,0,0,0.0,0.0
1014,1104,25-09-2019 00:26:00,0,2184.0,2117.0,0.969,10.949,0,0,0,0,0,0,0,0,0.0,0.0
1014,1105,25-09-2019 00:28:00,0,2154.0,2075.0,0.963,10.785,0,0,0,0,0,0,0,0,0.0,0.0
1014,1106,25-09-2019 00:30:00,0,2183.0,2078.0,0.952,10.903,0,0,0,0,0,0,0,0,0.0,0.0
1014,1107,25-09-2019 00:32:00,0,2189.0,2051.0,0.937,10.897,179,109,84,25,70,43,27,12,0.0,0.0
1014,1108,25-09-2019 00:34:00,0,2267.0,2201.0,0.971,11.37,44,25,15,10,19,11,8,49,0.0,0.0
1014,1109,25-09-2019 00:36:00,0,2173.0,2095.0,0.964,10.88,0,0,0,0,0,0,0,0,0.0,0.0
1014,1110,25-09-2019 00:38:00,0,2191.0,2063.0,0.942,10.915,5,3,2,1,2,1,1,0,0.0,0.0
1014,1111,25-09-2019 00:40:00,0,2179.0,2053.0,0.942,10.859,3,1,0,1,2,1,1,0,0.0,0.0
1014,1112,25-09-2019 00:42:00,0,2197.0,2032.0,0.925,10.904,3,2,2,0,1,0,1,0,0.0,0.0
1014,1113,25-09-2019 00:44:00,0,2197.0,2012.0,0.916,10.883,26,26,0,26,0,0,0,0,0.0,0.0
1014,1114,25-09-2019 00:46:00,0,2197.0,2014.0,0.916,10.886,26,25,0,25,1,0,1,0,0.0,0.0
1014,1115,25-09-2019 00:48:00,0,2188.0,2041.0,0.933,10.88,2,2,1,1,0,0,0,0,0.0,0.0
1014,1116,25-09-2019 00:50:00,0,2185.0,2059.0,0.942,10.89,0,0,0,0,0,0,0,0,0.0,0.0
1014,1117,25-09-2019 00:52:00,0,2181.0,2065.0,0.947,10.878,10,1,0,1,9,1,8,0,0.0,0.0
1014,1118,25-09-2019 00:54:00,0,2121.0,2086.5,0.985,10.6655,1,0,0,0,1,0,1,0,0.0,0.0
1014,1119,25-09-2019 00:56:00,0,2061.0,2108.0,1.023,10.453,0,0,0,0,0,0,0,0,0.0,0.0
1014,1120,25-09-2019 00:58:00,0,2056.0,2039.0,0.992,10.358,0,0,0,0,0,0,0,0,0.0,0.0
1014,1121,25-09-2019 01:00:00,0,2074.0,2005.0,0.967,10.39,0,0,0,0,0,0,0,0,0.0,0.0
1014,1122,25-09-2019 01:02:00,0,1969.0,1952.0,0.991,9.92,0,0,0,0,0,0,0,0,0.0,0.0
1014,1123,25-09-2019 01:04:00,0,1975.0,1962.0,0.994,9.954,8,0,0,0,8,0,8,0,0.0,0.0
1014,1124,25-09-2019 01:06:00,0,2050.0,2104.0,1.026,10.407,30,17,9,8,13,3,10,0,0.0,0.0
1014,1125,25-09-2019 01:08:00,0,2264.0,2250.0,0.994,11.411,113,79,45,34,34,19,15,59,0.0,0.0
1014,1126,25-09-2019 01:10:00,0,2330.0,2352.0,1.009,11.786,19,3,2,1,16,0,16,79,0.0,0.0
1014,1127,25-09-2019 01:12:00,0,2323.0,2420.0,1.042,11.831,148,69,51,18,79,52,27,86,0.0,0.0
1014,1128,25-09-2019 01:14:00,0,2352.0,2324.0,0.988,11.84,132,94,60,34,38,24,14,51,0.0,0.0
1014,1129,25-09-2019 01:16:00,0,2373.0,2284.0,0.962,11.878,142,76,48,28,66,37,29,59,0.0,0.0
1014,1130,25-09-2019 01:18:00,0,2615.0,2587.0,0.989,13.169,103,56,31,25,47,27,20,64,0.0,0.0
1014,1131,25-09-2019 01:20:00,0,2841.0,2792.0,0.983,14.282,188,121,82,39,67,47,20,42,0.0,0.0
1014,1132,25-09-2019 01:22:00,0,2834.0,2712.0,0.957,14.167,391,182,132,50,209,159,50,96,0.0,0.0
1014,1133,25-09-2019 01:24:00,0,3003.0,2986.0,0.994,15.139,371,188,137,51,183,137,46,47,0.0,0.0
1014,1134,25-09-2019 01:26:00,0,2753.0,2647.0,0.961,13.779,124,72,48,24,52,20,32,98,0.0,0.0
1014,1135,25-09-2019 01:28:00,0,2711.0,2541.0,0.9365,13.4945,86,30,24,6,56,18,38,52,0.03,0.0
1014,1136,25-09-2019 01:30:00,0,2669.0,2435.0,0.912,13.21,58,44,24,20,14,6,8,11,0.0,0.0
1014,1137,25-09-2019 01:32:00,0,2560.0,2419.0,0.945,12.766,97,70,38,32,27,8,19,10,0.0,0.0
1014,1138,25-09-2019 01:34:00,0,2647.0,2583.0,0.976,13.288,109,83,58,25,26,5,21,33,0.0,0.0
1014,1139,25-09-2019 01:36:00,0,2807.0,2824.0,1.006,14.186,135,92,65,27,43,0,43,67,0.0,0.0
1014,1140,25-09-2019 01:38:00,0,3672.0,3681.0,1.002,18.544,212,120,89,31,92,56,36,70,0.01,0.0
1014,1141,25-09-2019 01:40:00,0,2617.0,2556.0,0.977,13.14,296,131,100,31,165,114,51,89,0.02,0.0
1014,1142,25-09-2019 01:42:00,0,2669.0,2531.0,0.948,13.317,413,214,179,35,199,157,42,140,0.0,0.0
1014,1143,25-09-2019 01:44:00,0,2860.0,2647.0,0.926,14.197,339,225,173,52,114,83,31,61,0.0,0.0
1014,1144,25-09-2019 01:46:00,0,2871.0,2639.0,0.919,14.233,146,82,51,31,64,35,29,56,0.0,0.11
1014,1145,25-09-2019 01:48:00,0,2837.0,2671.0,0.941,14.135,243,142,108,34,101,70,31,93,0.0,0.0
1014,1146,25-09-2019 01:50:00,0,2839.0,2782.0,0.98,14.264,146,77,48,29,69,29,40,95,0.0,0.0
1014,1147,25-09-2019 01:52:00,0,3004.0,2884.0,0.96,15.028,81,36,18,18,45,4,41,50,0.0,0.0
1014,1148,25-09-2019 01:54:00,0,3133.0,2952.0,0.942,15.61,84,27,11,16,57,0,57,53,0.0,0.0
1014,1149,25-09-2019 01:56:00,0,3206.0,3110.0,0.97,16.073,129,78,45,33,51,2,49,55,0.0,0.0
1014,1150,25-09-2019 01:58:00,0,3108.0,3090.0,0.994,15.668,100,54,38,16,46,0,46,54,0.0,0.0
1014,1151,25-09-2019 02:00:00,0,2829.0,2708.0,0.957,14.145,71,24,14,10,47,0,47,51,0.0,0.0
1014,1152,25-09-2019 02:02:00,0,3120.0,2925.5,0.939,15.532,250,138,112,26,112,76,36,70,0.09,0.01
1014,1153,25-09-2019 02:04:00,0,3411.0,3143.0,0.921,16.919,120,45,21,24,75,35,40,34,0.03,0.09
1014,1154,25-09-2019 02:06:00,0,3346.0,3111.0,0.93,16.629,246,141,116,25,105,73,32,128,0.02,0.02
1014,1155,25-09-2019 02:08:00,0,3232.0,3066.0,0.949,16.13,175,91,54,37,84,35,49,98,0.07,0.0
1014,1156,25-09-2019 02:10:00,0,3023.0,2917.0,0.965,15.141,220,130,89,41,90,46,44,24,0.0,0.01
1014,1157,25-09-2019 02:12:00,0,2571.0,2340.0,0.91,12.723,204,128,98,30,76,52,24,100,0.05,0.01
1014,1158,25-09-2019 02:14:00,0,3217.0,3122.0,0.971,16.13,412,215,166,49,197,152,45,76,0.0,0.0
1014,1159,25-09-2019 02:16:00,0,2860.0,2666.0,0.932,14.221,115,50,35,15,65,14,51,66,0.03,0.0
1014,1160,25-09-2019 02:18:00,0,3027.0,2872.0,0.949,15.107,92,66,37,29,26,10,16,47,0.05,0.01
1014,1161,25-09-2019 02:20:00,0,2675.0,2461.0,0.92,13.263,58,50,22,28,8,2,6,0,0.0,0.0
1014,1162,25-09-2019 02:22:00,0,2676.0,2450.0,0.916,13.256,40,26,8,18,14,1,13,0,0.0,0.0
1014,1163,25-09-2019 02:24:00,0,2669.0,2482.0,0.93,13.263,33,26,11,15,7,2,5,0,0.0,0.0
1014,1164,25-09-2019 02:26:00,0,2682.0,2400.0,0.895,13.224,22,17,8,9,5,1,4,0,0.0,0.0
1014,1165,25-09-2019 02:28:00,0,2680.0,2437.0,0.909,13.258,5,2,0,2,3,1,2,0,0.0,0.0
1014,1166,25-09-2019 02:30:00,0,2592.0,2333.0,0.9,12.794,0,0,0,0,0,0,0,0,0.0,0.0
1014,1167,25-09-2019 02:32:00,0,2386.0,2242.0,0.939,11.884,7,0,0,0,7,0,7,0,0.0,0.0
1014,1168,25-09-2019 02:34:00,0,2390.0,2175.0,0.91,11.824,4,0,0,0,4,0,4,0,0.01,0.02
1014,1169,25-09-2019 02:36:00,0,2228.5,2100.0,0.945,11.106,6,1,1,0,5,0,5,0,0.0,0.0
1014,1170,25-09-2019 02:38:00,0,2067.0,2025.0,0.98,10.388,2,2,1,1,0,0,0,0,0.0,0.0
1014,1171,25-09-2019 02:40:00,0,2096.0,1979.0,0.944,10.448,3,3,0,3,0,0,0,0,0.0,0.0
1014,1172,25-09-2019 02:42:00,0,2072.0,2030.0,0.98,10.409,53,44,35,9,9,4,5,2,0.0,0.0
1014,1173,25-09-2019 02:44:00,0,2659.0,2551.0,0.959,13.301,278,210,163,47,68,29,39,30,0.0,0.0
1014,1174,25-09-2019 02:46:00,0,2804.0,2854.0,1.018,14.208,290,156,127,29,134,110,24,125,0.0,0.0
1014,1175,25-09-2019 02:48:00,0,2741.0,2648.0,0.966,13.733,216,95,67,28,121,83,38,71,0.0,0.0
1014,1176,25-09-2019 02:50:00,0,2859.0,2675.0,0.936,14.225,40,24,9,15,16,4,12,0,0.0,0.0
1014,1177,25-09-2019 02:52:00,0,2859.0,2670.0,0.934,14.22,57,20,2,18,37,0,37,6,0.03,0.0
1014,1178,25-09-2019 02:54:00,0,2838.0,2760.0,0.973,14.239,32,21,8,13,11,1,10,0,0.0,0.0
1014,1179,25-09-2019 02:56:00,0,2846.0,2718.0,0.955,14.22,62,39,16,23,23,8,15,0,0.0,0.0
1014,1180,25-09-2019 02:58:00,0,2845.0,2691.0,0.946,14.187,25,24,8,16,1,0,1,0,0.0,0.0
1014,1181,25-09-2019 03:00:00,0,2635.0,2539.0,0.963,13.194,0,0,0,0,0,0,0,0,0.0,0.0
1014,1182,25-09-2019 03:02:00,0,2683.0,2428.0,0.905,13.261,0,0,0,0,0,0,0,0,0.0,0.0
1014,1183,25-09-2019 03:04:00,0,2346.0,2310.0,0.984,11.801,0,0,0,0,0,0,0,0,0.0,0.0
1014,1184,25-09-2019 03:06:00,0,2388.0,2214.0,0.927,11.859,17,17,1,16,0,0,0,0,0.0,0.0
1014,1185,25-09-2019 03:08:00,0,2045.0,2093.0,1.024,10.374,3,3,1,2,0,0,0,0,0.0,0.0
1014,1186,25-09-2019 03:10:00,0,2124.5,2042.5,0.964,10.631,1,1,0,1,0,0,0,0,0.0,0.0
1014,1187,25-09-2019 03:12:00,0,2204.0,1992.0,0.904,10.888,1,1,0,1,0,0,0,0,0.0,0.0
1014,1188,25-09-2019 03:14:00,0,2212.0,1979.0,0.895,10.907,28,19,9,10,9,4,5,0,0.0,0.0
1014,1189,25-09-2019 03:16:00,0,2194.0,2002.0,0.912,10.862,16,16,0,16,0,0,0,0,0.0,0.0
1014,1190,25-09-2019 03:18:00,0,2190.0,2028.0,0.926,10.875,3,3,0,3,0,0,0,0,0.0,0.0
1014,1191,25-09-2019 03:20:00,0,2205.0,1981.0,0.899,10.88,0,0,0,0,0,0,0,0,0.0,0.0
1014,1192,25-09-2019 03:22:00,0,2224.0,1945.0,0.875,10.917,32,20,10,10,12,2,10,0,0.0,0.0
1014,1193,25-09-2019 03:24:00,0,2208.0,1967.0,0.891,10.877,15,11,4,7,4,1,3,0,0.0,0.0
1014,1194,25-09-2019 03:26:00,0,2190.0,2019.0,0.922,10.863,0,0,0,0,0,0,0,0,0.0,0.0
1014,1195,25-09-2019 03:28:00,0,2196.0,2015.0,0.918,10.881,1,1,0,1,0,0,0,0,0.0,0.0
1014,1196,25-09-2019 03:30:00,0,2208.0,1975.0,0.895,10.885,0,0,0,0,0,0,0,0,0.0,0.0
1014,1197,25-09-2019 03:32:00,0,2203.0,1992.0,0.904,10.884,15,10,5,5,5,3,2,0,0.0,0.0
1014,1198,25-09-2019 03:34:00,0,2103.0,1937.0,0.921,10.429,5,4,2,2,1,0,1,0,0.0,0.0
1014,1199,25-09-2019 03:36:00,0,1980.0,1873.0,0.946,9.874,0,0,0,0,0,0,0,0,0.0,0.0
1014,1200,25-09-2019 03:38:00,0,1987.0,1895.0,0.954,9.926,1,0,0,0,1,0,1,0,0.0,0.0
1014,1201,25-09-2019 03:40:00,0,2213.0,1960.0,0.886,10.887,7,5,2,3,2,0,2,0,0.0,0.0
1014,1202,25-09-2019 03:42:00,0,2212.0,1959.0,0.886,10.883,109,57,45,12,52,40,12,59,0.0,0.0
1014,1203,25-09-2019 03:44:00,0,2341.5,2167.5,0.924,11.624,58,9,7,2,49,0,49,72,0.0,0.0
1014,1204,25-09-2019 03:46:00,0,2471.0,2376.0,0.962,12.365,60,13,8,5,47,0,47,77,0.0,0.0
1014,1205,25-09-2019 03:48:00,0,2439.0,2347.0,0.962,12.208,103,55,40,15,48,0,48,87,0.0,0.0
1014,1206,25-09-2019 03:50:00,0,2803.0,2459.0,0.877,13.767,180,96,70,26,84,40,44,78,0.0,0.0
1014,1207,25-09-2019 03:52:00,0,2172.0,2066.0,0.951,10.846,190,95,64,31,95,66,29,80,0.0,0.0
1014,1208,25-09-2019 03:54:00,0,2878.0,2608.0,0.906,14.226,113,63,33,30,50,2,48,64,0.0,0.0
1014,1209,25-09-2019 03:56:00,0,2940.0,2740.0,0.932,14.618,111,57,36,21,54,0,54,72,0.0,0.0
1014,1210,25-09-2019 03:58:00,0,3156.0,2891.0,0.916,15.636,216,132,97,35,84,32,52,59,0.03,0.13
1014,1211,25-09-2019 04:00:00,0,2967.0,2737.0,0.922,14.719,219,123,98,25,96,63,33,79,0.08,0.0
1014,1212,25-09-2019 04:02:00,0,3243.0,2980.0,0.919,16.078,91,36,14,22,55,0,55,55,0.01,0.02
1014,1213,25-09-2019 04:04:00,0,3215.0,3040.0,0.945,16.032,87,50,29,21,37,0,37,50,0.0,0.05
1014,1214,25-09-2019 04:06:00,0,3239.0,3021.0,0.933,16.105,280,141,106,35,139,84,55,85,0.09,0.1
1014,1215,25-09-2019 04:08:00,0,2934.0,2848.0,0.971,14.714,351,210,161,49,141,98,43,22,0.03,0.0
1014,1216,25-09-2019 04:10:00,0,2578.0,2351.0,0.912,12.761,384,232,171,61,152,116,36,24,0.0,0.0
1014,1217,25-09-2019 04:12:00,0,2758.0,2583.0,0.937,13.727,275,144,115,29,131,99,32,158,0.08,0.0
1014,1218,25-09-2019 04:14:00,0,2778.0,2576.0,0.927,13.797,163,105,76,29,58,36,22,6,0.01,0.0
1014,1219,25-09-2019 04:16:00,0,2777.0,2502.0,0.901,13.713,68,68,38,30,0,0,0,1,0.0,0.0
1014,1220,25-09-2019 04:18:00,0,2718.0,2481.5,0.913,13.4565,57,57,31,26,0,0,0,0,0.0,0.0
1014,1221,25-09-2019 04:20:00,0,2659.0,2461.0,0.925,13.2,73,59,31,28,14,2,12,2,0.0,0.0
1014,1222,25-09-2019 04:22:00,0,2856.0,2646.0,0.926,14.183,38,10,2,8,28,2,26,0,0.0,0.0
1014,1223,25-09-2019 04:24:00,0,2845.0,2682.0,0.943,14.18,42,26,12,14,16,2,14,1,0.0,0.0
1014,1224,25-09-2019 04:26:00,0,3026.0,2922.0,0.966,15.156,69,56,38,18,13,6,7,6,0.0,0.0
1014,1225,25-09-2019 04:28:00,0,2855.0,2677.0,0.938,14.211,4,4,1,3,0,0,0,0,0.0,0.0
1014,1226,25-09-2019 04:30:00,0,2838.0,2696.0,0.95,14.165,0,0,0,0,0,0,0,0,0.0,0.0
1014,1227,25-09-2019 04:32:00,0,2762.0,2599.0,0.941,13.759,1,1,0,1,0,0,0,0,0.0,0.0
1014,1228,25-09-2019 04:34:00,0,2652.0,2468.0,0.931,13.183,3,3,1,2,0,0,0,0,0.0,0.0
1014,1229,25-09-2019 04:36:00,0,2686.0,2423.0,0.902,13.263,5,0,0,0,5,0,5,0,0.01,0.0
1014,1230,25-09-2019 04:38:00,0,2465.0,2333.0,0.946,12.296,2,0,0,0,2,0,2,0,0.03,0.0
1014,1231,25-09-2019 04:40:00,0,2380.0,2167.0,0.91,11.778,0,0,0,0,0,0,0,0,0.0,0.0
1014,1232,25-09-2019 04:42:00,0,2049.0,2097.0,1.024,10.393,18,11,7,4,7,3,4,0,0.0,0.0
1014,1233,25-09-2019 04:44:00,0,2075.0,2055.0,0.991,10.449,0,0,0,0,0,0,0,0,0.0,0.0
1014,1234,25-09-2019 04:46:00,0,2060.0,2027.0,0.984,10.361,14,10,4,6,4,0,4,0,0.0,0.0
1014,1235,25-09-2019 04:48:00,0,2079.0,2035.0,0.978,10.445,17,17,1,16,0,0,0,0,0.0,0.0
1014,1236,25-09-2019 04:50:00,0,2072.0,2045.0,0.987,10.429,12,11,2,9,1,1,0,0,0.0,0.0
1014,1237,25-09-2019 04:52:00,0,2071.0,2015.0,0.973,10.39,7,6,0,6,1,0,1,0,0.0,0.0
1014,1238,25-09-2019 04:54:00,0,2070.0,1985.0,0.959,10.351,21,13,6,7,8,2,6,0,0.0,0.0
1014,1239,25-09-2019 04:56:00,0,2085.0,2004.0,0.961,10.433,3,0,0,0,3,0,3,0,0.0,0.0
1014,1240,25-09-2019 04:58:00,0,2098.0,1962.0,0.935,10.439,8,6,3,3,2,0,2,0,0.0,0.0
1014,1241,25-09-2019 05:00:00,0,2093.0,1968.0,0.94,10.427,73,42,16,26,31,8,23,4,0.0,0.0
1014,1242,25-09-2019 05:02:00,0,2365.0,2227.0,0.941,11.782,86,37,21,16,49,8,41,69,0.0,0.0
1014,1243,25-09-2019 05:04:00,0,2362.0,2285.0,0.968,11.835,75,21,5,16,54,0,54,67,0.0,0.0
1014,1244,25-09-2019 05:06:00,0,2666.0,2484.0,0.932,13.256,83,36,17,19,47,0,47,68,0.0,0.0
1014,1245,25-09-2019 05:08:00,0,2855.0,2616.0,0.916,14.144,146,88,62,26,58,14,44,83,0.0,0.05
1014,1246,25-09-2019 05:10:00,0,2822.0,2761.0,0.978,14.176,123,68,43,25,55,0,55,71,0.0,0.07
1014,1247,25-09-2019 05:12:00,0,2811.0,2847.0,1.013,14.226,37,14,9,5,23,0,23,17,0.0,0.42
1014,1248,25-09-2019 05:14:00,0,2570.0,2324.0,0.904,12.699,0,0,0,0,0,0,0,0,0.0,0.0
1014,1249,25-09-2019 05:16:00,0,2667.0,2521.0,0.945,13.299,191,101,83,18,90,58,32,75,0.06,0.02
1014,1250,25-09-2019 05:18:00,0,2355.0,2270.0,0.964,11.79,217,106,80,26,111,75,36,97,0.01,0.0
1014,1251,25-09-2019 05:20:00,0,2855.0,2703.0,0.947,14.241,242,151,106,45,91,75,16,140,0.09,0.0
1014,1252,25-09-2019 05:22:00,0,2631.0,2599.0,0.988,13.242,61,32,26,6,29,23,6,20,0.0,0.0
1014,1253,25-09-2019 05:24:00,0,2764.0,2594.0,0.939,13.76,0,0,0,0,0,0,0,0,0.0,0.0
1014,1254,25-09-2019 05:26:00,0,2954.5,2763.5,0.936,14.699,302,145,106,39,157,107,50,23,0.11,0.0
1014,1255,25-09-2019 05:28:00,0,3145.0,2933.0,0.933,15.638,243,118,85,33,125,93,32,142,0.03,0.01
1014,1256,25-09-2019 05:30:00,0,2859.0,2655.0,0.929,14.204,116,63,47,16,53,41,12,94,0.0,0.0
1014,1257,25-09-2019 05:32:00,0,3421.0,3258.0,0.952,17.087,296,163,132,31,133,108,25,100,0.01,0.0
1014,1258,25-09-2019 05:34:00,0,3027.0,2894.0,0.956,15.13,299,159,129,30,140,114,26,228,0.0,0.0
1014,1259,25-09-2019 05:36:00,0,3503.0,3380.0,0.965,17.542,279,165,126,39,114,78,36,62,0.11,0.0
1014,1260,25-09-2019 05:38:00,0,3120.0,2956.0,0.947,15.567,111,59,41,18,52,42,10,77,0.0,0.0
1014,1261,25-09-2019 05:40:00,0,3429.0,3150.0,0.919,16.996,351,195,163,32,156,122,34,114,0.06,0.0
1014,1262,25-09-2019 05:42:00,0,3128.0,3036.0,0.971,15.687,333,148,116,32,185,142,43,126,0.0,0.0
1014,1263,25-09-2019 05:44:00,0,2825.0,2777.0,0.983,14.206,35,26,11,15,9,3,6,0,0.03,0.0
1014,1264,25-09-2019 05:46:00,0,3103.0,3066.0,0.988,15.618,104,69,34,35,35,13,22,1,0.0,0.0
1014,1265,25-09-2019 05:48:00,0,3111.0,3045.0,0.979,15.628,102,77,52,25,25,7,18,0,0.0,0.0
1014,1266,25-09-2019 05:50:00,0,3155.0,2924.0,0.927,15.67,55,32,11,21,23,4,19,0,0.0,0.0
1014,1267,25-09-2019 05:52:00,0,3141.0,2903.0,0.924,15.588,55,27,11,16,28,2,26,0,0.0,0.0
1014,1268,25-09-2019 05:54:00,0,3141.0,2918.0,0.929,15.604,22,19,4,15,3,2,1,0,0.0,0.0
1014,1269,25-09-2019 05:56:00,0,2840.0,2754.0,0.97,14.239,4,4,0,4,0,0,0,0,0.0,0.0
1014,1270,25-09-2019 05:58:00,0,2778.0,2567.0,0.924,13.787,1,1,0,1,0,0,0,0,0.0,0.0
1014,1271,25-09-2019 06:00:00,1,2724.5,2501.0,0.9175,13.504,10,9,4,5,1,0,1,0,0.0,0.0
1014,1272,25-09-2019 06:02:00,1,2671.0,2435.0,0.911,13.221,0,0,0,0,0,0,0,0,0.0,0.0
1014,1273,25-09-2019 06:04:00,1,2588.0,2361.0,0.912,12.811,53,34,16,18,19,5,14,4,0.0,0.0
1014,1274,25-09-2019 06:06:00,1,2591.0,2380.0,0.919,12.842,165,104,82,22,61,38,23,49,0.0,0.0
1014,1275,25-09-2019 06:08:00,1,2665.0,2459.0,0.923,13.221,87,32,25,7,55,44,11,129,0.0,0.0
1014,1276,25-09-2019 06:10:00,1,2645.0,2574.0,0.973,13.272,167,78,63,15,89,63,26,106,0.0,0.0
1014,1277,25-09-2019 06:12:00,1,2375.0,2279.0,0.96,11.881,201,89,74,15,112,87,25,53,0.01,0.0
1014,1278,25-09-2019 06:14:00,1,3108.0,2985.0,0.96,15.552,53,25,9,16,28,16,12,3,0.07,0.0
1014,1279,25-09-2019 06:16:00,1,2695.0,2370.0,0.879,13.241,158,54,26,28,104,70,34,8,0.0,0.35
1014,1280,25-09-2019 06:18:00,1,2658.0,2503.0,0.942,13.242,112,47,28,19,65,47,18,25,0.0,0.0
1014,1281,25-09-2019 06:20:00,1,2060.0,2105.0,1.022,10.446,382,184,142,42,198,154,44,1,0.0,0.0
1014,1282,25-09-2019 06:22:00,1,2572.0,2334.0,0.908,12.717,147,111,76,35,36,19,17,0,0.0,0.0
1014,1283,25-09-2019 06:24:00,1,2647.0,2537.0,0.958,13.238,334,182,135,47,152,104,48,0,0.0,0.0
1014,1284,25-09-2019 06:26:00,1,2663.0,2474.0,0.929,13.232,268,165,124,41,103,73,30,54,0.0,0.0
1014,1285,25-09-2019 06:28:00,1,2581.0,2363.0,0.915,12.786,36,25,10,15,11,2,9,0,0.0,0.0
1014,1286,25-09-2019 06:30:00,1,2688.0,2443.0,0.909,13.294,4,2,0,2,2,0,2,0,0.0,0.0
1014,1287,25-09-2019 06:32:00,1,2582.0,2319.0,0.898,12.74,6,0,0,0,6,0,6,0,0.0,0.0
1014,1288,25-09-2019 06:34:00,1,2489.0,2236.0,0.898,12.2815,1,1,1,0,0,0,0,0,0.0,0.0
1014,1289,25-09-2019 06:36:00,1,2396.0,2153.0,0.898,11.823,11,8,2,6,3,0,3,0,0.0,0.0
1014,1290,25-09-2019 06:38:00,1,2175.0,2068.0,0.951,10.858,2,2,1,1,0,0,0,0,0.0,0.0
1014,1291,25-09-2019 06:40:00,1,2073.0,2024.0,0.977,10.408,6,6,2,4,0,0,0,0,0.0,0.0
1014,1292,25-09-2019 06:42:00,1,2093.0,1979.0,0.946,10.437,4,4,2,2,0,0,0,0,0.0,0.0
1014,1293,25-09-2019 06:44:00,1,2093.0,1978.0,0.945,10.437,0,0,0,0,0,0,0,0,0.0,0.0
1014,1294,25-09-2019 06:46:00,1,2068.0,2008.0,0.971,10.369,0,0,0,0,0,0,0,0,0.0,0.0
1014,1295,25-09-2019 06:48:00,1,2074.0,2053.0,0.99,10.445,0,0,0,0,0,0,0,0,0.0,0.0
1014,1296,25-09-2019 06:50:00,1,2065.0,2074.0,1.004,10.43,0,0,0,0,0,0,0,0,0.0,0.0
1014,1297,25-09-2019 06:52:00,1,2077.0,2056.0,0.99,10.461,0,0,0,0,0,0,0,0,0.0,0.0
1014,1298,25-09-2019 06:54:00,1,2068.0,2022.0,0.978,10.387,17,6,5,1,11,0,11,0,0.0,0.0
1014,1299,25-09-2019 06:56:00,1,2090.0,2000.0,0.957,10.448,6,5,3,2,1,0,1,0,0.0,0.0
1014,1300,25-09-2019 06:58:00,1,2080.0,1990.0,0.957,10.4,4,3,1,2,1,1,0,0,0.0,0.0
1014,1301,25-09-2019 07:00:00,1,2082.0,2013.0,0.967,10.433,18,7,4,3,11,2,9,0,0.0,0.0
1014,1302,25-09-2019 07:02:00,1,2068.0,2007.0,0.971,10.368,8,3,0,3,5,0,5,0,0.0,0.0
1014,1303,25-09-2019 07:04:00,1,2089.0,2018.0,0.966,10.465,11,1,1,0,10,0,10,0,0.0,0.0
1014,1304,25-09-2019 07:06:00,1,2079.0,1999.0,0.961,10.406,3,1,1,0,2,0,2,0,0.0,0.0
1014,1305,25-09-2019 07:08:00,1,2177.5,2065.0,0.9485,10.865,92,48,33,15,44,32,12,2,0.0,0.0
1014,1306,25-09-2019 07:10:00,1,2276.0,2131.0,0.936,11.324,69,49,23,26,20,4,16,0,0.0,0.0
1014,1307,25-09-2019 07:12:00,1,2372.0,2253.0,0.949,11.841,71,64,32,32,7,1,6,1,0.0,0.0
1014,1308,25-09-2019 07:14:00,1,2360.0,2278.0,0.965,11.821,68,60,25,35,8,1,7,1,0.0,0.0
1014,1309,25-09-2019 07:16:00,1,2368.0,2305.0,0.974,11.882,3,0,0,0,3,0,3,0,0.0,0.0
1014,1310,25-09-2019 07:18:00,1,2166.0,2123.0,0.98,10.885,3,2,1,1,1,0,1,0,0.0,0.0
1014,1311,25-09-2019 07:20:00,1,2076.0,2036.0,0.981,10.433,1,0,0,0,1,0,1,0,0.0,0.0
1014,1312,25-09-2019 07:22:00,1,2079.0,1963.0,0.944,10.364,0,0,0,0,0,0,0,0,0.0,0.0
1014,1313,25-09-2019 07:24:00,1,2106.0,1926.0,0.914,10.428,0,0,0,0,0,0,0,0,0.0,0.0
1014,1314,25-09-2019 07:26:00,1,1994.0,1900.0,0.953,9.959,18,12,4,8,6,1,5,0,0.0,0.0
1014,1315,25-09-2019 07:28:00,1,2097.0,1930.0,0.92,10.4,0,0,0,0,0,0,0,0,0.0,0.0
1014,1316,25-09-2019 07:30:00,1,2098.0,1933.0,0.921,10.408,1,0,0,0,1,1,0,0,0.0,0.0
1014,1317,25-09-2019 07:32:00,1,2107.0,1923.0,0.913,10.43,10,6,2,4,4,0,4,0,0.0,0.0
1014,1318,25-09-2019 07:34:00,1,2104.0,1949.0,0.926,10.446,1,1,0,1,0,0,0,0,0.0,0.0
1014,1319,25-09-2019 07:36:00,1,2106.0,1921.0,0.912,10.422,24,20,9,11,4,3,1,0,0.0,0.0
1014,1320,25-09-2019 07:38:00,1,2092.0,1886.0,0.901,10.329,4,0,0,0,4,0,4,0,0.0,0.0
1014,1321,25-09-2019 07:40:00,1,2101.0,1903.0,0.906,10.384,3,1,0,1,2,0,2,0,0.0,0.0
1014,1322,25-09-2019 07:42:00,1,2093.0,1933.5,0.924,10.3855,4,3,0,3,1,0,1,0,0.0,0.0
1014,1323,25-09-2019 07:44:00,1,2085.0,1964.0,0.942,10.387,0,0,0,0,0,0,0,0,0.0,0.0
1014,1324,25-09-2019 07:46:00,1,2108.0,1898.0,0.9,10.407,39,32,16,16,7,0,7,0,0.0,0.0
1014,1325,25-09-2019 07:48:00,1,2091.0,1928.0,0.922,10.374,71,57,32,25,14,7,7,25,0.0,0.0
1014,1326,25-09-2019 07:50:00,1,2377.0,2218.0,0.933,11.821,9,2,1,1,7,0,7,60,0.0,0.0
1014,1327,25-09-2019 07:52:00,1,2377.0,2233.0,0.939,11.839,11,3,1,2,8,1,7,69,0.0,0.0
1014,1328,25-09-2019 07:54:00,1,2297.0,2134.0,0.929,11.411,293,168,133,35,125,90,35,74,0.0,0.0
1014,1329,25-09-2019 07:56:00,1,2718.0,2328.0,0.856,13.285,45,15,9,6,30,1,29,82,0.0,0.0
1014,1330,25-09-2019 07:58:00,1,2688.0,2390.0,0.889,13.238,177,109,79,30,68,34,34,84,0.0,0.0
1014,1331,25-09-2019 08:00:00,1,2691.0,2332.0,0.867,13.186,159,92,71,21,67,23,44,62,0.0,0.0
1014,1332,25-09-2019 08:02:00,1,2399.0,2167.0,0.903,11.851,212,155,109,46,57,33,24,49,0.0,0.0
1014,1333,25-09-2019 08:04:00,1,2682.0,2439.0,0.91,13.268,80,60,40,20,20,6,14,55,0.0,0.0
1014,1334,25-09-2019 08:06:00,1,2106.0,1872.0,0.889,10.368,95,81,39,42,14,4,10,2,0.0,0.0
1014,1335,25-09-2019 08:08:00,1,2018.0,1827.0,0.906,9.972,56,35,16,19,21,3,18,0,0.0,0.0
1014,1336,25-09-2019 08:10:00,1,2191.0,2023.0,0.923,10.873,25,7,4,3,18,3,15,0,0.0,0.0
1014,1337,25-09-2019 08:12:00,1,2102.0,1947.0,0.926,10.437,6,0,0,0,6,0,6,0,0.0,0.0
1014,1338,25-09-2019 08:14:00,1,2407.0,2060.0,0.856,11.763,29,0,0,0,29,0,29,0,0.0,0.0
1014,1339,25-09-2019 08:16:00,1,2507.5,2154.0,0.859,12.264,24,21,5,16,3,0,3,0,0.0,0.0
1014,1340,25-09-2019 08:18:00,1,2608.0,2248.0,0.862,12.765,0,0,0,0,0,0,0,0,0.0,0.0
1014,1341,25-09-2019 08:20:00,1,2497.0,2225.0,0.891,12.302,8,7,1,6,1,1,0,0,0.0,0.0
1014,1342,25-09-2019 08:22:00,1,2382.0,2214.0,0.929,11.835,11,9,2,7,2,0,2,0,0.0,0.0
1014,1343,25-09-2019 08:24:00,1,2397.0,2119.0,0.884,11.79,1,1,0,1,0,0,0,0,0.0,0.0
1014,1344,25-09-2019 08:26:00,1,2175.0,2051.0,0.943,10.839,5,5,2,3,0,0,0,0,0.0,0.0
1014,1345,25-09-2019 08:28:00,1,2075.0,1995.0,0.961,10.382,4,2,1,1,2,1,1,0,0.0,0.0
1014,1346,25-09-2019 08:30:00,1,2088.0,1940.0,0.929,10.375,2,0,0,0,2,0,2,0,0.0,0.0
1014,1347,25-09-2019 08:32:00,1,2086.0,1960.0,0.94,10.387,4,1,0,1,3,0,3,0,0.0,0.0
1014,1348,25-09-2019 08:34:00,1,2096.0,1952.0,0.931,10.42,0,0,0,0,0,0,0,0,0.0,0.0
1014,1349,25-09-2019 08:36:00,1,2096.0,1926.0,0.919,10.391,8,2,1,1,6,0,6,0,0.0,0.0
1014,1350,25-09-2019 08:38:00,1,2106.0,1922.0,0.913,10.426,0,0,0,0,0,0,0,0,0.0,0.0
1014,1351,25-09-2019 08:40:00,1,2100.0,1869.0,0.89,10.344,2,0,0,0,2,0,2,0,0.0,0.0
1014,1352,25-09-2019 08:42:00,1,2111.0,1867.0,0.884,10.383,3,0,0,0,3,0,3,0,0.0,0.0
1014,1353,25-09-2019 08:44:00,1,2119.0,1842.0,0.869,10.389,3,0,0,0,3,0,3,0,0.0,0.0
1014,1354,25-09-2019 08:46:00,1,2127.0,1861.0,0.875,10.443,8,6,5,1,2,0,2,0,0.0,0.0
1014,1355,25-09-2019 08:48:00,1,2128.0,1850.0,0.869,10.433,5,3,0,3,2,0,2,0,0.0,0.0
1014,1356,25-09-2019 08:50:00,1,2114.0,1873.0,0.886,10.4035,11,9,7,2,2,0,2,0,0.0,0.0
1014,1357,25-09-2019 08:52:00,1,2100.0,1896.0,0.903,10.374,2,1,1,0,1,1,0,0,0.0,0.0
1014,1358,25-09-2019 08:54:00,1,2113.0,1892.0,0.896,10.421,3,3,1,2,0,0,0,0,0.0,0.0
1014,1359,25-09-2019 08:56:00,1,2092.0,1885.0,0.901,10.33,14,12,6,6,2,1,1,0,0.0,0.0
1014,1360,25-09-2019 08:58:00,1,2133.0,1818.0,0.852,10.415,4,3,2,1,1,0,1,0,0.0,0.0
1014,1361,25-09-2019 09:00:00,1,2148.0,1767.0,0.823,10.418,0,0,0,0,0,0,0,0,0.0,0.0
1014,1362,25-09-2019 09:02:00,1,2148.0,1733.0,0.807,10.382,50,44,31,13,6,2,4,2,0.0,0.0
1014,1363,25-09-2019 09:04:00,1,2122.0,1827.0,0.861,10.385,85,56,30,26,29,6,23,10,0.0,0.0
1014,1364,25-09-2019 09:06:00,1,2210.0,1954.0,0.884,10.873,112,50,28,22,62,25,37,47,0.0,0.0
1014,1365,25-09-2019 09:08:00,1,2319.0,2014.0,0.868,11.367,167,76,62,14,91,51,40,80,0.0,0.0
1014,1366,25-09-2019 09:10:00,1,2427.0,1997.0,0.823,11.774,53,21,13,8,32,6,26,61,0.0,0.0
1014,1367,25-09-2019 09:12:00,1,2423.0,2028.0,0.837,11.794,72,29,13,16,43,1,42,45,0.0,0.0
1014,1368,25-09-2019 09:14:00,1,2633.0,2160.0,0.82,12.764,132,77,51,26,55,5,50,60,0.0,0.0
1014,1369,25-09-2019 09:16:00,1,2725.0,2248.0,0.825,13.225,193,99,67,32,94,44,50,73,0.0,0.0
1014,1370,25-09-2019 09:18:00,1,2720.0,2229.0,0.819,13.186,174,94,75,19,80,62,18,59,0.0,0.0
1014,1371,25-09-2019 09:20:00,1,2613.0,2248.0,0.86,12.784,258,138,99,39,120,82,38,35,0.0,0.0
1014,1372,25-09-2019 09:22:00,1,2098.0,1909.0,0.91,10.379,110,47,22,25,63,33,30,46,0.0,0.0
1014,1373,25-09-2019 09:24:00,1,2310.5,1991.0,0.8655,11.3075,163,75,41,34,88,62,26,0,0.0,0.0
1014,1374,25-09-2019 09:26:00,1,2523.0,2073.0,0.821,12.236,525,280,213,67,245,176,69,14,0.0,0.0
1014,1375,25-09-2019 09:28:00,1,2530.0,2130.0,0.842,12.326,300,159,119,40,141,101,40,68,0.0,0.0
1014,1376,25-09-2019 09:30:00,1,2535.0,2080.0,0.82,12.29,308,227,165,62,81,36,45,1,0.0,0.0
1014,1377,25-09-2019 09:32:00,1,2736.0,2208.0,0.807,13.223,451,279,216,63,172,122,50,12,0.0,0.0
1014,1378,25-09-2019 09:34:00,1,2753.0,2194.0,0.797,13.274,175,85,69,16,90,54,36,63,0.0,0.0
1014,1379,25-09-2019 09:36:00,1,2620.0,2165.0,0.826,12.72,210,154,105,49,56,25,31,4,0.0,0.0
1014,1380,25-09-2019 09:38:00,1,2548.0,2042.0,0.802,12.298,36,17,8,9,19,5,14,0,0.0,0.0
1014,1381,25-09-2019 09:40:00,1,2417.0,1988.0,0.823,11.723,125,84,59,25,41,19,22,18,0.0,0.0
1014,1382,25-09-2019 09:42:00,1,2507.0,2151.0,0.858,12.257,204,99,65,34,105,59,46,9,0.0,0.0
1014,1383,25-09-2019 09:44:00,1,2319.0,1969.0,0.849,11.315,278,152,115,37,126,82,44,12,0.0,0.0
1014,1384,25-09-2019 09:46:00,1,2541.0,2066.0,0.813,12.297,91,71,43,28,20,8,12,0,0.0,0.0
1014,1385,25-09-2019 09:48:00,1,2538.0,2014.0,0.793,12.229,30,8,5,3,22,0,22,0,0.0,0.0
1014,1386,25-09-2019 09:50:00,1,2423.0,2008.0,0.829,11.769,29,29,8,21,0,0,0,0,0.0,0.0
1014,1387,25-09-2019 09:52:00,1,2217.0,1970.0,0.889,10.914,3,3,0,3,0,0,0,0,0.0,0.0
1014,1388,25-09-2019 09:54:00,1,2248.0,1809.0,0.805,10.86,0,0,0,0,0,0,0,0,0.0,0.0
1014,1389,25-09-2019 09:56:00,1,2041.0,1719.0,0.842,9.945,0,0,0,0,0,0,0,0,0.0,0.0
1014,1390,25-09-2019 09:58:00,1,2146.0,1756.0,0.819,10.4005,0,0,0,0,0,0,0,0,0.0,0.0
1014,1391,25-09-2019 10:00:00,1,2251.0,1793.0,0.796,10.856,0,0,0,0,0,0,0,0,0.0,0.0
1014,1392,25-09-2019 10:02:00,1,2241.0,1798.0,0.802,10.82,0,0,0,0,0,0,0,0,0.0,0.0
1014,1393,25-09-2019 10:04:00,1,2271.0,1770.0,0.78,10.907,0,0,0,0,0,0,0,0,0.0,0.0
1014,1394,25-09-2019 10:06:00,1,2156.0,1704.0,0.79,10.381,0,0,0,0,0,0,0,0,0.0,0.0
1014,1395,25-09-2019 10:08:00,1,2171.0,1689.0,0.778,10.422,2,2,0,2,0,0,0,0,0.0,0.0
1014,1396,25-09-2019 10:10:00,1,2050.0,1633.0,0.797,9.884,0,0,0,0,0,0,0,0,0.0,0.0
1014,1397,25-09-2019 10:12:00,1,2070.0,1603.0,0.774,9.931,0,0,0,0,0,0,0,0,0.0,0.0
1014,1398,25-09-2019 10:14:00,1,2071.0,1615.0,0.78,9.948,2,2,1,1,0,0,0,0,0.0,0.0
1014,1399,25-09-2019 10:16:00,1,2167.0,1654.0,0.763,10.369,2,2,0,2,0,0,0,0,0.0,0.0
1014,1400,25-09-2019 10:18:00,1,2075.0,1600.0,0.771,9.949,1,1,0,1,0,0,0,0,0.0,0.0
1014,1401,25-09-2019 10:20:00,1,2063.0,1599.0,0.775,9.901,0,0,0,0,0,0,0,0,0.0,0.0
1014,1402,25-09-2019 10:22:00,1,2073.0,1598.0,0.771,9.937,10,7,0,7,3,0,3,0,0.0,0.0
1014,1403,25-09-2019 10:24:00,1,2057.0,1616.0,0.786,9.896,0,0,0,0,0,0,0,0,0.0,0.0
1014,1404,25-09-2019 10:26:00,1,2073.0,1600.0,0.772,9.938,6,6,0,6,0,0,0,0,0.0,0.0
1014,1405,25-09-2019 10:28:00,1,2087.0,1527.0,0.732,9.915,21,19,5,14,2,0,2,0,0.0,0.0
1014,1406,25-09-2019 10:30:00,1,2089.0,1519.0,0.727,9.913,9,7,4,3,2,0,2,0,0.0,0.0
1014,1407,25-09-2019 10:32:00,1,2081.5,1539.5,0.7395,9.907,19,16,4,12,3,2,1,0,0.0,0.0
1014,1408,25-09-2019 10:34:00,1,2074.0,1560.0,0.752,9.901,25,18,6,12,7,0,7,0,0.0,0.0
1014,1409,25-09-2019 10:36:00,1,2267.0,1751.0,0.772,10.871,126,97,63,34,29,11,18,21,0.0,0.0
1014,1410,25-09-2019 10:38:00,1,2240.0,1810.0,0.808,10.831,280,149,116,33,131,90,41,91,0.0,0.0
1014,1411,25-09-2019 10:40:00,1,2259.0,1810.0,0.801,10.906,36,15,8,7,21,2,19,1,0.0,0.0
1014,1412,25-09-2019 10:42:00,1,2234.0,1811.0,0.811,10.807,65,30,1,29,35,0,35,0,0.0,0.0
1014,1413,25-09-2019 10:44:00,1,2243.0,1829.0,0.815,10.864,37,24,4,20,13,0,13,4,0.0,0.0
1014,1414,25-09-2019 10:46:00,1,2239.0,1810.0,0.808,10.824,1,0,0,0,1,0,1,0,0.0,0.0
1014,1415,25-09-2019 10:48:00,1,2277.0,1712.0,0.752,10.866,1,0,0,0,1,0,1,0,0.0,0.0
1014,1416,25-09-2019 10:50:00,1,2062.0,1576.0,0.764,9.871,0,0,0,0,0,0,0,0,0.0,0.0
1014,1417,25-09-2019 10:52:00,1,1985.0,1490.0,0.751,9.472,6,0,0,0,6,0,6,0,0.0,0.0
1014,1418,25-09-2019 10:54:00,1,1759.0,1432.0,0.814,8.516,2,0,0,0,2,0,2,0,0.0,0.0
1014,1419,25-09-2019 10:56:00,1,1982.0,1442.0,0.728,9.406,7,7,1,6,0,0,0,0,0.0,0.0
1014,1420,25-09-2019 10:58:00,1,1773.0,1389.0,0.783,8.524,1,0,0,0,1,0,1,0,0.0,0.0
1014,1421,25-09-2019 11:00:00,1,1760.0,1368.0,0.777,8.449,21,21,1,20,0,0,0,0,0.0,0.0
1014,1422,25-09-2019 11:02:00,1,1773.0,1397.0,0.788,8.533,5,5,0,5,0,0,0,0,0.0,0.0
1014,1423,25-09-2019 11:04:00,1,1863.0,1420.0,0.762,8.915,17,13,2,11,4,1,3,0,0.0,0.0
1014,1424,25-09-2019 11:06:00,1,2036.5,1462.5,0.7215,9.644,2,1,0,1,1,1,0,0,0.0,0.0
1014,1425,25-09-2019 11:08:00,1,2210.0,1505.0,0.681,10.373,0,0,0,0,0,0,0,0,0.0,0.0
1014,1426,25-09-2019 11:10:00,1,2104.0,1471.0,0.699,9.919,0,0,0,0,0,0,0,0,0.0,0.0
1014,1427,25-09-2019 11:12:00,1,2105.0,1473.0,0.7,9.926,0,0,0,0,0,0,0,0,0.0,0.0
1014,1428,25-09-2019 11:14:00,1,2111.0,1479.0,0.7,9.955,2,0,0,0,2,0,2,0,0.0,0.0
1014,1429,25-09-2019 11:16:00,1,2097.0,1438.0,0.686,9.856,26,12,5,7,14,0,14,0,0.0,0.0
1014,1430,25-09-2019 11:18:00,1,2204.0,1499.0,0.68,10.344,7,5,1,4,2,0,2,0,0.0,0.0
1014,1431,25-09-2019 11:20:00,1,2204.0,1512.0,0.686,10.358,0,0,0,0,0,0,0,0,0.0,0.0
1014,1432,25-09-2019 11:22:00,1,2199.0,1542.0,0.701,10.371,1,1,0,1,0,0,0,0,0.0,0.0
1014,1433,25-09-2019 11:24:00,1,2214.0,1496.0,0.676,10.378,1,0,0,0,1,0,1,0,0.0,0.0
1014,1434,25-09-2019 11:26:00,1,2224.0,1473.0,0.662,10.393,1,0,0,0,1,0,1,0,0.0,0.0
1014,1435,25-09-2019 11:28:00,1,2113.0,1466.0,0.694,9.95,0,0,0,0,0,0,0,0,0.0,0.0
1014,1436,25-09-2019 11:30:00,1,2115.0,1422.0,0.672,9.908,12,9,4,5,3,0,3,0,0.0,0.0
1014,1437,25-09-2019 11:32:00,1,2109.0,1423.0,0.675,9.885,11,9,4,5,2,0,2,0,0.0,0.0
1014,1438,25-09-2019 11:34:00,1,1998.0,1435.0,0.718,9.461,0,0,0,0,0,0,0,0,0.0,0.0
1014,1439,25-09-2019 11:36:00,1,2112.0,1445.0,0.684,9.92,2,2,1,1,0,0,0,0,0.0,0.0
1014,1440,25-09-2019 11:38:00,1,2212.0,1474.0,0.666,10.348,2,2,0,2,0,0,0,0,0.0,0.0
1014,1441,25-09-2019 11:40:00,1,2160.5,1475.5,0.683,10.1465,4,4,1,3,0,0,0,0,0.0,0.0
1014,1442,25-09-2019 11:42:00,1,2109.0,1477.0,0.7,9.945,2,2,0,2,0,0,0,0,0.0,0.0
1014,1443,25-09-2019 11:44:00,1,1994.0,1422.0,0.713,9.431,1,1,0,1,0,0,0,0,0.0,0.0
1014,1444,25-09-2019 11:46:00,1,2006.0,1397.0,0.696,9.453,21,15,8,7,6,2,4,0,0.0,0.0
1014,1445,25-09-2019 11:48:00,1,2212.0,1491.0,0.674,10.365,23,13,5,8,10,2,8,0,0.0,0.0
1014,1446,25-09-2019 11:50:00,1,2186.0,1614.0,0.738,10.402,8,0,0,0,8,1,7,0,0.0,0.0
1014,1447,25-09-2019 11:52:00,1,2278.0,1665.0,0.731,10.818,38,32,8,24,6,3,3,3,0.0,0.0
1014,1448,25-09-2019 11:54:00,1,2384.0,1774.0,0.744,11.358,32,15,7,8,17,2,15,0,0.0,0.0
1014,1449,25-09-2019 11:56:00,1,2347.0,1803.0,0.768,11.243,35,11,1,10,24,0,24,0,0.0,0.0
1014,1450,25-09-2019 11:58:00,1,2378.0,1806.0,0.76,11.369,43,19,11,8,24,4,20,5,0.0,0.0
1014,1451,25-09-2019 12:00:00,1,2350.0,1819.0,0.774,11.271,292,183,129,54,109,72,37,53,0.0,0.0
1014,1452,25-09-2019 12:02:00,1,2348.0,1857.0,0.791,11.308,300,146,114,32,154,98,56,15,0.0,0.0
1014,1453,25-09-2019 12:04:00,1,2389.0,1732.0,0.725,11.33,154,77,52,25,77,48,29,68,0.0,0.0
1014,1454,25-09-2019 12:06:00,1,2163.0,1700.0,0.786,10.406,152,80,60,20,72,40,32,132,0.0,0.0
1014,1455,25-09-2019 12:08:00,1,2585.0,1898.0,0.734,12.286,125,74,42,32,51,2,49,84,0.0,0.0
1014,1456,25-09-2019 12:10:00,1,2673.0,2010.0,0.752,12.758,84,51,26,25,33,6,27,65,0.0,0.0
1014,1457,25-09-2019 12:12:00,1,2686.0,1982.0,0.738,12.777,112,67,38,29,45,2,43,55,0.0,0.0
1014,1458,25-09-2019 12:14:00,1,2930.0,2162.5,0.738,13.9385,133,84,50,34,49,2,47,64,0.0,0.0
1014,1459,25-09-2019 12:16:00,1,3174.0,2343.0,0.738,15.1,149,103,63,40,46,4,42,67,0.0,0.0
1014,1460,25-09-2019 12:18:00,1,3170.0,2378.0,0.75,15.123,108,70,50,20,38,6,32,25,0.0,0.0
1014,1461,25-09-2019 12:20:00,1,2676.0,1980.0,0.74,12.734,270,156,117,39,114,77,37,18,0.0,0.0
1014,1462,25-09-2019 12:22:00,1,2665.0,1988.0,0.746,12.701,531,307,235,72,224,169,55,95,0.0,0.0
1014,1463,25-09-2019 12:24:00,1,2667.0,2053.0,0.77,12.78,343,160,133,27,183,140,43,101,0.0,0.0
1014,1464,25-09-2019 12:26:00,1,2386.0,1757.0,0.736,11.345,223,136,96,40,87,50,37,0,0.0,0.0
1014,1465,25-09-2019 12:28:00,1,2436.0,1944.0,0.798,11.751,517,320,254,66,197,137,60,9,0.0,0.0
1014,1466,25-09-2019 12:30:00,1,2673.0,2034.0,0.761,12.782,239,139,103,36,100,65,35,17,0.0,0.0
1014,1467,25-09-2019 12:32:00,1,2754.0,2149.0,0.781,13.229,191,148,103,45,43,22,21,19,0.0,0.0
1014,1468,25-09-2019 12:34:00,1,2350.0,1858.0,0.791,11.315,111,39,24,15,72,52,20,8,0.0,0.0
1014,1469,25-09-2019 12:36:00,1,2373.0,1834.0,0.773,11.38,30,24,6,18,6,1,5,0,0.0,0.0
1014,1470,25-09-2019 12:38:00,1,2374.0,1794.0,0.756,11.341,41,15,5,10,26,0,26,0,0.0,0.0
1014,1471,25-09-2019 12:40:00,1,2621.0,2122.0,0.81,12.677,6,1,1,0,5,0,5,0,0.0,0.0
1014,1472,25-09-2019 12:42:00,1,2648.0,2104.0,0.794,12.763,4,1,1,0,3,0,3,0,0.0,0.0
1014,1473,25-09-2019 12:44:00,1,2550.0,1994.0,0.782,12.256,2,0,0,0,2,0,2,0,0.0,0.0
1014,1474,25-09-2019 12:46:00,1,2355.0,1897.0,0.806,11.378,7,0,0,0,7,0,7,0,0.0,0.0
1014,1475,25-09-2019 12:48:00,1,2249.0,1801.5,0.801,10.856,7,3,1,2,4,0,4,0,0.0,0.0
1014,1476,25-09-2019 12:50:00,1,2143.0,1706.0,0.796,10.334,1,1,1,0,0,0,0,0,0.0,0.0
1014,1477,25-09-2019 12:52:00,1,2164.0,1695.0,0.784,10.402,2,2,1,1,0,0,0,0,0.0,0.0
1014,1478,25-09-2019 12:54:00,1,2170.0,1681.0,0.775,10.412,0,0,0,0,0,0,0,0,0.0,0.0
1014,1479,25-09-2019 12:56:00,1,2164.0,1639.0,0.757,10.342,0,0,0,0,0,0,0,0,0.0,0.0
1014,1480,25-09-2019 12:58:00,1,2199.0,1565.0,0.712,10.396,4,4,2,2,0,0,0,0,0.0,0.0
1014,1481,25-09-2019 13:00:00,1,2193.0,1589.0,0.725,10.401,1,1,0,1,0,0,0,0,0.0,0.0
1014,1482,25-09-2019 13:02:00,1,2173.0,1624.0,0.747,10.36,5,4,1,3,1,1,0,0,0.0,0.0
1014,1483,25-09-2019 13:04:00,1,2171.0,1668.0,0.768,10.401,0,0,0,0,0,0,0,0,0.0,0.0
1014,1484,25-09-2019 13:06:00,1,2160.0,1642.0,0.76,10.33,0,0,0,0,0,0,0,0,0.0,0.0
1014,1485,25-09-2019 13:08:00,1,2178.0,1645.0,0.755,10.404,0,0,0,0,0,0,0,0,0.0,0.0
1014,1486,25-09-2019 13:10:00,1,2191.0,1602.0,0.731,10.405,16,15,9,6,1,1,0,0,0.0,0.0
1014,1487,25-09-2019 13:12:00,1,2187.0,1586.0,0.725,10.373,2,2,1,1,0,0,0,0,0.0,0.0
1014,1488,25-09-2019 13:14:00,1,2189.0,1568.0,0.716,10.362,2,2,0,2,0,0,0,0,0.0,0.0
1014,1489,25-09-2019 13:16:00,1,2208.0,1554.0,0.704,10.419,0,0,0,0,0,0,0,0,0.0,0.0
1014,1490,25-09-2019 13:18:00,1,2214.0,1526.0,0.689,10.414,3,3,0,3,0,0,0,0,0.0,0.0
1014,1491,25-09-2019 13:20:00,1,2090.0,1481.0,0.708,9.876,0,0,0,0,0,0,0,0,0.0,0.0
1014,1492,25-09-2019 13:22:00,1,1979.0,1465.0,0.742,9.4195,7,5,2,3,2,0,2,0,0.01,0.0
1014,1493,25-09-2019 13:24:00,1,1868.0,1449.0,0.776,8.963,3,3,0,3,0,0,0,0,0.0,0.0
1014,1494,25-09-2019 13:26:00,1,1759.0,1423.0,0.809,8.506,10,10,0,10,0,0,0,0,0.0,0.0
1014,1495,25-09-2019 13:28:00,1,1865.0,1417.0,0.76,8.916,5,5,0,5,0,0,0,0,0.0,0.0
1014,1496,25-09-2019 13:30:00,1,1997.0,1458.0,0.73,9.483,20,13,5,8,7,0,7,0,0.0,0.0
1014,1497,25-09-2019 13:32:00,1,2098.0,1512.0,0.721,9.94,0,0,0,0,0,0,0,0,0.0,0.0
1014,1498,25-09-2019 13:34:00,1,2090.0,1535.0,0.735,9.934,1,0,0,0,1,0,1,0,0.0,0.0
1014,1499,25-09-2019 13:36:00,1,2053.0,1640.0,0.799,9.903,27,19,10,9,8,1,7,0,0.0,0.0
1014,1500,25-09-2019 13:38:00,1,2154.0,1674.0,0.777,10.34,100,78,45,33,22,9,13,1,0.0,0.0
1014,1501,25-09-2019 13:40:00,1,2280.0,1699.0,0.745,10.865,30,19,8,11,11,0,11,1,0.0,0.0
1014,1502,25-09-2019 13:42:00,1,2266.0,1795.0,0.792,10.915,16,13,2,11,3,0,3,0,0.0,0.0
1014,1503,25-09-2019 13:44:00,1,2243.0,1817.0,0.81,10.848,28,22,6,16,6,1,5,2,0.0,0.0
1014,1504,25-09-2019 13:46:00,1,2244.0,1847.0,0.823,10.885,3,1,1,0,2,0,2,0,0.01,0.0
1014,1505,25-09-2019 13:48:00,1,2265.0,1755.0,0.775,10.869,0,0,0,0,0,0,0,0,0.0,0.0
1014,1506,25-09-2019 13:50:00,1,2065.0,1612.0,0.781,9.921,11,9,2,7,2,1,1,0,0.0,0.0
1014,1507,25-09-2019 13:52:00,1,1964.0,1518.0,0.773,9.42,0,0,0,0,0,0,0,0,0.0,0.0
1014,1508,25-09-2019 13:54:00,1,1979.0,1492.0,0.754,9.45,0,0,0,0,0,0,0,0,0.0,0.0
1014,1509,25-09-2019 13:56:00,1,1986.5,1480.0,0.745,9.4665,0,0,0,0,0,0,0,0,0.0,0.0
1014,1510,25-09-2019 13:58:00,1,1994.0,1468.0,0.736,9.483,0,0,0,0,0,0,0,0,0.0,0.0
1014,1511,25-09-2019 14:00:00,1,1979.0,1442.0,0.728,9.395,0,0,0,0,0,0,0,0,0.0,0.0
1014,1512,25-09-2019 14:02:00,1,2000.0,1442.0,0.721,9.476,0,0,0,0,0,0,0,0,0.0,0.0
1014,1513,25-09-2019 14:04:00,1,1984.0,1445.0,0.728,9.419,0,0,0,0,0,0,0,0,0.0,0.0
1014,1514,25-09-2019 14:06:00,1,1776.0,1381.0,0.778,8.527,1,1,1,0,0,0,0,0,0.0,0.0
1014,1515,25-09-2019 14:08:00,1,1772.0,1343.0,0.758,8.47,8,4,2,2,4,0,4,0,0.0,0.0
1014,1516,25-09-2019 14:10:00,1,1776.0,1359.0,0.765,8.504,1,0,0,0,1,0,1,0,0.0,0.0
1014,1517,25-09-2019 14:12:00,1,1768.0,1402.0,0.793,8.52,0,0,0,0,0,0,0,0,0.0,0.0
1014,1518,25-09-2019 14:14:00,1,1764.0,1409.0,0.799,8.51,1,1,0,1,0,0,0,0,0.0,0.0
1014,1519,25-09-2019 14:16:00,1,1757.0,1381.0,0.786,8.452,15,8,2,6,7,0,7,0,0.0,0.0
1014,1520,25-09-2019 14:18:00,1,1758.0,1379.0,0.784,8.455,2,1,0,1,1,0,1,0,0.0,0.0
1014,1521,25-09-2019 14:20:00,1,1766.0,1370.0,0.776,8.476,0,0,0,0,0,0,0,0,0.0,0.0
1014,1522,25-09-2019 14:22:00,1,1766.0,1405.0,0.796,8.515,10,10,0,10,0,0,0,0,0.0,0.0
1014,1523,25-09-2019 14:24:00,1,1776.0,1353.0,0.762,8.496,5,5,0,5,0,0,0,0,0.0,0.0
1014,1524,25-09-2019 14:26:00,1,1783.0,1362.0,0.764,8.532,34,15,8,7,19,2,17,0,0.0,0.0
1014,1525,25-09-2019 14:28:00,1,1759.0,1378.0,0.783,8.458,2,0,0,0,2,0,2,0,0.0,0.0
1014,1526,25-09-2019 14:30:00,1,1932.5,1410.0,0.734,9.1755,4,0,0,0,4,0,4,0,0.0,0.0
1014,1527,25-09-2019 14:32:00,1,2106.0,1442.0,0.685,9.893,5,0,0,0,5,0,5,0,0.0,0.0
1014,1528,25-09-2019 14:34:00,1,2002.0,1432.0,0.715,9.475,30,14,2,12,16,0,16,0,0.0,0.0
1014,1529,25-09-2019 14:36:00,1,2210.0,1490.0,0.674,10.357,61,58,16,42,3,0,3,0,0.0,0.0
1014,1530,25-09-2019 14:38:00,1,2187.0,1602.0,0.732,10.389,39,36,4,32,3,2,1,2,0.0,0.0
1014,1531,25-09-2019 14:40:00,1,2167.0,1650.0,0.762,10.364,32,28,2,26,4,0,4,0,0.0,0.0
1014,1532,25-09-2019 14:42:00,1,2398.0,1731.0,0.722,11.365,39,32,8,24,7,4,3,1,0.0,0.0
1014,1533,25-09-2019 14:44:00,1,2375.0,1727.0,0.727,11.27,36,23,3,20,13,3,10,2,0.0,0.0
1014,1534,25-09-2019 14:46:00,1,2385.0,1754.0,0.735,11.339,7,3,0,3,4,0,4,0,0.0,0.0
1014,1535,25-09-2019 14:48:00,1,2279.0,1694.0,0.743,10.857,7,2,0,2,5,0,5,0,0.0,0.0
1014,1536,25-09-2019 14:50:00,1,2203.0,1564.0,0.71,10.413,7,3,1,2,4,0,4,0,0.0,0.0
1014,1537,25-09-2019 14:52:00,1,2095.0,1514.0,0.723,9.933,0,0,0,0,0,0,0,0,0.01,0.0
1014,1538,25-09-2019 14:54:00,1,1994.0,1439.0,0.722,9.451,0,0,0,0,0,0,0,0,0.0,0.0
1014,1539,25-09-2019 14:56:00,1,1876.0,1379.0,0.735,8.921,0,0,0,0,0,0,0,0,0.0,0.0
1014,1540,25-09-2019 14:58:00,1,1898.0,1384.0,0.729,9.009,0,0,0,0,0,0,0,0,0.0,0.0
1014,1541,25-09-2019 15:00:00,1,1891.0,1357.0,0.718,8.952,0,0,0,0,0,0,0,0,0.0,0.0
1014,1542,25-09-2019 15:02:00,1,1898.0,1353.0,0.713,8.976,0,0,0,0,0,0,0,0,0.0,0.0
1014,1543,25-09-2019 15:04:00,1,1897.0,1371.5,0.723,8.992,0,0,0,0,0,0,0,0,0.0,0.0
1014,1544,25-09-2019 15:06:00,1,1896.0,1390.0,0.733,9.008,3,0,0,0,3,1,2,0,0.0,0.0
1014,1545,25-09-2019 15:08:00,1,2102.0,1425.0,0.678,9.859,14,0,0,0,14,0,14,0,0.0,0.0
1014,1546,25-09-2019 15:10:00,1,2104.0,1455.0,0.691,9.903,11,6,5,1,5,0,5,1,0.0,0.0
1014,1547,25-09-2019 15:12:00,1,2096.0,1433.0,0.684,9.844,5,0,0,0,5,0,5,0,0.0,0.0
1014,1548,25-09-2019 15:14:00,1,2013.0,1395.0,0.693,9.478,10,5,2,3,5,0,5,0,0.0,0.0
1014,1549,25-09-2019 15:16:00,1,1999.0,1400.0,0.701,9.426,7,7,0,7,0,0,0,0,0.0,0.0
1014,1550,25-09-2019 15:18:00,1,1897.0,1359.0,0.716,8.981,27,17,6,11,10,1,9,0,0.0,0.0
1014,1551,25-09-2019 15:20:00,1,2114.0,1429.0,0.676,9.911,174,103,66,37,71,46,25,27,0.0,0.0
1014,1552,25-09-2019 15:22:00,1,2178.0,1645.0,0.755,10.403,84,49,36,13,35,19,16,22,0.0,0.0
1014,1553,25-09-2019 15:24:00,1,2375.0,1722.0,0.725,11.266,353,210,167,43,143,109,34,154,0.0,0.0
1014,1554,25-09-2019 15:26:00,1,2367.0,1838.0,0.777,11.36,92,60,30,30,32,13,19,77,0.0,0.0
1014,1555,25-09-2019 15:28:00,1,2695.0,1946.0,0.722,12.775,110,58,25,33,52,4,48,56,0.0,0.0
1014,1556,25-09-2019 15:30:00,1,2668.0,2014.0,0.755,12.743,75,30,10,20,45,0,45,47,0.0,0.0
1014,1557,25-09-2019 15:32:00,1,2988.0,2138.0,0.715,14.141,75,27,11,16,48,0,48,54,0.0,0.0
1014,1558,25-09-2019 15:34:00,1,3176.0,2421.0,0.762,15.192,321,191,145,46,130,92,38,47,0.0,0.0
1014,1559,25-09-2019 15:36:00,1,2345.0,1888.0,0.805,11.331,169,86,62,24,83,61,22,46,0.0,0.0
1014,1560,25-09-2019 15:38:00,1,2355.0,1840.0,0.7815,11.317,68,50,21,29,18,1,17,0,0.0,0.0
1014,1561,25-09-2019 15:40:00,1,2365.0,1792.0,0.758,11.303,52,27,6,21,25,1,24,0,0.0,0.0
1014,1562,25-09-2019 15:42:00,1,2350.0,1911.0,0.813,11.374,53,51,19,32,2,0,2,0,0.0,0.0
1014,1563,25-09-2019 15:44:00,1,2346.0,1832.0,0.781,11.27,0,0,0,0,0,0,0,0,0.0,0.0
1014,1564,25-09-2019 15:46:00,1,2175.0,1686.0,0.775,10.436,0,0,0,0,0,0,0,0,0.0,0.0
1014,1565,25-09-2019 15:48:00,1,2257.0,1729.0,0.766,10.808,0,0,0,0,0,0,0,0,0.0,0.0
1014,1566,25-09-2019 15:50:00,1,2366.0,1834.0,0.775,11.354,0,0,0,0,0,0,0,0,0.0,0.0
1014,1567,25-09-2019 15:52:00,1,2361.0,1842.0,0.78,11.343,14,14,1,13,0,0,0,0,0.0,0.0
1014,1568,25-09-2019 15:54:00,1,2348.0,1865.0,0.795,11.315,4,4,2,2,0,0,0,0,0.0,0.0
1014,1569,25-09-2019 15:56:00,1,2357.0,1854.0,0.786,11.339,0,0,0,0,0,0,0,0,0.0,0.0
1014,1570,25-09-2019 15:58:00,1,2250.0,1834.0,0.815,10.896,3,2,0,2,1,1,0,0,0.0,0.0
1014,1571,25-09-2019 16:00:00,1,2234.0,1867.0,0.836,10.868,1,1,0,1,0,0,0,0,0.0,0.0
1014,1572,25-09-2019 16:02:00,1,2233.0,1880.0,0.842,10.879,0,0,0,0,0,0,0,0,0.0,0.0
1014,1573,25-09-2019 16:04:00,1,2349.0,1896.0,0.807,11.354,3,3,0,3,0,0,0,0,0.0,0.0
1014,1574,25-09-2019 16:06:00,1,2321.0,1971.0,0.849,11.328,18,15,2,13,3,2,1,0,0.0,0.0
1014,1575,25-09-2019 16:08:00,1,2229.0,1874.0,0.841,10.857,10,10,0,10,0,0,0,0,0.0,0.0
1014,1576,25-09-2019 16:10:00,1,2343.0,1883.0,0.803,11.317,1,1,0,1,0,0,0,0,0.0,0.0
1014,1577,25-09-2019 16:12:00,1,2341.0,1884.5,0.805,11.31,1,1,0,1,0,0,0,0,0.0,0.0
1014,1578,25-09-2019 16:14:00,1,2339.0,1886.0,0.807,11.303,0,0,0,0,0,0,0,0,0.0,0.0
1014,1579,25-09-2019 16:16:00,1,2129.0,1834.0,0.861,10.421,4,2,0,2,2,1,1,0,0.0,0.0
1014,1580,25-09-2019 16:18:00,1,2134.0,1776.0,0.832,10.375,0,0,0,0,0,0,0,0,0.0,0.0
1014,1581,25-09-2019 16:20:00,1,2143.0,1778.0,0.83,10.411,2,0,0,0,2,0,2,0,0.0,0.0
1014,1582,25-09-2019 16:22:00,1,2126.0,1837.0,0.864,10.412,0,0,0,0,0,0,0,0,0.0,0.0
1014,1583,25-09-2019 16:24:00,1,2134.0,1835.0,0.86,10.439,0,0,0,0,0,0,0,0,0.0,0.0
1014,1584,25-09-2019 16:26:00,1,2127.0,1806.0,0.849,10.38,23,14,8,6,9,3,6,0,0.0,0.0
1014,1585,25-09-2019 16:28:00,1,2136.0,1791.0,0.838,10.4,0,0,0,0,0,0,0,0,0.0,0.0
1014,1586,25-09-2019 16:30:00,1,2147.0,1752.0,0.816,10.4,9,3,1,2,6,1,5,0,0.0,0.0
1014,1587,25-09-2019 16:32:00,1,2149.0,1754.0,0.816,10.409,0,0,0,0,0,0,0,0,0.0,0.0
1014,1588,25-09-2019 16:34:00,1,2171.0,1668.0,0.768,10.399,0,0,0,0,0,0,0,0,0.0,0.0
1014,1589,25-09-2019 16:36:00,1,2158.0,1696.0,0.786,10.382,5,4,1,3,1,0,1,0,0.0,0.0
1014,1590,25-09-2019 16:38:00,1,2160.0,1664.0,0.77,10.354,5,4,1,3,1,0,1,0,0.0,0.0
1014,1591,25-09-2019 16:40:00,1,2177.0,1640.0,0.753,10.394,3,1,0,1,2,0,2,0,0.0,0.0
1014,1592,25-09-2019 16:42:00,1,2180.0,1612.0,0.74,10.374,39,23,7,16,16,1,15,0,0.0,0.0
1014,1593,25-09-2019 16:44:00,1,2163.0,1673.0,0.773,10.377,50,24,6,18,26,1,25,0,0.0,0.0
1014,1594,25-09-2019 16:46:00,1,2245.5,1794.5,0.798,10.8355,53,31,11,20,22,3,19,2,0.0,0.0
1014,1595,25-09-2019 16:48:00,1,2328.0,1916.0,0.823,11.294,121,84,50,34,37,28,9,13,0.0,0.0
1014,1596,25-09-2019 16:50:00,1,2351.0,1884.0,0.801,11.347,147,65,42,23,82,45,37,46,0.0,0.0
1014,1597,25-09-2019 16:52:00,1,2334.0,1902.0,0.815,11.3,138,74,48,26,64,1,63,65,0.0,0.0
1014,1598,25-09-2019 16:54:00,1,2551.0,2009.0,0.787,12.277,123,69,43,26,54,4,50,64,0.0,0.0
1014,1599,25-09-2019 16:56:00,1,2656.0,2045.0,0.77,12.728,114,70,46,24,44,0,44,52,0.0,0.0
1014,1600,25-09-2019 16:58:00,1,2865.0,2184.0,0.762,13.706,101,52,34,18,49,8,41,74,0.0,0.0
1014,1601,25-09-2019 17:00:00,1,2247.0,1787.0,0.795,10.831,260,156,123,33,104,67,37,70,0.0,0.0
1014,1602,25-09-2019 17:02:00,1,1858.0,1527.0,0.822,9.012,53,32,22,10,21,6,15,1,0.0,0.0
1014,1603,25-09-2019 17:04:00,1,1842.0,1503.0,0.816,8.92,93,52,29,23,41,9,32,11,0.0,0.0
1014,1604,25-09-2019 17:06:00,1,2197.0,1608.0,0.732,10.437,72,49,24,25,23,4,19,3,0.0,0.0
1014,1605,25-09-2019 17:08:00,1,2263.0,1741.0,0.769,10.842,18,18,6,12,0,0,0,0,0.0,0.0
1014,1606,25-09-2019 17:10:00,1,2182.0,1650.0,0.756,10.423,4,4,2,2,0,0,0,0,0.01,0.0
1014,1607,25-09-2019 17:12:00,1,2174.0,1629.0,0.749,10.369,2,2,1,1,0,0,0,0,0.0,0.0
1014,1608,25-09-2019 17:14:00,1,2386.0,1750.0,0.734,11.338,2,2,0,2,0,0,0,0,0.0,0.0
1014,1609,25-09-2019 17:16:00,1,2353.0,1898.0,0.807,11.372,0,0,0,0,0,0,0,0,0.0,0.0
1014,1610,25-09-2019 17:18:00,1,2337.0,1914.0,0.819,11.328,4,4,0,4,0,0,0,0,0.0,0.0
1014,1611,25-09-2019 17:20:00,1,2497.0,1985.0,0.7965,12.0375,66,52,21,31,14,5,9,0,0.0,0.0
1014,1612,25-09-2019 17:22:00,1,2657.0,2056.0,0.774,12.747,59,39,13,26,20,2,18,0,0.0,0.0
1014,1613,25-09-2019 17:24:00,1,2656.0,2095.0,0.789,12.784,72,51,20,31,21,0,21,0,0.02,0.02
1014,1614,25-09-2019 17:26:00,1,2639.0,2137.0,0.81,12.763,10,6,2,4,4,0,4,0,0.0,0.0
1014,1615,25-09-2019 17:28:00,1,2332.0,1986.0,0.851,11.388,2,2,1,1,0,0,0,0,0.0,0.0
1014,1616,25-09-2019 17:30:00,1,2366.0,1853.0,0.783,11.375,0,0,0,0,0,0,0,0,0.0,0.0
1014,1617,25-09-2019 17:32:00,1,2264.0,1756.0,0.776,10.864,95,68,33,35,27,5,22,2,0.0,0.0
1014,1618,25-09-2019 17:34:00,1,2378.0,1799.0,0.757,11.36,110,54,30,24,56,0,56,66,0.0,0.0
1014,1619,25-09-2019 17:36:00,1,2356.0,1842.0,0.782,11.323,141,85,63,22,56,4,52,44,0.0,0.0
1014,1620,25-09-2019 17:38:00,1,2692.0,1984.0,0.737,12.801,80,30,5,25,50,1,49,59,0.0,0.0
1014,1621,25-09-2019 17:40:00,1,2644.0,2100.0,0.794,12.742,102,53,35,18,49,1,48,53,0.0,0.03
1014,1622,25-09-2019 17:42:00,1,2962.0,2274.0,0.768,14.186,162,113,80,33,49,0,49,65,0.0,0.05
1014,1623,25-09-2019 17:44:00,1,3129.0,2483.0,0.794,15.075,80,36,23,13,44,0,44,50,0.0,0.02
1014,1624,25-09-2019 17:46:00,1,3218.0,2682.0,0.833,15.648,120,67,44,23,53,0,53,51,0.0,0.07
1014,1625,25-09-2019 17:48:00,1,3108.0,2542.0,0.818,15.061,184,102,82,20,82,43,39,60,0.05,0.06
1014,1626,25-09-2019 17:50:00,1,2325.0,1930.0,0.83,11.299,67,45,25,20,22,2,20,0,0.0,0.0
1014,1627,25-09-2019 17:52:00,1,2072.0,1551.0,0.749,9.881,11,9,4,5,2,0,2,0,0.01,0.01
1014,1628,25-09-2019 17:54:00,1,2022.0,1528.0,0.756,9.6585,3,3,0,3,0,0,0,0,0.0,0.0
1014,1629,25-09-2019 17:56:00,1,1972.0,1505.0,0.763,9.436,0,0,0,0,0,0,0,0,0.01,0.02
1014,1630,25-09-2019 17:58:00,1,2169.0,1696.0,0.782,10.425,3,3,1,2,0,0,0,0,0.02,0.0
1014,1631,25-09-2019 18:00:00,0,2343.0,1843.0,0.787,11.271,2,2,0,2,0,0,0,0,0.0,0.0
1014,1632,25-09-2019 18:02:00,0,2336.0,1941.0,0.831,11.352,2,0,0,0,2,0,2,0,0.0,0.0
1014,1633,25-09-2019 18:04:00,0,2319.0,1997.0,0.861,11.349,3,1,1,0,2,0,2,0,0.0,0.0
1014,1634,25-09-2019 18:06:00,0,2549.0,2095.0,0.822,12.361,5,5,1,4,0,0,0,0,0.0,0.0
1014,1635,25-09-2019 18:08:00,0,2611.0,2204.0,0.844,12.727,333,220,169,51,113,83,30,62,0.0,0.01
1014,1636,25-09-2019 18:10:00,0,2905.0,2498.0,0.86,14.211,67,43,17,26,24,3,21,12,0.0,0.0
1014,1637,25-09-2019 18:12:00,0,2989.0,2589.0,0.866,14.643,138,105,67,38,33,2,31,7,0.0,0.0
1014,1638,25-09-2019 18:14:00,0,3068.0,2748.0,0.896,15.131,33,18,6,12,15,0,15,1,0.0,0.0
1014,1639,25-09-2019 18:16:00,0,3161.0,2872.0,0.909,15.633,111,73,38,35,38,0,38,1,0.0,0.0
1014,1640,25-09-2019 18:18:00,0,3080.0,2765.0,0.898,15.197,356,232,184,48,124,95,29,123,0.0,0.0
1014,1641,25-09-2019 18:20:00,0,3375.0,2940.0,0.871,16.551,299,166,128,38,133,91,42,162,0.01,0.0
1014,1642,25-09-2019 18:22:00,0,3346.0,2956.0,0.883,16.456,158,85,54,31,73,0,73,72,0.0,0.03
1014,1643,25-09-2019 18:24:00,0,3348.0,3039.0,0.908,16.555,167,93,67,26,74,18,56,64,0.0,0.08
1014,1644,25-09-2019 18:26:00,0,3432.0,3109.0,0.906,16.966,133,78,61,17,55,36,19,59,0.17,0.0
1014,1645,25-09-2019 18:28:00,0,3637.5,3238.0,0.891,17.918,97,61,45,16,36,19,17,39,0.0,0.01
1014,1646,25-09-2019 18:30:00,0,3843.0,3367.0,0.876,18.87,333,169,127,42,164,133,31,99,0.0,0.02
1014,1647,25-09-2019 18:32:00,0,3840.0,3467.0,0.903,18.969,134,85,54,31,49,15,34,59,0.03,0.0
1014,1648,25-09-2019 18:34:00,0,3348.0,3069.0,0.917,16.589,122,76,49,27,46,0,46,61,0.0,0.04
1014,1649,25-09-2019 18:36:00,0,3679.0,3178.0,0.864,18.015,115,67,51,16,48,8,40,62,0.01,0.06
1014,1650,25-09-2019 18:38:00,0,3044.0,2790.0,0.917,15.085,43,23,19,4,20,14,6,47,0.06,0.02
1014,1651,25-09-2019 18:40:00,0,2710.0,2315.0,0.854,13.24,298,165,132,33,133,102,31,116,0.0,0.0
1014,1652,25-09-2019 18:42:00,0,2969.0,2644.0,0.89,14.626,428,179,148,31,249,203,46,114,0.04,0.0
1014,1653,25-09-2019 18:44:00,0,3350.0,3037.0,0.906,16.563,230,127,104,23,103,60,43,97,0.11,0.02
1014,1654,25-09-2019 18:46:00,0,3661.0,3192.0,0.872,17.96,98,43,30,13,55,6,49,41,0.0,0.32
1014,1655,25-09-2019 18:48:00,0,3052.0,2746.0,0.9,15.066,8,0,0,0,8,1,7,0,0.0,0.01
1014,1656,25-09-2019 18:50:00,0,3070.0,2744.0,0.894,15.135,106,61,48,13,45,32,13,8,0.03,0.0
1014,1657,25-09-2019 18:52:00,0,3668.0,3178.0,0.866,17.972,304,160,122,38,144,100,44,40,0.0,0.0
1014,1658,25-09-2019 18:54:00,0,2914.0,2490.0,0.855,14.238,207,103,83,20,104,71,33,74,0.06,0.0
1014,1659,25-09-2019 18:56:00,0,3079.0,2696.0,0.876,15.115,231,130,99,31,101,76,25,101,0.01,0.0
1014,1660,25-09-2019 18:58:00,0,3090.0,2683.0,0.868,15.147,42,30,8,22,12,1,11,2,0.02,0.01
1014,1661,25-09-2019 19:00:00,0,3088.0,2627.0,0.851,15.076,49,37,17,20,12,0,12,0,0.0,0.01
1014,1662,25-09-2019 19:02:00,0,3072.0,2710.0,0.8825,15.1045,84,72,26,46,12,6,6,0,0.0,0.0
1014,1663,25-09-2019 19:04:00,0,3056.0,2793.0,0.914,15.133,2,2,0,2,0,0,0,0,0.0,0.0
1014,1664,25-09-2019 19:06:00,0,3108.0,2626.0,0.845,15.154,4,4,0,4,0,0,0,0,0.0,0.0
1014,1665,25-09-2019 19:08:00,0,2704.0,2346.0,0.868,13.25,1,0,0,0,1,1,0,0,0.0,0.0
1014,1666,25-09-2019 19:10:00,0,2600.0,2203.0,0.847,12.685,12,8,2,6,4,0,4,0,0.0,0.0
1014,1667,25-09-2019 19:12:00,0,2610.0,2289.0,0.877,12.818,3,0,0,0,3,0,3,0,0.0,0.0
1014,1668,25-09-2019 19:14:00,0,2799.0,2420.0,0.865,13.707,8,6,2,4,2,0,2,0,0.0,0.0
1014,1669,25-09-2019 19:16:00,0,2885.0,2554.0,0.885,14.193,6,3,0,3,3,0,3,0,0.0,0.0
1014,1670,25-09-2019 19:18:00,0,2858.0,2642.0,0.924,14.185,24,17,12,5,7,3,4,0,0.0,0.0
1014,1671,25-09-2019 19:20:00,0,3076.0,2708.0,0.88,15.117,48,8,5,3,40,20,20,33,0.04,0.0
1014,1672,25-09-2019 19:22:00,0,2862.0,2665.0,0.931,14.228,271,171,134,37,100,65,35,39,0.01,0.02
1014,1673,25-09-2019 19:24:00,0,2862.0,2601.0,0.909,14.157,177,100,78,22,77,45,32,43,0.0,0.0
1014,1674,25-09-2019 19:26:00,0,3041.0,2907.0,0.956,15.2,200,105,76,29,95,74,21,95,0.01,0.0
1014,1675,25-09-2019 19:28:00,0,3038.0,2795.0,0.92,15.064,146,88,63,25,58,23,35,81,0.05,0.0
1014,1676,25-09-2019 19:30:00,0,3150.0,2911.0,0.924,15.632,119,50,31,19,69,11,58,72,0.0,0.0
1014,1677,25-09-2019 19:32:00,0,3365.0,3011.0,0.895,16.592,114,69,47,22,45,6,39,66,0.02,0.04
1014,1678,25-09-2019 19:34:00,0,3063.0,2793.0,0.912,15.16,207,124,89,35,83,56,27,79,0.08,0.03
1014,1679,25-09-2019 19:36:00,0,2911.0,2680.5,0.9215,14.436,54,30,16,14,24,5,19,0,0.04,0.0
1014,1680,25-09-2019 19:38:00,0,2759.0,2568.0,0.931,13.712,13,8,3,5,5,0,5,0,0.0,0.0
1014,1681,25-09-2019 19:40:00,0,2579.0,2386.0,0.925,12.801,3,3,1,2,0,0,0,0,0.0,0.0
1014,1682,25-09-2019 19:42:00,0,2493.0,2243.0,0.9,12.304,2,0,0,0,2,1,1,0,0.0,0.0
1014,1683,25-09-2019 19:44:00,0,2502.0,2236.0,0.894,12.333,2,0,0,0,2,0,2,0,0.0,0.0
1014,1684,25-09-2019 19:46:00,0,2162.0,2081.0,0.962,10.822,6,5,2,3,1,0,1,0,0.0,0.0
1014,1685,25-09-2019 19:48:00,0,2502.0,2226.0,0.89,12.322,21,10,4,6,11,5,6,0,0.0,0.0
1014,1686,25-09-2019 19:50:00,0,2281.0,2161.0,0.947,11.38,2,2,1,1,0,0,0,0,0.0,0.0
1014,1687,25-09-2019 19:52:00,0,2459.0,2368.0,0.963,12.31,7,0,0,0,7,1,6,0,0.0,0.0
1014,1688,25-09-2019 19:54:00,0,2381.0,2218.0,0.931,11.836,3,0,0,0,3,0,3,0,0.0,0.0
1014,1689,25-09-2019 19:56:00,0,2266.0,2179.0,0.962,11.34,14,11,7,4,3,1,2,0,0.0,0.0
1014,1690,25-09-2019 19:58:00,0,2464.0,2398.0,0.973,12.364,192,93,70,23,99,59,40,77,0.0,0.0
1014,1691,25-09-2019 20:00:00,0,2829.0,2686.0,0.949,14.121,145,51,36,15,94,48,46,49,0.0,0.0
1014,1692,25-09-2019 20:02:00,0,2942.0,2805.0,0.954,14.697,100,52,34,18,48,4,44,65,0.0,0.01
1014,1693,25-09-2019 20:04:00,0,3020.0,2927.0,0.969,15.138,246,143,107,36,103,45,58,86,0.08,0.04
1014,1694,25-09-2019 20:06:00,0,2939.0,2831.0,0.963,14.712,162,101,78,23,61,10,51,62,0.0,0.0
1014,1695,25-09-2019 20:08:00,0,3207.0,3106.0,0.968,16.076,135,78,51,27,57,0,57,70,0.0,0.0
1014,1696,25-09-2019 20:10:00,0,3314.0,3158.5,0.9535,16.5555,223,138,97,41,85,49,36,74,0.02,0.06
1014,1697,25-09-2019 20:12:00,0,3421.0,3211.0,0.939,17.035,317,155,127,28,162,114,48,89,0.01,0.01
1014,1698,25-09-2019 20:14:00,0,3422.0,3271.0,0.956,17.105,114,65,43,22,49,0,49,68,0.0,0.0
1014,1699,25-09-2019 20:16:00,0,3502.0,3354.0,0.958,17.509,128,68,44,24,60,23,37,57,0.05,0.05
1014,1700,25-09-2019 20:18:00,0,3239.0,2968.0,0.916,16.046,151,92,63,29,59,13,46,57,0.02,0.0
1014,1701,25-09-2019 20:20:00,0,3558.0,3220.0,0.905,17.582,159,95,58,37,64,0,64,61,0.0,0.02
1014,1702,25-09-2019 20:22:00,0,3499.0,3304.0,0.944,17.444,119,74,47,27,45,0,45,64,0.0,0.1
1014,1703,25-09-2019 20:24:00,0,3700.0,3469.0,0.937,18.418,222,103,77,26,119,61,58,77,0.07,0.05
1014,1704,25-09-2019 20:26:00,0,3968.0,3842.0,0.968,19.888,387,198,163,35,189,139,50,84,0.06,0.01
1014,1705,25-09-2019 20:28:00,0,3226.0,3065.0,0.95,16.104,189,108,84,24,81,45,36,69,0.07,0.0
1014,1706,25-09-2019 20:30:00,0,3312.0,3168.0,0.957,16.556,213,91,66,25,122,89,33,111,0.0,0.0
1014,1707,25-09-2019 20:32:00,0,3512.0,3336.0,0.95,17.531,151,87,56,31,64,0,64,77,0.0,0.0
1014,1708,25-09-2019 20:34:00,0,3609.0,3410.0,0.945,17.995,133,55,33,22,78,26,52,74,0.06,0.09
1014,1709,25-09-2019 20:36:00,0,2957.0,2734.0,0.925,14.679,83,81,44,37,2,1,1,8,0.01,0.01
1014,1710,25-09-2019 20:38:00,0,2932.0,2849.0,0.972,14.705,32,25,8,17,7,1,6,1,0.01,0.02
1014,1711,25-09-2019 20:40:00,0,3243.0,2972.0,0.916,16.069,59,37,23,14,22,5,17,0,0.0,0.0
1014,1712,25-09-2019 20:42:00,0,3213.0,3125.0,0.973,16.119,226,134,97,37,92,61,31,143,0.01,0.0
1014,1713,25-09-2019 20:44:00,0,3513.0,3357.0,0.957,17.557,120,61,42,19,59,0,59,75,0.0,0.0
1014,1714,25-09-2019 20:46:00,0,3813.0,3589.0,0.941,18.995,105,42,25,17,63,0,63,52,0.01,0.09
1014,1715,25-09-2019 20:48:00,0,4113.0,3762.0,0.915,20.372,142,76,51,25,66,0,66,72,0.0,0.05
1014,1716,25-09-2019 20:50:00,0,3800.0,3587.0,0.944,18.941,111,37,18,19,74,20,54,32,0.08,0.06
1014,1717,25-09-2019 20:52:00,0,4074.0,3917.0,0.961,20.386,183,89,75,14,94,45,49,30,0.06,0.0
1014,1718,25-09-2019 20:54:00,0,3642.0,3261.0,0.895,17.96,211,73,44,29,138,102,36,70,0.01,0.0
1014,1719,25-09-2019 20:56:00,0,3078.0,2729.0,0.886,15.15,211,125,101,24,86,64,22,136,0.02,0.0
1014,1720,25-09-2019 20:58:00,0,3029.0,2866.0,0.946,15.107,340,178,149,29,162,128,34,194,0.04,0.01
1014,1721,25-09-2019 21:00:00,0,3565.0,3146.0,0.883,17.531,102,41,28,13,61,0,61,43,0.02,0.38
1014,1722,25-09-2019 21:02:00,0,3333.0,3060.0,0.918,16.519,10,0,0,0,10,0,10,0,0.0,0.01
1014,1723,25-09-2019 21:04:00,0,3161.0,2882.0,0.911,15.646,20,4,2,2,16,6,10,0,0.0,0.01
1014,1724,25-09-2019 21:06:00,0,3612.0,3386.0,0.938,17.98,287,137,107,30,150,114,36,59,0.05,0.02
1014,1725,25-09-2019 21:08:00,0,3334.0,3097.0,0.929,16.564,166,76,48,28,90,67,23,29,0.06,0.0
1014,1726,25-09-2019 21:10:00,0,2884.0,2545.0,0.882,14.181,455,233,174,59,222,167,55,38,0.0,0.0
1014,1727,25-09-2019 21:12:00,0,3136.0,2935.0,0.936,15.605,224,156,122,34,68,51,17,57,0.01,0.0
1014,1728,25-09-2019 21:14:00,0,2877.0,2574.0,0.895,14.186,31,27,15,12,4,1,3,0,0.01,0.0
1014,1729,25-09-2019 21:16:00,0,3041.0,2824.0,0.929,15.107,52,38,22,16,14,7,7,0,0.0,0.0
1014,1730,25-09-2019 21:18:00,0,3181.5,2948.5,0.927,15.798,77,59,48,11,18,10,8,0,0.0,0.0
1014,1731,25-09-2019 21:20:00,0,3322.0,3073.0,0.925,16.489,278,192,150,42,86,50,36,0,0.01,0.0
1014,1732,25-09-2019 21:22:00,0,3640.0,3268.0,0.898,17.961,300,209,166,43,91,59,32,22,0.0,0.0
1014,1733,25-09-2019 21:24:00,0,3615.0,3351.0,0.927,17.953,147,74,53,21,73,49,24,96,0.04,0.0
1014,1734,25-09-2019 21:26:00,0,3533.0,3253.0,0.921,17.52,361,213,175,38,148,111,37,79,0.0,0.0
1014,1735,25-09-2019 21:28:00,0,3614.0,3253.0,0.9,17.841,186,106,69,37,80,50,30,23,0.1,0.0
1014,1736,25-09-2019 21:30:00,0,3355.0,3061.0,0.912,16.609,77,44,22,22,33,13,20,3,0.0,0.0
1014,1737,25-09-2019 21:32:00,0,3357.0,2984.0,0.889,16.53,94,84,57,27,10,1,9,1,0.0,0.0
1014,1738,25-09-2019 21:34:00,0,3367.0,3027.0,0.899,16.618,26,7,3,4,19,0,19,0,0.04,0.0
1014,1739,25-09-2019 21:36:00,0,3374.0,2939.0,0.871,16.546,24,0,0,0,24,0,24,0,0.0,0.0
1014,1740,25-09-2019 21:38:00,0,3086.0,2725.0,0.883,15.176,0,0,0,0,0,0,0,0,0.0,0.0
1014,1741,25-09-2019 21:40:00,0,2874.0,2557.0,0.89,14.155,4,3,1,2,1,0,1,0,0.0,0.0
1014,1742,25-09-2019 21:42:00,0,2969.0,2636.0,0.888,14.614,15,15,2,13,0,0,0,0,0.0,0.0
1014,1743,25-09-2019 21:44:00,0,2855.0,2673.0,0.937,14.207,3,2,1,1,1,0,1,0,0.0,0.0
1014,1744,25-09-2019 21:46:00,0,2880.0,2553.0,0.886,14.174,2,2,0,2,0,0,0,0,0.0,0.0
1014,1745,25-09-2019 21:48:00,0,2587.0,2276.0,0.88,12.715,1,1,0,1,0,0,0,0,0.0,0.0
1014,1746,25-09-2019 21:50:00,0,2285.0,2137.0,0.935,11.37,0,0,0,0,0,0,0,0,0.0,0.0
1014,1747,25-09-2019 21:52:00,0,2509.0,2384.0,0.949,12.5245,73,54,30,24,19,9,10,2,0.0,0.0
1014,1748,25-09-2019 21:54:00,0,2733.0,2631.0,0.963,13.679,177,109,87,22,68,41,27,79,0.0,0.0
1014,1749,25-09-2019 21:56:00,0,2747.0,2645.0,0.963,13.75,76,35,18,17,41,4,37,66,0.0,0.0
1014,1750,25-09-2019 21:58:00,0,2750.0,2605.0,0.947,13.72,40,14,9,5,26,0,26,57,0.0,0.0
1014,1751,25-09-2019 22:00:00,0,2763.0,2551.0,0.923,13.71,115,66,47,19,49,21,28,95,0.01,0.0
1014,1752,25-09-2019 22:02:00,0,2738.0,2645.0,0.966,13.716,106,56,35,21,50,2,48,85,0.01,0.0
1014,1753,25-09-2019 22:04:00,0,2974.0,2691.0,0.905,14.696,93,28,15,13,65,0,65,55,0.0,0.01
1014,1754,25-09-2019 22:06:00,0,2910.0,2929.0,1.007,14.707,119,52,26,26,67,31,36,32,0.06,0.15
1014,1755,25-09-2019 22:08:00,0,3200.0,3113.0,0.973,16.054,75,53,36,17,22,19,3,27,0.0,0.0
1014,1756,25-09-2019 22:10:00,0,3123.0,2987.0,0.956,15.613,222,136,96,40,86,61,25,55,0.0,0.0
1014,1757,25-09-2019 22:12:00,0,2777.0,2465.0,0.887,13.671,235,140,102,38,95,54,41,61,0.01,0.0
1014,1758,25-09-2019 22:14:00,0,3301.0,3164.0,0.958,16.509,199,71,52,19,128,77,51,51,0.01,0.0
1014,1759,25-09-2019 22:16:00,0,2919.0,2883.0,0.988,14.692,247,108,75,33,139,78,61,73,0.03,0.0
1014,1760,25-09-2019 22:18:00,0,2676.0,2471.0,0.924,13.278,109,63,45,18,46,4,42,52,0.02,0.0
1014,1761,25-09-2019 22:20:00,0,3252.0,2982.0,0.917,16.115,133,68,39,29,65,18,47,42,0.07,0.0
1014,1762,25-09-2019 22:22:00,0,3211.0,3093.0,0.963,16.075,113,47,31,16,66,0,66,51,0.0,0.0
1014,1763,25-09-2019 22:24:00,0,3527.0,3270.0,0.927,17.518,120,69,44,25,51,4,47,54,0.0,0.01
1014,1764,25-09-2019 22:26:00,0,3142.0,2945.5,0.939,15.641,157,73,49,24,84,25,59,37,0.04,0.02
1014,1765,25-09-2019 22:28:00,0,2757.0,2621.0,0.951,13.764,40,22,6,16,18,2,16,2,0.0,0.0
1014,1766,25-09-2019 22:30:00,0,2969.0,2714.0,0.914,14.702,87,64,39,25,23,2,21,0,0.0,0.0
1014,1767,25-09-2019 22:32:00,0,2920.0,2845.0,0.974,14.655,25,2,1,1,23,2,21,0,0.0,0.0
1014,1768,25-09-2019 22:34:00,0,2953.0,2734.0,0.926,14.662,2,0,0,0,2,0,2,0,0.01,0.01
1014,1769,25-09-2019 22:36:00,0,2741.0,2623.0,0.957,13.704,13,9,3,6,4,0,4,0,0.04,0.03
1014,1770,25-09-2019 22:38:00,0,2477.0,2340.0,0.945,12.351,6,6,0,6,0,0,0,0,0.0,0.0
1014,1771,25-09-2019 22:40:00,0,2481.0,2243.0,0.904,12.26,21,17,9,8,4,0,4,0,0.0,0.0
1014,1772,25-09-2019 22:42:00,0,2395.0,2198.0,0.918,11.872,2,2,0,2,0,0,0,0,0.0,0.0
1014,1773,25-09-2019 22:44:00,0,2265.0,2176.0,0.961,11.333,6,6,0,6,0,0,0,0,0.0,0.0
1014,1774,25-09-2019 22:46:00,0,2273.0,2200.0,0.968,11.391,2,2,0,2,0,0,0,0,0.0,0.0
1014,1775,25-09-2019 22:48:00,0,2381.0,2219.0,0.932,11.837,1,1,0,1,0,0,0,0,0.0,0.0
1014,1776,25-09-2019 22:50:00,0,2265.0,2169.0,0.957,11.327,17,14,8,6,3,1,2,0,0.0,0.0
1014,1777,25-09-2019 22:52:00,0,2472.0,2277.0,0.921,12.26,2,2,0,2,0,0,0,0,0.0,0.0
1014,1778,25-09-2019 22:54:00,0,2478.0,2278.0,0.919,12.286,11,7,1,6,4,0,4,0,0.0,0.0
1014,1779,25-09-2019 22:56:00,0,2488.0,2297.0,0.923,12.346,0,0,0,0,0,0,0,0,0.0,0.0
1014,1780,25-09-2019 22:58:00,0,2454.0,2365.0,0.964,12.288,24,15,6,9,9,2,7,0,0.0,0.0
1014,1781,25-09-2019 23:00:00,0,2450.5,2381.0,0.972,12.291,6,1,0,1,5,0,5,0,0.0,0.0
1014,1782,25-09-2019 23:02:00,0,2447.0,2397.0,0.98,12.294,25,19,9,10,6,1,5,0,0.0,0.0
1014,1783,25-09-2019 23:04:00,0,2453.0,2382.0,0.971,12.303,6,6,2,4,0,0,0,0,0.0,0.0
1014,1784,25-09-2019 23:06:00,0,2462.0,2355.0,0.957,12.308,0,0,0,0,0,0,0,0,0.0,0.0
1014,1785,25-09-2019 23:08:00,0,2466.0,2363.0,0.958,12.332,9,2,1,1,7,3,4,0,0.0,0.0
1014,1786,25-09-2019 23:10:00,0,2478.0,2292.0,0.925,12.299,3,3,2,1,0,0,0,0,0.0,0.0
1014,1787,25-09-2019 23:12:00,0,2450.0,2383.0,0.972,12.293,17,11,2,9,6,0,6,0,0.0,0.0
1014,1788,25-09-2019 23:14:00,0,2443.0,2468.0,1.01,12.359,10,9,0,9,1,0,1,0,0.0,0.0
1014,1789,25-09-2019 23:16:00,0,2256.0,2229.0,0.988,11.358,47,38,17,21,9,0,9,0,0.0,0.0
1014,1790,25-09-2019 23:18:00,0,2773.0,2547.0,0.918,13.743,111,79,45,34,32,18,14,42,0.0,0.0
1014,1791,25-09-2019 23:20:00,0,2660.0,2473.0,0.93,13.216,117,50,28,22,67,0,67,78,0.0,0.0
1014,1792,25-09-2019 23:22:00,0,2747.0,2640.0,0.961,13.746,236,121,91,30,115,60,55,92,0.0,0.01
1014,1793,25-09-2019 23:24:00,0,2952.0,2752.0,0.932,14.678,145,81,56,25,64,0,64,83,0.0,0.0
1014,1794,25-09-2019 23:26:00,0,2930.0,2844.0,0.971,14.691,279,159,119,40,120,53,67,78,0.05,0.1
1014,1795,25-09-2019 23:28:00,0,3306.0,3184.0,0.963,16.55,193,111,85,26,82,52,30,57,0.0,0.0
1014,1796,25-09-2019 23:30:00,0,3022.0,2948.0,0.976,15.172,107,42,32,10,65,0,65,60,0.0,0.0
1014,1797,25-09-2019 23:32:00,0,3206.0,3042.0,0.949,16.0,143,74,47,27,69,1,68,67,0.02,0.03
1014,1798,25-09-2019 23:34:00,0,3201.5,3107.0,0.9705,16.054,166,74,48,26,92,29,63,43,0.1,0.04
1014,1799,25-09-2019 23:36:00,0,3197.0,3172.0,0.992,16.108,378,179,137,42,199,147,52,143,0.03,0.0
1014,1800,25-09-2019 23:38:00,0,2900.0,2911.0,1.004,14.648,159,94,70,24,65,31,34,99,0.0,0.0
1014,1801,25-09-2019 23:40:00,0,3696.0,3466.0,0.938,18.398,127,68,44,24,59,11,48,55,0.03,0.03
1014,1802,25-09-2019 23:42:00,0,3314.0,3182.0,0.96,16.581,300,163,128,35,137,101,36,116,0.0,0.0
1014,1803,25-09-2019 23:44:00,0,3207.0,3124.0,0.974,16.093,334,161,129,32,173,139,34,79,0.02,0.0
1014,1804,25-09-2019 23:46:00,0,2934.0,2835.0,0.966,14.698,188,88,62,26,100,44,56,60,0.01,0.0
1014,1805,25-09-2019 23:48:00,0,3702.0,3513.0,0.949,18.475,116,64,41,23,52,0,52,59,0.01,0.0
1014,1806,25-09-2019 23:50:00,0,3709.0,3497.0,0.943,18.487,117,74,43,31,43,0,43,47,0.01,0.06
1014,1807,25-09-2019 23:52:00,0,3712.0,3531.0,0.951,18.535,149,91,65,26,58,0,58,63,0.0,0.0
1014,1808,25-09-2019 23:54:00,0,3475.0,3314.0,0.954,17.359,138,87,61,26,51,0,51,55,0.0,0.0
1014,1809,25-09-2019 23:56:00,0,3705.0,3501.0,0.945,18.472,127,58,33,25,69,24,45,28,0.08,0.1
1014,1810,25-09-2019 23:58:00,0,3206.0,3131.0,0.977,16.099,194,82,55,27,112,76,36,0,0.0,0.01
1014,1811,26-09-2019 00:00:00,0,3420.0,3235.0,0.946,17.056,263,160,118,42,103,72,31,26,0.01,0.0
1014,1812,26-09-2019 00:02:00,0,2748.0,2642.0,0.961,13.753,331,201,160,41,130,100,30,88,0.0,0.0
1014,1813,26-09-2019 00:04:00,0,3122.0,2974.0,0.953,15.592,228,128,98,30,100,52,48,87,0.0,0.0
1014,1814,26-09-2019 00:06:00,0,3527.0,3279.0,0.93,17.526,116,56,43,13,60,0,60,53,0.0,0.0
1014,1815,26-09-2019 00:08:00,0,3605.0,3412.5,0.9465,17.9815,116,60,43,17,56,0,56,65,0.01,0.01
1014,1816,26-09-2019 00:10:00,0,3683.0,3546.0,0.963,18.437,122,72,49,23,50,0,50,56,0.0,0.0
1014,1817,26-09-2019 00:12:00,0,3519.0,3361.0,0.955,17.587,124,69,48,21,55,8,47,47,0.08,0.06
1014,1818,26-09-2019 00:14:00,0,3516.0,3242.0,0.922,17.441,151,83,53,30,68,3,65,62,0.01,0.03
1014,1819,26-09-2019 00:16:00,0,3500.0,3394.0,0.97,17.548,101,60,38,22,41,0,41,45,0.0,0.1
1014,1820,26-09-2019 00:18:00,0,3549.0,3203.0,0.903,17.531,133,55,36,19,78,8,70,56,0.0,0.08
1014,1821,26-09-2019 00:20:00,0,3503.0,3353.0,0.957,17.515,187,115,76,39,72,38,34,2,0.08,0.0
1014,1822,26-09-2019 00:22:00,0,3133.0,2914.0,0.93,15.57,336,167,127,40,169,129,40,125,0.03,0.01
1014,1823,26-09-2019 00:24:00,0,3618.0,3434.0,0.949,18.058,267,149,111,38,118,89,29,59,0.0,0.0
1014,1824,26-09-2019 00:26:00,0,2935.0,2800.0,0.954,14.662,104,77,40,37,27,2,25,1,0.0,0.0
1014,1825,26-09-2019 00:28:00,0,3142.0,2958.0,0.941,15.654,31,12,4,8,19,1,18,0,0.0,0.0
1014,1826,26-09-2019 00:30:00,0,2916.0,2862.0,0.982,14.656,68,57,30,27,11,3,8,0,0.0,0.0
1014,1827,26-09-2019 00:32:00,0,3226.0,3069.0,0.951,16.107,360,281,217,64,79,42,37,0,0.0,0.0
1014,1828,26-09-2019 00:34:00,0,3235.0,3041.0,0.94,16.114,476,306,246,60,170,113,57,3,0.0,0.0
1014,1829,26-09-2019 00:36:00,0,3323.0,3163.0,0.952,16.594,458,216,169,47,242,183,59,74,0.0,0.0
1014,1830,26-09-2019 00:38:00,0,3522.0,3255.0,0.924,17.482,235,98,59,39,137,81,56,39,0.0,0.12
1014,1831,26-09-2019 00:40:00,0,3446.0,3195.0,0.927,17.115,107,30,13,17,77,0,77,64,0.0,0.0
1014,1832,26-09-2019 00:42:00,0,3475.0,3270.5,0.941,17.3115,117,43,31,12,74,0,74,71,0.0,0.0
1014,1833,26-09-2019 00:44:00,0,3504.0,3346.0,0.955,17.508,185,108,74,34,77,35,42,19,0.09,0.03
1014,1834,26-09-2019 00:46:00,0,2786.0,2500.0,0.897,13.744,20,5,2,3,15,0,15,0,0.0,0.01
1014,1835,26-09-2019 00:48:00,0,2948.0,2791.0,0.947,14.704,36,35,8,27,1,0,1,0,0.0,0.0
1014,1836,26-09-2019 00:50:00,0,2935.0,2788.0,0.95,14.649,69,36,18,18,33,2,31,0,0.0,0.0
1014,1837,26-09-2019 00:52:00,0,2951.0,2766.0,0.937,14.69,56,34,18,16,22,1,21,0,0.0,0.0
1014,1838,26-09-2019 00:54:00,0,2864.0,2638.0,0.921,14.204,1,0,0,0,1,1,0,0,0.0,0.0
1014,1839,26-09-2019 00:56:00,0,2782.0,2437.0,0.876,13.66,3,1,1,0,2,0,2,0,0.0,0.0
1014,1840,26-09-2019 00:58:00,0,2692.0,2383.0,0.885,13.243,14,2,1,1,12,0,12,0,0.0,0.0
1014,1841,26-09-2019 01:00:00,0,2481.0,2287.0,0.922,12.306,3,0,0,0,3,0,3,0,0.03,0.0
1014,1842,26-09-2019 01:02:00,0,2476.0,2301.0,0.929,12.303,12,8,2,6,4,0,4,0,0.0,0.0
1014,1843,26-09-2019 01:04:00,0,2465.0,2352.0,0.954,12.317,3,0,0,0,3,0,3,0,0.0,0.0
1014,1844,26-09-2019 01:06:00,0,2555.0,2424.0,0.949,12.751,3,3,1,2,0,0,0,0,0.0,0.0
1014,1845,26-09-2019 01:08:00,0,2474.0,2292.0,0.926,12.285,0,0,0,0,0,0,0,0,0.0,0.0
1014,1846,26-09-2019 01:10:00,0,2367.0,2239.0,0.946,11.807,1,1,0,1,0,0,0,0,0.0,0.0
1014,1847,26-09-2019 01:12:00,0,2473.0,2324.0,0.94,12.318,2,0,0,0,2,1,1,0,0.0,0.0
1014,1848,26-09-2019 01:14:00,0,2459.0,2337.0,0.95,12.275,11,5,4,1,6,1,5,0,0.0,0.0
1014,1849,26-09-2019 01:16:00,0,2459.5,2329.0,0.947,12.268,0,0,0,0,0,0,0,0,0.0,0.0
1014,1850,26-09-2019 01:18:00,0,2460.0,2321.0,0.944,12.261,7,4,2,2,3,1,2,0,0.0,0.0
1014,1851,26-09-2019 01:20:00,0,2472.0,2325.0,0.941,12.315,34,25,14,11,9,3,6,0,0.0,0.0
1014,1852,26-09-2019 01:22:00,0,2462.0,2296.0,0.933,12.24,0,0,0,0,0,0,0,0,0.0,0.01
1014,1853,26-09-2019 01:24:00,0,2457.0,2392.0,0.974,12.328,26,22,15,7,4,0,4,2,0.0,0.0
1014,1854,26-09-2019 01:26:00,0,2467.0,2342.0,0.949,12.314,4,4,1,3,0,0,0,0,0.0,0.0
1014,1855,26-09-2019 01:28:00,0,2546.0,2504.0,0.983,12.803,0,0,0,0,0,0,0,0,0.0,0.0
1014,1856,26-09-2019 01:30:00,0,2427.0,2459.0,1.013,12.284,8,1,0,1,7,1,6,0,0.0,0.0
1014,1857,26-09-2019 01:32:00,0,2485.0,2326.0,0.936,12.364,1,1,1,0,0,0,0,0,0.0,0.0
1014,1858,26-09-2019 01:34:00,0,2138.0,2171.0,1.015,10.829,32,24,10,14,8,3,5,0,0.0,0.0
1014,1859,26-09-2019 01:36:00,0,2162.0,2115.0,0.978,10.859,7,1,1,0,6,0,6,0,0.0,0.0
1014,1860,26-09-2019 01:38:00,0,1974.0,1947.0,0.986,9.931,0,0,0,0,0,0,0,0,0.0,0.0
1014,1861,26-09-2019 01:40:00,0,2203.0,2015.0,0.915,10.909,16,16,1,15,0,0,0,0,0.0,0.0
1014,1862,26-09-2019 01:42:00,0,2260.0,2226.0,0.985,11.368,187,111,79,32,76,48,28,6,0.0,0.0
1014,1863,26-09-2019 01:44:00,0,2454.0,2371.0,0.966,12.294,140,85,51,34,55,38,17,11,0.0,0.0
1014,1864,26-09-2019 01:46:00,0,2543.0,2475.0,0.973,12.76,59,52,15,37,7,2,5,1,0.0,0.0
1014,1865,26-09-2019 01:48:00,0,2559.0,2467.0,0.964,12.811,404,237,183,54,167,113,54,49,0.0,0.01
1014,1866,26-09-2019 01:50:00,0,2648.0,2553.0,0.964,13.259,271,185,139,46,86,53,33,16,0.03,0.0
1014,1867,26-09-2019 01:52:00,0,2737.0,2639.0,0.964,13.707,43,29,9,20,14,2,12,2,0.01,0.0
1014,1868,26-09-2019 01:54:00,0,2741.0,2701.0,0.986,13.788,32,31,7,24,1,0,1,4,0.0,0.0
1014,1869,26-09-2019 01:56:00,0,2842.0,2721.0,0.957,14.21,8,8,1,7,0,0,0,0,0.0,0.0
1014,1870,26-09-2019 01:58:00,0,2771.0,2493.0,0.9,13.677,0,0,0,0,0,0,0,0,0.0,0.0
1014,1871,26-09-2019 02:00:00,0,2455.0,2400.0,0.978,12.331,0,0,0,0,0,0,0,0,0.03,0.0
1014,1872,26-09-2019 02:02:00,0,2466.0,2322.0,0.942,12.286,5,5,3,2,0,0,0,0,0.0,0.0
1014,1873,26-09-2019 02:04:00,0,2253.0,2243.0,0.995,11.361,0,0,0,0,0,0,0,0,0.0,0.0
1014,1874,26-09-2019 02:06:00,0,2160.0,2112.0,0.978,10.849,0,0,0,0,0,0,0,0,0.0,0.0
1014,1875,26-09-2019 02:08:00,0,2194.0,2047.0,0.933,10.912,21,21,3,18,0,0,0,0,0.0,0.0
1014,1876,26-09-2019 02:10:00,0,1995.0,1894.0,0.949,9.956,12,12,2,10,0,0,0,0,0.0,0.0
1014,1877,26-09-2019 02:12:00,0,1988.0,1904.0,0.958,9.941,8,8,2,6,0,0,0,0,0.0,0.0
1014,1878,26-09-2019 02:14:00,0,1990.0,1884.0,0.947,9.926,11,11,0,11,0,0,0,0,0.0,0.0
1014,1879,26-09-2019 02:16:00,0,1999.0,1893.0,0.947,9.974,21,18,3,15,3,0,3,0,0.0,0.0
1014,1880,26-09-2019 02:18:00,0,1970.0,1964.0,0.997,9.935,1,1,0,1,0,0,0,0,0.0,0.0
1014,1881,26-09-2019 02:20:00,0,1970.0,1981.0,1.006,9.954,2,2,1,1,0,0,0,0,0.0,0.0
1014,1882,26-09-2019 02:22:00,0,2189.0,2059.0,0.94,10.903,19,13,7,6,6,1,5,0,0.0,0.0
1014,1883,26-09-2019 02:24:00,0,2081.5,2026.0,0.975,10.4425,0,0,0,0,0,0,0,0,0.0,0.0
1014,1884,26-09-2019 02:26:00,0,1974.0,1993.0,1.01,9.982,18,5,2,3,13,6,7,0,0.0,0.0
1014,1885,26-09-2019 02:28:00,0,2181.0,2050.0,0.94,10.861,3,0,0,0,3,1,2,0,0.0,0.0
1014,1886,26-09-2019 02:30:00,0,1964.0,2018.0,1.027,9.973,33,27,8,19,6,1,5,0,0.0,0.0
1014,1887,26-09-2019 02:32:00,0,2146.0,2205.0,1.027,10.898,269,150,115,35,119,75,44,61,0.0,0.0
1014,1888,26-09-2019 02:34:00,0,2257.0,2229.0,0.988,11.361,143,75,47,28,68,0,68,83,0.0,0.0
1014,1889,26-09-2019 02:36:00,0,2655.0,2494.0,0.94,13.22,125,50,31,19,75,0,75,74,0.0,0.06
1014,1890,26-09-2019 02:38:00,0,2559.0,2452.0,0.958,12.798,15,1,1,0,14,3,11,1,0.0,0.3
1014,1891,26-09-2019 02:40:00,0,2451.0,2380.0,0.971,12.293,35,11,7,4,24,13,11,8,0.0,0.0
1014,1892,26-09-2019 02:42:00,0,2660.0,2511.0,0.944,13.261,79,49,38,11,30,21,9,78,0.0,0.0
1014,1893,26-09-2019 02:44:00,0,2479.0,2304.0,0.929,12.32,68,36,22,14,32,23,9,0,0.07,0.0
1014,1894,26-09-2019 02:46:00,0,2765.0,2532.0,0.916,13.696,281,206,161,45,75,47,28,0,0.01,0.01
1014,1895,26-09-2019 02:48:00,0,2935.0,2807.0,0.956,14.672,362,226,178,48,136,92,44,42,0.01,0.0
1014,1896,26-09-2019 02:50:00,0,2738.0,2675.0,0.977,13.75,168,90,72,18,78,60,18,171,0.12,0.0
1014,1897,26-09-2019 02:52:00,0,2895.0,2961.0,1.023,14.685,426,296,239,57,130,76,54,7,0.01,0.0
1014,1898,26-09-2019 02:54:00,0,2937.0,2819.0,0.96,14.694,267,156,108,48,111,74,37,8,0.0,0.03
1014,1899,26-09-2019 02:56:00,0,2920.0,2866.0,0.982,14.676,328,189,146,43,139,102,37,17,0.05,0.0
1014,1900,26-09-2019 02:58:00,0,3022.5,2924.5,0.968,15.146,85,62,35,27,23,7,16,0,0.0,0.0
1014,1901,26-09-2019 03:00:00,0,3125.0,2983.0,0.954,15.616,38,32,8,24,6,0,6,0,0.0,0.0
1014,1902,26-09-2019 03:02:00,0,3122.0,2963.0,0.949,15.582,42,32,8,24,10,0,10,1,0.0,0.0
1014,1903,26-09-2019 03:04:00,0,2924.0,2817.0,0.963,14.638,63,30,13,17,33,3,30,0,0.0,0.0
1014,1904,26-09-2019 03:06:00,0,2961.0,2738.0,0.925,14.697,50,44,16,28,6,1,5,0,0.0,0.0
1014,1905,26-09-2019 03:08:00,0,2944.0,2777.0,0.943,14.676,184,154,106,48,30,9,21,8,0.0,0.0
1014,1906,26-09-2019 03:10:00,0,2930.0,2852.0,0.973,14.703,75,55,26,29,20,0,20,1,0.0,0.0
1014,1907,26-09-2019 03:12:00,0,2942.0,2764.0,0.939,14.65,53,35,13,22,18,2,16,0,0.0,0.0
1014,1908,26-09-2019 03:14:00,0,2960.0,2766.0,0.934,14.726,2,2,1,1,0,0,0,0,0.0,0.0
1014,1909,26-09-2019 03:16:00,0,2745.0,2588.0,0.943,13.679,2,1,0,1,1,0,1,0,0.0,0.0
1014,1910,26-09-2019 03:18:00,0,2666.0,2486.0,0.933,13.256,1,1,0,1,0,0,0,0,0.0,0.0
1014,1911,26-09-2019 03:20:00,0,2452.0,2418.0,0.986,12.339,0,0,0,0,0,0,0,0,0.0,0.0
1014,1912,26-09-2019 03:22:00,0,2478.0,2313.0,0.934,12.323,2,1,0,1,1,0,1,0,0.0,0.0
1014,1913,26-09-2019 03:24:00,0,2256.0,2230.0,0.988,11.359,0,0,0,0,0,0,0,0,0.0,0.0
1014,1914,26-09-2019 03:26:00,0,2154.0,2169.0,1.007,10.888,3,1,1,0,2,0,2,0,0.0,0.0
1014,1915,26-09-2019 03:28:00,0,2139.0,2182.0,1.02,10.844,0,0,0,0,0,0,0,0,0.02,0.0
1014,1916,26-09-2019 03:30:00,0,2164.0,2113.0,0.976,10.865,1,0,0,0,1,0,1,0,0.0,0.0
1014,1917,26-09-2019 03:32:00,0,2180.0,2061.5,0.9455,10.8715,0,0,0,0,0,0,0,0,0.0,0.0
1014,1918,26-09-2019 03:34:00,0,2196.0,2010.0,0.915,10.878,3,0,0,0,3,0,3,0,0.0,0.0
1014,1919,26-09-2019 03:36:00,0,2078.0,2046.0,0.985,10.451,1,0,0,0,1,0,1,0,0.0,0.0
1014,1920,26-09-2019 03:38:00,0,1977.0,1931.0,0.977,9.925,2,0,0,0,2,0,2,0,0.0,0.0
1014,1921,26-09-2019 03:40:00,0,1899.0,1760.0,0.927,9.43,16,13,5,8,3,0,3,0,0.0,0.0
1014,1922,26-09-2019 03:42:00,0,2013.0,1831.0,0.909,9.959,12,7,3,4,5,4,1,0,0.0,0.0
1014,1923,26-09-2019 03:44:00,0,1977.0,1961.0,0.992,9.96,0,0,0,0,0,0,0,0,0.0,0.0
1014,1924,26-09-2019 03:46:00,0,1986.0,1918.0,0.966,9.948,3,2,1,1,1,1,0,0,0.0,0.0
1014,1925,26-09-2019 03:48:00,0,2085.0,1994.0,0.956,10.424,4,2,0,2,2,0,2,0,0.0,0.0
1014,1926,26-09-2019 03:50:00,0,2186.0,2010.0,0.919,10.84,2,2,0,2,0,0,0,0,0.0,0.0
1014,1927,26-09-2019 03:52:00,0,2083.0,2006.0,0.963,10.428,1,1,1,0,0,0,0,0,0.0,0.0
1014,1928,26-09-2019 03:54:00,0,2197.0,2010.0,0.915,10.881,2,2,1,1,0,0,0,0,0.0,0.0
1014,1929,26-09-2019 03:56:00,0,2203.0,2022.0,0.918,10.918,3,2,0,2,1,1,0,0,0.0,0.0
1014,1930,26-09-2019 03:58:00,0,2186.0,2022.0,0.925,10.85,156,100,74,26,56,41,15,3,0.0,0.0
1014,1931,26-09-2019 04:00:00,0,2182.0,2068.0,0.948,10.885,73,56,32,24,17,3,14,0,0.0,0.0
1014,1932,26-09-2019 04:02:00,0,2143.0,2159.0,1.008,10.833,56,32,6,26,24,2,22,0,0.0,0.0
1014,1933,26-09-2019 04:04:00,0,2370.0,2282.0,0.963,11.863,42,31,13,18,11,2,9,2,0.0,0.0
1014,1934,26-09-2019 04:06:00,0,2370.0,2273.0,0.959,11.8525,0,0,0,0,0,0,0,0,0.0,0.0
1014,1935,26-09-2019 04:08:00,0,2370.0,2264.0,0.955,11.842,4,2,1,1,2,1,1,1,0.0,0.0
1014,1936,26-09-2019 04:10:00,0,2139.0,2224.0,1.04,10.888,16,10,5,5,6,2,4,0,0.0,0.0
1014,1937,26-09-2019 04:12:00,0,2353.0,2278.0,0.968,11.79,115,67,47,20,48,29,19,15,0.0,0.0
1014,1938,26-09-2019 04:14:00,0,2138.0,2236.0,1.046,10.898,230,176,137,39,54,34,20,40,0.0,0.0
1014,1939,26-09-2019 04:16:00,0,2250.0,2249.0,0.999,11.355,53,40,26,14,13,4,9,12,0.0,0.0
1014,1940,26-09-2019 04:18:00,0,2167.0,2109.0,0.973,10.873,0,0,0,0,0,0,0,0,0.0,0.0
1014,1941,26-09-2019 04:20:00,0,2174.0,2085.0,0.959,10.874,2,1,0,1,1,0,1,0,0.0,0.0
1014,1942,26-09-2019 04:22:00,0,2175.0,2116.0,0.973,10.914,5,4,2,2,1,0,1,0,0.0,0.0
1014,1943,26-09-2019 04:24:00,0,2178.0,2042.0,0.938,10.842,0,0,0,0,0,0,0,0,0.0,0.0
1014,1944,26-09-2019 04:26:00,0,2085.0,1996.0,0.957,10.424,1,1,0,1,0,0,0,0,0.0,0.0
1014,1945,26-09-2019 04:28:00,0,2204.0,2019.0,0.916,10.918,2,2,0,2,0,0,0,0,0.0,0.0
1014,1946,26-09-2019 04:30:00,0,2197.0,2026.0,0.922,10.898,4,2,1,1,2,1,1,0,0.0,0.0
1014,1947,26-09-2019 04:32:00,0,2169.0,2104.0,0.97,10.877,4,3,1,2,1,1,0,0,0.0,0.0
1014,1948,26-09-2019 04:34:00,0,2187.0,2054.0,0.939,10.892,67,35,11,24,32,0,32,0,0.0,0.0
1014,1949,26-09-2019 04:36:00,0,2264.0,2195.0,0.97,11.349,57,33,3,30,24,0,24,1,0.0,0.0
1014,1950,26-09-2019 04:38:00,0,2457.0,2313.0,0.942,12.241,36,0,0,0,36,2,34,0,0.0,0.0
1014,1951,26-09-2019 04:40:00,0,2564.0,2382.5,0.93,12.7385,20,19,1,18,1,0,1,0,0.0,0.0
1014,1952,26-09-2019 04:42:00,0,2671.0,2452.0,0.918,13.236,3,3,0,3,0,0,0,0,0.0,0.0
1014,1953,26-09-2019 04:44:00,0,2481.0,2282.0,0.92,12.302,0,0,0,0,0,0,0,0,0.0,0.0
1014,1954,26-09-2019 04:46:00,0,2164.0,2174.0,1.005,10.934,0,0,0,0,0,0,0,0,0.0,0.0
1014,1955,26-09-2019 04:48:00,0,2185.0,2057.0,0.941,10.887,23,9,6,3,14,4,10,0,0.0,0.0
1014,1956,26-09-2019 04:50:00,0,2186.0,2035.0,0.931,10.864,0,0,0,0,0,0,0,0,0.0,0.0
1014,1957,26-09-2019 04:52:00,0,2090.0,1967.0,0.941,10.414,3,1,0,1,2,0,2,0,0.0,0.0
1014,1958,26-09-2019 04:54:00,0,2201.0,2001.0,0.909,10.889,1,1,0,1,0,0,0,0,0.0,0.0
1014,1959,26-09-2019 04:56:00,0,2091.0,1980.0,0.947,10.43,39,27,15,12,12,2,10,0,0.0,0.0
1014,1960,26-09-2019 04:58:00,0,2173.0,2116.0,0.974,10.903,195,117,77,40,78,48,30,17,0.0,0.0
1014,1961,26-09-2019 05:00:00,0,2463.0,2394.0,0.972,12.354,151,87,53,34,64,28,36,72,0.0,0.0
1014,1962,26-09-2019 05:02:00,0,2459.0,2334.0,0.949,12.271,98,42,27,15,56,0,56,72,0.0,0.0
1014,1963,26-09-2019 05:04:00,0,2763.0,2516.0,0.911,13.671,114,66,42,24,48,0,48,80,0.0,0.0
1014,1964,26-09-2019 05:06:00,0,2770.0,2548.0,0.92,13.736,286,144,107,37,142,85,57,85,0.0,0.04
1014,1965,26-09-2019 05:08:00,0,2678.0,2446.0,0.913,13.259,111,55,40,15,56,26,30,110,0.0,0.01
1014,1966,26-09-2019 05:10:00,0,3206.0,3148.0,0.982,16.116,264,143,109,34,121,86,35,67,0.01,0.02
1014,1967,26-09-2019 05:12:00,0,2922.0,2847.0,0.974,14.663,394,198,156,42,196,153,43,64,0.03,0.0
1014,1968,26-09-2019 05:14:00,0,2935.0,2820.0,0.961,14.6855,246,136,96,40,110,73,37,16,0.01,0.0
1014,1969,26-09-2019 05:16:00,0,2948.0,2793.0,0.948,14.708,298,137,110,27,161,104,57,31,0.0,0.0
1014,1970,26-09-2019 05:18:00,0,2955.0,2730.0,0.924,14.664,106,57,38,19,49,2,47,56,0.0,0.0
1014,1971,26-09-2019 05:20:00,0,2948.0,2734.0,0.927,14.642,213,106,75,31,107,39,68,61,0.04,0.01
1014,1972,26-09-2019 05:22:00,0,2467.0,2347.0,0.951,12.319,51,35,14,21,16,2,14,2,0.01,0.03
1014,1973,26-09-2019 05:24:00,0,2175.0,2120.0,0.975,10.915,34,33,9,24,1,1,0,0,0.01,0.0
1014,1974,26-09-2019 05:26:00,0,2689.0,2408.0,0.896,13.259,31,31,3,28,0,0,0,0,0.0,0.0
1014,1975,26-09-2019 05:28:00,0,2689.0,2392.0,0.89,13.242,73,58,31,27,15,1,14,1,0.0,0.0
1014,1976,26-09-2019 05:30:00,0,2775.0,2500.0,0.901,13.702,37,4,1,3,33,0,33,0,0.01,0.0
1014,1977,26-09-2019 05:32:00,0,2781.0,2528.0,0.909,13.755,0,0,0,0,0,0,0,0,0.0,0.0
1014,1978,26-09-2019 05:34:00,0,2783.0,2495.0,0.896,13.728,0,0,0,0,0,0,0,0,0.0,0.0
1014,1979,26-09-2019 05:36:00,0,2790.0,2452.0,0.879,13.708,1,1,1,0,0,0,0,0,0.0,0.0
1014,1980,26-09-2019 05:38:00,0,2480.0,2296.0,0.926,12.311,0,0,0,0,0,0,0,0,0.0,0.0
1014,1981,26-09-2019 05:40:00,0,2257.0,2166.0,0.96,11.291,2,0,0,0,2,0,2,0,0.0,0.0
1014,1982,26-09-2019 05:42:00,0,2176.0,2096.0,0.963,10.893,6,0,0,0,6,0,6,0,0.01,0.0
1014,1983,26-09-2019 05:44:00,0,2196.0,1993.0,0.907,10.859,6,6,1,5,0,0,0,0,0.0,0.0
1014,1984,26-09-2019 05:46:00,0,1989.0,1907.0,0.959,9.949,28,25,13,12,3,3,0,0,0.0,0.0
1014,1985,26-09-2019 05:48:00,0,2086.0,1989.0,0.954,10.422,2,2,0,2,0,0,0,0,0.0,0.0
1014,1986,26-09-2019 05:50:00,0,2183.0,2071.0,0.949,10.895,7,0,0,0,7,1,6,0,0.0,0.0
1014,1987,26-09-2019 05:52:00,0,2191.0,2046.0,0.934,10.897,11,0,0,0,11,0,11,0,0.0,0.0
1014,1988,26-09-2019 05:54:00,0,2082.0,1945.0,0.934,10.357,10,0,0,0,10,0,10,0,0.0,0.0
1014,1989,26-09-2019 05:56:00,0,1998.0,1873.0,0.937,9.944,10,2,1,1,8,0,8,0,0.0,0.0
1014,1990,26-09-2019 05:58:00,0,2006.0,1824.0,0.909,9.925,1,0,0,0,1,1,0,0,0.0,0.0
1014,1991,26-09-2019 06:00:00,1,2009.0,1820.0,0.906,9.93,132,86,59,27,46,32,14,14,0.0,0.0
1014,1992,26-09-2019 06:02:00,1,2205.0,1995.0,0.905,10.895,85,37,18,19,48,2,46,58,0.0,0.02
1014,1993,26-09-2019 06:04:00,1,2484.0,2273.0,0.915,12.303,127,42,28,14,85,0,85,60,0.0,0.0
1014,1994,26-09-2019 06:06:00,1,2700.0,2365.0,0.876,13.258,167,85,58,27,82,38,44,122,0.0,0.08
1014,1995,26-09-2019 06:08:00,1,2709.0,2345.0,0.866,13.27,79,65,45,20,14,5,9,53,0.0,0.03
1014,1996,26-09-2019 06:10:00,1,2772.0,2511.0,0.906,13.701,186,99,80,19,87,69,18,165,0.0,0.0
1014,1997,26-09-2019 06:12:00,1,2964.0,2713.0,0.915,14.682,207,129,95,34,78,46,32,115,0.0,0.0
1014,1998,26-09-2019 06:14:00,1,2950.0,2720.0,0.922,14.633,281,139,108,31,142,96,46,49,0.0,0.08
1014,1999,26-09-2019 06:16:00,1,2207.0,1998.0,0.906,10.907,261,107,70,37,154,94,60,25,0.0,0.0
1014,2000,26-09-2019 06:18:00,1,3142.0,2894.0,0.921,15.585,165,76,64,12,89,64,25,13,0.12,0.0
1014,2001,26-09-2019 06:20:00,1,2941.0,2794.0,0.95,14.679,276,190,142,48,86,49,37,6,0.01,0.0
1014,2002,26-09-2019 06:22:00,1,2932.0,2811.5,0.959,14.6635,144,82,51,31,62,20,42,51,0.0,0.0
1014,2003,26-09-2019 06:24:00,1,2923.0,2829.0,0.968,14.648,224,90,66,24,134,78,56,44,0.09,0.0
1014,2004,26-09-2019 06:26:00,1,2581.0,2351.0,0.911,12.772,318,163,119,44,155,119,36,68,0.01,0.0
1014,2005,26-09-2019 06:28:00,1,2288.0,2113.0,0.924,11.354,49,34,16,18,15,7,8,5,0.0,0.0
1014,2006,26-09-2019 06:30:00,1,2971.0,2686.0,0.904,14.68,105,78,45,33,27,13,14,8,0.01,0.0
1014,2007,26-09-2019 06:32:00,1,2972.0,2641.0,0.889,14.633,156,123,83,40,33,15,18,0,0.0,0.0
1014,2008,26-09-2019 06:34:00,1,2942.0,2787.0,0.947,14.677,278,216,156,60,62,26,36,3,0.0,0.0
1014,2009,26-09-2019 06:36:00,1,2941.0,2784.0,0.947,14.669,271,197,146,51,74,39,35,10,0.0,0.13
1014,2010,26-09-2019 06:38:00,1,2965.0,2705.0,0.912,14.675,112,39,23,16,73,1,72,62,0.0,0.0
1014,2011,26-09-2019 06:40:00,1,2964.0,2729.0,0.921,14.699,108,34,19,15,74,0,74,64,0.0,0.0
1014,2012,26-09-2019 06:42:00,1,2580.0,2364.0,0.916,12.783,55,36,22,14,19,4,15,5,0.0,0.0
1014,2013,26-09-2019 06:44:00,1,2180.0,2007.0,0.92,10.812,15,11,2,9,4,0,4,0,0.0,0.0
1014,2014,26-09-2019 06:46:00,1,2405.0,2128.0,0.885,11.831,21,19,2,17,2,2,0,0,0.0,0.0
1014,2015,26-09-2019 06:48:00,1,2770.0,2498.0,0.902,13.681,47,29,8,21,18,3,15,4,0.0,0.0
1014,2016,26-09-2019 06:50:00,1,2993.0,2638.0,0.882,14.712,1,1,0,1,0,0,0,0,0.0,0.0
1014,2017,26-09-2019 06:52:00,1,2761.0,2562.0,0.928,13.713,0,0,0,0,0,0,0,0,0.04,0.0
1014,2018,26-09-2019 06:54:00,1,2801.0,2449.0,0.874,13.748,0,0,0,0,0,0,0,0,0.0,0.0
1014,2019,26-09-2019 06:56:00,1,2645.0,2355.5,0.8915,13.0295,5,3,1,2,2,0,2,0,0.0,0.0
1014,2020,26-09-2019 06:58:00,1,2489.0,2262.0,0.909,12.311,35,22,12,10,13,3,10,0,0.0,0.0
1014,2021,26-09-2019 07:00:00,1,2489.0,2282.0,0.917,12.331,0,0,0,0,0,0,0,0,0.0,0.0
1014,2022,26-09-2019 07:02:00,1,2380.0,2182.0,0.917,11.792,0,0,0,0,0,0,0,0,0.0,0.0
1014,2023,26-09-2019 07:04:00,1,2177.0,2096.0,0.963,10.897,0,0,0,0,0,0,0,0,0.0,0.0
1014,2024,26-09-2019 07:06:00,1,2194.0,2022.0,0.922,10.882,9,1,0,1,8,1,7,0,0.0,0.0
1014,2025,26-09-2019 07:08:00,1,2092.0,1953.0,0.934,10.406,2,1,1,0,1,0,1,0,0.0,0.0
1014,2026,26-09-2019 07:10:00,1,2101.0,1939.0,0.923,10.425,2,0,0,0,2,0,2,0,0.0,0.0
1014,2027,26-09-2019 07:12:00,1,1991.0,1901.0,0.955,9.95,0,0,0,0,0,0,0,0,0.0,0.0
1014,2028,26-09-2019 07:14:00,1,2021.0,1824.0,0.902,9.984,0,0,0,0,0,0,0,0,0.0,0.0
1014,2029,26-09-2019 07:16:00,1,2014.0,1789.0,0.888,9.917,24,18,5,13,6,0,6,0,0.0,0.0
1014,2030,26-09-2019 07:18:00,1,1991.0,1908.0,0.958,9.955,14,12,1,11,2,1,1,0,0.0,0.0
1014,2031,26-09-2019 07:20:00,1,1996.0,1860.0,0.932,9.925,12,12,0,12,0,0,0,0,0.0,0.0
1014,2032,26-09-2019 07:22:00,1,2013.0,1792.0,0.89,9.917,1,1,0,1,0,0,0,0,0.0,0.0
1014,2033,26-09-2019 07:24:00,1,2026.0,1745.0,0.861,9.915,0,0,0,0,0,0,0,0,0.0,0.0
1014,2034,26-09-2019 07:26:00,1,1921.0,1678.0,0.874,9.427,6,5,1,4,1,0,1,0,0.0,0.0
1014,2035,26-09-2019 07:28:00,1,1813.0,1674.0,0.923,8.994,4,4,2,2,0,0,0,0,0.0,0.0
1014,2036,26-09-2019 07:30:00,1,1867.0,1680.5,0.9005,9.2145,6,3,0,3,3,0,3,0,0.0,0.0
1014,2037,26-09-2019 07:32:00,1,1921.0,1687.0,0.878,9.435,2,1,0,1,1,0,1,0,0.0,0.0
1014,2038,26-09-2019 07:34:00,1,2029.0,1714.0,0.845,9.894,0,0,0,0,0,0,0,0,0.01,0.0
1014,2039,26-09-2019 07:36:00,1,1931.0,1681.0,0.87,9.468,0,0,0,0,0,0,0,0,0.0,0.0
1014,2040,26-09-2019 07:38:00,1,1706.0,1632.0,0.957,8.527,17,12,6,6,5,1,4,0,0.0,0.0
1014,2041,26-09-2019 07:40:00,1,1765.0,1404.0,0.796,8.51,0,0,0,0,0,0,0,0,0.0,0.0
1014,2042,26-09-2019 07:42:00,1,1725.0,1532.0,0.888,8.495,0,0,0,0,0,0,0,0,0.0,0.0
1014,2043,26-09-2019 07:44:00,1,2007.0,1844.0,0.919,9.95,48,48,21,27,0,0,0,0,0.0,0.0
1014,2044,26-09-2019 07:46:00,1,2180.0,2062.0,0.946,10.872,73,49,19,30,24,6,18,3,0.0,0.0
1014,2045,26-09-2019 07:48:00,1,2289.0,2098.0,0.917,11.339,31,21,3,18,10,4,6,9,0.0,0.0
1014,2046,26-09-2019 07:50:00,1,2511.0,2194.0,0.874,12.322,48,30,8,22,18,5,13,6,0.0,0.0
1014,2047,26-09-2019 07:52:00,1,2501.0,2239.0,0.895,12.334,47,24,17,7,23,0,23,0,0.0,0.0
1014,2048,26-09-2019 07:54:00,1,2479.0,2241.0,0.904,12.25,111,79,48,31,32,17,15,8,0.0,0.0
1014,2049,26-09-2019 07:56:00,1,2501.0,2221.0,0.888,12.313,127,45,21,24,82,0,82,71,0.0,0.0
1014,2050,26-09-2019 07:58:00,1,2714.0,2295.0,0.846,13.234,250,117,90,27,133,51,82,79,0.0,0.0
1014,2051,26-09-2019 08:00:00,1,2488.0,2278.0,0.916,12.325,277,148,105,43,129,96,33,27,0.0,0.0
1014,2052,26-09-2019 08:02:00,1,2495.0,2245.0,0.9,12.317,519,204,147,57,315,221,94,47,0.0,0.0
1014,2053,26-09-2019 08:04:00,1,2735.0,2456.5,0.8985,13.497,172,96,85,11,76,61,15,184,0.0,0.0
1014,2054,26-09-2019 08:06:00,1,2975.0,2668.0,0.897,14.677,223,114,88,26,109,54,55,129,0.0,0.09
1014,2055,26-09-2019 08:08:00,1,3018.0,2560.0,0.848,14.726,125,64,41,23,61,12,49,71,0.0,0.02
1014,2056,26-09-2019 08:10:00,1,2891.0,2524.0,0.873,14.185,89,34,26,8,55,0,55,59,0.0,0.0
1014,2057,26-09-2019 08:12:00,1,2998.0,2642.0,0.881,14.738,155,83,55,28,72,17,55,58,0.0,0.0
1014,2058,26-09-2019 08:14:00,1,2472.0,2264.0,0.916,12.248,102,58,38,20,44,26,18,1,0.08,0.0
1014,2059,26-09-2019 08:16:00,1,2005.0,1823.0,0.909,9.917,340,221,167,54,119,81,38,1,0.0,0.0
1014,2060,26-09-2019 08:18:00,1,2876.0,2541.0,0.883,14.145,333,177,138,39,156,113,43,13,0.0,0.15
1014,2061,26-09-2019 08:20:00,1,2775.0,2485.0,0.896,13.685,240,156,114,42,84,50,34,7,0.0,0.0
1014,2062,26-09-2019 08:22:00,1,3055.0,2784.0,0.911,15.121,141,43,18,25,98,60,38,9,0.01,0.0
1014,2063,26-09-2019 08:24:00,1,2595.0,2322.0,0.895,12.795,277,174,119,55,103,72,31,0,0.0,0.0
1014,2064,26-09-2019 08:26:00,1,2587.0,2312.0,0.894,12.751,593,380,293,87,213,144,69,7,0.0,0.0
1014,2065,26-09-2019 08:28:00,1,2700.0,2364.0,0.876,13.256,319,176,131,45,143,106,37,38,0.0,0.0
1014,2066,26-09-2019 08:30:00,1,2787.0,2474.0,0.888,13.718,194,122,88,34,72,34,38,99,0.0,0.0
1014,2067,26-09-2019 08:32:00,1,2515.0,2167.0,0.861,12.31,212,130,87,43,82,52,30,0,0.0,0.0
1014,2068,26-09-2019 08:34:00,1,2599.0,2293.0,0.882,12.777,326,223,165,58,103,61,42,4,0.0,0.0
1014,2069,26-09-2019 08:36:00,1,2703.0,2333.0,0.863,13.233,333,217,167,50,116,77,39,4,0.0,0.0
1014,2070,26-09-2019 08:38:00,1,2704.0,2330.0,0.8615,13.234,489,271,204,67,218,166,52,37,0.0,0.0
1014,2071,26-09-2019 08:40:00,1,2705.0,2327.0,0.86,13.235,75,62,29,33,13,3,10,15,0.0,0.0
1014,2072,26-09-2019 08:42:00,1,2823.0,2360.0,0.836,13.736,43,31,12,19,12,0,12,0,0.01,0.0
1014,2073,26-09-2019 08:44:00,1,2490.0,2211.0,0.888,12.257,0,0,0,0,0,0,0,0,0.0,0.0
1014,2074,26-09-2019 08:46:00,1,2408.0,2087.0,0.867,11.797,0,0,0,0,0,0,0,0,0.0,0.0
1014,2075,26-09-2019 08:48:00,1,2216.0,1970.0,0.889,10.911,0,0,0,0,0,0,0,0,0.0,0.0
1014,2076,26-09-2019 08:50:00,1,2123.0,1857.0,0.875,10.42,10,7,5,2,3,0,3,0,0.0,0.0
1014,2077,26-09-2019 08:52:00,1,2023.0,1774.0,0.877,9.935,0,0,0,0,0,0,0,0,0.0,0.0
1014,2078,26-09-2019 08:54:00,1,2045.0,1668.0,0.816,9.903,29,17,6,11,12,2,10,0,0.0,0.0
1014,2079,26-09-2019 08:56:00,1,2047.0,1682.0,0.822,9.927,1,0,0,0,1,0,1,0,0.0,0.0
1014,2080,26-09-2019 08:58:00,1,2039.0,1685.0,0.827,9.897,3,1,0,1,2,0,2,0,0.0,0.0
1014,2081,26-09-2019 09:00:00,1,2046.0,1703.0,0.832,9.948,4,0,0,0,4,0,4,0,0.0,0.0
1014,2082,26-09-2019 09:02:00,1,2047.0,1694.0,0.828,9.939,1,0,0,0,1,1,0,0,0.0,0.0
1014,2083,26-09-2019 09:04:00,1,2044.0,1689.0,0.826,9.925,2,0,0,0,2,1,1,0,0.02,0.0
1014,2084,26-09-2019 09:06:00,1,2071.0,1585.0,0.766,9.914,12,10,6,4,2,0,2,0,0.0,0.0
1014,2085,26-09-2019 09:08:00,1,2072.0,1596.0,0.77,9.932,0,0,0,0,0,0,0,0,0.0,0.0
1014,2086,26-09-2019 09:10:00,1,1761.0,1406.0,0.798,8.496,1,0,0,0,1,0,1,0,0.0,0.0
1014,2087,26-09-2019 09:12:00,1,2002.0,1606.0,0.8015,9.6665,0,0,0,0,0,0,0,0,0.0,0.0
1014,2088,26-09-2019 09:14:00,1,2243.0,1806.0,0.805,10.837,7,1,1,0,6,0,6,0,0.0,0.0
1014,2089,26-09-2019 09:16:00,1,2249.0,1820.0,0.809,10.875,6,0,0,0,6,0,6,0,0.0,0.0
1014,2090,26-09-2019 09:18:00,1,2266.0,1737.0,0.767,10.852,15,14,2,12,1,0,1,0,0.0,0.0
1014,2091,26-09-2019 09:20:00,1,2057.0,1658.0,0.806,9.941,17,13,7,6,4,0,4,0,0.0,0.0
1014,2092,26-09-2019 09:22:00,1,2056.0,1654.0,0.805,9.93,0,0,0,0,0,0,0,0,0.0,0.0
1014,2093,26-09-2019 09:24:00,1,2058.0,1631.0,0.793,9.913,9,6,3,3,3,0,3,0,0.0,0.0
1014,2094,26-09-2019 09:26:00,1,2052.0,1624.0,0.791,9.885,82,54,30,24,28,6,22,0,0.0,0.0
1014,2095,26-09-2019 09:28:00,1,2062.0,1644.0,0.797,9.945,48,34,2,32,14,0,14,2,0.0,0.0
1014,2096,26-09-2019 09:30:00,1,2037.0,1678.0,0.824,9.884,77,58,26,32,19,2,17,1,0.0,0.0
1014,2097,26-09-2019 09:32:00,1,2231.0,1878.0,0.842,10.869,64,50,22,28,14,2,12,0,0.0,0.0
1014,2098,26-09-2019 09:34:00,1,2233.0,1879.0,0.842,10.877,13,13,5,8,0,0,0,0,0.0,0.0
1014,2099,26-09-2019 09:36:00,1,2033.0,1765.0,0.868,9.963,6,6,3,3,0,0,0,0,0.0,0.0
1014,2100,26-09-2019 09:38:00,1,2047.0,1678.0,0.82,9.923,3,3,0,3,0,0,0,0,0.0,0.0
1014,2101,26-09-2019 09:40:00,1,2070.0,1610.0,0.778,9.937,4,4,2,2,0,0,0,0,0.0,0.0
1014,2102,26-09-2019 09:42:00,1,2061.0,1590.0,0.771,9.88,4,4,2,2,0,0,0,0,0.0,0.0
1014,2103,26-09-2019 09:44:00,1,2058.0,1611.0,0.783,9.894,1,1,0,1,0,0,0,0,0.0,0.0
1014,2104,26-09-2019 09:46:00,1,2175.5,1637.5,0.754,10.386,0,0,0,0,0,0,0,0,0.0,0.0
1014,2105,26-09-2019 09:48:00,1,2293.0,1664.0,0.725,10.878,0,0,0,0,0,0,0,0,0.0,0.0
1014,2106,26-09-2019 09:50:00,1,2401.0,1658.0,0.691,11.297,2,1,1,0,1,0,1,0,0.0,0.0
1014,2107,26-09-2019 09:52:00,1,2195.0,1568.0,0.714,10.385,2,2,1,1,0,0,0,0,0.0,0.0
1014,2108,26-09-2019 09:54:00,1,2197.0,1586.0,0.722,10.414,6,2,1,1,4,0,4,0,0.0,0.0
1014,2109,26-09-2019 09:56:00,1,2109.0,1431.0,0.678,9.896,3,3,0,3,0,0,0,0,0.0,0.0
1014,2110,26-09-2019 09:58:00,1,2182.0,1631.0,0.747,10.403,3,2,1,1,1,0,1,0,0.0,0.0
1014,2111,26-09-2019 10:00:00,1,2383.0,1703.0,0.715,11.276,5,5,0,5,0,0,0,0,0.0,0.0
1014,2112,26-09-2019 10:02:00,1,2415.0,1677.0,0.694,11.372,29,22,12,10,7,0,7,0,0.0,0.0
1014,2113,26-09-2019 10:04:00,1,2181.0,1614.0,0.74,10.382,8,6,4,2,2,0,2,0,0.0,0.0
1014,2114,26-09-2019 10:06:00,1,2204.0,1547.0,0.702,10.398,0,0,0,0,0,0,0,0,0.0,0.0
1014,2115,26-09-2019 10:08:00,1,2208.0,1521.0,0.689,10.386,0,0,0,0,0,0,0,0,0.0,0.0
1014,2116,26-09-2019 10:10:00,1,2098.0,1492.0,0.711,9.919,9,7,3,4,2,0,2,0,0.0,0.0
1014,2117,26-09-2019 10:12:00,1,2212.0,1523.0,0.689,10.401,0,0,0,0,0,0,0,0,0.0,0.0
1014,2118,26-09-2019 10:14:00,1,2210.0,1532.0,0.693,10.405,2,2,1,1,0,0,0,0,0.0,0.0
1014,2119,26-09-2019 10:16:00,1,2216.0,1510.0,0.681,10.403,17,10,3,7,7,0,7,0,0.0,0.0
1014,2120,26-09-2019 10:18:00,1,2221.0,1494.0,0.673,10.403,10,7,3,4,3,0,3,0,0.0,0.0
1014,2121,26-09-2019 10:20:00,1,2159.5,1486.5,0.689,10.1545,0,0,0,0,0,0,0,0,0.0,0.0
1014,2122,26-09-2019 10:22:00,1,2098.0,1479.0,0.705,9.906,8,4,3,1,4,2,2,0,0.0,0.0
1014,2123,26-09-2019 10:24:00,1,2218.0,1503.0,0.677,10.405,7,2,1,1,5,0,5,0,0.0,0.0
1014,2124,26-09-2019 10:26:00,1,2210.0,1495.0,0.676,10.363,1,0,0,0,1,0,1,0,0.0,0.0
1014,2125,26-09-2019 10:28:00,1,2210.0,1517.0,0.687,10.387,8,7,1,6,1,0,1,0,0.0,0.0
1014,2126,26-09-2019 10:30:00,1,2208.0,1532.0,0.694,10.395,7,6,0,6,1,0,1,0,0.0,0.0
1014,2127,26-09-2019 10:32:00,1,2192.0,1550.0,0.707,10.351,10,7,3,4,3,0,3,0,0.0,0.0
1014,2128,26-09-2019 10:34:00,1,2199.0,1558.0,0.708,10.39,6,3,2,1,3,0,3,0,0.0,0.0
1014,2129,26-09-2019 10:36:00,1,2202.0,1532.0,0.696,10.375,17,13,2,11,4,0,4,0,0.0,0.0
1014,2130,26-09-2019 10:38:00,1,2205.0,1535.0,0.696,10.389,11,3,0,3,8,0,8,0,0.0,0.0
1014,2131,26-09-2019 10:40:00,1,2099.0,1503.0,0.716,9.935,9,7,0,7,2,0,2,0,0.0,0.0
1014,2132,26-09-2019 10:42:00,1,2113.0,1473.0,0.697,9.957,5,4,0,4,1,0,1,0,0.0,0.0
1014,2133,26-09-2019 10:44:00,1,1989.0,1455.0,0.731,9.448,30,5,2,3,25,0,25,0,0.0,0.0
1014,2134,26-09-2019 10:46:00,1,2196.0,1548.0,0.705,10.366,57,32,9,23,25,2,23,3,0.0,0.0
1014,2135,26-09-2019 10:48:00,1,2161.0,1673.0,0.774,10.367,82,59,30,29,23,6,17,6,0.0,0.0
1014,2136,26-09-2019 10:50:00,1,2399.0,1751.0,0.73,11.393,57,39,14,25,18,4,14,5,0.0,0.0
1014,2137,26-09-2019 10:52:00,1,2365.0,1806.0,0.764,11.319,22,16,3,13,6,0,6,0,0.0,0.0
1014,2138,26-09-2019 10:54:00,1,2411.5,1866.0,0.774,11.567,42,28,8,20,14,0,14,1,0.0,0.0
1014,2139,26-09-2019 10:56:00,1,2458.0,1926.0,0.784,11.815,97,71,40,31,26,1,25,16,0.0,0.0
1014,2140,26-09-2019 10:58:00,1,2665.0,2050.0,0.769,12.77,126,55,34,21,71,0,71,66,0.0,0.0
1014,2141,26-09-2019 11:00:00,1,2890.0,2107.0,0.729,13.72,284,153,125,28,131,102,29,130,0.0,0.0
1014,2142,26-09-2019 11:02:00,1,2875.0,2111.0,0.734,13.664,198,130,107,23,68,45,23,43,0.0,0.0
1014,2143,26-09-2019 11:04:00,1,2639.0,2038.0,0.772,12.655,389,261,207,54,128,83,45,26,0.0,0.0
1014,2144,26-09-2019 11:06:00,1,2678.0,1987.0,0.742,12.749,574,286,210,76,288,213,75,6,0.0,0.0
1014,2145,26-09-2019 11:08:00,1,2882.0,2125.0,0.737,13.711,299,215,164,51,84,52,32,29,0.0,0.0
1014,2146,26-09-2019 11:10:00,1,2574.0,1948.0,0.757,12.3,80,56,41,15,24,10,14,14,0.0,0.02
1014,2147,26-09-2019 11:12:00,1,2555.0,1941.0,0.76,12.218,213,145,100,45,68,39,29,2,0.0,0.0
1014,2148,26-09-2019 11:14:00,1,2340.0,1869.0,0.799,11.287,296,187,134,53,109,72,37,1,0.0,0.0
1014,2149,26-09-2019 11:16:00,1,2454.0,1933.0,0.788,11.81,176,122,84,38,54,28,26,0,0.0,0.0
1014,2150,26-09-2019 11:18:00,1,2678.0,1996.0,0.746,12.76,404,311,226,85,93,56,37,9,0.0,0.0
1014,2151,26-09-2019 11:20:00,1,2669.0,2002.0,0.75,12.733,91,61,34,27,30,19,11,0,0.0,0.0
1014,2152,26-09-2019 11:22:00,1,2673.0,2019.0,0.755,12.769,3,3,0,3,0,0,0,0,0.0,0.0
1014,2153,26-09-2019 11:24:00,1,2427.0,1982.0,0.817,11.757,28,22,6,16,6,0,6,0,0.0,0.0
1014,2154,26-09-2019 11:26:00,1,2329.0,1949.0,0.837,11.335,4,4,1,3,0,0,0,0,0.0,0.0
1014,2155,26-09-2019 11:28:00,1,2230.5,1852.0,0.83,10.8395,3,3,0,3,0,0,0,0,0.0,0.0
1014,2156,26-09-2019 11:30:00,1,2132.0,1755.0,0.823,10.344,3,3,2,1,0,0,0,0,0.0,0.0
1014,2157,26-09-2019 11:32:00,1,2163.0,1693.0,0.782,10.398,16,16,2,14,0,0,0,0,0.0,0.0
1014,2158,26-09-2019 11:34:00,1,2178.0,1622.0,0.745,10.376,9,9,0,9,0,0,0,0,0.0,0.0
1014,2159,26-09-2019 11:36:00,1,1959.0,1569.0,0.801,9.455,6,6,2,4,0,0,0,0,0.0,0.0
1014,2160,26-09-2019 11:38:00,1,1960.0,1545.0,0.788,9.435,13,13,6,7,0,0,0,0,0.0,0.0
1014,2161,26-09-2019 11:40:00,1,1966.0,1567.0,0.797,9.482,0,0,0,0,0,0,0,0,0.0,0.0
1014,2162,26-09-2019 11:42:00,1,2066.0,1579.0,0.764,9.888,0,0,0,0,0,0,0,0,0.0,0.0
1014,2163,26-09-2019 11:44:00,1,2081.0,1575.0,0.757,9.942,40,31,16,15,9,4,5,0,0.0,0.0
1014,2164,26-09-2019 11:46:00,1,2185.0,1650.0,0.755,10.438,0,0,0,0,0,0,0,0,0.0,0.0
1014,2165,26-09-2019 11:48:00,1,2174.0,1636.0,0.752,10.378,1,1,0,1,0,0,0,0,0.01,0.0
1014,2166,26-09-2019 11:50:00,1,2177.0,1617.0,0.743,10.369,14,0,0,0,14,1,13,0,0.0,0.0
1014,2167,26-09-2019 11:52:00,1,2184.0,1641.0,0.751,10.423,6,0,0,0,6,0,6,0,0.0,0.0
1014,2168,26-09-2019 11:54:00,1,1963.0,1557.0,0.793,9.458,2,1,0,1,1,0,1,0,0.0,0.0
1014,2169,26-09-2019 11:56:00,1,1856.0,1513.0,0.815,8.987,2,1,0,1,1,0,1,0,0.0,0.0
1014,2170,26-09-2019 11:58:00,1,1976.0,1520.0,0.769,9.47,4,1,0,1,3,0,3,0,0.0,0.0
1014,2171,26-09-2019 12:00:00,1,1964.0,1531.0,0.78,9.431,5,1,0,1,4,0,4,0,0.0,0.0
1014,2172,26-09-2019 12:02:00,1,1913.0,1494.5,0.7815,9.191,4,1,0,1,3,0,3,0,0.0,0.0
1014,2173,26-09-2019 12:04:00,1,1862.0,1458.0,0.783,8.951,2,0,0,0,2,0,2,0,0.0,0.0
1014,2174,26-09-2019 12:06:00,1,2197.0,1573.0,0.716,10.396,10,5,3,2,5,0,5,0,0.0,0.0
1014,2175,26-09-2019 12:08:00,1,2180.0,1603.0,0.735,10.364,0,0,0,0,0,0,0,0,0.0,0.0
1014,2176,26-09-2019 12:10:00,1,2070.0,1573.0,0.76,9.899,5,3,1,2,2,0,2,0,0.0,0.0
1014,2177,26-09-2019 12:12:00,1,2082.0,1562.0,0.75,9.932,0,0,0,0,0,0,0,0,0.0,0.0
1014,2178,26-09-2019 12:14:00,1,2079.0,1535.0,0.738,9.893,21,10,3,7,11,0,11,0,0.0,0.0
1014,2179,26-09-2019 12:16:00,1,2169.0,1628.0,0.751,10.35,31,2,1,1,29,1,28,0,0.0,0.0
1014,2180,26-09-2019 12:18:00,1,2168.0,1647.0,0.759,10.367,9,7,5,2,2,1,1,0,0.0,0.0
1014,2181,26-09-2019 12:20:00,1,2166.0,1672.0,0.772,10.385,0,0,0,0,0,0,0,0,0.0,0.0
1014,2182,26-09-2019 12:22:00,1,2170.0,1655.0,0.763,10.38,0,0,0,0,0,0,0,0,0.0,0.0
1014,2183,26-09-2019 12:24:00,1,2178.0,1652.0,0.758,10.412,0,0,0,0,0,0,0,0,0.0,0.0
1014,2184,26-09-2019 12:26:00,1,2180.0,1644.0,0.754,10.408,5,5,3,2,0,0,0,0,0.0,0.0
1014,2185,26-09-2019 12:28:00,1,2184.0,1576.0,0.721,10.35,3,0,0,0,3,0,3,0,0.0,0.0
1014,2186,26-09-2019 12:30:00,1,2090.0,1500.0,0.717,9.897,4,2,1,1,2,0,2,0,0.0,0.0
1014,2187,26-09-2019 12:32:00,1,1868.0,1420.0,0.76,8.931,0,0,0,0,0,0,0,0,0.0,0.0
1014,2188,26-09-2019 12:34:00,1,1895.0,1383.0,0.73,8.998,14,3,2,1,11,0,11,0,0.0,0.0
1014,2189,26-09-2019 12:36:00,1,1882.5,1417.5,0.753,8.9865,4,2,0,2,2,0,2,0,0.0,0.0
1014,2190,26-09-2019 12:38:00,1,1870.0,1452.0,0.776,8.975,7,2,0,2,5,0,5,0,0.0,0.0
1014,2191,26-09-2019 12:40:00,1,1976.0,1484.0,0.751,9.428,15,9,4,5,6,0,6,0,0.0,0.0
1014,2192,26-09-2019 12:42:00,1,2089.0,1523.0,0.729,9.918,0,0,0,0,0,0,0,0,0.0,0.0
1014,2193,26-09-2019 12:44:00,1,2203.0,1568.0,0.712,10.418,0,0,0,0,0,0,0,0,0.0,0.0
1014,2194,26-09-2019 12:46:00,1,2187.0,1586.0,0.725,10.374,0,0,0,0,0,0,0,0,0.0,0.0
1014,2195,26-09-2019 12:48:00,1,2197.0,1564.0,0.712,10.389,29,18,12,6,11,2,9,0,0.0,0.0
1014,2196,26-09-2019 12:50:00,1,2167.0,1680.0,0.775,10.399,24,5,1,4,19,0,19,0,0.0,0.0
1014,2197,26-09-2019 12:52:00,1,2148.0,1722.0,0.802,10.37,18,15,4,11,3,0,3,4,0.0,0.0
1014,2198,26-09-2019 12:54:00,1,2374.0,1838.0,0.774,11.389,39,35,5,30,4,2,2,0,0.0,0.0
1014,2199,26-09-2019 12:56:00,1,2355.0,1847.0,0.784,11.322,50,33,13,20,17,4,13,1,0.0,0.0
1014,2200,26-09-2019 12:58:00,1,2358.0,1896.0,0.804,11.391,48,47,2,45,1,0,1,0,0.0,0.0
1014,2201,26-09-2019 13:00:00,1,2369.0,1808.0,0.763,11.335,38,38,4,34,0,0,0,0,0.0,0.0
1014,2202,26-09-2019 13:02:00,1,2371.0,1811.0,0.764,11.348,85,71,43,28,14,2,12,12,0.0,0.0
1014,2203,26-09-2019 13:04:00,1,2367.0,1843.0,0.779,11.368,64,59,41,18,5,0,5,0,0.0,0.0
1014,2204,26-09-2019 13:06:00,1,2351.0,1892.0,0.805,11.357,50,38,20,18,12,2,10,0,0.0,0.0
1014,2205,26-09-2019 13:08:00,1,2365.0,1816.0,0.768,11.329,2,2,1,1,0,0,0,0,0.0,0.0
1014,2206,26-09-2019 13:10:00,1,2275.0,1725.5,0.758,10.8735,10,8,2,6,2,0,2,0,0.0,0.0
1014,2207,26-09-2019 13:12:00,1,2185.0,1635.0,0.748,10.418,1,1,0,1,0,0,0,0,0.0,0.0
1014,2208,26-09-2019 13:14:00,1,2079.0,1579.0,0.76,9.94,0,0,0,0,0,0,0,0,0.0,0.0
1014,2209,26-09-2019 13:16:00,1,1981.0,1506.0,0.76,9.474,4,4,2,2,0,0,0,0,0.0,0.0
1014,2210,26-09-2019 13:18:00,1,2092.0,1504.0,0.719,9.907,1,1,0,1,0,0,0,0,0.0,0.0
1014,2211,26-09-2019 13:20:00,1,2092.0,1501.0,0.717,9.903,7,4,2,2,3,0,3,0,0.0,0.0
1014,2212,26-09-2019 13:22:00,1,2198.0,1541.0,0.701,10.367,1,0,0,0,1,0,1,0,0.0,0.0
1014,2213,26-09-2019 13:24:00,1,2197.0,1586.0,0.722,10.41,27,17,12,5,10,3,7,0,0.0,0.0
1014,2214,26-09-2019 13:26:00,1,2406.0,1676.0,0.697,11.337,0,0,0,0,0,0,0,0,0.0,0.0
1014,2215,26-09-2019 13:28:00,1,2282.0,1665.0,0.73,10.835,10,10,3,7,0,0,0,0,0.0,0.0
1014,2216,26-09-2019 13:30:00,1,2186.0,1597.0,0.731,10.38,0,0,0,0,0,0,0,0,0.0,0.0
1014,2217,26-09-2019 13:32:00,1,2202.0,1562.0,0.709,10.407,4,1,0,1,3,1,2,0,0.0,0.0
1014,2218,26-09-2019 13:34:00,1,2184.0,1598.0,0.732,10.374,0,0,0,0,0,0,0,0,0.0,0.0
1014,2219,26-09-2019 13:36:00,1,2199.0,1551.0,0.706,10.381,0,0,0,0,0,0,0,0,0.0,0.0
1014,2220,26-09-2019 13:38:00,1,2198.0,1548.0,0.704,10.375,5,0,0,0,5,0,5,6,0.0,0.0
1014,2221,26-09-2019 13:40:00,1,2202.0,1533.0,0.696,10.373,0,0,0,0,0,0,0,2,0.0,0.0
1014,2222,26-09-2019 13:42:00,1,2209.0,1493.0,0.676,10.357,8,3,2,1,5,0,5,0,0.0,0.0
1014,2223,26-09-2019 13:44:00,1,2201.0,1527.5,0.694,10.3635,14,9,5,4,5,2,3,0,0.0,0.0
1014,2224,26-09-2019 13:46:00,1,2193.0,1562.0,0.712,10.37,2,2,0,2,0,0,0,0,0.0,0.0
1014,2225,26-09-2019 13:48:00,1,2196.0,1578.0,0.719,10.4,0,0,0,0,0,0,0,0,0.0,0.0
1014,2226,26-09-2019 13:50:00,1,2196.0,1573.0,0.716,10.394,5,5,2,3,0,0,0,13,0.0,0.0
1014,2227,26-09-2019 13:52:00,1,2193.0,1592.0,0.726,10.402,5,5,1,4,0,0,0,5,0.0,0.0
1014,2228,26-09-2019 13:54:00,1,2210.0,1515.0,0.685,10.386,6,6,1,5,0,0,0,0,0.0,0.0
1014,2229,26-09-2019 13:56:00,1,2209.0,1560.0,0.706,10.432,2,2,1,1,0,0,0,0,0.0,0.0
1014,2230,26-09-2019 13:58:00,1,2094.0,1477.0,0.705,9.887,1,1,0,1,0,0,0,0,0.0,0.0
1014,2231,26-09-2019 14:00:00,1,2214.0,1508.0,0.681,10.393,1,1,0,1,0,0,0,3,0.0,0.0
1014,2232,26-09-2019 14:02:00,1,2088.0,1506.0,0.721,9.893,2,2,0,2,0,0,0,2,0.0,0.0
1014,2233,26-09-2019 14:04:00,1,2210.0,1539.0,0.696,10.413,0,0,0,0,0,0,0,10,0.0,0.0
1014,2234,26-09-2019 14:06:00,1,2091.0,1488.0,0.712,9.885,8,7,5,2,1,0,1,8,0.0,0.0
1014,2235,26-09-2019 14:08:00,1,2104.0,1482.0,0.704,9.932,29,18,4,14,11,2,9,19,0.0,0.0
1014,2236,26-09-2019 14:10:00,1,2096.0,1506.0,0.719,9.926,20,14,7,7,6,1,5,54,0.0,0.0
1014,2237,26-09-2019 14:12:00,1,2095.0,1491.0,0.712,9.907,14,13,3,10,1,0,1,47,0.0,0.0
1014,2238,26-09-2019 14:14:00,1,2096.0,1482.0,0.707,9.898,27,14,3,11,13,1,12,52,0.0,0.0
1014,2239,26-09-2019 14:16:00,1,2177.0,1625.0,0.747,10.377,228,124,97,27,104,72,32,101,0.0,0.0
1014,2240,26-09-2019 14:18:00,1,2420.5,1811.0,0.7485,11.541,152,99,66,33,53,32,21,105,0.0,0.0
1014,2241,26-09-2019 14:20:00,1,2664.0,1997.0,0.75,12.705,175,102,65,37,73,47,26,93,0.0,0.0
1014,2242,26-09-2019 14:22:00,1,2663.0,2038.0,0.765,12.749,116,64,42,22,52,3,49,62,0.0,0.0
1014,2243,26-09-2019 14:24:00,1,2664.0,2031.0,0.762,12.744,62,31,14,17,31,5,26,60,0.0,0.0
1014,2244,26-09-2019 14:26:00,1,2770.0,2117.0,0.764,13.256,149,88,62,26,61,12,49,58,0.0,0.0
1014,2245,26-09-2019 14:28:00,1,2658.0,2082.0,0.783,12.779,102,47,21,26,55,0,55,53,0.0,0.0
1014,2246,26-09-2019 14:30:00,1,2859.0,2182.0,0.763,13.681,95,57,32,25,38,4,34,24,0.0,0.0
1014,2247,26-09-2019 14:32:00,1,1877.0,1410.0,0.751,8.956,53,28,7,21,25,0,25,1,0.0,0.0
1014,2248,26-09-2019 14:34:00,1,1874.0,1414.0,0.754,8.948,58,50,16,34,8,0,8,0,0.0,0.0
1014,2249,26-09-2019 14:36:00,1,2177.0,1645.0,0.756,10.398,45,33,9,24,12,2,10,1,0.0,0.0
1014,2250,26-09-2019 14:38:00,1,2168.0,1643.0,0.758,10.362,2,1,0,1,1,0,1,0,0.0,0.0
1014,2251,26-09-2019 14:40:00,1,2161.0,1679.0,0.777,10.373,28,13,0,13,15,0,15,1,0.0,0.0
1014,2252,26-09-2019 14:42:00,1,2349.0,1853.0,0.789,11.309,59,39,14,25,20,2,18,1,0.0,0.0
1014,2253,26-09-2019 14:44:00,1,2331.0,1935.0,0.83,11.327,11,8,0,8,3,0,3,0,0.0,0.0
1014,2254,26-09-2019 14:46:00,1,2339.0,1919.0,0.821,11.34,16,10,6,4,6,0,6,0,0.0,0.0
1014,2255,26-09-2019 14:48:00,1,2341.0,1899.0,0.811,11.327,0,0,0,0,0,0,0,0,0.0,0.0
1014,2256,26-09-2019 14:50:00,1,2353.0,1846.0,0.785,11.314,5,5,1,4,0,0,0,0,0.0,0.0
1014,2257,26-09-2019 14:52:00,1,2356.5,1849.5,0.785,11.332,0,0,0,0,0,0,0,0,0.0,0.0
1014,2258,26-09-2019 14:54:00,1,2360.0,1853.0,0.785,11.35,11,11,4,7,0,0,0,0,0.0,0.0
1014,2259,26-09-2019 14:56:00,1,2379.0,1759.0,0.739,11.319,0,0,0,0,0,0,0,0,0.0,0.0
1014,2260,26-09-2019 14:58:00,1,2387.0,1731.0,0.725,11.322,6,2,2,0,4,0,4,0,0.0,0.0
1014,2261,26-09-2019 15:00:00,1,2392.0,1750.0,0.732,11.361,5,0,0,0,5,0,5,0,0.0,0.0
1014,2262,26-09-2019 15:02:00,1,2166.0,1681.0,0.776,10.396,7,1,1,0,6,0,6,0,0.0,0.0
1014,2263,26-09-2019 15:04:00,1,2178.0,1653.0,0.759,10.412,0,0,0,0,0,0,0,0,0.0,0.0
1014,2264,26-09-2019 15:06:00,1,2167.0,1672.0,0.772,10.39,0,0,0,0,0,0,0,0,0.0,0.0
1014,2265,26-09-2019 15:08:00,1,2163.0,1657.0,0.766,10.355,36,15,6,9,21,0,21,0,0.0,0.0
1014,2266,26-09-2019 15:10:00,1,2293.0,1674.0,0.73,10.889,5,3,1,2,2,1,1,0,0.0,0.0
1014,2267,26-09-2019 15:12:00,1,2286.0,1679.0,0.734,10.865,0,0,0,0,0,0,0,0,0.0,0.0
1014,2268,26-09-2019 15:14:00,1,2168.0,1671.0,0.771,10.394,7,7,0,7,0,0,0,0,0.0,0.0
1014,2269,26-09-2019 15:16:00,1,2168.0,1659.0,0.765,10.381,2,2,0,2,0,0,0,0,0.0,0.0
1014,2270,26-09-2019 15:18:00,1,2177.0,1645.0,0.756,10.397,1,1,0,1,0,0,0,0,0.0,0.0
1014,2271,26-09-2019 15:20:00,1,2180.0,1640.0,0.752,10.405,0,0,0,0,0,0,0,0,0.0,0.0
1014,2272,26-09-2019 15:22:00,1,2177.0,1631.0,0.749,10.385,0,0,0,0,0,0,0,0,0.0,0.0
1014,2273,26-09-2019 15:24:00,1,2185.0,1604.0,0.734,10.387,0,0,0,0,0,0,0,0,0.0,0.0
1014,2274,26-09-2019 15:26:00,1,2141.0,1557.5,0.727,10.1615,12,6,3,3,6,0,6,0,0.0,0.0
1014,2275,26-09-2019 15:28:00,1,2097.0,1511.0,0.72,9.936,0,0,0,0,0,0,0,1,0.0,0.0
1014,2276,26-09-2019 15:30:00,1,2206.0,1521.0,0.69,10.375,0,0,0,0,0,0,0,9,0.0,0.0
1014,2277,26-09-2019 15:32:00,1,2180.0,1570.0,0.72,10.329,0,0,0,0,0,0,0,0,0.0,0.0
1014,2278,26-09-2019 15:34:00,1,2187.0,1592.0,0.728,10.379,19,10,7,3,9,2,7,3,0.0,0.0
1014,2279,26-09-2019 15:36:00,1,2188.0,1588.0,0.726,10.378,9,3,1,2,6,2,4,2,0.0,0.0
1014,2280,26-09-2019 15:38:00,1,2204.0,1533.0,0.696,10.38,12,5,0,5,7,0,7,0,0.0,0.0
1014,2281,26-09-2019 15:40:00,1,2194.0,1546.0,0.704,10.358,2,2,1,1,0,0,0,29,0.0,0.0
1014,2282,26-09-2019 15:42:00,1,2199.0,1557.0,0.708,10.39,8,3,1,2,5,1,4,46,0.0,0.0
1014,2283,26-09-2019 15:44:00,1,2185.0,1571.0,0.719,10.348,7,0,0,0,7,0,7,46,0.0,0.0
1014,2284,26-09-2019 15:46:00,1,2203.0,1540.0,0.699,10.383,3,0,0,0,3,0,3,35,0.0,0.0
1014,2285,26-09-2019 15:48:00,1,2196.0,1542.0,0.702,10.362,1,0,0,0,1,0,1,26,0.0,0.0
1014,2286,26-09-2019 15:50:00,1,2195.0,1563.0,0.712,10.379,2,0,0,0,2,0,2,23,0.0,0.0
1014,2287,26-09-2019 15:52:00,1,2210.0,1521.0,0.688,10.39,3,0,0,0,3,0,3,39,0.0,0.0
1014,2288,26-09-2019 15:54:00,1,2205.0,1523.0,0.69,10.376,15,11,8,3,4,2,2,24,0.0,0.0
1014,2289,26-09-2019 15:56:00,1,2094.0,1489.0,0.711,9.899,3,2,0,2,1,1,0,37,0.0,0.0
1014,2290,26-09-2019 15:58:00,1,2094.0,1477.0,0.705,9.887,11,6,3,3,5,1,4,39,0.0,0.0
1014,2291,26-09-2019 16:00:00,1,2144.5,1510.0,0.704,10.122,6,6,3,3,0,0,0,42,0.0,0.0
1014,2292,26-09-2019 16:02:00,1,2195.0,1543.0,0.703,10.357,20,12,3,9,8,3,5,42,0.0,0.0
1014,2293,26-09-2019 16:04:00,1,2185.0,1646.0,0.753,10.432,36,32,13,19,4,1,3,46,0.0,0.0
1014,2294,26-09-2019 16:06:00,1,2370.0,1808.0,0.763,11.341,36,30,10,20,6,1,5,42,0.0,0.0
1014,2295,26-09-2019 16:08:00,1,2265.0,1736.0,0.766,10.846,87,72,35,37,15,3,12,45,0.0,0.0
1014,2296,26-09-2019 16:10:00,1,2381.0,1775.0,0.745,11.346,100,81,38,43,19,4,15,48,0.0,0.0
1014,2297,26-09-2019 16:12:00,1,2346.0,1926.0,0.821,11.374,222,112,78,34,110,78,32,73,0.0,0.0
1014,2298,26-09-2019 16:14:00,1,2374.0,1785.0,0.752,11.331,185,100,79,21,85,23,62,51,0.0,0.0
1014,2299,26-09-2019 16:16:00,1,2360.0,1819.0,0.771,11.313,333,180,133,47,153,90,63,72,0.0,0.0
1014,2300,26-09-2019 16:18:00,1,2457.0,1909.0,0.777,11.794,175,74,52,22,101,47,54,67,0.0,0.12
1014,2301,26-09-2019 16:20:00,1,2663.0,2034.0,0.764,12.745,90,55,25,30,35,6,29,83,0.0,0.0
1014,2302,26-09-2019 16:22:00,1,2662.0,2062.0,0.775,12.771,96,46,18,28,50,4,46,59,0.0,0.0
1014,2303,26-09-2019 16:24:00,1,2771.0,2113.0,0.762,13.259,82,38,18,20,44,0,44,52,0.0,0.0
1014,2304,26-09-2019 16:26:00,1,2970.0,2256.0,0.76,14.2,77,29,12,17,48,2,46,50,0.0,0.0
1014,2305,26-09-2019 16:28:00,1,2940.0,2298.0,0.782,14.127,183,73,53,20,110,53,57,37,0.03,0.0
1014,2306,26-09-2019 16:30:00,1,2558.0,2003.0,0.783,12.295,174,76,54,22,98,57,41,78,0.03,0.0
1014,2307,26-09-2019 16:32:00,1,2343.0,1878.0,0.801,11.311,88,57,28,29,31,21,10,22,0.0,0.0
1014,2308,26-09-2019 16:34:00,1,2344.0,1898.5,0.81,11.337,36,32,0,32,4,0,4,0,0.0,0.0
1014,2309,26-09-2019 16:36:00,1,2345.0,1919.0,0.819,11.363,34,24,13,11,10,0,10,0,0.0,0.0
1014,2310,26-09-2019 16:38:00,1,2144.0,1757.0,0.819,10.394,1,0,0,0,1,0,1,0,0.0,0.0
1014,2311,26-09-2019 16:40:00,1,2177.0,1637.0,0.752,10.391,1,1,0,1,0,0,0,2,0.01,0.0
1014,2312,26-09-2019 16:42:00,1,1960.0,1557.0,0.795,9.445,0,0,0,0,0,0,0,0,0.0,0.0
1014,2313,26-09-2019 16:44:00,1,1846.0,1517.0,0.822,8.955,4,4,1,3,0,0,0,0,0.0,0.0
1014,2314,26-09-2019 16:46:00,1,1961.0,1545.0,0.788,9.439,6,6,0,6,0,0,0,0,0.0,0.0
1014,2315,26-09-2019 16:48:00,1,2056.0,1639.0,0.797,9.916,7,7,0,7,0,0,0,0,0.0,0.0
1014,2316,26-09-2019 16:50:00,1,2149.0,1743.0,0.811,10.396,1,1,1,0,0,0,0,12,0.0,0.0
1014,2317,26-09-2019 16:52:00,1,2334.0,1965.0,0.842,11.371,4,4,1,3,0,0,0,5,0.0,0.0
1014,2318,26-09-2019 16:54:00,1,2308.0,2029.0,0.879,11.341,1,1,0,1,0,0,0,0,0.0,0.0
1014,2319,26-09-2019 16:56:00,1,2331.0,1967.0,0.844,11.363,0,0,0,0,0,0,0,0,0.0,0.0
1014,2320,26-09-2019 16:58:00,1,2333.0,1948.0,0.835,11.35,2,2,1,1,0,0,0,0,0.0,0.0
1014,2321,26-09-2019 17:00:00,1,2313.0,1972.0,0.852,11.297,0,0,0,0,0,0,0,3,0.01,0.0
1014,2322,26-09-2019 17:02:00,1,2292.0,2044.0,0.892,11.292,0,0,0,0,0,0,0,0,0.0,0.0
1014,2323,26-09-2019 17:04:00,1,2301.0,2092.0,0.909,11.382,57,35,22,13,22,3,19,8,0.0,0.0
1014,2324,26-09-2019 17:06:00,1,2296.0,2091.0,0.911,11.361,31,19,11,8,12,3,9,0,0.0,0.0
1014,2325,26-09-2019 17:08:00,1,2304.5,2062.0,0.895,11.362,8,8,4,4,0,0,0,2,0.0,0.0
1014,2326,26-09-2019 17:10:00,1,2313.0,2033.0,0.879,11.363,15,15,10,5,0,0,0,0,0.0,0.0
1014,2327,26-09-2019 17:12:00,1,2325.0,1992.0,0.857,11.368,8,8,4,4,0,0,0,2,0.0,0.0
1014,2328,26-09-2019 17:14:00,1,2321.0,1953.0,0.841,11.307,15,15,7,8,0,0,0,0,0.0,0.0
1014,2329,26-09-2019 17:16:00,1,2336.0,1947.0,0.833,11.361,5,5,2,3,0,0,0,1,0.0,0.0
1014,2330,26-09-2019 17:18:00,1,2322.0,1934.0,0.833,11.292,58,40,22,18,18,6,12,0,0.0,0.0
1014,2331,26-09-2019 17:20:00,1,2359.0,1885.0,0.799,11.38,87,67,48,19,20,4,16,27,0.0,0.0
1014,2332,26-09-2019 17:22:00,1,2320.0,1947.0,0.839,11.299,65,54,18,36,11,3,8,46,0.0,0.0
1014,2333,26-09-2019 17:24:00,1,2300.0,2043.0,0.888,11.326,26,21,13,8,5,4,1,40,0.0,0.0
1014,2334,26-09-2019 17:26:00,1,2417.0,2075.0,0.859,11.822,51,45,24,21,6,1,5,47,0.0,0.0
1014,2335,26-09-2019 17:28:00,1,2633.0,2161.0,0.821,12.766,3,3,0,3,0,0,0,32,0.0,0.0
1014,2336,26-09-2019 17:30:00,1,2528.0,2102.0,0.832,12.286,58,30,16,14,28,1,27,25,0.0,0.0
1014,2337,26-09-2019 17:32:00,1,2638.0,2072.0,0.785,12.689,218,144,99,45,74,19,55,77,0.0,0.0
1014,2338,26-09-2019 17:34:00,1,2636.0,2154.0,0.817,12.772,178,109,86,23,69,33,36,75,0.0,0.0
1014,2339,26-09-2019 17:36:00,1,2634.0,2150.0,0.816,12.758,142,84,53,31,58,0,58,70,0.0,0.0
1014,2340,26-09-2019 17:38:00,1,2328.0,1961.0,0.842,11.345,129,83,57,26,46,23,23,36,0.0,0.0
1014,2341,26-09-2019 17:40:00,1,2170.0,1681.0,0.775,10.411,20,7,2,5,13,0,13,27,0.0,0.0
1014,2342,26-09-2019 17:42:00,1,2115.0,1621.5,0.7665,10.129,15,14,0,14,1,0,1,23,0.0,0.0
1014,2343,26-09-2019 17:44:00,1,2060.0,1562.0,0.758,9.847,10,10,0,10,0,0,0,22,0.0,0.0
1014,2344,26-09-2019 17:46:00,1,2075.0,1554.0,0.749,9.898,95,95,70,25,0,0,0,30,0.0,0.0
1014,2345,26-09-2019 17:48:00,1,2180.0,1648.0,0.756,10.413,89,58,30,28,31,1,30,63,0.0,0.0
1014,2346,26-09-2019 17:50:00,1,2648.0,2085.0,0.787,12.741,70,22,15,7,48,0,48,69,0.0,0.0
1014,2347,26-09-2019 17:52:00,1,2944.0,2298.0,0.78,14.143,114,64,43,21,50,0,50,102,0.0,0.01
1014,2348,26-09-2019 17:54:00,1,2928.0,2390.0,0.816,14.183,108,54,34,20,54,11,43,69,0.01,0.06
1014,2349,26-09-2019 17:56:00,1,3029.0,2468.0,0.815,14.668,121,62,43,19,59,0,59,90,0.0,0.0
1014,2350,26-09-2019 17:58:00,1,2913.0,2500.0,0.858,14.245,147,77,58,19,70,11,59,84,0.03,0.06
1014,2351,26-09-2019 18:00:00,0,3111.0,2598.0,0.835,15.133,212,97,62,35,115,57,58,71,0.04,0.03
1014,2352,26-09-2019 18:02:00,0,2914.0,2436.0,0.836,14.179,401,264,214,50,137,97,40,91,0.0,0.0
1014,2353,26-09-2019 18:04:00,0,3099.0,2609.0,0.842,15.101,476,292,225,67,184,128,56,115,0.0,0.0
1014,2354,26-09-2019 18:06:00,0,3088.0,2659.0,0.861,15.112,274,179,132,47,95,66,29,67,0.01,0.0
1014,2355,26-09-2019 18:08:00,0,3006.0,2540.0,0.845,14.654,57,56,18,38,1,0,1,8,0.03,0.0
1014,2356,26-09-2019 18:10:00,0,2827.0,2343.0,0.829,13.73,11,11,3,8,0,0,0,23,0.0,0.0
1014,2357,26-09-2019 18:12:00,0,2303.0,2026.0,0.88,11.317,4,4,3,1,0,0,0,34,0.0,0.0
1014,2358,26-09-2019 18:14:00,0,2325.0,1975.0,0.85,11.347,10,10,2,8,0,0,0,51,0.0,0.0
1014,2359,26-09-2019 18:16:00,0,2325.0,1974.0,0.8495,11.3465,4,4,2,2,0,0,0,29,0.0,0.0
1014,2360,26-09-2019 18:18:00,0,2325.0,1973.0,0.849,11.346,12,12,2,10,0,0,0,10,0.0,0.0
1014,2361,26-09-2019 18:20:00,0,2346.0,1880.0,0.801,11.326,11,8,3,5,3,0,3,22,0.0,0.0
1014,2362,26-09-2019 18:22:00,0,2700.0,2317.0,0.858,13.203,377,274,218,56,103,78,25,31,0.0,0.0
1014,2363,26-09-2019 18:24:00,0,3352.0,3026.0,0.903,16.558,159,95,64,31,64,48,16,30,0.0,0.0
1014,2364,26-09-2019 18:26:00,0,3055.0,2799.0,0.916,15.134,105,102,62,40,3,0,3,1,0.0,0.0
1014,2365,26-09-2019 18:28:00,0,3362.0,2981.0,0.887,16.548,484,260,206,54,224,178,46,85,0.0,0.0
1014,2366,26-09-2019 18:30:00,0,3322.0,3164.0,0.952,16.591,494,255,197,58,239,186,53,74,0.0,0.0
1014,2367,26-09-2019 18:32:00,0,3138.0,2902.0,0.925,15.578,500,246,183,63,254,192,62,56,0.0,0.0
1014,2368,26-09-2019 18:34:00,0,3047.0,2831.0,0.929,15.138,387,252,194,58,135,98,37,175,0.01,0.0
1014,2369,26-09-2019 18:36:00,0,3155.0,2877.0,0.912,15.617,397,243,182,61,154,113,41,104,0.0,0.0
1014,2370,26-09-2019 18:38:00,0,3099.0,2694.0,0.869,15.194,201,101,73,28,100,81,19,25,0.0,0.0
1014,2371,26-09-2019 18:40:00,0,3716.0,3044.0,0.819,18.01,93,42,15,27,51,25,26,0,0.08,0.0
1014,2372,26-09-2019 18:42:00,0,3092.0,2618.0,0.847,15.08,448,264,204,60,184,133,51,30,0.0,0.0
1014,2373,26-09-2019 18:44:00,0,3092.0,2670.0,0.863,15.141,188,127,99,28,61,36,25,78,0.0,0.0
1014,2374,26-09-2019 18:46:00,0,3095.0,2552.0,0.825,15.019,135,50,23,27,85,50,35,1,0.0,0.0
1014,2375,26-09-2019 18:48:00,0,2935.0,2391.0,0.815,14.21,237,123,73,50,114,79,35,4,0.0,0.0
1014,2376,26-09-2019 18:50:00,0,3161.5,2635.0,0.8325,15.373,258,178,140,38,80,62,18,136,0.0,0.0
1014,2377,26-09-2019 18:52:00,0,3388.0,2879.0,0.85,16.536,351,193,159,34,158,123,35,70,0.0,0.0
1014,2378,26-09-2019 18:54:00,0,3114.0,2603.0,0.836,15.151,223,100,67,33,123,89,34,14,0.0,0.0
1014,2379,26-09-2019 18:56:00,0,3597.0,2985.0,0.83,17.476,536,268,198,70,268,205,63,34,0.0,0.0
1014,2380,26-09-2019 18:58:00,0,3017.0,2435.0,0.807,14.582,127,71,37,34,56,23,33,3,0.0,0.0
1014,2381,26-09-2019 19:00:00,0,3308.0,2771.0,0.837,16.103,367,247,185,62,120,79,41,15,0.0,0.0
1014,2382,26-09-2019 19:02:00,0,3205.0,2687.0,0.838,15.602,498,354,283,71,144,96,48,50,0.0,0.0
1014,2383,26-09-2019 19:04:00,0,3093.0,2619.0,0.847,15.084,251,167,126,41,84,54,30,55,0.0,0.0
1014,2384,26-09-2019 19:06:00,0,3134.0,2530.0,0.807,15.149,135,57,25,32,78,45,33,49,0.0,0.0
1014,2385,26-09-2019 19:08:00,0,2948.0,2293.0,0.778,14.155,181,71,39,32,110,67,43,35,0.0,0.0
1014,2386,26-09-2019 19:10:00,0,2931.0,2404.0,0.82,14.211,340,204,143,61,136,88,48,22,0.0,0.0
1014,2387,26-09-2019 19:12:00,0,3207.0,2652.0,0.827,15.57,510,275,211,64,235,170,65,19,0.0,0.0
1014,2388,26-09-2019 19:14:00,0,2740.0,2174.0,0.793,13.202,75,35,15,20,40,16,24,4,0.0,0.0
1014,2389,26-09-2019 19:16:00,0,3049.0,2399.0,0.787,14.669,178,109,70,39,69,37,32,4,0.0,0.0
1014,2390,26-09-2019 19:18:00,0,3046.0,2395.0,0.786,14.653,192,73,41,32,119,76,43,30,0.0,0.0
1014,2391,26-09-2019 19:20:00,0,2929.0,2365.0,0.807,14.159,240,154,109,45,86,45,41,37,0.0,0.0
1014,2392,26-09-2019 19:22:00,0,2859.0,2197.0,0.769,13.698,284,134,94,40,150,96,54,23,0.0,0.0
1014,2393,26-09-2019 19:24:00,0,2997.0,2337.5,0.7795,14.3975,327,174,134,40,153,97,56,66,0.0,0.0
1014,2394,26-09-2019 19:26:00,0,3135.0,2478.0,0.79,15.097,326,148,110,38,178,135,43,154,0.0,0.0
1014,2395,26-09-2019 19:28:00,0,2952.0,2331.0,0.79,14.214,181,110,79,31,71,54,17,47,0.0,0.0
1014,2396,26-09-2019 19:30:00,0,2967.0,2231.0,0.752,14.161,149,73,33,40,76,37,39,0,0.0,0.0
1014,2397,26-09-2019 19:32:00,0,2967.0,2257.0,0.761,14.19,271,150,96,54,121,80,41,27,0.0,0.0
1014,2398,26-09-2019 19:34:00,0,2959.0,2254.0,0.762,14.155,275,159,127,32,116,90,26,121,0.0,0.0
1014,2399,26-09-2019 19:36:00,0,2949.0,2303.0,0.781,14.17,140,70,40,30,70,35,35,10,0.0,0.0
1014,2400,26-09-2019 19:38:00,0,3150.0,2416.0,0.767,15.085,380,259,190,69,121,82,39,27,0.0,0.0
1014,2401,26-09-2019 19:40:00,0,3133.0,2421.0,0.773,15.023,348,273,204,69,75,50,25,38,0.0,0.0
1014,2402,26-09-2019 19:42:00,0,3153.0,2450.0,0.777,15.137,395,270,189,81,125,92,33,41,0.0,0.0
1014,2403,26-09-2019 19:44:00,0,2945.0,2279.0,0.774,14.127,170,123,79,44,47,23,24,14,0.0,0.0
1014,2404,26-09-2019 19:46:00,0,2968.0,2240.0,0.755,14.174,140,113,74,39,27,16,11,69,0.0,0.0
1014,2405,26-09-2019 19:48:00,0,2874.0,2135.0,0.743,13.686,172,122,85,37,50,33,17,32,0.0,0.0
1014,2406,26-09-2019 19:50:00,0,3443.0,2626.0,0.763,16.471,157,60,31,29,97,56,41,10,0.0,0.0
1014,2407,26-09-2019 19:52:00,0,2772.0,2058.0,0.742,13.2,151,64,31,33,87,49,38,16,0.0,0.0
1014,2408,26-09-2019 19:54:00,0,2985.0,2154.0,0.722,14.145,181,121,90,31,60,33,27,66,0.0,0.0
1014,2409,26-09-2019 19:56:00,0,2964.0,2256.0,0.761,14.178,172,43,22,21,129,80,49,4,0.0,0.0
1014,2410,26-09-2019 19:58:00,0,2817.5,2137.5,0.7585,13.4695,234,103,76,27,131,92,39,19,0.0,0.0
1014,2411,26-09-2019 20:00:00,0,2671.0,2019.0,0.756,12.761,260,158,109,49,102,72,30,49,0.0,0.0
1014,2412,26-09-2019 20:02:00,0,3081.0,2285.0,0.742,14.672,241,158,101,57,83,56,27,45,0.0,0.0
1014,2413,26-09-2019 20:04:00,0,2972.0,2170.0,0.73,14.114,270,138,91,47,132,91,41,32,0.0,0.0
1014,2414,26-09-2019 20:06:00,0,3068.0,2289.0,0.746,14.623,416,256,195,61,160,108,52,92,0.0,0.0
1014,2415,26-09-2019 20:08:00,0,3162.0,2392.0,0.757,15.107,484,329,243,86,155,112,43,51,0.0,0.0
1014,2416,26-09-2019 20:10:00,0,3269.0,2469.0,0.755,15.613,229,140,105,35,89,56,33,3,0.0,0.0
1014,2417,26-09-2019 20:12:00,0,3072.0,2292.0,0.746,14.643,450,322,255,67,128,92,36,140,0.0,0.0
1014,2418,26-09-2019 20:14:00,0,3176.0,2366.0,0.745,15.134,313,176,126,50,137,91,46,54,0.0,0.0
1014,2419,26-09-2019 20:16:00,0,3268.0,2438.0,0.746,15.576,86,17,10,7,69,36,33,57,0.0,0.0
1014,2420,26-09-2019 20:18:00,0,2983.0,2224.0,0.746,14.216,164,114,74,40,50,27,23,48,0.0,0.0
1014,2421,26-09-2019 20:20:00,0,2890.0,2071.0,0.717,13.681,203,123,102,21,80,52,28,66,0.0,0.0
1014,2422,26-09-2019 20:22:00,0,3191.0,2274.0,0.713,15.091,132,75,38,37,57,37,20,51,0.0,0.0
1014,2423,26-09-2019 20:24:00,0,2670.0,1986.0,0.744,12.719,110,67,44,23,43,27,16,63,0.0,0.0
1014,2424,26-09-2019 20:26:00,0,2667.0,1983.0,0.744,12.704,219,128,97,31,91,58,33,25,0.0,0.0
1014,2425,26-09-2019 20:28:00,0,2908.0,2059.0,0.708,13.737,311,202,152,50,109,78,31,62,0.0,0.0
1014,2426,26-09-2019 20:30:00,0,3073.0,2230.0,0.726,14.577,214,153,96,57,61,35,26,39,0.0,0.0
1014,2427,26-09-2019 20:32:00,0,3136.5,2235.5,0.713,14.8335,118,85,44,41,33,18,15,38,0.0,0.0
1014,2428,26-09-2019 20:34:00,0,3200.0,2241.0,0.7,15.09,138,75,54,21,63,40,23,40,0.0,0.0
1014,2429,26-09-2019 20:36:00,0,3022.0,2082.0,0.689,14.212,59,48,24,24,11,4,7,32,0.0,0.0
1014,2430,26-09-2019 20:38:00,0,2994.0,2160.0,0.721,14.191,283,188,138,50,95,68,27,82,0.0,0.0
1014,2431,26-09-2019 20:40:00,0,3001.0,2099.0,0.699,14.147,235,120,78,42,115,70,45,9,0.0,0.0
1014,2432,26-09-2019 20:42:00,0,2900.0,2008.0,0.692,13.651,103,50,25,25,53,30,23,0,0.0,0.0
1014,2433,26-09-2019 20:44:00,0,3019.0,2065.0,0.684,14.182,143,54,32,22,89,47,42,27,0.0,0.0
1014,2434,26-09-2019 20:46:00,0,3000.0,2138.0,0.713,14.186,78,17,10,7,61,35,26,2,0.0,0.0
1014,2435,26-09-2019 20:48:00,0,2683.0,2003.0,0.746,12.79,361,228,179,49,133,105,28,62,0.0,0.0
1014,2436,26-09-2019 20:50:00,0,3087.0,2208.0,0.715,14.608,130,53,36,17,77,51,26,3,0.02,0.0
1014,2437,26-09-2019 20:52:00,0,3000.0,2116.0,0.705,14.162,387,250,195,55,137,96,41,77,0.0,0.0
1014,2438,26-09-2019 20:54:00,0,2897.0,2071.0,0.715,13.707,415,269,210,59,146,106,40,142,0.01,0.0
1014,2439,26-09-2019 20:56:00,0,3015.0,2081.0,0.69,14.182,364,177,143,34,187,151,36,96,0.05,0.0
1014,2440,26-09-2019 20:58:00,0,2912.0,2030.0,0.697,13.721,234,127,84,43,107,74,33,43,0.0,0.0
1014,2441,26-09-2019 21:00:00,0,2995.0,2102.0,0.702,14.128,208,109,77,32,99,60,39,14,0.01,0.0
1014,2442,26-09-2019 21:02:00,0,2689.0,1930.0,0.718,12.732,318,151,118,33,167,115,52,80,0.05,0.0
1014,2443,26-09-2019 21:04:00,0,2889.0,2024.0,0.7,13.625,417,243,196,47,174,130,44,127,0.0,0.0
1014,2444,26-09-2019 21:06:00,0,2937.0,2066.5,0.7035,13.86,182,61,33,28,121,80,41,9,0.0,0.0
1014,2445,26-09-2019 21:08:00,0,2985.0,2109.0,0.707,14.095,379,199,153,46,180,133,47,57,0.0,0.0
1014,2446,26-09-2019 21:10:00,0,3001.0,2139.0,0.713,14.192,267,180,125,55,87,51,36,79,0.0,0.0
1014,2447,26-09-2019 21:12:00,0,3013.0,2070.0,0.687,14.163,330,179,145,34,151,121,30,95,0.0,0.0
1014,2448,26-09-2019 21:14:00,0,3007.0,2087.0,0.694,14.159,163,87,64,23,76,54,22,0,0.0,0.0
1014,2449,26-09-2019 21:16:00,0,3008.0,2089.0,0.694,14.165,138,69,45,24,69,34,35,4,0.0,0.0
1014,2450,26-09-2019 21:18:00,0,2976.0,2128.0,0.715,14.082,134,70,51,19,64,47,17,3,0.0,0.0
1014,2451,26-09-2019 21:20:00,0,3200.0,2233.0,0.698,15.083,271,161,121,40,110,74,36,64,0.0,0.0
1014,2452,26-09-2019 21:22:00,0,2693.0,1975.0,0.733,12.798,338,174,133,41,164,120,44,59,0.0,0.0
1014,2453,26-09-2019 21:24:00,0,2806.0,1950.0,0.695,13.216,108,67,48,19,41,29,12,17,0.0,0.0
1014,2454,26-09-2019 21:26:00,0,3010.0,2059.0,0.684,14.139,359,257,186,71,102,69,33,33,0.0,0.0
1014,2455,26-09-2019 21:28:00,0,3004.0,2110.0,0.703,14.171,362,261,194,67,101,63,38,46,0.03,0.0
1014,2456,26-09-2019 21:30:00,0,2993.0,2095.0,0.7,14.114,237,170,123,47,67,45,22,71,0.0,0.0
1014,2457,26-09-2019 21:32:00,0,2916.0,1979.0,0.679,13.68,85,78,57,21,7,4,3,81,0.0,0.0
1014,2458,26-09-2019 21:34:00,0,2800.0,1967.0,0.702,13.211,142,105,77,28,37,15,22,48,0.0,0.0
1014,2459,26-09-2019 21:36:00,0,2715.0,1849.0,0.681,12.743,174,132,84,48,42,31,11,15,0.0,0.0
1014,2460,26-09-2019 21:38:00,0,3015.0,2031.0,0.674,14.127,94,35,21,14,59,37,22,48,0.0,0.0
1014,2461,26-09-2019 21:40:00,0,3063.0,2084.0,0.6805,14.3755,278,118,76,42,160,105,55,89,0.0,0.0
1014,2462,26-09-2019 21:42:00,0,3111.0,2137.0,0.687,14.624,58,37,26,11,21,18,3,34,0.0,0.0
1014,2463,26-09-2019 21:44:00,0,2707.0,1908.0,0.705,12.778,333,209,172,37,124,91,33,131,0.0,0.0
1014,2464,26-09-2019 21:46:00,0,3021.0,2017.0,0.667,14.137,46,18,15,3,28,16,12,15,0.0,0.0
1014,2465,26-09-2019 21:48:00,0,3021.0,2010.0,0.665,14.128,85,74,52,22,11,8,3,34,0.0,0.0
1014,2466,26-09-2019 21:50:00,0,2692.0,1910.0,0.71,12.721,202,148,107,41,54,33,21,9,0.01,0.0
1014,2467,26-09-2019 21:52:00,0,2619.0,1767.0,0.675,12.274,74,35,10,25,39,15,24,0,0.0,0.0
1014,2468,26-09-2019 21:54:00,0,2384.0,1708.0,0.717,11.284,80,46,22,24,34,10,24,0,0.0,0.0
1014,2469,26-09-2019 21:56:00,0,2819.0,1925.0,0.683,13.24,216,94,66,28,122,83,39,15,0.08,0.0
1014,2470,26-09-2019 21:58:00,0,2715.0,1846.0,0.68,12.741,334,204,151,53,130,100,30,158,0.0,0.0
1014,2471,26-09-2019 22:00:00,0,2698.0,1934.0,0.717,12.774,406,287,227,60,119,82,37,85,0.0,0.0
1014,2472,26-09-2019 22:02:00,0,2713.0,1877.0,0.692,12.767,146,85,56,29,61,42,19,33,0.0,0.0
1014,2473,26-09-2019 22:04:00,0,2700.0,1876.0,0.695,12.717,142,114,75,39,28,16,12,75,0.0,0.0
1014,2474,26-09-2019 22:06:00,0,2793.0,1957.0,0.701,13.173,70,22,16,6,48,36,12,50,0.0,0.0
1014,2475,26-09-2019 22:08:00,0,2910.0,1974.0,0.678,13.65,135,78,54,24,57,40,17,33,0.0,0.0
1014,2476,26-09-2019 22:10:00,0,2706.0,1870.0,0.691,12.732,139,62,33,29,77,52,25,35,0.0,0.0
1014,2477,26-09-2019 22:12:00,0,2604.0,1797.0,0.69,12.251,469,208,163,45,261,204,57,59,0.0,0.0
1014,2478,26-09-2019 22:14:00,0,2703.5,1873.5,0.693,12.728,315,211,149,62,104,71,33,32,0.0,0.0
1014,2479,26-09-2019 22:16:00,0,2803.0,1950.0,0.696,13.205,147,108,77,31,39,27,12,17,0.0,0.0
1014,2480,26-09-2019 22:18:00,0,2704.0,1937.0,0.716,12.798,236,140,98,42,96,65,31,66,0.04,0.0
1014,2481,26-09-2019 22:20:00,0,2714.0,1864.0,0.687,12.756,18,15,9,6,3,1,2,0,0.0,0.0
1014,2482,26-09-2019 22:22:00,0,2991.0,2088.0,0.698,14.098,197,84,55,29,113,84,29,16,0.01,0.0
1014,2483,26-09-2019 22:24:00,0,2714.0,1839.0,0.678,12.73,107,68,48,20,39,9,30,2,0.03,0.0
1014,2484,26-09-2019 22:26:00,0,2719.0,1835.0,0.675,12.744,89,43,14,29,46,18,28,0,0.0,0.0
1014,2485,26-09-2019 22:28:00,0,2398.0,1712.0,0.714,11.344,163,88,44,44,75,46,29,8,0.0,0.0
1014,2486,26-09-2019 22:30:00,0,2609.0,1821.0,0.698,12.296,75,49,33,16,26,7,19,15,0.0,0.0
1014,2487,26-09-2019 22:32:00,0,2609.0,1799.0,0.69,12.273,187,131,101,30,56,37,19,28,0.0,0.0
1014,2488,26-09-2019 22:34:00,0,2710.0,1853.0,0.684,12.731,206,127,100,27,79,60,19,42,0.03,0.0
1014,2489,26-09-2019 22:36:00,0,2712.0,1828.0,0.674,12.709,26,14,7,7,12,2,10,0,0.02,0.0
1014,2490,26-09-2019 22:38:00,0,2723.0,1819.0,0.668,12.744,42,39,13,26,3,1,2,2,0.0,0.0
1014,2491,26-09-2019 22:40:00,0,2384.0,1776.0,0.745,11.362,295,177,128,49,118,86,32,41,0.0,0.0
1014,2492,26-09-2019 22:42:00,0,2490.0,1769.0,0.71,11.769,105,98,61,37,7,1,6,4,0.0,0.0
1014,2493,26-09-2019 22:44:00,0,2717.0,1797.0,0.661,12.693,214,105,81,24,109,77,32,86,0.03,0.0
1014,2494,26-09-2019 22:46:00,0,2381.0,1755.0,0.737,11.325,266,163,120,43,103,81,22,103,0.0,0.0
1014,2495,26-09-2019 22:48:00,0,2548.0,1789.0,0.704,12.02,326,208,156,52,118,86,32,33,0.0,0.0
1014,2496,26-09-2019 22:50:00,0,2715.0,1823.0,0.671,12.715,283,163,107,56,120,92,28,47,0.0,0.0
1014,2497,26-09-2019 22:52:00,0,2717.0,1822.0,0.671,12.721,168,96,55,41,72,40,32,20,0.0,0.0
1014,2498,26-09-2019 22:54:00,0,2397.0,1724.0,0.719,11.352,50,20,6,14,30,21,9,10,0.0,0.0
1014,2499,26-09-2019 22:56:00,0,2734.0,1822.0,0.666,12.791,44,42,26,16,2,0,2,29,0.0,0.0
1014,2500,26-09-2019 22:58:00,0,2711.0,1810.0,0.667,12.685,121,97,66,31,24,18,6,51,0.0,0.0
1014,2501,26-09-2019 23:00:00,0,2393.0,1727.0,0.722,11.339,63,52,29,23,11,7,4,7,0.0,0.0
1014,2502,26-09-2019 23:02:00,0,2384.0,1757.0,0.737,11.34,181,159,103,56,22,9,13,4,0.0,0.0
1014,2503,26-09-2019 23:04:00,0,2440.0,1587.0,0.65,11.371,281,198,151,47,83,53,30,64,0.0,0.0
1014,2504,26-09-2019 23:06:00,0,2394.0,1715.0,0.717,11.331,231,128,106,22,103,80,23,71,0.07,0.0
1014,2505,26-09-2019 23:08:00,0,2388.0,1756.0,0.735,11.352,40,20,11,9,20,15,5,3,0.0,0.0
1014,2506,26-09-2019 23:10:00,0,2508.0,1775.0,0.708,11.849,84,63,42,21,21,15,6,6,0.0,0.0
1014,2507,26-09-2019 23:12:00,0,2602.0,1804.0,0.693,12.249,182,95,75,20,87,68,19,15,0.0,0.0
1014,2508,26-09-2019 23:14:00,0,2387.0,1739.0,0.729,11.332,44,41,23,18,3,3,0,0,0.0,0.0
1014,2509,26-09-2019 23:16:00,0,2404.0,1628.0,0.677,11.275,122,104,76,28,18,13,5,50,0.0,0.0
1014,2510,26-09-2019 23:18:00,0,2412.0,1681.0,0.697,11.364,17,14,3,11,3,1,2,0,0.0,0.0
1014,2511,26-09-2019 23:20:00,0,2400.0,1698.0,0.708,11.337,78,70,44,26,8,1,7,1,0.0,0.0
1014,2512,26-09-2019 23:22:00,0,2412.5,1650.5,0.6845,11.334,15,8,2,6,7,0,7,0,0.0,0.0
1014,2513,26-09-2019 23:24:00,0,2425.0,1603.0,0.661,11.331,0,0,0,0,0,0,0,0,0.0,0.0
1014,2514,26-09-2019 23:26:00,0,2207.0,1494.0,0.677,10.348,1,1,0,1,0,0,0,0,0.0,0.0
1014,2515,26-09-2019 23:28:00,0,2118.0,1416.0,0.669,9.913,4,0,0,0,4,0,4,0,0.0,0.0
1014,2516,26-09-2019 23:30:00,0,1901.0,1348.0,0.709,8.981,6,2,2,0,4,0,4,0,0.0,0.0
1014,2517,26-09-2019 23:32:00,0,1919.0,1263.0,0.658,8.961,0,0,0,0,0,0,0,0,0.0,0.0
1014,2518,26-09-2019 23:34:00,0,1934.0,1177.0,0.609,8.925,35,27,14,13,8,0,8,0,0.0,0.0
1014,2519,26-09-2019 23:36:00,0,1932.0,1217.0,0.63,8.96,0,0,0,0,0,0,0,0,0.0,0.0
1014,2520,26-09-2019 23:38:00,0,1940.0,1188.0,0.612,8.961,0,0,0,0,0,0,0,1,0.03,0.0
1014,2521,26-09-2019 23:40:00,0,1829.0,1154.0,0.631,8.485,1,1,1,0,0,0,0,24,0.0,0.0
1014,2522,26-09-2019 23:42:00,0,1714.0,1129.0,0.659,8.003,3,2,1,1,1,0,1,47,0.0,0.0
1014,2523,26-09-2019 23:44:00,0,1612.0,1094.0,0.679,7.562,1,1,0,1,0,0,0,11,0.0,0.0
1014,2524,26-09-2019 23:46:00,0,1617.0,1064.0,0.658,7.55,7,7,0,7,0,0,0,0,0.0,0.0
1014,2525,26-09-2019 23:48:00,0,1628.0,1025.0,0.629,7.551,0,0,0,0,0,0,0,0,0.0,0.0
1014,2526,26-09-2019 23:50:00,0,1521.0,990.0,0.651,7.089,0,0,0,0,0,0,0,15,0.0,0.0
1014,2527,26-09-2019 23:52:00,0,1513.0,1007.0,0.665,7.075,1,0,0,0,1,0,1,20,0.0,0.0
1014,2528,26-09-2019 23:54:00,0,1400.0,987.0,0.705,6.608,0,0,0,0,0,0,0,0,0.0,0.0
1014,2529,26-09-2019 23:56:00,0,1402.0,981.0,0.7,6.6095,0,0,0,0,0,0,0,0,0.0,0.0
1014,2530,26-09-2019 23:58:00,0,1404.0,975.0,0.695,6.611,0,0,0,0,0,0,0,0,0.0,0.0
1014,2531,27-09-2019 00:00:00,0,1407.0,964.0,0.685,6.609,1,0,0,0,1,0,1,40,0.0,0.0
1014,2532,27-09-2019 00:02:00,0,1407.0,961.0,0.683,6.608,0,0,0,0,0,0,0,50,0.0,0.0
1014,2533,27-09-2019 00:04:00,0,1412.0,950.0,0.673,6.613,0,0,0,0,0,0,0,8,0.0,0.0
1014,2534,27-09-2019 00:06:00,0,1412.0,938.0,0.664,6.601,0,0,0,0,0,0,0,0,0.0,0.0
1014,2535,27-09-2019 00:08:00,0,1418.0,913.0,0.644,6.596,0,0,0,0,0,0,0,4,0.0,0.0
1014,2536,27-09-2019 00:10:00,0,1423.0,911.0,0.64,6.616,0,0,0,0,0,0,0,0,0.0,0.0
1014,2537,27-09-2019 00:12:00,0,1417.0,918.0,0.648,6.601,1,1,0,1,0,0,0,2,0.0,0.0
1014,2538,27-09-2019 00:14:00,0,1417.0,912.0,0.643,6.594,0,0,0,0,0,0,0,0,0.0,0.0
1014,2539,27-09-2019 00:16:00,0,1423.0,886.0,0.623,6.589,2,2,1,1,0,0,0,0,0.0,0.0
1014,2540,27-09-2019 00:18:00,0,1428.0,885.0,0.62,6.606,0,0,0,0,0,0,0,0,0.0,0.0
1014,2541,27-09-2019 00:20:00,0,1431.0,852.0,0.596,6.58,12,11,9,2,1,0,1,0,0.0,0.0
1014,2542,27-09-2019 00:22:00,0,1393.0,1010.0,0.725,6.607,208,143,109,34,65,47,18,15,0.0,0.0
1014,2543,27-09-2019 00:24:00,0,1595.0,1162.0,0.728,7.569,260,159,123,36,101,72,29,76,0.0,0.0
1014,2544,27-09-2019 00:26:00,0,2005.0,1381.0,0.689,9.43,381,233,186,47,148,111,37,110,0.0,0.0
1014,2545,27-09-2019 00:28:00,0,2300.0,1603.0,0.697,10.837,362,237,177,60,125,96,29,127,0.0,0.0
1014,2546,27-09-2019 00:30:00,0,2617.0,1765.5,0.677,12.266,352,171,132,39,181,137,44,107,0.0,0.0
1014,2547,27-09-2019 00:32:00,0,2934.0,1928.0,0.657,13.695,332,186,149,37,146,115,31,121,0.0,0.0
1014,2548,27-09-2019 00:34:00,0,2931.0,1907.0,0.651,13.66,166,120,94,26,46,36,10,30,0.0,0.0
1014,2549,27-09-2019 00:36:00,0,3237.0,2117.0,0.654,15.097,213,134,98,36,79,57,22,33,0.0,0.0
1014,2550,27-09-2019 00:38:00,0,2929.0,1931.0,0.659,13.68,157,116,70,46,41,20,21,11,0.0,0.0
1014,2551,27-09-2019 00:40:00,0,2931.0,1910.0,0.652,13.663,396,228,182,46,168,131,37,71,0.0,0.0
1014,2552,27-09-2019 00:42:00,0,3218.0,2154.0,0.67,15.065,213,69,53,16,144,105,39,22,0.0,0.0
1014,2553,27-09-2019 00:44:00,0,3031.0,1991.0,0.657,14.149,413,248,204,44,165,117,48,115,0.0,0.0
1014,2554,27-09-2019 00:46:00,0,3121.0,2122.0,0.68,14.647,447,284,219,65,163,123,40,111,0.0,0.0
1014,2555,27-09-2019 00:48:00,0,3010.0,2065.0,0.686,14.147,202,102,76,26,100,81,19,106,0.0,0.0
1014,2556,27-09-2019 00:50:00,0,3027.0,2036.0,0.673,14.179,96,61,30,31,35,28,7,21,0.0,0.0
1014,2557,27-09-2019 00:52:00,0,3200.0,2219.0,0.693,15.067,201,90,61,29,111,83,28,20,0.0,0.0
1014,2558,27-09-2019 00:54:00,0,2797.0,1907.0,0.682,13.131,241,106,89,17,135,103,32,160,0.0,0.0
1014,2559,27-09-2019 00:56:00,0,3229.0,2192.0,0.679,15.151,139,86,70,16,53,37,16,84,0.1,0.0
1014,2560,27-09-2019 00:58:00,0,3003.0,2060.0,0.686,14.111,131,67,46,21,64,46,18,13,0.0,0.0
1014,2561,27-09-2019 01:00:00,0,3019.0,2059.0,0.682,14.175,27,20,11,9,7,2,5,0,0.0,0.0
1014,2562,27-09-2019 01:02:00,0,3006.0,2065.0,0.687,14.131,151,89,60,29,62,40,22,4,0.02,0.0
1014,2563,27-09-2019 01:04:00,0,3007.0,2077.0,0.691,14.147,109,69,52,17,40,26,14,50,0.04,0.0
1014,2564,27-09-2019 01:06:00,0,3008.0,2089.0,0.695,14.163,211,61,46,15,150,114,36,104,0.06,0.0
1014,2565,27-09-2019 01:08:00,0,2922.0,1937.0,0.663,13.659,129,65,53,12,64,50,14,69,0.0,0.0
1014,2566,27-09-2019 01:10:00,0,3026.0,2023.0,0.669,14.161,124,58,34,24,66,35,31,0,0.0,0.0
1014,2567,27-09-2019 01:12:00,0,3040.0,1961.0,0.645,14.15,38,8,3,5,30,15,15,0,0.07,0.0
1014,2568,27-09-2019 01:14:00,0,2703.0,1875.0,0.694,12.725,74,45,22,23,29,10,19,0,0.0,0.0
1014,2569,27-09-2019 01:16:00,0,2729.0,1803.0,0.661,12.748,83,62,34,28,21,0,21,0,0.0,0.0
1014,2570,27-09-2019 01:18:00,0,2622.0,1752.0,0.668,12.271,60,58,30,28,2,0,2,0,0.0,0.0
1014,2571,27-09-2019 01:20:00,0,2502.0,1718.0,0.687,11.758,47,35,4,31,12,0,12,0,0.0,0.0
1014,2572,27-09-2019 01:22:00,0,2412.0,1666.0,0.691,11.348,2,2,0,2,0,0,0,0,0.0,0.0
1014,2573,27-09-2019 01:24:00,0,2196.0,1531.0,0.697,10.349,0,0,0,0,0,0,0,0,0.0,0.0
1014,2574,27-09-2019 01:26:00,0,2231.0,1431.0,0.641,10.376,0,0,0,0,0,0,0,0,0.0,0.0
1014,2575,27-09-2019 01:28:00,0,2019.0,1337.0,0.662,9.437,4,3,0,3,1,0,1,0,0.0,0.0
1014,2576,27-09-2019 01:30:00,0,1920.0,1257.0,0.655,8.956,1,1,0,1,0,0,0,0,0.0,0.0
1014,2577,27-09-2019 01:32:00,0,1931.0,1208.0,0.626,8.945,9,3,0,3,6,0,6,0,0.0,0.0
1014,2578,27-09-2019 01:34:00,0,1944.0,1170.0,0.602,8.955,0,0,0,0,0,0,0,0,0.0,0.0
1014,2579,27-09-2019 01:36:00,0,1727.0,1123.0,0.65,8.047,0,0,0,0,0,0,0,0,0.0,0.0
1014,2580,27-09-2019 01:38:00,0,1673.5,1089.0,0.6505,7.799,0,0,0,0,0,0,0,0,0.0,0.0
1014,2581,27-09-2019 01:40:00,0,1620.0,1055.0,0.651,7.551,0,0,0,0,0,0,0,0,0.0,0.0
1014,2582,27-09-2019 01:42:00,0,1623.0,1031.0,0.635,7.536,1,0,0,0,1,0,1,0,0.0,0.0
1014,2583,27-09-2019 01:44:00,0,1632.0,997.0,0.611,7.533,0,0,0,0,0,0,0,0,0.0,0.0
1014,2584,27-09-2019 01:46:00,0,1521.0,962.0,0.633,7.057,0,0,0,0,0,0,0,0,0.0,0.0
1014,2585,27-09-2019 01:48:00,0,1414.0,936.0,0.662,6.606,6,5,3,2,1,0,1,0,0.0,0.0
1014,2586,27-09-2019 01:50:00,0,1418.0,949.0,0.669,6.636,80,62,29,33,18,6,12,3,0.0,0.0
1014,2587,27-09-2019 01:52:00,0,1605.0,1117.0,0.696,7.559,149,105,71,34,44,27,17,62,0.0,0.0
1014,2588,27-09-2019 01:54:00,0,1935.0,1219.0,0.63,8.975,287,184,148,36,103,71,32,92,0.0,0.0
1014,2589,27-09-2019 01:56:00,0,1930.0,1212.0,0.628,8.946,200,133,102,31,67,38,29,47,0.0,0.0
1014,2590,27-09-2019 01:58:00,0,1915.0,1314.0,0.686,9.001,252,149,120,29,103,84,19,65,0.0,0.0
1014,2591,27-09-2019 02:00:00,0,2001.0,1369.0,0.684,9.401,125,45,18,27,80,45,35,0,0.0,0.0
1014,2592,27-09-2019 02:02:00,0,2223.0,1470.0,0.661,10.385,238,126,86,40,112,75,37,65,0.0,0.0
1014,2593,27-09-2019 02:04:00,0,2230.0,1470.0,0.659,10.415,142,67,43,24,75,46,29,7,0.0,0.0
1014,2594,27-09-2019 02:06:00,0,2217.0,1447.0,0.653,10.337,139,50,22,28,89,55,34,5,0.0,0.0
1014,2595,27-09-2019 02:08:00,0,2196.0,1551.0,0.706,10.371,257,160,113,47,97,78,19,70,0.0,0.0
1014,2596,27-09-2019 02:10:00,0,2229.0,1437.0,0.645,10.373,177,106,72,34,71,43,28,22,0.0,0.0
1014,2597,27-09-2019 02:12:00,0,2323.5,1529.0,0.6575,10.848,45,12,4,8,33,11,22,0,0.0,0.0
1014,2598,27-09-2019 02:14:00,0,2418.0,1621.0,0.67,11.323,103,70,53,17,33,19,14,11,0.0,0.0
1014,2599,27-09-2019 02:16:00,0,2606.0,1737.0,0.666,12.192,43,29,17,12,14,10,4,17,0.0,0.0
1014,2600,27-09-2019 02:18:00,0,1902.0,1311.0,0.69,8.944,88,57,12,45,31,10,21,0,0.0,0.0
1014,2601,27-09-2019 02:20:00,0,2238.0,1422.0,0.635,10.392,46,28,12,16,18,0,18,0,0.0,0.0
1014,2602,27-09-2019 02:22:00,0,2129.0,1375.0,0.646,9.911,21,20,4,16,1,0,1,0,0.0,0.0
1014,2603,27-09-2019 02:24:00,0,2127.0,1375.0,0.646,9.904,3,3,1,2,0,0,0,0,0.0,0.0
1014,2604,27-09-2019 02:26:00,0,1907.0,1308.0,0.686,8.962,0,0,0,0,0,0,0,0,0.0,0.0
1014,2605,27-09-2019 02:28:00,0,1933.0,1228.0,0.635,8.975,0,0,0,0,0,0,0,0,0.0,0.0
1014,2606,27-09-2019 02:30:00,0,1942.0,1179.0,0.607,8.957,0,0,0,0,0,0,0,0,0.0,0.0
1014,2607,27-09-2019 02:32:00,0,1727.0,1130.0,0.654,8.056,0,0,0,0,0,0,0,0,0.0,0.0
1014,2608,27-09-2019 02:34:00,0,1618.0,1071.0,0.662,7.559,4,4,1,3,0,0,0,0,0.0,0.0
1014,2609,27-09-2019 02:36:00,0,1629.0,1023.0,0.628,7.55,0,0,0,0,0,0,0,0,0.0,0.0
1014,2610,27-09-2019 02:38:00,0,1639.0,977.0,0.596,7.541,3,3,0,3,0,0,0,0,0.0,0.0
1014,2611,27-09-2019 02:40:00,0,1525.0,964.0,0.632,7.076,2,1,0,1,1,0,1,0,0.0,0.0
1014,2612,27-09-2019 02:42:00,0,1410.0,937.0,0.664,6.594,0,0,0,0,0,0,0,0,0.0,0.0
1014,2613,27-09-2019 02:44:00,0,1412.0,910.0,0.644,6.571,0,0,0,0,0,0,0,0,0.0,0.0
1014,2614,27-09-2019 02:46:00,0,1420.0,907.0,0.6385,6.5995,11,5,1,4,6,0,6,0,0.0,0.0
1014,2615,27-09-2019 02:48:00,0,1428.0,904.0,0.633,6.628,15,15,0,15,0,0,0,0,0.0,0.0
1014,2616,27-09-2019 02:50:00,0,1426.0,873.0,0.612,6.586,10,10,0,10,0,0,0,0,0.0,0.0
1014,2617,27-09-2019 02:52:00,0,1435.0,854.0,0.596,6.598,12,12,0,12,0,0,0,0,0.0,0.0
1014,2618,27-09-2019 02:54:00,0,1442.0,834.0,0.579,6.604,0,0,0,0,0,0,0,0,0.0,0.0
1014,2619,27-09-2019 02:56:00,0,1326.0,814.0,0.614,6.126,3,1,0,1,2,0,2,0,0.0,0.0
1014,2620,27-09-2019 02:58:00,0,1440.0,840.0,0.583,6.606,10,9,2,7,1,0,1,0,0.0,0.0
1014,2621,27-09-2019 03:00:00,0,1441.0,815.0,0.566,6.579,8,8,0,8,0,0,0,0,0.0,0.0
1014,2622,27-09-2019 03:02:00,0,1326.0,810.0,0.611,6.121,1,1,0,1,0,0,0,0,0.0,0.0
1014,2623,27-09-2019 03:04:00,0,1335.0,796.0,0.596,6.14,1,1,0,1,0,0,0,0,0.0,0.0
1014,2624,27-09-2019 03:06:00,0,1218.0,776.0,0.637,5.659,0,0,0,0,0,0,0,0,0.0,0.0
1014,2625,27-09-2019 03:08:00,0,1224.0,761.0,0.621,5.665,3,3,1,2,0,0,0,0,0.0,0.0
1014,2626,27-09-2019 03:10:00,0,1225.0,763.0,0.623,5.671,0,0,0,0,0,0,0,0,0.0,0.0
1014,2627,27-09-2019 03:12:00,0,1107.0,758.0,0.685,5.201,0,0,0,0,0,0,0,0,0.0,0.0
1014,2628,27-09-2019 03:14:00,0,1217.0,766.0,0.629,5.643,0,0,0,0,0,0,0,0,0.0,0.0
1014,2629,27-09-2019 03:16:00,0,1224.0,767.0,0.626,5.672,0,0,0,0,0,0,0,0,0.0,0.0
1014,2630,27-09-2019 03:18:00,0,1106.0,745.0,0.674,5.182,0,0,0,0,0,0,0,0,0.0,0.0
1014,2631,27-09-2019 03:20:00,0,1104.0,751.0,0.6805,5.182,2,2,1,1,0,0,0,0,0.0,0.0
1014,2632,27-09-2019 03:22:00,0,1102.0,757.0,0.687,5.182,8,0,0,0,8,0,8,0,0.0,0.0
1014,2633,27-09-2019 03:24:00,0,1108.0,754.0,0.681,5.2,4,1,0,1,3,0,3,0,0.0,0.0
1014,2634,27-09-2019 03:26:00,0,1108.0,741.0,0.669,5.187,3,0,0,0,3,0,3,0,0.0,0.0
1014,2635,27-09-2019 03:28:00,0,1108.0,729.0,0.658,5.173,0,0,0,0,0,0,0,0,0.0,0.0
1014,2636,27-09-2019 03:30:00,0,1117.0,724.0,0.649,5.202,0,0,0,0,0,0,0,0,0.0,0.0
1014,2637,27-09-2019 03:32:00,0,1116.0,711.0,0.637,5.185,0,0,0,0,0,0,0,0,0.0,0.0
1014,2638,27-09-2019 03:34:00,0,1119.0,696.0,0.622,5.18,7,3,0,3,4,0,4,0,0.0,0.0
1014,2639,27-09-2019 03:36:00,0,1326.0,816.0,0.615,6.126,212,126,88,38,86,48,38,38,0.0,0.0
1014,2640,27-09-2019 03:38:00,0,1407.0,987.0,0.701,6.637,112,63,48,15,49,32,17,22,0.0,0.0
1014,2641,27-09-2019 03:40:00,0,1421.0,905.0,0.637,6.6,55,52,35,17,3,0,3,1,0.0,0.0
1014,2642,27-09-2019 03:42:00,0,1615.0,1056.0,0.654,7.533,135,93,58,35,42,20,22,42,0.0,0.0
1014,2643,27-09-2019 03:44:00,0,2218.0,1491.0,0.672,10.392,235,111,87,24,124,91,33,64,0.0,0.0
1014,2644,27-09-2019 03:46:00,0,2012.0,1370.0,0.681,9.446,152,60,42,18,92,71,21,41,0.0,0.0
1014,2645,27-09-2019 03:48:00,0,2011.0,1386.0,0.689,9.457,239,141,114,27,98,76,22,109,0.0,0.0
1014,2646,27-09-2019 03:50:00,0,2227.0,1428.0,0.641,10.356,170,96,70,26,74,51,23,28,0.0,0.0
1014,2647,27-09-2019 03:52:00,0,2125.0,1377.0,0.648,9.896,81,50,31,19,31,6,25,0,0.0,0.0
1014,2648,27-09-2019 03:54:00,0,2175.0,1430.0,0.6575,10.152,563,330,262,68,233,172,61,3,0.0,0.0
1014,2649,27-09-2019 03:56:00,0,2225.0,1483.0,0.667,10.408,235,123,99,24,112,81,31,105,0.0,0.0
1014,2650,27-09-2019 03:58:00,0,2322.0,1538.0,0.662,10.852,204,99,75,24,105,72,33,79,0.0,0.0
1014,2651,27-09-2019 04:00:00,0,2210.0,1523.0,0.689,10.393,12,12,5,7,0,0,0,0,0.0,0.0
1014,2652,27-09-2019 04:02:00,0,2221.0,1443.0,0.65,10.351,76,61,34,27,15,9,6,0,0.0,0.0
1014,2653,27-09-2019 04:04:00,0,2233.0,1424.0,0.638,10.374,103,64,42,22,39,15,24,6,0.0,0.0
1014,2654,27-09-2019 04:06:00,0,2238.0,1392.0,0.622,10.358,54,32,11,21,22,10,12,0,0.0,0.0
1014,2655,27-09-2019 04:08:00,0,2250.0,1386.0,0.616,10.402,192,137,102,35,55,28,27,29,0.0,0.0
1014,2656,27-09-2019 04:10:00,0,2217.0,1489.0,0.672,10.383,394,220,181,39,174,121,53,85,0.02,0.0
1014,2657,27-09-2019 04:12:00,0,2210.0,1492.0,0.675,10.359,212,124,92,32,88,56,32,12,0.0,0.0
1014,2658,27-09-2019 04:14:00,0,2130.0,1349.0,0.633,9.886,30,18,7,11,12,2,10,0,0.0,0.0
1014,2659,27-09-2019 04:16:00,0,1912.0,1297.0,0.678,8.968,7,5,2,3,2,0,2,0,0.0,0.0
1014,2660,27-09-2019 04:18:00,0,1934.0,1206.0,0.624,8.955,0,0,0,0,0,0,0,0,0.0,0.0
1014,2661,27-09-2019 04:20:00,0,1942.0,1177.0,0.606,8.957,1,0,0,0,1,0,1,0,0.0,0.0
1014,2662,27-09-2019 04:22:00,0,1953.0,1140.0,0.583,8.959,3,1,0,1,2,0,2,0,0.0,0.0
1014,2663,27-09-2019 04:24:00,0,1725.0,1100.0,0.637,8.016,1,1,0,1,0,0,0,0,0.0,0.0
1014,2664,27-09-2019 04:26:00,0,1621.0,1051.0,0.648,7.549,1,1,0,1,0,0,0,0,0.0,0.0
1014,2665,27-09-2019 04:28:00,0,1629.0,1026.5,0.63,7.5555,0,0,0,0,0,0,0,0,0.0,0.0
1014,2666,27-09-2019 04:30:00,0,1637.0,1002.0,0.612,7.562,1,0,0,0,1,0,1,0,0.0,0.0
1014,2667,27-09-2019 04:32:00,0,1640.0,963.0,0.587,7.53,8,5,1,4,3,0,3,0,0.02,0.0
1014,2668,27-09-2019 04:34:00,0,1630.0,979.0,0.601,7.508,0,0,0,0,0,0,0,0,0.0,0.0
1014,2669,27-09-2019 04:36:00,0,1524.0,962.0,0.631,7.069,0,0,0,0,0,0,0,0,0.0,0.0
1014,2670,27-09-2019 04:38:00,0,1418.0,919.0,0.648,6.604,3,1,1,0,2,0,2,0,0.0,0.0
1014,2671,27-09-2019 04:40:00,0,1428.0,882.0,0.618,6.603,0,0,0,0,0,0,0,0,0.0,0.0
1014,2672,27-09-2019 04:42:00,0,1438.0,844.0,0.587,6.6,0,0,0,0,0,0,0,0,0.0,0.0
1014,2673,27-09-2019 04:44:00,0,1443.0,832.0,0.576,6.607,0,0,0,0,0,0,0,0,0.0,0.0
1014,2674,27-09-2019 04:46:00,0,1441.0,806.0,0.559,6.57,0,0,0,0,0,0,0,0,0.0,0.0
1014,2675,27-09-2019 04:48:00,0,1332.0,794.0,0.596,6.127,4,1,0,1,3,0,3,0,0.0,0.0
1014,2676,27-09-2019 04:50:00,0,1332.0,785.0,0.589,6.118,1,0,0,0,1,0,1,0,0.0,0.0
1014,2677,27-09-2019 04:52:00,0,1327.0,794.0,0.599,6.106,1,0,0,0,1,0,1,0,0.0,0.0
1014,2678,27-09-2019 04:54:00,0,1217.0,786.0,0.646,5.666,7,2,1,1,5,0,5,0,0.0,0.0
1014,2679,27-09-2019 04:56:00,0,1215.0,774.0,0.637,5.645,136,73,54,19,63,41,22,40,0.0,0.0
1014,2680,27-09-2019 04:58:00,0,1439.0,845.0,0.588,6.605,76,36,26,10,40,23,17,10,0.0,0.0
1014,2681,27-09-2019 05:00:00,0,1417.0,904.0,0.638,6.585,14,12,5,7,2,0,2,0,0.0,0.0
1014,2682,27-09-2019 05:02:00,0,1421.0,892.0,0.628,6.588,6,6,2,4,0,0,0,0,0.0,0.0
1014,2683,27-09-2019 05:04:00,0,1425.0,880.0,0.618,6.591,5,5,3,2,0,0,0,0,0.0,0.0
1014,2684,27-09-2019 05:06:00,0,1432.0,858.0,0.599,6.594,0,0,0,0,0,0,0,0,0.01,0.0
1014,2685,27-09-2019 05:08:00,0,1438.0,830.0,0.577,6.585,0,0,0,0,0,0,0,0,0.0,0.0
1014,2686,27-09-2019 05:10:00,0,1330.0,797.0,0.6,6.123,1,1,0,1,0,0,0,0,0.0,0.0
1014,2687,27-09-2019 05:12:00,0,1216.0,768.0,0.632,5.642,0,0,0,0,0,0,0,0,0.0,0.0
1014,2688,27-09-2019 05:14:00,0,1109.0,749.0,0.675,5.197,3,3,0,3,0,0,0,0,0.0,0.0
1014,2689,27-09-2019 05:16:00,0,1110.0,732.0,0.659,5.184,2,2,0,2,0,0,0,0,0.0,0.0
1014,2690,27-09-2019 05:18:00,0,1118.0,725.0,0.649,5.207,0,0,0,0,0,0,0,0,0.0,0.0
1014,2691,27-09-2019 05:20:00,0,1116.0,714.0,0.64,5.187,0,0,0,0,0,0,0,0,0.0,0.0
1014,2692,27-09-2019 05:22:00,0,1125.0,697.0,0.62,5.204,54,40,14,26,14,0,14,0,0.0,0.0
1014,2693,27-09-2019 05:24:00,0,1329.0,811.0,0.61,6.134,79,54,22,32,25,0,25,12,0.0,0.0
1014,2694,27-09-2019 05:26:00,0,1400.0,961.0,0.686,6.58,84,55,36,19,29,11,18,7,0.0,0.0
1014,2695,27-09-2019 05:28:00,0,1610.0,1064.0,0.661,7.521,145,90,55,35,55,35,20,17,0.0,0.0
1014,2696,27-09-2019 05:30:00,0,1609.0,1101.0,0.684,7.559,156,101,64,37,55,32,23,58,0.0,0.0
1014,2697,27-09-2019 05:32:00,0,2424.0,1640.0,0.676,11.367,71,54,37,17,17,7,10,11,0.0,0.0
1014,2698,27-09-2019 05:34:00,0,2313.0,1566.0,0.677,10.849,74,56,42,14,18,4,14,1,0.0,0.0
1014,2699,27-09-2019 05:36:00,0,2266.0,1529.0,0.6745,10.6225,43,26,4,22,17,1,16,0,0.0,0.0
1014,2700,27-09-2019 05:38:00,0,2219.0,1492.0,0.672,10.396,35,28,10,18,7,3,4,0,0.0,0.0
1014,2701,27-09-2019 05:40:00,0,2218.0,1457.0,0.657,10.352,123,69,52,17,54,27,27,10,0.0,0.0
1014,2702,27-09-2019 05:42:00,0,2227.0,1447.0,0.65,10.378,218,61,43,18,157,109,48,29,0.0,0.0
1014,2703,27-09-2019 05:44:00,0,2206.0,1505.0,0.682,10.357,80,55,33,22,25,15,10,1,0.0,0.0
1014,2704,27-09-2019 05:46:00,0,2241.0,1373.0,0.613,10.351,48,37,13,24,11,1,10,0,0.0,0.0
1014,2705,27-09-2019 05:48:00,0,2131.0,1385.0,0.65,9.929,35,35,11,24,0,0,0,0,0.0,0.0
1014,2706,27-09-2019 05:50:00,0,2229.0,1411.0,0.633,10.345,209,92,68,24,117,76,41,83,0.0,0.0
1014,2707,27-09-2019 05:52:00,0,2318.0,1542.0,0.665,10.841,139,78,41,37,61,41,20,32,0.0,0.0
1014,2708,27-09-2019 05:54:00,0,2227.0,1456.0,0.654,10.388,302,177,125,52,125,84,41,0,0.0,0.0
1014,2709,27-09-2019 05:56:00,0,2215.0,1510.0,0.682,10.401,110,56,34,22,54,34,20,3,0.01,0.0
1014,2710,27-09-2019 05:58:00,0,2239.0,1406.0,0.628,10.378,20,20,12,8,0,0,0,0,0.0,0.0
1014,2711,27-09-2019 06:00:00,1,2024.0,1338.0,0.661,9.454,70,40,26,14,30,22,8,8,0.0,0.0
1014,2712,27-09-2019 06:02:00,1,2226.0,1443.0,0.648,10.369,150,81,56,25,69,26,43,62,0.0,0.0
1014,2713,27-09-2019 06:04:00,1,2210.0,1488.0,0.673,10.355,130,70,37,33,60,0,60,66,0.0,0.0
1014,2714,27-09-2019 06:06:00,1,2641.0,1726.0,0.654,12.316,241,137,89,48,104,50,54,52,0.0,0.0
1014,2715,27-09-2019 06:08:00,1,2940.0,1875.0,0.638,13.66,98,60,30,30,38,0,38,48,0.0,0.04
1014,2716,27-09-2019 06:10:00,1,3058.0,2087.0,0.681,14.36,156,91,56,35,65,9,56,56,0.01,0.04
1014,2717,27-09-2019 06:12:00,1,3176.0,2299.0,0.724,15.06,153,65,27,38,88,26,62,59,0.06,0.01
1014,2718,27-09-2019 06:14:00,1,3174.0,2341.0,0.738,15.096,134,69,41,28,65,0,65,66,0.01,0.06
1014,2719,27-09-2019 06:16:00,1,3490.0,2543.0,0.729,16.567,206,48,30,18,158,88,70,35,0.21,0.06
1014,2720,27-09-2019 06:18:00,1,3361.0,2516.0,0.749,16.029,194,83,47,36,111,41,70,55,0.1,0.02
1014,2721,27-09-2019 06:20:00,1,3448.0,2647.0,0.768,16.514,174,92,65,27,82,15,67,69,0.04,0.08
1014,2722,27-09-2019 06:22:00,1,3444.0,2711.0,0.787,16.572,200,91,63,28,109,33,76,66,0.03,0.04
1014,2723,27-09-2019 06:24:00,1,3462.0,2657.0,0.768,16.581,197,75,43,32,122,44,78,65,0.1,0.05
1014,2724,27-09-2019 06:26:00,1,3402.0,2800.0,0.823,16.504,72,35,25,10,37,0,37,33,0.0,0.29
1014,2725,27-09-2019 06:28:00,1,2962.0,2285.0,0.771,14.199,8,0,0,0,8,0,8,0,0.0,0.0
1014,2726,27-09-2019 06:30:00,1,2960.0,2265.0,0.765,14.171,161,75,64,11,86,65,21,8,0.11,0.01
1014,2727,27-09-2019 06:32:00,1,3127.0,2565.0,0.82,15.161,125,24,8,16,101,65,36,1,0.13,0.0
1014,2728,27-09-2019 06:34:00,1,3709.0,2972.0,0.801,17.904,250,75,52,23,175,125,50,39,0.12,0.0
1014,2729,27-09-2019 06:36:00,1,3105.0,2599.0,0.837,15.112,153,78,51,27,75,14,61,62,0.01,0.02
1014,2730,27-09-2019 06:38:00,1,3416.0,2801.0,0.82,16.562,186,82,58,24,104,39,65,58,0.09,0.0
1014,2731,27-09-2019 06:40:00,1,3417.0,2744.0,0.803,16.503,208,123,88,35,85,32,53,66,0.05,0.0
1014,2732,27-09-2019 06:42:00,1,3430.0,2767.0,0.807,16.577,320,189,149,40,131,54,77,52,0.1,0.05
1014,2733,27-09-2019 06:44:00,1,3406.0,2825.5,0.83,16.547,329,144,113,31,185,116,69,63,0.08,0.1
1014,2734,27-09-2019 06:46:00,1,3382.0,2884.0,0.853,16.517,127,78,49,29,49,2,47,59,0.0,0.0
1014,2735,27-09-2019 06:48:00,1,3444.0,2746.0,0.797,16.611,232,131,93,38,101,45,56,54,0.06,0.0
1014,2736,27-09-2019 06:50:00,1,3396.0,2894.0,0.852,16.583,165,71,45,26,94,31,63,47,0.05,0.0
1014,2737,27-09-2019 06:52:00,1,3675.0,3114.0,0.847,17.927,223,103,70,33,120,49,71,80,0.03,0.0
1014,2738,27-09-2019 06:54:00,1,3626.0,2940.0,0.811,17.541,164,72,43,29,92,28,64,36,0.01,0.02
1014,2739,27-09-2019 06:56:00,1,3719.0,3011.0,0.81,17.986,257,111,78,33,146,81,65,47,0.11,0.01
1014,2740,27-09-2019 06:58:00,1,3429.0,2809.0,0.819,16.619,238,153,112,41,85,20,65,58,0.0,0.0
1014,2741,27-09-2019 07:00:00,1,3368.0,2909.0,0.864,16.49,141,97,63,34,44,2,42,50,0.01,0.03
1014,2742,27-09-2019 07:02:00,1,3595.0,3022.0,0.841,17.508,239,133,101,32,106,40,66,41,0.02,0.03
1014,2743,27-09-2019 07:04:00,1,3378.0,2934.0,0.869,16.56,149,95,62,33,54,31,23,29,0.01,0.06
1014,2744,27-09-2019 07:06:00,1,3478.0,2979.0,0.856,17.003,195,112,72,40,83,18,65,57,0.02,0.0
1014,2745,27-09-2019 07:08:00,1,3402.0,2868.0,0.843,16.58,270,147,113,34,123,61,62,86,0.01,0.0
1014,2746,27-09-2019 07:10:00,1,3390.0,2885.0,0.851,16.551,358,217,170,47,141,81,60,70,0.03,0.0
1014,2747,27-09-2019 07:12:00,1,3581.0,3069.0,0.857,17.506,339,194,140,54,145,71,74,80,0.01,0.0
1014,2748,27-09-2019 07:14:00,1,3395.0,2903.0,0.855,16.593,230,161,118,43,69,3,66,72,0.03,0.0
1014,2749,27-09-2019 07:16:00,1,3698.0,3045.0,0.823,17.941,175,115,83,32,60,11,49,71,0.0,0.0
1014,2750,27-09-2019 07:18:00,1,3611.5,3137.0,0.8695,17.703,209,130,99,31,79,31,48,68,0.02,0.0
1014,2751,27-09-2019 07:20:00,1,3525.0,3229.0,0.916,17.465,125,80,54,26,45,9,36,64,0.01,0.0
1014,2752,27-09-2019 07:22:00,1,3526.0,3207.0,0.91,17.441,120,51,28,23,69,14,55,45,0.03,0.03
1014,2753,27-09-2019 07:24:00,1,3467.0,3047.0,0.879,17.032,117,71,48,23,46,4,42,58,0.0,0.01
1014,2754,27-09-2019 07:26:00,1,3559.0,3130.0,0.879,17.488,168,83,51,32,85,30,55,50,0.03,0.01
1014,2755,27-09-2019 07:28:00,1,3356.0,2966.0,0.884,16.506,258,176,130,46,82,26,56,76,0.01,0.0
1014,2756,27-09-2019 07:30:00,1,3243.0,2961.0,0.913,16.056,292,175,127,48,117,76,41,27,0.03,0.08
1014,2757,27-09-2019 07:32:00,1,3341.0,3033.0,0.908,16.522,154,75,51,24,79,27,52,48,0.03,0.0
1014,2758,27-09-2019 07:34:00,1,3478.0,3044.0,0.875,17.073,172,94,64,30,78,14,64,53,0.0,0.0
1014,2759,27-09-2019 07:36:00,1,3262.0,2938.0,0.901,16.104,132,79,47,32,53,2,51,57,0.0,0.0
1014,2760,27-09-2019 07:38:00,1,3461.0,3076.0,0.889,17.043,165,105,67,38,60,5,55,57,0.0,0.0
1014,2761,27-09-2019 07:40:00,1,3349.0,3022.0,0.902,16.54,134,65,42,23,69,12,57,53,0.02,0.0
1014,2762,27-09-2019 07:42:00,1,3342.0,3047.0,0.912,16.542,128,79,46,33,49,0,49,50,0.01,0.0
1014,2763,27-09-2019 07:44:00,1,3225.0,3019.0,0.936,16.049,156,104,69,35,52,2,50,39,0.0,0.02
1014,2764,27-09-2019 07:46:00,1,3358.0,3058.0,0.91,16.618,152,90,53,37,62,15,47,44,0.0,0.05
1014,2765,27-09-2019 07:48:00,1,3573.0,3132.0,0.877,17.543,186,93,59,34,93,30,63,41,0.13,0.03
1014,2766,27-09-2019 07:50:00,1,3478.0,3073.0,0.884,17.104,117,67,45,22,50,5,45,47,0.03,0.05
1014,2767,27-09-2019 07:52:00,1,3448.0,3169.0,0.9195,17.0925,152,75,51,24,77,28,49,50,0.0,0.04
1014,2768,27-09-2019 07:54:00,1,3418.0,3265.0,0.955,17.081,148,91,63,28,57,9,48,55,0.05,0.04
1014,2769,27-09-2019 07:56:00,1,3426.0,3200.0,0.934,17.042,141,73,47,26,68,21,47,36,0.03,0.01
1014,2770,27-09-2019 07:58:00,1,3123.0,2949.0,0.944,15.57,74,43,26,17,31,0,31,31,0.0,0.02
1014,2771,27-09-2019 08:00:00,1,3142.0,2935.0,0.934,15.628,116,63,34,29,53,20,33,38,0.04,0.03
1014,2772,27-09-2019 08:02:00,1,3113.0,3016.0,0.969,15.604,485,219,165,54,266,205,61,23,0.03,0.17
1014,2773,27-09-2019 08:04:00,1,2814.0,2840.0,1.01,14.23,281,170,124,46,111,62,49,30,0.02,0.0
1014,2774,27-09-2019 08:06:00,1,2935.0,2814.0,0.959,14.681,138,65,43,22,73,21,52,47,0.0,0.0
1014,2775,27-09-2019 08:08:00,1,2859.0,2628.0,0.919,14.172,74,32,15,17,42,27,15,29,0.01,0.0
1014,2776,27-09-2019 08:10:00,1,2055.0,2097.0,1.02,10.416,30,23,7,16,7,6,1,9,0.02,0.0
1014,2777,27-09-2019 08:12:00,1,2100.0,1924.0,0.916,10.405,7,5,1,4,2,1,1,0,0.0,0.0
1014,2778,27-09-2019 08:14:00,1,2103.0,1917.0,0.912,10.41,1,1,1,0,0,0,0,0,0.0,0.0
1014,2779,27-09-2019 08:16:00,1,2098.0,1935.0,0.922,10.407,0,0,0,0,0,0,0,0,0.0,0.0
1014,2780,27-09-2019 08:18:00,1,2106.0,1924.0,0.913,10.428,3,0,0,0,3,1,2,0,0.0,0.0
1014,2781,27-09-2019 08:20:00,1,1899.0,1779.0,0.937,9.451,0,0,0,0,0,0,0,0,0.0,0.0
1014,2782,27-09-2019 08:22:00,1,1920.0,1694.0,0.882,9.44,3,0,0,0,3,0,3,0,0.0,0.0
1014,2783,27-09-2019 08:24:00,1,1919.0,1728.0,0.9,9.474,9,4,3,1,5,0,5,0,0.01,0.0
1014,2784,27-09-2019 08:26:00,1,2016.5,1794.0,0.89,9.9315,0,0,0,0,0,0,0,0,0.01,0.0
1014,2785,27-09-2019 08:28:00,1,2114.0,1860.0,0.88,10.389,10,6,1,5,4,1,3,0,0.0,0.0
1014,2786,27-09-2019 08:30:00,1,1888.0,1799.0,0.953,9.431,0,0,0,0,0,0,0,0,0.0,0.0
1014,2787,27-09-2019 08:32:00,1,1926.0,1709.0,0.887,9.48,3,3,1,2,0,0,0,0,0.0,0.0
1014,2788,27-09-2019 08:34:00,1,1921.0,1708.0,0.889,9.46,0,0,0,0,0,0,0,0,0.0,0.0
1014,2789,27-09-2019 08:36:00,1,1803.0,1689.0,0.937,8.972,0,0,0,0,0,0,0,0,0.0,0.0
1014,2790,27-09-2019 08:38:00,1,1591.0,1585.0,0.996,8.025,0,0,0,0,0,0,0,0,0.0,0.0
1014,2791,27-09-2019 08:40:00,1,1610.0,1560.0,0.969,8.069,27,25,9,16,2,1,1,0,0.0,0.0
1014,2792,27-09-2019 08:42:00,1,1912.0,1720.0,0.9,9.438,139,137,86,51,2,2,0,0,0.0,0.0
1014,2793,27-09-2019 08:44:00,1,2098.0,1963.0,0.935,10.44,123,116,93,23,7,2,5,2,0.0,0.0
1014,2794,27-09-2019 08:46:00,1,2045.0,2161.0,1.057,10.451,0,0,0,0,0,0,0,0,0.0,0.0
1014,2795,27-09-2019 08:48:00,1,2035.0,2179.0,1.071,10.432,0,0,0,0,0,0,0,0,0.0,0.0
1014,2796,27-09-2019 08:50:00,1,2040.0,2139.0,1.049,10.404,2,2,0,2,0,0,0,0,0.0,0.0
1014,2797,27-09-2019 08:52:00,1,2046.0,2116.0,1.034,10.404,0,0,0,0,0,0,0,0,0.0,0.0
1014,2798,27-09-2019 08:54:00,1,2064.0,2065.0,1.001,10.419,0,0,0,0,0,0,0,0,0.0,0.0
1014,2799,27-09-2019 08:56:00,1,1862.0,1914.0,1.028,9.453,0,0,0,0,0,0,0,0,0.0,0.0
1014,2800,27-09-2019 08:58:00,1,1880.0,1868.0,0.994,9.475,19,15,9,6,4,0,4,0,0.0,0.0
1014,2801,27-09-2019 09:00:00,1,1950.0,1835.0,0.943,9.714,35,24,20,4,11,6,5,0,0.0,0.0
1014,2802,27-09-2019 09:02:00,1,2020.0,1802.0,0.892,9.953,6,6,4,2,0,0,0,0,0.0,0.0
1014,2803,27-09-2019 09:04:00,1,1905.0,1742.0,0.915,9.435,6,6,1,5,0,0,0,0,0.0,0.0
1014,2804,27-09-2019 09:06:00,1,1904.0,1742.0,0.915,9.43,2,2,0,2,0,0,0,0,0.0,0.0
1014,2805,27-09-2019 09:08:00,1,2018.0,1780.0,0.882,9.922,9,9,2,7,0,0,0,0,0.0,0.0
1014,2806,27-09-2019 09:10:00,1,1904.0,1759.0,0.924,9.447,7,7,1,6,0,0,0,0,0.0,0.0
1014,2807,27-09-2019 09:12:00,1,2020.0,1779.0,0.881,9.93,0,0,0,0,0,0,0,0,0.0,0.0
1014,2808,27-09-2019 09:14:00,1,1992.0,1909.0,0.958,9.961,132,59,38,21,73,16,57,54,0.0,0.0
1014,2809,27-09-2019 09:16:00,1,2201.0,2029.0,0.922,10.917,128,74,45,29,54,8,46,62,0.0,0.0
1014,2810,27-09-2019 09:18:00,1,2173.0,2060.0,0.948,10.841,90,35,13,22,55,0,55,61,0.0,0.0
1014,2811,27-09-2019 09:20:00,1,2504.0,2220.0,0.887,12.324,125,65,33,32,60,2,58,62,0.0,0.0
1014,2812,27-09-2019 09:22:00,1,2470.0,2320.0,0.939,12.301,154,92,56,36,62,0,62,62,0.0,0.0
1014,2813,27-09-2019 09:24:00,1,2784.0,2504.0,0.9,13.742,135,92,50,42,43,0,43,55,0.0,0.0
1014,2814,27-09-2019 09:26:00,1,2958.0,2716.0,0.918,14.662,145,101,66,35,44,0,44,61,0.0,0.0
1014,2815,27-09-2019 09:28:00,1,2944.0,2791.0,0.948,14.69,132,95,55,40,37,0,37,56,0.0,0.0
1014,2816,27-09-2019 09:30:00,1,2932.0,2847.0,0.971,14.704,166,114,72,42,52,0,52,54,0.0,0.01
1014,2817,27-09-2019 09:32:00,1,3249.0,2975.0,0.916,16.095,145,101,60,41,44,0,44,48,0.0,0.08
1014,2818,27-09-2019 09:34:00,1,3238.0,3025.5,0.9345,16.1065,133,73,53,20,60,14,46,36,0.12,0.03
1014,2819,27-09-2019 09:36:00,1,3227.0,3076.0,0.953,16.118,142,69,41,28,73,9,64,45,0.07,0.07
1014,2820,27-09-2019 09:38:00,1,3262.0,2941.0,0.901,16.109,143,99,71,28,44,27,17,51,0.04,0.11
1014,2821,27-09-2019 09:40:00,1,2780.0,2457.0,0.884,13.675,205,123,92,31,82,37,45,70,0.0,0.0
1014,2822,27-09-2019 09:42:00,1,3236.0,3023.0,0.934,16.097,100,79,50,29,21,0,21,57,0.0,0.0
1014,2823,27-09-2019 09:44:00,1,3226.0,3060.0,0.949,16.099,151,78,49,29,73,0,73,71,0.0,0.07
1014,2824,27-09-2019 09:46:00,1,3044.0,2873.0,0.944,15.173,122,50,36,14,72,13,59,30,0.08,0.04
1014,2825,27-09-2019 09:48:00,1,3342.0,3096.0,0.927,16.594,224,94,66,28,130,70,60,28,0.08,0.06
1014,2826,27-09-2019 09:50:00,1,3243.0,2943.0,0.908,16.035,528,307,237,70,221,167,54,6,0.07,0.01
1014,2827,27-09-2019 09:52:00,1,2684.0,2413.0,0.899,13.248,544,257,196,61,287,218,69,43,0.01,0.0
1014,2828,27-09-2019 09:54:00,1,2571.0,2344.0,0.912,12.724,519,381,302,79,138,97,41,6,0.0,0.07
1014,2829,27-09-2019 09:56:00,1,3036.0,2893.0,0.953,15.163,168,65,42,23,103,44,59,44,0.0,0.0
1014,2830,27-09-2019 09:58:00,1,3152.0,2885.0,0.915,15.613,49,33,18,15,16,0,16,26,0.0,0.0
1014,2831,27-09-2019 10:00:00,1,2933.0,2862.0,0.976,14.725,118,36,21,15,82,22,60,47,0.0,0.03
1014,2832,27-09-2019 10:02:00,1,2687.0,2410.0,0.897,13.257,257,208,154,54,49,25,24,2,0.04,0.01
1014,2833,27-09-2019 10:04:00,1,2117.0,1910.0,0.902,10.456,434,320,237,83,114,79,35,8,0.01,0.03
1014,2834,27-09-2019 10:06:00,1,2778.0,2448.0,0.881,13.653,183,124,84,40,59,33,26,6,0.1,0.0
1014,2835,27-09-2019 10:08:00,1,2788.5,2429.5,0.871,13.675,62,42,14,28,20,0,20,0,0.02,0.0
1014,2836,27-09-2019 10:10:00,1,2799.0,2411.0,0.861,13.697,37,29,12,17,8,0,8,0,0.0,0.0
1014,2837,27-09-2019 10:12:00,1,2707.0,2357.0,0.871,13.273,5,5,1,4,0,0,0,0,0.0,0.0
1014,2838,27-09-2019 10:14:00,1,2611.0,2282.0,0.874,12.813,0,0,0,0,0,0,0,0,0.0,0.0
1014,2839,27-09-2019 10:16:00,1,2589.0,2314.0,0.894,12.761,4,4,2,2,0,0,0,0,0.0,0.0
1014,2840,27-09-2019 10:18:00,1,2797.0,2420.0,0.865,13.698,0,0,0,0,0,0,0,0,0.0,0.0
1014,2841,27-09-2019 10:20:00,1,2804.0,2437.0,0.869,13.746,2,2,0,2,0,0,0,0,0.0,0.0
1014,2842,27-09-2019 10:22:00,1,2569.0,2383.0,0.928,12.758,0,0,0,0,0,0,0,0,0.0,0.0
1014,2843,27-09-2019 10:24:00,1,2470.0,2351.0,0.952,12.332,0,0,0,0,0,0,0,0,0.0,0.0
1014,2844,27-09-2019 10:26:00,1,2492.0,2219.0,0.89,12.275,1,1,1,0,0,0,0,0,0.0,0.0
1014,2845,27-09-2019 10:28:00,1,2262.0,2174.0,0.961,11.318,0,0,0,0,0,0,0,0,0.0,0.0
1014,2846,27-09-2019 10:30:00,1,2206.0,2021.0,0.916,10.928,2,2,2,0,0,0,0,0,0.0,0.0
1014,2847,27-09-2019 10:32:00,1,2209.0,1952.0,0.884,10.865,1,1,1,0,0,0,0,0,0.0,0.0
1014,2848,27-09-2019 10:34:00,1,2096.0,1945.0,0.928,10.411,9,9,0,9,0,0,0,0,0.0,0.0
1014,2849,27-09-2019 10:36:00,1,2104.0,1950.0,0.927,10.449,14,11,7,4,3,0,3,0,0.0,0.0
1014,2850,27-09-2019 10:38:00,1,1976.0,1915.0,0.969,9.903,1,0,0,0,1,0,1,0,0.0,0.0
1014,2851,27-09-2019 10:40:00,1,1989.0,1913.0,0.961,9.956,0,0,0,0,0,0,0,0,0.0,0.0
1014,2852,27-09-2019 10:42:00,1,2074.0,2031.0,0.978,10.4215,25,20,9,11,5,0,5,0,0.0,0.0
1014,2853,27-09-2019 10:44:00,1,2159.0,2149.0,0.995,10.887,92,47,35,12,45,11,34,46,0.0,0.0
1014,2854,27-09-2019 10:46:00,1,2155.0,2141.0,0.994,10.859,201,92,65,27,109,58,51,79,0.02,0.0
1014,2855,27-09-2019 10:48:00,1,2176.0,2134.0,0.981,10.937,90,79,44,35,11,6,5,7,0.0,0.0
1014,2856,27-09-2019 10:50:00,1,2269.0,2220.0,0.979,11.398,58,53,28,25,5,2,3,3,0.02,0.0
1014,2857,27-09-2019 10:52:00,1,2452.0,2357.0,0.961,12.272,24,11,4,7,13,0,13,1,0.04,0.0
1014,2858,27-09-2019 10:54:00,1,2478.0,2297.0,0.927,12.304,26,5,1,4,21,0,21,0,0.0,0.0
1014,2859,27-09-2019 10:56:00,1,2483.0,2236.0,0.901,12.259,49,30,4,26,19,0,19,1,0.0,0.0
1014,2860,27-09-2019 10:58:00,1,2473.0,2316.0,0.937,12.306,70,64,43,21,6,0,6,0,0.0,0.0
1014,2861,27-09-2019 11:00:00,1,2682.0,2431.0,0.907,13.257,3,3,1,2,0,0,0,0,0.0,0.0
1014,2862,27-09-2019 11:02:00,1,2471.0,2337.0,0.946,12.324,13,12,0,12,1,0,1,0,0.0,0.0
1014,2863,27-09-2019 11:04:00,1,2492.0,2219.0,0.891,12.274,0,0,0,0,0,0,0,0,0.0,0.0
1014,2864,27-09-2019 11:06:00,1,2172.0,2106.0,0.969,10.889,16,16,1,15,0,0,0,0,0.0,0.0
1014,2865,27-09-2019 11:08:00,1,2197.0,1995.0,0.908,10.866,5,5,1,4,0,0,0,0,0.0,0.0
1014,2866,27-09-2019 11:10:00,1,2103.0,1928.0,0.917,10.42,8,6,4,2,2,0,2,0,0.0,0.0
1014,2867,27-09-2019 11:12:00,1,1986.0,1919.0,0.967,9.948,0,0,0,0,0,0,0,0,0.0,0.0
1014,2868,27-09-2019 11:14:00,1,2195.0,1988.0,0.906,10.851,4,4,3,1,0,0,0,0,0.0,0.0
1014,2869,27-09-2019 11:16:00,1,2199.5,1997.0,0.908,10.878,0,0,0,0,0,0,0,0,0.0,0.0
1014,2870,27-09-2019 11:18:00,1,2204.0,2006.0,0.91,10.905,0,0,0,0,0,0,0,0,0.0,0.0
1014,2871,27-09-2019 11:20:00,1,1977.0,1964.0,0.994,9.964,1,1,1,0,0,0,0,0,0.0,0.0
1014,2872,27-09-2019 11:22:00,1,1990.0,1881.0,0.945,9.923,91,80,53,27,11,2,9,3,0.0,0.0
1014,2873,27-09-2019 11:24:00,1,1986.0,1887.0,0.95,9.915,4,4,0,4,0,0,0,0,0.0,0.0
1014,2874,27-09-2019 11:26:00,1,1979.0,1938.0,0.979,9.944,5,5,1,4,0,0,0,0,0.0,0.0
1014,2875,27-09-2019 11:28:00,1,2000.0,1865.0,0.932,9.945,1,0,0,0,1,0,1,0,0.0,0.0
1014,2876,27-09-2019 11:30:00,1,1998.0,1847.0,0.924,9.917,15,12,2,10,3,0,3,0,0.0,0.0
1014,2877,27-09-2019 11:32:00,1,1978.0,1932.0,0.977,9.93,4,1,0,1,3,0,3,0,0.0,0.0
1014,2878,27-09-2019 11:34:00,1,1984.0,1940.0,0.977,9.966,2,1,0,1,1,0,1,0,0.0,0.0
1014,2879,27-09-2019 11:36:00,1,1980.0,1912.0,0.966,9.917,14,10,4,6,4,0,4,0,0.0,0.0
1014,2880,27-09-2019 11:38:00,1,1986.0,1901.0,0.957,9.929,0,0,0,0,0,0,0,0,0.0,0.0
1014,2881,27-09-2019 11:40:00,1,2002.0,1864.0,0.931,9.952,0,0,0,0,0,0,0,0,0.0,0.0
1014,2882,27-09-2019 11:42:00,1,2010.0,1814.0,0.902,9.926,3,3,1,2,0,0,0,0,0.0,0.0
1014,2883,27-09-2019 11:44:00,1,1903.0,1768.0,0.929,9.457,0,0,0,0,0,0,0,0,0.0,0.0
1014,2884,27-09-2019 11:46:00,1,1920.0,1732.0,0.902,9.482,3,3,0,3,0,0,0,0,0.0,0.0
1014,2885,27-09-2019 11:48:00,1,1921.0,1731.0,0.901,9.486,1,1,0,1,0,0,0,0,0.0,0.0
1014,2886,27-09-2019 11:50:00,1,1964.0,1768.0,0.9,9.696,18,11,4,7,7,0,7,0,0.0,0.01
1014,2887,27-09-2019 11:52:00,1,2007.0,1805.0,0.899,9.906,11,1,0,1,10,0,10,0,0.0,0.0
1014,2888,27-09-2019 11:54:00,1,2013.0,1835.0,0.912,9.963,25,15,5,10,10,0,10,0,0.0,0.0
1014,2889,27-09-2019 11:56:00,1,2006.0,1829.0,0.912,9.929,4,4,1,3,0,0,0,0,0.0,0.0
1014,2890,27-09-2019 11:58:00,1,2006.0,1858.0,0.926,9.959,0,0,0,0,0,0,0,0,0.0,0.0
1014,2891,27-09-2019 12:00:00,1,2003.0,1838.0,0.918,9.925,87,51,30,21,36,2,34,0,0.0,0.0
1014,2892,27-09-2019 12:02:00,1,1973.0,1980.0,1.003,9.966,42,37,16,21,5,0,5,5,0.0,0.0
1014,2893,27-09-2019 12:04:00,1,2162.0,2113.0,0.978,10.857,14,13,1,12,1,0,1,0,0.0,0.0
1014,2894,27-09-2019 12:06:00,1,2168.0,2175.0,1.004,10.949,54,38,9,29,16,2,14,2,0.0,0.0
1014,2895,27-09-2019 12:08:00,1,2245.0,2238.0,0.997,11.322,85,66,40,26,19,1,18,9,0.0,0.26
1014,2896,27-09-2019 12:10:00,1,2452.0,2405.0,0.981,12.323,8,0,0,0,8,0,8,0,0.0,0.01
1014,2897,27-09-2019 12:12:00,1,2678.0,2466.0,0.921,13.28,0,0,0,0,0,0,0,0,0.0,0.0
1014,2898,27-09-2019 12:14:00,1,2657.0,2476.0,0.932,13.211,0,0,0,0,0,0,0,0,0.0,0.0
1014,2899,27-09-2019 12:16:00,1,2761.0,2531.0,0.917,13.68,40,23,8,15,17,10,7,0,0.0,0.0
1014,2900,27-09-2019 12:18:00,1,2452.0,2431.0,0.992,12.352,253,168,132,36,85,61,24,40,0.07,0.0
1014,2901,27-09-2019 12:20:00,1,2752.0,2627.0,0.955,13.75,321,206,155,51,115,62,53,29,0.09,0.0
1014,2902,27-09-2019 12:22:00,1,2670.0,2425.0,0.908,13.205,184,100,72,28,84,21,63,54,0.0,0.0
1014,2903,27-09-2019 12:24:00,1,2711.0,2529.5,0.9325,13.4815,124,67,32,35,57,8,49,39,0.0,0.3
1014,2904,27-09-2019 12:26:00,1,2752.0,2634.0,0.957,13.758,175,114,67,47,61,2,59,35,0.0,0.0
1014,2905,27-09-2019 12:28:00,1,2754.0,2577.0,0.936,13.705,430,240,185,55,190,136,54,29,0.03,0.0
1014,2906,27-09-2019 12:30:00,1,2175.0,2073.0,0.953,10.865,358,269,207,62,89,42,47,23,0.04,0.0
1014,2907,27-09-2019 12:32:00,1,2848.0,2663.0,0.935,14.17,153,94,56,38,59,4,55,54,0.01,0.0
1014,2908,27-09-2019 12:34:00,1,2945.0,2767.0,0.939,14.667,141,94,55,39,47,0,47,53,0.04,0.0
1014,2909,27-09-2019 12:36:00,1,3141.0,2949.0,0.939,15.638,144,96,63,33,48,0,48,49,0.0,0.0
1014,2910,27-09-2019 12:38:00,1,2922.0,2843.0,0.973,14.661,164,118,71,47,46,0,46,50,0.0,0.0
1014,2911,27-09-2019 12:40:00,1,3124.0,2975.0,0.952,15.604,185,109,69,40,76,0,76,50,0.0,0.0
1014,2912,27-09-2019 12:42:00,1,2948.0,2750.0,0.933,14.658,418,260,204,56,158,102,56,17,0.1,0.0
1014,2913,27-09-2019 12:44:00,1,3243.0,3019.0,0.931,16.118,210,121,81,40,89,39,50,42,0.03,0.0
1014,2914,27-09-2019 12:46:00,1,2854.0,2698.0,0.945,14.232,71,56,36,20,15,2,13,1,0.01,0.0
1014,2915,27-09-2019 12:48:00,1,2174.0,2081.0,0.957,10.868,49,42,13,29,7,0,7,0,0.01,0.0
1014,2916,27-09-2019 12:50:00,1,1997.0,1860.0,0.931,9.927,17,17,9,8,0,0,0,0,0.02,0.0
1015,1,23-09-2019 11:40:00,1,4999.0,3769.0,0.754,23.87,660,273,212,61,387,313,74,76,0.01,0.0
1015,2,23-09-2019 11:42:00,1,4929.0,3563.0,0.723,23.366,692,225,178,47,467,411,56,66,0.0,0.06
1015,3,23-09-2019 11:44:00,1,5007.0,3698.0,0.739,23.824,351,107,67,40,244,219,25,42,0.0,0.0
1015,4,23-09-2019 11:46:00,1,5014.0,3680.0,0.734,23.828,349,82,50,32,267,253,14,70,0.01,0.0
1015,5,23-09-2019 11:48:00,1,5013.0,3717.0,0.741,23.867,626,220,169,51,406,364,42,77,0.0,0.0
1015,6,23-09-2019 11:50:00,1,4817.0,3503.0,0.727,22.858,424,155,121,34,269,230,39,158,0.0,0.0
1015,7,23-09-2019 11:52:00,1,4595.0,3322.0,0.723,21.781,443,165,134,31,278,246,32,150,0.0,0.0
1015,8,23-09-2019 11:54:00,1,4483.0,3242.0,0.723,21.253,780,287,228,59,493,440,53,95,0.02,0.0
1015,9,23-09-2019 11:56:00,1,5009.0,3718.0,0.742,23.852,396,201,157,44,195,145,50,110,0.0,0.0
1015,10,23-09-2019 11:58:00,1,5007.0,3766.0,0.752,23.899,599,266,216,50,333,271,62,73,0.0,0.0
1015,11,23-09-2019 12:00:00,1,4273.0,3098.0,0.725,20.268,442,177,139,38,265,216,49,155,0.0,0.0
1015,12,23-09-2019 12:02:00,1,4492.0,3266.0,0.727,21.316,458,220,165,55,238,176,62,19,0.0,0.0
1015,13,23-09-2019 12:04:00,1,4267.0,3128.0,0.733,20.276,560,254,201,53,306,240,66,106,0.0,0.0
1015,14,23-09-2019 12:06:00,1,4431.5,3235.0,0.73,21.0425,126,59,34,25,67,34,33,11,0.0,0.0
1015,15,23-09-2019 12:08:00,1,4596.0,3342.0,0.727,21.809,417,212,161,51,205,140,65,77,0.0,0.0
1015,16,23-09-2019 12:10:00,1,4235.0,3151.0,0.744,20.174,153,63,43,20,90,32,58,84,0.0,0.0
1015,17,23-09-2019 12:12:00,1,4354.0,3274.0,0.752,20.78,378,191,142,49,187,146,41,83,0.0,0.0
1015,18,23-09-2019 12:14:00,1,3931.0,2907.0,0.739,18.707,418,200,160,40,218,161,57,147,0.0,0.0
1015,19,23-09-2019 12:16:00,1,3154.0,2393.0,0.759,15.077,105,45,24,21,60,23,37,0,0.0,0.0
1015,20,23-09-2019 12:18:00,1,2938.0,2190.0,0.745,14.0,418,214,161,53,204,152,52,57,0.0,0.0
1015,21,23-09-2019 12:20:00,1,3710.0,2767.0,0.746,17.681,362,139,102,37,223,168,55,103,0.0,0.0
1015,22,23-09-2019 12:22:00,1,4336.0,3362.0,0.775,20.808,451,204,153,51,247,191,56,124,0.0,0.0
1015,23,23-09-2019 12:24:00,1,4097.0,3249.0,0.793,19.739,180,104,75,29,76,54,22,78,0.0,0.0
1015,24,23-09-2019 12:26:00,1,2604.0,1970.0,0.757,12.441,237,111,85,26,126,86,40,34,0.0,0.0
1015,25,23-09-2019 12:28:00,1,3673.0,2898.0,0.789,17.679,253,131,89,42,122,71,51,90,0.0,0.0
1015,26,23-09-2019 12:30:00,1,4428.0,3383.0,0.764,21.194,428,240,180,60,188,134,54,42,0.0,0.0
1015,27,23-09-2019 12:32:00,1,3365.0,2614.0,0.777,16.154,381,176,138,38,205,140,65,32,0.0,0.0
1015,28,23-09-2019 12:34:00,1,3475.0,2682.0,0.772,16.66,488,213,160,53,275,212,63,137,0.01,0.0
1015,29,23-09-2019 12:36:00,1,2591.0,2002.0,0.773,12.426,235,134,109,25,101,74,27,136,0.0,0.0
1015,30,23-09-2019 12:38:00,1,2945.0,2166.0,0.736,14.001,90,58,40,18,32,21,11,13,0.0,0.0
1015,31,23-09-2019 12:40:00,1,3420.5,2595.5,0.756,16.351,386,190,145,45,196,145,51,70,0.0,0.0
1015,32,23-09-2019 12:42:00,1,3896.0,3025.0,0.776,18.701,378,204,163,41,174,130,44,60,0.0,0.0
1015,33,23-09-2019 12:44:00,1,3118.0,2499.0,0.802,15.053,385,158,117,41,227,166,61,43,0.0,0.0
1015,34,23-09-2019 12:46:00,1,3134.0,2470.0,0.788,15.083,162,85,45,40,77,48,29,34,0.0,0.0
1015,35,23-09-2019 12:48:00,1,2491.0,1882.0,0.756,11.9,285,155,120,35,130,91,39,76,0.0,0.0
1015,36,23-09-2019 12:50:00,1,3123.0,2475.0,0.792,15.043,307,142,111,31,165,132,33,121,0.0,0.0
1015,37,23-09-2019 12:52:00,1,2599.0,2010.0,0.774,12.465,299,181,147,34,118,87,31,126,0.0,0.0
1015,38,23-09-2019 12:54:00,1,2834.0,2117.0,0.747,13.51,115,47,32,15,68,47,21,40,0.0,0.0
1015,39,23-09-2019 12:56:00,1,3135.0,2450.0,0.781,15.064,173,80,51,29,93,65,28,5,0.0,0.0
1015,40,23-09-2019 12:58:00,1,2619.0,1944.0,0.742,12.471,68,36,15,21,32,8,24,0,0.0,0.0
1015,41,23-09-2019 13:00:00,1,2625.0,1919.0,0.731,12.468,36,14,2,12,22,3,19,0,0.0,0.0
1015,42,23-09-2019 13:02:00,1,2629.0,1895.0,0.721,12.458,24,17,4,13,7,2,5,0,0.0,0.0
1015,43,23-09-2019 13:04:00,1,2629.0,1926.0,0.732,12.491,62,43,22,21,19,12,7,0,0.0,0.0
1015,44,23-09-2019 13:06:00,1,2623.0,1915.0,0.73,12.453,450,214,159,55,236,190,46,34,0.0,0.0
1015,45,23-09-2019 13:08:00,1,3766.0,3025.0,0.803,18.19,326,173,135,38,153,115,38,57,0.0,0.0
1015,46,23-09-2019 13:10:00,1,2939.0,2220.0,0.755,14.036,817,406,320,86,411,329,82,0,0.0,0.0
1015,47,23-09-2019 13:12:00,1,3997.0,3198.0,0.8,19.29,480,203,154,49,277,218,59,52,0.0,0.06
1015,48,23-09-2019 13:14:00,1,4001.0,3172.5,0.793,19.2765,368,189,144,45,179,128,51,123,0.0,0.0
1015,49,23-09-2019 13:16:00,1,4005.0,3147.0,0.786,19.263,178,120,76,44,58,39,19,47,0.0,0.0
1015,50,23-09-2019 13:18:00,1,2574.0,2105.0,0.818,12.471,220,144,109,35,76,47,29,2,0.0,0.0
1015,51,23-09-2019 13:20:00,1,2934.0,2204.0,0.751,14.001,236,103,73,30,133,93,40,12,0.0,0.0
1015,52,23-09-2019 13:22:00,1,2920.0,2260.0,0.774,14.006,62,30,13,17,32,3,29,0,0.0,0.0
1015,53,23-09-2019 13:24:00,1,2413.0,1731.0,0.717,11.423,84,52,16,36,32,12,20,0,0.0,0.0
1015,54,23-09-2019 13:26:00,1,2418.0,1723.0,0.712,11.434,16,13,4,9,3,0,3,0,0.0,0.0
1015,55,23-09-2019 13:28:00,1,2408.0,1742.0,0.723,11.415,7,2,0,2,5,0,5,0,0.0,0.0
1015,56,23-09-2019 13:30:00,1,2049.0,1632.0,0.796,9.878,8,3,0,3,5,0,5,0,0.0,0.0
1015,57,23-09-2019 13:32:00,1,2064.0,1573.0,0.762,9.873,3,0,0,0,3,0,3,0,0.0,0.0
1015,58,23-09-2019 13:34:00,1,2072.0,1514.0,0.731,9.839,14,9,3,6,5,2,3,0,0.0,0.0
1015,59,23-09-2019 13:36:00,1,2060.0,1577.0,0.765,9.863,7,0,0,0,7,0,7,0,0.0,0.0
1015,60,23-09-2019 13:38:00,1,1954.0,1503.0,0.769,9.363,4,0,0,0,4,0,4,0,0.0,0.0
1015,61,23-09-2019 13:40:00,1,1947.0,1522.0,0.781,9.358,3,0,0,0,3,0,3,0,0.0,0.0
1015,62,23-09-2019 13:42:00,1,2062.0,1563.0,0.758,9.855,28,20,4,16,8,0,8,0,0.0,0.0
1015,63,23-09-2019 13:44:00,1,2066.0,1540.0,0.745,9.846,3,0,0,0,3,0,3,0,0.0,0.0
1015,64,23-09-2019 13:46:00,1,1834.0,1466.0,0.799,8.851,7,1,1,0,6,0,6,0,0.0,0.0
1015,65,23-09-2019 13:48:00,1,1889.5,1490.0,0.7885,9.0955,2,0,0,0,2,0,2,0,0.0,0.0
1015,66,23-09-2019 13:50:00,1,1945.0,1514.0,0.778,9.34,5,0,0,0,5,0,5,0,0.0,0.0
1015,67,23-09-2019 13:52:00,1,1827.0,1451.0,0.794,8.805,3,0,0,0,3,0,3,0,0.0,0.0
1015,68,23-09-2019 13:54:00,1,1832.0,1452.0,0.793,8.828,5,0,0,0,5,0,5,0,0.0,0.0
1015,69,23-09-2019 13:56:00,1,1844.0,1436.0,0.779,8.855,1,0,0,0,1,0,1,0,0.0,0.0
1015,70,23-09-2019 13:58:00,1,1837.0,1405.0,0.765,8.794,8,2,1,1,6,1,5,0,0.0,0.0
1015,71,23-09-2019 14:00:00,1,1851.0,1396.0,0.754,8.841,11,1,1,0,10,6,4,0,0.0,0.0
1015,72,23-09-2019 14:02:00,1,1856.0,1386.0,0.747,8.846,5,0,0,0,5,3,2,0,0.0,0.0
1015,73,23-09-2019 14:04:00,1,1840.0,1451.0,0.789,8.857,7,0,0,0,7,3,4,0,0.0,0.0
1015,74,23-09-2019 14:06:00,1,1846.0,1376.0,0.745,8.799,8,0,0,0,8,0,8,0,0.0,0.0
1015,75,23-09-2019 14:08:00,1,1860.0,1320.0,0.71,8.789,10,2,0,2,8,2,6,0,0.0,0.0
1015,76,23-09-2019 14:10:00,1,1873.0,1334.0,0.712,8.859,2,0,0,0,2,1,1,0,0.0,0.0
1015,77,23-09-2019 14:12:00,1,1857.0,1389.0,0.748,8.853,27,16,13,3,11,6,5,0,0.0,0.0
1015,78,23-09-2019 14:14:00,1,1847.0,1389.0,0.752,8.816,3,0,0,0,3,1,2,0,0.0,0.0
1015,79,23-09-2019 14:16:00,1,1851.0,1395.0,0.754,8.837,4,3,0,3,1,0,1,0,0.0,0.0
1015,80,23-09-2019 14:18:00,1,1845.0,1430.0,0.775,8.851,5,4,0,4,1,0,1,0,0.0,0.0
1015,81,23-09-2019 14:20:00,1,1850.0,1375.0,0.744,8.812,9,6,0,6,3,3,0,0,0.0,0.0
1015,82,23-09-2019 14:22:00,1,1840.0,1403.0,0.763,8.804,6,5,2,3,1,0,1,0,0.0,0.0
1015,83,23-09-2019 14:24:00,1,1830.0,1431.0,0.782,8.796,4,0,0,0,4,1,3,0,0.0,0.0
1015,84,23-09-2019 14:26:00,1,1846.0,1392.0,0.754,8.817,0,0,0,0,0,0,0,0,0.0,0.0
1015,85,23-09-2019 14:28:00,1,1859.0,1375.0,0.74,8.848,0,0,0,0,0,0,0,0,0.0,0.0
1015,86,23-09-2019 14:30:00,1,1842.0,1416.0,0.769,8.827,21,8,4,4,13,5,8,0,0.0,0.0
1015,87,23-09-2019 14:32:00,1,1849.0,1376.0,0.744,8.808,88,64,22,42,24,6,18,3,0.0,0.0
1015,88,23-09-2019 14:34:00,1,2390.0,1807.0,0.756,11.419,56,34,17,17,22,5,17,0,0.0,0.0
1015,89,23-09-2019 14:36:00,1,3645.0,2993.0,0.821,17.675,389,171,141,30,218,168,50,144,0.0,0.0
1015,90,23-09-2019 14:38:00,1,3428.0,2836.0,0.827,16.647,366,223,177,46,143,115,28,57,0.0,0.0
1015,91,23-09-2019 14:40:00,1,2394.0,1805.0,0.754,11.432,74,52,22,30,22,5,17,0,0.0,0.0
1015,92,23-09-2019 14:42:00,1,2396.0,1814.0,0.757,11.449,59,26,8,18,33,5,28,0,0.0,0.0
1015,93,23-09-2019 14:44:00,1,2295.0,1701.0,0.741,10.927,59,32,13,19,27,5,22,0,0.0,0.0
1015,94,23-09-2019 14:46:00,1,2163.0,1700.0,0.786,10.403,78,52,27,25,26,14,12,0,0.0,0.0
1015,95,23-09-2019 14:48:00,1,3432.0,2762.0,0.805,16.579,256,136,102,34,120,94,26,66,0.0,0.0
1015,96,23-09-2019 14:50:00,1,3647.0,2994.0,0.821,17.686,229,117,88,29,112,80,32,33,0.0,0.0
1015,97,23-09-2019 14:52:00,1,4083.0,3339.0,0.818,19.782,188,111,78,33,77,53,24,37,0.0,0.0
1015,98,23-09-2019 14:54:00,1,3894.0,3098.0,0.796,18.775,115,62,37,25,53,12,41,51,0.0,0.0
1015,99,23-09-2019 14:56:00,1,3618.5,2891.0,0.7995,17.459,126,83,51,32,43,27,16,0,0.0,0.0
1015,100,23-09-2019 14:58:00,1,3343.0,2684.0,0.803,16.143,520,290,227,63,230,184,46,8,0.0,0.0
1015,101,23-09-2019 15:00:00,1,2815.0,2215.0,0.787,13.545,100,64,51,13,36,22,14,0,0.0,0.0
1015,102,23-09-2019 15:02:00,1,2604.0,2000.0,0.768,12.475,51,29,4,25,22,2,20,0,0.0,0.0
1015,103,23-09-2019 15:04:00,1,3127.0,2473.0,0.791,15.058,16,12,3,9,4,0,4,0,0.0,0.0
1015,104,23-09-2019 15:06:00,1,2395.0,1791.0,0.748,11.419,3,2,0,2,1,0,1,0,0.0,0.0
1015,105,23-09-2019 15:08:00,1,2061.0,1579.0,0.766,9.87,3,2,0,2,1,0,1,0,0.0,0.0
1015,106,23-09-2019 15:10:00,1,1842.0,1427.0,0.775,8.837,15,15,2,13,0,0,0,0,0.0,0.0
1015,107,23-09-2019 15:12:00,1,1612.0,1327.0,0.823,7.822,4,3,0,3,1,0,1,0,0.0,0.0
1015,108,23-09-2019 15:14:00,1,1734.0,1322.0,0.762,8.297,5,5,0,5,0,0,0,0,0.0,0.0
1015,109,23-09-2019 15:16:00,1,1866.0,1342.0,0.719,8.837,23,23,0,23,0,0,0,0,0.0,0.0
1015,110,23-09-2019 15:18:00,1,1854.0,1392.0,0.751,8.847,27,27,0,27,0,0,0,0,0.0,0.0
1015,111,23-09-2019 15:20:00,1,1834.0,1449.0,0.79,8.828,13,9,0,9,4,0,4,0,0.0,0.0
1015,112,23-09-2019 15:22:00,1,1815.0,1496.0,0.824,8.809,7,4,1,3,3,0,3,0,0.0,0.0
1015,113,23-09-2019 15:24:00,1,2055.0,1575.0,0.767,9.841,0,0,0,0,0,0,0,0,0.0,0.0
1015,114,23-09-2019 15:26:00,1,2180.0,1685.0,0.773,10.453,2,0,0,0,2,0,2,0,0.0,0.0
1015,115,23-09-2019 15:28:00,1,2039.0,1638.0,0.803,9.847,15,4,3,1,11,0,11,0,0.0,0.0
1015,116,23-09-2019 15:30:00,1,1952.5,1506.0,0.7695,9.3605,1,1,0,1,0,0,0,0,0.0,0.0
1015,117,23-09-2019 15:32:00,1,1866.0,1374.0,0.736,8.874,1,1,0,1,0,0,0,0,0.0,0.0
1015,118,23-09-2019 15:34:00,1,1611.0,1315.0,0.816,7.804,1,1,0,1,0,0,0,0,0.0,0.0
1015,119,23-09-2019 15:36:00,1,1731.0,1317.0,0.761,8.281,2,0,0,0,2,1,1,0,0.0,0.0
1015,120,23-09-2019 15:38:00,1,1862.0,1363.0,0.732,8.846,2,0,0,0,2,1,1,0,0.0,0.0
1015,121,23-09-2019 15:40:00,1,1848.0,1413.0,0.765,8.845,5,0,0,0,5,0,5,0,0.0,0.0
1015,122,23-09-2019 15:42:00,1,1827.0,1472.0,0.805,8.828,20,0,0,0,20,0,20,0,0.0,0.0
1015,123,23-09-2019 15:44:00,1,1827.0,1469.0,0.804,8.825,24,17,11,6,7,0,7,0,0.0,0.0
1015,124,23-09-2019 15:46:00,1,1945.0,1552.0,0.798,9.383,10,10,1,9,0,0,0,0,0.0,0.0
1015,125,23-09-2019 15:48:00,1,2069.0,1555.0,0.752,9.875,8,8,0,8,0,0,0,0,0.0,0.0
1015,126,23-09-2019 15:50:00,1,2158.0,1653.0,0.766,10.334,1,0,0,0,1,1,0,0,0.0,0.0
1015,127,23-09-2019 15:52:00,1,1827.0,1502.0,0.822,8.863,1,1,0,1,0,0,0,0,0.0,0.0
1015,128,23-09-2019 15:54:00,1,1854.0,1369.0,0.738,8.82,7,7,2,5,0,0,0,0,0.0,0.0
1015,129,23-09-2019 15:56:00,1,1854.0,1349.0,0.728,8.799,2,2,0,2,0,0,0,0,0.0,0.0
1015,130,23-09-2019 15:58:00,1,1861.0,1372.0,0.738,8.851,0,0,0,0,0,0,0,0,0.0,0.0
1015,131,23-09-2019 16:00:00,1,1850.0,1398.0,0.755,8.837,0,0,0,0,0,0,0,0,0.0,0.0
1015,132,23-09-2019 16:02:00,1,1822.0,1501.0,0.824,8.84,7,6,0,6,1,0,1,0,0.0,0.0
1015,133,23-09-2019 16:04:00,1,1947.0,1511.0,0.779,9.3435,3,3,0,3,0,0,0,0,0.0,0.0
1015,134,23-09-2019 16:06:00,1,2072.0,1521.0,0.734,9.847,1,1,0,1,0,0,0,0,0.0,0.0
1015,135,23-09-2019 16:08:00,1,2181.0,1617.0,0.741,10.382,7,7,1,6,0,0,0,0,0.0,0.0
1015,136,23-09-2019 16:10:00,1,1970.0,1432.0,0.727,9.348,3,3,0,3,0,0,0,0,0.0,0.0
1015,137,23-09-2019 16:12:00,1,1863.0,1335.0,0.717,8.817,1,1,0,1,0,0,0,0,0.0,0.0
1015,138,23-09-2019 16:14:00,1,1620.0,1272.0,0.786,7.79,1,1,0,1,0,0,0,0,0.0,0.0
1015,139,23-09-2019 16:16:00,1,1741.0,1314.0,0.755,8.313,2,2,0,2,0,0,0,0,0.0,0.0
1015,140,23-09-2019 16:18:00,1,1982.0,1375.0,0.693,9.333,0,0,0,0,0,0,0,0,0.0,0.0
1015,141,23-09-2019 16:20:00,1,1969.0,1406.0,0.714,9.316,3,2,1,1,1,0,1,0,0.0,0.0
1015,142,23-09-2019 16:22:00,1,1970.0,1433.0,0.728,9.347,9,7,2,5,2,1,1,0,0.0,0.0
1015,143,23-09-2019 16:24:00,1,1994.0,1357.0,0.681,9.359,0,0,0,0,0,0,0,0,0.0,0.0
1015,144,23-09-2019 16:26:00,1,1979.0,1366.0,0.69,9.311,0,0,0,0,0,0,0,0,0.0,0.0
1015,145,23-09-2019 16:28:00,1,1985.0,1345.0,0.678,9.312,1,1,1,0,0,0,0,0,0.0,0.0
1015,146,23-09-2019 16:30:00,1,1747.0,1307.0,0.748,8.33,1,0,0,0,1,1,0,0,0.0,0.0
1015,147,23-09-2019 16:32:00,1,1863.0,1310.0,0.703,8.791,5,0,0,0,5,1,4,0,0.0,0.0
1015,148,23-09-2019 16:34:00,1,1982.0,1360.0,0.686,9.316,49,39,18,21,10,4,6,0,0.0,0.0
1015,149,23-09-2019 16:36:00,1,2064.0,1547.0,0.749,9.844,37,30,2,28,7,0,7,0,0.0,0.0
1015,150,23-09-2019 16:38:00,1,2917.5,2308.5,0.7815,14.051,121,77,42,35,44,20,24,20,0.0,0.0
1015,151,23-09-2019 16:40:00,1,3771.0,3070.0,0.814,18.258,282,138,114,24,144,116,28,104,0.0,0.0
1015,152,23-09-2019 16:42:00,1,3465.0,2674.0,0.772,16.612,180,113,87,26,67,48,19,50,0.0,0.0
1015,153,23-09-2019 16:44:00,1,2731.0,1997.0,0.731,12.97,117,72,50,22,45,25,20,36,0.0,0.0
1015,154,23-09-2019 16:46:00,1,4097.0,3299.0,0.805,19.793,357,169,129,40,188,154,34,83,0.0,0.0
1015,155,23-09-2019 16:48:00,1,3680.0,2838.0,0.771,17.641,159,71,43,28,88,44,44,42,0.0,0.0
1015,156,23-09-2019 16:50:00,1,4023.0,3067.0,0.762,19.247,103,48,26,22,55,4,51,43,0.0,0.0
1015,157,23-09-2019 16:52:00,1,4115.0,3203.0,0.778,19.762,101,47,25,22,54,3,51,48,0.0,0.0
1015,158,23-09-2019 16:54:00,1,4010.0,3126.0,0.78,19.261,79,35,20,15,44,9,35,55,0.0,0.0
1015,159,23-09-2019 16:56:00,1,3252.0,2525.0,0.777,15.607,109,81,55,26,28,6,22,11,0.0,0.0
1015,160,23-09-2019 16:58:00,1,2396.0,1816.0,0.758,11.453,19,11,5,6,8,1,7,0,0.0,0.0
1015,161,23-09-2019 17:00:00,1,1941.0,1521.0,0.783,9.333,51,35,11,24,16,1,15,0,0.0,0.0
1015,162,23-09-2019 17:02:00,1,1990.0,1402.0,0.704,9.392,37,32,3,29,5,2,3,0,0.0,0.0
1015,163,23-09-2019 17:04:00,1,1952.0,1511.0,0.774,9.365,79,70,30,40,9,2,7,0,0.0,0.0
1015,164,23-09-2019 17:06:00,1,3344.0,2655.0,0.794,16.113,257,126,102,24,131,100,31,50,0.0,0.0
1015,165,23-09-2019 17:08:00,1,3216.0,2653.0,0.825,15.609,6,2,1,1,4,0,4,0,0.0,0.0
1015,166,23-09-2019 17:10:00,1,2483.0,1937.0,0.78,11.926,2,0,0,0,2,0,2,0,0.0,0.0
1015,167,23-09-2019 17:12:00,1,2324.0,1819.5,0.783,11.17,0,0,0,0,0,0,0,0,0.0,0.0
1015,168,23-09-2019 17:14:00,1,2165.0,1702.0,0.786,10.414,0,0,0,0,0,0,0,0,0.0,0.0
1015,169,23-09-2019 17:16:00,1,2177.0,1669.0,0.767,10.425,1,1,0,1,0,0,0,0,0.0,0.0
1015,170,23-09-2019 17:18:00,1,2175.0,1672.0,0.768,10.422,0,0,0,0,0,0,0,0,0.0,0.0
1015,171,23-09-2019 17:20:00,1,1938.0,1516.0,0.783,9.313,28,14,5,9,14,0,14,0,0.0,0.0
1015,172,23-09-2019 17:22:00,1,1967.0,1473.0,0.749,9.38,0,0,0,0,0,0,0,0,0.0,0.0
1015,173,23-09-2019 17:24:00,1,1953.0,1482.0,0.759,9.338,16,8,5,3,8,0,8,0,0.0,0.0
1015,174,23-09-2019 17:26:00,1,1962.0,1510.0,0.77,9.401,1,0,0,0,1,0,1,0,0.0,0.0
1015,175,23-09-2019 17:28:00,1,1927.0,1582.0,0.821,9.346,9,0,0,0,9,0,9,0,0.0,0.0
1015,176,23-09-2019 17:30:00,1,1915.0,1649.0,0.861,9.373,3,0,0,0,3,0,3,0,0.0,0.0
1015,177,23-09-2019 17:32:00,1,1904.0,1631.0,0.856,9.307,37,21,11,10,16,0,16,0,0.0,0.0
1015,178,23-09-2019 17:34:00,1,1924.0,1614.0,0.839,9.369,0,0,0,0,0,0,0,0,0.0,0.0
1015,179,23-09-2019 17:36:00,1,1936.0,1583.0,0.818,9.381,2,2,0,2,0,0,0,0,0.0,0.0
1015,180,23-09-2019 17:38:00,1,1940.0,1551.0,0.8,9.361,3,3,0,3,0,0,0,0,0.0,0.0
1015,181,23-09-2019 17:40:00,1,1963.0,1459.0,0.743,9.349,0,0,0,0,0,0,0,0,0.0,0.0
1015,182,23-09-2019 17:42:00,1,1843.0,1432.0,0.777,8.846,0,0,0,0,0,0,0,0,0.0,0.0
1015,183,23-09-2019 17:44:00,1,1833.0,1439.0,0.785,8.816,2,2,0,2,0,0,0,0,0.0,0.0
1015,184,23-09-2019 17:46:00,1,1885.0,1504.0,0.7975,9.0935,5,5,0,5,0,0,0,0,0.0,0.0
1015,185,23-09-2019 17:48:00,1,1937.0,1569.0,0.81,9.371,17,12,4,8,5,3,2,0,0.0,0.0
1015,186,23-09-2019 17:50:00,1,2036.0,1615.0,0.793,9.809,36,20,2,18,16,0,16,0,0.0,0.0
1015,187,23-09-2019 17:52:00,1,2139.0,1734.0,0.811,10.35,64,42,21,21,22,0,22,0,0.0,0.0
1015,188,23-09-2019 17:54:00,1,3245.0,2589.0,0.798,15.65,41,22,4,18,19,0,19,0,0.0,0.0
1015,189,23-09-2019 17:56:00,1,3233.0,2574.0,0.796,15.587,19,9,0,9,10,2,8,0,0.0,0.0
1015,190,23-09-2019 17:58:00,1,3221.0,2561.0,0.795,15.527,224,139,103,36,85,45,40,43,0.0,0.0
1015,191,23-09-2019 18:00:00,0,3001.0,2510.0,0.836,14.602,439,186,150,36,253,204,49,84,0.0,0.0
1015,192,23-09-2019 18:02:00,0,3412.0,2864.0,0.839,16.613,727,385,312,73,342,275,67,121,0.0,0.0
1015,193,23-09-2019 18:04:00,0,3235.0,2632.0,0.814,15.659,584,264,202,62,320,265,55,144,0.0,0.03
1015,194,23-09-2019 18:06:00,0,3000.0,2376.0,0.792,14.45,309,157,113,44,152,107,45,40,0.0,0.0
1015,195,23-09-2019 18:08:00,0,3569.0,2763.0,0.774,17.122,421,226,180,46,195,140,55,98,0.0,0.0
1015,196,23-09-2019 18:10:00,0,4086.0,3363.0,0.823,19.82,189,77,58,19,112,68,44,82,0.0,0.0
1015,197,23-09-2019 18:12:00,0,3994.0,3168.0,0.793,19.245,235,112,77,35,123,83,40,71,0.0,0.0
1015,198,23-09-2019 18:14:00,0,2592.0,2045.0,0.789,12.477,362,204,155,49,158,129,29,163,0.0,0.0
1015,199,23-09-2019 18:16:00,0,3982.0,3201.0,0.804,19.233,276,133,90,43,143,96,47,95,0.0,0.0
1015,200,23-09-2019 18:18:00,0,4083.0,3312.0,0.811,19.756,166,81,53,28,85,30,55,76,0.0,0.0
1015,201,23-09-2019 18:20:00,0,3338.0,2674.0,0.798,16.113,147,86,55,31,61,27,34,40,0.0,0.0
1015,202,23-09-2019 18:22:00,0,2593.0,2036.0,0.785,12.47,283,164,129,35,119,87,32,103,0.0,0.02
1015,203,23-09-2019 18:24:00,0,3003.0,2457.0,0.818,14.555,275,163,121,42,112,79,33,71,0.08,0.0
1015,204,23-09-2019 18:26:00,0,3773.0,2977.0,0.789,18.161,348,158,128,30,190,143,47,87,0.0,0.0
1015,205,23-09-2019 18:28:00,0,3218.0,2604.0,0.809,15.563,95,65,26,39,30,2,28,1,0.0,0.0
1015,206,23-09-2019 18:30:00,0,2511.0,1879.0,0.748,11.976,31,24,10,14,7,2,5,0,0.0,0.0
1015,207,23-09-2019 18:32:00,0,3044.0,2319.0,0.762,14.562,57,36,10,26,21,4,17,0,0.0,0.0
1015,208,23-09-2019 18:34:00,0,3446.0,2732.0,0.793,16.601,20,13,5,8,7,2,5,0,0.0,0.0
1015,209,23-09-2019 18:36:00,0,2690.0,2150.0,0.799,12.98,17,15,7,8,2,0,2,0,0.0,0.0
1015,210,23-09-2019 18:38:00,0,2715.0,2071.0,0.763,12.99,3,1,0,1,2,1,1,0,0.0,0.0
1015,211,23-09-2019 18:40:00,0,2607.0,2029.0,0.778,12.519,0,0,0,0,0,0,0,0,0.0,0.0
1015,212,23-09-2019 18:42:00,0,2695.0,2097.0,0.778,12.941,38,20,14,6,18,10,8,2,0.0,0.0
1015,213,23-09-2019 18:44:00,0,3571.0,2807.0,0.786,17.177,274,137,103,34,137,93,44,49,0.0,0.0
1015,214,23-09-2019 18:46:00,0,2680.0,2187.0,0.816,12.98,53,28,10,18,25,6,19,0,0.0,0.0
1015,215,23-09-2019 18:48:00,0,2054.0,1642.0,0.799,9.912,52,31,12,19,21,2,19,0,0.0,0.0
1015,216,23-09-2019 18:50:00,0,3023.0,2400.0,0.794,14.569,331,183,141,42,148,118,30,114,0.0,0.0
1015,217,23-09-2019 18:52:00,0,4297.0,3482.0,0.81,20.787,251,116,88,28,135,93,42,112,0.0,0.01
1015,218,23-09-2019 18:54:00,0,4038.0,3226.5,0.798,19.4825,478,214,160,54,264,193,71,110,0.06,0.0
1015,219,23-09-2019 18:56:00,0,3779.0,2971.0,0.786,18.178,195,108,67,41,87,47,40,60,0.0,0.0
1015,220,23-09-2019 18:58:00,0,3328.0,2709.0,0.814,16.112,330,160,122,38,170,126,44,103,0.0,0.0
1015,221,23-09-2019 19:00:00,0,3876.0,3131.0,0.808,18.739,249,148,110,38,101,72,29,162,0.0,0.0
1015,222,23-09-2019 19:02:00,0,3209.0,2671.0,0.832,15.599,443,227,181,46,216,168,48,169,0.0,0.0
1015,223,23-09-2019 19:04:00,0,3757.0,3059.0,0.814,18.19,467,223,178,45,244,193,51,111,0.0,0.0
1015,224,23-09-2019 19:06:00,0,4051.0,3361.0,0.83,19.683,124,48,34,14,76,37,39,12,0.0,0.0
1015,225,23-09-2019 19:08:00,0,4069.0,3388.0,0.833,19.785,588,290,241,49,298,234,64,129,0.0,0.0
1015,226,23-09-2019 19:10:00,0,3776.0,3002.0,0.795,18.201,433,193,145,48,240,187,53,141,0.0,0.01
1015,227,23-09-2019 19:12:00,0,3538.0,2854.0,0.807,17.099,326,168,122,46,158,118,40,28,0.0,0.0
1015,228,23-09-2019 19:14:00,0,3966.0,3210.0,0.809,19.181,375,189,137,52,186,135,51,65,0.0,0.0
1015,229,23-09-2019 19:16:00,0,4094.0,3294.0,0.805,19.778,144,73,41,32,71,17,54,51,0.0,0.0
1015,230,23-09-2019 19:18:00,0,4320.0,3433.0,0.795,20.823,208,105,69,36,103,61,42,66,0.0,0.0
1015,231,23-09-2019 19:20:00,0,4079.0,3325.0,0.815,19.753,140,90,64,26,50,24,26,46,0.0,0.03
1015,232,23-09-2019 19:22:00,0,3971.0,3178.0,0.8,19.164,434,229,177,52,205,152,53,129,0.0,0.01
1015,233,23-09-2019 19:24:00,0,4103.0,3239.0,0.79,19.752,101,60,31,29,41,6,35,35,0.0,0.02
1015,234,23-09-2019 19:26:00,0,3671.0,2945.0,0.802,17.724,376,210,176,34,166,134,32,119,0.0,0.0
1015,235,23-09-2019 19:28:00,0,3867.5,3109.5,0.804,18.6805,493,147,103,44,346,299,47,98,0.0,0.0
1015,236,23-09-2019 19:30:00,0,4064.0,3274.0,0.806,19.637,336,65,45,20,271,244,27,50,0.0,0.02
1015,237,23-09-2019 19:32:00,0,4070.0,3448.0,0.847,19.854,341,74,50,24,267,243,24,72,0.0,0.0
1015,238,23-09-2019 19:34:00,0,4074.0,3368.0,0.827,19.78,205,74,39,35,131,118,13,13,0.0,0.03
1015,239,23-09-2019 19:36:00,0,3729.0,3097.0,0.831,18.124,213,46,23,23,167,149,18,6,0.1,0.01
1015,240,23-09-2019 19:38:00,0,3421.0,2830.0,0.827,16.613,511,205,166,39,306,285,21,73,0.0,0.0
1015,241,23-09-2019 19:40:00,0,3854.0,3238.0,0.84,18.771,313,56,39,17,257,254,3,65,0.0,0.0
1015,242,23-09-2019 19:42:00,0,3944.0,3337.0,0.846,19.235,220,76,45,31,144,136,8,4,0.06,0.03
1015,243,23-09-2019 19:44:00,0,2955.0,2585.0,0.875,14.505,225,79,49,30,146,134,12,57,0.0,0.0
1015,244,23-09-2019 19:46:00,0,3502.0,2956.0,0.844,17.068,228,97,62,35,131,118,13,24,0.0,0.01
1015,245,23-09-2019 19:48:00,0,3818.0,3346.0,0.876,18.746,580,207,160,47,373,327,46,86,0.0,0.01
1015,246,23-09-2019 19:50:00,0,3603.0,3129.0,0.868,17.659,202,67,37,30,135,126,9,2,0.0,0.0
1015,247,23-09-2019 19:52:00,0,3004.0,2470.0,0.822,14.569,209,87,47,40,122,113,9,0,0.01,0.01
1015,248,23-09-2019 19:54:00,0,2987.0,2532.0,0.848,14.573,374,126,89,37,248,221,27,39,0.0,0.05
1015,249,23-09-2019 19:56:00,0,3987.0,3598.0,0.902,19.693,558,202,168,34,356,313,43,148,0.0,0.0
1015,250,23-09-2019 19:58:00,0,4026.0,3516.0,0.873,19.756,360,77,46,31,283,269,14,70,0.0,0.0
1015,251,23-09-2019 20:00:00,0,3998.0,3596.0,0.9,19.732,267,15,7,8,252,250,2,30,0.0,0.0
1015,252,23-09-2019 20:02:00,0,3379.5,3010.0,0.889,16.647,185,31,18,13,154,153,1,28,0.0,0.0
1015,253,23-09-2019 20:04:00,0,2761.0,2424.0,0.878,13.562,292,123,94,29,169,152,17,46,0.0,0.0
1015,254,23-09-2019 20:06:00,0,3718.0,3173.0,0.854,18.162,583,261,206,55,322,276,46,94,0.0,0.0
1015,255,23-09-2019 20:08:00,0,4510.0,4090.0,0.907,22.296,289,128,98,30,161,97,64,62,0.01,0.0
1015,256,23-09-2019 20:10:00,0,4220.0,3772.0,0.894,20.802,107,70,44,26,37,9,28,37,0.0,0.0
1015,257,23-09-2019 20:12:00,0,3715.0,3303.0,0.889,18.296,83,53,24,29,30,13,17,9,0.0,0.0
1015,258,23-09-2019 20:14:00,0,3668.0,3393.0,0.925,18.207,324,192,143,49,132,67,65,47,0.0,0.0
1015,259,23-09-2019 20:16:00,0,3611.0,3161.0,0.875,17.726,102,27,12,15,75,0,75,37,0.0,0.0
1015,260,23-09-2019 20:18:00,0,4015.0,3520.0,0.877,19.716,124,44,27,17,80,1,79,68,0.0,0.0
1015,261,23-09-2019 20:20:00,0,3502.0,3044.0,0.869,17.168,98,64,32,32,34,8,26,12,0.0,0.0
1015,262,23-09-2019 20:22:00,0,3692.0,3318.0,0.899,18.221,438,209,165,44,229,168,61,48,0.0,0.0
1015,263,23-09-2019 20:24:00,0,3474.0,3094.0,0.891,17.111,291,116,96,20,175,128,47,125,0.05,0.0
1015,264,23-09-2019 20:26:00,0,3918.0,3519.0,0.898,19.333,193,102,80,22,91,39,52,75,0.01,0.0
1015,265,23-09-2019 20:28:00,0,4246.0,3682.0,0.867,20.804,129,79,50,29,50,2,48,56,0.0,0.0
1015,266,23-09-2019 20:30:00,0,4117.0,3686.0,0.895,20.303,158,53,29,24,105,35,70,34,0.1,0.03
1015,267,23-09-2019 20:32:00,0,3513.0,3015.0,0.858,17.177,123,71,38,33,52,22,30,3,0.0,0.0
1015,268,23-09-2019 20:34:00,0,4226.0,3784.0,0.895,20.841,378,223,169,54,155,119,36,101,0.0,0.0
1015,269,23-09-2019 20:36:00,0,4229.5,3793.5,0.8965,20.865,113,41,24,17,72,13,59,30,0.0,0.0
1015,270,23-09-2019 20:38:00,0,4233.0,3803.0,0.898,20.889,123,34,23,11,89,33,56,35,0.0,0.02
1015,271,23-09-2019 20:40:00,0,3490.0,3083.0,0.883,17.165,59,29,19,10,30,15,15,0,0.0,0.01
1015,272,23-09-2019 20:42:00,0,2967.0,2605.0,0.878,14.572,1,0,0,0,1,1,0,0,0.0,0.0
1015,273,23-09-2019 20:44:00,0,2429.0,2170.0,0.894,11.971,5,3,1,2,2,0,2,0,0.0,0.0
1015,274,23-09-2019 20:46:00,0,2456.0,2093.0,0.852,11.994,11,5,2,3,6,2,4,0,0.0,0.0
1015,275,23-09-2019 20:48:00,0,2452.0,2075.0,0.846,11.957,8,4,2,2,4,2,2,0,0.0,0.0
1015,276,23-09-2019 20:50:00,0,2462.0,2011.0,0.816,11.928,5,4,0,4,1,0,1,0,0.0,0.0
1015,277,23-09-2019 20:52:00,0,2226.0,1963.0,0.882,10.945,7,5,0,5,2,0,2,0,0.0,0.01
1015,278,23-09-2019 20:54:00,0,2117.0,1861.0,0.879,10.401,21,17,6,11,4,2,2,0,0.0,0.01
1015,279,23-09-2019 20:56:00,0,2462.0,2017.0,0.819,11.934,0,0,0,0,0,0,0,0,0.0,0.0
1015,280,23-09-2019 20:58:00,0,1875.0,1774.0,0.946,9.353,1,0,0,0,1,1,0,0,0.0,0.0
1015,281,23-09-2019 21:00:00,0,2017.0,1774.0,0.88,9.91,9,8,1,7,1,0,1,0,0.0,0.0
1015,282,23-09-2019 21:02:00,0,1905.0,1701.0,0.893,9.39,6,4,0,4,2,0,2,0,0.0,0.0
1015,283,23-09-2019 21:04:00,0,2750.0,2366.0,0.86,13.455,276,141,110,31,135,81,54,40,0.0,0.0
1015,284,23-09-2019 21:06:00,0,3471.0,3079.0,0.887,17.086,181,79,56,23,102,37,65,81,0.0,0.0
1015,285,23-09-2019 21:08:00,0,3742.0,3150.0,0.842,18.233,130,64,39,25,66,34,32,55,0.0,0.0
1015,286,23-09-2019 21:10:00,0,3722.5,3219.0,0.865,18.232,105,38,26,12,67,4,63,44,0.0,0.0
1015,287,23-09-2019 21:12:00,0,3703.0,3288.0,0.888,18.231,286,135,96,39,151,95,56,42,0.1,0.07
1015,288,23-09-2019 21:14:00,0,3821.0,3362.0,0.88,18.778,266,141,108,33,125,66,59,79,0.0,0.01
1015,289,23-09-2019 21:16:00,0,3671.0,3363.0,0.916,18.186,75,26,13,13,49,13,36,27,0.04,0.0
1015,290,23-09-2019 21:18:00,0,3775.0,3469.0,0.919,18.714,590,258,199,59,332,254,78,117,0.0,0.01
1015,291,23-09-2019 21:20:00,0,3265.0,2984.0,0.914,16.167,515,293,227,66,222,169,53,109,0.0,0.0
1015,292,23-09-2019 21:22:00,0,3599.0,3161.0,0.878,17.682,571,281,229,52,290,226,64,108,0.0,0.0
1015,293,23-09-2019 21:24:00,0,4214.0,3788.0,0.899,20.797,197,85,51,34,112,47,65,76,0.0,0.0
1015,294,23-09-2019 21:26:00,0,4107.0,3701.0,0.901,20.281,116,70,42,28,46,3,43,44,0.0,0.01
1015,295,23-09-2019 21:28:00,0,3064.0,2756.0,0.899,15.124,382,209,160,49,173,137,36,95,0.0,0.02
1015,296,23-09-2019 21:30:00,0,4012.0,3603.0,0.898,19.796,124,47,31,16,77,17,60,59,0.0,0.0
1015,297,23-09-2019 21:32:00,0,4221.0,3838.0,0.909,20.881,86,16,9,7,70,2,68,41,0.0,0.0
1015,298,23-09-2019 21:34:00,0,4222.0,3803.0,0.901,20.845,105,41,23,18,64,2,62,57,0.01,0.0
1015,299,23-09-2019 21:36:00,0,4178.0,3836.0,0.918,20.706,210,51,28,23,159,82,77,33,0.18,0.11
1015,300,23-09-2019 21:38:00,0,3994.0,3610.0,0.904,19.733,130,53,27,26,77,33,44,14,0.0,0.02
1015,301,23-09-2019 21:40:00,0,3499.0,3040.0,0.869,17.152,419,245,194,51,174,134,40,92,0.03,0.01
1015,302,23-09-2019 21:42:00,0,4773.0,4567.0,0.957,23.861,350,189,146,43,161,120,41,106,0.0,0.01
1015,303,23-09-2019 21:44:00,0,4488.5,4172.5,0.928,22.3045,499,235,179,56,264,211,53,126,0.0,0.0
1015,304,23-09-2019 21:46:00,0,4204.0,3778.0,0.899,20.748,73,7,3,4,66,0,66,30,0.0,0.0
1015,305,23-09-2019 21:48:00,0,3996.0,3645.0,0.912,19.778,97,28,9,19,69,2,67,55,0.0,0.0
1015,306,23-09-2019 21:50:00,0,4230.0,3871.0,0.915,20.952,84,18,14,4,66,0,66,60,0.0,0.07
1015,307,23-09-2019 21:52:00,0,3948.0,3692.0,0.935,19.641,128,13,4,9,115,64,51,22,0.13,0.07
1015,308,23-09-2019 21:54:00,0,3631.0,3484.0,0.959,18.162,307,161,111,50,146,103,43,15,0.0,0.01
1015,309,23-09-2019 21:56:00,0,4203.0,3891.0,0.926,20.869,440,245,192,53,195,144,51,101,0.01,0.0
1015,310,23-09-2019 21:58:00,0,3856.0,3578.0,0.928,19.155,435,175,130,45,260,203,57,109,0.06,0.0
1015,311,23-09-2019 22:00:00,0,3956.0,3768.0,0.953,19.757,341,200,157,43,141,103,38,80,0.0,0.01
1015,312,23-09-2019 22:02:00,0,3995.0,3663.0,0.917,19.795,401,202,160,42,199,151,48,107,0.0,0.0
1015,313,23-09-2019 22:04:00,0,3947.0,3804.0,0.964,19.762,157,57,35,22,100,29,71,49,0.0,0.0
1015,314,23-09-2019 22:06:00,0,3997.0,3671.0,0.918,19.813,81,21,6,15,60,0,60,42,0.0,0.0
1015,315,23-09-2019 22:08:00,0,4175.0,3880.0,0.929,20.744,150,82,57,25,68,10,58,54,0.0,0.05
1015,316,23-09-2019 22:10:00,0,3974.0,3701.0,0.931,19.755,122,29,16,13,93,31,62,37,0.01,0.07
1015,317,23-09-2019 22:12:00,0,3996.0,3740.0,0.936,19.885,146,55,34,21,91,45,46,7,0.1,0.01
1015,318,23-09-2019 22:14:00,0,2913.0,2754.0,0.945,14.526,352,175,135,40,177,122,55,58,0.0,0.0
1015,319,23-09-2019 22:16:00,0,3980.0,3735.0,0.938,19.817,464,239,180,59,225,167,58,94,0.0,0.03
1015,320,23-09-2019 22:18:00,0,3989.0,3684.5,0.9235,19.7965,260,124,88,36,136,98,38,114,0.03,0.0
1015,321,23-09-2019 22:20:00,0,3998.0,3634.0,0.909,19.776,152,82,52,30,70,47,23,20,0.0,0.0
1015,322,23-09-2019 22:22:00,0,4161.0,4019.0,0.966,20.841,449,244,195,49,205,165,40,65,0.0,0.0
1015,323,23-09-2019 22:24:00,0,3966.0,3741.0,0.943,19.769,98,30,15,15,68,6,62,47,0.0,0.0
1015,324,23-09-2019 22:26:00,0,3952.0,3782.0,0.957,19.759,107,42,28,14,65,4,61,38,0.0,0.0
1015,325,23-09-2019 22:28:00,0,3972.0,3796.0,0.956,19.851,92,39,25,14,53,0,53,38,0.0,0.0
1015,326,23-09-2019 22:30:00,0,3985.0,3621.0,0.909,19.71,108,40,21,19,68,2,66,43,0.0,0.11
1015,327,23-09-2019 22:32:00,0,3979.0,3657.0,0.919,19.726,156,48,29,19,108,44,64,30,0.13,0.07
1015,328,23-09-2019 22:34:00,0,3995.0,3769.0,0.943,19.914,571,259,201,58,312,248,64,26,0.0,0.0
1015,329,23-09-2019 22:36:00,0,3655.0,3401.0,0.931,18.168,119,53,33,20,66,32,34,66,0.03,0.0
1015,330,23-09-2019 22:38:00,0,4461.0,4376.0,0.981,22.42,298,192,145,47,106,82,24,71,0.0,0.0
1015,331,23-09-2019 22:40:00,0,3982.0,3745.0,0.94,19.835,367,178,140,38,189,141,48,163,0.09,0.0
1015,332,23-09-2019 22:42:00,0,4170.0,3930.0,0.942,20.782,474,245,200,45,229,174,55,122,0.0,0.02
1015,333,23-09-2019 22:44:00,0,3647.0,3425.0,0.939,18.16,372,192,142,50,180,144,36,130,0.0,0.0
1015,334,23-09-2019 22:46:00,0,4276.0,4111.0,0.962,21.397,372,199,151,48,173,124,49,85,0.01,0.0
1015,335,23-09-2019 22:48:00,0,2934.0,2748.0,0.937,14.603,87,41,16,25,46,17,29,0,0.0,0.0
1015,336,23-09-2019 22:50:00,0,2614.0,2386.0,0.913,12.943,125,60,23,37,65,33,32,0,0.0,0.0
1015,337,23-09-2019 22:52:00,0,3654.5,3432.0,0.9335,18.1995,309,162,124,38,147,115,32,64,0.0,0.03
1015,338,23-09-2019 22:54:00,0,4695.0,4478.0,0.954,23.456,106,15,10,5,91,42,49,6,0.0,0.0
1015,339,23-09-2019 22:56:00,0,4265.0,4062.0,0.952,21.302,76,16,11,5,60,21,39,21,0.0,0.0
1015,340,23-09-2019 22:58:00,0,4153.0,3908.0,0.941,20.688,136,37,24,13,99,31,68,66,0.0,0.0
1015,341,23-09-2019 23:00:00,0,4268.0,4101.0,0.961,21.356,133,38,20,18,95,28,67,44,0.0,0.0
1015,342,23-09-2019 23:02:00,0,4143.0,4104.0,0.991,20.864,364,141,106,35,223,167,56,25,0.02,0.0
1015,343,23-09-2019 23:04:00,0,3950.0,3773.0,0.955,19.741,239,124,96,28,115,85,30,95,0.03,0.0
1015,344,23-09-2019 23:06:00,0,4152.0,4003.0,0.964,20.788,122,30,15,15,92,33,59,64,0.0,0.0
1015,345,23-09-2019 23:08:00,0,4161.0,4035.0,0.97,20.86,210,91,64,27,119,75,44,72,0.0,0.0
1015,346,23-09-2019 23:10:00,0,3011.0,2904.0,0.964,15.076,142,74,50,24,68,46,22,7,0.01,0.02
1015,347,23-09-2019 23:12:00,0,3466.0,3228.0,0.931,17.232,162,49,29,20,113,39,74,57,0.0,0.0
1015,348,23-09-2019 23:14:00,0,4158.0,4032.0,0.97,20.847,173,63,47,16,110,61,49,14,0.0,0.02
1015,349,23-09-2019 23:16:00,0,3239.0,3083.0,0.952,16.175,64,24,21,3,40,23,17,1,0.0,0.0
1015,350,23-09-2019 23:18:00,0,3437.0,3313.0,0.964,17.211,74,18,13,5,56,29,27,0,0.0,0.0
1015,351,23-09-2019 23:20:00,0,2720.0,2578.0,0.948,13.572,10,0,0,0,10,3,7,0,0.0,0.01
1015,352,23-09-2019 23:22:00,0,2950.0,2666.0,0.904,14.573,8,0,0,0,8,2,6,0,0.0,0.0
1015,353,23-09-2019 23:24:00,0,3122.0,2983.0,0.955,15.603,38,19,10,9,19,10,9,0,0.0,0.02
1015,354,23-09-2019 23:26:00,0,3361.5,3346.5,0.9925,16.948,41,21,12,9,20,8,12,5,0.0,0.0
1015,355,23-09-2019 23:28:00,0,3601.0,3710.0,1.03,18.293,505,258,221,37,247,183,64,70,0.0,0.0
1015,356,23-09-2019 23:30:00,0,3621.0,3522.0,0.973,18.165,402,205,154,51,197,148,49,59,0.02,0.01
1015,357,23-09-2019 23:32:00,0,3641.0,3505.0,0.963,18.224,362,168,138,30,194,134,60,126,0.0,0.0
1015,358,23-09-2019 23:34:00,0,3746.0,3644.0,0.973,18.793,118,26,12,14,92,20,72,55,0.0,0.0
1015,359,23-09-2019 23:36:00,0,3421.0,3335.0,0.975,17.172,130,47,23,24,83,31,52,53,0.0,0.0
1015,360,23-09-2019 23:38:00,0,3615.0,3593.0,0.994,18.219,112,32,22,10,80,30,50,47,0.0,0.0
1015,361,23-09-2019 23:40:00,0,3627.0,3425.0,0.944,18.082,35,20,8,12,15,6,9,5,0.0,0.31
1015,362,23-09-2019 23:42:00,0,2442.0,2152.0,0.882,12.003,11,3,0,3,8,0,8,0,0.0,0.03
1015,363,23-09-2019 23:44:00,0,2188.0,2073.0,0.948,10.916,454,203,156,47,251,192,59,15,0.06,0.0
1015,364,23-09-2019 23:46:00,0,4146.0,4044.0,0.975,20.81,573,308,257,51,265,206,59,123,0.08,0.0
1015,365,23-09-2019 23:48:00,0,4155.0,4032.0,0.97,20.836,396,180,140,40,216,160,56,71,0.0,0.0
1015,366,23-09-2019 23:50:00,0,3855.0,3669.0,0.952,19.25,341,174,128,46,167,124,43,26,0.02,0.01
1015,367,23-09-2019 23:52:00,0,4276.0,4124.0,0.965,21.411,353,151,113,38,202,147,55,88,0.06,0.0
1015,368,23-09-2019 23:54:00,0,3666.0,3418.0,0.932,18.229,271,133,96,37,138,93,45,0,0.0,0.0
1015,369,23-09-2019 23:56:00,0,4050.0,3951.0,0.976,20.329,2,0,0,0,2,1,1,0,0.0,0.0
1015,370,23-09-2019 23:58:00,0,4438.0,4363.0,0.983,22.316,337,108,65,43,229,165,64,6,0.0,0.0
1015,371,24-09-2019 00:00:00,0,4466.5,4325.0,0.9685,22.3855,217,115,65,50,102,68,34,3,0.11,0.0
1015,372,24-09-2019 00:02:00,0,4495.0,4287.0,0.954,22.455,309,133,85,48,176,122,54,15,0.0,0.0
1015,373,24-09-2019 00:04:00,0,4181.0,3903.0,0.934,20.794,488,219,159,60,269,210,59,86,0.01,0.07
1015,374,24-09-2019 00:06:00,0,3737.0,3647.0,0.976,18.761,411,171,121,50,240,178,62,9,0.02,0.0
1015,375,24-09-2019 00:08:00,0,3047.0,2799.0,0.919,15.103,286,150,99,51,136,85,51,4,0.0,0.0
1015,376,24-09-2019 00:10:00,0,3787.0,3445.0,0.91,18.734,176,81,46,35,95,62,33,1,0.0,0.0
1015,377,24-09-2019 00:12:00,0,4777.0,4586.0,0.96,23.9,277,109,65,44,168,118,50,2,0.0,0.0
1015,378,24-09-2019 00:14:00,0,5003.0,4764.0,0.952,24.987,285,136,88,48,149,103,46,9,0.09,0.0
1015,379,24-09-2019 00:16:00,0,4643.0,4309.0,0.928,23.065,242,129,84,45,113,73,40,6,0.0,0.0
1015,380,24-09-2019 00:18:00,0,4372.0,4134.0,0.946,21.802,182,75,41,34,107,50,57,55,0.0,0.0
1015,381,24-09-2019 00:20:00,0,4823.0,4418.0,0.916,23.894,109,43,24,19,66,12,54,43,0.0,0.0
1015,382,24-09-2019 00:22:00,0,4593.0,4286.0,0.933,22.84,200,110,65,45,90,50,40,22,0.05,0.0
1015,383,24-09-2019 00:24:00,0,3473.0,3117.0,0.897,17.135,206,114,74,40,92,62,30,3,0.0,0.0
1015,384,24-09-2019 00:26:00,0,3356.0,3054.0,0.91,16.602,322,159,109,50,163,111,52,8,0.05,0.0
1015,385,24-09-2019 00:28:00,0,5009.0,4833.0,0.965,25.084,236,101,64,37,135,77,58,35,0.0,0.0
1015,386,24-09-2019 00:30:00,0,4517.0,4091.0,0.906,22.325,128,54,27,27,74,6,68,63,0.01,0.0
1015,387,24-09-2019 00:32:00,0,4618.0,4191.0,0.907,22.836,114,39,20,19,75,9,66,60,0.0,0.0
1015,388,24-09-2019 00:34:00,0,4055.0,3643.0,0.8965,20.01,173,111,74,37,62,29,33,38,0.0,0.04
1015,389,24-09-2019 00:36:00,0,3492.0,3095.0,0.886,17.184,218,108,72,36,110,68,42,16,0.12,0.0
1015,390,24-09-2019 00:38:00,0,4780.0,4606.0,0.964,23.932,163,79,40,39,84,45,39,32,0.0,0.01
1015,391,24-09-2019 00:40:00,0,4817.0,4474.0,0.929,23.93,193,93,50,43,100,66,34,17,0.0,0.0
1015,392,24-09-2019 00:42:00,0,4779.0,4566.0,0.956,23.884,318,156,107,49,162,116,46,3,0.0,0.0
1015,393,24-09-2019 00:44:00,0,4069.0,3843.0,0.944,20.285,307,148,90,58,159,103,56,27,0.05,0.0
1015,394,24-09-2019 00:46:00,0,4197.0,3843.0,0.916,20.789,176,94,73,21,82,31,51,55,0.0,0.0
1015,395,24-09-2019 00:48:00,0,4836.0,4390.0,0.908,23.916,211,108,70,38,103,45,58,37,0.0,0.02
1015,396,24-09-2019 00:50:00,0,4296.0,4047.0,0.942,21.407,254,114,76,38,140,98,42,17,0.0,0.01
1015,397,24-09-2019 00:52:00,0,3577.0,3192.0,0.893,17.626,268,92,59,33,176,120,56,2,0.0,0.0
1015,398,24-09-2019 00:54:00,0,2528.0,2253.0,0.891,12.454,282,152,101,51,130,91,39,11,0.0,0.0
1015,399,24-09-2019 00:56:00,0,4624.0,4258.0,0.921,22.932,156,70,45,25,86,31,55,57,0.01,0.0
1015,400,24-09-2019 00:58:00,0,5144.0,4878.0,0.948,25.666,192,83,50,33,109,66,43,33,0.03,0.02
1015,401,24-09-2019 01:00:00,0,5242.0,4890.0,0.933,26.068,117,39,5,34,78,43,35,0,0.07,0.01
1015,402,24-09-2019 01:02:00,0,5104.0,4910.0,0.962,25.543,210,77,49,28,133,98,35,1,0.0,0.0
1015,403,24-09-2019 01:04:00,0,5080.0,4892.0,0.963,25.432,211,98,52,46,113,67,46,10,0.0,0.05
1015,404,24-09-2019 01:06:00,0,4975.0,4838.0,0.973,24.956,156,36,17,19,120,66,54,19,0.02,0.0
1015,405,24-09-2019 01:08:00,0,4882.5,4629.0,0.948,24.36,205,66,28,38,139,90,49,1,0.06,0.0
1015,406,24-09-2019 01:10:00,0,4790.0,4420.0,0.923,23.764,386,182,118,64,204,157,47,49,0.0,0.0
1015,407,24-09-2019 01:12:00,0,4085.0,3774.0,0.924,20.272,278,126,85,41,152,104,48,25,0.0,0.0
1015,408,24-09-2019 01:14:00,0,4816.0,4518.0,0.938,23.979,141,55,28,27,86,31,55,44,0.0,0.0
1015,409,24-09-2019 01:16:00,0,4614.0,4216.0,0.914,22.846,114,48,27,21,66,17,49,48,0.0,0.0
1015,410,24-09-2019 01:18:00,0,4508.0,4128.0,0.916,22.331,187,69,34,35,118,72,46,53,0.0,0.0
1015,411,24-09-2019 01:20:00,0,3067.0,2709.0,0.883,15.085,230,92,52,40,138,94,44,3,0.0,0.01
1015,412,24-09-2019 01:22:00,0,2650.0,2311.0,0.872,12.998,211,88,53,35,123,83,40,6,0.05,0.01
1015,413,24-09-2019 01:24:00,0,4826.0,4479.0,0.928,23.974,320,151,93,58,169,115,54,24,0.0,0.0
1015,414,24-09-2019 01:26:00,0,4629.0,4207.0,0.909,22.897,256,156,99,57,100,67,33,16,0.0,0.0
1015,415,24-09-2019 01:28:00,0,3882.0,3614.0,0.931,19.296,273,117,62,55,156,109,47,27,0.0,0.07
1015,416,24-09-2019 01:30:00,0,4088.0,3789.0,0.927,20.301,285,127,90,37,158,119,39,8,0.07,0.0
1015,417,24-09-2019 01:32:00,0,4809.0,4525.0,0.941,23.956,283,169,123,46,114,81,33,63,0.0,0.0
1015,418,24-09-2019 01:34:00,0,4826.0,4537.0,0.94,24.036,182,66,47,19,116,64,52,62,0.0,0.0
1015,419,24-09-2019 01:36:00,0,3760.0,3491.0,0.928,18.681,312,132,90,42,180,123,57,47,0.0,0.0
1015,420,24-09-2019 01:38:00,0,3880.0,3560.0,0.917,19.228,164,82,53,29,82,27,55,53,0.0,0.0
1015,421,24-09-2019 01:40:00,0,4834.0,4477.0,0.926,24.003,182,85,57,28,97,30,67,49,0.0,0.0
1015,422,24-09-2019 01:42:00,0,5078.5,4729.5,0.931,25.245,217,124,79,45,93,52,41,4,0.04,0.0
1015,423,24-09-2019 01:44:00,0,5323.0,4982.0,0.936,26.487,301,146,97,49,155,108,47,18,0.01,0.0
1015,424,24-09-2019 01:46:00,0,4599.0,4297.0,0.934,22.879,166,55,27,28,111,54,57,50,0.0,0.0
1015,425,24-09-2019 01:48:00,0,4636.0,4225.0,0.911,22.942,243,121,80,41,122,71,51,29,0.0,0.01
1015,426,24-09-2019 01:50:00,0,3087.0,2664.0,0.863,15.112,146,84,42,42,62,30,32,2,0.0,0.02
1015,427,24-09-2019 01:52:00,0,2778.0,2337.0,0.841,13.533,263,115,80,35,148,105,43,24,0.07,0.0
1015,428,24-09-2019 01:54:00,0,5027.0,4741.0,0.943,25.053,380,192,139,53,188,143,45,52,0.0,0.0
1015,429,24-09-2019 01:56:00,0,3084.0,2664.0,0.864,15.102,227,113,73,40,114,73,41,19,0.0,0.0
1015,430,24-09-2019 01:58:00,0,4924.0,4568.0,0.928,24.46,298,150,102,48,148,111,37,60,0.0,0.0
1015,431,24-09-2019 02:00:00,0,3584.0,3263.0,0.91,17.731,324,180,127,53,144,96,48,11,0.0,0.0
1015,432,24-09-2019 02:02:00,0,4592.0,4305.0,0.938,22.859,403,189,131,58,214,146,68,16,0.0,0.0
1015,433,24-09-2019 02:04:00,0,3078.0,2651.0,0.861,15.064,262,130,83,47,132,90,42,0,0.0,0.0
1015,434,24-09-2019 02:06:00,0,3085.0,2672.0,0.866,15.112,113,73,39,34,40,21,19,0,0.0,0.0
1015,435,24-09-2019 02:08:00,0,4180.0,3846.0,0.92,20.726,96,61,39,22,35,8,27,0,0.0,0.0
1015,436,24-09-2019 02:10:00,0,4093.0,3814.0,0.932,20.348,148,80,50,30,68,29,39,0,0.0,0.0
1015,437,24-09-2019 02:12:00,0,4300.0,3964.0,0.922,21.331,487,256,189,67,231,163,68,0,0.0,0.0
1015,438,24-09-2019 02:14:00,0,4414.0,4096.0,0.928,21.925,219,131,83,48,88,48,40,0,0.0,0.0
1015,439,24-09-2019 02:16:00,0,4353.0,4054.5,0.9315,21.6385,75,44,9,35,31,12,19,0,0.0,0.0
1015,440,24-09-2019 02:18:00,0,4292.0,4013.0,0.935,21.352,87,49,14,35,38,9,29,0,0.0,0.0
1015,441,24-09-2019 02:20:00,0,4196.0,3838.0,0.915,20.782,10,8,3,5,2,1,1,0,0.0,0.0
1015,442,24-09-2019 02:22:00,0,4001.0,3623.0,0.906,19.774,1,0,0,0,1,1,0,0,0.0,0.0
1015,443,24-09-2019 02:24:00,0,3809.0,3368.0,0.884,18.738,1,0,0,0,1,0,1,0,0.0,0.0
1015,444,24-09-2019 02:26:00,0,3601.0,3185.0,0.884,17.713,1,0,0,0,1,0,1,0,0.0,0.0
1015,445,24-09-2019 02:28:00,0,3259.0,2985.0,0.916,16.146,79,42,26,16,37,18,19,0,0.0,0.01
1015,446,24-09-2019 02:30:00,0,3253.0,2918.0,0.897,16.047,14,9,2,7,5,2,3,0,0.0,0.0
1015,447,24-09-2019 02:32:00,0,3067.0,2700.0,0.88,15.072,7,0,0,0,7,0,7,0,0.0,0.0
1015,448,24-09-2019 02:34:00,0,2857.0,2577.0,0.902,14.11,4,0,0,0,4,2,2,0,0.0,0.0
1015,449,24-09-2019 02:36:00,0,2749.0,2437.0,0.886,13.529,11,0,0,0,11,3,8,0,0.0,0.0
1015,450,24-09-2019 02:38:00,0,2769.0,2368.0,0.855,13.531,4,4,1,3,0,0,0,0,0.0,0.0
1015,451,24-09-2019 02:40:00,0,2532.0,2274.0,0.898,12.494,23,23,0,23,0,0,0,0,0.0,0.0
1015,452,24-09-2019 02:42:00,0,2565.0,2144.0,0.836,12.48,30,8,4,4,22,12,10,0,0.0,0.0
1015,453,24-09-2019 02:44:00,0,2537.0,2266.0,0.893,12.503,1,1,0,1,0,0,0,0,0.0,0.0
1015,454,24-09-2019 02:46:00,0,2536.0,2225.0,0.877,12.454,30,19,4,15,11,7,4,0,0.0,0.0
1015,455,24-09-2019 02:48:00,0,2532.0,2223.0,0.878,12.439,7,3,0,3,4,2,2,0,0.0,0.0
1015,456,24-09-2019 02:50:00,0,2583.5,2276.0,0.881,12.6985,12,0,0,0,12,6,6,0,0.0,0.0
1015,457,24-09-2019 02:52:00,0,2635.0,2329.0,0.884,12.958,40,25,8,17,15,7,8,0,0.0,0.0
1015,458,24-09-2019 02:54:00,0,2646.0,2317.0,0.875,12.992,12,11,0,11,1,1,0,0,0.0,0.0
1015,459,24-09-2019 02:56:00,0,2541.0,2254.0,0.887,12.505,2,2,0,2,0,0,0,0,0.0,0.0
1015,460,24-09-2019 02:58:00,0,2535.0,2273.0,0.897,12.503,18,7,1,6,11,6,5,0,0.0,0.0
1015,461,24-09-2019 03:00:00,0,2514.0,2305.0,0.917,12.456,25,9,6,3,16,8,8,0,0.0,0.0
1015,462,24-09-2019 03:02:00,0,2545.0,2233.0,0.877,12.497,9,0,0,0,9,5,4,0,0.0,0.0
1015,463,24-09-2019 03:04:00,0,2556.0,2196.0,0.859,12.502,42,8,2,6,34,12,22,0,0.0,0.0
1015,464,24-09-2019 03:06:00,0,2551.0,2210.0,0.867,12.497,7,6,2,4,1,0,1,0,0.0,0.0
1015,465,24-09-2019 03:08:00,0,2542.0,2219.0,0.873,12.474,13,7,3,4,6,2,4,0,0.0,0.0
1015,466,24-09-2019 03:10:00,0,2557.0,2193.0,0.858,12.501,6,1,0,1,5,2,3,0,0.0,0.0
1015,467,24-09-2019 03:12:00,0,2551.0,2151.0,0.843,12.432,1,0,0,0,1,0,1,0,0.0,0.0
1015,468,24-09-2019 03:14:00,0,2562.0,2132.0,0.832,12.456,2,0,0,0,2,0,2,0,0.0,0.0
1015,469,24-09-2019 03:16:00,0,2573.0,2138.0,0.831,12.504,40,19,13,6,21,11,10,0,0.0,0.0
1015,470,24-09-2019 03:18:00,0,2562.0,2186.0,0.853,12.515,0,0,0,0,0,0,0,0,0.0,0.0
1015,471,24-09-2019 03:20:00,0,2550.0,2148.0,0.842,12.426,0,0,0,0,0,0,0,0,0.0,0.0
1015,472,24-09-2019 03:22:00,0,2546.0,2173.0,0.853,12.437,10,0,0,0,10,4,6,0,0.0,0.0
1015,473,24-09-2019 03:24:00,0,2496.5,2139.5,0.857,12.205,12,0,0,0,12,2,10,0,0.0,0.0
1015,474,24-09-2019 03:26:00,0,2447.0,2106.0,0.861,11.973,78,37,18,19,41,20,21,0,0.0,0.0
1015,475,24-09-2019 03:28:00,0,2550.0,2181.0,0.855,12.463,143,69,35,34,74,32,42,0,0.0,0.0
1015,476,24-09-2019 03:30:00,0,2768.0,2375.0,0.858,13.535,52,10,3,7,42,12,30,0,0.0,0.0
1015,477,24-09-2019 03:32:00,0,2729.0,2523.0,0.925,13.544,75,40,19,21,35,8,27,0,0.0,0.0
1015,478,24-09-2019 03:34:00,0,3054.0,2755.0,0.902,15.082,161,89,56,33,72,41,31,36,0.0,0.0
1015,479,24-09-2019 03:36:00,0,3058.0,2771.0,0.906,15.116,273,140,110,30,133,104,29,68,0.0,0.0
1015,480,24-09-2019 03:38:00,0,3232.0,3042.0,0.941,16.101,281,111,82,29,170,115,55,33,0.0,0.0
1015,481,24-09-2019 03:40:00,0,3265.0,2989.0,0.915,16.175,127,57,38,19,70,15,55,62,0.0,0.0
1015,482,24-09-2019 03:42:00,0,3580.0,3225.0,0.901,17.677,178,62,38,24,116,53,63,65,0.0,0.0
1015,483,24-09-2019 03:44:00,0,3366.0,3068.0,0.912,16.657,394,178,124,54,216,174,42,85,0.0,0.02
1015,484,24-09-2019 03:46:00,0,3815.0,3360.0,0.881,18.751,167,71,43,28,96,37,59,51,0.0,0.01
1015,485,24-09-2019 03:48:00,0,4008.0,3552.0,0.886,19.723,215,144,112,32,71,30,41,31,0.0,0.01
1015,486,24-09-2019 03:50:00,0,3817.0,3344.0,0.876,18.74,361,180,141,39,181,125,56,109,0.0,0.0
1015,487,24-09-2019 03:52:00,0,4017.0,3556.0,0.885,19.765,128,63,38,25,65,13,52,37,0.0,0.0
1015,488,24-09-2019 03:54:00,0,4000.0,3580.0,0.895,19.724,111,57,30,27,54,0,54,55,0.0,0.0
1015,489,24-09-2019 03:56:00,0,4081.0,3765.0,0.923,20.247,100,34,21,13,66,8,58,36,0.0,0.0
1015,490,24-09-2019 03:58:00,0,4102.5,3738.5,0.9115,20.3035,146,72,45,27,74,22,52,64,0.0,0.07
1015,491,24-09-2019 04:00:00,0,4124.0,3712.0,0.9,20.36,340,140,105,35,200,143,57,52,0.03,0.04
1015,492,24-09-2019 04:02:00,0,3379.0,3032.0,0.897,16.668,552,261,203,58,291,220,71,126,0.14,0.0
1015,493,24-09-2019 04:04:00,0,3052.0,2785.0,0.912,15.108,373,166,122,44,207,147,60,93,0.0,0.0
1015,494,24-09-2019 04:06:00,0,4114.0,3727.0,0.906,20.335,131,66,36,30,65,5,60,51,0.0,0.0
1015,495,24-09-2019 04:08:00,0,4076.0,3747.0,0.919,20.208,120,46,32,14,74,0,74,54,0.0,0.0
1015,496,24-09-2019 04:10:00,0,4290.0,4024.0,0.938,21.359,125,66,38,28,59,0,59,59,0.0,0.0
1015,497,24-09-2019 04:12:00,0,4065.0,3813.0,0.938,20.238,317,140,101,39,177,113,64,6,0.01,0.1
1015,498,24-09-2019 04:14:00,0,4065.0,3815.0,0.938,20.238,370,187,133,54,183,129,54,44,0.06,0.02
1015,499,24-09-2019 04:16:00,0,3966.0,3699.0,0.932,19.723,446,226,174,52,220,175,45,109,0.02,0.04
1015,500,24-09-2019 04:18:00,0,3767.0,3494.0,0.928,18.709,302,157,113,44,145,106,39,17,0.0,0.0
1015,501,24-09-2019 04:20:00,0,3999.0,3633.0,0.908,19.779,193,97,60,37,96,58,38,8,0.06,0.0
1015,502,24-09-2019 04:22:00,0,3588.0,3225.0,0.899,17.706,235,119,80,39,116,80,36,19,0.08,0.0
1015,503,24-09-2019 04:24:00,0,3687.0,3320.0,0.901,18.202,223,104,60,44,119,78,41,1,0.0,0.0
1015,504,24-09-2019 04:26:00,0,3578.0,3217.0,0.899,17.66,96,46,27,19,50,25,25,0,0.0,0.0
1015,505,24-09-2019 04:28:00,0,3575.0,3281.0,0.918,17.717,181,60,30,30,121,78,43,0,0.0,0.0
1015,506,24-09-2019 04:30:00,0,3870.0,3588.0,0.927,19.22,156,94,55,39,62,35,27,0,0.0,0.0
1015,507,24-09-2019 04:32:00,0,3895.0,3542.0,0.9095,19.2685,314,161,104,57,153,103,50,0,0.0,0.0
1015,508,24-09-2019 04:34:00,0,3920.0,3496.0,0.892,19.317,435,290,215,75,145,100,45,0,0.0,0.0
1015,509,24-09-2019 04:36:00,0,3994.0,3619.0,0.906,19.744,332,199,146,53,133,96,37,38,0.0,0.0
1015,510,24-09-2019 04:38:00,0,3679.0,3295.0,0.895,18.144,58,48,8,40,10,2,8,0,0.0,0.0
1015,511,24-09-2019 04:40:00,0,3815.0,3323.0,0.871,18.709,41,31,1,30,10,4,6,0,0.0,0.0
1015,512,24-09-2019 04:42:00,0,3821.0,3348.0,0.876,18.763,23,4,3,1,19,2,17,0,0.0,0.0
1015,513,24-09-2019 04:44:00,0,3700.0,3285.0,0.888,18.215,1,0,0,0,1,0,1,0,0.0,0.0
1015,514,24-09-2019 04:46:00,0,3506.0,3038.0,0.866,17.175,8,3,2,1,5,1,4,0,0.0,0.0
1015,515,24-09-2019 04:48:00,0,3411.0,2833.0,0.831,16.576,1,0,0,0,1,1,0,0,0.0,0.0
1015,516,24-09-2019 04:50:00,0,3219.0,2651.0,0.823,15.62,19,15,1,14,4,2,2,0,0.0,0.0
1015,517,24-09-2019 04:52:00,0,2867.0,2464.0,0.86,14.024,59,30,8,22,29,18,11,0,0.0,0.0
1015,518,24-09-2019 04:54:00,0,2877.0,2485.0,0.864,14.088,66,31,8,23,35,7,28,0,0.0,0.0
1015,519,24-09-2019 04:56:00,0,2861.0,2487.0,0.869,14.025,7,1,0,1,6,2,4,0,0.0,0.0
1015,520,24-09-2019 04:58:00,0,2898.0,2332.0,0.805,14.001,6,0,0,0,6,1,5,0,0.0,0.0
1015,521,24-09-2019 05:00:00,0,2666.0,2237.0,0.839,12.982,23,8,2,6,15,3,12,0,0.0,0.0
1015,522,24-09-2019 05:02:00,0,2689.0,2194.0,0.816,13.024,2,2,0,2,0,0,0,0,0.0,0.0
1015,523,24-09-2019 05:04:00,0,2687.0,2159.0,0.804,12.979,0,0,0,0,0,0,0,0,0.0,0.0
1015,524,24-09-2019 05:06:00,0,2623.0,2156.5,0.823,12.723,1,0,0,0,1,1,0,0,0.0,0.0
1015,525,24-09-2019 05:08:00,0,2559.0,2154.0,0.842,12.467,21,13,2,11,8,4,4,0,0.0,0.0
1015,526,24-09-2019 05:10:00,0,2538.0,2199.0,0.867,12.433,2,0,0,0,2,1,1,0,0.0,0.0
1015,527,24-09-2019 05:12:00,0,2561.0,2177.0,0.85,12.5,0,0,0,0,0,0,0,0,0.0,0.0
1015,528,24-09-2019 05:14:00,0,2555.0,2166.0,0.847,12.465,2,0,0,0,2,0,2,0,0.0,0.0
1015,529,24-09-2019 05:16:00,0,2568.0,2122.0,0.827,12.466,0,0,0,0,0,0,0,0,0.0,0.0
1015,530,24-09-2019 05:18:00,0,2333.0,2021.0,0.866,11.432,47,13,4,9,34,22,12,0,0.0,0.0
1015,531,24-09-2019 05:20:00,0,2216.0,1991.0,0.899,10.935,24,4,1,3,20,0,20,0,0.0,0.0
1015,532,24-09-2019 05:22:00,0,2223.0,1954.0,0.879,10.921,33,0,0,0,33,25,8,0,0.0,0.0
1015,533,24-09-2019 05:24:00,0,2233.0,1939.0,0.868,10.945,10,1,1,0,9,5,4,0,0.0,0.0
1015,534,24-09-2019 05:26:00,0,2227.0,1898.0,0.852,10.876,18,0,0,0,18,4,14,0,0.0,0.0
1015,535,24-09-2019 05:28:00,0,2230.0,1968.0,0.882,10.966,5,0,0,0,5,1,4,0,0.0,0.0
1015,536,24-09-2019 05:30:00,0,2228.0,1943.0,0.872,10.93,15,1,1,0,14,5,9,0,0.0,0.0
1015,537,24-09-2019 05:32:00,0,2439.0,2090.0,0.857,11.925,7,0,0,0,7,0,7,0,0.0,0.0
1015,538,24-09-2019 05:34:00,0,2316.0,2060.0,0.889,11.405,23,11,6,5,12,4,8,0,0.0,0.0
1015,539,24-09-2019 05:36:00,0,2322.0,2062.0,0.888,11.43,6,0,0,0,6,1,5,0,0.0,0.0
1015,540,24-09-2019 05:38:00,0,2335.0,2056.0,0.881,11.475,15,4,1,3,11,8,3,0,0.0,0.0
1015,541,24-09-2019 05:40:00,0,2502.0,2153.0,0.862,12.2415,172,65,23,42,107,54,53,0,0.0,0.0
1015,542,24-09-2019 05:42:00,0,2669.0,2250.0,0.843,13.008,147,83,52,31,64,31,33,0,0.0,0.0
1015,543,24-09-2019 05:44:00,0,3195.0,2679.0,0.839,15.553,436,226,180,46,210,164,46,62,0.0,0.0
1015,544,24-09-2019 05:46:00,0,3193.0,2711.0,0.849,15.584,434,204,163,41,230,172,58,73,0.0,0.0
1015,545,24-09-2019 05:48:00,0,3426.0,2859.0,0.834,16.666,140,76,43,33,64,4,60,64,0.0,0.0
1015,546,24-09-2019 05:50:00,0,3758.0,3075.0,0.818,18.211,116,51,30,21,65,2,63,49,0.0,0.0
1015,547,24-09-2019 05:52:00,0,3711.0,3224.0,0.869,18.19,86,40,17,23,46,0,46,48,0.0,0.04
1015,548,24-09-2019 05:54:00,0,3941.0,3326.0,0.844,19.21,117,38,24,14,79,8,71,59,0.0,0.08
1015,549,24-09-2019 05:56:00,0,3685.0,3287.0,0.892,18.156,606,275,223,52,331,242,89,79,0.0,0.01
1015,550,24-09-2019 05:58:00,0,3731.0,3221.0,0.863,18.267,463,217,175,42,246,186,60,120,0.06,0.01
1015,551,24-09-2019 06:00:00,1,3699.0,3287.0,0.889,18.212,381,145,116,29,236,156,80,31,0.04,0.0
1015,552,24-09-2019 06:02:00,1,3948.0,3340.0,0.846,19.254,486,243,189,54,243,186,57,92,0.0,0.0
1015,553,24-09-2019 06:04:00,1,3729.0,3218.0,0.863,18.257,340,168,133,35,172,126,46,117,0.03,0.0
1015,554,24-09-2019 06:06:00,1,3814.0,3300.0,0.865,18.681,138,47,17,30,91,43,48,25,0.02,0.0
1015,555,24-09-2019 06:08:00,1,3930.0,3348.0,0.852,19.189,103,44,22,22,59,0,59,48,0.0,0.07
1015,556,24-09-2019 06:10:00,1,4009.0,3542.0,0.884,19.718,89,31,17,14,58,0,58,44,0.01,0.02
1015,557,24-09-2019 06:12:00,1,4146.0,3609.0,0.871,20.332,307,150,117,33,157,100,57,38,0.09,0.04
1015,558,24-09-2019 06:14:00,1,4188.0,3646.0,0.871,20.537,308,166,125,41,142,98,44,63,0.08,0.01
1015,559,24-09-2019 06:16:00,1,4230.0,3683.0,0.871,20.742,428,201,148,53,227,186,41,58,0.0,0.05
1015,560,24-09-2019 06:18:00,1,3626.0,3055.0,0.843,17.671,421,185,150,35,236,171,65,84,0.0,0.0
1015,561,24-09-2019 06:20:00,1,2867.0,2465.0,0.86,14.026,315,183,131,52,132,93,39,2,0.01,0.0
1015,562,24-09-2019 06:22:00,1,3943.0,3325.0,0.843,19.217,298,111,82,29,187,143,44,5,0.08,0.0
1015,563,24-09-2019 06:24:00,1,3803.0,3333.0,0.876,18.675,70,22,6,16,48,26,22,0,0.0,0.0
1015,564,24-09-2019 06:26:00,1,3715.0,3288.0,0.885,18.278,157,68,27,41,89,46,43,0,0.0,0.0
1015,565,24-09-2019 06:28:00,1,3723.0,3191.0,0.857,18.201,73,29,9,20,44,10,34,0,0.0,0.0
1015,566,24-09-2019 06:30:00,1,3921.0,3446.0,0.879,19.264,237,155,121,34,82,53,29,24,0.0,0.0
1015,567,24-09-2019 06:32:00,1,3743.0,3148.0,0.841,18.232,150,91,51,40,59,25,34,0,0.0,0.0
1015,568,24-09-2019 06:34:00,1,3726.0,3146.0,0.844,18.164,732,472,384,88,260,194,66,0,0.0,0.0
1015,569,24-09-2019 06:36:00,1,3727.0,3146.0,0.844,18.167,89,67,36,31,22,5,17,0,0.0,0.0
1015,570,24-09-2019 06:38:00,1,3740.0,3127.0,0.836,18.199,29,6,2,4,23,6,17,0,0.0,0.0
1015,571,24-09-2019 06:40:00,1,3397.0,2967.0,0.874,16.668,6,1,1,0,5,0,5,0,0.0,0.0
1015,572,24-09-2019 06:42:00,1,3298.0,2761.0,0.837,16.053,10,2,0,2,8,0,8,0,0.0,0.0
1015,573,24-09-2019 06:44:00,1,3213.0,2599.0,0.809,15.537,10,4,3,1,6,2,4,0,0.01,0.0
1015,574,24-09-2019 06:46:00,1,3121.0,2521.0,0.808,15.086,0,0,0,0,0,0,0,0,0.0,0.0
1015,575,24-09-2019 06:48:00,1,2950.0,2422.0,0.822,14.3035,0,0,0,0,0,0,0,0,0.0,0.0
1015,576,24-09-2019 06:50:00,1,2779.0,2323.0,0.836,13.521,0,0,0,0,0,0,0,0,0.0,0.0
1015,577,24-09-2019 06:52:00,1,2542.0,2249.0,0.885,12.507,8,8,0,8,0,0,0,0,0.0,0.0
1015,578,24-09-2019 06:54:00,1,2563.0,2150.0,0.839,12.478,13,11,0,11,2,2,0,0,0.0,0.0
1015,579,24-09-2019 06:56:00,1,2564.0,2133.0,0.832,12.464,0,0,0,0,0,0,0,0,0.0,0.0
1015,580,24-09-2019 06:58:00,1,2572.0,2087.0,0.812,12.444,0,0,0,0,0,0,0,0,0.0,0.0
1015,581,24-09-2019 07:00:00,1,2580.0,2081.0,0.806,12.47,4,0,0,0,4,2,2,0,0.01,0.0
1015,582,24-09-2019 07:02:00,1,2583.0,2084.0,0.807,12.486,17,5,0,5,12,2,10,0,0.0,0.0
1015,583,24-09-2019 07:04:00,1,2449.0,2038.0,0.832,11.906,10,7,1,6,3,2,1,0,0.0,0.0
1015,584,24-09-2019 07:06:00,1,2585.0,2055.0,0.795,12.46,1,0,0,0,1,0,1,0,0.0,0.0
1015,585,24-09-2019 07:08:00,1,2458.0,2042.0,0.831,11.944,1,0,0,0,1,0,1,0,0.0,0.0
1015,586,24-09-2019 07:10:00,1,2458.0,2025.0,0.824,11.927,3,1,1,0,2,0,2,0,0.0,0.0
1015,587,24-09-2019 07:12:00,1,2595.0,2037.0,0.785,12.478,22,14,10,4,8,4,4,0,0.0,0.0
1015,588,24-09-2019 07:14:00,1,2583.0,2052.0,0.794,12.451,18,16,0,16,2,2,0,0,0.0,0.0
1015,589,24-09-2019 07:16:00,1,2451.0,2039.0,0.832,11.914,16,3,0,3,13,5,8,0,0.0,0.0
1015,590,24-09-2019 07:18:00,1,2577.0,2062.0,0.8,12.435,3,0,0,0,3,1,2,0,0.0,0.0
1015,591,24-09-2019 07:20:00,1,2592.0,2064.0,0.796,12.498,14,0,0,0,14,6,8,0,0.0,0.0
1015,592,24-09-2019 07:22:00,1,2529.0,2058.0,0.814,12.2435,19,12,0,12,7,2,5,0,0.0,0.0
1015,593,24-09-2019 07:24:00,1,2466.0,2052.0,0.832,11.989,44,16,7,9,28,9,19,0,0.0,0.0
1015,594,24-09-2019 07:26:00,1,2465.0,2046.0,0.83,11.979,9,0,0,0,9,3,6,0,0.0,0.0
1015,595,24-09-2019 07:28:00,1,2434.0,2095.0,0.861,11.91,5,0,0,0,5,2,3,0,0.0,0.0
1015,596,24-09-2019 07:30:00,1,2437.0,2076.0,0.852,11.898,3,0,0,0,3,1,2,0,0.0,0.0
1015,597,24-09-2019 07:32:00,1,2464.0,2042.0,0.829,11.968,10,3,1,2,7,3,4,0,0.0,0.0
1015,598,24-09-2019 07:34:00,1,2475.0,1982.0,0.801,11.947,3,0,0,0,3,3,0,0,0.0,0.0
1015,599,24-09-2019 07:36:00,1,2342.0,1990.0,0.85,11.433,13,10,1,9,3,0,3,0,0.0,0.0
1015,600,24-09-2019 07:38:00,1,2229.0,1925.0,0.864,10.913,22,6,3,3,16,9,7,0,0.0,0.0
1015,601,24-09-2019 07:40:00,1,2223.0,1964.0,0.883,10.933,1,0,0,0,1,0,1,0,0.0,0.0
1015,602,24-09-2019 07:42:00,1,2346.0,1991.0,0.849,11.449,2,0,0,0,2,0,2,0,0.0,0.0
1015,603,24-09-2019 07:44:00,1,2481.0,1991.0,0.802,11.982,6,0,0,0,6,0,6,0,0.0,0.0
1015,604,24-09-2019 07:46:00,1,2347.0,1952.0,0.832,11.408,8,0,0,0,8,2,6,0,0.0,0.0
1015,605,24-09-2019 07:48:00,1,2228.0,1943.0,0.872,10.929,6,0,0,0,6,0,6,0,0.0,0.0
1015,606,24-09-2019 07:50:00,1,2112.0,1888.0,0.894,10.411,10,3,1,2,7,5,2,0,0.0,0.0
1015,607,24-09-2019 07:52:00,1,2120.0,1854.0,0.875,10.404,7,0,0,0,7,4,3,0,0.0,0.0
1015,608,24-09-2019 07:54:00,1,2123.0,1834.0,0.864,10.395,1,0,0,0,1,0,1,0,0.0,0.0
1015,609,24-09-2019 07:56:00,1,2186.5,1846.5,0.845,10.659,6,1,1,0,5,5,0,0,0.0,0.0
1015,610,24-09-2019 07:58:00,1,2250.0,1859.0,0.826,10.923,51,23,14,9,28,18,10,0,0.0,0.0
1015,611,24-09-2019 08:00:00,1,2242.0,1894.0,0.845,10.93,57,0,0,0,57,18,39,0,0.0,0.0
1015,612,24-09-2019 08:02:00,1,2252.0,1824.0,0.81,10.892,21,0,0,0,21,8,13,0,0.0,0.0
1015,613,24-09-2019 08:04:00,1,2013.0,1782.0,0.885,9.905,10,0,0,0,10,6,4,0,0.0,0.0
1015,614,24-09-2019 08:06:00,1,2130.0,1798.0,0.844,10.382,14,0,0,0,14,3,11,0,0.0,0.0
1015,615,24-09-2019 08:08:00,1,2265.0,1823.0,0.805,10.944,5,0,0,0,5,1,4,0,0.0,0.0
1015,616,24-09-2019 08:10:00,1,2136.0,1767.0,0.827,10.372,99,77,40,37,22,13,9,0,0.0,0.0
1015,617,24-09-2019 08:12:00,1,2603.0,2019.0,0.775,12.493,160,105,59,46,55,29,26,13,0.0,0.0
1015,618,24-09-2019 08:14:00,1,2757.0,2427.0,0.88,13.548,257,109,87,22,148,106,42,67,0.0,0.0
1015,619,24-09-2019 08:16:00,1,3003.0,2460.0,0.819,14.556,226,112,90,22,114,62,52,43,0.0,0.0
1015,620,24-09-2019 08:18:00,1,3294.0,2894.0,0.878,16.182,144,76,51,25,68,42,26,27,0.0,0.0
1015,621,24-09-2019 08:20:00,1,3321.0,2723.0,0.82,16.101,623,301,241,60,322,241,81,68,0.0,0.0
1015,622,24-09-2019 08:22:00,1,3125.0,2496.0,0.799,15.078,583,297,237,60,286,213,73,40,0.0,0.0
1015,623,24-09-2019 08:24:00,1,3094.0,2630.0,0.85,15.101,417,205,158,47,212,159,53,28,0.0,0.0
1015,624,24-09-2019 08:26:00,1,2876.0,2448.0,0.851,14.042,612,339,279,60,273,215,58,9,0.0,0.0
1015,625,24-09-2019 08:28:00,1,3092.0,2619.0,0.847,15.082,556,288,236,52,268,206,62,18,0.0,0.0
1015,626,24-09-2019 08:30:00,1,3162.5,2603.0,0.8235,15.342,101,61,35,26,40,20,20,10,0.0,0.04
1015,627,24-09-2019 08:32:00,1,3233.0,2587.0,0.8,15.602,77,56,28,28,21,6,15,0,0.0,0.0
1015,628,24-09-2019 08:34:00,1,3223.0,2586.0,0.802,15.561,60,38,1,37,22,5,17,0,0.0,0.0
1015,629,24-09-2019 08:36:00,1,3243.0,2534.0,0.781,15.583,9,7,1,6,2,0,2,0,0.0,0.0
1015,630,24-09-2019 08:38:00,1,3009.0,2415.0,0.803,14.53,2,1,0,1,1,0,1,0,0.0,0.0
1015,631,24-09-2019 08:40:00,1,2935.0,2260.0,0.77,14.068,1,0,0,0,1,0,1,0,0.0,0.0
1015,632,24-09-2019 08:42:00,1,2707.0,2051.0,0.758,12.935,26,18,6,12,8,1,7,0,0.0,0.0
1015,633,24-09-2019 08:44:00,1,2487.0,1956.0,0.787,11.964,1,0,0,0,1,1,0,0,0.0,0.0
1015,634,24-09-2019 08:46:00,1,2615.0,1976.0,0.756,12.491,0,0,0,0,0,0,0,0,0.0,0.0
1015,635,24-09-2019 08:48:00,1,2366.0,1915.0,0.809,11.443,14,8,1,7,6,1,5,0,0.0,0.0
1015,636,24-09-2019 08:50:00,1,2371.0,1929.0,0.813,11.478,50,38,10,28,12,0,12,0,0.0,0.0
1015,637,24-09-2019 08:52:00,1,2709.0,2082.0,0.769,12.98,10,10,0,10,0,0,0,0,0.0,0.0
1015,638,24-09-2019 08:54:00,1,2695.0,2114.0,0.784,12.958,19,17,2,15,2,2,0,0,0.0,0.0
1015,639,24-09-2019 08:56:00,1,2705.0,2140.0,0.791,13.026,4,3,0,3,1,0,1,0,0.0,0.0
1015,640,24-09-2019 08:58:00,1,2736.0,1998.0,0.73,12.992,17,16,1,15,1,1,0,0,0.0,0.0
1015,641,24-09-2019 09:00:00,1,2362.0,1908.0,0.808,11.417,354,261,210,51,93,69,24,4,0.0,0.0
1015,642,24-09-2019 09:02:00,1,2689.0,2150.0,0.799,12.974,172,104,68,36,68,54,14,29,0.0,0.0
1015,643,24-09-2019 09:04:00,1,2810.0,2196.0,0.782,13.5035,126,60,38,22,66,37,29,3,0.0,0.0
1015,644,24-09-2019 09:06:00,1,2931.0,2242.0,0.765,14.033,51,26,8,18,25,2,23,0,0.0,0.0
1015,645,24-09-2019 09:08:00,1,2936.0,2250.0,0.766,14.06,63,37,23,14,26,2,24,0,0.0,0.0
1015,646,24-09-2019 09:10:00,1,2939.0,2234.0,0.76,14.055,27,13,5,8,14,2,12,1,0.0,0.0
1015,647,24-09-2019 09:12:00,1,2821.0,2145.0,0.76,13.491,5,4,0,4,1,0,1,0,0.0,0.0
1015,648,24-09-2019 09:14:00,1,2732.0,2001.0,0.732,12.981,5,5,0,5,0,0,0,0,0.0,0.0
1015,649,24-09-2019 09:16:00,1,2501.0,1880.0,0.752,11.935,18,15,7,8,3,0,3,0,0.0,0.0
1015,650,24-09-2019 09:18:00,1,2274.0,1737.0,0.764,10.882,1,0,0,0,1,1,0,0,0.0,0.0
1015,651,24-09-2019 09:20:00,1,2167.0,1650.0,0.762,10.364,6,2,0,2,4,1,3,0,0.0,0.0
1015,652,24-09-2019 09:22:00,1,2175.0,1615.0,0.743,10.356,3,1,0,1,2,1,1,0,0.0,0.0
1015,653,24-09-2019 09:24:00,1,2169.0,1641.0,0.757,10.361,0,0,0,0,0,0,0,0,0.0,0.0
1015,654,24-09-2019 09:26:00,1,2172.0,1646.0,0.758,10.38,15,11,2,9,4,1,3,0,0.0,0.0
1015,655,24-09-2019 09:28:00,1,2182.0,1631.0,0.748,10.403,1,1,1,0,0,0,0,0,0.0,0.0
1015,656,24-09-2019 09:30:00,1,2200.0,1590.0,0.723,10.429,0,0,0,0,0,0,0,0,0.0,0.0
1015,657,24-09-2019 09:32:00,1,2202.0,1502.0,0.682,10.338,14,11,3,8,3,0,3,0,0.0,0.0
1015,658,24-09-2019 09:34:00,1,2176.0,1655.0,0.761,10.407,2,1,0,1,1,0,1,0,0.01,0.0
1015,659,24-09-2019 09:36:00,1,2167.0,1638.0,0.756,10.353,0,0,0,0,0,0,0,0,0.0,0.0
1015,660,24-09-2019 09:38:00,1,2283.0,1697.0,0.744,10.8755,37,27,14,13,10,2,8,0,0.0,0.0
1015,661,24-09-2019 09:40:00,1,2399.0,1756.0,0.732,11.398,7,0,0,0,7,1,6,0,0.0,0.0
1015,662,24-09-2019 09:42:00,1,2284.0,1712.0,0.75,10.895,3,1,0,1,2,1,1,0,0.0,0.0
1015,663,24-09-2019 09:44:00,1,2179.0,1656.0,0.76,10.417,5,3,0,3,2,0,2,0,0.0,0.0
1015,664,24-09-2019 09:46:00,1,2191.0,1608.0,0.734,10.415,26,18,12,6,8,2,6,0,0.0,0.0
1015,665,24-09-2019 09:48:00,1,2289.0,1688.0,0.738,10.889,0,0,0,0,0,0,0,0,0.0,0.0
1015,666,24-09-2019 09:50:00,1,2417.0,1712.0,0.708,11.42,7,6,1,5,1,0,1,0,0.0,0.0
1015,667,24-09-2019 09:52:00,1,2400.0,1764.0,0.735,11.408,9,9,0,9,0,0,0,0,0.0,0.0
1015,668,24-09-2019 09:54:00,1,2411.0,1742.0,0.722,11.429,16,3,0,3,13,0,13,0,0.0,0.0
1015,669,24-09-2019 09:56:00,1,2413.0,1718.0,0.712,11.409,1,0,0,0,1,0,1,0,0.0,0.0
1015,670,24-09-2019 09:58:00,1,2293.0,1656.0,0.722,10.867,4,3,2,1,1,0,1,0,0.0,0.0
1015,671,24-09-2019 10:00:00,1,2180.0,1620.0,0.743,10.382,4,2,0,2,2,2,0,0,0.0,0.0
1015,672,24-09-2019 10:02:00,1,2179.0,1599.0,0.734,10.358,0,0,0,0,0,0,0,0,0.0,0.0
1015,673,24-09-2019 10:04:00,1,2187.0,1614.0,0.738,10.402,8,6,3,3,2,2,0,0,0.0,0.0
1015,674,24-09-2019 10:06:00,1,2183.0,1605.0,0.735,10.376,9,9,1,8,0,0,0,0,0.0,0.0
1015,675,24-09-2019 10:08:00,1,2172.0,1632.0,0.752,10.366,10,10,1,9,0,0,0,0,0.0,0.0
1015,676,24-09-2019 10:10:00,1,2295.0,1656.0,0.722,10.876,2,2,1,1,0,0,0,0,0.0,0.0
1015,677,24-09-2019 10:12:00,1,2521.0,1807.5,0.7175,11.935,87,69,24,45,18,6,12,0,0.0,0.0
1015,678,24-09-2019 10:14:00,1,2747.0,1959.0,0.713,12.994,164,89,64,25,75,47,28,23,0.0,0.0
1015,679,24-09-2019 10:16:00,1,2948.0,2113.0,0.717,13.954,64,19,9,10,45,5,40,46,0.0,0.0
1015,680,24-09-2019 10:18:00,1,2920.0,2219.0,0.76,13.962,110,48,32,16,62,0,62,54,0.0,0.0
1015,681,24-09-2019 10:20:00,1,3265.0,2490.0,0.763,15.622,82,22,10,12,60,0,60,56,0.0,0.0
1015,682,24-09-2019 10:22:00,1,3499.0,2617.0,0.748,16.683,113,48,31,17,65,2,63,52,0.0,0.41
1015,683,24-09-2019 10:24:00,1,3235.0,2507.0,0.775,15.524,1,0,0,0,1,1,0,0,0.0,0.03
1015,684,24-09-2019 10:26:00,1,2844.0,2101.0,0.739,13.531,73,31,18,13,42,26,16,15,0.07,0.0
1015,685,24-09-2019 10:28:00,1,3422.0,2764.0,0.808,16.544,638,356,288,68,282,222,60,59,0.0,0.0
1015,686,24-09-2019 10:30:00,1,3467.0,2697.0,0.778,16.646,261,141,107,34,120,77,43,52,0.05,0.01
1015,687,24-09-2019 10:32:00,1,3430.0,2798.0,0.816,16.611,656,379,311,68,277,206,71,65,0.01,0.0
1015,688,24-09-2019 10:34:00,1,3410.0,2841.0,0.833,16.58,392,206,150,56,186,135,51,0,0.0,0.0
1015,689,24-09-2019 10:36:00,1,3667.0,2930.0,0.799,17.69,617,321,263,58,296,228,68,10,0.0,0.0
1015,690,24-09-2019 10:38:00,1,3773.0,3016.0,0.799,18.205,669,466,371,95,203,151,52,3,0.12,0.0
1015,691,24-09-2019 10:40:00,1,3751.0,3056.0,0.815,18.164,457,234,196,38,223,160,63,117,0.0,0.0
1015,692,24-09-2019 10:42:00,1,3647.0,3003.0,0.823,17.693,646,372,300,72,274,210,64,44,0.08,0.0
1015,693,24-09-2019 10:44:00,1,3753.0,3060.0,0.815,18.177,167,100,67,33,67,48,19,0,0.0,0.0
1015,694,24-09-2019 10:46:00,1,3566.5,2989.0,0.839,17.3625,1,1,1,0,0,0,0,0,0.0,0.0
1015,695,24-09-2019 10:48:00,1,3380.0,2918.0,0.863,16.548,9,6,2,4,3,1,2,0,0.0,0.0
1015,696,24-09-2019 10:50:00,1,3635.0,3043.0,0.837,17.693,558,351,277,74,207,152,55,0,0.02,0.0
1015,697,24-09-2019 10:52:00,1,3753.0,3143.0,0.837,18.265,631,390,321,69,241,188,53,40,0.0,0.0
1015,698,24-09-2019 10:54:00,1,3732.0,3142.0,0.842,18.185,112,76,46,30,36,14,22,1,0.0,0.0
1015,699,24-09-2019 10:56:00,1,3719.0,3195.0,0.859,18.19,33,6,1,5,27,0,27,0,0.0,0.0
1015,700,24-09-2019 10:58:00,1,3719.0,3224.0,0.867,18.223,46,7,4,3,39,3,36,0,0.0,0.0
1015,701,24-09-2019 11:00:00,1,3610.0,3124.0,0.865,17.682,58,39,14,25,19,3,16,0,0.0,0.0
1015,702,24-09-2019 11:02:00,1,3489.0,3095.0,0.887,17.172,70,62,25,37,8,2,6,0,0.01,0.0
1015,703,24-09-2019 11:04:00,1,3624.0,3118.0,0.86,17.73,49,22,3,19,27,7,20,0,0.0,0.0
1015,704,24-09-2019 11:06:00,1,3362.0,3038.0,0.904,16.608,0,0,0,0,0,0,0,0,0.0,0.0
1015,705,24-09-2019 11:08:00,1,3180.0,2806.0,0.883,15.635,1,0,0,0,1,1,0,0,0.0,0.0
1015,706,24-09-2019 11:10:00,1,3094.0,2613.0,0.845,15.082,0,0,0,0,0,0,0,0,0.0,0.0
1015,707,24-09-2019 11:12:00,1,2853.0,2504.0,0.878,14.014,0,0,0,0,0,0,0,0,0.0,0.0
1015,708,24-09-2019 11:14:00,1,2884.0,2405.0,0.834,14.027,0,0,0,0,0,0,0,0,0.0,0.0
1015,709,24-09-2019 11:16:00,1,2648.0,2300.0,0.869,12.978,0,0,0,0,0,0,0,0,0.0,0.0
1015,710,24-09-2019 11:18:00,1,2685.0,2221.0,0.827,13.04,110,82,49,33,28,12,16,0,0.0,0.0
1015,711,24-09-2019 11:20:00,1,2658.0,2295.0,0.8635,13.015,23,23,10,13,0,0,0,0,0.0,0.0
1015,712,24-09-2019 11:22:00,1,2631.0,2369.0,0.9,12.99,1,1,0,1,0,0,0,0,0.01,0.0
1015,713,24-09-2019 11:24:00,1,2664.0,2305.0,0.865,13.049,22,15,10,5,7,5,2,0,0.0,0.0
1015,714,24-09-2019 11:26:00,1,2656.0,2306.0,0.868,13.019,4,1,0,1,3,0,3,0,0.0,0.0
1015,715,24-09-2019 11:28:00,1,2660.0,2277.0,0.856,12.999,0,0,0,0,0,0,0,0,0.0,0.0
1015,716,24-09-2019 11:30:00,1,2661.0,2239.0,0.842,12.961,9,7,0,7,2,0,2,0,0.0,0.0
1015,717,24-09-2019 11:32:00,1,2655.0,2290.0,0.863,12.997,23,21,0,21,2,0,2,0,0.0,0.0
1015,718,24-09-2019 11:34:00,1,2628.0,2370.0,0.902,12.979,3,3,0,3,0,0,0,0,0.0,0.0
1015,719,24-09-2019 11:36:00,1,2654.0,2318.0,0.874,13.023,16,4,0,4,12,6,6,0,0.0,0.0
1015,720,24-09-2019 11:38:00,1,2651.0,2291.0,0.864,12.983,71,6,3,3,65,54,11,0,0.0,0.0
1015,721,24-09-2019 11:40:00,1,2635.0,2383.0,0.904,13.021,15,7,5,2,8,2,6,0,0.0,0.0
1015,722,24-09-2019 11:42:00,1,2640.0,2362.0,0.895,13.015,17,11,7,4,6,0,6,0,0.0,0.0
1015,723,24-09-2019 11:44:00,1,2659.0,2273.0,0.855,12.993,5,4,2,2,1,0,1,0,0.0,0.0
1015,724,24-09-2019 11:46:00,1,2558.0,2188.0,0.855,12.5,23,16,10,6,7,2,5,0,0.0,0.0
1015,725,24-09-2019 11:48:00,1,2422.0,2183.0,0.901,11.959,0,0,0,0,0,0,0,0,0.0,0.0
1015,726,24-09-2019 11:50:00,1,2303.0,2122.0,0.922,11.422,0,0,0,0,0,0,0,0,0.0,0.0
1015,727,24-09-2019 11:52:00,1,2334.0,2055.0,0.881,11.47,33,22,14,8,11,6,5,0,0.0,0.0
1015,728,24-09-2019 11:54:00,1,2436.5,2158.0,0.886,11.9875,13,11,7,4,2,1,1,0,0.0,0.0
1015,729,24-09-2019 11:56:00,1,2539.0,2261.0,0.891,12.505,12,8,6,2,4,1,3,0,0.0,0.0
1015,730,24-09-2019 11:58:00,1,2305.0,2137.0,0.927,11.449,2,2,1,1,0,0,0,0,0.0,0.0
1015,731,24-09-2019 12:00:00,1,2304.0,2117.0,0.919,11.42,26,22,9,13,4,0,4,0,0.0,0.0
1015,732,24-09-2019 12:02:00,1,2546.0,2231.0,0.876,12.5,144,89,59,30,55,39,16,12,0.0,0.0
1015,733,24-09-2019 12:04:00,1,2601.0,2420.0,0.931,12.927,535,277,226,51,258,197,61,26,0.0,0.05
1015,734,24-09-2019 12:06:00,1,2741.0,2456.0,0.896,13.519,627,329,248,81,298,229,69,27,0.02,0.0
1015,735,24-09-2019 12:08:00,1,2819.0,2640.0,0.937,14.029,380,174,132,42,206,165,41,32,0.0,0.0
1015,736,24-09-2019 12:10:00,1,2832.0,2612.0,0.922,14.052,36,27,13,14,9,2,7,0,0.0,0.0
1015,737,24-09-2019 12:12:00,1,3072.0,2710.0,0.882,15.104,28,22,6,16,6,0,6,0,0.0,0.0
1015,738,24-09-2019 12:14:00,1,2831.0,2595.0,0.917,14.028,98,98,60,38,0,0,0,0,0.0,0.0
1015,739,24-09-2019 12:16:00,1,2825.0,2623.0,0.929,14.035,106,91,52,39,15,3,12,1,0.0,0.0
1015,740,24-09-2019 12:18:00,1,3066.0,2720.0,0.887,15.092,70,68,38,30,2,1,1,0,0.0,0.0
1015,741,24-09-2019 12:20:00,1,3186.0,2764.0,0.868,15.613,117,117,71,46,0,0,0,0,0.01,0.0
1015,742,24-09-2019 12:22:00,1,3172.0,2798.0,0.882,15.594,69,68,39,29,1,0,1,0,0.0,0.0
1015,743,24-09-2019 12:24:00,1,2823.0,2604.0,0.922,14.008,28,24,10,14,4,1,3,0,0.0,0.0
1015,744,24-09-2019 12:26:00,1,2860.0,2511.0,0.878,14.05,2,2,0,2,0,0,0,0,0.0,0.0
1015,745,24-09-2019 12:28:00,1,2754.0,2424.5,0.8805,13.5365,0,0,0,0,0,0,0,0,0.0,0.0
1015,746,24-09-2019 12:30:00,1,2648.0,2338.0,0.883,13.023,0,0,0,0,0,0,0,0,0.0,0.0
1015,747,24-09-2019 12:32:00,1,2665.0,2271.0,0.852,13.015,4,4,0,4,0,0,0,0,0.0,0.0
1015,748,24-09-2019 12:34:00,1,2658.0,2265.0,0.852,12.979,0,0,0,0,0,0,0,0,0.0,0.0
1015,749,24-09-2019 12:36:00,1,2646.0,2329.0,0.88,13.005,0,0,0,0,0,0,0,0,0.0,0.0
1015,750,24-09-2019 12:38:00,1,2638.0,2321.0,0.88,12.963,3,3,0,3,0,0,0,0,0.0,0.0
1015,751,24-09-2019 12:40:00,1,2653.0,2321.0,0.875,13.023,19,16,4,12,3,2,1,0,0.0,0.0
1015,752,24-09-2019 12:42:00,1,2647.0,2288.0,0.865,12.961,5,5,0,5,0,0,0,0,0.0,0.0
1015,753,24-09-2019 12:44:00,1,2682.0,2170.0,0.809,12.968,8,7,2,5,1,0,1,0,0.0,0.0
1015,754,24-09-2019 12:46:00,1,2685.0,2191.0,0.816,13.004,1,1,0,1,0,0,0,0,0.0,0.0
1015,755,24-09-2019 12:48:00,1,2668.0,2267.0,0.85,13.021,0,0,0,0,0,0,0,0,0.0,0.0
1015,756,24-09-2019 12:50:00,1,2666.0,2270.0,0.851,13.019,3,3,0,3,0,0,0,0,0.0,0.0
1015,757,24-09-2019 12:52:00,1,2650.0,2274.0,0.858,12.96,19,15,7,8,4,2,2,0,0.01,0.0
1015,758,24-09-2019 12:54:00,1,2664.0,2295.0,0.862,13.037,0,0,0,0,0,0,0,0,0.0,0.0
1015,759,24-09-2019 12:56:00,1,2695.0,2168.0,0.805,13.02,14,14,3,11,0,0,0,0,0.0,0.0
1015,760,24-09-2019 12:58:00,1,2700.0,2119.0,0.785,12.986,14,10,6,4,4,2,2,0,0.0,0.0
1015,761,24-09-2019 13:00:00,1,2674.0,2184.0,0.817,12.953,2,2,1,1,0,0,0,0,0.0,0.0
1015,762,24-09-2019 13:02:00,1,2628.5,2134.5,0.812,12.7195,4,1,0,1,3,0,3,0,0.0,0.0
1015,763,24-09-2019 13:04:00,1,2583.0,2085.0,0.807,12.486,1,0,0,0,1,0,1,0,0.0,0.0
1015,764,24-09-2019 13:06:00,1,2343.0,2009.0,0.858,11.455,0,0,0,0,0,0,0,0,0.0,0.0
1015,765,24-09-2019 13:08:00,1,2339.0,2041.0,0.873,11.474,10,2,2,0,8,0,8,0,0.0,0.0
1015,766,24-09-2019 13:10:00,1,2348.0,1986.0,0.846,11.449,1,0,0,0,1,0,1,0,0.0,0.0
1015,767,24-09-2019 13:12:00,1,2336.0,1977.0,0.847,11.392,1,0,0,0,1,1,0,0,0.0,0.0
1015,768,24-09-2019 13:14:00,1,2349.0,1985.0,0.845,11.453,2,0,0,0,2,1,1,0,0.0,0.0
1015,769,24-09-2019 13:16:00,1,2350.0,1984.0,0.844,11.454,0,0,0,0,0,0,0,0,0.0,0.0
1015,770,24-09-2019 13:18:00,1,2354.0,1944.0,0.826,11.428,1,0,0,0,1,1,0,0,0.0,0.0
1015,771,24-09-2019 13:20:00,1,2113.0,1833.0,0.868,10.353,3,0,0,0,3,1,2,0,0.0,0.0
1015,772,24-09-2019 13:22:00,1,2377.0,1896.0,0.798,11.465,1,1,1,0,0,0,0,0,0.0,0.0
1015,773,24-09-2019 13:24:00,1,2361.0,1901.0,0.805,11.406,2,2,2,0,0,0,0,0,0.0,0.0
1015,774,24-09-2019 13:26:00,1,2365.0,1917.0,0.811,11.442,6,6,3,3,0,0,0,0,0.0,0.0
1015,775,24-09-2019 13:28:00,1,2361.0,1919.0,0.813,11.429,67,51,31,20,16,5,11,0,0.0,0.0
1015,776,24-09-2019 13:30:00,1,2687.0,2180.0,0.811,12.999,14,14,4,10,0,0,0,0,0.0,0.0
1015,777,24-09-2019 13:32:00,1,2684.0,2202.0,0.821,13.012,1,1,0,1,0,0,0,0,0.0,0.0
1015,778,24-09-2019 13:34:00,1,2695.0,2162.0,0.802,13.014,6,6,0,6,0,0,0,0,0.0,0.0
1015,779,24-09-2019 13:36:00,1,2513.0,2092.0,0.8345,12.2175,6,5,0,5,1,0,1,0,0.0,0.0
1015,780,24-09-2019 13:38:00,1,2331.0,2022.0,0.867,11.421,1,1,0,1,0,0,0,0,0.0,0.0
1015,781,24-09-2019 13:40:00,1,2466.0,2052.0,0.832,11.989,0,0,0,0,0,0,0,0,0.0,0.0
1015,782,24-09-2019 13:42:00,1,2343.0,2012.0,0.859,11.46,0,0,0,0,0,0,0,0,0.0,0.0
1015,783,24-09-2019 13:44:00,1,2335.0,1958.0,0.839,11.37,2,2,0,2,0,0,0,0,0.0,0.0
1015,784,24-09-2019 13:46:00,1,2343.0,1977.0,0.844,11.421,0,0,0,0,0,0,0,0,0.0,0.0
1015,785,24-09-2019 13:48:00,1,2354.0,1933.0,0.821,11.416,0,0,0,0,0,0,0,0,0.0,0.0
1015,786,24-09-2019 13:50:00,1,2370.0,1901.0,0.802,11.443,0,0,0,0,0,0,0,0,0.0,0.0
1015,787,24-09-2019 13:52:00,1,2381.0,1864.0,0.783,11.446,0,0,0,0,0,0,0,0,0.0,0.0
1015,788,24-09-2019 13:54:00,1,2135.0,1813.0,0.849,10.421,146,93,57,36,53,30,23,0,0.0,0.0
1015,789,24-09-2019 13:56:00,1,2704.0,2073.0,0.767,12.949,11,9,5,4,2,2,0,0,0.0,0.0
1015,790,24-09-2019 13:58:00,1,2700.0,2124.0,0.787,12.992,2,0,0,0,2,0,2,0,0.0,0.0
1015,791,24-09-2019 14:00:00,1,2458.0,2051.0,0.835,11.954,19,10,6,4,9,6,3,0,0.0,0.0
1015,792,24-09-2019 14:02:00,1,2701.0,2119.0,0.784,12.988,1,0,0,0,1,0,1,0,0.0,0.0
1015,793,24-09-2019 14:04:00,1,2697.0,2113.0,0.783,12.965,3,0,0,0,3,2,1,0,0.0,0.0
1015,794,24-09-2019 14:06:00,1,2713.0,2105.0,0.776,13.02,2,0,0,0,2,0,2,0,0.0,0.0
1015,795,24-09-2019 14:08:00,1,2714.0,2074.0,0.764,12.989,3,0,0,0,3,0,3,0,0.0,0.0
1015,796,24-09-2019 14:10:00,1,2544.0,1993.0,0.7845,12.2305,13,8,5,3,5,0,5,0,0.0,0.0
1015,797,24-09-2019 14:12:00,1,2374.0,1912.0,0.805,11.472,0,0,0,0,0,0,0,0,0.0,0.0
1015,798,24-09-2019 14:14:00,1,2260.0,1821.0,0.805,10.921,18,9,8,1,9,2,7,0,0.0,0.0
1015,799,24-09-2019 14:16:00,1,2600.0,2025.0,0.779,12.488,7,5,1,4,2,0,2,0,0.0,0.0
1015,800,24-09-2019 14:18:00,1,2597.0,2022.0,0.779,12.471,3,0,0,0,3,0,3,0,0.0,0.0
1015,801,24-09-2019 14:20:00,1,2594.0,2018.0,0.778,12.456,4,0,0,0,4,0,4,0,0.0,0.0
1015,802,24-09-2019 14:22:00,1,2367.0,1924.0,0.813,11.457,23,0,0,0,23,0,23,0,0.0,0.0
1015,803,24-09-2019 14:24:00,1,2382.0,1843.0,0.774,11.427,23,12,7,5,11,0,11,0,0.0,0.0
1015,804,24-09-2019 14:26:00,1,2362.0,1860.0,0.787,11.367,9,8,5,3,1,0,1,0,0.0,0.0
1015,805,24-09-2019 14:28:00,1,2379.0,1868.0,0.785,11.443,3,0,0,0,3,0,3,0,0.0,0.0
1015,806,24-09-2019 14:30:00,1,2380.0,1876.0,0.788,11.456,5,0,0,0,5,0,5,0,0.0,0.0
1015,807,24-09-2019 14:32:00,1,2383.0,1884.0,0.791,11.474,14,0,0,0,14,0,14,0,0.0,0.0
1015,808,24-09-2019 14:34:00,1,2388.0,1816.0,0.76,11.419,20,0,0,0,20,0,20,0,0.0,0.0
1015,809,24-09-2019 14:36:00,1,2142.0,1780.0,0.831,10.412,101,64,34,30,37,0,37,0,0.0,0.0
1015,810,24-09-2019 14:38:00,1,2697.0,2092.0,0.776,12.944,90,62,39,23,28,0,28,0,0.0,0.0
1015,811,24-09-2019 14:40:00,1,2899.0,2352.0,0.811,14.028,40,17,5,12,23,2,21,0,0.0,0.0
1015,812,24-09-2019 14:42:00,1,2900.0,2399.0,0.827,14.083,80,57,27,30,23,0,23,0,0.0,0.0
1015,813,24-09-2019 14:44:00,1,3051.0,2535.5,0.8305,14.8285,351,185,148,37,166,122,44,50,0.0,0.0
1015,814,24-09-2019 14:46:00,1,3202.0,2672.0,0.834,15.574,361,220,180,40,141,95,46,50,0.0,0.0
1015,815,24-09-2019 14:48:00,1,3198.0,2679.0,0.838,15.566,298,162,124,38,136,76,60,102,0.0,0.0
1015,816,24-09-2019 14:50:00,1,3452.0,2739.0,0.793,16.635,85,31,18,13,54,4,50,48,0.0,0.0
1015,817,24-09-2019 14:52:00,1,3438.0,2850.0,0.829,16.703,202,95,66,29,107,57,50,51,0.0,0.0
1015,818,24-09-2019 14:54:00,1,3438.0,2841.0,0.826,16.692,117,34,21,13,83,0,83,59,0.0,0.04
1015,819,24-09-2019 14:56:00,1,3422.0,2864.0,0.837,16.656,123,17,12,5,106,23,83,62,0.01,0.06
1015,820,24-09-2019 14:58:00,1,3205.0,2708.0,0.845,15.625,111,72,35,37,39,21,18,0,0.07,0.0
1015,821,24-09-2019 15:00:00,1,2684.0,2214.0,0.825,13.028,586,384,312,72,202,149,53,35,0.0,0.1
1015,822,24-09-2019 15:02:00,1,3193.0,2761.0,0.865,15.638,593,364,288,76,229,181,48,8,0.0,0.0
1015,823,24-09-2019 15:04:00,1,3095.0,2542.0,0.821,15.01,769,402,330,72,367,281,86,47,0.06,0.0
1015,824,24-09-2019 15:06:00,1,3305.0,2793.0,0.845,16.113,260,132,100,32,128,87,41,75,0.01,0.0
1015,825,24-09-2019 15:08:00,1,3120.0,2566.0,0.823,15.132,49,42,9,33,7,2,5,0,0.0,0.0
1015,826,24-09-2019 15:10:00,1,3387.0,2921.0,0.862,16.579,141,107,73,34,34,14,20,0,0.0,0.0
1015,827,24-09-2019 15:12:00,1,3288.0,2799.0,0.851,16.054,30,20,2,18,10,1,9,0,0.0,0.0
1015,828,24-09-2019 15:14:00,1,3424.0,2947.0,0.861,16.752,234,147,111,36,87,64,23,10,0.0,0.0
1015,829,24-09-2019 15:16:00,1,3624.0,3060.0,0.844,17.666,409,245,180,65,164,116,48,48,0.0,0.0
1015,830,24-09-2019 15:18:00,1,3513.0,3008.0,0.8565,17.172,73,56,28,28,17,2,15,4,0.0,0.0
1015,831,24-09-2019 15:20:00,1,3402.0,2956.0,0.869,16.678,358,219,166,53,139,95,44,0,0.0,0.0
1015,832,24-09-2019 15:22:00,1,3397.0,2978.0,0.877,16.681,290,198,143,55,92,63,29,2,0.04,0.0
1015,833,24-09-2019 15:24:00,1,3490.0,3059.0,0.876,17.137,35,31,0,31,4,1,3,0,0.0,0.0
1015,834,24-09-2019 15:26:00,1,3394.0,2963.0,0.873,16.654,3,2,0,2,1,0,1,0,0.01,0.0
1015,835,24-09-2019 15:28:00,1,3411.0,2879.0,0.844,16.628,6,3,0,3,3,1,2,0,0.0,0.0
1015,836,24-09-2019 15:30:00,1,3176.0,2749.0,0.866,15.555,4,4,1,3,0,0,0,0,0.0,0.0
1015,837,24-09-2019 15:32:00,1,3094.0,2603.0,0.841,15.073,9,9,1,8,0,0,0,0,0.0,0.0
1015,838,24-09-2019 15:34:00,1,2884.0,2426.0,0.841,14.05,0,0,0,0,0,0,0,0,0.0,0.0
1015,839,24-09-2019 15:36:00,1,2657.0,2291.0,0.862,13.005,4,3,0,3,1,0,1,0,0.0,0.0
1015,840,24-09-2019 15:38:00,1,2677.0,2212.0,0.826,12.998,2,1,0,1,1,0,1,0,0.0,0.0
1015,841,24-09-2019 15:40:00,1,2695.0,2155.0,0.799,13.005,0,0,0,0,0,0,0,0,0.0,0.0
1015,842,24-09-2019 15:42:00,1,2565.0,2110.0,0.823,12.443,0,0,0,0,0,0,0,0,0.0,0.0
1015,843,24-09-2019 15:44:00,1,2455.0,2063.0,0.84,11.958,14,9,6,3,5,0,5,0,0.0,0.0
1015,844,24-09-2019 15:46:00,1,2680.0,2237.0,0.835,13.037,0,0,0,0,0,0,0,0,0.0,0.0
1015,845,24-09-2019 15:48:00,1,2680.0,2213.0,0.826,13.012,0,0,0,0,0,0,0,0,0.0,0.0
1015,846,24-09-2019 15:50:00,1,2672.0,2220.0,0.831,12.984,0,0,0,0,0,0,0,0,0.0,0.0
1015,847,24-09-2019 15:52:00,1,2677.0,2205.0,0.8235,12.9885,0,0,0,0,0,0,0,0,0.0,0.0
1015,848,24-09-2019 15:54:00,1,2682.0,2190.0,0.816,12.993,1,1,1,0,0,0,0,0,0.0,0.0
1015,849,24-09-2019 15:56:00,1,2703.0,2142.0,0.793,13.021,0,0,0,0,0,0,0,0,0.0,0.0
1015,850,24-09-2019 15:58:00,1,2698.0,2130.0,0.789,12.989,24,19,12,7,5,0,5,0,0.0,0.0
1015,851,24-09-2019 16:00:00,1,2690.0,2155.0,0.801,12.983,0,0,0,0,0,0,0,0,0.0,0.0
1015,852,24-09-2019 16:02:00,1,2706.0,2129.0,0.787,13.019,1,0,0,0,1,1,0,0,0.0,0.0
1015,853,24-09-2019 16:04:00,1,2713.0,2102.0,0.775,13.016,3,3,1,2,0,0,0,0,0.0,0.0
1015,854,24-09-2019 16:06:00,1,2692.0,2166.0,0.805,13.006,8,6,6,0,2,0,2,0,0.0,0.0
1015,855,24-09-2019 16:08:00,1,2701.0,2121.0,0.785,12.992,24,12,6,6,12,1,11,0,0.0,0.0
1015,856,24-09-2019 16:10:00,1,2711.0,2119.0,0.782,13.028,5,4,0,4,1,0,1,0,0.0,0.0
1015,857,24-09-2019 16:12:00,1,2592.0,2048.0,0.79,12.478,0,0,0,0,0,0,0,0,0.0,0.0
1015,858,24-09-2019 16:14:00,1,2340.0,1984.0,0.848,11.416,2,2,1,1,0,0,0,0,0.0,0.0
1015,859,24-09-2019 16:16:00,1,2350.0,1969.0,0.838,11.438,0,0,0,0,0,0,0,0,0.0,0.0
1015,860,24-09-2019 16:18:00,1,2352.0,1958.0,0.832,11.435,4,4,0,4,0,0,0,0,0.0,0.0
1015,861,24-09-2019 16:20:00,1,2345.0,1964.0,0.838,11.416,1,1,0,1,0,0,0,0,0.0,0.0
1015,862,24-09-2019 16:22:00,1,2356.0,1942.0,0.824,11.433,0,0,0,0,0,0,0,0,0.0,0.0
1015,863,24-09-2019 16:24:00,1,2482.0,1978.0,0.797,11.97,4,3,0,3,1,1,0,0,0.0,0.0
1015,864,24-09-2019 16:26:00,1,2540.5,2004.0,0.789,12.23,14,10,5,5,4,3,1,0,0.0,0.0
1015,865,24-09-2019 16:28:00,1,2599.0,2030.0,0.781,12.49,126,85,62,23,41,24,17,0,0.0,0.0
1015,866,24-09-2019 16:30:00,1,2706.0,2081.0,0.769,12.966,97,80,40,40,17,0,17,0,0.0,0.0
1015,867,24-09-2019 16:32:00,1,2675.0,2215.0,0.828,12.991,16,10,6,4,6,2,4,0,0.0,0.0
1015,868,24-09-2019 16:34:00,1,2685.0,2143.0,0.798,12.951,7,1,0,1,6,2,4,0,0.0,0.0
1015,869,24-09-2019 16:36:00,1,2601.0,2064.0,0.793,12.531,0,0,0,0,0,0,0,0,0.0,0.0
1015,870,24-09-2019 16:38:00,1,2341.0,1944.0,0.83,11.377,1,0,0,0,1,1,0,0,0.0,0.0
1015,871,24-09-2019 16:40:00,1,2367.0,1969.0,0.832,11.505,34,14,12,2,20,16,4,0,0.0,0.0
1015,872,24-09-2019 16:42:00,1,2601.0,2020.0,0.776,12.485,1,1,0,1,0,0,0,0,0.0,0.0
1015,873,24-09-2019 16:44:00,1,2482.0,1977.0,0.796,11.969,1,0,0,0,1,1,0,0,0.0,0.0
1015,874,24-09-2019 16:46:00,1,2364.0,1933.0,0.818,11.454,7,3,0,3,4,1,3,0,0.0,0.0
1015,875,24-09-2019 16:48:00,1,2369.0,1909.0,0.806,11.446,5,3,1,2,2,0,2,0,0.0,0.0
1015,876,24-09-2019 16:50:00,1,2383.0,1873.0,0.786,11.464,0,0,0,0,0,0,0,0,0.0,0.0
1015,877,24-09-2019 16:52:00,1,2385.0,1821.0,0.764,11.415,93,47,27,20,46,14,32,18,0.0,0.0
1015,878,24-09-2019 16:54:00,1,2696.0,2117.0,0.785,12.967,138,56,28,28,82,7,75,65,0.0,0.0
1015,879,24-09-2019 16:56:00,1,3255.0,2474.0,0.76,15.563,102,36,12,24,66,4,62,54,0.0,0.0
1015,880,24-09-2019 16:58:00,1,3209.0,2650.0,0.826,15.577,431,245,197,48,186,131,55,57,0.0,0.02
1015,881,24-09-2019 17:00:00,1,3200.0,2681.0,0.838,15.575,284,187,146,41,97,72,25,48,0.0,0.02
1015,882,24-09-2019 17:02:00,1,3191.0,2712.0,0.85,15.573,638,353,282,71,285,218,67,67,0.06,0.04
1015,883,24-09-2019 17:04:00,1,3232.0,2565.0,0.794,15.574,509,242,192,50,267,211,56,71,0.0,0.0
1015,884,24-09-2019 17:06:00,1,3235.0,2567.0,0.794,15.587,65,40,21,19,25,12,13,1,0.0,0.0
1015,885,24-09-2019 17:08:00,1,2895.0,2371.0,0.819,14.03,65,59,38,21,6,2,4,0,0.01,0.0
1015,886,24-09-2019 17:10:00,1,3226.0,2586.0,0.802,15.572,55,37,12,25,18,1,17,0,0.0,0.0
1015,887,24-09-2019 17:12:00,1,3209.0,2746.0,0.856,15.682,22,8,4,4,14,1,13,0,0.0,0.0
1015,888,24-09-2019 17:14:00,1,2984.0,2501.0,0.838,14.526,4,0,0,0,4,0,4,0,0.0,0.0
1015,889,24-09-2019 17:16:00,1,2888.0,2382.0,0.825,14.017,0,0,0,0,0,0,0,0,0.0,0.0
1015,890,24-09-2019 17:18:00,1,2918.0,2288.0,0.784,14.031,0,0,0,0,0,0,0,0,0.0,0.0
1015,891,24-09-2019 17:20:00,1,2665.0,2242.0,0.841,12.982,5,5,1,4,0,0,0,0,0.0,0.0
1015,892,24-09-2019 17:22:00,1,2678.0,2202.0,0.822,12.988,2,1,0,1,1,1,0,0,0.0,0.0
1015,893,24-09-2019 17:24:00,1,2669.0,2253.0,0.844,13.01,2,0,0,0,2,1,1,0,0.0,0.0
1015,894,24-09-2019 17:26:00,1,2673.0,2266.0,0.848,13.042,0,0,0,0,0,0,0,0,0.0,0.0
1015,895,24-09-2019 17:28:00,1,2772.0,2319.0,0.837,13.491,74,48,28,20,26,10,16,0,0.0,0.0
1015,896,24-09-2019 17:30:00,1,2869.0,2454.0,0.855,14.02,16,15,2,13,1,1,0,0,0.0,0.0
1015,897,24-09-2019 17:32:00,1,2862.0,2497.0,0.872,14.043,42,33,12,21,9,1,8,0,0.0,0.0
1015,898,24-09-2019 17:34:00,1,3021.5,2640.0,0.8735,14.828,41,31,10,21,10,2,8,0,0.0,0.0
1015,899,24-09-2019 17:36:00,1,3181.0,2783.0,0.875,15.613,44,31,9,22,13,6,7,0,0.0,0.0
1015,900,24-09-2019 17:38:00,1,3205.0,2684.0,0.837,15.598,118,88,50,38,30,11,19,4,0.0,0.0
1015,901,24-09-2019 17:40:00,1,3166.0,2839.0,0.897,15.617,373,178,146,32,195,123,72,61,0.0,0.0
1015,902,24-09-2019 17:42:00,1,3409.0,2875.0,0.843,16.614,158,80,49,31,78,51,27,7,0.0,0.0
1015,903,24-09-2019 17:44:00,1,3160.0,2814.0,0.89,15.565,25,15,7,8,10,2,8,0,0.0,0.0
1015,904,24-09-2019 17:46:00,1,3105.0,2555.0,0.823,15.062,15,3,2,1,12,5,7,0,0.0,0.0
1015,905,24-09-2019 17:48:00,1,2898.0,2391.0,0.825,14.064,11,10,0,10,1,0,1,0,0.0,0.0
1015,906,24-09-2019 17:50:00,1,2799.0,2247.0,0.803,13.515,6,6,4,2,0,0,0,0,0.0,0.0
1015,907,24-09-2019 17:52:00,1,2684.0,2168.0,0.808,12.977,4,4,0,4,0,0,0,0,0.01,0.0
1015,908,24-09-2019 17:54:00,1,2694.0,2157.0,0.801,13.001,2,2,1,1,0,0,0,0,0.0,0.0
1015,909,24-09-2019 17:56:00,1,2693.0,2100.0,0.78,12.934,1,0,0,0,1,0,1,0,0.0,0.0
1015,910,24-09-2019 17:58:00,1,2349.0,1940.0,0.826,11.402,1,0,0,0,1,0,1,0,0.0,0.0
1015,911,24-09-2019 18:00:00,0,2356.0,1978.0,0.84,11.473,10,10,6,4,0,0,0,0,0.0,0.0
1015,912,24-09-2019 18:02:00,0,2604.0,2007.0,0.771,12.48,12,10,5,5,2,1,1,0,0.0,0.0
1015,913,24-09-2019 18:04:00,0,2699.0,2117.0,0.784,12.977,155,91,59,32,64,40,24,21,0.0,0.0
1015,914,24-09-2019 18:06:00,0,2899.0,2374.0,0.819,14.05,128,95,60,35,33,15,18,1,0.0,0.0
1015,915,24-09-2019 18:08:00,0,3068.5,2472.0,0.8065,14.826,78,70,38,32,8,0,8,0,0.0,0.0
1015,916,24-09-2019 18:10:00,0,3238.0,2570.0,0.794,15.602,124,89,55,34,35,3,32,14,0.0,0.0
1015,917,24-09-2019 18:12:00,0,3204.0,2616.0,0.817,15.522,104,22,10,12,82,0,82,48,0.0,0.0
1015,918,24-09-2019 18:14:00,0,3789.0,2969.0,0.784,18.216,528,290,237,53,238,169,69,111,0.0,0.02
1015,919,24-09-2019 18:16:00,0,3448.0,2758.0,0.8,16.639,124,86,71,15,38,27,11,19,0.0,0.0
1015,920,24-09-2019 18:18:00,0,3336.0,2708.0,0.812,16.14,201,102,87,15,99,55,44,67,0.0,0.0
1015,921,24-09-2019 18:20:00,0,3429.0,2836.0,0.827,16.653,93,24,10,14,69,0,69,47,0.0,0.04
1015,922,24-09-2019 18:22:00,0,3756.0,3025.0,0.805,18.148,107,22,10,12,85,0,85,62,0.0,0.05
1015,923,24-09-2019 18:24:00,0,3721.0,3136.0,0.843,18.131,152,56,38,18,96,23,73,37,0.0,0.08
1015,924,24-09-2019 18:26:00,0,3535.0,3000.0,0.849,17.251,350,195,147,48,155,122,33,112,0.06,0.0
1015,925,24-09-2019 18:28:00,0,3609.0,3032.0,0.84,17.577,287,131,103,28,156,113,43,71,0.0,0.03
1015,926,24-09-2019 18:30:00,0,3713.0,3286.0,0.885,18.269,287,156,117,39,131,91,40,65,0.0,0.0
1015,927,24-09-2019 18:32:00,0,3709.0,3238.0,0.873,18.197,329,162,130,32,167,117,50,70,0.0,0.0
1015,928,24-09-2019 18:34:00,0,2362.0,1947.0,0.824,11.463,312,172,131,41,140,95,45,36,0.0,0.0
1015,929,24-09-2019 18:36:00,0,2774.0,2353.0,0.848,13.532,141,57,43,14,84,59,25,11,0.03,0.0
1015,930,24-09-2019 18:38:00,0,3874.0,3541.0,0.914,19.185,111,23,4,19,88,49,39,1,0.01,0.0
1015,931,24-09-2019 18:40:00,0,3885.0,3555.0,0.915,19.243,292,155,126,29,137,91,46,107,0.01,0.0
1015,932,24-09-2019 18:42:00,0,3799.5,3396.5,0.8935,18.73,109,19,9,10,90,0,90,66,0.0,0.02
1015,933,24-09-2019 18:44:00,0,3714.0,3238.0,0.872,18.217,108,14,8,6,94,0,94,51,0.0,0.08
1015,934,24-09-2019 18:46:00,0,3701.0,3292.0,0.89,18.227,147,29,16,13,118,31,87,29,0.03,0.07
1015,935,24-09-2019 18:48:00,0,3693.0,3253.0,0.881,18.151,177,101,80,21,76,63,13,13,0.0,0.0
1015,936,24-09-2019 18:50:00,0,4115.0,3644.0,0.885,20.247,336,153,119,34,183,137,46,77,0.04,0.0
1015,937,24-09-2019 18:52:00,0,3293.0,2899.0,0.88,16.185,248,136,113,23,112,82,30,43,0.0,0.0
1015,938,24-09-2019 18:54:00,0,3286.0,2910.0,0.886,16.169,337,184,147,37,153,114,39,48,0.0,0.0
1015,939,24-09-2019 18:56:00,0,3166.0,2765.0,0.873,15.534,456,242,185,57,214,168,46,100,0.01,0.0
1015,940,24-09-2019 18:58:00,0,3916.0,3453.0,0.882,19.253,182,87,65,22,95,65,30,13,0.09,0.0
1015,941,24-09-2019 19:00:00,0,3899.0,3591.0,0.921,19.338,95,37,9,28,58,23,35,3,0.0,0.0
1015,942,24-09-2019 19:02:00,0,3907.0,3533.0,0.904,19.304,330,197,151,46,133,97,36,94,0.0,0.0
1015,943,24-09-2019 19:04:00,0,3334.0,3070.0,0.921,16.535,393,191,150,41,202,161,41,76,0.01,0.0
1015,944,24-09-2019 19:06:00,0,3903.0,3475.0,0.89,19.226,207,139,120,19,68,42,26,52,0.0,0.02
1015,945,24-09-2019 19:08:00,0,4216.0,3809.0,0.903,20.827,98,32,18,14,66,4,62,42,0.0,0.08
1015,946,24-09-2019 19:10:00,0,4244.0,3796.0,0.894,20.925,92,46,32,14,46,28,18,4,0.07,0.01
1015,947,24-09-2019 19:12:00,0,3374.0,2982.0,0.884,16.595,34,30,12,18,4,0,4,3,0.0,0.0
1015,948,24-09-2019 19:14:00,0,3180.0,2790.0,0.877,15.617,89,46,41,5,43,15,28,1,0.0,0.0
1015,949,24-09-2019 19:16:00,0,3276.0,2941.5,0.897,16.163,143,108,61,47,35,7,28,0,0.0,0.0
1015,950,24-09-2019 19:18:00,0,3372.0,3093.0,0.917,16.709,80,60,31,29,20,13,7,3,0.0,0.0
1015,951,24-09-2019 19:20:00,0,3901.0,3528.0,0.904,19.277,285,160,126,34,125,93,32,36,0.01,0.01
1015,952,24-09-2019 19:22:00,0,3908.0,3511.0,0.899,19.285,356,179,131,48,177,139,38,76,0.05,0.0
1015,953,24-09-2019 19:24:00,0,3158.0,2835.0,0.898,15.58,63,39,16,23,24,2,22,0,0.0,0.0
1015,954,24-09-2019 19:26:00,0,3158.0,2831.0,0.896,15.579,54,42,17,25,12,0,12,0,0.0,0.0
1015,955,24-09-2019 19:28:00,0,3659.0,3345.0,0.914,18.119,69,48,24,24,21,4,17,0,0.0,0.0
1015,956,24-09-2019 19:30:00,0,3778.0,3440.0,0.911,18.694,6,4,2,2,2,0,2,0,0.01,0.01
1015,957,24-09-2019 19:32:00,0,3699.0,3327.0,0.9,18.256,6,3,2,1,3,0,3,0,0.01,0.0
1015,958,24-09-2019 19:34:00,0,3611.0,3188.0,0.883,17.757,10,8,4,4,2,0,2,0,0.0,0.0
1015,959,24-09-2019 19:36:00,0,3361.0,3053.0,0.909,16.621,8,8,6,2,0,0,0,0,0.0,0.0
1015,960,24-09-2019 19:38:00,0,3261.0,2936.0,0.9,16.101,50,43,26,17,7,3,4,0,0.0,0.0
1015,961,24-09-2019 19:40:00,0,3251.0,2956.0,0.909,16.082,123,76,56,20,47,18,29,12,0.0,0.2
1015,962,24-09-2019 19:42:00,0,3587.0,3245.0,0.905,17.724,42,8,3,5,34,2,32,0,0.0,0.01
1015,963,24-09-2019 19:44:00,0,3708.0,3302.0,0.89,18.266,184,110,76,34,74,35,39,4,0.0,0.0
1015,964,24-09-2019 19:46:00,0,3667.0,3337.0,0.91,18.143,314,160,121,39,154,111,43,25,0.04,0.02
1015,965,24-09-2019 19:48:00,0,3664.0,3440.0,0.939,18.246,303,167,124,43,136,90,46,62,0.0,0.0
1015,966,24-09-2019 19:50:00,0,3502.0,3308.0,0.945,17.46,367,216,157,59,151,117,34,72,0.0,0.0
1015,967,24-09-2019 19:52:00,0,3340.0,3176.0,0.951,16.674,273,131,104,27,142,107,35,75,0.05,0.0
1015,968,24-09-2019 19:54:00,0,3336.0,3153.0,0.945,16.635,178,104,69,35,74,48,26,59,0.0,0.0
1015,969,24-09-2019 19:56:00,0,3581.0,3256.0,0.909,17.715,284,135,105,30,149,106,43,35,0.1,0.04
1015,970,24-09-2019 19:58:00,0,3576.0,3291.0,0.92,17.732,502,245,189,56,257,195,62,94,0.0,0.0
1015,971,24-09-2019 20:00:00,0,3362.0,3107.0,0.924,16.686,187,96,70,26,91,61,30,41,0.0,0.0
1015,972,24-09-2019 20:02:00,0,3681.0,3382.0,0.919,18.248,450,237,184,53,213,164,49,81,0.0,0.0
1015,973,24-09-2019 20:04:00,0,3670.0,3350.0,0.913,18.169,267,136,98,38,131,92,39,58,0.0,0.0
1015,974,24-09-2019 20:06:00,0,3911.0,3460.0,0.885,19.238,121,34,18,16,87,50,37,21,0.0,0.0
1015,975,24-09-2019 20:08:00,0,3699.0,3280.0,0.887,18.206,128,77,55,22,51,39,12,40,0.0,0.0
1015,976,24-09-2019 20:10:00,0,3156.0,2829.0,0.896,15.568,99,43,31,12,56,40,16,10,0.0,0.0
1015,977,24-09-2019 20:12:00,0,3697.0,3274.0,0.886,18.191,116,79,61,18,37,25,12,11,0.0,0.0
1015,978,24-09-2019 20:14:00,0,3344.0,3111.0,0.93,16.618,76,48,28,20,28,8,20,0,0.0,0.0
1015,979,24-09-2019 20:16:00,0,3691.0,3277.0,0.888,18.172,60,42,19,23,18,2,16,0,0.0,0.0
1015,980,24-09-2019 20:18:00,0,3579.0,3245.0,0.907,17.693,146,85,53,32,61,6,55,47,0.0,0.0
1015,981,24-09-2019 20:20:00,0,3897.0,3537.0,0.908,19.272,115,46,27,19,69,0,69,72,0.0,0.0
1015,982,24-09-2019 20:22:00,0,3985.0,3675.0,0.922,19.77,240,137,102,35,103,61,42,59,0.0,0.06
1015,983,24-09-2019 20:24:00,0,4100.0,3745.0,0.9135,20.2995,411,178,140,38,233,187,46,67,0.0,0.0
1015,984,24-09-2019 20:26:00,0,4215.0,3815.0,0.905,20.829,255,154,120,34,101,71,30,21,0.0,0.01
1015,985,24-09-2019 20:28:00,0,3696.0,3331.0,0.901,18.251,383,193,145,48,190,141,49,119,0.0,0.01
1015,986,24-09-2019 20:30:00,0,3965.0,3736.0,0.942,19.756,86,41,18,23,45,31,14,2,0.0,0.0
1015,987,24-09-2019 20:32:00,0,3843.0,3674.0,0.956,19.209,125,75,50,25,50,29,21,6,0.0,0.0
1015,988,24-09-2019 20:34:00,0,3184.0,2798.0,0.879,15.644,173,99,67,32,74,27,47,50,0.0,0.0
1015,989,24-09-2019 20:36:00,0,3694.0,3258.0,0.882,18.161,105,48,24,24,57,9,48,40,0.0,0.0
1015,990,24-09-2019 20:38:00,0,3863.0,3663.0,0.948,19.275,147,92,70,22,55,38,17,13,0.0,0.0
1015,991,24-09-2019 20:40:00,0,4105.0,3727.0,0.908,20.301,50,20,2,18,30,16,14,0,0.04,0.01
1015,992,24-09-2019 20:42:00,0,3663.0,3448.0,0.941,18.251,352,185,143,42,167,116,51,92,0.0,0.0
1015,993,24-09-2019 20:44:00,0,3698.0,3210.0,0.868,18.125,140,73,40,33,67,6,61,74,0.0,0.0
1015,994,24-09-2019 20:46:00,0,3923.0,3503.0,0.893,19.334,333,161,126,35,172,125,47,104,0.0,0.01
1015,995,24-09-2019 20:48:00,0,3154.0,2874.0,0.911,15.609,245,112,81,31,133,93,40,43,0.02,0.0
1015,996,24-09-2019 20:50:00,0,3594.0,3221.0,0.896,17.727,331,161,132,29,170,118,52,148,0.03,0.0
1015,997,24-09-2019 20:52:00,0,3902.0,3473.0,0.89,19.218,107,39,22,17,68,2,66,64,0.02,0.0
1015,998,24-09-2019 20:54:00,0,3855.0,3673.0,0.953,19.256,188,87,61,26,101,55,46,16,0.0,0.0
1015,999,24-09-2019 20:56:00,0,3186.0,2766.0,0.868,15.614,139,84,64,20,55,30,25,26,0.0,0.0
1015,1000,24-09-2019 20:58:00,0,3651.0,3244.0,0.886,17.976,173,107,89,18,66,27,39,65,0.0,0.0
1015,1001,24-09-2019 21:00:00,0,4116.0,3722.0,0.904,20.338,191,92,61,31,99,39,60,58,0.0,0.03
1015,1002,24-09-2019 21:02:00,0,3905.0,3573.0,0.915,19.341,449,257,208,49,192,135,57,117,0.0,0.01
1015,1003,24-09-2019 21:04:00,0,4428.0,4022.0,0.908,21.9,120,76,57,19,44,34,10,12,0.0,0.01
1015,1004,24-09-2019 21:06:00,0,3858.0,3656.0,0.948,19.249,387,185,153,32,202,136,66,106,0.0,0.02
1015,1005,24-09-2019 21:08:00,0,3880.0,3551.0,0.915,19.218,180,83,61,22,97,35,62,50,0.0,0.0
1015,1006,24-09-2019 21:10:00,0,4394.0,4059.0,0.924,21.805,200,110,82,28,90,65,25,65,0.0,0.0
1015,1007,24-09-2019 21:12:00,0,4169.0,3910.0,0.938,20.756,121,46,29,17,75,13,62,67,0.0,0.0
1015,1008,24-09-2019 21:14:00,0,4184.0,3938.0,0.941,20.844,129,57,32,25,72,3,69,68,0.0,0.0
1015,1009,24-09-2019 21:16:00,0,4212.0,3837.0,0.911,20.845,181,73,51,22,108,64,44,8,0.03,0.07
1015,1010,24-09-2019 21:18:00,0,4178.0,3911.0,0.936,20.79,329,128,99,29,201,143,58,51,0.0,0.0
1015,1011,24-09-2019 21:20:00,0,4296.0,3908.0,0.91,21.253,272,35,18,17,237,170,67,23,0.04,0.0
1015,1012,24-09-2019 21:22:00,0,3864.0,3650.0,0.945,19.265,456,210,160,50,246,177,69,69,0.01,0.06
1015,1013,24-09-2019 21:24:00,0,4227.0,3803.0,0.9,20.866,101,35,25,10,66,0,66,64,0.0,0.0
1015,1014,24-09-2019 21:26:00,0,4281.0,3974.0,0.928,21.267,79,37,26,11,42,5,37,50,0.0,0.04
1015,1015,24-09-2019 21:28:00,0,4204.0,3890.0,0.925,20.872,331,176,140,36,155,122,33,59,0.03,0.01
1015,1016,24-09-2019 21:30:00,0,3872.0,3516.0,0.908,19.147,278,154,120,34,124,66,58,119,0.0,0.01
1015,1017,24-09-2019 21:32:00,0,4144.0,3785.5,0.913,20.518,123,42,24,18,81,2,79,80,0.0,0.06
1015,1018,24-09-2019 21:34:00,0,4416.0,4055.0,0.918,21.889,267,121,97,24,146,103,43,5,0.08,0.04
1015,1019,24-09-2019 21:36:00,0,4181.0,3929.0,0.94,20.823,306,155,128,27,151,114,37,23,0.04,0.0
1015,1020,24-09-2019 21:38:00,0,4618.0,4213.0,0.912,22.858,101,33,7,26,68,45,23,0,0.0,0.01
1015,1021,24-09-2019 21:40:00,0,4498.0,4213.0,0.937,22.386,28,14,7,7,14,6,8,0,0.0,0.0
1015,1022,24-09-2019 21:42:00,0,4181.0,3954.0,0.946,20.85,97,45,26,19,52,2,50,66,0.0,0.01
1015,1023,24-09-2019 21:44:00,0,4087.0,3704.0,0.906,20.202,72,12,9,3,60,22,38,17,0.0,0.03
1015,1024,24-09-2019 21:46:00,0,4190.0,3925.0,0.937,20.854,0,0,0,0,0,0,0,0,0.0,0.0
1015,1025,24-09-2019 21:48:00,0,4223.0,3786.0,0.897,20.829,171,87,63,24,84,59,25,17,0.05,0.0
1015,1026,24-09-2019 21:50:00,0,3889.0,3495.0,0.899,19.194,139,28,0,28,111,57,54,0,0.01,0.0
1015,1027,24-09-2019 21:52:00,0,3883.0,3564.0,0.918,19.246,51,13,0,13,38,16,22,1,0.0,0.0
1015,1028,24-09-2019 21:54:00,0,4177.0,3920.0,0.938,20.797,333,178,134,44,155,113,42,47,0.0,0.06
1015,1029,24-09-2019 21:56:00,0,3863.0,3691.0,0.955,19.304,479,191,140,51,288,226,62,44,0.04,0.0
1015,1030,24-09-2019 21:58:00,0,3677.0,3344.0,0.909,18.187,445,206,163,43,239,181,58,89,0.02,0.01
1015,1031,24-09-2019 22:00:00,0,3861.0,3609.0,0.935,19.21,185,96,65,31,89,41,48,77,0.0,0.0
1015,1032,24-09-2019 22:02:00,0,3882.0,3617.0,0.932,19.299,235,124,97,27,111,58,53,63,0.0,0.0
1015,1033,24-09-2019 22:04:00,0,3878.0,3561.0,0.918,19.223,402,207,166,41,195,148,47,97,0.0,0.0
1015,1034,24-09-2019 22:06:00,0,4036.5,3736.0,0.925,20.0405,143,44,27,17,99,50,49,56,0.0,0.0
1015,1035,24-09-2019 22:08:00,0,4195.0,3911.0,0.932,20.858,207,81,58,23,126,85,41,21,0.03,0.0
1015,1036,24-09-2019 22:10:00,0,3707.0,3289.0,0.887,18.248,349,195,155,40,154,88,66,85,0.0,0.0
1015,1037,24-09-2019 22:12:00,0,4173.0,3934.0,0.943,20.798,129,65,43,22,64,1,63,84,0.01,0.0
1015,1038,24-09-2019 22:14:00,0,4389.0,4113.0,0.937,21.845,127,72,58,14,55,39,16,36,0.0,0.07
1015,1039,24-09-2019 22:16:00,0,4398.0,4175.0,0.949,21.95,102,63,37,26,39,25,14,4,0.07,0.01
1015,1040,24-09-2019 22:18:00,0,3862.0,3672.0,0.951,19.283,411,198,162,36,213,145,68,99,0.0,0.0
1015,1041,24-09-2019 22:20:00,0,3362.0,3131.0,0.931,16.711,284,157,113,44,127,76,51,78,0.0,0.07
1015,1042,24-09-2019 22:22:00,0,3770.0,3454.0,0.916,18.677,530,276,225,51,254,207,47,280,0.0,0.0
1015,1043,24-09-2019 22:24:00,0,3371.0,3069.0,0.91,16.677,266,123,91,32,143,109,34,45,0.0,0.0
1015,1044,24-09-2019 22:26:00,0,4165.0,3959.0,0.951,20.792,441,223,177,46,218,163,55,86,0.01,0.0
1015,1045,24-09-2019 22:28:00,0,3871.0,3673.0,0.949,19.316,108,44,24,20,64,2,62,84,0.0,0.0
1015,1046,24-09-2019 22:30:00,0,4409.0,4058.0,0.92,21.866,154,60,30,30,94,41,53,62,0.01,0.0
1015,1047,24-09-2019 22:32:00,0,3361.0,3072.0,0.914,16.645,244,127,102,25,117,83,34,57,0.05,0.0
1015,1048,24-09-2019 22:34:00,0,4162.0,3955.0,0.95,20.777,239,136,100,36,103,63,40,82,0.01,0.0
1015,1049,24-09-2019 22:36:00,0,4304.0,3935.0,0.914,21.315,133,68,47,21,65,8,57,58,0.0,0.0
1015,1050,24-09-2019 22:38:00,0,4169.0,3985.0,0.956,20.838,295,101,68,33,194,164,30,52,0.02,0.01
1015,1051,24-09-2019 22:40:00,0,4035.5,3762.0,0.9315,20.065,388,218,175,43,170,118,52,75,0.0,0.0
1015,1052,24-09-2019 22:42:00,0,3902.0,3539.0,0.907,19.292,244,102,73,29,142,92,50,80,0.03,0.01
1015,1053,24-09-2019 22:44:00,0,4399.0,4109.0,0.934,21.879,143,65,46,19,78,41,37,46,0.0,0.0
1015,1054,24-09-2019 22:46:00,0,3965.0,3709.0,0.935,19.728,532,223,174,49,309,227,82,29,0.01,0.0
1015,1055,24-09-2019 22:48:00,0,3685.0,3290.0,0.893,18.16,454,200,145,55,254,190,64,27,0.0,0.01
1015,1056,24-09-2019 22:50:00,0,3865.0,3699.0,0.957,19.322,331,161,110,51,170,114,56,37,0.0,0.08
1015,1057,24-09-2019 22:52:00,0,3988.0,3714.0,0.931,19.825,198,111,76,35,87,23,64,104,0.01,0.0
1015,1058,24-09-2019 22:54:00,0,4174.0,3864.0,0.926,20.724,132,59,34,25,73,13,60,57,0.0,0.01
1015,1059,24-09-2019 22:56:00,0,4282.0,3993.0,0.932,21.291,241,126,102,24,115,86,29,61,0.0,0.0
1015,1060,24-09-2019 22:58:00,0,3995.0,3595.0,0.9,19.719,388,166,131,35,222,156,66,101,0.06,0.0
1015,1061,24-09-2019 23:00:00,0,4199.0,3958.0,0.943,20.927,120,55,32,23,65,4,61,84,0.0,0.0
1015,1062,24-09-2019 23:02:00,0,4297.0,3955.0,0.921,21.308,172,68,43,25,104,34,70,72,0.0,0.08
1015,1063,24-09-2019 23:04:00,0,3160.0,2818.0,0.892,15.57,309,81,65,16,228,179,49,27,0.03,0.0
1015,1064,24-09-2019 23:06:00,0,3383.0,3012.0,0.89,16.665,428,242,200,42,186,131,55,93,0.01,0.01
1015,1065,24-09-2019 23:08:00,0,3259.0,2982.0,0.915,16.141,241,103,73,30,138,98,40,43,0.0,0.0
1015,1066,24-09-2019 23:10:00,0,4390.0,4110.0,0.936,21.845,161,24,3,21,137,110,27,0,0.0,0.0
1015,1067,24-09-2019 23:12:00,0,4704.0,4341.0,0.923,23.341,154,34,11,23,120,103,17,30,0.01,0.0
1015,1068,24-09-2019 23:14:00,0,4393.5,4065.5,0.9255,21.8125,116,77,54,23,39,23,16,12,0.0,0.0
1015,1069,24-09-2019 23:16:00,0,4083.0,3790.0,0.928,20.284,235,105,78,27,130,85,45,55,0.0,0.0
1015,1070,24-09-2019 23:18:00,0,3788.0,3430.0,0.906,18.724,177,67,49,18,110,55,55,87,0.0,0.0
1015,1071,24-09-2019 23:20:00,0,3887.0,3533.0,0.909,19.227,102,29,13,16,73,0,73,66,0.0,0.02
1015,1072,24-09-2019 23:22:00,0,4176.0,3918.0,0.938,20.791,95,4,0,4,91,0,91,54,0.0,0.13
1015,1073,24-09-2019 23:24:00,0,4409.0,4051.0,0.919,21.856,249,74,54,20,175,111,64,14,0.08,0.05
1015,1074,24-09-2019 23:26:00,0,3971.0,3728.0,0.939,19.772,480,240,189,51,240,188,52,56,0.04,0.0
1015,1075,24-09-2019 23:28:00,0,3863.0,3628.0,0.939,19.236,280,133,101,32,147,94,53,82,0.0,0.02
1015,1076,24-09-2019 23:30:00,0,4394.0,4155.0,0.945,21.914,322,183,150,33,139,109,30,68,0.08,0.0
1015,1077,24-09-2019 23:32:00,0,3128.0,2922.0,0.934,15.561,549,273,215,58,276,213,63,35,0.0,0.0
1015,1078,24-09-2019 23:34:00,0,3765.0,3465.0,0.92,18.669,712,351,285,66,361,284,77,75,0.0,0.0
1015,1079,24-09-2019 23:36:00,0,3988.0,3674.0,0.921,19.781,493,328,259,69,165,120,45,13,0.0,0.0
1015,1080,24-09-2019 23:38:00,0,3921.0,3466.0,0.884,19.286,92,50,45,5,42,32,10,9,0.01,0.0
1015,1081,24-09-2019 23:40:00,0,4221.0,3842.0,0.91,20.883,254,109,74,35,145,94,51,113,0.0,0.0
1015,1082,24-09-2019 23:42:00,0,3858.0,3606.0,0.935,19.191,90,23,13,10,67,0,67,53,0.01,0.0
1015,1083,24-09-2019 23:44:00,0,4211.0,3775.0,0.897,20.77,98,17,8,9,81,0,81,49,0.0,0.06
1015,1084,24-09-2019 23:46:00,0,4302.0,4022.0,0.935,21.404,100,14,6,8,86,0,86,50,0.0,0.06
1015,1085,24-09-2019 23:48:00,0,4297.5,3992.0,0.929,21.3515,329,85,56,29,244,180,64,24,0.06,0.05
1015,1086,24-09-2019 23:50:00,0,4293.0,3962.0,0.923,21.299,199,87,68,19,112,88,24,18,0.02,0.0
1015,1087,24-09-2019 23:52:00,0,4173.0,3873.0,0.928,20.729,346,205,176,29,141,105,36,18,0.05,0.01
1015,1088,24-09-2019 23:54:00,0,2949.0,2678.0,0.908,14.583,388,166,137,29,222,186,36,28,0.0,0.0
1015,1089,24-09-2019 23:56:00,0,3861.0,3656.0,0.947,19.26,504,225,178,47,279,200,79,111,0.03,0.0
1015,1090,24-09-2019 23:58:00,0,3864.0,3686.0,0.954,19.307,237,102,90,12,135,109,26,21,0.01,0.01
1015,1091,25-09-2019 00:00:00,0,4590.0,4233.0,0.922,22.771,497,237,193,44,260,208,52,132,0.0,0.02
1015,1092,25-09-2019 00:02:00,0,3860.0,3670.0,0.951,19.269,370,202,162,40,168,130,38,192,0.0,0.0
1015,1093,25-09-2019 00:04:00,0,3705.0,3298.0,0.89,18.248,182,87,62,25,95,59,36,14,0.0,0.0
1015,1094,25-09-2019 00:06:00,0,3852.0,3712.0,0.964,19.285,428,236,192,44,192,147,45,73,0.02,0.0
1015,1095,25-09-2019 00:08:00,0,4426.0,4030.0,0.911,21.899,101,20,7,13,81,0,81,64,0.0,0.0
1015,1096,25-09-2019 00:10:00,0,4406.0,4011.0,0.91,21.802,108,50,31,19,58,7,51,41,0.0,0.06
1015,1097,25-09-2019 00:12:00,0,3883.0,3538.0,0.911,19.217,228,124,92,32,104,73,31,10,0.0,0.01
1015,1098,25-09-2019 00:14:00,0,3395.0,2990.0,0.881,16.687,114,79,62,17,35,22,13,0,0.0,0.01
1015,1099,25-09-2019 00:16:00,0,3478.0,3157.0,0.908,17.198,335,153,114,39,182,137,45,5,0.04,0.0
1015,1100,25-09-2019 00:18:00,0,3866.0,3570.0,0.924,19.184,223,150,121,29,73,46,27,0,0.02,0.0
1015,1101,25-09-2019 00:20:00,0,3878.0,3635.0,0.937,19.303,145,122,84,38,23,12,11,0,0.0,0.0
1015,1102,25-09-2019 00:22:00,0,3898.5,3580.0,0.9185,19.3225,68,55,22,33,13,4,9,0,0.0,0.01
1015,1103,25-09-2019 00:24:00,0,3919.0,3525.0,0.9,19.342,44,41,11,30,3,0,3,0,0.0,0.0
1015,1104,25-09-2019 00:26:00,0,3873.0,3553.0,0.917,19.192,29,17,0,17,12,1,11,0,0.0,0.0
1015,1105,25-09-2019 00:28:00,0,3881.0,3597.0,0.927,19.275,37,15,1,14,22,0,22,0,0.0,0.0
1015,1106,25-09-2019 00:30:00,0,3857.0,3658.0,0.949,19.245,300,197,149,48,103,71,32,14,0.0,0.0
1015,1107,25-09-2019 00:32:00,0,3870.0,3678.0,0.951,19.318,109,82,47,35,27,15,12,12,0.0,0.0
1015,1108,25-09-2019 00:34:00,0,3853.0,3712.0,0.963,19.291,122,76,51,25,46,32,14,8,0.0,0.0
1015,1109,25-09-2019 00:36:00,0,3665.0,3376.0,0.921,18.177,2,0,0,0,2,1,1,0,0.0,0.0
1015,1110,25-09-2019 00:38:00,0,3724.0,3219.0,0.864,18.238,5,4,2,2,1,1,0,0,0.0,0.0
1015,1111,25-09-2019 00:40:00,0,3462.0,3151.0,0.91,17.127,0,0,0,0,0,0,0,0,0.0,0.0
1015,1112,25-09-2019 00:42:00,0,3265.0,2950.0,0.903,16.131,1,0,0,0,1,1,0,0,0.0,0.0
1015,1113,25-09-2019 00:44:00,0,3155.0,2814.0,0.892,15.546,1,0,0,0,1,0,1,0,0.0,0.0
1015,1114,25-09-2019 00:46:00,0,3069.0,2702.0,0.88,15.083,2,0,0,0,2,0,2,0,0.0,0.0
1015,1115,25-09-2019 00:48:00,0,2956.0,2671.0,0.903,14.602,18,13,6,7,5,3,2,0,0.0,0.0
1015,1116,25-09-2019 00:50:00,0,3066.0,2716.0,0.886,15.088,10,8,5,3,2,1,1,0,0.0,0.0
1015,1117,25-09-2019 00:52:00,0,2813.0,2653.0,0.943,14.022,1,0,0,0,1,1,0,0,0.0,0.0
1015,1118,25-09-2019 00:54:00,0,2843.0,2595.0,0.913,14.075,3,1,0,1,2,0,2,0,0.0,0.0
1015,1119,25-09-2019 00:56:00,0,2892.5,2652.0,0.917,14.3335,7,5,0,5,2,1,1,0,0.0,0.0
1015,1120,25-09-2019 00:58:00,0,2942.0,2709.0,0.921,14.592,26,23,4,19,3,0,3,0,0.0,0.0
1015,1121,25-09-2019 01:00:00,0,2820.0,2702.0,0.958,14.101,4,4,0,4,0,0,0,0,0.0,0.0
1015,1122,25-09-2019 01:02:00,0,2828.0,2643.0,0.934,14.07,13,11,0,11,2,0,2,0,0.0,0.0
1015,1123,25-09-2019 01:04:00,0,2848.0,2583.0,0.907,14.079,1,0,0,0,1,0,1,0,0.0,0.0
1015,1124,25-09-2019 01:06:00,0,2828.0,2619.0,0.926,14.041,0,0,0,0,0,0,0,0,0.0,0.0
1015,1125,25-09-2019 01:08:00,0,2835.0,2604.0,0.919,14.051,2,2,1,1,0,0,0,0,0.0,0.0
1015,1126,25-09-2019 01:10:00,0,2860.0,2529.0,0.884,14.067,90,55,42,13,35,22,13,0,0.0,0.0
1015,1127,25-09-2019 01:12:00,0,2836.0,2570.0,0.906,14.018,1,1,0,1,0,0,0,0,0.0,0.0
1015,1128,25-09-2019 01:14:00,0,2844.0,2621.0,0.921,14.107,2,2,0,2,0,0,0,0,0.0,0.0
1015,1129,25-09-2019 01:16:00,0,2825.0,2600.0,0.921,14.007,3,3,1,2,0,0,0,0,0.0,0.0
1015,1130,25-09-2019 01:18:00,0,2828.0,2616.0,0.925,14.037,4,4,1,3,0,0,0,0,0.0,0.0
1015,1131,25-09-2019 01:20:00,0,2820.0,2667.0,0.946,14.064,19,15,11,4,4,2,2,0,0.0,0.0
1015,1132,25-09-2019 01:22:00,0,2827.0,2633.0,0.931,14.052,44,42,8,34,2,1,1,0,0.0,0.0
1015,1133,25-09-2019 01:24:00,0,2829.0,2534.0,0.896,13.953,12,12,0,12,0,0,0,0,0.0,0.0
1015,1134,25-09-2019 01:26:00,0,2609.0,2484.0,0.952,13.031,52,21,9,12,31,10,21,0,0.0,0.0
1015,1135,25-09-2019 01:28:00,0,2835.0,2597.0,0.916,14.046,14,7,1,6,7,0,7,0,0.0,0.0
1015,1136,25-09-2019 01:30:00,0,2840.0,2572.0,0.9055,14.037,7,4,0,4,3,0,3,0,0.0,0.0
1015,1137,25-09-2019 01:32:00,0,2845.0,2547.0,0.895,14.028,11,6,0,6,5,0,5,0,0.0,0.0
1015,1138,25-09-2019 01:34:00,0,2846.0,2563.0,0.901,14.049,3,2,0,2,1,0,1,0,0.0,0.0
1015,1139,25-09-2019 01:36:00,0,2838.0,2581.0,0.909,14.04,10,0,0,0,10,0,10,0,0.0,0.0
1015,1140,25-09-2019 01:38:00,0,2847.0,2557.0,0.898,14.048,89,52,26,26,37,14,23,0,0.0,0.0
1015,1141,25-09-2019 01:40:00,0,2815.0,2710.0,0.963,14.09,54,31,11,20,23,8,15,0,0.0,0.0
1015,1142,25-09-2019 01:42:00,0,3158.0,2843.0,0.9,15.591,232,139,94,45,93,60,33,22,0.0,0.0
1015,1143,25-09-2019 01:44:00,0,3228.0,3087.0,0.956,16.136,291,175,146,29,116,82,34,59,0.0,0.0
1015,1144,25-09-2019 01:46:00,0,3343.0,3148.0,0.941,16.657,266,152,117,35,114,81,33,108,0.0,0.0
1015,1145,25-09-2019 01:48:00,0,3310.0,3244.0,0.98,16.632,204,97,68,29,107,65,42,46,0.0,0.0
1015,1146,25-09-2019 01:50:00,0,3351.0,3155.0,0.941,16.697,413,219,178,41,194,135,59,62,0.0,0.03
1015,1147,25-09-2019 01:52:00,0,3696.0,3341.0,0.904,18.261,248,137,110,27,111,60,51,101,0.0,0.0
1015,1148,25-09-2019 01:54:00,0,3786.0,3510.0,0.927,18.804,519,249,206,43,270,207,63,133,0.06,0.0
1015,1149,25-09-2019 01:56:00,0,3660.0,3430.0,0.937,18.217,117,27,23,4,90,8,82,37,0.0,0.23
1015,1150,25-09-2019 01:58:00,0,3695.0,3318.0,0.898,18.232,4,0,0,0,4,2,2,0,0.0,0.0
1015,1151,25-09-2019 02:00:00,0,3187.0,2801.0,0.879,15.657,78,14,5,9,64,37,27,1,0.0,0.0
1015,1152,25-09-2019 02:02:00,0,3686.0,3392.0,0.92,18.279,435,225,181,44,210,160,50,44,0.03,0.08
1015,1153,25-09-2019 02:04:00,0,3459.5,3241.5,0.938,17.22,587,263,204,59,324,248,76,134,0.09,0.0
1015,1154,25-09-2019 02:06:00,0,3233.0,3091.0,0.956,16.161,389,149,109,40,240,194,46,66,0.01,0.0
1015,1155,25-09-2019 02:08:00,0,4062.0,3864.0,0.951,20.28,450,215,171,44,235,187,48,96,0.06,0.0
1015,1156,25-09-2019 02:10:00,0,3718.0,3759.0,1.011,18.811,503,261,207,54,242,202,40,141,0.0,0.03
1015,1157,25-09-2019 02:12:00,0,3703.0,3689.0,0.996,18.672,458,211,169,42,247,195,52,160,0.03,0.0
1015,1158,25-09-2019 02:14:00,0,3225.0,3066.0,0.951,16.101,262,136,101,35,126,87,39,37,0.0,0.0
1015,1159,25-09-2019 02:16:00,0,3555.0,3391.0,0.954,17.759,331,188,147,41,143,110,33,59,0.02,0.0
1015,1160,25-09-2019 02:18:00,0,3854.0,3696.0,0.959,19.275,203,105,77,28,98,40,58,83,0.0,0.0
1015,1161,25-09-2019 02:20:00,0,4063.0,3912.0,0.963,20.338,395,216,184,32,179,137,42,59,0.03,0.0
1015,1162,25-09-2019 02:22:00,0,4024.0,3931.0,0.977,20.205,219,103,80,23,116,65,51,88,0.0,0.0
1015,1163,25-09-2019 02:24:00,0,3838.0,3708.0,0.966,19.227,358,175,149,26,183,140,43,76,0.03,0.0
1015,1164,25-09-2019 02:26:00,0,4283.0,4021.0,0.939,21.325,599,299,246,53,300,234,66,58,0.0,0.0
1015,1165,25-09-2019 02:28:00,0,4062.0,3875.0,0.954,20.294,191,38,18,20,153,91,62,25,0.01,0.0
1015,1166,25-09-2019 02:30:00,0,3749.0,3593.0,0.958,18.75,112,44,24,20,68,5,63,56,0.0,0.0
1015,1167,25-09-2019 02:32:00,0,4167.0,4014.0,0.963,20.861,341,201,158,43,140,93,47,46,0.01,0.0
1015,1168,25-09-2019 02:34:00,0,4088.0,3797.0,0.929,20.311,210,90,62,28,120,62,58,49,0.0,0.0
1015,1169,25-09-2019 02:36:00,0,3967.0,3706.0,0.934,19.732,233,146,109,37,87,44,43,32,0.0,0.0
1015,1170,25-09-2019 02:38:00,0,3654.5,3439.0,0.9415,18.205,575,318,255,63,257,192,65,4,0.04,0.0
1015,1171,25-09-2019 02:40:00,0,3342.0,3172.0,0.949,16.678,784,490,413,77,294,226,68,40,0.0,0.0
1015,1172,25-09-2019 02:42:00,0,3563.0,3271.0,0.918,17.66,381,228,177,51,153,116,37,48,0.0,0.0
1015,1173,25-09-2019 02:44:00,0,4031.0,3960.0,0.982,20.266,87,45,26,19,42,27,15,5,0.0,0.0
1015,1174,25-09-2019 02:46:00,0,3553.0,3364.0,0.947,17.725,77,56,23,33,21,3,18,0,0.0,0.0
1015,1175,25-09-2019 02:48:00,0,3570.0,3304.0,0.925,17.725,52,44,17,27,8,1,7,0,0.0,0.0
1015,1176,25-09-2019 02:50:00,0,3583.0,3255.0,0.908,17.72,19,18,7,11,1,1,0,0,0.0,0.0
1015,1177,25-09-2019 02:52:00,0,3550.0,3308.0,0.932,17.65,144,111,81,30,33,20,13,0,0.01,0.0
1015,1178,25-09-2019 02:54:00,0,3765.0,3515.0,0.934,18.726,781,536,446,90,245,193,52,0,0.0,0.0
1015,1179,25-09-2019 02:56:00,0,3740.0,3643.0,0.974,18.767,466,267,218,49,199,154,45,122,0.0,0.0
1015,1180,25-09-2019 02:58:00,0,3546.0,3394.0,0.957,17.727,268,157,113,44,111,81,30,49,0.0,0.0
1015,1181,25-09-2019 03:00:00,0,3763.0,3503.0,0.931,18.703,296,217,158,59,79,52,27,39,0.0,0.0
1015,1182,25-09-2019 03:02:00,0,3538.0,3365.0,0.951,17.666,87,73,36,37,14,1,13,0,0.0,0.0
1015,1183,25-09-2019 03:04:00,0,3566.0,3321.0,0.931,17.726,31,31,0,31,0,0,0,0,0.0,0.0
1015,1184,25-09-2019 03:06:00,0,3567.0,3329.0,0.933,17.74,24,23,3,20,1,0,1,0,0.0,0.0
1015,1185,25-09-2019 03:08:00,0,3599.0,3186.0,0.885,17.709,1,1,0,1,0,0,0,0,0.0,0.0
1015,1186,25-09-2019 03:10:00,0,3260.0,2949.0,0.905,16.11,1,1,0,1,0,0,0,0,0.0,0.0
1015,1187,25-09-2019 03:12:00,0,3226.0,2832.5,0.878,15.8475,4,4,1,3,0,0,0,0,0.0,0.0
1015,1188,25-09-2019 03:14:00,0,3192.0,2716.0,0.851,15.585,2,2,2,0,0,0,0,0,0.0,0.0
1015,1189,25-09-2019 03:16:00,0,3067.0,2698.0,0.88,15.071,1,1,1,0,0,0,0,0,0.0,0.0
1015,1190,25-09-2019 03:18:00,0,3185.0,2739.0,0.86,15.58,2,2,0,2,0,0,0,0,0.0,0.0
1015,1191,25-09-2019 03:20:00,0,3081.0,2686.0,0.872,15.112,2,2,1,1,0,0,0,0,0.0,0.0
1015,1192,25-09-2019 03:22:00,0,2833.0,2631.0,0.929,14.076,2,2,0,2,0,0,0,0,0.0,0.0
1015,1193,25-09-2019 03:24:00,0,2852.0,2535.0,0.889,14.044,100,100,82,18,0,0,0,0,0.0,0.0
1015,1194,25-09-2019 03:26:00,0,2847.0,2521.0,0.886,14.007,2,2,0,2,0,0,0,0,0.0,0.0
1015,1195,25-09-2019 03:28:00,0,2865.0,2488.0,0.868,14.044,4,4,0,4,0,0,0,0,0.0,0.0
1015,1196,25-09-2019 03:30:00,0,2629.0,2414.0,0.918,13.031,18,10,5,5,8,4,4,0,0.0,0.0
1015,1197,25-09-2019 03:32:00,0,2621.0,2373.0,0.905,12.956,3,1,0,1,2,0,2,0,0.0,0.0
1015,1198,25-09-2019 03:34:00,0,2628.0,2344.0,0.892,12.951,12,8,1,7,4,2,2,0,0.0,0.0
1015,1199,25-09-2019 03:36:00,0,2630.0,2385.0,0.907,13.003,2,0,0,0,2,0,2,0,0.0,0.0
1015,1200,25-09-2019 03:38:00,0,2745.0,2410.0,0.878,13.484,0,0,0,0,0,0,0,0,0.0,0.0
1015,1201,25-09-2019 03:40:00,0,2637.0,2402.0,0.911,13.05,26,0,0,0,26,0,26,0,0.0,0.0
1015,1202,25-09-2019 03:42:00,0,2641.0,2347.0,0.889,13.004,22,7,3,4,15,0,15,0,0.0,0.0
1015,1203,25-09-2019 03:44:00,0,2645.0,2293.0,0.867,12.96,1,1,0,1,0,0,0,0,0.0,0.0
1015,1204,25-09-2019 03:46:00,0,2662.0,2269.0,0.8525,13.001,7,7,4,3,0,0,0,0,0.0,0.0
1015,1205,25-09-2019 03:48:00,0,2679.0,2245.0,0.838,13.042,0,0,0,0,0,0,0,0,0.0,0.0
1015,1206,25-09-2019 03:50:00,0,2654.0,2216.0,0.835,12.909,2,2,0,2,0,0,0,0,0.0,0.0
1015,1207,25-09-2019 03:52:00,0,2660.0,2263.0,0.851,12.986,1,1,0,1,0,0,0,0,0.0,0.0
1015,1208,25-09-2019 03:54:00,0,2636.0,2288.0,0.868,12.92,4,4,0,4,0,0,0,0,0.0,0.0
1015,1209,25-09-2019 03:56:00,0,2649.0,2354.0,0.889,13.043,5,5,2,3,0,0,0,0,0.0,0.0
1015,1210,25-09-2019 03:58:00,0,2670.0,2258.0,0.846,13.02,26,23,0,23,3,1,2,0,0.0,0.0
1015,1211,25-09-2019 04:00:00,0,2670.0,2267.0,0.849,13.029,131,88,65,23,43,24,19,6,0.0,0.0
1015,1212,25-09-2019 04:02:00,0,2842.0,2579.0,0.908,14.053,138,133,82,51,5,0,5,2,0.0,0.0
1015,1213,25-09-2019 04:04:00,0,3197.0,2766.0,0.865,15.659,208,128,82,46,80,51,29,29,0.0,0.0
1015,1214,25-09-2019 04:06:00,0,3370.0,3025.0,0.898,16.625,295,170,142,28,125,96,29,50,0.01,0.0
1015,1215,25-09-2019 04:08:00,0,3690.0,3269.0,0.886,18.156,277,172,151,21,105,77,28,88,0.0,0.0
1015,1216,25-09-2019 04:10:00,0,3704.0,3253.0,0.878,18.194,210,72,45,27,138,92,46,45,0.0,0.0
1015,1217,25-09-2019 04:12:00,0,3702.0,3251.0,0.878,18.187,198,105,85,20,93,54,39,87,0.0,0.0
1015,1218,25-09-2019 04:14:00,0,3679.0,3408.0,0.926,18.266,250,126,100,26,124,77,47,79,0.0,0.0
1015,1219,25-09-2019 04:16:00,0,3674.0,3406.0,0.927,18.247,171,91,69,22,80,35,45,103,0.0,0.01
1015,1220,25-09-2019 04:18:00,0,3722.0,3263.0,0.877,18.275,512,270,218,52,242,184,58,71,0.02,0.02
1015,1221,25-09-2019 04:20:00,0,3811.5,3371.5,0.8845,18.749,263,136,102,34,127,70,57,122,0.01,0.0
1015,1222,25-09-2019 04:22:00,0,3901.0,3480.0,0.892,19.223,312,144,114,30,168,110,58,47,0.0,0.08
1015,1223,25-09-2019 04:24:00,0,3897.0,3460.0,0.888,19.184,309,162,119,43,147,87,60,88,0.0,0.0
1015,1224,25-09-2019 04:26:00,0,4009.0,3626.0,0.905,19.809,126,52,31,21,74,2,72,72,0.0,0.0
1015,1225,25-09-2019 04:28:00,0,4325.0,3951.0,0.914,21.412,407,196,161,35,211,155,56,118,0.04,0.03
1015,1226,25-09-2019 04:30:00,0,3814.0,3363.0,0.882,18.751,139,71,40,31,68,25,43,84,0.01,0.04
1015,1227,25-09-2019 04:32:00,0,3896.0,3556.0,0.913,19.286,295,141,100,41,154,102,52,96,0.06,0.0
1015,1228,25-09-2019 04:34:00,0,3765.0,3482.0,0.925,18.687,565,255,202,53,310,245,65,155,0.06,0.0
1015,1229,25-09-2019 04:36:00,0,2855.0,2524.0,0.884,14.041,245,103,71,32,142,80,62,37,0.02,0.0
1015,1230,25-09-2019 04:38:00,0,4428.0,3998.0,0.903,21.87,167,67,35,32,100,46,54,77,0.0,0.0
1015,1231,25-09-2019 04:40:00,0,4303.0,3948.0,0.918,21.324,341,175,142,33,166,105,61,126,0.0,0.0
1015,1232,25-09-2019 04:42:00,0,3871.0,3644.0,0.941,19.285,498,280,220,60,218,153,65,90,0.0,0.03
1015,1233,25-09-2019 04:44:00,0,3900.0,3442.0,0.882,19.177,395,193,146,47,202,142,60,69,0.06,0.0
1015,1234,25-09-2019 04:46:00,0,4422.0,3995.0,0.903,21.847,181,104,79,25,77,22,55,75,0.0,0.0
1015,1235,25-09-2019 04:48:00,0,4213.0,3815.0,0.905,20.823,204,97,73,24,107,48,59,74,0.0,0.0
1015,1236,25-09-2019 04:50:00,0,3815.0,3295.0,0.864,18.68,367,189,156,33,178,139,39,83,0.0,0.0
1015,1237,25-09-2019 04:52:00,0,3182.0,2742.0,0.862,15.574,46,17,13,4,29,20,9,57,0.0,0.0
1015,1238,25-09-2019 04:54:00,0,3434.0,3033.0,0.882,16.8885,301,162,130,32,139,109,30,114,0.01,0.0
1015,1239,25-09-2019 04:56:00,0,3686.0,3324.0,0.902,18.203,139,70,55,15,69,18,51,63,0.0,0.0
1015,1240,25-09-2019 04:58:00,0,3867.0,3645.0,0.943,19.269,365,243,203,40,122,83,39,118,0.0,0.0
1015,1241,25-09-2019 05:00:00,0,3902.0,3526.0,0.904,19.277,381,176,139,37,205,137,68,114,0.02,0.02
1015,1242,25-09-2019 05:02:00,0,3373.0,3085.0,0.915,16.707,224,137,103,34,87,49,38,16,0.0,0.0
1015,1243,25-09-2019 05:04:00,0,2952.0,2633.0,0.892,14.545,337,205,156,49,132,93,39,15,0.0,0.0
1015,1244,25-09-2019 05:06:00,0,3918.0,3472.0,0.886,19.281,264,122,96,26,142,99,43,50,0.0,0.0
1015,1245,25-09-2019 05:08:00,0,3176.0,2807.0,0.884,15.622,389,183,140,43,206,158,48,58,0.0,0.01
1015,1246,25-09-2019 05:10:00,0,3882.0,3607.0,0.929,19.29,148,85,62,23,63,23,40,46,0.01,0.01
1015,1247,25-09-2019 05:12:00,0,3605.0,3141.0,0.871,17.683,129,98,67,31,31,11,20,2,0.0,0.0
1015,1248,25-09-2019 05:14:00,0,3186.0,2784.0,0.874,15.636,234,154,118,36,80,59,21,66,0.0,0.0
1015,1249,25-09-2019 05:16:00,0,3933.0,3443.0,0.875,19.308,575,370,309,61,205,153,52,40,0.0,0.0
1015,1250,25-09-2019 05:18:00,0,3888.0,3559.0,0.915,19.259,135,31,23,8,104,26,78,5,0.0,0.0
1015,1251,25-09-2019 05:20:00,0,3901.0,3434.0,0.88,19.172,36,29,10,19,7,5,2,3,0.0,0.0
1015,1252,25-09-2019 05:22:00,0,3689.0,3250.0,0.881,18.133,40,31,13,18,9,0,9,0,0.0,0.0
1015,1253,25-09-2019 05:24:00,0,3702.0,3267.0,0.883,18.202,64,37,18,19,27,2,25,0,0.0,0.0
1015,1254,25-09-2019 05:26:00,0,3727.0,3166.0,0.85,18.188,17,9,2,7,8,0,8,0,0.0,0.0
1015,1255,25-09-2019 05:28:00,0,3575.0,3013.0,0.8425,17.4205,0,0,0,0,0,0,0,0,0.0,0.0
1015,1256,25-09-2019 05:30:00,0,3423.0,2860.0,0.835,16.653,0,0,0,0,0,0,0,0,0.0,0.0
1015,1257,25-09-2019 05:32:00,0,3182.0,2728.0,0.857,15.556,0,0,0,0,0,0,0,0,0.0,0.0
1015,1258,25-09-2019 05:34:00,0,3104.0,2582.0,0.832,15.09,1,1,0,1,0,0,0,0,0.0,0.0
1015,1259,25-09-2019 05:36:00,0,2872.0,2459.0,0.856,14.04,0,0,0,0,0,0,0,0,0.0,0.0
1015,1260,25-09-2019 05:38:00,0,2902.0,2330.0,0.803,14.011,41,27,13,14,14,2,12,0,0.0,0.0
1015,1261,25-09-2019 05:40:00,0,2768.0,2359.0,0.852,13.52,10,4,2,2,6,0,6,0,0.0,0.0
1015,1262,25-09-2019 05:42:00,0,2650.0,2292.0,0.865,12.977,0,0,0,0,0,0,0,0,0.0,0.0
1015,1263,25-09-2019 05:44:00,0,2665.0,2265.0,0.85,13.008,1,0,0,0,1,0,1,0,0.0,0.0
1015,1264,25-09-2019 05:46:00,0,2660.0,2263.0,0.851,12.985,0,0,0,0,0,0,0,0,0.0,0.0
1015,1265,25-09-2019 05:48:00,0,2678.0,2218.0,0.828,13.007,8,3,2,1,5,2,3,0,0.0,0.0
1015,1266,25-09-2019 05:50:00,0,2668.0,2233.0,0.837,12.982,2,2,1,1,0,0,0,0,0.0,0.0
1015,1267,25-09-2019 05:52:00,0,2678.0,2173.0,0.811,12.956,6,4,3,1,2,0,2,0,0.0,0.0
1015,1268,25-09-2019 05:54:00,0,2696.0,2178.0,0.808,13.034,0,0,0,0,0,0,0,0,0.0,0.0
1015,1269,25-09-2019 05:56:00,0,2698.0,2142.0,0.794,13.001,1,0,0,0,1,0,1,0,0.0,0.0
1015,1270,25-09-2019 05:58:00,0,2692.0,2181.0,0.81,13.021,0,0,0,0,0,0,0,0,0.0,0.0
1015,1271,25-09-2019 06:00:00,1,2690.0,2158.0,0.802,12.99,0,0,0,0,0,0,0,0,0.0,0.0
1015,1272,25-09-2019 06:02:00,1,2631.5,2127.5,0.8085,12.726,0,0,0,0,0,0,0,0,0.0,0.0
1015,1273,25-09-2019 06:04:00,1,2573.0,2097.0,0.815,12.462,0,0,0,0,0,0,0,0,0.0,0.0
1015,1274,25-09-2019 06:06:00,1,2581.0,2092.0,0.81,12.487,0,0,0,0,0,0,0,0,0.0,0.0
1015,1275,25-09-2019 06:08:00,1,2481.0,2000.0,0.806,11.991,15,9,4,5,6,2,4,0,0.0,0.0
1015,1276,25-09-2019 06:10:00,1,2335.0,1954.0,0.837,11.363,10,7,1,6,3,0,3,0,0.0,0.0
1015,1277,25-09-2019 06:12:00,1,2484.0,1977.0,0.796,11.975,2,1,0,1,1,0,1,0,0.01,0.0
1015,1278,25-09-2019 06:14:00,1,2362.0,1936.0,0.82,11.45,79,53,36,17,26,11,15,4,0.0,0.0
1015,1279,25-09-2019 06:16:00,1,2567.0,2109.0,0.822,12.448,265,106,90,16,159,104,55,72,0.0,0.0
1015,1280,25-09-2019 06:18:00,1,2893.0,2404.0,0.831,14.059,247,129,102,27,118,61,57,67,0.0,0.0
1015,1281,25-09-2019 06:20:00,1,3331.0,2705.0,0.812,16.119,288,145,111,34,143,88,55,41,0.0,0.0
1015,1282,25-09-2019 06:22:00,1,3221.0,2628.0,0.816,15.601,168,102,74,28,66,33,33,70,0.0,0.0
1015,1283,25-09-2019 06:24:00,1,3347.0,2642.0,0.79,16.111,88,16,7,9,72,0,72,61,0.0,0.0
1015,1284,25-09-2019 06:26:00,1,3298.0,2814.0,0.853,16.11,84,20,6,14,64,0,64,57,0.0,0.0
1015,1285,25-09-2019 06:28:00,1,3620.0,3064.0,0.846,17.654,431,213,172,41,218,153,65,75,0.0,0.05
1015,1286,25-09-2019 06:30:00,1,3302.0,2792.0,0.845,16.101,393,208,172,36,185,143,42,138,0.05,0.04
1015,1287,25-09-2019 06:32:00,1,3066.0,2686.0,0.876,15.055,333,137,113,24,196,150,46,68,0.06,0.0
1015,1288,25-09-2019 06:34:00,1,3291.0,2831.0,0.86,16.101,557,220,175,45,337,265,72,114,0.02,0.0
1015,1289,25-09-2019 06:36:00,1,3460.5,2922.5,0.845,16.8705,210,118,84,34,92,33,59,86,0.0,0.02
1015,1290,25-09-2019 06:38:00,1,3630.0,3014.0,0.83,17.64,91,24,14,10,67,0,67,71,0.0,0.0
1015,1291,25-09-2019 06:40:00,1,3614.0,3115.0,0.862,17.687,222,113,89,24,109,47,62,39,0.0,0.03
1015,1292,25-09-2019 06:42:00,1,3519.0,3019.0,0.858,17.208,626,345,279,66,281,213,68,29,0.05,0.01
1015,1293,25-09-2019 06:44:00,1,3508.0,3026.0,0.863,17.172,396,187,145,42,209,144,65,11,0.04,0.0
1015,1294,25-09-2019 06:46:00,1,3113.0,2566.0,0.824,15.108,197,142,96,46,55,32,23,0,0.0,0.0
1015,1295,25-09-2019 06:48:00,1,3050.0,2738.0,0.898,15.047,495,275,222,53,220,168,52,29,0.0,0.01
1015,1296,25-09-2019 06:50:00,1,3381.0,3009.0,0.89,16.654,70,55,28,27,15,2,13,0,0.0,0.0
1015,1297,25-09-2019 06:52:00,1,3288.0,2895.0,0.88,16.16,49,44,25,19,5,2,3,0,0.0,0.0
1015,1298,25-09-2019 06:54:00,1,3268.0,2925.0,0.895,16.116,56,51,21,30,5,2,3,0,0.0,0.0
1015,1299,25-09-2019 06:56:00,1,3276.0,2897.0,0.884,16.114,37,24,3,21,13,3,10,0,0.0,0.0
1015,1300,25-09-2019 06:58:00,1,3270.0,2946.0,0.901,16.144,11,5,1,4,6,0,6,0,0.0,0.0
1015,1301,25-09-2019 07:00:00,1,3171.0,2794.0,0.881,15.585,0,0,0,0,0,0,0,0,0.0,0.0
1015,1302,25-09-2019 07:02:00,1,3089.0,2660.0,0.861,15.116,7,5,3,2,2,0,2,0,0.0,0.0
1015,1303,25-09-2019 07:04:00,1,2853.0,2534.0,0.888,14.044,4,0,0,0,4,0,4,0,0.0,0.0
1015,1304,25-09-2019 07:06:00,1,2750.0,2458.0,0.894,13.556,0,0,0,0,0,0,0,0,0.0,0.0
1015,1305,25-09-2019 07:08:00,1,2767.0,2328.0,0.842,13.479,4,1,1,0,3,0,3,0,0.0,0.0
1015,1306,25-09-2019 07:10:00,1,2721.0,2255.5,0.829,13.219,0,0,0,0,0,0,0,0,0.0,0.0
1015,1307,25-09-2019 07:12:00,1,2675.0,2183.0,0.816,12.959,2,0,0,0,2,0,2,0,0.0,0.0
1015,1308,25-09-2019 07:14:00,1,2692.0,2158.0,0.802,12.996,0,0,0,0,0,0,0,0,0.0,0.02
1015,1309,25-09-2019 07:16:00,1,2699.0,2142.0,0.794,13.007,3,2,1,1,1,0,1,0,0.0,0.0
1015,1310,25-09-2019 07:18:00,1,2568.0,2125.0,0.828,12.47,2,0,0,0,2,0,2,0,0.0,0.0
1015,1311,25-09-2019 07:20:00,1,2690.0,2154.0,0.801,12.982,0,0,0,0,0,0,0,0,0.0,0.0
1015,1312,25-09-2019 07:22:00,1,2692.0,2172.0,0.807,13.011,0,0,0,0,0,0,0,0,0.0,0.0
1015,1313,25-09-2019 07:24:00,1,2559.0,2131.0,0.833,12.441,2,2,1,1,0,0,0,0,0.0,0.0
1015,1314,25-09-2019 07:26:00,1,2451.0,2080.0,0.849,11.96,0,0,0,0,0,0,0,0,0.0,0.0
1015,1315,25-09-2019 07:28:00,1,2330.0,2032.0,0.872,11.432,0,0,0,0,0,0,0,0,0.0,0.0
1015,1316,25-09-2019 07:30:00,1,2329.0,2024.0,0.869,11.418,1,0,0,0,1,1,0,0,0.0,0.0
1015,1317,25-09-2019 07:32:00,1,2360.0,1968.0,0.834,11.477,0,0,0,0,0,0,0,0,0.0,0.0
1015,1318,25-09-2019 07:34:00,1,2373.0,1890.0,0.797,11.442,59,45,27,18,14,6,8,0,0.0,0.0
1015,1319,25-09-2019 07:36:00,1,2681.0,2179.0,0.813,12.975,160,150,91,59,10,3,7,0,0.0,0.0
1015,1320,25-09-2019 07:38:00,1,3089.0,2609.0,0.845,15.058,282,161,137,24,121,92,29,47,0.0,0.0
1015,1321,25-09-2019 07:40:00,1,3217.0,2663.0,0.828,15.622,246,161,128,33,85,56,29,49,0.0,0.0
1015,1322,25-09-2019 07:42:00,1,3194.0,2664.0,0.834,15.534,272,162,126,36,110,75,35,76,0.0,0.0
1015,1323,25-09-2019 07:44:00,1,3136.0,2648.5,0.8445,15.288,342,209,169,40,133,91,42,69,0.0,0.0
1015,1324,25-09-2019 07:46:00,1,3078.0,2633.0,0.855,15.042,22,16,8,8,6,3,3,0,0.0,0.0
1015,1325,25-09-2019 07:48:00,1,3121.0,2549.0,0.817,15.119,5,5,1,4,0,0,0,0,0.0,0.0
1015,1326,25-09-2019 07:50:00,1,3106.0,2580.0,0.831,15.095,18,18,5,13,0,0,0,0,0.0,0.0
1015,1327,25-09-2019 07:52:00,1,2754.0,2381.0,0.865,13.488,0,0,0,0,0,0,0,0,0.0,0.0
1015,1328,25-09-2019 07:54:00,1,2803.0,2249.0,0.802,13.535,0,0,0,0,0,0,0,0,0.0,0.0
1015,1329,25-09-2019 07:56:00,1,2577.0,2117.0,0.821,12.497,1,0,0,0,1,1,0,0,0.0,0.0
1015,1330,25-09-2019 07:58:00,1,2584.0,2043.0,0.791,12.445,0,0,0,0,0,0,0,0,0.0,0.0
1015,1331,25-09-2019 08:00:00,1,2468.0,1975.0,0.8,11.91,6,3,1,2,3,1,2,0,0.0,0.0
1015,1332,25-09-2019 08:02:00,1,2480.0,1979.0,0.798,11.964,15,13,3,10,2,1,1,0,0.0,0.0
1015,1333,25-09-2019 08:04:00,1,2606.0,2031.0,0.779,12.519,1,1,0,1,0,0,0,0,0.0,0.0
1015,1334,25-09-2019 08:06:00,1,2591.0,2020.0,0.78,12.443,17,17,0,17,0,0,0,0,0.0,0.0
1015,1335,25-09-2019 08:08:00,1,2601.0,2031.0,0.781,12.499,23,18,12,6,5,1,4,0,0.0,0.0
1015,1336,25-09-2019 08:10:00,1,2354.0,1942.0,0.825,11.426,0,0,0,0,0,0,0,0,0.0,0.0
1015,1337,25-09-2019 08:12:00,1,2353.0,1952.0,0.83,11.431,20,20,0,20,0,0,0,0,0.0,0.0
1015,1338,25-09-2019 08:14:00,1,2343.0,1967.0,0.84,11.409,23,21,0,21,2,1,1,0,0.0,0.0
1015,1339,25-09-2019 08:16:00,1,2472.0,1984.0,0.802,11.937,11,11,0,11,0,0,0,0,0.0,0.0
1015,1340,25-09-2019 08:18:00,1,2539.5,1959.0,0.772,12.1745,0,0,0,0,0,0,0,0,0.0,0.0
1015,1341,25-09-2019 08:20:00,1,2607.0,1934.0,0.742,12.412,1,1,0,1,0,0,0,0,0.0,0.0
1015,1342,25-09-2019 08:22:00,1,2741.0,1968.0,0.718,12.977,5,5,0,5,0,0,0,0,0.0,0.0
1015,1343,25-09-2019 08:24:00,1,2739.0,2020.0,0.738,13.028,19,19,0,19,0,0,0,0,0.0,0.0
1015,1344,25-09-2019 08:26:00,1,2732.0,1987.0,0.727,12.966,1,1,0,1,0,0,0,0,0.0,0.0
1015,1345,25-09-2019 08:28:00,1,2739.0,1968.0,0.718,12.972,2,1,0,1,1,0,1,0,0.0,0.0
1015,1346,25-09-2019 08:30:00,1,2618.0,1912.0,0.731,12.431,27,26,1,25,1,0,1,0,0.0,0.0
1015,1347,25-09-2019 08:32:00,1,2515.0,1846.0,0.734,11.953,24,15,10,5,9,4,5,0,0.0,0.0
1015,1348,25-09-2019 08:34:00,1,2763.0,1900.0,0.688,12.993,0,0,0,0,0,0,0,0,0.0,0.0
1015,1349,25-09-2019 08:36:00,1,2508.0,1846.0,0.736,11.925,8,7,2,5,1,0,1,0,0.0,0.0
1015,1350,25-09-2019 08:38:00,1,2394.0,1837.0,0.768,11.465,3,3,0,3,0,0,0,0,0.0,0.0
1015,1351,25-09-2019 08:40:00,1,2389.0,1834.0,0.768,11.444,5,3,0,3,2,0,2,0,0.0,0.0
1015,1352,25-09-2019 08:42:00,1,2402.0,1776.0,0.74,11.43,7,2,0,2,5,1,4,0,0.0,0.0
1015,1353,25-09-2019 08:44:00,1,2410.0,1754.0,0.728,11.439,0,0,0,0,0,0,0,0,0.0,0.0
1015,1354,25-09-2019 08:46:00,1,2293.0,1678.0,0.732,10.894,64,47,21,26,17,3,14,0,0.0,0.0
1015,1355,25-09-2019 08:48:00,1,2748.0,1952.0,0.71,12.989,62,44,18,26,18,0,18,0,0.0,0.0
1015,1356,25-09-2019 08:50:00,1,2835.0,2126.0,0.75,13.522,174,102,71,31,72,45,27,10,0.0,0.0
1015,1357,25-09-2019 08:52:00,1,2937.5,2217.0,0.7545,14.0285,412,237,199,38,175,129,46,70,0.0,0.0
1015,1358,25-09-2019 08:54:00,1,3040.0,2308.0,0.759,14.535,375,200,158,42,175,125,50,35,0.0,0.0
1015,1359,25-09-2019 08:56:00,1,3265.0,2467.0,0.755,15.595,554,252,207,45,302,233,69,113,0.02,0.0
1015,1360,25-09-2019 08:58:00,1,3279.0,2395.0,0.73,15.572,234,127,86,41,107,63,44,78,0.0,0.0
1015,1361,25-09-2019 09:00:00,1,3262.0,2477.0,0.759,15.596,214,113,80,33,101,55,46,59,0.0,0.04
1015,1362,25-09-2019 09:02:00,1,3234.0,2583.0,0.799,15.601,224,104,77,27,120,86,34,71,0.0,0.0
1015,1363,25-09-2019 09:04:00,1,3272.0,2471.0,0.755,15.629,209,156,121,35,53,33,20,0,0.0,0.0
1015,1364,25-09-2019 09:06:00,1,3283.0,2463.0,0.75,15.661,431,255,207,48,176,139,37,137,0.0,0.0
1015,1365,25-09-2019 09:08:00,1,3468.0,2607.0,0.752,16.552,158,91,59,32,67,54,13,34,0.0,0.02
1015,1366,25-09-2019 09:10:00,1,3252.0,2443.0,0.751,15.517,71,35,14,21,36,15,21,0,0.0,0.0
1015,1367,25-09-2019 09:12:00,1,3235.0,2553.0,0.789,15.572,258,151,125,26,107,82,25,11,0.0,0.0
1015,1368,25-09-2019 09:14:00,1,3257.0,2476.0,0.76,15.575,37,31,11,20,6,1,5,0,0.0,0.0
1015,1369,25-09-2019 09:16:00,1,3281.0,2392.0,0.729,15.575,0,0,0,0,0,0,0,0,0.0,0.0
1015,1370,25-09-2019 09:18:00,1,2943.0,2202.0,0.748,14.035,0,0,0,0,0,0,0,0,0.0,0.0
1015,1371,25-09-2019 09:20:00,1,2732.0,2016.0,0.738,12.995,1,1,1,0,0,0,0,0,0.0,0.0
1015,1372,25-09-2019 09:22:00,1,2743.0,1945.0,0.709,12.961,0,0,0,0,0,0,0,0,0.0,0.0
1015,1373,25-09-2019 09:24:00,1,2636.0,1886.0,0.715,12.475,5,5,1,4,0,0,0,0,0.0,0.0
1015,1374,25-09-2019 09:26:00,1,2517.5,1842.5,0.7325,11.9595,5,3,0,3,2,1,1,0,0.0,0.0
1015,1375,25-09-2019 09:28:00,1,2399.0,1799.0,0.75,11.444,2,2,1,1,0,0,0,0,0.0,0.0
1015,1376,25-09-2019 09:30:00,1,2406.0,1746.0,0.726,11.412,0,0,0,0,0,0,0,0,0.0,0.0
1015,1377,25-09-2019 09:32:00,1,2411.0,1737.0,0.72,11.423,0,0,0,0,0,0,0,0,0.0,0.0
1015,1378,25-09-2019 09:34:00,1,2416.0,1703.0,0.705,11.406,0,0,0,0,0,0,0,0,0.0,0.0
1015,1379,25-09-2019 09:36:00,1,2422.0,1714.0,0.708,11.441,3,3,3,0,0,0,0,0,0.0,0.0
1015,1380,25-09-2019 09:38:00,1,2419.0,1719.0,0.711,11.433,0,0,0,0,0,0,0,0,0.0,0.0
1015,1381,25-09-2019 09:40:00,1,2417.0,1709.0,0.707,11.416,0,0,0,0,0,0,0,0,0.0,0.0
1015,1382,25-09-2019 09:42:00,1,2418.0,1686.0,0.697,11.396,0,0,0,0,0,0,0,0,0.0,0.0
1015,1383,25-09-2019 09:44:00,1,2430.0,1692.0,0.696,11.448,16,13,8,5,3,0,3,0,0.0,0.0
1015,1384,25-09-2019 09:46:00,1,2508.0,1822.0,0.726,11.9,1,1,1,0,0,0,0,0,0.0,0.0
1015,1385,25-09-2019 09:48:00,1,2637.0,1839.0,0.697,12.426,3,3,1,2,0,0,0,0,0.0,0.0
1015,1386,25-09-2019 09:50:00,1,2406.0,1800.0,0.748,11.471,0,0,0,0,0,0,0,0,0.02,0.0
1015,1387,25-09-2019 09:52:00,1,2398.0,1753.0,0.731,11.39,7,7,1,6,0,0,0,0,0.0,0.0
1015,1388,25-09-2019 09:54:00,1,2405.0,1733.0,0.721,11.394,4,4,1,3,0,0,0,0,0.0,0.0
1015,1389,25-09-2019 09:56:00,1,2515.0,1814.0,0.721,11.92,11,11,0,11,0,0,0,0,0.0,0.0
1015,1390,25-09-2019 09:58:00,1,2298.0,1635.0,0.711,10.866,5,4,1,3,1,0,1,0,0.0,0.0
1015,1391,25-09-2019 10:00:00,1,2365.5,1633.5,0.691,11.1295,1,1,0,1,0,0,0,0,0.0,0.0
1015,1392,25-09-2019 10:02:00,1,2433.0,1632.0,0.671,11.393,1,1,0,1,0,0,0,0,0.0,0.0
1015,1393,25-09-2019 10:04:00,1,2437.0,1639.0,0.673,11.417,0,0,0,0,0,0,0,0,0.0,0.0
1015,1394,25-09-2019 10:06:00,1,2442.0,1633.0,0.669,11.432,8,5,4,1,3,0,3,0,0.0,0.0
1015,1395,25-09-2019 10:08:00,1,2419.0,1740.0,0.719,11.459,30,22,10,12,8,4,4,0,0.0,0.0
1015,1396,25-09-2019 10:10:00,1,2304.0,1633.0,0.709,10.886,6,6,2,4,0,0,0,0,0.0,0.0
1015,1397,25-09-2019 10:12:00,1,2309.0,1613.0,0.699,10.886,1,1,0,1,0,0,0,0,0.0,0.0
1015,1398,25-09-2019 10:14:00,1,2304.0,1640.0,0.712,10.894,1,1,0,1,0,0,0,0,0.0,0.0
1015,1399,25-09-2019 10:16:00,1,2402.0,1754.0,0.73,11.408,0,0,0,0,0,0,0,0,0.0,0.0
1015,1400,25-09-2019 10:18:00,1,2411.0,1734.0,0.719,11.42,0,0,0,0,0,0,0,0,0.0,0.0
1015,1401,25-09-2019 10:20:00,1,2409.0,1730.0,0.718,11.409,3,3,1,2,0,0,0,0,0.0,0.0
1015,1402,25-09-2019 10:22:00,1,2422.0,1718.0,0.709,11.443,1,1,0,1,0,0,0,0,0.0,0.0
1015,1403,25-09-2019 10:24:00,1,2422.0,1684.0,0.695,11.409,14,10,6,4,4,2,2,0,0.0,0.0
1015,1404,25-09-2019 10:26:00,1,2654.0,1824.0,0.687,12.476,10,1,1,0,9,2,7,0,0.0,0.0
1015,1405,25-09-2019 10:28:00,1,2762.0,1904.0,0.689,12.992,1,0,0,0,1,0,1,0,0.0,0.0
1015,1406,25-09-2019 10:30:00,1,2758.0,1863.0,0.676,12.929,9,3,1,2,6,0,6,0,0.0,0.0
1015,1407,25-09-2019 10:32:00,1,2531.0,1777.0,0.702,11.941,2,0,0,0,2,0,2,0,0.0,0.0
1015,1408,25-09-2019 10:34:00,1,2472.5,1759.0,0.7115,11.6895,10,7,1,6,3,0,3,0,0.0,0.0
1015,1409,25-09-2019 10:36:00,1,2414.0,1741.0,0.721,11.438,51,41,7,34,10,0,10,0,0.0,0.0
1015,1410,25-09-2019 10:38:00,1,2407.0,1765.0,0.733,11.437,49,38,14,24,11,0,11,0,0.0,0.0
1015,1411,25-09-2019 10:40:00,1,2746.0,1959.0,0.714,12.989,209,120,95,25,89,62,27,17,0.0,0.0
1015,1412,25-09-2019 10:42:00,1,2936.0,2239.0,0.762,14.047,298,162,132,30,136,105,31,115,0.0,0.0
1015,1413,25-09-2019 10:44:00,1,3170.0,2292.0,0.723,15.027,228,113,83,30,115,78,37,75,0.0,0.0
1015,1414,25-09-2019 10:46:00,1,3293.0,2369.0,0.719,15.597,334,193,152,41,141,108,33,108,0.0,0.0
1015,1415,25-09-2019 10:48:00,1,3313.0,2314.0,0.698,15.617,100,51,31,20,49,23,26,47,0.0,0.0
1015,1416,25-09-2019 10:50:00,1,3490.0,2639.0,0.756,16.673,198,87,62,25,111,66,45,90,0.0,0.0
1015,1417,25-09-2019 10:52:00,1,3238.0,2519.0,0.778,15.547,302,166,119,47,136,96,40,56,0.02,0.0
1015,1418,25-09-2019 10:54:00,1,3474.0,2653.0,0.764,16.625,89,47,28,19,42,4,38,45,0.01,0.0
1015,1419,25-09-2019 10:56:00,1,3826.0,2858.0,0.747,18.239,104,30,21,9,74,0,74,67,0.01,0.11
1015,1420,25-09-2019 10:58:00,1,3487.0,2654.0,0.761,16.678,128,40,22,18,88,36,52,40,0.06,0.02
1015,1421,25-09-2019 11:00:00,1,3475.0,2640.0,0.76,16.614,367,176,138,38,191,142,49,60,0.0,0.04
1015,1422,25-09-2019 11:02:00,1,3223.0,2538.0,0.788,15.511,931,572,480,92,359,276,83,12,0.02,0.0
1015,1423,25-09-2019 11:04:00,1,3442.0,2768.0,0.804,16.628,289,137,100,37,152,93,59,116,0.03,0.07
1015,1424,25-09-2019 11:06:00,1,3483.0,2633.0,0.756,16.639,173,61,47,14,112,50,62,51,0.07,0.0
1015,1425,25-09-2019 11:08:00,1,3453.5,2724.0,0.789,16.624,454,291,228,63,163,124,39,4,0.03,0.0
1015,1426,25-09-2019 11:10:00,1,3424.0,2815.0,0.822,16.609,592,353,289,64,239,180,59,11,0.0,0.0
1015,1427,25-09-2019 11:12:00,1,3210.0,2687.0,0.837,15.622,619,427,354,73,192,132,60,5,0.03,0.0
1015,1428,25-09-2019 11:14:00,1,3419.0,2865.0,0.838,16.645,881,477,396,81,404,316,88,17,0.02,0.0
1015,1429,25-09-2019 11:16:00,1,3748.0,3084.0,0.823,18.181,661,384,322,62,277,218,59,171,0.04,0.01
1015,1430,25-09-2019 11:18:00,1,3728.0,3197.0,0.858,18.227,190,117,85,32,73,54,19,26,0.0,0.0
1015,1431,25-09-2019 11:20:00,1,3404.0,2925.0,0.859,16.651,154,95,65,30,59,34,25,0,0.0,0.0
1015,1432,25-09-2019 11:22:00,1,3635.0,3018.0,0.83,17.666,128,72,53,19,56,42,14,0,0.0,0.0
1015,1433,25-09-2019 11:24:00,1,3435.0,2843.0,0.828,16.682,6,6,0,6,0,0,0,0,0.0,0.0
1015,1434,25-09-2019 11:26:00,1,3187.0,2762.0,0.867,15.613,21,21,4,17,0,0,0,0,0.0,0.0
1015,1435,25-09-2019 11:28:00,1,3215.0,2651.0,0.825,15.603,5,4,3,1,1,0,1,0,0.0,0.0
1015,1436,25-09-2019 11:30:00,1,3232.0,2571.0,0.795,15.582,1,1,1,0,0,0,0,0,0.0,0.0
1015,1437,25-09-2019 11:32:00,1,3000.0,2524.0,0.841,14.615,0,0,0,0,0,0,0,0,0.0,0.0
1015,1438,25-09-2019 11:34:00,1,2903.0,2362.0,0.814,14.052,0,0,0,0,0,0,0,0,0.0,0.0
1015,1439,25-09-2019 11:36:00,1,2660.0,2310.0,0.868,13.037,14,13,7,6,1,0,1,0,0.0,0.0
1015,1440,25-09-2019 11:38:00,1,2681.0,2214.0,0.826,13.013,0,0,0,0,0,0,0,0,0.0,0.0
1015,1441,25-09-2019 11:40:00,1,2667.0,2240.0,0.84,12.989,0,0,0,0,0,0,0,0,0.0,0.0
1015,1442,25-09-2019 11:42:00,1,2617.0,2194.5,0.8385,12.7415,9,9,4,5,0,0,0,0,0.0,0.0
1015,1443,25-09-2019 11:44:00,1,2567.0,2149.0,0.837,12.494,12,12,0,12,0,0,0,0,0.0,0.0
1015,1444,25-09-2019 11:46:00,1,2315.0,2081.0,0.899,11.425,1,1,0,1,0,0,0,0,0.0,0.0
1015,1445,25-09-2019 11:48:00,1,2109.0,1887.0,0.895,10.398,2,2,0,2,0,0,0,0,0.0,0.0
1015,1446,25-09-2019 11:50:00,1,2123.0,1848.0,0.87,10.412,2,2,1,1,0,0,0,0,0.0,0.0
1015,1447,25-09-2019 11:52:00,1,2122.0,1860.0,0.877,10.422,1,1,1,0,0,0,0,0,0.0,0.0
1015,1448,25-09-2019 11:54:00,1,2119.0,1860.0,0.878,10.407,8,8,6,2,0,0,0,0,0.0,0.0
1015,1449,25-09-2019 11:56:00,1,2116.0,1863.0,0.88,10.4,0,0,0,0,0,0,0,0,0.0,0.0
1015,1450,25-09-2019 11:58:00,1,2110.0,1868.0,0.885,10.38,8,6,1,5,2,1,1,0,0.0,0.0
1015,1451,25-09-2019 12:00:00,1,2111.0,1914.0,0.907,10.435,1,1,0,1,0,0,0,0,0.0,0.0
1015,1452,25-09-2019 12:02:00,1,2336.0,2024.0,0.866,11.444,4,3,2,1,1,1,0,0,0.0,0.0
1015,1453,25-09-2019 12:04:00,1,2314.0,2106.0,0.91,11.448,16,12,7,5,4,2,2,0,0.0,0.0
1015,1454,25-09-2019 12:06:00,1,2563.0,2157.0,0.842,12.489,0,0,0,0,0,0,0,0,0.0,0.0
1015,1455,25-09-2019 12:08:00,1,2431.0,2133.0,0.877,11.94,2,2,1,1,0,0,0,0,0.0,0.0
1015,1456,25-09-2019 12:10:00,1,2438.0,2119.0,0.869,11.952,0,0,0,0,0,0,0,0,0.0,0.0
1015,1457,25-09-2019 12:12:00,1,2360.0,1983.0,0.84,11.493,0,0,0,0,0,0,0,0,0.0,0.0
1015,1458,25-09-2019 12:14:00,1,2340.0,2006.0,0.857,11.439,22,15,10,5,7,2,5,0,0.0,0.0
1015,1459,25-09-2019 12:16:00,1,2351.5,1975.5,0.84,11.451,0,0,0,0,0,0,0,0,0.0,0.0
1015,1460,25-09-2019 12:18:00,1,2363.0,1945.0,0.823,11.463,3,3,1,2,0,0,0,0,0.0,0.0
1015,1461,25-09-2019 12:20:00,1,2357.0,1984.0,0.842,11.481,9,7,3,4,2,1,1,0,0.0,0.0
1015,1462,25-09-2019 12:22:00,1,2456.0,2060.0,0.839,11.959,4,1,1,0,3,1,2,0,0.0,0.0
1015,1463,25-09-2019 12:24:00,1,2461.0,2037.0,0.828,11.953,0,0,0,0,0,0,0,0,0.0,0.0
1015,1464,25-09-2019 12:26:00,1,2681.0,2130.0,0.794,12.921,2,1,0,1,1,0,1,0,0.0,0.0
1015,1465,25-09-2019 12:28:00,1,2694.0,2097.0,0.778,12.937,19,16,5,11,3,2,1,0,0.0,0.0
1015,1466,25-09-2019 12:30:00,1,2708.0,2102.0,0.776,12.997,4,4,1,3,0,0,0,0,0.0,0.0
1015,1467,25-09-2019 12:32:00,1,2590.0,2054.0,0.793,12.48,2,2,0,2,0,0,0,0,0.0,0.0
1015,1468,25-09-2019 12:34:00,1,2351.0,1990.0,0.847,11.468,27,21,8,13,6,3,3,0,0.0,0.0
1015,1469,25-09-2019 12:36:00,1,2340.0,1974.0,0.843,11.406,70,27,0,27,43,3,40,0,0.0,0.0
1015,1470,25-09-2019 12:38:00,1,2593.0,2068.0,0.797,12.506,25,18,0,18,7,0,7,0,0.0,0.0
1015,1471,25-09-2019 12:40:00,1,2676.0,2222.0,0.83,13.001,46,30,7,23,16,1,15,0,0.0,0.0
1015,1472,25-09-2019 12:42:00,1,2876.0,2399.0,0.834,13.986,51,35,11,24,16,0,16,2,0.0,0.0
1015,1473,25-09-2019 12:44:00,1,2873.0,2480.0,0.863,14.065,210,144,114,30,66,46,20,23,0.0,0.0
1015,1474,25-09-2019 12:46:00,1,3091.0,2585.0,0.836,15.041,281,196,153,43,85,55,30,27,0.0,0.0
1015,1475,25-09-2019 12:48:00,1,2875.0,2460.0,0.856,14.052,221,151,113,38,70,49,21,25,0.0,0.0
1015,1476,25-09-2019 12:50:00,1,2939.0,2489.5,0.8475,14.336,67,35,12,23,32,14,18,1,0.0,0.0
1015,1477,25-09-2019 12:52:00,1,3003.0,2519.0,0.839,14.62,17,10,6,4,7,2,5,0,0.0,0.0
1015,1478,25-09-2019 12:54:00,1,2915.0,2275.0,0.78,14.005,12,12,0,12,0,0,0,0,0.0,0.0
1015,1479,25-09-2019 12:56:00,1,2706.0,2095.0,0.774,12.981,3,3,2,1,0,0,0,0,0.0,0.0
1015,1480,25-09-2019 12:58:00,1,2347.0,1966.0,0.838,11.424,9,7,2,5,2,0,2,0,0.0,0.0
1015,1481,25-09-2019 13:00:00,1,2365.0,1929.0,0.815,11.455,4,1,0,1,3,1,2,0,0.0,0.0
1015,1482,25-09-2019 13:02:00,1,2379.0,1880.0,0.79,11.454,20,13,3,10,7,1,6,0,0.0,0.0
1015,1483,25-09-2019 13:04:00,1,2381.0,1856.0,0.779,11.437,4,4,0,4,0,0,0,0,0.0,0.0
1015,1484,25-09-2019 13:06:00,1,2388.0,1827.0,0.765,11.433,0,0,0,0,0,0,0,0,0.0,0.0
1015,1485,25-09-2019 13:08:00,1,2383.0,1803.0,0.756,11.386,27,22,6,16,5,3,2,0,0.0,0.0
1015,1486,25-09-2019 13:10:00,1,2617.0,1988.0,0.76,12.511,37,33,1,32,4,2,2,0,0.0,0.0
1015,1487,25-09-2019 13:12:00,1,2618.0,1948.0,0.744,12.471,16,10,0,10,6,2,4,0,0.0,0.0
1015,1488,25-09-2019 13:14:00,1,2361.0,1916.0,0.812,11.424,6,0,0,0,6,2,4,0,0.0,0.0
1015,1489,25-09-2019 13:16:00,1,2363.0,1874.0,0.793,11.387,0,0,0,0,0,0,0,0,0.0,0.0
1015,1490,25-09-2019 13:18:00,1,2390.0,1845.0,0.772,11.458,5,0,0,0,5,1,4,0,0.0,0.0
1015,1491,25-09-2019 13:20:00,1,2397.0,1796.0,0.749,11.434,0,0,0,0,0,0,0,0,0.0,0.0
1015,1492,25-09-2019 13:22:00,1,2388.0,1807.0,0.757,11.41,0,0,0,0,0,0,0,0,0.0,0.0
1015,1493,25-09-2019 13:24:00,1,2388.0,1800.0,0.754,11.403,9,1,1,0,8,1,7,0,0.0,0.0
1015,1494,25-09-2019 13:26:00,1,2388.0,1793.0,0.751,11.396,0,0,0,0,0,0,0,0,0.0,0.0
1015,1495,25-09-2019 13:28:00,1,2404.0,1754.0,0.729,11.416,6,0,0,0,6,0,6,0,0.0,0.0
1015,1496,25-09-2019 13:30:00,1,2406.0,1745.0,0.725,11.411,0,0,0,0,0,0,0,0,0.0,0.0
1015,1497,25-09-2019 13:32:00,1,2171.0,1698.0,0.782,10.434,13,13,1,12,0,0,0,0,0.0,0.0
1015,1498,25-09-2019 13:34:00,1,2193.0,1578.0,0.72,10.387,12,11,0,11,1,0,1,0,0.0,0.0
1015,1499,25-09-2019 13:36:00,1,2175.0,1653.0,0.76,10.398,84,63,32,31,21,3,18,0,0.0,0.0
1015,1500,25-09-2019 13:38:00,1,2743.0,1958.0,0.714,12.976,40,27,8,19,13,1,12,0,0.0,0.0
1015,1501,25-09-2019 13:40:00,1,2697.0,2105.0,0.78,12.958,74,64,41,23,10,3,7,0,0.0,0.0
1015,1502,25-09-2019 13:42:00,1,2927.0,2273.0,0.777,14.049,17,15,0,15,2,1,1,0,0.0,0.0
1015,1503,25-09-2019 13:44:00,1,3030.0,2385.0,0.787,14.581,166,96,50,46,70,41,29,30,0.0,0.0
1015,1504,25-09-2019 13:46:00,1,3226.0,2584.0,0.801,15.571,256,139,103,36,117,61,56,58,0.01,0.0
1015,1505,25-09-2019 13:48:00,1,3228.0,2592.0,0.803,15.587,98,31,7,24,67,2,65,32,0.0,0.0
1015,1506,25-09-2019 13:50:00,1,3550.0,2841.0,0.8,17.131,289,151,119,32,138,74,64,82,0.0,0.03
1015,1507,25-09-2019 13:52:00,1,3462.0,2719.0,0.785,16.651,106,28,9,19,78,19,59,42,0.0,0.0
1015,1508,25-09-2019 13:54:00,1,3676.0,2846.0,0.774,17.637,310,145,122,23,165,103,62,71,0.02,0.04
1015,1509,25-09-2019 13:56:00,1,3561.0,2910.0,0.817,17.254,146,64,41,23,82,18,64,51,0.01,0.15
1015,1510,25-09-2019 13:58:00,1,3670.0,2975.0,0.8105,17.7545,101,32,9,23,69,0,69,51,0.0,0.0
1015,1511,25-09-2019 14:00:00,1,3779.0,3040.0,0.804,18.255,386,225,171,54,161,113,48,45,0.04,0.0
1015,1512,25-09-2019 14:02:00,1,3410.0,2908.0,0.853,16.655,659,350,292,58,309,249,60,47,0.04,0.0
1015,1513,25-09-2019 14:04:00,1,3753.0,3074.0,0.819,18.19,405,221,175,46,184,126,58,37,0.01,0.0
1015,1514,25-09-2019 14:06:00,1,3240.0,2562.0,0.791,15.603,564,385,312,73,179,140,39,52,0.01,0.0
1015,1515,25-09-2019 14:08:00,1,3215.0,2614.0,0.813,15.561,114,41,25,16,73,6,67,41,0.0,0.0
1015,1516,25-09-2019 14:10:00,1,3402.0,2928.0,0.861,16.645,98,35,22,13,63,1,62,52,0.0,0.0
1015,1517,25-09-2019 14:12:00,1,3369.0,2984.0,0.886,16.578,71,44,19,25,27,9,18,3,0.0,0.0
1015,1518,25-09-2019 14:14:00,1,2706.0,2103.0,0.777,12.99,40,17,1,16,23,0,23,0,0.0,0.0
1015,1519,25-09-2019 14:16:00,1,2592.0,2026.0,0.782,12.453,44,39,13,26,5,2,3,0,0.0,0.0
1015,1520,25-09-2019 14:18:00,1,3224.0,2583.0,0.801,15.563,27,10,6,4,17,4,13,0,0.0,0.0
1015,1521,25-09-2019 14:20:00,1,3427.0,2854.0,0.833,16.663,8,7,3,4,1,0,1,0,0.0,0.0
1015,1522,25-09-2019 14:22:00,1,3175.0,2825.0,0.89,15.636,1,1,0,1,0,0,0,0,0.0,0.0
1015,1523,25-09-2019 14:24:00,1,3190.0,2784.0,0.873,15.651,3,0,0,0,3,1,2,0,0.0,0.0
1015,1524,25-09-2019 14:26:00,1,3195.0,2673.0,0.837,15.547,1,0,0,0,1,0,1,0,0.0,0.0
1015,1525,25-09-2019 14:28:00,1,3104.0,2613.0,0.842,15.124,17,12,6,6,5,0,5,0,0.0,0.0
1015,1526,25-09-2019 14:30:00,1,2837.0,2541.0,0.896,13.99,0,0,0,0,0,0,0,0,0.0,0.0
1015,1527,25-09-2019 14:32:00,1,2843.0,2528.5,0.8895,14.001,12,10,4,6,2,2,0,0,0.0,0.0
1015,1528,25-09-2019 14:34:00,1,2849.0,2516.0,0.883,14.012,1,1,0,1,0,0,0,0,0.0,0.0
1015,1529,25-09-2019 14:36:00,1,2867.0,2543.0,0.887,14.113,0,0,0,0,0,0,0,0,0.0,0.0
1015,1530,25-09-2019 14:38:00,1,2866.0,2496.0,0.871,14.054,0,0,0,0,0,0,0,0,0.0,0.0
1015,1531,25-09-2019 14:40:00,1,2865.0,2510.0,0.876,14.068,4,2,0,2,2,0,2,0,0.0,0.0
1015,1532,25-09-2019 14:42:00,1,2837.0,2545.0,0.897,13.995,4,2,1,1,2,0,2,0,0.0,0.0
1015,1533,25-09-2019 14:44:00,1,2896.0,2428.0,0.838,14.098,1,0,0,0,1,1,0,0,0.0,0.0
1015,1534,25-09-2019 14:46:00,1,2653.0,2292.0,0.864,12.991,1,0,0,0,1,1,0,0,0.0,0.0
1015,1535,25-09-2019 14:48:00,1,2657.0,2298.0,0.865,13.011,6,6,1,5,0,0,0,0,0.0,0.0
1015,1536,25-09-2019 14:50:00,1,2652.0,2278.0,0.859,12.972,14,14,0,14,0,0,0,0,0.0,0.0
1015,1537,25-09-2019 14:52:00,1,2675.0,2250.0,0.841,13.032,9,9,4,5,0,0,0,0,0.0,0.0
1015,1538,25-09-2019 14:54:00,1,2774.0,2352.0,0.848,13.535,0,0,0,0,0,0,0,0,0.0,0.0
1015,1539,25-09-2019 14:56:00,1,2660.0,2297.0,0.864,13.022,0,0,0,0,0,0,0,0,0.0,0.0
1015,1540,25-09-2019 14:58:00,1,2652.0,2289.0,0.863,12.985,0,0,0,0,0,0,0,0,0.0,0.0
1015,1541,25-09-2019 15:00:00,1,2655.0,2309.0,0.87,13.015,7,3,2,1,4,0,4,0,0.0,0.0
1015,1542,25-09-2019 15:02:00,1,2681.0,2202.0,0.821,13.003,0,0,0,0,0,0,0,0,0.0,0.0
1015,1543,25-09-2019 15:04:00,1,2574.0,2141.0,0.832,12.512,3,0,0,0,3,0,3,0,0.0,0.0
1015,1544,25-09-2019 15:06:00,1,2629.5,2167.5,0.8245,12.7605,4,1,1,0,3,0,3,0,0.0,0.0
1015,1545,25-09-2019 15:08:00,1,2685.0,2194.0,0.817,13.009,1,0,0,0,1,0,1,0,0.0,0.0
1015,1546,25-09-2019 15:10:00,1,2691.0,2198.0,0.817,13.035,5,3,0,3,2,0,2,1,0.0,0.0
1015,1547,25-09-2019 15:12:00,1,2676.0,2196.0,0.821,12.975,6,5,1,4,1,1,0,0,0.0,0.0
1015,1548,25-09-2019 15:14:00,1,2672.0,2223.0,0.832,12.99,2,2,1,1,0,0,0,0,0.0,0.0
1015,1549,25-09-2019 15:16:00,1,2914.0,2350.0,0.806,14.083,1,1,0,1,0,0,0,0,0.0,0.0
1015,1550,25-09-2019 15:18:00,1,2909.0,2332.0,0.802,14.044,0,0,0,0,0,0,0,0,0.0,0.0
1015,1551,25-09-2019 15:20:00,1,2663.0,2269.0,0.852,13.004,15,11,8,3,4,3,1,0,0.0,0.0
1015,1552,25-09-2019 15:22:00,1,2782.0,2289.0,0.823,13.497,88,70,37,33,18,7,11,1,0.0,0.0
1015,1553,25-09-2019 15:24:00,1,2893.0,2393.0,0.827,14.05,32,18,6,12,14,1,13,0,0.0,0.0
1015,1554,25-09-2019 15:26:00,1,2890.0,2415.0,0.836,14.06,59,33,14,19,26,3,23,0,0.0,0.0
1015,1555,25-09-2019 15:28:00,1,2880.0,2407.0,0.836,14.01,27,17,3,14,10,0,10,0,0.0,0.0
1015,1556,25-09-2019 15:30:00,1,2877.0,2453.0,0.853,14.049,8,5,1,4,3,0,3,0,0.0,0.0
1015,1557,25-09-2019 15:32:00,1,2686.0,2157.0,0.803,12.973,6,4,0,4,2,0,2,0,0.0,0.0
1015,1558,25-09-2019 15:34:00,1,2587.0,2069.0,0.8,12.486,0,0,0,0,0,0,0,0,0.0,0.0
1015,1559,25-09-2019 15:36:00,1,2592.0,2074.0,0.8,12.507,2,1,0,1,1,0,1,0,0.0,0.0
1015,1560,25-09-2019 15:38:00,1,2581.0,2065.0,0.8,12.456,33,25,11,14,8,0,8,0,0.0,0.0
1015,1561,25-09-2019 15:40:00,1,2746.5,2196.5,0.7995,13.254,10,3,1,2,7,0,7,0,0.0,0.0
1015,1562,25-09-2019 15:42:00,1,2912.0,2328.0,0.799,14.052,136,95,71,24,41,27,14,7,0.0,0.0
1015,1563,25-09-2019 15:44:00,1,2795.0,2266.0,0.811,13.523,112,45,25,20,67,3,64,59,0.0,0.0
1015,1564,25-09-2019 15:46:00,1,3224.0,2591.0,0.804,15.572,418,237,182,55,181,106,75,77,0.0,0.0
1015,1565,25-09-2019 15:48:00,1,3229.0,2612.0,0.809,15.613,127,40,26,14,87,25,62,60,0.0,0.0
1015,1566,25-09-2019 15:50:00,1,3439.0,2766.0,0.804,16.614,151,104,68,36,47,23,24,47,0.0,0.01
1015,1567,25-09-2019 15:52:00,1,3188.0,2760.0,0.866,15.615,191,119,77,42,72,46,26,23,0.01,0.0
1015,1568,25-09-2019 15:54:00,1,3221.0,2616.0,0.812,15.587,245,130,95,35,115,77,38,29,0.0,0.0
1015,1569,25-09-2019 15:56:00,1,3210.0,2688.0,0.837,15.624,206,108,81,27,98,70,28,35,0.01,0.02
1015,1570,25-09-2019 15:58:00,1,3199.0,2671.0,0.835,15.561,93,25,8,17,68,2,66,69,0.0,0.0
1015,1571,25-09-2019 16:00:00,1,3422.0,2886.0,0.843,16.676,77,12,2,10,65,0,65,44,0.0,0.0
1015,1572,25-09-2019 16:02:00,1,3418.0,2916.0,0.853,16.694,110,36,14,22,74,0,74,44,0.0,0.0
1015,1573,25-09-2019 16:04:00,1,3391.0,2976.0,0.878,16.655,79,19,9,10,60,0,60,57,0.0,0.09
1015,1574,25-09-2019 16:06:00,1,3488.0,3012.0,0.864,17.077,115,56,36,20,59,8,51,40,0.0,0.04
1015,1575,25-09-2019 16:08:00,1,3201.0,2704.0,0.845,15.605,656,393,334,59,263,199,64,42,0.06,0.0
1015,1576,25-09-2019 16:10:00,1,3604.0,3229.0,0.896,17.773,426,232,189,43,194,138,56,66,0.01,0.06
1015,1577,25-09-2019 16:12:00,1,3405.0,2911.0,0.855,16.639,419,255,197,58,164,118,46,19,0.01,0.01
1015,1578,25-09-2019 16:14:00,1,3281.0,2870.5,0.8755,16.1045,593,346,272,74,247,195,52,44,0.01,0.0
1015,1579,25-09-2019 16:16:00,1,3157.0,2830.0,0.896,15.57,152,82,49,33,70,32,38,3,0.03,0.0
1015,1580,25-09-2019 16:18:00,1,3231.0,2631.0,0.814,15.642,72,53,27,26,19,2,17,0,0.0,0.0
1015,1581,25-09-2019 16:20:00,1,2964.0,2567.0,0.866,14.521,37,14,1,13,23,0,23,0,0.0,0.0
1015,1582,25-09-2019 16:22:00,1,3206.0,2684.0,0.837,15.604,25,11,0,11,14,0,14,0,0.0,0.0
1015,1583,25-09-2019 16:24:00,1,3417.0,2870.0,0.84,16.642,54,34,22,12,20,0,20,0,0.0,0.0
1015,1584,25-09-2019 16:26:00,1,3414.0,2913.0,0.853,16.674,5,5,0,5,0,0,0,0,0.01,0.0
1015,1585,25-09-2019 16:28:00,1,3141.0,2842.0,0.905,15.523,0,0,0,0,0,0,0,0,0.0,0.0
1015,1586,25-09-2019 16:30:00,1,3197.0,2709.0,0.848,15.594,84,71,56,15,13,6,7,0,0.0,0.0
1015,1587,25-09-2019 16:32:00,1,3171.0,2786.0,0.879,15.577,785,505,409,96,280,205,75,13,0.0,0.0
1015,1588,25-09-2019 16:34:00,1,3379.0,2958.0,0.875,16.591,366,187,133,54,179,122,57,33,0.0,0.0
1015,1589,25-09-2019 16:36:00,1,3365.0,3026.0,0.899,16.609,62,46,18,28,16,3,13,0,0.0,0.0
1015,1590,25-09-2019 16:38:00,1,3380.0,3011.0,0.891,16.652,41,23,8,15,18,0,18,0,0.0,0.0
1015,1591,25-09-2019 16:40:00,1,3392.0,2982.0,0.879,16.665,0,0,0,0,0,0,0,0,0.0,0.0
1015,1592,25-09-2019 16:42:00,1,3168.0,2801.0,0.884,15.585,0,0,0,0,0,0,0,0,0.0,0.0
1015,1593,25-09-2019 16:44:00,1,3086.0,2630.0,0.852,15.07,1,0,0,0,1,0,1,0,0.0,0.0
1015,1594,25-09-2019 16:46:00,1,2863.0,2486.0,0.868,14.031,2,2,1,1,0,0,0,0,0.0,0.0
1015,1595,25-09-2019 16:48:00,1,2765.5,2377.0,0.859,13.5265,5,5,0,5,0,0,0,0,0.0,0.0
1015,1596,25-09-2019 16:50:00,1,2668.0,2268.0,0.85,13.022,0,0,0,0,0,0,0,0,0.0,0.0
1015,1597,25-09-2019 16:52:00,1,2699.0,2181.0,0.808,13.048,4,3,0,3,1,0,1,0,0.0,0.0
1015,1598,25-09-2019 16:54:00,1,2574.0,2135.0,0.829,12.504,0,0,0,0,0,0,0,0,0.0,0.0
1015,1599,25-09-2019 16:56:00,1,2332.0,2033.0,0.872,11.44,1,1,0,1,0,0,0,0,0.0,0.0
1015,1600,25-09-2019 16:58:00,1,2339.0,1982.0,0.848,11.408,0,0,0,0,0,0,0,0,0.0,0.0
1015,1601,25-09-2019 17:00:00,1,2353.0,2011.0,0.855,11.497,8,5,2,3,3,0,3,0,0.0,0.0
1015,1602,25-09-2019 17:02:00,1,2450.0,2100.0,0.857,11.98,1,0,0,0,1,0,1,0,0.0,0.0
1015,1603,25-09-2019 17:04:00,1,2329.0,2038.0,0.875,11.432,7,3,0,3,4,0,4,0,0.0,0.0
1015,1604,25-09-2019 17:06:00,1,2346.0,1998.0,0.852,11.454,11,5,0,5,6,0,6,0,0.0,0.0
1015,1605,25-09-2019 17:08:00,1,2359.0,1950.0,0.826,11.453,5,4,3,1,1,0,1,0,0.0,0.0
1015,1606,25-09-2019 17:10:00,1,2237.0,1894.0,0.847,10.91,0,0,0,0,0,0,0,0,0.0,0.0
1015,1607,25-09-2019 17:12:00,1,2114.0,1842.0,0.871,10.367,15,13,5,8,2,0,2,0,0.0,0.0
1015,1608,25-09-2019 17:14:00,1,2345.0,1954.0,0.833,11.405,7,4,1,3,3,0,3,0,0.0,0.0
1015,1609,25-09-2019 17:16:00,1,2461.0,2004.0,0.814,11.916,1,1,1,0,0,0,0,0,0.0,0.0
1015,1610,25-09-2019 17:18:00,1,2474.0,2029.0,0.82,11.995,11,9,4,5,2,0,2,0,0.0,0.0
1015,1611,25-09-2019 17:20:00,1,2583.0,2035.0,0.788,12.43,2,2,0,2,0,0,0,0,0.0,0.0
1015,1612,25-09-2019 17:22:00,1,2639.5,2081.5,0.7885,12.704,31,23,14,9,8,6,2,0,0.0,0.0
1015,1613,25-09-2019 17:24:00,1,2696.0,2128.0,0.789,12.978,44,26,1,25,18,0,18,0,0.0,0.0
1015,1614,25-09-2019 17:26:00,1,2890.0,2402.0,0.831,14.047,50,27,9,18,23,4,19,0,0.0,0.0
1015,1615,25-09-2019 17:28:00,1,2862.0,2486.0,0.869,14.028,47,30,11,19,17,0,17,0,0.0,0.0
1015,1616,25-09-2019 17:30:00,1,3101.0,2565.0,0.827,15.059,38,37,25,12,1,0,1,0,0.0,0.0
1015,1617,25-09-2019 17:32:00,1,3234.0,2586.0,0.8,15.605,26,26,18,8,0,0,0,0,0.0,0.0
1015,1618,25-09-2019 17:34:00,1,2891.0,2381.0,0.824,14.027,2,2,1,1,0,0,0,0,0.0,0.0
1015,1619,25-09-2019 17:36:00,1,2665.0,2223.0,0.834,12.962,132,82,62,20,50,36,14,5,0.0,0.0
1015,1620,25-09-2019 17:38:00,1,2684.0,2253.0,0.839,13.069,150,94,56,38,56,31,25,10,0.0,0.0
1015,1621,25-09-2019 17:40:00,1,2893.0,2373.0,0.82,14.024,74,38,18,20,36,0,36,0,0.0,0.0
1015,1622,25-09-2019 17:42:00,1,2902.0,2387.0,0.823,14.075,12,12,7,5,0,0,0,0,0.0,0.0
1015,1623,25-09-2019 17:44:00,1,2674.0,2246.0,0.84,13.024,5,5,2,3,0,0,0,0,0.0,0.0
1015,1624,25-09-2019 17:46:00,1,2695.0,2114.0,0.784,12.957,3,2,1,1,1,1,0,0,0.0,0.0
1015,1625,25-09-2019 17:48:00,1,2473.0,1995.0,0.807,11.951,11,9,4,5,2,1,1,0,0.0,0.0
1015,1626,25-09-2019 17:50:00,1,2615.0,1986.0,0.759,12.504,198,130,88,42,68,12,56,47,0.0,0.0
1015,1627,25-09-2019 17:52:00,1,3270.0,2471.0,0.755,15.622,81,20,12,8,61,0,61,66,0.0,0.0
1015,1628,25-09-2019 17:54:00,1,3459.0,2697.0,0.78,16.614,78,17,9,8,61,0,61,54,0.0,0.06
1015,1629,25-09-2019 17:56:00,1,3600.0,2875.5,0.798,17.3685,179,74,64,10,105,44,61,66,0.0,0.07
1015,1630,25-09-2019 17:58:00,1,3741.0,3054.0,0.816,18.123,326,182,138,44,144,116,28,71,0.04,0.04
1015,1631,25-09-2019 18:00:00,0,3440.0,2804.0,0.815,16.661,559,276,226,50,283,224,59,141,0.04,0.0
1015,1632,25-09-2019 18:02:00,0,3415.0,2889.0,0.846,16.654,884,523,446,77,361,294,67,171,0.01,0.0
1015,1633,25-09-2019 18:04:00,0,3764.0,3061.0,0.813,18.221,649,341,288,53,308,241,67,151,0.0,0.0
1015,1634,25-09-2019 18:06:00,0,3710.0,3228.0,0.87,18.191,792,458,393,65,334,270,64,109,0.0,0.0
1015,1635,25-09-2019 18:08:00,0,3399.0,2948.0,0.867,16.658,228,141,108,33,87,67,20,81,0.0,0.0
1015,1636,25-09-2019 18:10:00,0,3828.0,3272.0,0.855,18.704,492,261,221,40,231,173,58,119,0.03,0.07
1015,1637,25-09-2019 18:12:00,0,3953.0,3320.0,0.84,19.249,320,175,145,30,145,83,62,83,0.0,0.0
1015,1638,25-09-2019 18:14:00,0,3948.0,3383.0,0.857,19.302,141,42,23,19,99,8,91,53,0.0,0.02
1015,1639,25-09-2019 18:16:00,0,3879.0,3518.0,0.907,19.179,414,225,187,38,189,135,54,60,0.06,0.03
1015,1640,25-09-2019 18:18:00,0,4235.0,3740.0,0.883,20.824,453,262,218,44,191,144,47,62,0.05,0.04
1015,1641,25-09-2019 18:20:00,0,3741.0,3185.0,0.852,18.266,43,11,8,3,32,10,22,5,0.0,0.0
1015,1642,25-09-2019 18:22:00,0,3913.0,3521.0,0.9,19.316,292,165,129,36,127,69,58,90,0.0,0.0
1015,1643,25-09-2019 18:24:00,0,3803.0,3321.0,0.873,18.662,246,101,77,24,145,65,80,56,0.05,0.08
1015,1644,25-09-2019 18:26:00,0,4220.0,3773.0,0.894,20.803,487,242,191,51,245,191,54,57,0.0,0.0
1015,1645,25-09-2019 18:28:00,0,4211.0,3798.0,0.902,20.797,304,154,126,28,150,112,38,91,0.0,0.02
1015,1646,25-09-2019 18:30:00,0,4055.0,3629.5,0.895,19.995,262,171,140,31,91,57,34,99,0.02,0.0
1015,1647,25-09-2019 18:32:00,0,3899.0,3461.0,0.888,19.193,238,105,90,15,133,65,68,120,0.0,0.0
1015,1648,25-09-2019 18:34:00,0,4123.0,3658.0,0.887,20.294,176,65,54,11,111,19,92,55,0.0,0.34
1015,1649,25-09-2019 18:36:00,0,3910.0,3480.0,0.89,19.258,38,10,1,9,28,20,8,0,0.07,0.0
1015,1650,25-09-2019 18:38:00,0,4387.0,4120.0,0.939,21.845,207,128,101,27,79,64,15,28,0.0,0.0
1015,1651,25-09-2019 18:40:00,0,3894.0,3505.0,0.9,19.223,620,317,256,61,303,237,66,121,0.0,0.03
1015,1652,25-09-2019 18:42:00,0,4176.0,3834.0,0.918,20.697,564,272,217,55,292,226,66,109,0.03,0.03
1015,1653,25-09-2019 18:44:00,0,2828.0,2553.0,0.903,13.968,95,63,33,30,32,14,18,7,0.0,0.0
1015,1654,25-09-2019 18:46:00,0,3666.0,3416.0,0.932,18.225,86,75,41,34,11,2,9,0,0.01,0.0
1015,1655,25-09-2019 18:48:00,0,4221.0,3818.0,0.905,20.858,39,27,15,12,12,6,6,0,0.0,0.0
1015,1656,25-09-2019 18:50:00,0,3907.0,3543.0,0.907,19.317,1,0,0,0,1,0,1,0,0.0,0.0
1015,1657,25-09-2019 18:52:00,0,3866.0,3659.0,0.947,19.283,41,33,13,20,8,1,7,0,0.0,0.0
1015,1658,25-09-2019 18:54:00,0,3981.0,3707.0,0.931,19.787,27,17,8,9,10,2,8,0,0.0,0.0
1015,1659,25-09-2019 18:56:00,0,3895.0,3508.0,0.901,19.229,15,9,2,7,6,3,3,0,0.0,0.0
1015,1660,25-09-2019 18:58:00,0,3653.0,3402.0,0.931,18.158,11,2,0,2,9,3,6,0,0.0,0.0
1015,1661,25-09-2019 19:00:00,0,3686.0,3324.0,0.902,18.203,10,0,0,0,10,4,6,0,0.0,0.0
1015,1662,25-09-2019 19:02:00,0,3587.0,3206.0,0.894,17.682,7,0,0,0,7,0,7,0,0.0,0.0
1015,1663,25-09-2019 19:04:00,0,3464.5,3179.0,0.9185,17.17,71,63,27,36,8,4,4,0,0.0,0.0
1015,1664,25-09-2019 19:06:00,0,3342.0,3152.0,0.943,16.658,271,140,94,46,131,97,34,18,0.03,0.0
1015,1665,25-09-2019 19:08:00,0,3673.0,3353.0,0.913,18.184,407,184,155,29,223,156,67,103,0.05,0.0
1015,1666,25-09-2019 19:10:00,0,3659.0,3393.0,0.927,18.173,343,196,167,29,147,119,28,108,0.0,0.0
1015,1667,25-09-2019 19:12:00,0,3645.0,3457.0,0.948,18.19,636,296,241,55,340,271,69,107,0.09,0.0
1015,1668,25-09-2019 19:14:00,0,3756.0,3484.0,0.928,18.656,100,64,42,22,36,29,7,33,0.0,0.0
1015,1669,25-09-2019 19:16:00,0,3879.0,3564.0,0.919,19.23,41,39,13,26,2,2,0,6,0.0,0.0
1015,1670,25-09-2019 19:18:00,0,3874.0,3644.0,0.941,19.298,60,36,28,8,24,15,9,23,0.0,0.0
1015,1671,25-09-2019 19:20:00,0,3763.0,3530.0,0.938,18.734,184,99,72,27,85,56,29,40,0.05,0.0
1015,1672,25-09-2019 19:22:00,0,3858.0,3569.0,0.925,19.152,384,226,178,48,158,116,42,88,0.0,0.0
1015,1673,25-09-2019 19:24:00,0,3627.0,3472.0,0.957,18.136,461,253,211,42,208,164,44,136,0.04,0.0
1015,1674,25-09-2019 19:26:00,0,3883.0,3594.0,0.926,19.28,473,230,175,55,243,196,47,133,0.0,0.0
1015,1675,25-09-2019 19:28:00,0,3894.0,3555.0,0.913,19.279,108,58,43,15,50,32,18,71,0.0,0.0
1015,1676,25-09-2019 19:30:00,0,3855.0,3575.0,0.927,19.147,205,105,75,30,100,71,29,42,0.0,0.0
1015,1677,25-09-2019 19:32:00,0,3763.0,3518.0,0.935,18.721,132,48,26,22,84,40,44,0,0.0,0.0
1015,1678,25-09-2019 19:34:00,0,3885.0,3581.0,0.922,19.272,19,4,1,3,15,6,9,0,0.0,0.0
1015,1679,25-09-2019 19:36:00,0,4079.0,3841.0,0.942,20.324,139,71,56,15,68,49,19,4,0.0,0.0
1015,1680,25-09-2019 19:38:00,0,3656.5,3447.5,0.943,18.2245,0,0,0,0,0,0,0,0,0.0,0.0
1015,1681,25-09-2019 19:40:00,0,3234.0,3054.0,0.944,16.125,69,49,35,14,20,12,8,0,0.0,0.0
1015,1682,25-09-2019 19:42:00,0,3140.0,2970.0,0.946,15.66,1,0,0,0,1,1,0,0,0.0,0.0
1015,1683,25-09-2019 19:44:00,0,3349.0,3122.0,0.932,16.651,2,1,0,1,1,0,1,0,0.0,0.0
1015,1684,25-09-2019 19:46:00,0,3341.0,3149.0,0.943,16.651,8,4,3,1,4,2,2,0,0.0,0.0
1015,1685,25-09-2019 19:48:00,0,3247.0,3009.0,0.927,16.123,28,19,8,11,9,3,6,0,0.0,0.0
1015,1686,25-09-2019 19:50:00,0,3126.0,2965.0,0.948,15.599,5,5,0,5,0,0,0,0,0.0,0.0
1015,1687,25-09-2019 19:52:00,0,3157.0,2856.0,0.905,15.6,8,2,0,2,6,0,6,0,0.0,0.0
1015,1688,25-09-2019 19:54:00,0,3155.0,2871.0,0.91,15.607,146,109,86,23,37,18,19,6,0.0,0.0
1015,1689,25-09-2019 19:56:00,0,3120.0,2980.0,0.955,15.591,55,31,16,15,24,6,18,1,0.0,0.0
1015,1690,25-09-2019 19:58:00,0,3334.0,3155.0,0.946,16.63,40,22,11,11,18,0,18,0,0.0,0.0
1015,1691,25-09-2019 20:00:00,0,3586.0,3287.0,0.917,17.768,40,27,16,11,13,4,9,0,0.0,0.0
1015,1692,25-09-2019 20:02:00,0,3692.0,3387.0,0.917,18.298,169,117,79,38,52,28,24,7,0.0,0.0
1015,1693,25-09-2019 20:04:00,0,3637.0,3442.0,0.946,18.139,490,263,216,47,227,177,50,103,0.0,0.0
1015,1694,25-09-2019 20:06:00,0,3643.0,3478.0,0.955,18.203,360,152,123,29,208,135,73,82,0.0,0.0
1015,1695,25-09-2019 20:08:00,0,3892.0,3589.0,0.922,19.306,312,148,119,29,164,115,49,61,0.0,0.0
1015,1696,25-09-2019 20:10:00,0,3566.0,3292.0,0.923,17.695,259,117,94,23,142,89,53,81,0.0,0.0
1015,1697,25-09-2019 20:12:00,0,3656.0,3397.5,0.929,18.1665,194,88,74,14,106,63,43,109,0.0,0.0
1015,1698,25-09-2019 20:14:00,0,3746.0,3503.0,0.935,18.638,433,240,199,41,193,146,47,137,0.0,0.0
1015,1699,25-09-2019 20:16:00,0,4075.0,3785.0,0.929,20.246,276,145,108,37,131,74,57,72,0.01,0.0
1015,1700,25-09-2019 20:18:00,0,3957.0,3753.0,0.949,19.746,88,12,5,7,76,0,76,54,0.0,0.02
1015,1701,25-09-2019 20:20:00,0,4163.0,3965.0,0.952,20.791,81,11,4,7,70,0,70,60,0.0,0.06
1015,1702,25-09-2019 20:22:00,0,4175.0,3943.0,0.944,20.814,142,89,67,22,53,34,19,35,0.0,0.05
1015,1703,25-09-2019 20:24:00,0,3753.0,3527.0,0.94,18.693,415,226,185,41,189,147,42,129,0.06,0.03
1015,1704,25-09-2019 20:26:00,0,3909.0,3511.0,0.898,19.289,65,7,3,4,58,27,31,1,0.0,0.0
1015,1705,25-09-2019 20:28:00,0,3762.0,3475.0,0.924,18.67,381,195,149,46,186,141,45,119,0.0,0.04
1015,1706,25-09-2019 20:30:00,0,3347.0,3112.0,0.93,16.634,400,177,139,38,223,170,53,103,0.0,0.0
1015,1707,25-09-2019 20:32:00,0,4409.0,4093.0,0.928,21.903,141,73,58,15,68,53,15,28,0.01,0.0
1015,1708,25-09-2019 20:34:00,0,3772.0,3496.0,0.927,18.732,344,179,142,37,165,101,64,66,0.02,0.0
1015,1709,25-09-2019 20:36:00,0,3869.0,3666.0,0.948,19.304,97,23,9,14,74,0,74,48,0.0,0.0
1015,1710,25-09-2019 20:38:00,0,4224.0,3830.0,0.907,20.882,125,52,26,26,73,2,71,56,0.0,0.02
1015,1711,25-09-2019 20:40:00,0,4073.0,3821.0,0.938,20.277,162,87,67,20,75,42,33,40,0.0,0.06
1015,1712,25-09-2019 20:42:00,0,3836.0,3697.0,0.964,19.207,426,170,122,48,256,193,63,51,0.0,0.02
1015,1713,25-09-2019 20:44:00,0,2843.0,2549.0,0.897,14.022,309,139,117,22,170,132,38,91,0.02,0.0
1015,1714,25-09-2019 20:46:00,0,3773.0,3455.5,0.9125,18.691,348,165,128,37,183,147,36,113,0.0,0.03
1015,1715,25-09-2019 20:48:00,0,4703.0,4362.0,0.928,23.36,551,272,226,46,279,220,59,94,0.05,0.03
1015,1716,25-09-2019 20:50:00,0,3890.0,3537.0,0.909,19.244,361,191,152,39,170,132,38,85,0.0,0.0
1015,1717,25-09-2019 20:52:00,0,4070.0,3851.0,0.946,20.301,299,178,144,34,121,93,28,65,0.0,0.0
1015,1718,25-09-2019 20:54:00,0,4933.0,4547.0,0.922,24.469,202,89,66,23,113,75,38,90,0.0,0.0
1015,1719,25-09-2019 20:56:00,0,3688.0,3344.0,0.907,18.231,98,22,11,11,76,0,76,39,0.0,0.0
1015,1720,25-09-2019 20:58:00,0,4194.0,3941.0,0.94,20.888,84,10,6,4,74,22,52,23,0.03,0.09
1015,1721,25-09-2019 21:00:00,0,4694.0,4373.0,0.932,23.334,97,33,19,14,64,36,28,19,0.05,0.0
1015,1722,25-09-2019 21:02:00,0,3958.0,3770.0,0.952,19.769,315,175,142,33,140,105,35,56,0.0,0.0
1015,1723,25-09-2019 21:04:00,0,4474.0,4272.0,0.955,22.356,397,181,147,34,216,165,51,39,0.04,0.04
1015,1724,25-09-2019 21:06:00,0,3875.0,3628.0,0.936,19.284,410,234,188,46,176,139,37,164,0.0,0.0
1015,1725,25-09-2019 21:08:00,0,4198.0,3887.0,0.926,20.845,400,222,183,39,178,131,47,114,0.0,0.68
1015,1726,25-09-2019 21:10:00,0,3146.0,2873.0,0.913,15.577,182,86,62,24,96,63,33,2,0.0,0.0
1015,1727,25-09-2019 21:12:00,0,4188.0,3971.0,0.948,20.896,419,201,153,48,218,165,53,91,0.0,0.0
1015,1728,25-09-2019 21:14:00,0,4281.0,4032.0,0.942,21.331,441,176,131,45,265,203,62,48,0.0,0.0
1015,1729,25-09-2019 21:16:00,0,3685.0,3309.0,0.898,18.181,150,40,31,9,110,34,76,59,0.0,0.0
1015,1730,25-09-2019 21:18:00,0,4405.0,4057.0,0.921,21.846,123,16,7,9,107,14,93,51,0.0,0.0
1015,1731,25-09-2019 21:20:00,0,4393.5,4134.0,0.941,21.8875,47,34,25,9,13,9,4,1,0.01,0.0
1015,1732,25-09-2019 21:22:00,0,4382.0,4211.0,0.961,21.929,403,191,164,27,212,163,49,104,0.0,0.0
1015,1733,25-09-2019 21:24:00,0,3747.0,3592.0,0.959,18.739,637,302,247,55,335,263,72,80,0.03,0.0
1015,1734,25-09-2019 21:26:00,0,4364.0,4181.0,0.958,21.822,253,129,99,30,124,80,44,72,0.0,0.0
1015,1735,25-09-2019 21:28:00,0,4074.0,3832.0,0.941,20.295,281,126,99,27,155,109,46,115,0.01,0.0
1015,1736,25-09-2019 21:30:00,0,3868.0,3625.0,0.937,19.252,297,150,113,37,147,99,48,95,0.0,0.0
1015,1737,25-09-2019 21:32:00,0,4084.0,3836.0,0.939,20.339,463,245,202,43,218,167,51,148,0.0,0.0
1015,1738,25-09-2019 21:34:00,0,4157.0,3963.0,0.953,20.764,494,277,230,47,217,167,50,101,0.01,0.0
1015,1739,25-09-2019 21:36:00,0,4276.0,4057.0,0.949,21.341,178,107,85,22,71,48,23,80,0.0,0.0
1015,1740,25-09-2019 21:38:00,0,4254.0,4094.0,0.962,21.293,206,113,75,38,93,53,40,27,0.04,0.0
1015,1741,25-09-2019 21:40:00,0,3661.0,3419.0,0.934,18.209,318,149,113,36,169,131,38,115,0.0,0.0
1015,1742,25-09-2019 21:42:00,0,3886.0,3597.0,0.926,19.295,151,73,63,10,78,53,25,25,0.0,0.0
1015,1743,25-09-2019 21:44:00,0,3977.0,3754.0,0.944,19.826,368,200,159,41,168,117,51,86,0.01,0.0
1015,1744,25-09-2019 21:46:00,0,4137.0,4012.0,0.97,20.742,252,104,78,26,148,78,70,76,0.0,0.0
1015,1745,25-09-2019 21:48:00,0,4727.0,4382.0,0.927,23.476,126,55,29,26,71,0,71,68,0.0,0.0
1015,1746,25-09-2019 21:50:00,0,4673.0,4450.0,0.952,23.338,244,56,35,21,188,110,78,48,0.05,0.0
1015,1747,25-09-2019 21:52:00,0,3883.0,3612.0,0.93,19.299,211,110,76,34,101,56,45,15,0.01,0.0
1015,1748,25-09-2019 21:54:00,0,4189.0,3914.5,0.934,20.84,284,141,115,26,143,108,35,65,0.0,0.0
1015,1749,25-09-2019 21:56:00,0,4495.0,4217.0,0.938,22.381,465,203,167,36,262,208,54,99,0.02,0.0
1015,1750,25-09-2019 21:58:00,0,4202.0,3840.0,0.914,20.807,372,161,124,37,211,159,52,65,0.0,0.0
1015,1751,25-09-2019 22:00:00,0,3861.0,3681.0,0.953,19.286,383,187,145,42,196,147,49,71,0.0,0.0
1015,1752,25-09-2019 22:02:00,0,4157.0,3995.0,0.961,20.801,568,232,173,59,336,266,70,100,0.05,0.0
1015,1753,25-09-2019 22:04:00,0,4211.0,3853.0,0.915,20.858,220,98,77,21,122,58,64,90,0.01,0.0
1015,1754,25-09-2019 22:06:00,0,4479.0,4218.0,0.942,22.318,228,137,100,37,91,45,46,77,0.0,0.0
1015,1755,25-09-2019 22:08:00,0,4196.0,3893.0,0.928,20.844,296,155,120,35,141,68,73,68,0.0,0.0
1015,1756,25-09-2019 22:10:00,0,4361.0,4240.0,0.972,21.875,250,80,56,24,170,77,93,40,0.02,0.0
1015,1757,25-09-2019 22:12:00,0,3348.0,3143.0,0.939,16.672,274,124,101,23,150,106,44,30,0.01,0.0
1015,1758,25-09-2019 22:14:00,0,4359.0,4220.0,0.968,21.846,277,121,78,43,156,103,53,38,0.04,0.0
1015,1759,25-09-2019 22:16:00,0,3790.0,3456.0,0.912,18.761,338,185,142,43,153,112,41,52,0.04,0.0
1015,1760,25-09-2019 22:18:00,0,3841.0,3736.0,0.972,19.271,380,219,179,40,161,124,37,102,0.0,0.0
1015,1761,25-09-2019 22:20:00,0,4420.0,4104.0,0.928,21.96,532,298,252,46,234,184,50,136,0.02,0.0
1015,1762,25-09-2019 22:22:00,0,4481.0,4275.0,0.954,22.386,128,38,18,20,90,4,86,74,0.0,0.0
1015,1763,25-09-2019 22:24:00,0,4698.0,4477.0,0.953,23.465,232,78,48,30,154,105,49,13,0.06,0.0
1015,1764,25-09-2019 22:26:00,0,3833.0,3777.0,0.985,19.284,409,193,149,44,216,171,45,61,0.0,0.0
1015,1765,25-09-2019 22:28:00,0,4021.0,3850.0,0.9585,20.105,443,218,178,40,225,169,56,57,0.02,0.0
1015,1766,25-09-2019 22:30:00,0,4209.0,3923.0,0.932,20.926,296,127,94,33,169,95,74,87,0.01,0.0
1015,1767,25-09-2019 22:32:00,0,4347.0,4230.0,0.973,21.81,274,136,97,39,138,98,40,53,0.0,0.0
1015,1768,25-09-2019 22:34:00,0,4299.0,3982.0,0.926,21.345,12,10,6,4,2,2,0,0,0.02,0.0
1015,1769,25-09-2019 22:36:00,0,4690.0,4431.0,0.945,23.384,291,129,103,26,162,135,27,65,0.05,0.0
1015,1770,25-09-2019 22:38:00,0,3569.0,3271.0,0.917,17.684,121,81,38,43,40,7,33,1,0.0,0.0
1015,1771,25-09-2019 22:40:00,0,3782.0,3460.0,0.915,18.734,254,145,107,38,109,82,27,82,0.0,0.0
1015,1772,25-09-2019 22:42:00,0,3853.0,3648.0,0.947,19.218,364,157,127,30,207,163,44,63,0.0,0.0
1015,1773,25-09-2019 22:44:00,0,4164.0,3936.0,0.945,20.764,214,88,63,25,126,53,73,83,0.0,0.0
1015,1774,25-09-2019 22:46:00,0,4284.0,4051.0,0.945,21.364,102,64,38,26,38,12,26,31,0.0,0.0
1015,1775,25-09-2019 22:48:00,0,3364.0,3064.0,0.911,16.644,117,75,55,20,42,22,20,1,0.0,0.0
1015,1776,25-09-2019 22:50:00,0,3574.0,3230.0,0.904,17.656,71,43,18,25,28,4,24,0,0.0,0.0
1015,1777,25-09-2019 22:52:00,0,3875.0,3639.0,0.939,19.298,46,29,8,21,17,1,16,0,0.0,0.0
1015,1778,25-09-2019 22:54:00,0,4211.0,3829.0,0.909,20.83,67,58,27,31,9,2,7,0,0.0,0.0
1015,1779,25-09-2019 22:56:00,0,4276.0,4078.0,0.953,21.363,289,194,149,45,95,64,31,8,0.0,0.0
1015,1780,25-09-2019 22:58:00,0,4243.0,4117.0,0.97,21.275,85,57,43,14,28,16,12,1,0.0,0.0
1015,1781,25-09-2019 23:00:00,0,4197.0,3952.0,0.942,20.911,184,106,69,37,78,55,23,21,0.0,0.0
1015,1782,25-09-2019 23:02:00,0,4033.0,3817.5,0.947,20.1165,240,143,102,41,97,72,25,32,0.05,0.0
1015,1783,25-09-2019 23:04:00,0,3869.0,3683.0,0.952,19.322,247,121,91,30,126,95,31,74,0.0,0.0
1015,1784,25-09-2019 23:06:00,0,4062.0,3875.0,0.954,20.295,432,217,173,44,215,175,40,84,0.0,0.0
1015,1785,25-09-2019 23:08:00,0,3866.0,3670.0,0.95,19.294,261,121,97,24,140,93,47,99,0.0,0.0
1015,1786,25-09-2019 23:10:00,0,4195.0,3912.0,0.933,20.858,158,82,60,22,76,50,26,59,0.01,0.0
1015,1787,25-09-2019 23:12:00,0,4075.0,3840.0,0.942,20.307,392,206,158,48,186,154,32,158,0.0,0.0
1015,1788,25-09-2019 23:14:00,0,3827.0,3749.0,0.98,19.227,360,184,136,48,176,127,49,110,0.0,0.0
1015,1789,25-09-2019 23:16:00,0,3861.0,3681.0,0.953,19.287,284,155,119,36,129,74,55,56,0.0,0.0
1015,1790,25-09-2019 23:18:00,0,4181.0,3894.0,0.931,20.784,364,183,152,31,181,143,38,119,0.0,0.0
1015,1791,25-09-2019 23:20:00,0,4206.0,3871.0,0.92,20.858,364,145,112,33,219,167,52,119,0.04,0.0
1015,1792,25-09-2019 23:22:00,0,3838.0,3775.0,0.984,19.3,307,162,121,41,145,78,67,84,0.03,0.02
1015,1793,25-09-2019 23:24:00,0,4163.0,4006.0,0.962,20.839,112,49,22,27,63,0,63,74,0.0,0.0
1015,1794,25-09-2019 23:26:00,0,4403.0,4127.0,0.937,21.917,136,53,36,17,83,38,45,57,0.0,0.05
1015,1795,25-09-2019 23:28:00,0,3669.0,3446.0,0.939,18.271,472,213,178,35,259,207,52,76,0.04,0.03
1015,1796,25-09-2019 23:30:00,0,4171.0,3991.0,0.957,20.852,294,166,127,39,128,92,36,56,0.01,0.0
1015,1797,25-09-2019 23:32:00,0,3969.0,3763.0,0.948,19.803,135,55,28,27,80,0,80,74,0.0,0.06
1015,1798,25-09-2019 23:34:00,0,4397.0,4068.0,0.925,21.827,391,145,117,28,246,174,72,82,0.07,0.08
1015,1799,25-09-2019 23:36:00,0,4180.0,3932.0,0.9415,20.823,327,180,149,31,147,114,33,153,0.0,0.0
1015,1800,25-09-2019 23:38:00,0,3963.0,3796.0,0.958,19.819,275,131,91,40,144,79,65,33,0.01,0.0
1015,1801,25-09-2019 23:40:00,0,3678.0,3378.0,0.918,18.23,322,146,113,33,176,127,49,65,0.0,0.0
1015,1802,25-09-2019 23:42:00,0,3857.0,3616.0,0.937,19.2,677,388,313,75,289,229,60,43,0.0,0.0
1015,1803,25-09-2019 23:44:00,0,4385.0,4174.0,0.952,21.899,472,202,168,34,270,222,48,164,0.08,0.01
1015,1804,25-09-2019 23:46:00,0,3843.0,3710.0,0.965,19.249,406,233,199,34,173,142,31,160,0.0,0.0
1015,1805,25-09-2019 23:48:00,0,3848.0,3715.0,0.965,19.274,161,62,39,23,99,63,36,33,0.0,0.0
1015,1806,25-09-2019 23:50:00,0,4405.0,4084.0,0.927,21.878,84,18,4,14,66,24,42,0,0.02,0.0
1015,1807,25-09-2019 23:52:00,0,4158.0,4005.0,0.963,20.817,208,145,97,48,63,40,23,30,0.0,0.0
1015,1808,25-09-2019 23:54:00,0,3892.0,3585.0,0.921,19.303,54,36,8,28,18,0,18,0,0.0,0.0
1015,1809,25-09-2019 23:56:00,0,3880.0,3587.0,0.925,19.258,23,13,6,7,10,0,10,0,0.0,0.0
1015,1810,25-09-2019 23:58:00,0,3860.0,3616.0,0.937,19.21,45,33,15,18,12,3,9,0,0.0,0.0
1015,1811,26-09-2019 00:00:00,0,3868.0,3632.0,0.939,19.259,726,521,433,88,205,153,52,1,0.0,0.0
1015,1812,26-09-2019 00:02:00,0,3949.0,3780.0,0.957,19.743,654,392,330,62,262,201,61,28,0.0,0.0
1015,1813,26-09-2019 00:04:00,0,3832.0,3741.0,0.976,19.239,587,259,201,58,328,238,90,108,0.0,0.0
1015,1814,26-09-2019 00:06:00,0,4099.0,3801.0,0.927,20.36,273,120,92,28,153,88,65,150,0.0,0.0
1015,1815,26-09-2019 00:08:00,0,3957.0,3745.0,0.947,19.735,279,142,107,35,137,95,42,8,0.05,0.0
1015,1816,26-09-2019 00:10:00,0,3915.5,3673.5,0.9385,19.494,933,562,464,98,371,288,83,4,0.0,0.0
1015,1817,26-09-2019 00:12:00,0,3874.0,3602.0,0.93,19.253,468,228,183,45,240,192,48,95,0.0,0.03
1015,1818,26-09-2019 00:14:00,0,3857.0,3728.0,0.966,19.324,369,253,203,50,116,86,30,41,0.01,0.0
1015,1819,26-09-2019 00:16:00,0,3831.0,3663.0,0.956,19.151,217,162,122,40,55,37,18,5,0.0,0.0
1015,1820,26-09-2019 00:18:00,0,3878.0,3660.0,0.944,19.331,37,22,8,14,15,3,12,0,0.0,0.0
1015,1821,26-09-2019 00:20:00,0,3889.0,3520.0,0.905,19.22,59,37,16,21,22,2,20,0,0.01,0.0
1015,1822,26-09-2019 00:22:00,0,3877.0,3598.0,0.928,19.259,25,18,2,16,7,1,6,0,0.0,0.0
1015,1823,26-09-2019 00:24:00,0,3884.0,3582.0,0.922,19.266,71,58,29,29,13,1,12,0,0.0,0.0
1015,1824,26-09-2019 00:26:00,0,3877.0,3628.0,0.936,19.293,39,30,18,12,9,5,4,0,0.0,0.0
1015,1825,26-09-2019 00:28:00,0,3669.0,3422.0,0.933,18.244,0,0,0,0,0,0,0,0,0.0,0.0
1015,1826,26-09-2019 00:30:00,0,3452.0,3212.0,0.931,17.156,12,11,7,4,1,1,0,0,0.0,0.0
1015,1827,26-09-2019 00:32:00,0,3374.0,3071.0,0.91,16.694,5,5,1,4,0,0,0,0,0.0,0.0
1015,1828,26-09-2019 00:34:00,0,3136.0,2943.0,0.939,15.615,10,10,5,5,0,0,0,0,0.0,0.0
1015,1829,26-09-2019 00:36:00,0,3152.0,2881.0,0.914,15.608,7,7,2,5,0,0,0,0,0.0,0.0
1015,1830,26-09-2019 00:38:00,0,3179.0,2847.0,0.896,15.676,32,24,14,10,8,5,3,0,0.0,0.0
1015,1831,26-09-2019 00:40:00,0,3134.0,2903.0,0.926,15.562,6,5,1,4,1,1,0,0,0.0,0.0
1015,1832,26-09-2019 00:42:00,0,3175.0,2821.0,0.888,15.631,32,32,0,32,0,0,0,0,0.0,0.0
1015,1833,26-09-2019 00:44:00,0,3170.5,2826.5,0.891,15.6195,2,2,0,2,0,0,0,0,0.0,0.0
1015,1834,26-09-2019 00:46:00,0,3166.0,2832.0,0.894,15.608,3,3,0,3,0,0,0,0,0.0,0.0
1015,1835,26-09-2019 00:48:00,0,3044.0,2797.0,0.919,15.091,1,0,0,0,1,0,1,0,0.0,0.0
1015,1836,26-09-2019 00:50:00,0,3062.0,2784.0,0.909,15.147,17,10,6,4,7,2,5,0,0.0,0.0
1015,1837,26-09-2019 00:52:00,0,3167.0,2830.0,0.894,15.613,0,0,0,0,0,0,0,0,0.0,0.0
1015,1838,26-09-2019 00:54:00,0,3047.0,2795.0,0.917,15.101,3,0,0,0,3,2,1,0,0.0,0.0
1015,1839,26-09-2019 00:56:00,0,2928.0,2765.0,0.944,14.596,5,1,1,0,4,2,2,0,0.0,0.0
1015,1840,26-09-2019 00:58:00,0,2805.0,2729.0,0.973,14.071,1,1,0,1,0,0,0,0,0.0,0.0
1015,1841,26-09-2019 01:00:00,0,2823.0,2641.0,0.935,14.048,0,0,0,0,0,0,0,0,0.01,0.0
1015,1842,26-09-2019 01:02:00,0,2830.0,2613.0,0.923,14.042,33,26,16,10,7,4,3,0,0.0,0.0
1015,1843,26-09-2019 01:04:00,0,2825.0,2641.0,0.935,14.056,0,0,0,0,0,0,0,0,0.0,0.0
1015,1844,26-09-2019 01:06:00,0,2815.0,2691.0,0.956,14.072,8,5,4,1,3,2,1,0,0.0,0.0
1015,1845,26-09-2019 01:08:00,0,2822.0,2672.0,0.947,14.077,6,6,1,5,0,0,0,0,0.0,0.0
1015,1846,26-09-2019 01:10:00,0,2813.0,2670.0,0.949,14.038,9,9,0,9,0,0,0,0,0.0,0.0
1015,1847,26-09-2019 01:12:00,0,2924.0,2748.0,0.94,14.563,6,6,3,3,0,0,0,0,0.0,0.0
1015,1848,26-09-2019 01:14:00,0,2814.0,2662.0,0.946,14.033,6,5,2,3,1,1,0,0,0.0,0.0
1015,1849,26-09-2019 01:16:00,0,2832.0,2625.0,0.927,14.066,45,22,11,11,23,8,15,0,0.0,0.0
1015,1850,26-09-2019 01:18:00,0,2971.5,2833.0,0.952,14.846,162,89,64,25,73,39,34,13,0.0,0.0
1015,1851,26-09-2019 01:20:00,0,3111.0,3041.0,0.977,15.626,336,210,172,38,126,81,45,82,0.0,0.0
1015,1852,26-09-2019 01:22:00,0,3366.0,3124.0,0.928,16.719,245,142,105,37,103,47,56,85,0.0,0.0
1015,1853,26-09-2019 01:24:00,0,3677.0,3324.0,0.904,18.168,107,25,17,8,82,1,81,66,0.0,0.05
1015,1854,26-09-2019 01:26:00,0,3657.0,3406.0,0.932,18.178,481,249,197,52,232,179,53,124,0.03,0.06
1015,1855,26-09-2019 01:28:00,0,3655.0,3451.0,0.944,18.222,257,100,82,18,157,126,31,68,0.03,0.0
1015,1856,26-09-2019 01:30:00,0,3691.0,3321.0,0.9,18.22,262,165,127,38,97,71,26,33,0.0,0.0
1015,1857,26-09-2019 01:32:00,0,3644.0,3536.0,0.97,18.27,257,142,122,20,115,96,19,106,0.0,0.0
1015,1858,26-09-2019 01:34:00,0,3848.0,3637.0,0.945,19.187,402,190,154,36,212,167,45,150,0.01,0.01
1015,1859,26-09-2019 01:36:00,0,3852.0,3729.0,0.968,19.307,199,108,88,20,91,32,59,58,0.0,0.31
1015,1860,26-09-2019 01:38:00,0,4207.0,3841.0,0.913,20.826,1,0,0,0,1,1,0,0,0.02,0.01
1015,1861,26-09-2019 01:40:00,0,3971.0,3798.0,0.956,19.852,103,44,33,11,59,42,17,13,0.04,0.0
1015,1862,26-09-2019 01:42:00,0,3848.0,3766.0,0.979,19.331,517,249,197,52,268,219,49,176,0.05,0.0
1015,1863,26-09-2019 01:44:00,0,4084.0,3825.0,0.937,20.326,358,176,139,37,182,139,43,91,0.03,0.01
1015,1864,26-09-2019 01:46:00,0,4348.0,4224.0,0.971,21.808,346,206,165,41,140,113,27,87,0.06,0.02
1015,1865,26-09-2019 01:48:00,0,4154.0,4041.0,0.973,20.84,226,116,96,20,110,84,26,129,0.02,0.0
1015,1866,26-09-2019 01:50:00,0,4388.0,4103.0,0.935,21.831,354,155,124,31,199,152,47,80,0.0,0.02
1015,1867,26-09-2019 01:52:00,0,4285.0,4017.0,0.9375,21.33,131,52,24,28,79,63,16,14,0.05,0.0
1015,1868,26-09-2019 01:54:00,0,4182.0,3931.0,0.94,20.829,104,61,37,24,43,29,14,1,0.0,0.0
1015,1869,26-09-2019 01:56:00,0,4271.0,4096.0,0.959,21.362,361,194,156,38,167,135,32,152,0.0,0.0
1015,1870,26-09-2019 01:58:00,0,4163.0,3996.0,0.96,20.827,336,174,142,32,162,126,36,112,0.08,0.0
1015,1871,26-09-2019 02:00:00,0,4403.0,4133.0,0.939,21.924,385,177,133,44,208,164,44,103,0.0,0.01
1015,1872,26-09-2019 02:02:00,0,4088.0,3821.0,0.935,20.335,198,111,86,25,87,63,24,129,0.0,0.0
1015,1873,26-09-2019 02:04:00,0,4388.0,4144.0,0.944,21.877,361,184,140,44,177,132,45,58,0.0,0.0
1015,1874,26-09-2019 02:06:00,0,4172.0,3881.0,0.93,20.733,454,241,189,52,213,160,53,92,0.01,0.0
1015,1875,26-09-2019 02:08:00,0,4194.0,3875.0,0.924,20.813,605,325,272,53,280,224,56,180,0.03,0.0
1015,1876,26-09-2019 02:10:00,0,4284.0,4037.0,0.942,21.347,858,508,420,88,350,279,71,3,0.01,0.0
1015,1877,26-09-2019 02:12:00,0,4499.0,4274.0,0.95,22.459,470,256,202,54,214,165,49,98,0.0,0.0
1015,1878,26-09-2019 02:14:00,0,4159.0,3988.0,0.959,20.8,403,216,166,50,187,140,47,70,0.0,0.0
1015,1879,26-09-2019 02:16:00,0,4405.0,4066.0,0.923,21.857,247,136,109,27,111,89,22,165,0.0,0.0
1015,1880,26-09-2019 02:18:00,0,4195.0,3854.0,0.919,20.793,325,139,108,31,186,149,37,123,0.0,0.0
1015,1881,26-09-2019 02:20:00,0,4270.0,4026.0,0.943,21.28,150,89,61,28,61,36,25,13,0.0,0.0
1015,1882,26-09-2019 02:22:00,0,4183.0,3909.0,0.934,20.81,40,36,8,28,4,1,3,0,0.0,0.0
1015,1883,26-09-2019 02:24:00,0,4185.0,3844.0,0.918,20.746,56,54,23,31,2,1,1,0,0.0,0.0
1015,1884,26-09-2019 02:26:00,0,4195.0,3850.0,0.9175,20.7905,55,47,18,29,8,2,6,0,0.0,0.0
1015,1885,26-09-2019 02:28:00,0,4205.0,3856.0,0.917,20.835,343,266,206,60,77,53,24,2,0.0,0.0
1015,1886,26-09-2019 02:30:00,0,3866.0,3637.0,0.941,19.26,80,43,32,11,37,9,28,5,0.0,0.0
1015,1887,26-09-2019 02:32:00,0,3901.0,3594.0,0.921,19.347,3,1,0,1,2,0,2,0,0.0,0.0
1015,1888,26-09-2019 02:34:00,0,3673.0,3374.0,0.919,18.206,1,0,0,0,1,1,0,0,0.01,0.0
1015,1889,26-09-2019 02:36:00,0,3589.0,3229.0,0.9,17.717,2,0,0,0,2,2,0,0,0.0,0.0
1015,1890,26-09-2019 02:38:00,0,3374.0,3078.0,0.912,16.702,1,1,1,0,0,0,0,0,0.0,0.0
1015,1891,26-09-2019 02:40:00,0,3161.0,2874.0,0.909,15.637,11,8,0,8,3,1,2,0,0.0,0.0
1015,1892,26-09-2019 02:42:00,0,3179.0,2782.0,0.875,15.605,5,5,0,5,0,0,0,0,0.0,0.0
1015,1893,26-09-2019 02:44:00,0,3057.0,2738.0,0.895,15.075,5,4,0,4,1,0,1,0,0.0,0.0
1015,1894,26-09-2019 02:46:00,0,3175.0,2748.0,0.866,15.551,2,0,0,0,2,1,1,0,0.0,0.0
1015,1895,26-09-2019 02:48:00,0,3193.0,2759.0,0.864,15.634,6,5,0,5,1,0,1,0,0.0,0.0
1015,1896,26-09-2019 02:50:00,0,2945.0,2713.0,0.921,14.606,0,0,0,0,0,0,0,0,0.0,0.0
1015,1897,26-09-2019 02:52:00,0,2814.0,2673.0,0.95,14.048,8,4,0,4,4,0,4,0,0.0,0.0
1015,1898,26-09-2019 02:54:00,0,2824.0,2623.0,0.929,14.03,4,3,1,2,1,0,1,0,0.0,0.0
1015,1899,26-09-2019 02:56:00,0,2856.0,2535.0,0.888,14.059,14,12,4,8,2,2,0,0,0.0,0.0
1015,1900,26-09-2019 02:58:00,0,2858.0,2497.0,0.874,14.025,0,0,0,0,0,0,0,0,0.01,0.0
1015,1901,26-09-2019 03:00:00,0,2863.0,2500.0,0.8735,14.0485,29,19,9,10,10,7,3,0,0.0,0.0
1015,1902,26-09-2019 03:02:00,0,2868.0,2503.0,0.873,14.072,9,7,2,5,2,1,1,0,0.0,0.0
1015,1903,26-09-2019 03:04:00,0,2852.0,2556.0,0.896,14.067,0,0,0,0,0,0,0,0,0.0,0.0
1015,1904,26-09-2019 03:06:00,0,2820.0,2600.0,0.922,13.989,4,4,0,4,0,0,0,0,0.0,0.0
1015,1905,26-09-2019 03:08:00,0,2735.0,2497.0,0.913,13.54,18,7,1,6,11,4,7,0,0.0,0.0
1015,1906,26-09-2019 03:10:00,0,2650.0,2365.0,0.893,13.061,10,3,0,3,7,2,5,0,0.0,0.0
1015,1907,26-09-2019 03:12:00,0,2539.0,2256.0,0.889,12.5,5,2,0,2,3,1,2,0,0.0,0.0
1015,1908,26-09-2019 03:14:00,0,2401.0,2199.0,0.916,11.895,2,0,0,0,2,1,1,0,0.0,0.0
1015,1909,26-09-2019 03:16:00,0,2542.0,2249.0,0.885,12.505,19,14,7,7,5,2,3,0,0.0,0.0
1015,1910,26-09-2019 03:18:00,0,2741.0,2480.0,0.905,13.546,2,2,0,2,0,0,0,0,0.0,0.0
1015,1911,26-09-2019 03:20:00,0,2869.0,2518.0,0.878,14.092,12,10,1,9,2,0,2,0,0.0,0.0
1015,1912,26-09-2019 03:22:00,0,2621.0,2461.0,0.939,13.051,163,117,89,28,46,30,16,0,0.0,0.0
1015,1913,26-09-2019 03:24:00,0,2620.0,2379.0,0.908,12.957,113,78,45,33,35,14,21,2,0.0,0.0
1015,1914,26-09-2019 03:26:00,0,2837.0,2626.0,0.925,14.085,69,54,25,29,15,6,9,0,0.0,0.0
1015,1915,26-09-2019 03:28:00,0,3138.0,2963.0,0.944,15.642,44,26,7,19,18,2,16,0,0.0,0.0
1015,1916,26-09-2019 03:30:00,0,3349.0,3107.0,0.928,16.634,384,209,182,27,175,139,36,49,0.0,0.0
1015,1917,26-09-2019 03:32:00,0,3327.0,3213.0,0.966,16.667,399,186,153,33,213,163,50,137,0.0,0.0
1015,1918,26-09-2019 03:34:00,0,3506.5,3283.5,0.938,17.4515,189,86,61,25,103,54,49,52,0.0,0.21
1015,1919,26-09-2019 03:36:00,0,3686.0,3354.0,0.91,18.236,3,2,1,1,1,0,1,0,0.0,0.0
1015,1920,26-09-2019 03:38:00,0,3366.0,3059.0,0.909,16.649,6,2,0,2,4,0,4,0,0.0,0.0
1015,1921,26-09-2019 03:40:00,0,3332.0,3149.0,0.945,16.615,316,156,119,37,160,125,35,60,0.02,0.01
1015,1922,26-09-2019 03:42:00,0,3895.0,3556.0,0.913,19.282,387,176,145,31,211,166,45,191,0.05,0.0
1015,1923,26-09-2019 03:44:00,0,3869.0,3645.0,0.942,19.278,329,180,142,38,149,117,32,89,0.01,0.09
1015,1924,26-09-2019 03:46:00,0,3984.0,3709.0,0.931,19.804,435,158,126,32,277,217,60,71,0.07,0.0
1015,1925,26-09-2019 03:48:00,0,4830.0,4461.0,0.924,23.969,440,248,214,34,192,154,38,91,0.02,0.0
1015,1926,26-09-2019 03:50:00,0,3660.0,3354.0,0.916,18.133,347,180,132,48,167,135,32,86,0.0,0.0
1015,1927,26-09-2019 03:52:00,0,3865.0,3712.0,0.96,19.336,459,216,174,42,243,199,44,97,0.0,0.0
1015,1928,26-09-2019 03:54:00,0,4095.0,3818.0,0.933,20.36,353,196,153,43,157,124,33,97,0.0,0.0
1015,1929,26-09-2019 03:56:00,0,3894.0,3490.0,0.896,19.205,380,172,137,35,208,142,66,131,0.0,0.0
1015,1930,26-09-2019 03:58:00,0,3976.0,3770.0,0.948,19.838,187,78,45,33,109,64,45,35,0.06,0.0
1015,1931,26-09-2019 04:00:00,0,3777.0,3508.0,0.929,18.765,181,114,87,27,67,34,33,50,0.01,0.0
1015,1932,26-09-2019 04:02:00,0,3855.0,3679.0,0.954,19.26,111,41,21,20,70,2,68,71,0.0,0.0
1015,1933,26-09-2019 04:04:00,0,4203.0,3836.0,0.913,20.809,279,132,94,38,147,105,42,88,0.04,0.0
1015,1934,26-09-2019 04:06:00,0,3905.0,3514.0,0.9,19.278,309,196,144,52,113,78,35,73,0.0,0.0
1015,1935,26-09-2019 04:08:00,0,3901.5,3541.5,0.908,19.293,324,204,164,40,120,84,36,4,0.0,0.0
1015,1936,26-09-2019 04:10:00,0,3898.0,3569.0,0.916,19.308,414,216,175,41,198,148,50,36,0.0,0.0
1015,1937,26-09-2019 04:12:00,0,3844.0,3667.0,0.954,19.207,100,68,41,27,32,18,14,15,0.0,0.0
1015,1938,26-09-2019 04:14:00,0,3667.0,3410.0,0.93,18.224,68,49,27,22,19,6,13,0,0.0,0.0
1015,1939,26-09-2019 04:16:00,0,3891.0,3559.0,0.915,19.271,31,15,1,14,16,6,10,0,0.0,0.0
1015,1940,26-09-2019 04:18:00,0,3787.0,3433.0,0.907,18.719,13,9,0,9,4,3,1,0,0.0,0.0
1015,1941,26-09-2019 04:20:00,0,3375.0,3039.0,0.9,16.663,0,0,0,0,0,0,0,0,0.0,0.0
1015,1942,26-09-2019 04:22:00,0,3158.0,2864.0,0.907,15.615,12,6,0,6,6,2,4,0,0.0,0.0
1015,1943,26-09-2019 04:24:00,0,3170.0,2809.0,0.886,15.602,8,0,0,0,8,2,6,0,0.01,0.0
1015,1944,26-09-2019 04:26:00,0,3178.0,2781.0,0.875,15.6,7,0,0,0,7,2,5,0,0.0,0.0
1015,1945,26-09-2019 04:28:00,0,3183.0,2767.0,0.869,15.604,3,0,0,0,3,0,3,0,0.02,0.01
1015,1946,26-09-2019 04:30:00,0,3180.0,2824.0,0.888,15.657,492,354,276,78,138,89,49,1,0.0,0.0
1015,1947,26-09-2019 04:32:00,0,3133.0,2983.0,0.952,15.648,236,147,107,40,89,64,25,17,0.0,0.0
1015,1948,26-09-2019 04:34:00,0,3362.0,3027.0,0.9,16.598,115,81,61,20,34,23,11,39,0.0,0.0
1015,1949,26-09-2019 04:36:00,0,3365.0,3109.0,0.924,16.701,216,139,101,38,77,60,17,41,0.0,0.0
1015,1950,26-09-2019 04:38:00,0,3676.0,3336.0,0.907,18.177,275,168,136,32,107,80,27,26,0.0,0.0
1015,1951,26-09-2019 04:40:00,0,3372.0,3062.0,0.908,16.677,430,205,168,37,225,162,63,73,0.0,0.0
1015,1952,26-09-2019 04:42:00,0,3354.5,3105.5,0.926,16.656,145,78,53,25,67,35,32,133,0.0,0.0
1015,1953,26-09-2019 04:44:00,0,3337.0,3149.0,0.944,16.635,129,88,61,27,41,26,15,41,0.03,0.0
1015,1954,26-09-2019 04:46:00,0,3587.0,3241.0,0.903,17.722,103,58,23,35,45,11,34,0,0.0,0.0
1015,1955,26-09-2019 04:48:00,0,3684.0,3303.0,0.896,18.174,81,60,35,25,21,5,16,0,0.0,0.0
1015,1956,26-09-2019 04:50:00,0,3709.0,3279.0,0.884,18.242,10,6,1,5,4,0,4,0,0.0,0.0
1015,1957,26-09-2019 04:52:00,0,3366.0,3014.0,0.895,16.601,7,5,2,3,2,0,2,0,0.0,0.0
1015,1958,26-09-2019 04:54:00,0,3156.0,2882.0,0.913,15.625,5,1,0,1,4,0,4,0,0.0,0.02
1015,1959,26-09-2019 04:56:00,0,3177.0,2765.0,0.87,15.58,2,0,0,0,2,0,2,0,0.0,0.0
1015,1960,26-09-2019 04:58:00,0,3066.0,2674.0,0.872,15.042,8,3,0,3,5,0,5,0,0.0,0.0
1015,1961,26-09-2019 05:00:00,0,2842.0,2586.0,0.91,14.062,5,1,0,1,4,0,4,0,0.0,0.0
1015,1962,26-09-2019 05:02:00,0,2819.0,2648.0,0.939,14.038,5,2,0,2,3,0,3,0,0.0,0.0
1015,1963,26-09-2019 05:04:00,0,2966.0,2653.0,0.895,14.622,7,4,0,4,3,0,3,0,0.0,0.0
1015,1964,26-09-2019 05:06:00,0,2835.0,2588.0,0.913,14.033,12,10,1,9,2,1,1,0,0.0,0.0
1015,1965,26-09-2019 05:08:00,0,2865.0,2498.0,0.872,14.051,8,4,2,2,4,1,3,0,0.0,0.0
1015,1966,26-09-2019 05:10:00,0,2873.0,2395.0,0.834,13.969,11,10,0,10,1,0,1,0,0.0,0.0
1015,1967,26-09-2019 05:12:00,0,2636.0,2359.0,0.895,12.999,16,11,2,9,5,0,5,0,0.0,0.0
1015,1968,26-09-2019 05:14:00,0,2884.0,2465.0,0.855,14.092,17,14,4,10,3,0,3,0,0.0,0.0
1015,1969,26-09-2019 05:16:00,0,2886.0,2446.0,0.848,14.0785,6,5,1,4,1,0,1,0,0.0,0.0
1015,1970,26-09-2019 05:18:00,0,2888.0,2427.0,0.841,14.065,73,54,35,19,19,12,7,4,0.0,0.0
1015,1971,26-09-2019 05:20:00,0,2966.0,2636.0,0.889,14.603,315,141,113,28,174,110,64,38,0.0,0.0
1015,1972,26-09-2019 05:22:00,0,3167.0,2852.0,0.9,15.637,251,125,93,32,126,90,36,62,0.0,0.05
1015,1973,26-09-2019 05:24:00,0,3268.0,2933.0,0.898,16.123,344,193,162,31,151,114,37,91,0.0,0.0
1015,1974,26-09-2019 05:26:00,0,3388.0,2965.0,0.875,16.631,269,123,99,24,146,110,36,118,0.0,0.0
1015,1975,26-09-2019 05:28:00,0,3468.0,3090.0,0.891,17.084,357,172,138,34,185,148,37,75,0.0,0.04
1015,1976,26-09-2019 05:30:00,0,3480.0,3097.0,0.89,17.141,531,193,154,39,338,262,76,14,0.0,0.0
1015,1977,26-09-2019 05:32:00,0,3715.0,3233.0,0.87,18.216,242,124,99,25,118,93,25,150,0.0,0.0
1015,1978,26-09-2019 05:34:00,0,3713.0,3268.0,0.88,18.25,568,300,247,53,268,206,62,42,0.0,0.0
1015,1979,26-09-2019 05:36:00,0,3710.0,3266.0,0.88,18.233,433,191,155,36,242,197,45,119,0.0,0.0
1015,1980,26-09-2019 05:38:00,0,3694.0,3296.0,0.892,18.202,334,129,109,20,205,153,52,99,0.0,0.0
1015,1981,26-09-2019 05:40:00,0,3695.0,3271.0,0.885,18.18,403,196,159,37,207,154,53,82,0.05,0.0
1015,1982,26-09-2019 05:42:00,0,3696.0,3306.0,0.894,18.222,343,157,124,33,186,137,49,61,0.0,0.0
1015,1983,26-09-2019 05:44:00,0,3914.0,3514.0,0.898,19.31,289,158,127,31,131,105,26,44,0.0,0.0
1015,1984,26-09-2019 05:46:00,0,3690.0,3245.0,0.879,18.133,554,351,290,61,203,155,48,22,0.0,0.0
1015,1985,26-09-2019 05:48:00,0,3700.0,3267.0,0.883,18.195,594,378,328,50,216,164,52,71,0.0,0.06
1015,1986,26-09-2019 05:50:00,0,3712.5,3256.5,0.877,18.2325,862,482,411,71,380,301,79,44,0.0,0.0
1015,1987,26-09-2019 05:52:00,0,3725.0,3246.0,0.871,18.27,266,139,111,28,127,105,22,120,0.0,0.0
1015,1988,26-09-2019 05:54:00,0,3699.0,3277.0,0.886,18.201,233,120,97,23,113,71,42,135,0.0,0.0
1015,1989,26-09-2019 05:56:00,0,3824.0,3260.0,0.852,18.674,105,21,12,9,84,8,76,61,0.0,0.0
1015,1990,26-09-2019 05:58:00,0,3904.0,3447.0,0.883,19.199,257,111,84,27,146,75,71,62,0.0,0.0
1015,1991,26-09-2019 06:00:00,1,3736.0,3123.0,0.836,18.179,407,235,187,48,172,122,50,41,0.02,0.0
1015,1992,26-09-2019 06:02:00,1,3823.0,3299.0,0.863,18.718,416,251,209,42,165,123,42,143,0.0,0.0
1015,1993,26-09-2019 06:04:00,1,3734.0,3112.0,0.834,18.157,166,88,70,18,78,56,22,50,0.06,0.0
1015,1994,26-09-2019 06:06:00,1,3703.0,3247.0,0.877,18.184,49,23,15,8,26,4,22,0,0.0,0.0
1015,1995,26-09-2019 06:08:00,1,3708.0,3229.0,0.871,18.184,65,34,18,16,31,4,27,0,0.0,0.0
1015,1996,26-09-2019 06:10:00,1,3722.0,3173.0,0.853,18.18,315,172,142,30,143,114,29,15,0.0,0.0
1015,1997,26-09-2019 06:12:00,1,3626.0,3099.0,0.855,17.717,295,108,85,23,187,139,48,26,0.0,0.0
1015,1998,26-09-2019 06:14:00,1,3718.0,3116.0,0.838,18.099,556,324,261,63,232,177,55,13,0.0,0.0
1015,1999,26-09-2019 06:16:00,1,3733.0,3116.0,0.835,18.157,245,136,110,26,109,82,27,5,0.0,0.0
1015,2000,26-09-2019 06:18:00,1,3500.0,3033.0,0.866,17.148,13,2,1,1,11,2,9,0,0.02,0.0
1015,2001,26-09-2019 06:20:00,1,3419.0,2917.0,0.853,16.7,7,2,2,0,5,2,3,0,0.0,0.0
1015,2002,26-09-2019 06:22:00,1,3411.0,2917.0,0.855,16.667,6,1,1,0,5,1,4,0,0.0,0.0
1015,2003,26-09-2019 06:24:00,1,3311.0,2785.5,0.841,16.1285,3,0,0,0,3,0,3,0,0.0,0.0
1015,2004,26-09-2019 06:26:00,1,3211.0,2654.0,0.827,15.59,2,0,0,0,2,0,2,0,0.0,0.0
1015,2005,26-09-2019 06:28:00,1,2854.0,2545.0,0.892,14.062,2,0,0,0,2,0,2,0,0.0,0.0
1015,2006,26-09-2019 06:30:00,1,2894.0,2411.0,0.833,14.072,1,1,1,0,0,0,0,0,0.0,0.0
1015,2007,26-09-2019 06:32:00,1,2645.0,2306.0,0.872,12.976,6,1,1,0,5,0,5,0,0.0,0.0
1015,2008,26-09-2019 06:34:00,1,2665.0,2240.0,0.841,12.979,2,0,0,0,2,0,2,0,0.0,0.0
1015,2009,26-09-2019 06:36:00,1,2677.0,2233.0,0.834,13.018,2,1,0,1,1,0,1,0,0.0,0.0
1015,2010,26-09-2019 06:38:00,1,2671.0,2217.0,0.83,12.977,6,1,0,1,5,0,5,0,0.0,0.0
1015,2011,26-09-2019 06:40:00,1,2683.0,2210.0,0.824,13.017,1,1,0,1,0,0,0,0,0.0,0.0
1015,2012,26-09-2019 06:42:00,1,2691.0,2165.0,0.805,13.002,5,0,0,0,5,0,5,0,0.0,0.0
1015,2013,26-09-2019 06:44:00,1,2704.0,2120.0,0.784,12.999,6,2,0,2,4,0,4,0,0.0,0.0
1015,2014,26-09-2019 06:46:00,1,2573.0,2095.0,0.814,12.458,3,2,1,1,1,1,0,0,0.0,0.0
1015,2015,26-09-2019 06:48:00,1,2338.0,2031.0,0.869,11.459,4,2,1,1,2,1,1,0,0.0,0.0
1015,2016,26-09-2019 06:50:00,1,2353.0,1974.0,0.839,11.456,5,1,0,1,4,0,4,0,0.0,0.0
1015,2017,26-09-2019 06:52:00,1,2342.0,1965.0,0.839,11.403,1,0,0,0,1,0,1,0,0.0,0.0
1015,2018,26-09-2019 06:54:00,1,2351.0,1946.0,0.828,11.416,2,0,0,0,2,0,2,0,0.0,0.0
1015,2019,26-09-2019 06:56:00,1,2354.0,1981.0,0.842,11.468,2,0,0,0,2,0,2,0,0.0,0.0
1015,2020,26-09-2019 06:58:00,1,2354.5,1958.5,0.832,11.4455,3,0,0,0,3,0,3,0,0.0,0.0
1015,2021,26-09-2019 07:00:00,1,2355.0,1936.0,0.822,11.423,15,11,6,5,4,2,2,0,0.0,0.0
1015,2022,26-09-2019 07:02:00,1,2329.0,2003.0,0.86,11.393,8,2,1,1,6,3,3,0,0.0,0.0
1015,2023,26-09-2019 07:04:00,1,2468.0,2035.0,0.824,11.976,0,0,0,0,0,0,0,0,0.0,0.0
1015,2024,26-09-2019 07:06:00,1,2352.0,1997.0,0.849,11.477,3,1,1,0,2,0,2,0,0.0,0.0
1015,2025,26-09-2019 07:08:00,1,2355.0,1946.0,0.826,11.433,5,1,0,1,4,0,4,0,0.0,0.0
1015,2026,26-09-2019 07:10:00,1,2352.0,1921.0,0.816,11.395,1,0,0,0,1,0,1,0,0.0,0.0
1015,2027,26-09-2019 07:12:00,1,2354.0,1959.0,0.832,11.445,1,0,0,0,1,0,1,0,0.0,0.0
1015,2028,26-09-2019 07:14:00,1,2352.0,1951.0,0.83,11.429,1,0,0,0,1,0,1,0,0.0,0.0
1015,2029,26-09-2019 07:16:00,1,2359.0,1941.0,0.823,11.445,11,6,3,3,5,2,3,0,0.0,0.0
1015,2030,26-09-2019 07:18:00,1,2358.0,1956.0,0.83,11.456,3,0,0,0,3,0,3,0,0.0,0.0
1015,2031,26-09-2019 07:20:00,1,2369.0,1912.0,0.807,11.45,1,0,0,0,1,0,1,0,0.0,0.0
1015,2032,26-09-2019 07:22:00,1,2367.0,1895.0,0.801,11.424,21,18,0,18,3,0,3,0,0.0,0.0
1015,2033,26-09-2019 07:24:00,1,2365.0,1930.0,0.816,11.457,19,17,0,17,2,0,2,0,0.0,0.0
1015,2034,26-09-2019 07:26:00,1,2490.0,1935.0,0.777,11.952,13,10,3,7,3,2,1,0,0.0,0.0
1015,2035,26-09-2019 07:28:00,1,2728.0,2011.0,0.737,12.976,0,0,0,0,0,0,0,0,0.0,0.0
1015,2036,26-09-2019 07:30:00,1,2728.0,2024.0,0.742,12.988,2,1,0,1,1,0,1,0,0.0,0.0
1015,2037,26-09-2019 07:32:00,1,2725.5,2059.0,0.7555,13.0175,0,0,0,0,0,0,0,0,0.0,0.0
1015,2038,26-09-2019 07:34:00,1,2723.0,2094.0,0.769,13.047,17,10,4,6,7,2,5,0,0.01,0.0
1015,2039,26-09-2019 07:36:00,1,2729.0,2031.0,0.744,12.999,6,6,1,5,0,0,0,0,0.0,0.0
1015,2040,26-09-2019 07:38:00,1,2728.0,2027.0,0.743,12.992,8,7,0,7,1,0,1,0,0.0,0.0
1015,2041,26-09-2019 07:40:00,1,2605.0,1983.0,0.761,12.46,0,0,0,0,0,0,0,0,0.0,0.0
1015,2042,26-09-2019 07:42:00,1,2154.0,1750.0,0.812,10.423,100,89,63,26,11,5,6,0,0.0,0.0
1015,2043,26-09-2019 07:44:00,1,2716.0,2051.0,0.755,12.972,23,23,4,19,0,0,0,0,0.0,0.0
1015,2044,26-09-2019 07:46:00,1,2951.0,2173.0,0.736,14.035,6,5,0,5,1,1,0,0,0.0,0.0
1015,2045,26-09-2019 07:48:00,1,2835.0,2146.0,0.757,13.546,105,80,37,43,25,4,21,0,0.0,0.0
1015,2046,26-09-2019 07:50:00,1,3023.0,2377.0,0.786,14.543,55,51,26,25,4,1,3,0,0.0,0.0
1015,2047,26-09-2019 07:52:00,1,3154.0,2426.0,0.769,15.113,90,63,41,22,27,18,9,1,0.0,0.0
1015,2048,26-09-2019 07:54:00,1,3436.0,2764.0,0.804,16.6,400,205,172,33,195,153,42,105,0.0,0.0
1015,2049,26-09-2019 07:56:00,1,3798.0,2939.0,0.774,18.221,119,66,54,12,53,42,11,72,0.0,0.0
1015,2050,26-09-2019 07:58:00,1,3744.0,3049.0,0.814,18.128,349,188,151,37,161,125,36,78,0.0,0.0
1015,2051,26-09-2019 08:00:00,1,3679.0,2917.0,0.793,17.726,253,124,104,20,129,96,33,94,0.0,0.0
1015,2052,26-09-2019 08:02:00,1,3553.0,2844.0,0.801,17.148,75,16,7,9,59,2,57,52,0.0,0.0
1015,2053,26-09-2019 08:04:00,1,3989.0,3107.0,0.779,19.157,81,12,7,5,69,0,69,71,0.0,0.0
1015,2054,26-09-2019 08:06:00,1,3880.5,3049.0,0.786,18.666,286,125,98,27,161,97,64,72,0.07,0.11
1015,2055,26-09-2019 08:08:00,1,3772.0,2991.0,0.793,18.175,455,207,166,41,248,192,56,106,0.03,0.02
1015,2056,26-09-2019 08:10:00,1,3664.0,2941.0,0.803,17.694,557,295,235,60,262,214,48,85,0.0,0.04
1015,2057,26-09-2019 08:12:00,1,3748.0,3070.0,0.819,18.168,508,260,201,59,248,199,49,81,0.01,0.0
1015,2058,26-09-2019 08:14:00,1,3743.0,3063.0,0.818,18.14,288,185,142,43,103,66,37,0,0.01,0.0
1015,2059,26-09-2019 08:16:00,1,3784.0,2999.0,0.793,18.23,779,462,385,77,317,241,76,4,0.0,0.0
1015,2060,26-09-2019 08:18:00,1,3748.0,3109.0,0.83,18.209,252,117,90,27,135,90,45,18,0.0,0.0
1015,2061,26-09-2019 08:20:00,1,3519.0,2927.0,0.832,17.107,74,52,23,29,22,4,18,0,0.0,0.0
1015,2062,26-09-2019 08:22:00,1,3423.0,2892.0,0.845,16.687,17,12,4,8,5,2,3,0,0.0,0.0
1015,2063,26-09-2019 08:24:00,1,3400.0,2925.0,0.86,16.634,4,2,1,1,2,2,0,0,0.0,0.0
1015,2064,26-09-2019 08:26:00,1,3317.0,2752.0,0.83,16.117,40,15,4,11,25,4,21,0,0.0,0.0
1015,2065,26-09-2019 08:28:00,1,3177.0,2728.0,0.859,15.536,4,2,1,1,2,1,1,0,0.0,0.0
1015,2066,26-09-2019 08:30:00,1,3229.0,2594.0,0.803,15.596,3,0,0,0,3,0,3,0,0.0,0.0
1015,2067,26-09-2019 08:32:00,1,2875.0,2457.0,0.855,14.047,2,0,0,0,2,0,2,0,0.0,0.0
1015,2068,26-09-2019 08:34:00,1,2785.0,2290.0,0.822,13.51,3,0,0,0,3,0,3,0,0.0,0.0
1015,2069,26-09-2019 08:36:00,1,2675.0,2205.0,0.824,12.979,3,0,0,0,3,0,3,0,0.0,0.0
1015,2070,26-09-2019 08:38:00,1,2690.0,2153.0,0.8,12.984,3,0,0,0,3,0,3,0,0.0,0.0
1015,2071,26-09-2019 08:40:00,1,2693.5,2122.0,0.7875,12.9625,2,0,0,0,2,0,2,0,0.0,0.0
1015,2072,26-09-2019 08:42:00,1,2697.0,2091.0,0.775,12.941,1,0,0,0,1,0,1,0,0.0,0.0
1015,2073,26-09-2019 08:44:00,1,2577.0,2057.0,0.798,12.432,13,9,3,6,4,3,1,0,0.0,0.0
1015,2074,26-09-2019 08:46:00,1,2695.0,2132.0,0.791,12.978,24,15,9,6,9,8,1,0,0.0,0.0
1015,2075,26-09-2019 08:48:00,1,2676.0,2231.0,0.834,13.016,19,19,1,18,0,0,0,0,0.0,0.0
1015,2076,26-09-2019 08:50:00,1,2665.0,2259.0,0.848,13.003,2,1,0,1,1,1,0,0,0.0,0.0
1015,2077,26-09-2019 08:52:00,1,2795.0,2244.0,0.803,13.497,2,0,0,0,2,0,2,0,0.0,0.0
1015,2078,26-09-2019 08:54:00,1,2914.0,2249.0,0.772,13.97,17,10,5,5,7,4,3,0,0.0,0.0
1015,2079,26-09-2019 08:56:00,1,2923.0,2260.0,0.773,14.019,0,0,0,0,0,0,0,0,0.0,0.0
1015,2080,26-09-2019 08:58:00,1,2930.0,2246.0,0.767,14.032,2,0,0,0,2,1,1,0,0.0,0.0
1015,2081,26-09-2019 09:00:00,1,2943.0,2219.0,0.754,14.053,10,2,0,2,8,2,6,0,0.0,0.0
1015,2082,26-09-2019 09:02:00,1,2950.0,2226.0,0.755,14.088,7,0,0,0,7,4,3,0,0.0,0.0
1015,2083,26-09-2019 09:04:00,1,2813.0,2177.0,0.774,13.492,7,4,2,2,3,1,2,0,0.01,0.0
1015,2084,26-09-2019 09:06:00,1,2702.0,2095.0,0.775,12.967,2,1,0,1,1,1,0,0,0.0,0.0
1015,2085,26-09-2019 09:08:00,1,2724.0,2027.0,0.744,12.979,5,3,2,1,2,0,2,0,0.0,0.0
1015,2086,26-09-2019 09:10:00,1,2483.0,1943.0,0.783,11.936,5,2,1,1,3,0,3,0,0.0,0.0
1015,2087,26-09-2019 09:12:00,1,2166.0,1684.0,0.777,10.398,18,10,5,5,8,2,6,0,0.0,0.0
1015,2088,26-09-2019 09:14:00,1,2269.0,1794.5,0.79,10.926,6,5,2,3,1,0,1,0,0.0,0.0
1015,2089,26-09-2019 09:16:00,1,2372.0,1905.0,0.803,11.454,22,13,6,7,9,2,7,0,0.0,0.0
1015,2090,26-09-2019 09:18:00,1,2733.0,2022.0,0.74,13.008,46,26,4,22,20,4,16,0,0.0,0.0
1015,2091,26-09-2019 09:20:00,1,2676.0,2167.0,0.81,12.943,78,61,30,31,17,6,11,0,0.0,0.0
1015,2092,26-09-2019 09:22:00,1,2908.0,2329.0,0.801,14.038,176,106,76,30,70,57,13,56,0.0,0.0
1015,2093,26-09-2019 09:24:00,1,3238.0,2567.0,0.793,15.601,278,152,123,29,126,85,41,72,0.0,0.0
1015,2094,26-09-2019 09:26:00,1,3223.0,2628.0,0.815,15.607,240,110,94,16,130,110,20,88,0.0,0.0
1015,2095,26-09-2019 09:28:00,1,3227.0,2580.0,0.8,15.57,38,24,8,16,14,6,8,0,0.0,0.0
1015,2096,26-09-2019 09:30:00,1,3245.0,2494.0,0.769,15.545,44,29,15,14,15,2,13,0,0.0,0.0
1015,2097,26-09-2019 09:32:00,1,2895.0,2405.0,0.831,14.067,13,12,0,12,1,1,0,0,0.0,0.0
1015,2098,26-09-2019 09:34:00,1,2810.0,2216.0,0.789,13.524,1,0,0,0,1,0,1,0,0.0,0.0
1015,2099,26-09-2019 09:36:00,1,2716.0,2058.0,0.758,12.979,2,1,0,1,1,0,1,0,0.0,0.0
1015,2100,26-09-2019 09:38:00,1,2373.0,1928.0,0.813,11.483,3,3,0,3,0,0,0,0,0.0,0.0
1015,2101,26-09-2019 09:40:00,1,2390.0,1836.0,0.768,11.451,9,2,0,2,7,3,4,0,0.0,0.0
1015,2102,26-09-2019 09:42:00,1,2396.0,1814.0,0.757,11.45,6,5,0,5,1,1,0,0,0.0,0.0
1015,2103,26-09-2019 09:44:00,1,2386.0,1841.0,0.772,11.439,16,14,3,11,2,2,0,0,0.0,0.0
1015,2104,26-09-2019 09:46:00,1,2606.0,1953.0,0.749,12.431,1,0,0,0,1,0,1,0,0.0,0.0
1015,2105,26-09-2019 09:48:00,1,2658.0,2024.5,0.761,12.7155,0,0,0,0,0,0,0,0,0.0,0.0
1015,2106,26-09-2019 09:50:00,1,2710.0,2096.0,0.773,13.0,0,0,0,0,0,0,0,0,0.0,0.0
1015,2107,26-09-2019 09:52:00,1,2715.0,2097.0,0.772,13.019,17,10,6,4,7,2,5,0,0.0,0.0
1015,2108,26-09-2019 09:54:00,1,2719.0,2032.0,0.747,12.962,1,0,0,0,1,0,1,0,0.0,0.0
1015,2109,26-09-2019 09:56:00,1,2158.0,1700.0,0.788,10.384,2,0,0,0,2,0,2,0,0.0,0.0
1015,2110,26-09-2019 09:58:00,1,2391.0,1792.0,0.749,11.405,6,4,3,1,2,0,2,0,0.0,0.0
1015,2111,26-09-2019 10:00:00,1,2753.0,1955.0,0.71,13.013,2,0,0,0,2,0,2,0,0.0,0.0
1015,2112,26-09-2019 10:02:00,1,2744.0,1951.0,0.711,12.972,24,23,0,23,1,0,1,0,0.0,0.0
1015,2113,26-09-2019 10:04:00,1,2726.0,2001.0,0.734,12.958,8,7,0,7,1,0,1,0,0.0,0.0
1015,2114,26-09-2019 10:06:00,1,2730.0,2016.0,0.738,12.99,3,0,0,0,3,0,3,0,0.0,0.0
1015,2115,26-09-2019 10:08:00,1,2711.0,2069.0,0.763,12.971,31,23,15,8,8,3,5,0,0.0,0.0
1015,2116,26-09-2019 10:10:00,1,2974.0,2131.0,0.717,14.075,21,11,2,9,10,2,8,0,0.0,0.0
1015,2117,26-09-2019 10:12:00,1,2708.0,2072.0,0.765,12.965,4,1,1,0,3,0,3,0,0.0,0.0
1015,2118,26-09-2019 10:14:00,1,2733.0,2037.0,0.746,13.022,5,1,1,0,4,2,2,0,0.0,0.0
1015,2119,26-09-2019 10:16:00,1,2725.0,2014.0,0.739,12.968,4,3,0,3,1,1,0,0,0.0,0.0
1015,2120,26-09-2019 10:18:00,1,2749.0,2013.0,0.732,13.062,14,8,3,5,6,4,2,0,0.0,0.0
1015,2121,26-09-2019 10:20:00,1,2720.0,2009.0,0.738,12.942,4,1,0,1,3,0,3,0,0.0,0.0
1015,2122,26-09-2019 10:22:00,1,2838.0,2081.0,0.733,13.4865,45,30,16,14,15,5,10,0,0.0,0.0
1015,2123,26-09-2019 10:24:00,1,2956.0,2153.0,0.728,14.031,87,66,25,41,21,0,21,0,0.0,0.0
1015,2124,26-09-2019 10:26:00,1,3176.0,2336.0,0.736,15.1,44,29,4,25,15,5,10,0,0.0,0.0
1015,2125,26-09-2019 10:28:00,1,3270.0,2406.0,0.736,15.55,250,161,122,39,89,55,34,14,0.0,0.0
1015,2126,26-09-2019 10:30:00,1,3258.0,2547.0,0.782,15.655,151,85,51,34,66,16,50,72,0.0,0.0
1015,2127,26-09-2019 10:32:00,1,3583.0,2774.0,0.774,17.188,391,168,128,40,223,156,67,117,0.0,0.0
1015,2128,26-09-2019 10:34:00,1,3444.0,2742.0,0.796,16.607,344,173,144,29,171,127,44,159,0.03,0.0
1015,2129,26-09-2019 10:36:00,1,3457.0,2659.0,0.769,16.565,277,149,125,24,128,100,28,48,0.01,0.0
1015,2130,26-09-2019 10:38:00,1,3573.0,2812.0,0.787,17.193,563,308,251,57,255,198,57,161,0.04,0.08
1015,2131,26-09-2019 10:40:00,1,3561.0,2841.0,0.798,17.178,158,114,91,23,44,20,24,20,0.0,0.0
1015,2132,26-09-2019 10:42:00,1,3439.0,2785.0,0.81,16.633,536,285,231,54,251,200,51,26,0.0,0.0
1015,2133,26-09-2019 10:44:00,1,3664.0,2892.0,0.789,17.64,158,70,57,13,88,73,15,83,0.0,0.0
1015,2134,26-09-2019 10:46:00,1,3457.0,2746.0,0.794,16.66,594,319,258,61,275,211,64,9,0.02,0.0
1015,2135,26-09-2019 10:48:00,1,3336.0,2687.0,0.805,16.118,652,401,319,82,251,206,45,43,0.0,0.0
1015,2136,26-09-2019 10:50:00,1,3454.0,2787.0,0.807,16.693,83,60,37,23,23,14,9,3,0.0,0.0
1015,2137,26-09-2019 10:52:00,1,3328.0,2678.0,0.805,16.079,68,58,30,28,10,4,6,0,0.0,0.0
1015,2138,26-09-2019 10:54:00,1,3192.0,2647.0,0.829,15.507,22,17,3,14,5,2,3,0,0.0,0.0
1015,2139,26-09-2019 10:56:00,1,3211.5,2613.5,0.814,15.547,21,10,2,8,11,3,8,0,0.0,0.0
1015,2140,26-09-2019 10:58:00,1,3231.0,2580.0,0.799,15.587,5,3,0,3,2,1,1,0,0.0,0.0
1015,2141,26-09-2019 11:00:00,1,2911.0,2384.0,0.819,14.109,10,3,0,3,7,2,5,0,0.0,0.0
1015,2142,26-09-2019 11:02:00,1,2930.0,2266.0,0.773,14.054,6,2,0,2,4,2,2,0,0.0,0.0
1015,2143,26-09-2019 11:04:00,1,2684.0,2135.0,0.795,12.941,4,1,0,1,3,1,2,0,0.0,0.0
1015,2144,26-09-2019 11:06:00,1,2718.0,2044.0,0.752,12.971,4,2,0,2,2,1,1,0,0.0,0.0
1015,2145,26-09-2019 11:08:00,1,2597.0,2011.0,0.775,12.457,2,2,1,1,0,0,0,0,0.0,0.0
1015,2146,26-09-2019 11:10:00,1,2620.0,1960.0,0.748,12.494,18,14,9,5,4,2,2,0,0.0,0.0
1015,2147,26-09-2019 11:12:00,1,2713.0,2005.0,0.739,12.911,13,6,4,2,7,2,5,0,0.0,0.0
1015,2148,26-09-2019 11:14:00,1,2734.0,2035.0,0.744,13.027,3,0,0,0,3,1,2,0,0.0,0.0
1015,2149,26-09-2019 11:16:00,1,2733.0,2019.0,0.739,13.003,8,2,0,2,6,1,5,0,0.0,0.0
1015,2150,26-09-2019 11:18:00,1,2733.0,2040.0,0.746,13.029,6,1,1,0,5,2,3,0,0.0,0.0
1015,2151,26-09-2019 11:20:00,1,2715.0,2040.0,0.751,12.958,3,0,0,0,3,1,2,0,0.0,0.0
1015,2152,26-09-2019 11:22:00,1,2726.0,2052.0,0.753,13.012,17,5,3,2,12,2,10,0,0.0,0.0
1015,2153,26-09-2019 11:24:00,1,2734.0,2028.0,0.742,13.019,10,6,2,4,4,0,4,0,0.0,0.0
1015,2154,26-09-2019 11:26:00,1,2738.0,2018.0,0.737,13.022,16,7,0,7,9,0,9,0,0.0,0.0
1015,2155,26-09-2019 11:28:00,1,2737.0,1994.0,0.729,12.993,11,2,1,1,9,4,5,0,0.0,0.0
1015,2156,26-09-2019 11:30:00,1,2732.0,2005.5,0.7345,12.986,30,7,2,5,23,15,8,0,0.0,0.0
1015,2157,26-09-2019 11:32:00,1,2727.0,2017.0,0.74,12.979,32,17,8,9,15,6,9,0,0.0,0.0
1015,2158,26-09-2019 11:34:00,1,2739.0,2011.0,0.734,13.02,4,0,0,0,4,0,4,0,0.0,0.0
1015,2159,26-09-2019 11:36:00,1,2725.0,1982.0,0.727,12.933,8,0,0,0,8,0,8,0,0.0,0.0
1015,2160,26-09-2019 11:38:00,1,2742.0,1951.0,0.711,12.965,14,6,1,5,8,2,6,0,0.0,0.0
1015,2161,26-09-2019 11:40:00,1,2623.0,1926.0,0.734,12.466,10,6,0,6,4,0,4,0,0.0,0.0
1015,2162,26-09-2019 11:42:00,1,2383.0,1864.0,0.782,11.453,6,0,0,0,6,0,6,0,0.0,0.0
1015,2163,26-09-2019 11:44:00,1,2380.0,1830.0,0.769,11.404,11,6,4,2,5,0,5,0,0.0,0.0
1015,2164,26-09-2019 11:46:00,1,2505.0,1830.0,0.731,11.895,13,0,0,0,13,0,13,0,0.0,0.0
1015,2165,26-09-2019 11:48:00,1,2759.0,1889.0,0.685,12.964,7,0,0,0,7,0,7,0,0.01,0.0
1015,2166,26-09-2019 11:50:00,1,2751.0,1928.0,0.701,12.973,8,1,0,1,7,0,7,0,0.0,0.0
1015,2167,26-09-2019 11:52:00,1,2737.0,1968.0,0.719,12.964,27,15,11,4,12,2,10,0,0.0,0.0
1015,2168,26-09-2019 11:54:00,1,2760.0,1923.0,0.697,13.003,9,3,0,3,6,0,6,0,0.0,0.0
1015,2169,26-09-2019 11:56:00,1,2496.0,1867.0,0.748,11.902,9,4,1,3,5,0,5,0,0.0,0.0
1015,2170,26-09-2019 11:58:00,1,2383.0,1847.0,0.775,11.433,19,13,3,10,6,0,6,0,0.0,0.0
1015,2171,26-09-2019 12:00:00,1,2397.0,1819.0,0.759,11.456,27,16,1,15,11,0,11,0,0.0,0.0
1015,2172,26-09-2019 12:02:00,1,2400.0,1766.0,0.736,11.413,35,22,3,19,13,3,10,0,0.0,0.0
1015,2173,26-09-2019 12:04:00,1,2345.0,1739.5,0.742,11.1665,6,3,1,2,3,1,2,0,0.0,0.0
1015,2174,26-09-2019 12:06:00,1,2290.0,1713.0,0.748,10.92,22,16,2,14,6,2,4,0,0.0,0.0
1015,2175,26-09-2019 12:08:00,1,2512.0,1853.0,0.738,11.95,49,37,8,29,12,6,6,1,0.0,0.0
1015,2176,26-09-2019 12:10:00,1,2946.0,2196.0,0.745,14.037,55,44,18,26,11,3,8,0,0.0,0.0
1015,2177,26-09-2019 12:12:00,1,2908.0,2307.0,0.793,14.012,187,159,104,55,28,10,18,0,0.0,0.0
1015,2178,26-09-2019 12:14:00,1,3027.0,2360.0,0.78,14.54,88,50,23,27,38,15,23,0,0.0,0.0
1015,2179,26-09-2019 12:16:00,1,3239.0,2516.0,0.777,15.547,243,82,64,18,161,88,73,80,0.0,0.0
1015,2180,26-09-2019 12:18:00,1,3552.0,2815.0,0.793,17.113,231,85,68,17,146,89,57,104,0.0,0.0
1015,2181,26-09-2019 12:20:00,1,3811.0,2885.0,0.757,18.21,24,9,3,6,15,3,12,30,0.0,0.0
1015,2182,26-09-2019 12:22:00,1,3237.0,2594.0,0.801,15.627,446,228,192,36,218,177,41,144,0.02,0.0
1015,2183,26-09-2019 12:24:00,1,3443.0,2751.0,0.799,16.613,487,224,173,51,263,202,61,128,0.01,0.0
1015,2184,26-09-2019 12:26:00,1,3459.0,2713.0,0.784,16.633,71,57,21,36,14,6,8,3,0.0,0.0
1015,2185,26-09-2019 12:28:00,1,3445.0,2682.0,0.779,16.543,597,399,322,77,198,148,50,0,0.0,0.0
1015,2186,26-09-2019 12:30:00,1,3451.0,2780.0,0.806,16.674,412,182,137,45,230,161,69,14,0.0,0.0
1015,2187,26-09-2019 12:32:00,1,3465.0,2749.0,0.794,16.695,231,132,89,43,99,73,26,0,0.0,0.0
1015,2188,26-09-2019 12:34:00,1,3435.0,2750.0,0.8,16.579,52,35,21,14,17,8,9,2,0.02,0.0
1015,2189,26-09-2019 12:36:00,1,3208.0,2656.0,0.828,15.58,69,52,16,36,17,3,14,0,0.0,0.0
1015,2190,26-09-2019 12:38:00,1,3223.5,2613.0,0.811,15.5935,46,36,18,18,10,3,7,0,0.0,0.0
1015,2191,26-09-2019 12:40:00,1,3239.0,2570.0,0.794,15.607,1,0,0,0,1,1,0,0,0.0,0.0
1015,2192,26-09-2019 12:42:00,1,3262.0,2503.0,0.767,15.624,41,27,10,17,14,2,12,0,0.0,0.0
1015,2193,26-09-2019 12:44:00,1,3249.0,2551.0,0.785,15.626,35,31,16,15,4,1,3,0,0.0,0.0
1015,2194,26-09-2019 12:46:00,1,3004.0,2430.0,0.809,14.525,6,4,0,4,2,1,1,0,0.0,0.0
1015,2195,26-09-2019 12:48:00,1,2919.0,2298.0,0.787,14.045,3,0,0,0,3,1,2,0,0.0,0.0
1015,2196,26-09-2019 12:50:00,1,2692.0,2171.0,0.806,13.012,11,8,5,3,3,2,1,0,0.0,0.0
1015,2197,26-09-2019 12:52:00,1,2707.0,2127.0,0.786,13.019,11,9,0,9,2,0,2,0,0.0,0.0
1015,2198,26-09-2019 12:54:00,1,2712.0,2076.0,0.765,12.985,0,0,0,0,0,0,0,0,0.0,0.0
1015,2199,26-09-2019 12:56:00,1,2718.0,2017.0,0.742,12.943,8,6,3,3,2,1,1,0,0.0,0.0
1015,2200,26-09-2019 12:58:00,1,2700.0,2093.0,0.775,12.954,3,3,1,2,0,0,0,0,0.0,0.0
1015,2201,26-09-2019 13:00:00,1,2714.0,2073.0,0.764,12.989,1,0,0,0,1,1,0,0,0.0,0.0
1015,2202,26-09-2019 13:02:00,1,2727.0,2025.0,0.742,12.986,6,3,0,3,3,2,1,0,0.0,0.0
1015,2203,26-09-2019 13:04:00,1,2722.0,2037.0,0.748,12.98,11,8,6,2,3,1,2,0,0.0,0.0
1015,2204,26-09-2019 13:06:00,1,2713.0,2053.0,0.757,12.963,0,0,0,0,0,0,0,0,0.0,0.0
1015,2205,26-09-2019 13:08:00,1,2714.0,2042.0,0.752,12.956,2,0,0,0,2,0,2,0,0.0,0.0
1015,2206,26-09-2019 13:10:00,1,2700.0,2083.0,0.771,12.946,4,0,0,0,4,2,2,0,0.0,0.0
1015,2207,26-09-2019 13:12:00,1,2714.5,2057.5,0.758,12.9735,1,0,0,0,1,1,0,0,0.0,0.0
1015,2208,26-09-2019 13:14:00,1,2729.0,2032.0,0.745,13.001,25,19,12,7,6,3,3,0,0.0,0.0
1015,2209,26-09-2019 13:16:00,1,2714.0,2020.0,0.744,12.929,2,0,0,0,2,2,0,0,0.0,0.0
1015,2210,26-09-2019 13:18:00,1,2743.0,1937.0,0.706,12.952,16,1,0,1,15,2,13,0,0.0,0.0
1015,2211,26-09-2019 13:20:00,1,2619.0,1920.0,0.733,12.445,2,0,0,0,2,0,2,0,0.0,0.0
1015,2212,26-09-2019 13:22:00,1,2637.0,1912.0,0.725,12.506,3,0,0,0,3,1,2,0,0.0,0.0
1015,2213,26-09-2019 13:24:00,1,2625.0,1882.0,0.717,12.427,2,0,0,0,2,1,1,0,0.0,0.0
1015,2214,26-09-2019 13:26:00,1,2763.0,1902.0,0.689,12.993,7,5,2,3,2,0,2,0,0.0,0.0
1015,2215,26-09-2019 13:28:00,1,2736.0,1971.0,0.721,12.962,1,0,0,0,1,0,1,0,0.0,0.0
1015,2216,26-09-2019 13:30:00,1,2744.0,1958.0,0.714,12.98,0,0,0,0,0,0,0,0,0.0,0.0
1015,2217,26-09-2019 13:32:00,1,2755.0,1894.0,0.687,12.954,41,25,11,14,16,6,10,0,0.0,0.0
1015,2218,26-09-2019 13:34:00,1,2750.0,1994.0,0.725,13.045,51,44,18,26,7,2,5,0,0.0,0.0
1015,2219,26-09-2019 13:36:00,1,2950.0,2143.0,0.726,13.995,88,77,40,37,11,0,11,0,0.0,0.0
1015,2220,26-09-2019 13:38:00,1,2953.0,2153.0,0.729,14.018,37,24,4,20,13,1,12,0,0.0,0.0
1015,2221,26-09-2019 13:40:00,1,2943.0,2221.0,0.755,14.056,25,3,0,3,22,7,15,0,0.0,0.0
1015,2222,26-09-2019 13:42:00,1,2900.0,2327.0,0.802,14.004,11,1,1,0,10,2,8,0,0.0,0.0
1015,2223,26-09-2019 13:44:00,1,2913.0,2303.0,0.791,14.025,41,29,6,23,12,0,12,0,0.0,0.0
1015,2224,26-09-2019 13:46:00,1,3086.5,2383.5,0.7735,14.7995,265,129,105,24,136,90,46,103,0.0,0.0
1015,2225,26-09-2019 13:48:00,1,3260.0,2464.0,0.756,15.574,285,189,149,40,96,42,54,63,0.0,0.0
1015,2226,26-09-2019 13:50:00,1,3260.0,2473.0,0.758,15.583,481,284,232,52,197,152,45,4,0.01,0.02
1015,2227,26-09-2019 13:52:00,1,3245.0,2498.0,0.77,15.552,156,90,65,25,66,46,20,26,0.0,0.0
1015,2228,26-09-2019 13:54:00,1,3268.0,2441.0,0.747,15.578,51,44,14,30,7,3,4,0,0.0,0.0
1015,2229,26-09-2019 13:56:00,1,3276.0,2400.0,0.733,15.566,29,27,1,26,2,1,1,0,0.0,0.0
1015,2230,26-09-2019 13:58:00,1,3168.0,2388.0,0.754,15.128,7,3,0,3,4,1,3,0,0.0,0.0
1015,2231,26-09-2019 14:00:00,1,2928.0,2196.0,0.75,13.968,2,0,0,0,2,2,0,0,0.0,0.0
1015,2232,26-09-2019 14:02:00,1,2708.0,2074.0,0.766,12.965,0,0,0,0,0,0,0,0,0.0,0.0
1015,2233,26-09-2019 14:04:00,1,2734.0,1989.0,0.728,12.973,4,2,1,1,2,1,1,0,0.0,0.0
1015,2234,26-09-2019 14:06:00,1,2749.0,1988.0,0.723,13.033,4,1,0,1,3,1,2,0,0.0,0.0
1015,2235,26-09-2019 14:08:00,1,2737.0,1981.0,0.724,12.976,0,0,0,0,0,0,0,0,0.0,0.0
1015,2236,26-09-2019 14:10:00,1,2742.0,1935.0,0.706,12.945,7,4,0,4,3,0,3,0,0.0,0.0
1015,2237,26-09-2019 14:12:00,1,2627.0,1917.0,0.73,12.473,0,0,0,0,0,0,0,0,0.0,0.0
1015,2238,26-09-2019 14:14:00,1,2630.0,1905.0,0.725,12.472,7,3,0,3,4,0,4,0,0.0,0.0
1015,2239,26-09-2019 14:16:00,1,2387.0,1857.0,0.778,11.463,2,0,0,0,2,1,1,0,0.0,0.0
1015,2240,26-09-2019 14:18:00,1,2380.0,1839.0,0.773,11.413,3,0,0,0,3,1,2,0,0.0,0.0
1015,2241,26-09-2019 14:20:00,1,2563.0,1896.0,0.742,12.197,2,0,0,0,2,0,2,0,0.0,0.0
1015,2242,26-09-2019 14:22:00,1,2746.0,1953.0,0.711,12.981,2,0,0,0,2,1,1,0,0.0,0.0
1015,2243,26-09-2019 14:24:00,1,2751.0,1960.0,0.713,13.008,12,2,0,2,10,1,9,0,0.0,0.0
1015,2244,26-09-2019 14:26:00,1,2744.0,1974.0,0.719,12.997,2,2,0,2,0,0,0,0,0.0,0.0
1015,2245,26-09-2019 14:28:00,1,2736.0,1973.0,0.721,12.965,4,2,0,2,2,0,2,0,0.0,0.0
1015,2246,26-09-2019 14:30:00,1,2636.0,1927.0,0.731,12.519,22,11,4,7,11,3,8,0,0.0,0.0
1015,2247,26-09-2019 14:32:00,1,2619.0,1900.0,0.725,12.423,7,1,0,1,6,2,4,0,0.0,0.0
1015,2248,26-09-2019 14:34:00,1,2627.0,1892.0,0.72,12.444,24,10,7,3,14,6,8,0,0.0,0.0
1015,2249,26-09-2019 14:36:00,1,2743.0,1979.0,0.722,12.997,0,0,0,0,0,0,0,0,0.0,0.0
1015,2250,26-09-2019 14:38:00,1,2627.0,1919.0,0.731,12.475,2,0,0,0,2,1,1,0,0.0,0.0
1015,2251,26-09-2019 14:40:00,1,2745.0,1953.0,0.711,12.977,0,0,0,0,0,0,0,0,0.0,0.0
1015,2252,26-09-2019 14:42:00,1,2739.0,1954.0,0.714,12.956,1,0,0,0,1,1,0,0,0.0,0.0
1015,2253,26-09-2019 14:44:00,1,2613.0,1924.0,0.736,12.427,1,0,0,0,1,1,0,0,0.0,0.0
1015,2254,26-09-2019 14:46:00,1,2754.0,1943.0,0.706,13.002,1,0,0,0,1,0,1,0,0.0,0.0
1015,2255,26-09-2019 14:48:00,1,2628.0,1927.0,0.733,12.487,1,0,0,0,1,0,1,0,0.0,0.0
1015,2256,26-09-2019 14:50:00,1,2621.0,1911.0,0.729,12.441,0,0,0,0,0,0,0,0,0.0,0.0
1015,2257,26-09-2019 14:52:00,1,2748.0,1917.0,0.698,12.948,1,0,0,0,1,0,1,0,0.0,0.0
1015,2258,26-09-2019 14:54:00,1,2689.5,1913.0,0.7115,12.7135,0,0,0,0,0,0,0,0,0.0,0.0
1015,2259,26-09-2019 14:56:00,1,2631.0,1909.0,0.725,12.479,1,0,0,0,1,0,1,0,0.0,0.0
1015,2260,26-09-2019 14:58:00,1,2377.0,1847.0,0.777,11.411,45,34,18,16,11,3,8,0,0.0,0.0
1015,2261,26-09-2019 15:00:00,1,2748.0,2023.0,0.736,13.069,37,34,4,30,3,1,2,0,0.0,0.0
1015,2262,26-09-2019 15:02:00,1,2694.0,2105.0,0.781,12.944,25,25,2,23,0,0,0,0,0.0,0.0
1015,2263,26-09-2019 15:04:00,1,2950.0,2205.0,0.747,14.063,67,59,27,32,8,2,6,0,0.0,0.0
1015,2264,26-09-2019 15:06:00,1,2928.0,2267.0,0.774,14.047,382,231,192,39,151,112,39,64,0.0,0.0
1015,2265,26-09-2019 15:08:00,1,2890.0,2361.0,0.817,14.0,94,20,7,13,74,0,74,56,0.0,0.0
1015,2266,26-09-2019 15:10:00,1,3467.0,2707.0,0.781,16.658,361,140,110,30,221,143,78,88,0.0,0.01
1015,2267,26-09-2019 15:12:00,1,3239.0,2531.0,0.781,15.564,443,223,177,46,220,157,63,85,0.03,0.04
1015,2268,26-09-2019 15:14:00,1,3147.0,2448.0,0.778,15.108,278,161,127,34,117,82,35,79,0.0,0.0
1015,2269,26-09-2019 15:16:00,1,3336.0,2680.0,0.803,16.112,221,122,92,30,99,74,25,61,0.0,0.0
1015,2270,26-09-2019 15:18:00,1,3151.0,2420.0,0.768,15.093,79,49,23,26,30,3,27,0,0.0,0.0
1015,2271,26-09-2019 15:20:00,1,3235.0,2540.0,0.785,15.559,187,109,81,28,78,55,23,24,0.06,0.0
1015,2272,26-09-2019 15:22:00,1,3234.0,2564.0,0.793,15.58,9,0,0,0,9,0,9,0,0.0,0.0
1015,2273,26-09-2019 15:24:00,1,3258.0,2497.0,0.766,15.603,65,40,25,15,25,6,19,0,0.0,0.0
1015,2274,26-09-2019 15:26:00,1,3211.0,2623.0,0.817,15.556,499,344,276,68,155,118,37,43,0.0,0.0
1015,2275,26-09-2019 15:28:00,1,3218.0,2629.0,0.817,15.591,93,65,38,27,28,19,9,0,0.0,0.0
1015,2276,26-09-2019 15:30:00,1,3225.0,2635.0,0.817,15.626,1,0,0,0,1,0,1,0,0.0,0.0
1015,2277,26-09-2019 15:32:00,1,3138.0,2500.0,0.797,15.131,0,0,0,0,0,0,0,0,0.0,0.0
1015,2278,26-09-2019 15:34:00,1,2895.0,2327.0,0.804,13.982,2,1,1,0,1,1,0,0,0.0,0.0
1015,2279,26-09-2019 15:36:00,1,2810.0,2238.0,0.797,13.549,0,0,0,0,0,0,0,0,0.0,0.0
1015,2280,26-09-2019 15:38:00,1,2692.0,2171.0,0.806,13.012,0,0,0,0,0,0,0,0,0.0,0.0
1015,2281,26-09-2019 15:40:00,1,2702.0,2144.0,0.794,13.02,0,0,0,0,0,0,0,0,0.0,0.0
1015,2282,26-09-2019 15:42:00,1,2691.0,2097.0,0.779,12.925,0,0,0,0,0,0,0,0,0.0,0.0
1015,2283,26-09-2019 15:44:00,1,2700.0,2144.0,0.794,13.012,0,0,0,0,0,0,0,0,0.0,0.0
1015,2284,26-09-2019 15:46:00,1,2714.0,2122.0,0.782,13.042,2,0,0,0,2,2,0,0,0.0,0.0
1015,2285,26-09-2019 15:48:00,1,2722.0,2062.0,0.757,13.009,0,0,0,0,0,0,0,0,0.0,0.0
1015,2286,26-09-2019 15:50:00,1,2682.0,2102.0,0.783,12.895,4,1,0,1,3,2,1,0,0.0,0.0
1015,2287,26-09-2019 15:52:00,1,2733.0,2039.0,0.746,13.025,15,6,4,2,9,4,5,0,0.0,0.0
1015,2288,26-09-2019 15:54:00,1,2723.0,2001.0,0.735,12.946,14,12,1,11,2,2,0,0,0.0,0.0
1015,2289,26-09-2019 15:56:00,1,2622.0,1924.0,0.734,12.462,7,6,0,6,1,1,0,0,0.0,0.0
1015,2290,26-09-2019 15:58:00,1,2501.0,1892.0,0.757,11.948,1,0,0,0,1,0,1,0,0.0,0.0
1015,2291,26-09-2019 16:00:00,1,2499.0,1907.0,0.763,11.957,2,2,0,2,0,0,0,0,0.0,0.0
1015,2292,26-09-2019 16:02:00,1,2498.5,1895.5,0.7585,11.9435,4,2,0,2,2,1,1,0,0.0,0.0
1015,2293,26-09-2019 16:04:00,1,2498.0,1884.0,0.754,11.93,1,0,0,0,1,0,1,0,0.0,0.0
1015,2294,26-09-2019 16:06:00,1,2497.0,1885.0,0.755,11.924,8,6,0,6,2,2,0,0,0.0,0.0
1015,2295,26-09-2019 16:08:00,1,2373.0,1832.0,0.772,11.378,24,13,5,8,11,2,9,0,0.0,0.0
1015,2296,26-09-2019 16:10:00,1,2637.0,1889.0,0.716,12.483,2,0,0,0,2,1,1,0,0.0,0.0
1015,2297,26-09-2019 16:12:00,1,2622.0,1881.0,0.717,12.415,3,0,0,0,3,1,2,0,0.0,0.0
1015,2298,26-09-2019 16:14:00,1,2629.0,1908.0,0.726,12.47,1,0,0,0,1,0,1,0,0.0,0.0
1015,2299,26-09-2019 16:16:00,1,2755.0,1896.0,0.688,12.956,1,0,0,0,1,0,1,0,0.0,0.0
1015,2300,26-09-2019 16:18:00,1,2629.0,1883.0,0.716,12.444,53,43,12,31,10,3,7,0,0.0,0.0
1015,2301,26-09-2019 16:20:00,1,2734.0,2018.0,0.738,13.008,56,34,17,17,22,2,20,0,0.0,0.0
1015,2302,26-09-2019 16:22:00,1,2717.0,2049.0,0.754,12.976,98,55,35,20,43,12,31,0,0.0,0.0
1015,2303,26-09-2019 16:24:00,1,2940.0,2178.0,0.741,13.997,96,53,33,20,43,12,31,26,0.0,0.0
1015,2304,26-09-2019 16:26:00,1,2917.0,2303.0,0.789,14.044,84,30,15,15,54,2,52,51,0.0,0.0
1015,2305,26-09-2019 16:28:00,1,3232.0,2479.0,0.767,15.478,101,32,13,19,69,0,69,64,0.0,0.04
1015,2306,26-09-2019 16:30:00,1,3227.0,2528.0,0.783,15.513,650,330,261,69,320,254,66,79,0.02,0.06
1015,2307,26-09-2019 16:32:00,1,3231.0,2590.0,0.802,15.597,538,284,232,52,254,208,46,138,0.0,0.0
1015,2308,26-09-2019 16:34:00,1,3262.0,2468.0,0.757,15.587,466,255,211,44,211,164,47,170,0.01,0.0
1015,2309,26-09-2019 16:36:00,1,3338.0,2651.0,0.7935,16.0875,393,221,174,47,172,125,47,73,0.0,0.0
1015,2310,26-09-2019 16:38:00,1,3414.0,2834.0,0.83,16.588,277,105,88,17,172,140,32,183,0.05,0.0
1015,2311,26-09-2019 16:40:00,1,3337.0,2696.0,0.808,16.134,166,94,76,18,72,45,27,76,0.01,0.0
1015,2312,26-09-2019 16:42:00,1,3428.0,2886.0,0.842,16.703,440,249,198,51,191,141,50,57,0.0,0.0
1015,2313,26-09-2019 16:44:00,1,3181.0,2726.0,0.857,15.552,208,113,88,25,95,68,27,32,0.0,0.05
1015,2314,26-09-2019 16:46:00,1,3321.0,2767.0,0.833,16.149,257,152,108,44,105,61,44,0,0.0,0.0
1015,2315,26-09-2019 16:48:00,1,3410.0,2868.0,0.841,16.61,485,297,226,71,188,134,54,65,0.0,0.0
1015,2316,26-09-2019 16:50:00,1,3408.0,2929.0,0.86,16.672,65,35,17,18,30,11,19,0,0.0,0.0
1015,2317,26-09-2019 16:52:00,1,3433.0,2806.0,0.817,16.632,71,46,15,31,25,5,20,0,0.0,0.0
1015,2318,26-09-2019 16:54:00,1,3432.0,2810.0,0.819,16.633,49,20,0,20,29,4,25,0,0.0,0.0
1015,2319,26-09-2019 16:56:00,1,3185.0,2761.0,0.867,15.606,41,17,2,15,24,0,24,0,0.0,0.0
1015,2320,26-09-2019 16:58:00,1,3196.0,2679.0,0.838,15.56,35,17,3,14,18,4,14,0,0.0,0.0
1015,2321,26-09-2019 17:00:00,1,3192.0,2726.0,0.854,15.596,13,4,1,3,9,3,6,0,0.0,0.0
1015,2322,26-09-2019 17:02:00,1,3116.0,2533.0,0.813,15.082,5,4,2,2,1,0,1,0,0.0,0.0
1015,2323,26-09-2019 17:04:00,1,2887.0,2377.0,0.823,14.006,14,10,1,9,4,0,4,0,0.0,0.0
1015,2324,26-09-2019 17:06:00,1,2792.0,2272.0,0.814,13.515,21,10,5,5,11,3,8,0,0.0,0.0
1015,2325,26-09-2019 17:08:00,1,2685.0,2185.0,0.814,12.998,10,1,0,1,9,3,6,0,0.0,0.0
1015,2326,26-09-2019 17:10:00,1,2697.0,2139.0,0.7935,12.995,1,0,0,0,1,1,0,0,0.0,0.0
1015,2327,26-09-2019 17:12:00,1,2709.0,2093.0,0.773,12.992,44,20,10,10,24,13,11,0,0.01,0.0
1015,2328,26-09-2019 17:14:00,1,2691.0,2173.0,0.807,13.01,9,1,0,1,8,1,7,0,0.0,0.0
1015,2329,26-09-2019 17:16:00,1,2719.0,2062.0,0.758,12.996,5,0,0,0,5,0,5,0,0.0,0.0
1015,2330,26-09-2019 17:18:00,1,2611.0,1990.0,0.762,12.492,4,0,0,0,4,0,4,0,0.0,0.0
1015,2331,26-09-2019 17:20:00,1,2348.0,1932.0,0.823,11.39,18,11,4,7,7,4,3,0,0.0,0.0
1015,2332,26-09-2019 17:22:00,1,2723.0,2014.0,0.74,12.957,43,35,9,26,8,3,5,2,0.0,0.0
1015,2333,26-09-2019 17:24:00,1,2907.0,2367.0,0.814,14.073,381,222,181,41,159,115,44,39,0.0,0.0
1015,2334,26-09-2019 17:26:00,1,2919.0,2306.0,0.79,14.054,99,60,24,36,39,17,22,0,0.0,0.0
1015,2335,26-09-2019 17:28:00,1,2910.0,2346.0,0.806,14.063,69,36,4,32,33,14,19,0,0.0,0.0
1015,2336,26-09-2019 17:30:00,1,2915.0,2331.0,0.8,14.065,53,31,1,30,22,4,18,0,0.0,0.0
1015,2337,26-09-2019 17:32:00,1,2910.0,2308.0,0.793,14.019,56,29,6,23,27,11,16,0,0.0,0.0
1015,2338,26-09-2019 17:34:00,1,3017.0,2353.0,0.78,14.494,70,42,12,30,28,9,19,0,0.0,0.0
1015,2339,26-09-2019 17:36:00,1,2908.0,2350.0,0.808,14.06,10,0,0,0,10,4,6,0,0.0,0.0
1015,2340,26-09-2019 17:38:00,1,2941.0,2211.0,0.752,14.037,5,0,0,0,5,2,3,0,0.0,0.0
1015,2341,26-09-2019 17:40:00,1,2699.0,2139.0,0.793,13.004,6,4,2,2,2,1,1,0,0.0,0.0
1015,2342,26-09-2019 17:42:00,1,2696.0,2133.0,0.791,12.986,12,4,0,4,8,3,5,0,0.0,0.0
1015,2343,26-09-2019 17:44:00,1,2824.5,2154.5,0.764,13.5145,146,88,67,21,58,23,35,15,0.0,0.0
1015,2344,26-09-2019 17:46:00,1,2953.0,2176.0,0.737,14.043,148,72,37,35,76,2,74,79,0.0,0.0
1015,2345,26-09-2019 17:48:00,1,3269.0,2433.0,0.744,15.573,125,49,22,27,76,2,74,54,0.0,0.03
1015,2346,26-09-2019 17:50:00,1,3463.0,2679.0,0.774,16.612,129,30,16,14,99,21,78,65,0.0,0.06
1015,2347,26-09-2019 17:52:00,1,3444.0,2744.0,0.797,16.606,605,313,245,68,292,228,64,113,0.05,0.04
1015,2348,26-09-2019 17:54:00,1,3247.0,2482.0,0.764,15.542,311,154,115,39,157,118,39,81,0.04,0.0
1015,2349,26-09-2019 17:56:00,1,3017.0,2393.0,0.793,14.535,232,144,97,47,88,68,20,35,0.0,0.0
1015,2350,26-09-2019 17:58:00,1,3267.0,2473.0,0.757,15.609,20,19,2,17,1,1,0,0,0.0,0.0
1015,2351,26-09-2019 18:00:00,0,2904.0,2382.0,0.82,14.077,76,53,36,17,23,14,9,0,0.0,0.0
1015,2352,26-09-2019 18:02:00,0,3511.0,2954.0,0.841,17.104,603,360,292,68,243,190,53,82,0.0,0.0
1015,2353,26-09-2019 18:04:00,0,3961.0,3389.0,0.856,19.359,498,302,253,49,196,143,53,74,0.0,0.0
1015,2354,26-09-2019 18:06:00,0,3730.0,3159.0,0.847,18.193,317,145,108,37,172,133,39,64,0.0,0.0
1015,2355,26-09-2019 18:08:00,0,3712.0,3188.0,0.859,18.155,476,277,224,53,199,160,39,137,0.02,0.0
1015,2356,26-09-2019 18:10:00,0,3727.0,3155.0,0.846,18.179,301,180,136,44,121,84,37,92,0.0,0.0
1015,2357,26-09-2019 18:12:00,0,3946.0,3372.0,0.854,19.281,596,346,292,54,250,196,54,118,0.0,0.0
1015,2358,26-09-2019 18:14:00,0,3822.0,3314.0,0.867,18.727,161,110,83,27,51,26,25,10,0.0,0.0
1015,2359,26-09-2019 18:16:00,0,3958.0,3360.0,0.849,19.315,179,104,74,30,75,55,20,72,0.0,0.0
1015,2360,26-09-2019 18:18:00,0,3930.5,3426.0,0.872,19.279,567,337,280,57,230,179,51,97,0.0,0.0
1015,2361,26-09-2019 18:20:00,0,3903.0,3492.0,0.895,19.243,242,134,115,19,108,88,20,131,0.0,0.0
1015,2362,26-09-2019 18:22:00,0,4244.0,3752.0,0.884,20.877,409,258,203,55,151,113,38,50,0.01,0.0
1015,2363,26-09-2019 18:24:00,0,3907.0,3526.0,0.902,19.297,267,181,151,30,86,70,16,66,0.0,0.0
1015,2364,26-09-2019 18:26:00,0,3890.0,3540.0,0.91,19.245,513,319,241,78,194,142,52,25,0.02,0.0
1015,2365,26-09-2019 18:28:00,0,4004.0,3568.0,0.891,19.727,653,376,295,81,277,202,75,13,0.0,0.0
1015,2366,26-09-2019 18:30:00,0,4222.0,3707.0,0.878,20.739,636,349,266,83,287,225,62,43,0.0,0.0
1015,2367,26-09-2019 18:32:00,0,3933.0,3418.0,0.869,19.28,339,190,153,37,149,116,33,81,0.0,0.0
1015,2368,26-09-2019 18:34:00,0,4445.0,3928.0,0.884,21.861,381,242,201,41,139,101,38,83,0.0,0.0
1015,2369,26-09-2019 18:36:00,0,3921.0,3417.0,0.872,19.23,217,123,96,27,94,77,17,42,0.0,0.0
1015,2370,26-09-2019 18:38:00,0,3947.0,3346.0,0.848,19.256,275,167,133,34,108,89,19,77,0.0,0.0
1015,2371,26-09-2019 18:40:00,0,3711.0,3240.0,0.873,18.207,138,82,44,38,56,28,28,14,0.0,0.0
1015,2372,26-09-2019 18:42:00,0,3934.0,3336.0,0.848,19.193,69,34,20,14,35,23,12,26,0.0,0.0
1015,2373,26-09-2019 18:44:00,0,3750.0,3074.0,0.82,18.178,696,361,273,88,335,258,77,48,0.0,0.0
1015,2374,26-09-2019 18:46:00,0,3958.0,3270.0,0.826,19.216,532,315,244,71,217,165,52,16,0.0,0.0
1015,2375,26-09-2019 18:48:00,0,3987.0,3223.0,0.808,19.278,390,224,176,48,166,124,42,32,0.0,0.0
1015,2376,26-09-2019 18:50:00,0,3990.0,3226.0,0.809,19.295,76,23,8,15,53,19,34,0,0.0,0.0
1015,2377,26-09-2019 18:52:00,0,3994.0,3181.5,0.797,19.26,57,41,11,30,16,3,13,0,0.0,0.0
1015,2378,26-09-2019 18:54:00,0,3998.0,3137.0,0.785,19.225,216,114,76,38,102,72,30,7,0.0,0.0
1015,2379,26-09-2019 18:56:00,0,3987.0,3233.0,0.811,19.289,440,263,214,49,177,135,42,89,0.0,0.0
1015,2380,26-09-2019 18:58:00,0,3955.0,3288.0,0.831,19.225,229,134,98,36,95,67,28,59,0.0,0.0
1015,2381,26-09-2019 19:00:00,0,3871.0,3070.0,0.793,18.653,95,44,20,24,51,23,28,0,0.0,0.0
1015,2382,26-09-2019 19:02:00,0,3871.0,3089.0,0.798,18.671,139,84,58,26,55,30,25,40,0.0,0.0
1015,2383,26-09-2019 19:04:00,0,3432.0,2771.0,0.807,16.59,621,373,282,91,248,194,54,54,0.0,0.0
1015,2384,26-09-2019 19:06:00,0,4085.0,3327.0,0.815,19.778,488,283,212,71,205,161,44,35,0.0,0.0
1015,2385,26-09-2019 19:08:00,0,3767.0,3059.0,0.812,18.229,302,180,141,39,122,88,34,51,0.0,0.0
1015,2386,26-09-2019 19:10:00,0,3996.0,3117.0,0.78,19.194,339,208,162,46,131,96,35,38,0.0,0.0
1015,2387,26-09-2019 19:12:00,0,3426.0,2825.0,0.825,16.624,297,174,132,42,123,89,34,26,0.0,0.0
1015,2388,26-09-2019 19:14:00,0,3452.0,2721.0,0.788,16.612,197,126,82,44,71,45,26,1,0.0,0.0
1015,2389,26-09-2019 19:16:00,0,3487.0,2624.0,0.753,16.645,59,37,15,22,22,10,12,0,0.0,0.0
1015,2390,26-09-2019 19:18:00,0,3805.0,2887.0,0.759,18.19,392,258,206,52,134,101,33,73,0.0,0.0
1015,2391,26-09-2019 19:20:00,0,3771.0,2957.0,0.784,18.131,491,343,290,53,148,99,49,109,0.0,0.0
1015,2392,26-09-2019 19:22:00,0,4009.0,3035.0,0.757,19.155,143,91,65,26,52,39,13,91,0.0,0.0
1015,2393,26-09-2019 19:24:00,0,4006.0,3108.0,0.776,19.226,168,98,80,18,70,49,21,52,0.0,0.0
1015,2394,26-09-2019 19:26:00,0,3997.5,3119.0,0.7805,19.2035,149,73,45,28,76,40,36,8,0.0,0.0
1015,2395,26-09-2019 19:28:00,0,3989.0,3130.0,0.785,19.181,154,72,33,39,82,41,41,0,0.0,0.0
1015,2396,26-09-2019 19:30:00,0,3794.0,2900.0,0.764,18.16,344,187,144,43,157,105,52,61,0.0,0.0
1015,2397,26-09-2019 19:32:00,0,3895.0,3007.0,0.772,18.677,436,254,194,60,182,138,44,88,0.0,0.0
1015,2398,26-09-2019 19:34:00,0,3786.0,2898.0,0.765,18.124,56,14,6,8,42,24,18,19,0.0,0.0
1015,2399,26-09-2019 19:36:00,0,3816.0,2876.0,0.754,18.22,331,194,155,39,137,98,39,41,0.03,0.0
1015,2400,26-09-2019 19:38:00,0,3784.0,2951.0,0.78,18.176,186,107,88,19,79,54,25,55,0.0,0.0
1015,2401,26-09-2019 19:40:00,0,3464.0,2730.0,0.788,16.672,289,146,107,39,143,107,36,34,0.0,0.0
1015,2402,26-09-2019 19:42:00,0,3570.0,2738.0,0.767,17.098,342,191,145,46,151,106,45,57,0.0,0.0
1015,2403,26-09-2019 19:44:00,0,3785.0,2935.0,0.775,18.164,468,276,219,57,192,141,51,72,0.0,0.0
1015,2404,26-09-2019 19:46:00,0,4057.0,3002.0,0.74,19.307,586,286,215,71,300,232,68,28,0.0,0.0
1015,2405,26-09-2019 19:48:00,0,3812.0,2853.0,0.748,18.176,355,217,168,49,138,90,48,19,0.0,0.0
1015,2406,26-09-2019 19:50:00,0,3724.0,2711.0,0.728,17.676,159,105,68,37,54,27,27,32,0.0,0.0
1015,2407,26-09-2019 19:52:00,0,3819.0,2767.0,0.725,18.109,397,229,191,38,168,128,40,113,0.02,0.0
1015,2408,26-09-2019 19:54:00,0,3820.0,2829.0,0.741,18.183,335,245,202,43,90,64,26,76,0.0,0.0
1015,2409,26-09-2019 19:56:00,0,3727.0,2698.0,0.724,17.671,134,66,45,21,68,47,21,8,0.0,0.0
1015,2410,26-09-2019 19:58:00,0,4149.0,3073.0,0.741,19.751,85,55,42,13,30,19,11,40,0.0,0.0
1015,2411,26-09-2019 20:00:00,0,3820.5,2834.0,0.742,18.191,341,213,153,60,128,93,35,58,0.0,0.0
1015,2412,26-09-2019 20:02:00,0,3492.0,2595.0,0.743,16.631,149,66,31,35,83,44,39,0,0.0,0.0
1015,2413,26-09-2019 20:04:00,0,3597.0,2668.0,0.742,17.126,216,94,71,23,122,86,36,36,0.0,0.0
1015,2414,26-09-2019 20:06:00,0,3505.0,2507.0,0.715,16.585,223,111,86,25,112,82,30,8,0.01,0.0
1015,2415,26-09-2019 20:08:00,0,3826.0,2794.0,0.73,18.167,379,193,145,48,186,143,43,57,0.0,0.0
1015,2416,26-09-2019 20:10:00,0,3816.0,2822.0,0.739,18.161,332,161,118,43,171,124,47,64,0.0,0.0
1015,2417,26-09-2019 20:12:00,0,3853.0,2730.0,0.708,18.205,256,176,137,39,80,60,20,56,0.0,0.0
1015,2418,26-09-2019 20:14:00,0,3827.0,2767.0,0.723,18.142,253,127,97,30,126,91,35,37,0.0,0.0
1015,2419,26-09-2019 20:16:00,0,3842.0,2718.0,0.707,18.148,332,192,143,49,140,101,39,47,0.0,0.0
1015,2420,26-09-2019 20:18:00,0,3620.0,2642.0,0.73,17.189,174,112,81,31,62,40,22,42,0.0,0.0
1015,2421,26-09-2019 20:20:00,0,3822.0,2736.0,0.716,18.087,163,96,64,32,67,37,30,6,0.0,0.0
1015,2422,26-09-2019 20:22:00,0,3841.0,2680.0,0.698,18.101,133,70,30,40,63,26,37,0,0.0,0.0
1015,2423,26-09-2019 20:24:00,0,3602.0,2617.0,0.727,17.089,292,169,119,50,123,81,42,14,0.0,0.0
1015,2424,26-09-2019 20:26:00,0,3849.0,2688.0,0.698,18.142,299,174,126,48,125,94,31,68,0.06,0.0
1015,2425,26-09-2019 20:28:00,0,3842.0,2765.0,0.72,18.201,364,214,160,54,150,112,38,89,0.01,0.0
1015,2426,26-09-2019 20:30:00,0,3838.0,2679.0,0.698,18.089,262,162,116,46,100,66,34,8,0.0,0.0
1015,2427,26-09-2019 20:32:00,0,3835.0,2801.0,0.73,18.213,335,204,164,40,131,91,40,72,0.0,0.0
1015,2428,26-09-2019 20:34:00,0,3989.5,2939.5,0.7365,18.9755,389,206,166,40,183,138,45,82,0.0,0.0
1015,2429,26-09-2019 20:36:00,0,4144.0,3078.0,0.743,19.738,483,276,214,62,207,151,56,24,0.0,0.0
1015,2430,26-09-2019 20:38:00,0,3837.0,2756.0,0.718,18.17,152,93,66,27,59,34,25,0,0.0,0.0
1015,2431,26-09-2019 20:40:00,0,3941.0,2853.0,0.724,18.687,451,271,222,49,180,136,44,71,0.05,0.0
1015,2432,26-09-2019 20:42:00,0,3859.0,2689.0,0.697,18.182,237,102,73,29,135,96,39,89,0.0,0.0
1015,2433,26-09-2019 20:44:00,0,3825.0,2724.0,0.712,18.089,121,67,42,25,54,36,18,32,0.0,0.0
1015,2434,26-09-2019 20:46:00,0,3732.0,2674.0,0.717,17.665,489,293,233,60,196,156,40,41,0.01,0.0
1015,2435,26-09-2019 20:48:00,0,3857.0,2671.0,0.692,18.156,282,175,128,47,107,78,29,39,0.01,0.0
1015,2436,26-09-2019 20:50:00,0,3830.0,2788.0,0.728,18.179,74,55,20,35,19,6,13,8,0.0,0.0
1015,2437,26-09-2019 20:52:00,0,4065.0,2854.0,0.702,19.178,239,114,82,32,125,91,34,90,0.01,0.0
1015,2438,26-09-2019 20:54:00,0,3824.0,2800.0,0.732,18.167,327,214,163,51,113,80,33,56,0.0,0.0
1015,2439,26-09-2019 20:56:00,0,3740.0,2656.0,0.71,17.676,546,321,263,58,225,168,57,84,0.0,0.0
1015,2440,26-09-2019 20:58:00,0,3862.0,2690.0,0.696,18.194,30,11,3,8,19,3,16,12,0.0,0.0
1015,2441,26-09-2019 21:00:00,0,3740.0,2627.0,0.702,17.645,46,14,4,10,32,12,20,2,0.0,0.0
1015,2442,26-09-2019 21:02:00,0,3608.0,2566.0,0.711,17.058,270,152,111,41,118,81,37,56,0.0,0.0
1015,2443,26-09-2019 21:04:00,0,3499.0,2566.0,0.733,16.627,410,245,196,49,165,119,46,63,0.0,0.0
1015,2444,26-09-2019 21:06:00,0,3749.0,2648.0,0.706,17.705,399,283,213,70,116,78,38,27,0.0,0.0
1015,2445,26-09-2019 21:08:00,0,3753.0,2630.5,0.701,17.6995,86,31,14,17,55,25,30,10,0.0,0.0
1015,2446,26-09-2019 21:10:00,0,3757.0,2613.0,0.696,17.694,370,209,173,36,161,115,46,72,0.03,0.0
1015,2447,26-09-2019 21:12:00,0,3619.0,2572.0,0.711,17.109,367,211,158,53,156,116,40,91,0.0,0.0
1015,2448,26-09-2019 21:14:00,0,3873.0,2633.0,0.68,18.175,348,175,138,37,173,139,34,83,0.0,0.0
1015,2449,26-09-2019 21:16:00,0,3736.0,2606.0,0.698,17.605,125,57,39,18,68,40,28,7,0.0,0.0
1015,2450,26-09-2019 21:18:00,0,3760.0,2611.0,0.694,17.706,412,209,168,41,203,163,40,44,0.0,0.0
1015,2451,26-09-2019 21:20:00,0,3739.0,2554.0,0.683,17.562,397,224,177,47,173,126,47,33,0.0,0.0
1015,2452,26-09-2019 21:22:00,0,3513.0,2566.0,0.731,16.681,215,144,91,53,71,35,36,0,0.0,0.0
1015,2453,26-09-2019 21:24:00,0,3520.0,2473.0,0.703,16.607,110,56,21,35,54,34,20,0,0.0,0.0
1015,2454,26-09-2019 21:26:00,0,3864.0,2639.0,0.683,18.148,359,167,124,43,192,151,41,71,0.0,0.0
1015,2455,26-09-2019 21:28:00,0,3743.0,2591.0,0.692,17.618,280,155,103,52,125,93,32,60,0.01,0.0
1015,2456,26-09-2019 21:30:00,0,3746.0,2581.0,0.689,17.619,402,238,195,43,164,128,36,41,0.0,0.0
1015,2457,26-09-2019 21:32:00,0,3515.0,2466.0,0.702,16.581,318,181,139,42,137,108,29,36,0.0,0.0
1015,2458,26-09-2019 21:34:00,0,3853.0,2713.0,0.704,18.186,170,102,65,37,68,38,30,0,0.0,0.0
1015,2459,26-09-2019 21:36:00,0,3737.0,2615.0,0.7,17.621,222,125,91,34,97,71,26,75,0.0,0.0
1015,2460,26-09-2019 21:38:00,0,3495.0,2551.0,0.73,16.597,367,189,145,44,178,136,42,30,0.0,0.0
1015,2461,26-09-2019 21:40:00,0,3758.0,2596.0,0.691,17.68,315,173,124,49,142,97,45,19,0.0,0.0
1015,2462,26-09-2019 21:42:00,0,3811.0,2619.5,0.6875,17.9155,437,282,224,58,155,119,36,46,0.0,0.0
1015,2463,26-09-2019 21:44:00,0,3864.0,2643.0,0.684,18.151,168,95,74,21,73,44,29,18,0.0,0.0
1015,2464,26-09-2019 21:46:00,0,3869.0,2619.0,0.677,18.145,5,0,0,0,5,2,3,0,0.0,0.0
1015,2465,26-09-2019 21:48:00,0,3515.0,2513.0,0.715,16.631,99,55,35,20,44,17,27,12,0.0,0.0
1015,2466,26-09-2019 21:50:00,0,3532.0,2472.0,0.7,16.652,390,232,180,52,158,119,39,64,0.01,0.0
1015,2467,26-09-2019 21:52:00,0,3285.0,2386.0,0.726,15.585,286,194,147,47,92,67,25,28,0.0,0.0
1015,2468,26-09-2019 21:54:00,0,3395.0,2383.0,0.702,16.014,254,152,113,39,102,65,37,29,0.0,0.0
1015,2469,26-09-2019 21:56:00,0,3528.0,2427.0,0.688,16.586,505,244,199,45,261,204,57,76,0.01,0.0
1015,2470,26-09-2019 21:58:00,0,3639.0,2572.0,0.707,17.185,287,176,142,34,111,80,31,49,0.0,0.0
1015,2471,26-09-2019 22:00:00,0,3619.0,2583.0,0.714,17.12,271,144,114,30,127,90,37,45,0.0,0.0
1015,2472,26-09-2019 22:02:00,0,3890.0,2655.0,0.682,18.267,297,196,146,50,101,70,31,69,0.0,0.0
1015,2473,26-09-2019 22:04:00,0,3508.0,2569.0,0.732,16.669,335,202,151,51,133,84,49,31,0.0,0.0
1015,2474,26-09-2019 22:06:00,0,3843.0,2677.0,0.696,18.107,175,85,45,40,90,51,39,0,0.0,0.0
1015,2475,26-09-2019 22:08:00,0,3513.0,2448.0,0.697,16.551,261,124,94,30,137,98,39,67,0.0,0.0
1015,2476,26-09-2019 22:10:00,0,3506.0,2557.0,0.729,16.646,511,306,242,64,205,147,58,58,0.0,0.0
1015,2477,26-09-2019 22:12:00,0,3607.0,2570.0,0.712,17.058,386,222,176,46,164,122,42,85,0.03,0.0
1015,2478,26-09-2019 22:14:00,0,3499.0,2568.0,0.734,16.628,421,250,198,52,171,131,40,62,0.0,0.0
1015,2479,26-09-2019 22:16:00,0,3674.5,2610.0,0.7115,17.3665,466,260,206,54,206,162,44,58,0.0,0.0
1015,2480,26-09-2019 22:18:00,0,3850.0,2652.0,0.689,18.105,364,187,156,31,177,137,40,63,0.0,0.0
1015,2481,26-09-2019 22:20:00,0,4055.0,2896.0,0.714,19.185,314,155,116,39,159,118,41,71,0.02,0.0
1015,2482,26-09-2019 22:22:00,0,3858.0,2681.0,0.695,18.17,342,176,135,41,166,130,36,84,0.03,0.0
1015,2483,26-09-2019 22:24:00,0,3845.0,2748.0,0.715,18.193,167,106,57,49,61,25,36,3,0.01,0.0
1015,2484,26-09-2019 22:26:00,0,3848.0,2715.0,0.706,18.167,501,301,251,50,200,155,45,88,0.01,0.0
1015,2485,26-09-2019 22:28:00,0,3834.0,2744.0,0.716,18.144,262,131,99,32,131,102,29,72,0.0,0.0
1015,2486,26-09-2019 22:30:00,0,3853.0,2747.0,0.713,18.224,102,34,15,19,68,46,22,14,0.0,0.0
1015,2487,26-09-2019 22:32:00,0,3844.0,2708.0,0.704,18.145,155,101,80,21,54,40,14,30,0.0,0.0
1015,2488,26-09-2019 22:34:00,0,3625.0,2531.0,0.698,17.087,280,149,108,41,131,85,46,36,0.02,0.0
1015,2489,26-09-2019 22:36:00,0,3838.0,2748.0,0.716,18.162,451,272,208,64,179,133,46,58,0.01,0.0
1015,2490,26-09-2019 22:38:00,0,3632.0,2564.0,0.706,17.147,380,290,222,68,90,61,29,18,0.0,0.0
1015,2491,26-09-2019 22:40:00,0,3505.0,2540.0,0.725,16.621,436,252,207,45,184,141,43,71,0.0,0.0
1015,2492,26-09-2019 22:42:00,0,3853.0,2637.0,0.684,18.1,267,171,133,38,96,73,23,51,0.0,0.0
1015,2493,26-09-2019 22:44:00,0,3738.0,2598.0,0.695,17.604,459,227,183,44,232,177,55,64,0.0,0.0
1015,2494,26-09-2019 22:46:00,0,3877.0,2657.0,0.685,18.219,282,88,53,35,194,130,64,13,0.0,0.0
1015,2495,26-09-2019 22:48:00,0,3837.0,2666.0,0.695,18.072,251,128,94,34,123,102,21,100,0.0,0.0
1015,2496,26-09-2019 22:50:00,0,3727.5,2593.5,0.696,17.5595,226,131,102,29,95,68,27,38,0.0,0.0
1015,2497,26-09-2019 22:52:00,0,3618.0,2521.0,0.697,17.047,428,287,227,60,141,108,33,51,0.0,0.0
1015,2498,26-09-2019 22:54:00,0,3513.0,2508.0,0.714,16.617,95,66,38,28,29,13,16,1,0.0,0.0
1015,2499,26-09-2019 22:56:00,0,3861.0,2684.0,0.695,18.183,277,163,138,25,114,95,19,38,0.0,0.0
1015,2500,26-09-2019 22:58:00,0,3751.0,2585.0,0.689,17.643,445,232,193,39,213,173,40,85,0.0,0.0
1015,2501,26-09-2019 23:00:00,0,3857.0,2660.0,0.69,18.14,514,404,323,81,110,74,36,50,0.03,0.0
1015,2502,26-09-2019 23:02:00,0,3857.0,2729.0,0.707,18.22,291,224,168,56,67,44,23,2,0.0,0.0
1015,2503,26-09-2019 23:04:00,0,3836.0,2731.0,0.712,18.139,173,127,85,42,46,24,22,22,0.0,0.0
1015,2504,26-09-2019 23:06:00,0,3870.0,2631.0,0.68,18.163,385,243,197,46,142,96,46,73,0.01,0.0
1015,2505,26-09-2019 23:08:00,0,3877.0,2637.0,0.68,18.195,214,100,66,34,114,77,37,30,0.0,0.0
1015,2506,26-09-2019 23:10:00,0,3618.0,2571.0,0.711,17.101,521,313,252,61,208,155,53,74,0.0,0.0
1015,2507,26-09-2019 23:12:00,0,3872.0,2618.0,0.676,18.155,356,178,133,45,178,134,44,52,0.0,0.0
1015,2508,26-09-2019 23:14:00,0,3886.0,2616.0,0.673,18.207,215,123,91,32,92,69,23,45,0.0,0.0
1015,2509,26-09-2019 23:16:00,0,3870.0,2661.0,0.687,18.196,76,37,20,17,39,25,14,2,0.0,0.0
1015,2510,26-09-2019 23:18:00,0,3855.0,2663.0,0.691,18.139,198,123,104,19,75,61,14,28,0.0,0.0
1015,2511,26-09-2019 23:20:00,0,3625.0,2527.0,0.697,17.083,458,307,246,61,151,108,43,98,0.0,0.0
1015,2512,26-09-2019 23:22:00,0,3548.0,2444.0,0.689,16.687,115,59,32,27,56,27,29,0,0.0,0.0
1015,2513,26-09-2019 23:24:00,0,3712.0,2516.5,0.6785,17.413,432,266,204,62,166,131,35,71,0.0,0.0
1015,2514,26-09-2019 23:26:00,0,3876.0,2589.0,0.668,18.139,28,19,9,10,9,4,5,0,0.0,0.0
1015,2515,26-09-2019 23:28:00,0,3844.0,2720.0,0.707,18.159,99,55,42,13,44,29,15,2,0.0,0.0
1015,2516,26-09-2019 23:30:00,0,3848.0,2663.0,0.692,18.111,380,228,184,44,152,124,28,51,0.06,0.0
1015,2517,26-09-2019 23:32:00,0,3841.0,2689.0,0.7,18.112,482,275,220,55,207,152,55,61,0.02,0.0
1015,2518,26-09-2019 23:34:00,0,3517.0,2483.0,0.706,16.606,239,143,118,25,96,71,25,18,0.0,0.0
1015,2519,26-09-2019 23:36:00,0,3766.0,2609.0,0.693,17.728,530,318,251,67,212,170,42,76,0.0,0.0
1015,2520,26-09-2019 23:38:00,0,3881.0,2603.0,0.671,18.176,351,182,144,38,169,116,53,29,0.08,0.0
1015,2521,26-09-2019 23:40:00,0,3868.0,2600.0,0.672,18.119,359,198,149,49,161,125,36,56,0.05,0.0
1015,2522,26-09-2019 23:42:00,0,4058.0,2886.0,0.711,19.186,359,238,198,40,121,92,29,69,0.03,0.0
1015,2523,26-09-2019 23:44:00,0,3743.0,2622.0,0.7,17.651,256,149,113,36,107,80,27,26,0.0,0.0
1015,2524,26-09-2019 23:46:00,0,3643.0,2533.0,0.695,17.157,378,230,175,55,148,110,38,45,0.0,0.0
1015,2525,26-09-2019 23:48:00,0,3867.0,2628.0,0.68,18.147,134,101,57,44,33,14,19,0,0.0,0.0
1015,2526,26-09-2019 23:50:00,0,3519.0,2509.0,0.713,16.643,460,255,201,54,205,152,53,79,0.0,0.0
1015,2527,26-09-2019 23:52:00,0,3850.0,2701.0,0.701,18.159,231,148,111,37,83,61,22,78,0.0,0.0
1015,2528,26-09-2019 23:54:00,0,3855.0,2655.0,0.689,18.127,69,57,20,37,12,5,7,5,0.0,0.0
1015,2529,26-09-2019 23:56:00,0,3873.0,2644.0,0.683,18.187,338,165,142,23,173,135,38,56,0.0,0.0
1015,2530,26-09-2019 23:58:00,0,3752.5,2598.0,0.693,17.661,238,143,106,37,95,66,29,21,0.0,0.0
1015,2531,27-09-2019 00:00:00,0,3632.0,2552.0,0.703,17.135,455,234,187,47,221,175,46,54,0.0,0.0
1015,2532,27-09-2019 00:02:00,0,3768.0,2547.0,0.676,17.667,44,17,5,12,27,9,18,0,0.0,0.0
1015,2533,27-09-2019 00:04:00,0,3853.0,2627.0,0.682,18.092,22,7,3,4,15,7,8,0,0.0,0.0
1015,2534,27-09-2019 00:06:00,0,3759.0,2569.0,0.683,17.654,0,0,0,0,0,0,0,0,0.0,0.0
1015,2535,27-09-2019 00:08:00,0,3539.0,2392.0,0.676,16.593,0,0,0,0,0,0,0,0,0.0,0.0
1015,2536,27-09-2019 00:10:00,0,3298.0,2268.0,0.688,15.507,0,0,0,0,0,0,0,0,0.0,0.0
1015,2537,27-09-2019 00:12:00,0,3341.0,2181.0,0.653,15.577,0,0,0,0,0,0,0,0,0.01,0.0
1015,2538,27-09-2019 00:14:00,0,2978.0,2026.0,0.68,13.976,0,0,0,0,0,0,0,0,0.0,0.0
1015,2539,27-09-2019 00:16:00,0,2875.0,1949.0,0.678,13.486,0,0,0,0,0,0,0,0,0.0,0.0
1015,2540,27-09-2019 00:18:00,0,2752.0,1933.0,0.702,12.985,0,0,0,0,0,0,0,0,0.0,0.0
1015,2541,27-09-2019 00:20:00,0,2776.0,1869.0,0.673,13.009,0,0,0,0,0,0,0,0,0.0,0.0
1015,2542,27-09-2019 00:22:00,0,2771.0,1789.0,0.646,12.899,0,0,0,0,0,0,0,0,0.0,0.0
1015,2543,27-09-2019 00:24:00,0,2425.0,1722.0,0.71,11.46,27,16,13,3,11,6,5,0,0.0,0.0
1015,2544,27-09-2019 00:26:00,0,2410.0,1706.0,0.708,11.386,274,160,133,27,114,78,36,38,0.0,0.0
1015,2545,27-09-2019 00:28:00,0,2761.0,1881.0,0.681,12.963,219,129,95,34,90,65,25,50,0.0,0.0
1015,2546,27-09-2019 00:30:00,0,2785.0,1831.0,0.657,13.002,356,207,154,53,149,105,44,54,0.0,0.0
1015,2547,27-09-2019 00:32:00,0,2887.5,1936.0,0.67,13.521,312,179,140,39,133,101,32,67,0.0,0.0
1015,2548,27-09-2019 00:34:00,0,2990.0,2041.0,0.683,14.04,376,221,184,37,155,110,45,67,0.01,0.0
1015,2549,27-09-2019 00:36:00,0,3069.0,2161.0,0.704,14.486,414,210,168,42,204,164,40,94,0.0,0.0
1015,2550,27-09-2019 00:38:00,0,3879.0,2604.0,0.671,18.165,215,133,101,32,82,47,35,12,0.0,0.0
1015,2551,27-09-2019 00:40:00,0,3298.0,2322.0,0.704,15.567,270,148,105,43,122,92,30,28,0.0,0.0
1015,2552,27-09-2019 00:42:00,0,3645.0,2525.0,0.693,17.156,174,82,65,17,92,77,15,97,0.03,0.0
1015,2553,27-09-2019 00:44:00,0,3751.0,2596.0,0.692,17.656,352,181,154,27,171,133,38,40,0.0,0.0
1015,2554,27-09-2019 00:46:00,0,3527.0,2445.0,0.693,16.602,483,340,272,68,143,105,38,248,0.0,0.0
1015,2555,27-09-2019 00:48:00,0,3849.0,2720.0,0.707,18.177,422,310,249,61,112,92,20,89,0.0,0.0
1015,2556,27-09-2019 00:50:00,0,4076.0,2831.0,0.695,19.192,420,263,223,40,157,119,38,62,0.06,0.0
1015,2557,27-09-2019 00:52:00,0,3838.0,2784.0,0.725,18.206,120,59,31,28,61,26,35,0,0.0,0.0
1015,2558,27-09-2019 00:54:00,0,4102.0,2794.0,0.681,19.255,312,167,121,46,145,116,29,61,0.02,0.0
1015,2559,27-09-2019 00:56:00,0,4090.0,2759.0,0.675,19.169,418,253,198,55,165,124,41,32,0.01,0.0
1015,2560,27-09-2019 00:58:00,0,4175.0,2938.0,0.704,19.703,420,272,207,65,148,111,37,26,0.0,0.0
1015,2561,27-09-2019 01:00:00,0,3505.0,2528.0,0.721,16.611,160,128,82,46,32,17,15,11,0.0,0.0
1015,2562,27-09-2019 01:02:00,0,3873.0,2665.0,0.688,18.212,357,218,176,42,139,113,26,84,0.02,0.0
1015,2563,27-09-2019 01:04:00,0,3948.0,2749.0,0.696,18.6,431,245,196,49,186,142,44,81,0.0,0.0
1015,2564,27-09-2019 01:06:00,0,3945.5,2741.0,0.6945,18.581,380,207,164,43,173,130,43,47,0.0,0.0
1015,2565,27-09-2019 01:08:00,0,3943.0,2733.0,0.693,18.562,194,121,91,30,73,52,21,17,0.0,0.0
1015,2566,27-09-2019 01:10:00,0,3862.0,2713.0,0.702,18.219,340,192,149,43,148,99,49,32,0.0,0.0
1015,2567,27-09-2019 01:12:00,0,3836.0,2692.0,0.702,18.094,16,10,8,2,6,5,1,2,0.0,0.0
1015,2568,27-09-2019 01:14:00,0,3852.0,2697.0,0.7,18.162,351,212,175,37,139,110,29,67,0.02,0.0
1015,2569,27-09-2019 01:16:00,0,3516.0,2471.0,0.703,16.588,268,148,115,33,120,93,27,25,0.04,0.0
1015,2570,27-09-2019 01:18:00,0,3497.0,2496.0,0.714,16.543,159,96,61,35,63,42,21,16,0.0,0.0
1015,2571,27-09-2019 01:20:00,0,3507.0,2542.0,0.725,16.632,191,71,39,32,120,82,38,3,0.0,0.0
1015,2572,27-09-2019 01:22:00,0,3758.0,2572.0,0.684,17.654,477,298,235,63,179,129,50,52,0.0,0.0
1015,2573,27-09-2019 01:24:00,0,3744.0,2558.0,0.683,17.585,174,112,85,27,62,38,24,26,0.0,0.0
1015,2574,27-09-2019 01:26:00,0,3530.0,2500.0,0.708,16.678,120,36,28,8,84,56,28,3,0.0,0.0
1015,2575,27-09-2019 01:28:00,0,3518.0,2504.0,0.712,16.633,104,20,16,4,84,58,26,1,0.0,0.0
1015,2576,27-09-2019 01:30:00,0,3415.0,2392.0,0.7,16.105,281,156,124,32,125,89,36,41,0.0,0.0
1015,2577,27-09-2019 01:32:00,0,3299.0,2331.0,0.707,15.582,316,189,146,43,127,98,29,33,0.01,0.0
1015,2578,27-09-2019 01:34:00,0,3322.0,2255.0,0.679,15.588,160,86,64,22,74,54,20,3,0.0,0.0
1015,2579,27-09-2019 01:36:00,0,3205.0,2188.0,0.683,15.051,105,74,59,15,31,18,13,0,0.0,0.0
1015,2580,27-09-2019 01:38:00,0,2971.0,2085.0,0.702,14.014,1,0,0,0,1,0,1,0,0.0,0.0
1015,2581,27-09-2019 01:40:00,0,2976.0,2072.0,0.6965,14.019,33,24,21,3,9,6,3,0,0.0,0.0
1015,2582,27-09-2019 01:42:00,0,2981.0,2059.0,0.691,14.024,0,0,0,0,0,0,0,0,0.0,0.0
1015,2583,27-09-2019 01:44:00,0,2751.0,1927.0,0.7,12.973,0,0,0,0,0,0,0,0,0.0,0.0
1015,2584,27-09-2019 01:46:00,0,2788.0,1815.0,0.651,12.994,0,0,0,0,0,0,0,0,0.0,0.0
1015,2585,27-09-2019 01:48:00,0,2419.0,1703.0,0.704,11.416,0,0,0,0,0,0,0,0,0.0,0.0
1015,2586,27-09-2019 01:50:00,0,2305.0,1615.0,0.701,10.872,7,3,2,1,4,0,4,0,0.0,0.0
1015,2587,27-09-2019 01:52:00,0,2435.0,1622.0,0.666,11.389,74,49,20,29,25,1,24,0,0.0,0.0
1015,2588,27-09-2019 01:54:00,0,2416.0,1745.0,0.722,11.453,214,116,81,35,98,65,33,25,0.0,0.0
1015,2589,27-09-2019 01:56:00,0,2779.0,1874.0,0.674,13.025,165,107,75,32,58,35,23,4,0.0,0.0
1015,2590,27-09-2019 01:58:00,0,2730.0,1966.0,0.72,12.932,267,159,125,34,108,83,25,24,0.0,0.0
1015,2591,27-09-2019 02:00:00,0,2756.0,1914.0,0.694,12.98,358,217,169,48,141,108,33,28,0.0,0.0
1015,2592,27-09-2019 02:02:00,0,2767.0,1856.0,0.671,12.955,261,154,119,35,107,90,17,53,0.0,0.0
1015,2593,27-09-2019 02:04:00,0,3001.0,2017.0,0.672,14.057,83,57,38,19,26,7,19,0,0.0,0.0
1015,2594,27-09-2019 02:06:00,0,2863.0,1970.0,0.688,13.463,238,130,96,34,108,69,39,17,0.0,0.0
1015,2595,27-09-2019 02:08:00,0,2878.0,1958.0,0.68,13.506,307,163,119,44,144,108,36,51,0.06,0.0
1015,2596,27-09-2019 02:10:00,0,2960.0,2097.0,0.708,13.983,149,90,70,20,59,45,14,95,0.0,0.0
1015,2597,27-09-2019 02:12:00,0,3093.0,2159.0,0.698,14.577,165,84,61,23,81,54,27,14,0.0,0.0
1015,2598,27-09-2019 02:14:00,0,3217.5,2183.0,0.679,15.0935,442,265,191,74,177,130,47,21,0.0,0.0
1015,2599,27-09-2019 02:16:00,0,3342.0,2207.0,0.66,15.61,337,234,161,73,103,66,37,0,0.0,0.0
1015,2600,27-09-2019 02:18:00,0,3306.0,2296.0,0.694,15.567,113,88,53,35,25,0,25,0,0.0,0.0
1015,2601,27-09-2019 02:20:00,0,3314.0,2227.0,0.672,15.524,9,0,0,0,9,0,9,0,0.0,0.0
1015,2602,27-09-2019 02:22:00,0,3083.0,2136.0,0.693,14.514,174,124,94,30,50,31,19,9,0.0,0.0
1015,2603,27-09-2019 02:24:00,0,3342.0,2242.0,0.671,15.649,264,167,133,34,97,75,22,70,0.0,0.0
1015,2604,27-09-2019 02:26:00,0,3302.0,2316.0,0.701,15.573,318,174,129,45,144,115,29,46,0.04,0.0
1015,2605,27-09-2019 02:28:00,0,3071.0,2147.0,0.699,14.478,475,319,253,66,156,115,41,21,0.0,0.0
1015,2606,27-09-2019 02:30:00,0,3300.0,2336.0,0.708,15.59,91,75,49,26,16,7,9,0,0.0,0.0
1015,2607,27-09-2019 02:32:00,0,3876.0,2652.0,0.684,18.207,82,51,36,15,31,24,7,26,0.0,0.0
1015,2608,27-09-2019 02:34:00,0,3645.0,2551.0,0.7,17.187,351,241,191,50,110,76,34,17,0.08,0.0
1015,2609,27-09-2019 02:36:00,0,3331.0,2224.0,0.668,15.588,395,181,122,59,214,152,62,9,0.0,0.0
1015,2610,27-09-2019 02:38:00,0,3295.0,2286.0,0.694,15.516,218,120,77,43,98,57,41,32,0.0,0.0
1015,2611,27-09-2019 02:40:00,0,3539.0,2398.0,0.678,16.601,467,270,231,39,197,150,47,70,0.0,0.0
1015,2612,27-09-2019 02:42:00,0,3296.0,2358.0,0.715,15.597,214,105,81,24,109,83,26,45,0.0,0.0
1015,2613,27-09-2019 02:44:00,0,3305.0,2254.0,0.682,15.516,45,13,5,8,32,14,18,1,0.0,0.0
1015,2614,27-09-2019 02:46:00,0,3547.0,2406.0,0.678,16.641,22,14,2,12,8,0,8,0,0.0,0.0
1015,2615,27-09-2019 02:48:00,0,3322.5,2257.5,0.6795,15.5905,14,8,0,8,6,0,6,0,0.0,0.0
1015,2616,27-09-2019 02:50:00,0,3098.0,2109.0,0.681,14.54,4,4,0,4,0,0,0,0,0.0,0.0
1015,2617,27-09-2019 02:52:00,0,2996.0,1991.0,0.664,14.009,11,11,0,11,0,0,0,0,0.0,0.0
1015,2618,27-09-2019 02:54:00,0,2769.0,1890.0,0.682,13.004,11,1,0,1,10,0,10,0,0.0,0.0
1015,2619,27-09-2019 02:56:00,0,2777.0,1803.0,0.649,12.937,2,0,0,0,2,0,2,0,0.0,0.0
1015,2620,27-09-2019 02:58:00,0,2421.0,1724.0,0.712,11.449,40,30,24,6,10,3,7,0,0.0,0.0
1015,2621,27-09-2019 03:00:00,0,2197.0,1521.0,0.692,10.34,1,1,0,1,0,0,0,0,0.0,0.0
1015,2622,27-09-2019 03:02:00,0,2222.0,1494.0,0.672,10.41,4,4,3,1,0,0,0,0,0.0,0.0
1015,2623,27-09-2019 03:04:00,0,2218.0,1468.0,0.662,10.363,1,1,0,1,0,0,0,0,0.0,0.0
1015,2624,27-09-2019 03:06:00,0,2229.0,1454.0,0.652,10.393,1,1,0,1,0,0,0,0,0.0,0.0
1015,2625,27-09-2019 03:08:00,0,2103.0,1417.0,0.674,9.857,20,20,12,8,0,0,0,0,0.0,0.0
1015,2626,27-09-2019 03:10:00,0,1846.0,1370.0,0.742,8.789,14,14,3,11,0,0,0,0,0.0,0.0
1015,2627,27-09-2019 03:12:00,0,1869.0,1348.0,0.721,8.855,1,0,0,0,1,0,1,0,0.0,0.0
1015,2628,27-09-2019 03:14:00,0,1864.0,1320.0,0.708,8.807,0,0,0,0,0,0,0,0,0.0,0.0
1015,2629,27-09-2019 03:16:00,0,1872.0,1313.0,0.701,8.831,2,1,0,1,1,0,1,0,0.0,0.0
1015,2630,27-09-2019 03:18:00,0,1888.0,1281.0,0.679,8.856,33,30,3,27,3,0,3,0,0.0,0.0
1015,2631,27-09-2019 03:20:00,0,1981.0,1411.0,0.712,9.37,214,121,84,37,93,60,33,30,0.0,0.0
1015,2632,27-09-2019 03:22:00,0,2192.5,1565.0,0.7135,10.373,250,162,123,39,88,60,28,45,0.0,0.0
1015,2633,27-09-2019 03:24:00,0,2404.0,1719.0,0.715,11.376,191,118,84,34,73,51,22,42,0.0,0.0
1015,2634,27-09-2019 03:26:00,0,2772.0,1854.0,0.669,12.975,97,73,42,31,24,12,12,0,0.0,0.0
1015,2635,27-09-2019 03:28:00,0,2667.0,1787.0,0.67,12.488,190,116,82,34,74,51,23,66,0.0,0.0
1015,2636,27-09-2019 03:30:00,0,3091.0,2091.0,0.677,14.494,153,93,75,18,60,48,12,42,0.01,0.0
1015,2637,27-09-2019 03:32:00,0,2979.0,2063.0,0.693,14.024,88,50,35,15,38,25,13,0,0.0,0.0
1015,2638,27-09-2019 03:34:00,0,3324.0,2205.0,0.663,15.536,343,201,163,38,142,108,34,45,0.01,0.0
1015,2639,27-09-2019 03:36:00,0,3308.0,2309.0,0.698,15.592,385,279,205,74,106,70,36,5,0.0,0.0
1015,2640,27-09-2019 03:38:00,0,3322.0,2210.0,0.665,15.537,218,129,103,26,89,66,23,63,0.04,0.0
1015,2641,27-09-2019 03:40:00,0,3349.0,2178.0,0.65,15.609,96,67,45,22,29,21,8,16,0.0,0.0
1015,2642,27-09-2019 03:42:00,0,3438.0,2314.0,0.673,16.107,205,107,83,24,98,74,24,29,0.02,0.0
1015,2643,27-09-2019 03:44:00,0,3298.0,2295.0,0.696,15.538,361,171,136,35,190,131,59,15,0.0,0.0
1015,2644,27-09-2019 03:46:00,0,3312.0,2296.0,0.693,15.591,259,139,101,38,120,95,25,41,0.0,0.0
1015,2645,27-09-2019 03:48:00,0,3293.0,2326.0,0.706,15.552,202,143,114,29,59,43,16,27,0.0,0.0
1015,2646,27-09-2019 03:50:00,0,3300.0,2323.0,0.704,15.576,404,257,196,61,147,108,39,56,0.0,0.0
1015,2647,27-09-2019 03:52:00,0,3414.0,2355.0,0.69,16.061,282,160,121,39,122,95,27,27,0.0,0.0
1015,2648,27-09-2019 03:54:00,0,3306.0,2270.0,0.686,15.541,50,34,16,18,16,4,12,0,0.0,0.0
1015,2649,27-09-2019 03:56:00,0,3311.0,2276.5,0.6875,15.5675,216,115,89,26,101,72,29,12,0.0,0.0
1015,2650,27-09-2019 03:58:00,0,3316.0,2283.0,0.689,15.594,284,152,107,45,132,89,43,30,0.0,0.0
1015,2651,27-09-2019 04:00:00,0,3336.0,2188.0,0.656,15.567,84,46,22,24,38,5,33,0,0.0,0.0
1015,2652,27-09-2019 04:02:00,0,3324.0,2195.0,0.66,15.526,364,203,151,52,161,115,46,35,0.0,0.0
1015,2653,27-09-2019 04:04:00,0,3293.0,2287.0,0.694,15.507,172,77,47,30,95,60,35,6,0.05,0.0
1015,2654,27-09-2019 04:06:00,0,3324.0,2210.0,0.665,15.543,17,6,0,6,11,3,8,0,0.0,0.0
1015,2655,27-09-2019 04:08:00,0,3099.0,2129.0,0.687,14.567,132,93,54,39,39,20,19,2,0.0,0.0
1015,2656,27-09-2019 04:10:00,0,3314.0,2189.0,0.66,15.482,118,74,59,15,44,35,9,36,0.0,0.0
1015,2657,27-09-2019 04:12:00,0,3327.0,2171.0,0.653,15.513,20,7,4,3,13,1,12,0,0.0,0.0
1015,2658,27-09-2019 04:14:00,0,2974.0,2080.0,0.699,14.022,0,0,0,0,0,0,0,0,0.0,0.0
1015,2659,27-09-2019 04:16:00,0,3016.0,1952.0,0.647,14.043,1,0,0,0,1,0,1,0,0.0,0.0
1015,2660,27-09-2019 04:18:00,0,2763.0,1842.0,0.666,12.928,4,2,1,1,2,1,1,0,0.0,0.0
1015,2661,27-09-2019 04:20:00,0,2681.0,1760.0,0.656,12.514,26,3,1,2,23,0,23,0,0.0,0.0
1015,2662,27-09-2019 04:22:00,0,2431.0,1674.0,0.688,11.432,14,5,0,5,9,3,6,0,0.0,0.0
1015,2663,27-09-2019 04:24:00,0,2442.0,1609.0,0.659,11.402,3,2,0,2,1,0,1,0,0.0,0.0
1015,2664,27-09-2019 04:26:00,0,2201.0,1550.0,0.704,10.388,6,1,0,1,5,2,3,0,0.0,0.0
1015,2665,27-09-2019 04:28:00,0,2212.0,1518.0,0.686,10.395,0,0,0,0,0,0,0,0,0.0,0.0
1015,2666,27-09-2019 04:30:00,0,2217.5,1478.5,0.6665,10.3745,7,4,0,4,3,1,2,0,0.01,0.0
1015,2667,27-09-2019 04:32:00,0,2223.0,1439.0,0.647,10.354,1,0,0,0,1,1,0,0,0.0,0.0
1015,2668,27-09-2019 04:34:00,0,2107.0,1404.0,0.666,9.858,1,0,0,0,1,0,1,0,0.01,0.0
1015,2669,27-09-2019 04:36:00,0,1983.0,1370.0,0.691,9.329,1,0,0,0,1,0,1,0,0.0,0.0
1015,2670,27-09-2019 04:38:00,0,1859.0,1333.0,0.717,8.8,8,0,0,0,8,1,7,0,0.0,0.0
1015,2671,27-09-2019 04:40:00,0,1874.0,1312.0,0.7,8.835,7,0,0,0,7,2,5,0,0.0,0.0
1015,2672,27-09-2019 04:42:00,0,1887.0,1283.0,0.68,8.855,19,0,0,0,19,0,19,0,0.0,0.0
1015,2673,27-09-2019 04:44:00,0,1887.0,1248.0,0.661,8.818,8,0,0,0,8,0,8,0,0.0,0.0
1015,2674,27-09-2019 04:46:00,0,1894.0,1229.0,0.649,8.825,18,0,0,0,18,2,16,0,0.0,0.0
1015,2675,27-09-2019 04:48:00,0,1900.0,1216.0,0.64,8.833,1,0,0,0,1,0,1,0,0.0,0.0
1015,2676,27-09-2019 04:50:00,0,1896.0,1211.0,0.639,8.809,74,39,27,12,35,13,22,0,0.0,0.0
1015,2677,27-09-2019 04:52:00,0,1850.0,1373.0,0.742,8.808,176,115,83,32,61,33,28,14,0.0,0.0
1015,2678,27-09-2019 04:54:00,0,2434.0,1666.0,0.684,11.435,255,144,103,41,111,75,36,17,0.0,0.0
1015,2679,27-09-2019 04:56:00,0,2426.0,1708.0,0.704,11.449,267,143,109,34,124,93,31,9,0.0,0.0
1015,2680,27-09-2019 04:58:00,0,2774.0,1844.0,0.665,12.971,314,157,106,51,157,109,48,34,0.0,0.0
1015,2681,27-09-2019 05:00:00,0,2991.0,1966.0,0.657,13.964,142,82,57,25,60,43,17,49,0.0,0.0
1015,2682,27-09-2019 05:02:00,0,3441.0,2344.0,0.681,16.155,209,122,94,28,87,66,21,52,0.0,0.0
1015,2683,27-09-2019 05:04:00,0,3227.5,2144.0,0.663,15.0915,238,97,70,27,141,103,38,23,0.04,0.0
1015,2684,27-09-2019 05:06:00,0,3014.0,1944.0,0.645,14.028,242,146,116,30,96,73,23,35,0.0,0.0
1015,2685,27-09-2019 05:08:00,0,2978.0,2055.0,0.69,14.011,209,118,91,27,91,64,27,55,0.02,0.0
1015,2686,27-09-2019 05:10:00,0,3318.0,2229.0,0.672,15.54,257,163,116,47,94,71,23,39,0.0,0.0
1015,2687,27-09-2019 05:12:00,0,3214.0,2173.0,0.676,15.072,193,99,71,28,94,68,26,33,0.03,0.0
1015,2688,27-09-2019 05:14:00,0,2969.0,2057.0,0.693,13.976,129,78,64,14,51,34,17,24,0.0,0.0
1015,2689,27-09-2019 05:16:00,0,3333.0,2184.0,0.655,15.552,436,244,188,56,192,155,37,57,0.05,0.0
1015,2690,27-09-2019 05:18:00,0,3315.0,2283.0,0.689,15.591,107,59,44,15,48,32,16,1,0.0,0.0
1015,2691,27-09-2019 05:20:00,0,3336.0,2196.0,0.658,15.576,69,57,34,23,12,3,9,0,0.0,0.0
1015,2692,27-09-2019 05:22:00,0,3356.0,2190.0,0.653,15.65,44,36,15,21,8,2,6,0,0.0,0.0
1015,2693,27-09-2019 05:24:00,0,3340.0,2175.0,0.651,15.57,0,0,0,0,0,0,0,0,0.0,0.0
1015,2694,27-09-2019 05:26:00,0,2987.0,2058.0,0.689,14.047,0,0,0,0,0,0,0,0,0.0,0.0
1015,2695,27-09-2019 05:28:00,0,2887.0,1925.0,0.667,13.508,18,16,8,8,2,1,1,0,0.0,0.0
1015,2696,27-09-2019 05:30:00,0,2780.0,1813.0,0.652,12.963,8,5,3,2,3,1,2,0,0.0,0.0
1015,2697,27-09-2019 05:32:00,0,2423.0,1701.0,0.702,11.43,0,0,0,0,0,0,0,0,0.0,0.0
1015,2698,27-09-2019 05:34:00,0,2445.0,1611.0,0.659,11.415,20,17,12,5,3,0,3,0,0.0,0.0
1015,2699,27-09-2019 05:36:00,0,2443.0,1606.0,0.657,11.406,0,0,0,0,0,0,0,0,0.0,0.0
1015,2700,27-09-2019 05:38:00,0,2331.5,1543.5,0.662,10.8965,0,0,0,0,0,0,0,0,0.0,0.0
1015,2701,27-09-2019 05:40:00,0,2220.0,1481.0,0.667,10.387,8,8,1,7,0,0,0,0,0.0,0.0
1015,2702,27-09-2019 05:42:00,0,2102.0,1413.0,0.672,9.845,1,1,0,1,0,0,0,0,0.0,0.0
1015,2703,27-09-2019 05:44:00,0,1858.0,1365.0,0.735,8.833,9,9,0,9,0,0,0,0,0.0,0.0
1015,2704,27-09-2019 05:46:00,0,1857.0,1319.0,0.71,8.779,3,2,2,0,1,0,1,0,0.0,0.0
1015,2705,27-09-2019 05:48:00,0,1872.0,1281.0,0.684,8.797,18,12,4,8,6,0,6,0,0.0,0.0
1015,2706,27-09-2019 05:50:00,0,1887.0,1250.0,0.662,8.821,3,3,2,1,0,0,0,0,0.0,0.0
1015,2707,27-09-2019 05:52:00,0,1894.0,1208.0,0.637,8.801,8,7,1,6,1,0,1,0,0.0,0.0
1015,2708,27-09-2019 05:54:00,0,1778.0,1193.0,0.671,8.328,3,2,1,1,1,0,1,0,0.0,0.0
1015,2709,27-09-2019 05:56:00,0,1644.0,1179.0,0.718,7.782,14,14,3,11,0,0,0,0,0.0,0.0
1015,2710,27-09-2019 05:58:00,0,1646.0,1171.0,0.712,7.783,6,6,1,5,0,0,0,0,0.0,0.0
1015,2711,27-09-2019 06:00:00,1,1660.0,1144.0,0.689,7.807,22,19,6,13,3,2,1,0,0.0,0.0
1015,2712,27-09-2019 06:02:00,1,1650.0,1180.0,0.715,7.808,211,107,91,16,104,77,27,22,0.0,0.0
1015,2713,27-09-2019 06:04:00,1,1864.0,1383.0,0.742,8.876,173,105,80,25,68,22,46,40,0.0,0.0
1015,2714,27-09-2019 06:06:00,1,2406.0,1745.0,0.725,11.411,239,109,87,22,130,65,65,69,0.0,0.0
1015,2715,27-09-2019 06:08:00,1,3213.0,2159.0,0.672,15.052,121,59,33,26,62,3,59,57,0.0,0.0
1015,2716,27-09-2019 06:10:00,1,3286.0,2342.0,0.713,15.541,178,75,59,16,103,24,79,51,0.0,0.06
1015,2717,27-09-2019 06:12:00,1,3559.5,2540.0,0.7135,16.8385,97,29,17,12,68,0,68,53,0.0,0.0
1015,2718,27-09-2019 06:14:00,1,3833.0,2738.0,0.714,18.136,101,28,13,15,73,0,73,62,0.0,0.1
1015,2719,27-09-2019 06:16:00,1,3940.0,2895.0,0.735,18.73,99,18,7,11,81,0,81,65,0.0,0.06
1015,2720,27-09-2019 06:18:00,1,4055.0,2982.0,0.735,19.28,90,28,24,4,62,3,59,49,0.0,0.12
1015,2721,27-09-2019 06:20:00,1,3256.0,2521.0,0.774,15.618,290,134,114,20,156,124,32,41,0.17,0.01
1015,2722,27-09-2019 06:22:00,1,4026.0,3030.0,0.753,19.216,149,43,22,21,106,30,76,45,0.09,0.02
1015,2723,27-09-2019 06:24:00,1,3813.0,2904.0,0.762,18.237,444,217,177,40,227,155,72,58,0.12,0.13
1015,2724,27-09-2019 06:26:00,1,3782.0,2967.0,0.785,18.187,173,74,58,16,99,33,66,90,0.03,0.0
1015,2725,27-09-2019 06:28:00,1,3753.0,3046.0,0.812,18.159,90,19,8,11,71,0,71,56,0.0,0.0
1015,2726,27-09-2019 06:30:00,1,4085.0,3348.0,0.82,19.802,185,35,20,15,150,67,83,49,0.12,0.06
1015,2727,27-09-2019 06:32:00,1,3867.0,3142.0,0.812,18.714,293,150,111,39,143,101,42,64,0.04,0.0
1015,2728,27-09-2019 06:34:00,1,3999.0,3137.0,0.784,19.228,133,45,27,18,88,20,68,45,0.01,0.11
1015,2729,27-09-2019 06:36:00,1,3938.0,3311.0,0.841,19.18,139,63,47,16,76,4,72,61,0.0,0.16
1015,2730,27-09-2019 06:38:00,1,3233.0,2634.0,0.815,15.654,0,0,0,0,0,0,0,0,0.0,0.01
1015,2731,27-09-2019 06:40:00,1,3768.0,2950.0,0.783,18.111,481,244,206,38,237,191,46,43,0.19,0.0
1015,2732,27-09-2019 06:42:00,1,3935.0,3420.0,0.869,19.29,198,93,72,21,105,40,65,47,0.01,0.01
1015,2733,27-09-2019 06:44:00,1,4478.0,3793.0,0.847,21.843,146,83,61,22,63,50,13,1,0.05,0.01
1015,2734,27-09-2019 06:46:00,1,4123.0,3422.0,0.8285,20.033,45,25,10,15,20,13,7,0,0.0,0.0
1015,2735,27-09-2019 06:48:00,1,3768.0,3051.0,0.81,18.223,146,77,60,17,69,56,13,0,0.08,0.0
1015,2736,27-09-2019 06:50:00,1,3530.0,2928.0,0.83,17.149,444,256,210,46,188,154,34,87,0.01,0.0
1015,2737,27-09-2019 06:52:00,1,3451.0,2791.0,0.809,16.687,241,121,91,30,120,80,40,14,0.0,0.0
1015,2738,27-09-2019 06:54:00,1,3769.0,3001.0,0.796,18.171,238,104,72,32,134,83,51,31,0.07,0.01
1015,2739,27-09-2019 06:56:00,1,3712.0,3150.0,0.848,18.114,131,42,25,17,89,0,89,61,0.01,0.04
1015,2740,27-09-2019 06:58:00,1,3924.0,3423.0,0.872,19.25,541,335,275,60,206,149,57,12,0.0,0.01
1015,2741,27-09-2019 07:00:00,1,3736.0,3155.0,0.844,18.212,673,427,351,76,246,188,58,0,0.07,0.0
1015,2742,27-09-2019 07:02:00,1,3408.0,2864.0,0.84,16.599,94,42,28,14,52,24,28,0,0.02,0.01
1015,2743,27-09-2019 07:04:00,1,3656.0,3023.0,0.827,17.753,33,18,9,9,15,3,12,0,0.0,0.0
1015,2744,27-09-2019 07:06:00,1,3519.0,2978.0,0.846,17.162,80,64,30,34,16,1,15,0,0.0,0.0
1015,2745,27-09-2019 07:08:00,1,3519.0,2976.0,0.845,17.161,12,6,1,5,6,0,6,0,0.0,0.0
1015,2746,27-09-2019 07:10:00,1,3430.0,2823.0,0.823,16.642,1,1,0,1,0,0,0,0,0.0,0.0
1015,2747,27-09-2019 07:12:00,1,3305.0,2791.0,0.844,16.112,0,0,0,0,0,0,0,0,0.0,0.0
1015,2748,27-09-2019 07:14:00,1,3201.0,2734.0,0.854,15.637,1,0,0,0,1,1,0,0,0.0,0.0
1015,2749,27-09-2019 07:16:00,1,3209.0,2661.0,0.829,15.588,1,1,0,1,0,0,0,0,0.0,0.01
1015,2750,27-09-2019 07:18:00,1,3238.0,2600.0,0.803,15.635,0,0,0,0,0,0,0,0,0.0,0.0
1015,2751,27-09-2019 07:20:00,1,3055.0,2534.0,0.831,14.842,26,19,6,13,7,4,3,0,0.0,0.0
1015,2752,27-09-2019 07:22:00,1,2872.0,2468.0,0.859,14.049,0,0,0,0,0,0,0,0,0.0,0.0
1015,2753,27-09-2019 07:24:00,1,2766.0,2321.0,0.839,13.466,1,0,0,0,1,1,0,0,0.0,0.0
1015,2754,27-09-2019 07:26:00,1,2642.0,2318.0,0.877,12.977,0,0,0,0,0,0,0,0,0.0,0.0
1015,2755,27-09-2019 07:28:00,1,2678.0,2262.0,0.845,13.055,0,0,0,0,0,0,0,0,0.0,0.0
1015,2756,27-09-2019 07:30:00,1,2676.0,2256.0,0.843,13.043,10,5,3,2,5,3,2,0,0.0,0.0
1015,2757,27-09-2019 07:32:00,1,2651.0,2292.0,0.865,12.983,2,2,1,1,0,0,0,0,0.0,0.0
1015,2758,27-09-2019 07:34:00,1,2674.0,2233.0,0.835,13.008,6,5,2,3,1,1,0,0,0.0,0.0
1015,2759,27-09-2019 07:36:00,1,2544.0,2166.0,0.851,12.423,3,0,0,0,3,1,2,0,0.0,0.0
1015,2760,27-09-2019 07:38:00,1,2433.0,2140.0,0.88,11.953,1,0,0,0,1,1,0,0,0.0,0.0
1015,2761,27-09-2019 07:40:00,1,2312.0,2085.0,0.902,11.417,16,13,7,6,3,1,2,0,0.0,0.0
1015,2762,27-09-2019 07:42:00,1,2319.0,2095.0,0.904,11.456,81,64,32,32,17,11,6,0,0.0,0.0
1015,2763,27-09-2019 07:44:00,1,2437.0,2167.0,0.889,12.001,271,141,110,31,130,88,42,47,0.01,0.0
1015,2764,27-09-2019 07:46:00,1,2883.0,2441.0,0.847,14.06,74,12,5,7,62,4,58,55,0.01,0.0
1015,2765,27-09-2019 07:48:00,1,3202.0,2662.0,0.831,15.565,93,25,14,11,68,0,68,58,0.0,0.0
1015,2766,27-09-2019 07:50:00,1,3274.0,2913.0,0.89,16.125,110,37,21,16,73,0,73,66,0.0,0.0
1015,2767,27-09-2019 07:52:00,1,3599.0,3160.0,0.878,17.678,140,47,33,14,93,35,58,45,0.09,0.12
1015,2768,27-09-2019 07:54:00,1,3442.5,3022.0,0.878,16.909,407,212,172,40,195,143,52,38,0.06,0.01
1015,2769,27-09-2019 07:56:00,1,3286.0,2884.0,0.878,16.14,100,25,16,9,75,0,75,64,0.01,0.0
1015,2770,27-09-2019 07:58:00,1,3735.0,3149.0,0.843,18.2,169,62,48,14,107,44,63,42,0.1,0.05
1015,2771,27-09-2019 08:00:00,1,3372.0,3000.0,0.89,16.608,100,27,12,15,73,0,73,62,0.0,0.02
1015,2772,27-09-2019 08:02:00,1,3670.0,3328.0,0.907,18.145,159,76,50,26,83,35,48,12,0.07,0.04
1015,2773,27-09-2019 08:04:00,1,3169.0,2824.0,0.891,15.611,362,195,157,38,167,109,58,38,0.01,0.01
1015,2774,27-09-2019 08:06:00,1,3161.0,2825.0,0.894,15.582,577,401,322,79,176,134,42,10,0.03,0.0
1015,2775,27-09-2019 08:08:00,1,3172.0,2801.0,0.883,15.599,304,141,107,34,163,89,74,35,0.0,0.0
1015,2776,27-09-2019 08:10:00,1,3702.0,3254.0,0.879,18.19,114,37,17,20,77,0,77,69,0.01,0.0
1015,2777,27-09-2019 08:12:00,1,3816.0,3369.0,0.883,18.765,145,67,45,22,78,35,43,33,0.05,0.08
1015,2778,27-09-2019 08:14:00,1,3190.0,2757.0,0.864,15.622,62,54,30,24,8,3,5,0,0.0,0.02
1015,2779,27-09-2019 08:16:00,1,2646.0,2288.0,0.865,12.958,17,13,1,12,4,0,4,0,0.0,0.0
1015,2780,27-09-2019 08:18:00,1,2887.0,2444.0,0.847,14.081,0,0,0,0,0,0,0,0,0.0,0.0
1015,2781,27-09-2019 08:20:00,1,2887.0,2424.0,0.84,14.06,3,3,1,2,0,0,0,0,0.0,0.0
1015,2782,27-09-2019 08:22:00,1,2883.0,2391.0,0.829,14.007,10,7,2,5,3,0,3,0,0.0,0.0
1015,2783,27-09-2019 08:24:00,1,2886.0,2405.0,0.833,14.032,5,2,0,2,3,2,1,0,0.0,0.0
1015,2784,27-09-2019 08:26:00,1,2882.0,2456.0,0.852,14.075,7,7,1,6,0,0,0,0,0.0,0.0
1015,2785,27-09-2019 08:28:00,1,2882.5,2435.5,0.845,14.0545,6,5,2,3,1,1,0,0,0.0,0.0
1015,2786,27-09-2019 08:30:00,1,2883.0,2415.0,0.838,14.034,4,3,0,3,1,1,0,0,0.0,0.0
1015,2787,27-09-2019 08:32:00,1,2645.0,2339.0,0.884,13.009,7,7,2,5,0,0,0,0,0.0,0.0
1015,2788,27-09-2019 08:34:00,1,2652.0,2309.0,0.871,13.006,1,1,0,1,0,0,0,0,0.0,0.0
1015,2789,27-09-2019 08:36:00,1,2653.0,2278.0,0.858,12.976,1,1,1,0,0,0,0,0,0.0,0.0
1015,2790,27-09-2019 08:38:00,1,2637.0,2316.0,0.878,12.955,0,0,0,0,0,0,0,0,0.0,0.0
1015,2791,27-09-2019 08:40:00,1,2545.0,2205.0,0.867,12.467,1,1,0,1,0,0,0,0,0.0,0.0
1015,2792,27-09-2019 08:42:00,1,2300.0,2156.0,0.938,11.45,3,3,0,3,0,0,0,0,0.0,0.0
1015,2793,27-09-2019 08:44:00,1,2299.0,2149.0,0.935,11.438,1,1,0,1,0,0,0,0,0.0,0.0
1015,2794,27-09-2019 08:46:00,1,2304.0,2114.0,0.918,11.417,3,3,0,3,0,0,0,0,0.0,0.0
1015,2795,27-09-2019 08:48:00,1,2300.0,2174.0,0.945,11.468,3,2,0,2,1,1,0,0,0.0,0.0
1015,2796,27-09-2019 08:50:00,1,2314.0,2081.0,0.899,11.419,9,9,2,7,0,0,0,0,0.0,0.0
1015,2797,27-09-2019 08:52:00,1,2315.0,2143.0,0.925,11.495,3,3,0,3,0,0,0,0,0.0,0.02
1015,2798,27-09-2019 08:54:00,1,2309.0,2121.0,0.918,11.446,2,1,0,1,1,0,1,0,0.0,0.0
1015,2799,27-09-2019 08:56:00,1,2322.0,2098.0,0.904,11.471,2,1,0,1,1,0,1,0,0.0,0.0
1015,2800,27-09-2019 08:58:00,1,2207.0,1995.0,0.904,10.906,82,63,34,29,19,5,14,0,0.0,0.0
1015,2801,27-09-2019 09:00:00,1,2423.0,2198.0,0.907,11.98,127,91,54,37,36,12,24,5,0.0,0.0
1015,2802,27-09-2019 09:02:00,1,2639.5,2360.0,0.895,13.0115,52,30,10,20,22,0,22,0,0.0,0.0
1015,2803,27-09-2019 09:04:00,1,2856.0,2522.0,0.883,14.043,101,96,63,33,5,0,5,0,0.0,0.0
1015,2804,27-09-2019 09:06:00,1,2851.0,2568.0,0.901,14.076,31,21,8,13,10,3,7,2,0.0,0.0
1015,2805,27-09-2019 09:08:00,1,2826.0,2622.0,0.928,14.036,124,64,40,24,60,16,44,37,0.0,0.0
1015,2806,27-09-2019 09:10:00,1,3165.0,2883.0,0.911,15.661,92,32,17,15,60,4,56,55,0.0,0.0
1015,2807,27-09-2019 09:12:00,1,3346.0,3122.0,0.933,16.642,192,82,63,19,110,62,48,53,0.0,0.0
1015,2808,27-09-2019 09:14:00,1,3353.0,3131.0,0.934,16.675,95,19,11,8,76,0,76,65,0.0,0.02
1015,2809,27-09-2019 09:16:00,1,3703.0,3252.0,0.878,18.189,123,17,13,4,106,34,72,54,0.02,0.07
1015,2810,27-09-2019 09:18:00,1,3374.0,3007.0,0.891,16.623,316,175,133,42,141,90,51,62,0.06,0.27
1015,2811,27-09-2019 09:20:00,1,3600.0,3204.0,0.89,17.73,124,66,49,17,58,37,21,13,0.0,0.51
1015,2812,27-09-2019 09:22:00,1,3479.0,3146.0,0.904,17.191,137,71,39,32,66,45,21,0,0.05,0.0
1015,2813,27-09-2019 09:24:00,1,2873.0,2477.0,0.862,14.061,72,44,23,21,28,6,22,0,0.0,0.0
1015,2814,27-09-2019 09:26:00,1,3158.0,2871.0,0.909,15.623,166,97,67,30,69,35,34,5,0.08,0.0
1015,2815,27-09-2019 09:28:00,1,3390.0,2990.0,0.882,16.666,497,279,225,54,218,160,58,7,0.0,0.0
1015,2816,27-09-2019 09:30:00,1,3601.0,3153.0,0.876,17.677,96,37,16,21,59,0,59,66,0.0,0.0
1015,2817,27-09-2019 09:32:00,1,3688.0,3298.0,0.894,18.183,106,36,17,19,70,2,68,61,0.0,0.0
1015,2818,27-09-2019 09:34:00,1,3727.0,3201.0,0.859,18.229,150,38,24,14,112,48,64,33,0.07,0.0
1015,2819,27-09-2019 09:36:00,1,3184.5,2760.0,0.8685,15.604,16,15,7,8,1,0,1,0,0.0,0.0
1015,2820,27-09-2019 09:38:00,1,2642.0,2319.0,0.878,12.979,46,42,9,33,4,1,3,0,0.0,0.0
1015,2821,27-09-2019 09:40:00,1,2868.0,2463.0,0.859,14.028,5,4,0,4,1,1,0,0,0.0,0.0
1015,2822,27-09-2019 09:42:00,1,2867.0,2430.0,0.848,13.988,0,0,0,0,0,0,0,0,0.0,0.0
1015,2823,27-09-2019 09:44:00,1,2882.0,2422.0,0.841,14.036,3,0,0,0,3,1,2,0,0.0,0.0
1015,2824,27-09-2019 09:46:00,1,2879.0,2461.0,0.855,14.068,7,3,1,2,4,1,3,0,0.0,0.0
1015,2825,27-09-2019 09:48:00,1,2868.0,2478.0,0.864,14.046,1,1,0,1,0,0,0,0,0.0,0.0
1015,2826,27-09-2019 09:50:00,1,2860.0,2470.0,0.864,14.005,10,6,2,4,4,0,4,0,0.0,0.0
1015,2827,27-09-2019 09:52:00,1,2861.0,2538.0,0.887,14.082,8,4,1,3,4,2,2,0,0.0,0.0
1015,2828,27-09-2019 09:54:00,1,2863.0,2486.0,0.868,14.033,4,1,1,0,3,2,1,0,0.0,0.0
1015,2829,27-09-2019 09:56:00,1,2879.0,2464.0,0.856,14.072,1,0,0,0,1,0,1,0,0.0,0.0
1015,2830,27-09-2019 09:58:00,1,2753.0,2424.0,0.88,13.529,1,0,0,0,1,1,0,0,0.0,0.0
1015,2831,27-09-2019 10:00:00,1,2634.0,2354.0,0.894,12.984,0,0,0,0,0,0,0,0,0.0,0.0
1015,2832,27-09-2019 10:02:00,1,2657.0,2268.0,0.854,12.978,53,34,15,19,19,5,14,0,0.0,0.0
1015,2833,27-09-2019 10:04:00,1,2626.0,2399.0,0.914,13.002,70,33,11,22,37,14,23,5,0.0,0.0
1015,2834,27-09-2019 10:06:00,1,2857.0,2504.0,0.877,14.027,17,14,1,13,3,2,1,0,0.0,0.0
1015,2835,27-09-2019 10:08:00,1,2752.0,2424.0,0.881,13.526,4,0,0,0,4,1,3,0,0.0,0.0
1015,2836,27-09-2019 10:10:00,1,2712.5,2333.0,0.86,13.271,6,1,0,1,5,2,3,0,0.0,0.0
1015,2837,27-09-2019 10:12:00,1,2673.0,2242.0,0.839,13.016,2,0,0,0,2,0,2,0,0.0,0.0
1015,2838,27-09-2019 10:14:00,1,2435.0,2167.0,0.89,11.995,10,3,0,3,7,1,6,0,0.0,0.0
1015,2839,27-09-2019 10:16:00,1,2307.0,2095.0,0.908,11.407,3,0,0,0,3,1,2,0,0.0,0.0
1015,2840,27-09-2019 10:18:00,1,2334.0,2035.0,0.872,11.449,37,15,8,7,22,3,19,0,0.0,0.0
1015,2841,27-09-2019 10:20:00,1,2302.0,2147.0,0.933,11.445,24,18,13,5,6,3,3,0,0.0,0.0
1015,2842,27-09-2019 10:22:00,1,2415.0,2215.0,0.917,11.968,2,0,0,0,2,0,2,0,0.0,0.0
1015,2843,27-09-2019 10:24:00,1,2535.0,2223.0,0.877,12.449,1,0,0,0,1,0,1,0,0.0,0.0
1015,2844,27-09-2019 10:26:00,1,2298.0,2175.0,0.946,11.461,1,0,0,0,1,1,0,0,0.0,0.0
1015,2845,27-09-2019 10:28:00,1,2289.0,2141.0,0.935,11.388,3,0,0,0,3,2,1,0,0.0,0.0
1015,2846,27-09-2019 10:30:00,1,2309.0,2116.0,0.916,11.442,3,0,0,0,3,1,2,0,0.0,0.0
1015,2847,27-09-2019 10:32:00,1,2310.0,2087.0,0.904,11.412,95,58,45,13,37,23,14,1,0.0,0.0
1015,2848,27-09-2019 10:34:00,1,2304.0,2124.0,0.922,11.43,31,15,8,7,16,3,13,0,0.0,0.0
1015,2849,27-09-2019 10:36:00,1,2308.0,2128.0,0.922,11.45,3,0,0,0,3,1,2,0,0.0,0.0
1015,2850,27-09-2019 10:38:00,1,2317.0,2061.0,0.889,11.413,64,40,30,10,24,15,9,4,0.0,0.0
1015,2851,27-09-2019 10:40:00,1,2291.0,2164.0,0.945,11.421,126,77,50,27,49,13,36,18,0.0,0.0
1015,2852,27-09-2019 10:42:00,1,2628.0,2352.0,0.895,12.959,141,59,45,14,82,28,54,73,0.0,0.0
1015,2853,27-09-2019 10:44:00,1,2894.5,2592.0,0.8955,14.2735,101,42,22,20,59,2,57,53,0.0,0.0
1015,2854,27-09-2019 10:46:00,1,3161.0,2832.0,0.896,15.588,105,21,9,12,84,6,78,56,0.0,0.0
1015,2855,27-09-2019 10:48:00,1,3372.0,3050.0,0.904,16.661,117,24,12,12,93,29,64,40,0.06,0.0
1015,2856,27-09-2019 10:50:00,1,3553.0,3301.0,0.929,17.653,435,205,168,37,230,187,43,88,0.06,0.0
1015,2857,27-09-2019 10:52:00,1,3194.0,2742.0,0.858,15.62,105,56,45,11,49,41,8,107,0.02,0.0
1015,2858,27-09-2019 10:54:00,1,3252.0,3000.0,0.922,16.133,283,125,92,33,158,99,59,35,0.0,0.0
1015,2859,27-09-2019 10:56:00,1,3718.0,3225.0,0.867,18.219,100,19,10,9,81,3,78,52,0.0,0.0
1015,2860,27-09-2019 10:58:00,1,3687.0,3302.0,0.895,18.183,174,46,41,5,128,58,70,58,0.05,0.0
1015,2861,27-09-2019 11:00:00,1,3895.0,3520.0,0.904,19.245,646,331,276,55,315,258,57,26,0.13,0.0
1015,2862,27-09-2019 11:02:00,1,3594.0,3231.0,0.899,17.739,459,283,230,53,176,98,78,51,0.01,0.0
1015,2863,27-09-2019 11:04:00,1,3677.0,3337.0,0.907,18.181,109,26,14,12,83,12,71,74,0.0,0.0
1015,2864,27-09-2019 11:06:00,1,3918.0,3441.0,0.878,19.245,127,33,18,15,94,10,84,67,0.0,0.0
1015,2865,27-09-2019 11:08:00,1,3706.0,3338.0,0.901,18.296,582,311,234,77,271,209,62,6,0.06,0.0
1015,2866,27-09-2019 11:10:00,1,3357.0,3062.0,0.912,16.616,897,588,480,108,309,235,74,0,0.08,0.0
1015,2867,27-09-2019 11:12:00,1,3484.0,3153.0,0.905,17.218,139,98,71,27,41,25,16,3,0.0,0.0
1015,2868,27-09-2019 11:14:00,1,3349.0,3064.0,0.915,16.589,61,45,25,20,16,5,11,0,0.0,0.0
1015,2869,27-09-2019 11:16:00,1,3479.0,3138.0,0.902,17.181,66,54,18,36,12,1,11,0,0.0,0.0
1015,2870,27-09-2019 11:18:00,1,3383.0,3014.5,0.891,16.6655,19,19,2,17,0,0,0,0,0.0,0.0
1015,2871,27-09-2019 11:20:00,1,3287.0,2891.0,0.88,16.15,1,1,0,1,0,0,0,0,0.0,0.0
1015,2872,27-09-2019 11:22:00,1,3188.0,2795.0,0.877,15.654,5,5,1,4,0,0,0,0,0.0,0.0
1015,2873,27-09-2019 11:24:00,1,3155.0,2806.0,0.889,15.538,1,1,0,1,0,0,0,0,0.0,0.0
1015,2874,27-09-2019 11:26:00,1,3189.0,2798.0,0.877,15.664,0,0,0,0,0,0,0,0,0.0,0.0
1015,2875,27-09-2019 11:28:00,1,3176.0,2737.0,0.862,15.545,6,6,2,4,0,0,0,0,0.0,0.0
1015,2876,27-09-2019 11:30:00,1,3197.0,2741.0,0.857,15.629,0,0,0,0,0,0,0,0,0.0,0.0
1015,2877,27-09-2019 11:32:00,1,3202.0,2708.0,0.846,15.615,5,5,1,4,0,0,0,0,0.0,0.0
1015,2878,27-09-2019 11:34:00,1,2947.0,2652.0,0.9,14.548,34,25,15,10,9,1,8,0,0.0,0.0
1015,2879,27-09-2019 11:36:00,1,2833.0,2592.0,0.915,14.031,2,2,2,0,0,0,0,0,0.0,0.0
1015,2880,27-09-2019 11:38:00,1,2848.0,2528.0,0.888,14.021,0,0,0,0,0,0,0,0,0.0,0.0
1015,2881,27-09-2019 11:40:00,1,2858.0,2483.0,0.869,14.011,19,11,7,4,8,4,4,0,0.0,0.0
1015,2882,27-09-2019 11:42:00,1,2741.0,2449.0,0.893,13.512,0,0,0,0,0,0,0,0,0.0,0.0
1015,2883,27-09-2019 11:44:00,1,2631.0,2393.0,0.91,13.015,1,0,0,0,1,0,1,0,0.0,0.0
1015,2884,27-09-2019 11:46:00,1,2645.0,2327.0,0.88,12.999,6,0,0,0,6,0,6,0,0.0,0.0
1015,2885,27-09-2019 11:48:00,1,2637.0,2351.0,0.892,12.994,0,0,0,0,0,0,0,0,0.0,0.0
1015,2886,27-09-2019 11:50:00,1,2640.0,2327.0,0.882,12.978,6,6,2,4,0,0,0,0,0.0,0.0
1015,2887,27-09-2019 11:52:00,1,2632.0,2357.0,0.896,12.9785,1,1,0,1,0,0,0,0,0.0,0.0
1015,2888,27-09-2019 11:54:00,1,2624.0,2387.0,0.91,12.979,0,0,0,0,0,0,0,0,0.0,0.0
1015,2889,27-09-2019 11:56:00,1,2630.0,2336.0,0.888,12.95,0,0,0,0,0,0,0,0,0.0,0.0
1015,2890,27-09-2019 11:58:00,1,2664.0,2293.0,0.861,13.033,14,10,5,5,4,2,2,0,0.0,0.0
1015,2891,27-09-2019 12:00:00,1,2662.0,2306.0,0.866,13.039,2,2,1,1,0,0,0,0,0.0,0.0
1015,2892,27-09-2019 12:02:00,1,2524.0,2265.0,0.897,12.454,0,0,0,0,0,0,0,0,0.0,0.0
1015,2893,27-09-2019 12:04:00,1,2316.0,2141.0,0.924,11.495,14,10,0,10,4,1,3,0,0.0,0.0
1015,2894,27-09-2019 12:06:00,1,2312.0,2111.0,0.913,11.447,1,0,0,0,1,0,1,0,0.0,0.0
1015,2895,27-09-2019 12:08:00,1,2305.0,2068.0,0.897,11.372,4,2,0,2,2,0,2,0,0.0,0.0
1015,2896,27-09-2019 12:10:00,1,2331.0,2068.0,0.887,11.475,77,47,35,12,30,21,9,0,0.0,0.0
1015,2897,27-09-2019 12:12:00,1,2296.0,2124.0,0.925,11.396,117,116,99,17,1,0,1,0,0.0,0.0
1015,2898,27-09-2019 12:14:00,1,2322.0,2105.0,0.907,11.479,53,52,46,6,1,0,1,0,0.0,0.0
1015,2899,27-09-2019 12:16:00,1,2200.0,2076.0,0.943,10.966,19,19,1,18,0,0,0,0,0.0,0.0
1015,2900,27-09-2019 12:18:00,1,2199.0,2042.0,0.928,10.926,10,9,1,8,1,0,1,0,0.0,0.0
1015,2901,27-09-2019 12:20:00,1,2202.0,2054.0,0.932,10.95,28,25,5,20,3,0,3,0,0.0,0.0
1015,2902,27-09-2019 12:22:00,1,2294.0,2163.0,0.943,11.434,103,61,40,21,42,28,14,3,0.0,0.0
1015,2903,27-09-2019 12:24:00,1,2314.0,2131.0,0.921,11.477,29,12,0,12,17,0,17,0,0.0,0.0
1015,2904,27-09-2019 12:26:00,1,2258.0,2103.0,0.9315,11.224,5,2,1,1,3,0,3,0,0.0,0.0
1015,2905,27-09-2019 12:28:00,1,2202.0,2075.0,0.942,10.971,21,21,1,20,0,0,0,0,0.0,0.0
1015,2906,27-09-2019 12:30:00,1,2074.0,2001.0,0.965,10.387,64,49,31,18,15,8,7,2,0.0,0.0
1015,2907,27-09-2019 12:32:00,1,2323.0,2085.0,0.898,11.459,1,0,0,0,1,0,1,0,0.0,0.0
1015,2908,27-09-2019 12:34:00,1,2287.0,2171.0,0.949,11.416,7,0,0,0,7,0,7,0,0.0,0.0
1015,2909,27-09-2019 12:36:00,1,2292.0,2189.0,0.955,11.454,8,0,0,0,8,0,8,0,0.0,0.0
1015,2910,27-09-2019 12:38:00,1,2296.0,2170.0,0.945,11.448,2,0,0,0,2,0,2,0,0.0,0.0
1015,2911,27-09-2019 12:40:00,1,2293.0,2174.0,0.948,11.441,1,0,0,0,1,0,1,0,0.0,0.0
1015,2912,27-09-2019 12:42:00,1,2303.0,2154.0,0.935,11.456,8,0,0,0,8,0,8,0,0.0,0.0
1015,2913,27-09-2019 12:44:00,1,2324.0,2068.0,0.89,11.445,6,5,1,4,1,0,1,0,0.0,0.0
1015,2914,27-09-2019 12:46:00,1,2187.0,2054.0,0.939,10.89,18,18,0,18,0,0,0,0,0.0,0.0
1015,2915,27-09-2019 12:48:00,1,2188.0,2070.0,0.946,10.911,17,17,0,17,0,0,0,0,0.0,0.0
1015,2916,27-09-2019 12:50:00,1,2316.0,2097.0,0.906,11.446,98,53,38,15,45,33,12,1,0.0,0.0
1016,1,23-09-2019 11:40:00,1,2358.0,1715.0,0.727,11.19,286,129,81,48,157,117,40,12,0.0,0.05
1016,2,23-09-2019 11:42:00,1,2253.0,1679.0,0.745,10.737,47,0,0,0,47,27,20,0,0.01,0.0
1016,3,23-09-2019 11:44:00,1,2058.0,1506.0,0.732,9.778,2,0,0,0,2,0,2,0,0.0,0.0
1016,4,23-09-2019 11:46:00,1,1766.0,1307.0,0.74,8.404,13,0,0,0,13,5,8,0,0.0,0.0
1016,5,23-09-2019 11:48:00,1,1577.0,1135.0,0.72,7.469,4,0,0,0,4,1,3,0,0.0,0.0
1016,6,23-09-2019 11:50:00,1,1496.0,1005.0,0.672,7.006,69,2,1,1,67,34,33,0,0.0,0.0
1016,7,23-09-2019 11:52:00,1,1280.0,934.0,0.729,6.076,9,0,0,0,9,0,9,0,0.0,0.0
1016,8,23-09-2019 11:54:00,1,1296.0,880.0,0.679,6.083,51,9,4,5,42,16,26,0,0.0,0.0
1016,9,23-09-2019 11:56:00,1,1287.0,835.0,0.649,5.995,115,0,0,0,115,65,50,0,0.0,0.0
1016,10,23-09-2019 11:58:00,1,1192.0,821.0,0.689,5.606,43,0,0,0,43,42,1,0,0.0,0.0
1016,11,23-09-2019 12:00:00,1,1285.0,944.0,0.735,6.106,113,21,6,15,92,64,28,0,0.0,0.0
1016,12,23-09-2019 12:02:00,1,1469.0,1142.0,0.777,7.055,303,165,128,37,138,88,50,15,0.0,0.0
1016,13,23-09-2019 12:04:00,1,1963.0,1479.0,0.754,9.371,392,213,169,44,179,137,42,52,0.0,0.0
1016,14,23-09-2019 12:06:00,1,1990.0,1419.0,0.713,9.413,255,157,115,42,98,72,26,38,0.0,0.0
1016,15,23-09-2019 12:08:00,1,1987.5,1406.0,0.7075,9.3885,338,170,133,37,168,125,43,13,0.0,0.0
1016,16,23-09-2019 12:10:00,1,1985.0,1393.0,0.702,9.364,395,148,104,44,247,181,66,0,0.0,0.0
1016,17,23-09-2019 12:12:00,1,1977.0,1484.0,0.751,9.433,226,99,69,30,127,90,37,4,0.0,0.0
1016,18,23-09-2019 12:14:00,1,1756.0,1241.0,0.707,8.293,213,112,84,28,101,74,27,21,0.0,0.0
1016,19,23-09-2019 12:16:00,1,1761.0,1292.0,0.734,8.37,93,26,15,11,67,35,32,6,0.0,0.0
1016,20,23-09-2019 12:18:00,1,1698.0,1216.0,0.716,8.036,15,8,2,6,7,3,4,0,0.0,0.0
1016,21,23-09-2019 12:20:00,1,1557.0,1171.0,0.752,7.431,248,90,58,32,158,106,52,6,0.0,0.0
1016,22,23-09-2019 12:22:00,1,1552.0,1160.0,0.748,7.398,148,49,17,32,99,49,50,3,0.0,0.0
1016,23,23-09-2019 12:24:00,1,1463.0,1174.0,0.803,7.065,239,84,50,34,155,111,44,2,0.0,0.0
1016,24,23-09-2019 12:26:00,1,1573.0,1179.0,0.75,7.504,289,122,89,33,167,112,55,3,0.0,0.0
1016,25,23-09-2019 12:28:00,1,1450.0,1109.0,0.765,6.94,111,11,2,9,100,55,45,0,0.0,0.0
1016,26,23-09-2019 12:30:00,1,1257.0,967.0,0.769,6.022,8,0,0,0,8,1,7,0,0.0,0.0
1016,27,23-09-2019 12:32:00,1,1293.0,920.0,0.711,6.113,20,4,0,4,16,8,8,0,0.0,0.0
1016,28,23-09-2019 12:34:00,1,1077.0,790.0,0.733,5.118,42,0,0,0,42,0,42,0,0.0,0.0
1016,29,23-09-2019 12:36:00,1,987.0,667.0,0.676,4.627,41,5,2,3,36,0,36,0,0.0,0.0
1016,30,23-09-2019 12:38:00,1,890.0,622.0,0.699,4.195,0,0,0,0,0,0,0,0,0.0,0.0
1016,31,23-09-2019 12:40:00,1,901.0,607.0,0.674,4.222,49,0,0,0,49,21,28,0,0.0,0.0
1016,32,23-09-2019 12:42:00,1,991.0,705.0,0.7085,4.685,33,0,0,0,33,0,33,0,0.0,0.0
1016,33,23-09-2019 12:44:00,1,1081.0,803.0,0.743,5.148,56,0,0,0,56,50,6,0,0.0,0.0
1016,34,23-09-2019 12:46:00,1,1288.0,892.0,0.692,6.063,60,25,9,16,35,17,18,0,0.0,0.0
1016,35,23-09-2019 12:48:00,1,1173.0,885.0,0.755,5.601,9,3,0,3,6,0,6,0,0.0,0.0
1016,36,23-09-2019 12:50:00,1,952.0,816.0,0.857,4.656,8,2,1,1,6,0,6,0,0.0,0.0
1016,37,23-09-2019 12:52:00,1,980.0,747.0,0.762,4.688,16,2,1,1,14,1,13,0,0.0,0.0
1016,38,23-09-2019 12:54:00,1,1181.0,860.0,0.728,5.604,12,3,1,2,9,5,4,0,0.0,0.0
1016,39,23-09-2019 12:56:00,1,1290.0,904.0,0.701,6.083,17,9,2,7,8,3,5,0,0.0,0.0
1016,40,23-09-2019 12:58:00,1,1289.0,869.0,0.674,6.042,0,0,0,0,0,0,0,0,0.0,0.0
1016,41,23-09-2019 13:00:00,1,1192.0,855.0,0.718,5.642,54,3,0,3,51,26,25,0,0.0,0.0
1016,42,23-09-2019 13:02:00,1,1298.0,866.0,0.667,6.075,14,0,0,0,14,1,13,0,0.0,0.0
1016,43,23-09-2019 13:04:00,1,972.0,789.0,0.812,4.702,18,0,0,0,18,0,18,0,0.0,0.0
1016,44,23-09-2019 13:06:00,1,974.0,739.0,0.759,4.655,43,0,0,0,43,2,41,0,0.0,0.0
1016,45,23-09-2019 13:08:00,1,995.0,717.0,0.72,4.715,58,14,8,6,44,16,28,0,0.0,0.0
1016,46,23-09-2019 13:10:00,1,1000.0,679.0,0.678,4.693,15,0,0,0,15,9,6,0,0.0,0.0
1016,47,23-09-2019 13:12:00,1,1164.0,839.0,0.72,5.516,6,0,0,0,6,1,5,0,0.0,0.0
1016,48,23-09-2019 13:14:00,1,973.0,739.0,0.76,4.651,2,0,0,0,2,1,1,0,0.0,0.0
1016,49,23-09-2019 13:16:00,1,1130.5,816.5,0.727,5.358,6,1,0,1,5,2,3,0,0.0,0.0
1016,50,23-09-2019 13:18:00,1,1288.0,894.0,0.694,6.065,92,23,11,12,69,39,30,0,0.0,0.0
1016,51,23-09-2019 13:20:00,1,1286.0,880.0,0.685,6.04,19,5,2,3,14,3,11,0,0.0,0.0
1016,52,23-09-2019 13:22:00,1,1283.0,842.0,0.656,5.987,8,3,0,3,5,1,4,0,0.0,0.0
1016,53,23-09-2019 13:24:00,1,1200.0,838.0,0.699,5.655,22,9,0,9,13,1,12,0,0.0,0.0
1016,54,23-09-2019 13:26:00,1,1295.0,918.0,0.709,6.118,11,3,0,3,8,4,4,0,0.0,0.0
1016,55,23-09-2019 13:28:00,1,1188.0,863.0,0.727,5.636,19,0,0,0,19,5,14,0,0.0,0.0
1016,56,23-09-2019 13:30:00,1,956.0,798.0,0.835,4.649,26,19,1,18,7,1,6,0,0.0,0.0
1016,57,23-09-2019 13:32:00,1,963.0,803.0,0.834,4.681,14,4,0,4,10,4,6,0,0.0,0.0
1016,58,23-09-2019 13:34:00,1,978.0,784.0,0.802,4.721,6,6,0,6,0,0,0,0,0.0,0.0
1016,59,23-09-2019 13:36:00,1,984.0,712.0,0.724,4.664,46,6,2,4,40,17,23,0,0.0,0.0
1016,60,23-09-2019 13:38:00,1,967.0,739.0,0.764,4.629,9,0,0,0,9,3,6,0,0.0,0.0
1016,61,23-09-2019 13:40:00,1,965.0,771.0,0.799,4.657,10,0,0,0,10,7,3,0,0.0,0.0
1016,62,23-09-2019 13:42:00,1,983.0,772.0,0.785,4.726,8,2,1,1,6,2,4,0,0.0,0.0
1016,63,23-09-2019 13:44:00,1,971.0,761.0,0.784,4.67,102,26,12,14,76,44,32,0,0.0,0.0
1016,64,23-09-2019 13:46:00,1,1440.0,1189.0,0.826,6.99,173,99,60,39,74,47,27,15,0.0,0.0
1016,65,23-09-2019 13:48:00,1,1456.0,1137.0,0.781,6.996,228,142,100,42,86,58,28,73,0.0,0.0
1016,66,23-09-2019 13:50:00,1,1723.5,1242.0,0.729,8.1665,201,137,96,41,64,42,22,46,0.0,0.0
1016,67,23-09-2019 13:52:00,1,1991.0,1347.0,0.677,9.337,78,52,23,29,26,3,23,26,0.0,0.0
1016,68,23-09-2019 13:54:00,1,1761.0,1259.0,0.715,8.331,233,130,101,29,103,73,30,64,0.0,0.0
1016,69,23-09-2019 13:56:00,1,1667.0,1224.0,0.734,7.925,184,133,100,33,51,36,15,6,0.0,0.0
1016,70,23-09-2019 13:58:00,1,1891.0,1282.0,0.678,8.87,404,236,181,55,168,121,47,7,0.0,0.0
1016,71,23-09-2019 14:00:00,1,2001.0,1294.0,0.647,9.319,285,175,120,55,110,78,32,15,0.0,0.0
1016,72,23-09-2019 14:02:00,1,1691.0,1164.0,0.689,7.95,81,13,0,13,68,40,28,0,0.0,0.0
1016,73,23-09-2019 14:04:00,1,1604.0,1072.0,0.668,7.507,120,52,14,38,68,37,31,0,0.0,0.0
1016,74,23-09-2019 14:06:00,1,1709.0,1095.0,0.641,7.946,138,25,6,19,113,71,42,0,0.0,0.0
1016,75,23-09-2019 14:08:00,1,1488.0,1066.0,0.717,7.043,58,15,1,14,43,17,26,0,0.0,0.0
1016,76,23-09-2019 14:10:00,1,1502.0,955.0,0.636,6.974,6,1,0,1,5,2,3,0,0.0,0.0
1016,77,23-09-2019 14:12:00,1,1194.0,863.0,0.723,5.66,33,6,3,3,27,19,8,0,0.0,0.0
1016,78,23-09-2019 14:14:00,1,1186.0,846.0,0.714,5.609,4,0,0,0,4,1,3,0,0.0,0.0
1016,79,23-09-2019 14:16:00,1,1185.0,762.0,0.643,5.511,0,0,0,0,0,0,0,0,0.0,0.0
1016,80,23-09-2019 14:18:00,1,1110.0,684.0,0.616,5.13,23,2,0,2,21,12,9,0,0.0,0.0
1016,81,23-09-2019 14:20:00,1,1109.0,694.0,0.626,5.139,24,0,0,0,24,9,15,0,0.0,0.0
1016,82,23-09-2019 14:22:00,1,1230.0,708.0,0.576,5.632,0,0,0,0,0,0,0,0,0.0,0.0
1016,83,23-09-2019 14:24:00,1,1254.0,789.5,0.6285,5.8155,40,2,0,2,38,17,21,0,0.0,0.0
1016,84,23-09-2019 14:26:00,1,1278.0,871.0,0.681,5.999,4,0,0,0,4,1,3,0,0.0,0.0
1016,85,23-09-2019 14:28:00,1,1314.0,882.0,0.672,6.153,1,0,0,0,1,1,0,0,0.0,0.0
1016,86,23-09-2019 14:30:00,1,1194.0,788.0,0.66,5.577,2,0,0,0,2,0,2,0,0.0,0.0
1016,87,23-09-2019 14:32:00,1,1190.0,804.0,0.675,5.58,11,4,1,3,7,4,3,0,0.0,0.0
1016,88,23-09-2019 14:34:00,1,1184.0,841.0,0.71,5.595,34,0,0,0,34,0,34,0,0.0,0.0
1016,89,23-09-2019 14:36:00,1,1310.0,863.0,0.659,6.116,75,1,0,1,74,35,39,0,0.0,0.0
1016,90,23-09-2019 14:38:00,1,1527.0,943.0,0.618,7.061,134,10,6,4,124,68,56,0,0.0,0.0
1016,91,23-09-2019 14:40:00,1,1386.0,890.0,0.643,6.446,70,0,0,0,70,59,11,0,0.0,0.0
1016,92,23-09-2019 14:42:00,1,1188.0,849.0,0.715,5.623,3,0,0,0,3,1,2,0,0.0,0.0
1016,93,23-09-2019 14:44:00,1,1195.0,844.0,0.707,5.641,51,12,7,5,39,8,31,0,0.0,0.0
1016,94,23-09-2019 14:46:00,1,1186.0,851.0,0.718,5.617,25,6,2,4,19,6,13,0,0.0,0.0
1016,95,23-09-2019 14:48:00,1,1278.0,879.0,0.688,6.009,12,1,1,0,11,7,4,0,0.0,0.0
1016,96,23-09-2019 14:50:00,1,1506.0,938.0,0.623,6.974,11,0,0,0,11,2,9,0,0.0,0.0
1016,97,23-09-2019 14:52:00,1,1402.0,901.0,0.643,6.522,27,15,9,6,12,5,7,0,0.0,0.0
1016,98,23-09-2019 14:54:00,1,1405.0,928.0,0.661,6.563,24,6,4,2,18,9,9,0,0.0,0.0
1016,99,23-09-2019 14:56:00,1,1395.0,918.0,0.658,6.513,21,6,2,4,15,3,12,0,0.0,0.0
1016,100,23-09-2019 14:58:00,1,1393.0,934.5,0.6705,6.524,2,0,0,0,2,1,1,0,0.0,0.0
1016,101,23-09-2019 15:00:00,1,1391.0,951.0,0.683,6.535,70,5,4,1,65,33,32,0,0.0,0.0
1016,102,23-09-2019 15:02:00,1,1383.0,1010.0,0.73,6.569,71,0,0,0,71,39,32,0,0.0,0.0
1016,103,23-09-2019 15:04:00,1,1481.0,1041.0,0.703,6.988,38,0,0,0,38,29,9,0,0.0,0.0
1016,104,23-09-2019 15:06:00,1,1181.0,884.0,0.748,5.63,0,0,0,0,0,0,0,0,0.0,0.0
1016,105,23-09-2019 15:08:00,1,1092.0,769.0,0.704,5.155,29,7,3,4,22,11,11,0,0.0,0.0
1016,106,23-09-2019 15:10:00,1,1075.0,825.0,0.767,5.149,37,4,2,2,33,4,29,0,0.0,0.0
1016,107,23-09-2019 15:12:00,1,1071.0,849.0,0.792,5.159,0,0,0,0,0,0,0,0,0.0,0.0
1016,108,23-09-2019 15:14:00,1,1068.0,828.0,0.775,5.123,0,0,0,0,0,0,0,0,0.0,0.0
1016,109,23-09-2019 15:16:00,1,1192.0,851.0,0.714,5.641,0,0,0,0,0,0,0,0,0.0,0.0
1016,110,23-09-2019 15:18:00,1,1405.0,931.0,0.663,6.566,228,117,85,32,111,66,45,13,0.0,0.0
1016,111,23-09-2019 15:20:00,1,1580.0,1144.0,0.724,7.493,214,112,82,30,102,62,40,23,0.0,0.0
1016,112,23-09-2019 15:22:00,1,1551.0,1154.0,0.744,7.39,315,156,119,37,159,104,55,11,0.0,0.0
1016,113,23-09-2019 15:24:00,1,1570.0,1104.0,0.703,7.409,87,13,0,13,74,50,24,0,0.0,0.0
1016,114,23-09-2019 15:26:00,1,1577.0,1135.0,0.72,7.471,119,19,0,19,100,55,45,4,0.0,0.0
1016,115,23-09-2019 15:28:00,1,1393.0,1009.0,0.724,6.607,122,31,7,24,91,46,45,0,0.0,0.0
1016,116,23-09-2019 15:30:00,1,1386.0,1005.0,0.725,6.575,81,19,3,16,62,27,35,0,0.0,0.0
1016,117,23-09-2019 15:32:00,1,1532.0,1101.5,0.7195,7.256,118,10,4,6,108,74,34,0,0.0,0.0
1016,118,23-09-2019 15:34:00,1,1678.0,1198.0,0.714,7.937,57,30,5,25,27,13,14,1,0.0,0.0
1016,119,23-09-2019 15:36:00,1,1701.0,1160.0,0.682,7.986,89,27,0,27,62,36,26,0,0.0,0.0
1016,120,23-09-2019 15:38:00,1,1686.0,1217.0,0.722,7.992,81,9,0,9,72,35,37,2,0.0,0.0
1016,121,23-09-2019 15:40:00,1,1661.0,1181.0,0.711,7.852,119,16,6,10,103,47,56,1,0.0,0.0
1016,122,23-09-2019 15:42:00,1,1588.0,1097.0,0.691,7.471,5,3,1,2,2,1,1,0,0.0,0.0
1016,123,23-09-2019 15:44:00,1,1390.0,953.0,0.686,6.531,24,5,0,5,19,8,11,0,0.0,0.0
1016,124,23-09-2019 15:46:00,1,1197.0,856.0,0.715,5.664,26,4,0,4,22,4,18,0,0.0,0.0
1016,125,23-09-2019 15:48:00,1,1176.0,853.0,0.726,5.578,25,0,0,0,25,12,13,0,0.0,0.0
1016,126,23-09-2019 15:50:00,1,1200.0,746.0,0.622,5.554,109,5,0,5,104,63,41,0,0.0,0.0
1016,127,23-09-2019 15:52:00,1,1095.0,705.0,0.644,5.095,129,0,0,0,129,73,56,0,0.0,0.0
1016,128,23-09-2019 15:54:00,1,991.0,703.0,0.709,4.682,50,3,0,3,47,12,35,0,0.0,0.0
1016,129,23-09-2019 15:56:00,1,1218.0,769.0,0.632,5.651,43,2,0,2,41,12,29,0,0.0,0.0
1016,130,23-09-2019 15:58:00,1,1180.0,865.0,0.733,5.609,41,3,0,3,38,4,34,0,0.0,0.0
1016,131,23-09-2019 16:00:00,1,1290.0,872.0,0.676,6.047,36,0,0,0,36,2,34,0,0.0,0.0
1016,132,23-09-2019 16:02:00,1,1291.0,893.0,0.692,6.075,32,5,3,2,27,13,14,0,0.0,0.0
1016,133,23-09-2019 16:04:00,1,1293.0,884.0,0.684,6.074,12,0,0,0,12,3,9,0,0.0,0.0
1016,134,23-09-2019 16:06:00,1,1387.0,960.5,0.692,6.5285,30,0,0,0,30,3,27,0,0.0,0.0
1016,135,23-09-2019 16:08:00,1,1481.0,1037.0,0.7,6.983,23,4,1,3,19,9,10,0,0.0,0.0
1016,136,23-09-2019 16:10:00,1,1501.0,976.0,0.65,6.994,5,2,0,2,3,2,1,0,0.0,0.0
1016,137,23-09-2019 16:12:00,1,1513.0,962.0,0.636,7.028,16,2,0,2,14,1,13,0,0.0,0.0
1016,138,23-09-2019 16:14:00,1,1506.0,958.0,0.636,6.996,12,1,0,1,11,2,9,0,0.0,0.0
1016,139,23-09-2019 16:16:00,1,1396.0,904.0,0.648,6.501,27,7,4,3,20,6,14,0,0.0,0.0
1016,140,23-09-2019 16:18:00,1,1179.0,877.0,0.744,5.614,2,2,0,2,0,0,0,0,0.0,0.0
1016,141,23-09-2019 16:20:00,1,1303.0,884.0,0.678,6.112,7,6,0,6,1,0,1,0,0.0,0.0
1016,142,23-09-2019 16:22:00,1,1162.0,871.0,0.749,5.542,59,6,0,6,53,35,18,0,0.0,0.0
1016,143,23-09-2019 16:24:00,1,1494.0,955.0,0.639,6.944,28,3,1,2,25,2,23,0,0.0,0.0
1016,144,23-09-2019 16:26:00,1,1295.0,899.0,0.694,6.098,14,0,0,0,14,5,9,0,0.0,0.0
1016,145,23-09-2019 16:28:00,1,1182.0,887.0,0.75,5.64,6,3,1,2,3,2,1,0,0.0,0.0
1016,146,23-09-2019 16:30:00,1,1281.0,878.0,0.685,6.021,15,1,0,1,14,9,5,0,0.0,0.0
1016,147,23-09-2019 16:32:00,1,1276.0,887.0,0.695,6.009,4,0,0,0,4,2,2,0,0.0,0.0
1016,148,23-09-2019 16:34:00,1,1177.0,860.0,0.731,5.589,17,0,0,0,17,9,8,0,0.0,0.0
1016,149,23-09-2019 16:36:00,1,1306.0,892.0,0.683,6.136,92,9,2,7,83,56,27,0,0.0,0.0
1016,150,23-09-2019 16:38:00,1,1160.0,868.0,0.748,5.531,88,17,1,16,71,42,29,0,0.0,0.0
1016,151,23-09-2019 16:40:00,1,1338.5,931.0,0.7015,6.3055,68,15,6,9,53,17,36,0,0.0,0.0
1016,152,23-09-2019 16:42:00,1,1517.0,994.0,0.655,7.08,5,4,0,4,1,0,1,0,0.0,0.0
1016,153,23-09-2019 16:44:00,1,1525.0,924.0,0.606,7.032,0,0,0,0,0,0,0,0,0.0,0.0
1016,154,23-09-2019 16:46:00,1,1297.0,892.0,0.688,6.096,0,0,0,0,0,0,0,0,0.0,0.0
1016,155,23-09-2019 16:48:00,1,1292.0,871.0,0.674,6.055,20,0,0,0,20,3,17,0,0.0,0.0
1016,156,23-09-2019 16:50:00,1,1389.0,876.0,0.631,6.443,18,0,0,0,18,2,16,0,0.0,0.0
1016,157,23-09-2019 16:52:00,1,1199.0,792.0,0.66,5.599,2,0,0,0,2,1,1,0,0.0,0.0
1016,158,23-09-2019 16:54:00,1,1220.0,752.0,0.617,5.638,2,0,0,0,2,0,2,0,0.0,0.0
1016,159,23-09-2019 16:56:00,1,1196.0,773.0,0.646,5.569,18,0,0,0,18,0,18,0,0.0,0.0
1016,160,23-09-2019 16:58:00,1,1182.0,815.0,0.69,5.558,0,0,0,0,0,0,0,0,0.0,0.0
1016,161,23-09-2019 17:00:00,1,1288.0,867.0,0.673,6.037,48,12,4,8,36,18,18,0,0.0,0.0
1016,162,23-09-2019 17:02:00,1,1526.0,928.0,0.608,7.04,8,0,0,0,8,1,7,0,0.0,0.0
1016,163,23-09-2019 17:04:00,1,1412.0,889.0,0.63,6.549,6,5,1,4,1,0,1,0,0.0,0.0
1016,164,23-09-2019 17:06:00,1,1402.0,891.0,0.635,6.511,2,1,0,1,1,0,1,0,0.0,0.0
1016,165,23-09-2019 17:08:00,1,1185.0,850.0,0.718,5.61,3,1,0,1,2,0,2,0,0.0,0.0
1016,166,23-09-2019 17:10:00,1,1192.0,835.0,0.7,5.619,15,7,2,5,8,3,5,0,0.0,0.0
1016,167,23-09-2019 17:12:00,1,1189.0,855.0,0.719,5.632,20,0,0,0,20,5,15,0,0.0,0.0
1016,168,23-09-2019 17:14:00,1,1340.0,934.5,0.6995,6.315,35,2,1,1,33,13,20,0,0.0,0.0
1016,169,23-09-2019 17:16:00,1,1491.0,1014.0,0.68,6.998,4,0,0,0,4,0,4,0,0.0,0.0
1016,170,23-09-2019 17:18:00,1,1397.0,936.0,0.67,6.542,46,13,4,9,33,21,12,0,0.0,0.0
1016,171,23-09-2019 17:20:00,1,1667.0,1206.0,0.723,7.904,210,82,56,26,128,87,41,7,0.0,0.0
1016,172,23-09-2019 17:22:00,1,1664.0,1198.0,0.72,7.884,87,28,8,20,59,36,23,11,0.0,0.0
1016,173,23-09-2019 17:24:00,1,1681.0,1206.0,0.717,7.96,197,135,99,36,62,38,24,19,0.0,0.0
1016,174,23-09-2019 17:26:00,1,1693.0,1170.0,0.691,7.965,147,77,50,27,70,46,24,32,0.0,0.0
1016,175,23-09-2019 17:28:00,1,1671.0,1154.0,0.69,7.862,187,78,49,29,109,68,41,28,0.0,0.0
1016,176,23-09-2019 17:30:00,1,1684.0,1134.0,0.674,7.892,148,76,63,13,72,45,27,67,0.0,0.0
1016,177,23-09-2019 17:32:00,1,1705.0,1154.0,0.677,7.997,100,55,36,19,45,0,45,32,0.0,0.0
1016,178,23-09-2019 17:34:00,1,1694.0,1178.0,0.695,7.981,86,37,25,12,49,1,48,50,0.0,0.0
1016,179,23-09-2019 17:36:00,1,1488.0,989.0,0.665,6.96,324,83,47,36,241,195,46,16,0.0,0.0
1016,180,23-09-2019 17:38:00,1,1691.0,1219.0,0.721,8.013,286,122,91,31,164,108,56,24,0.0,0.0
1016,181,23-09-2019 17:40:00,1,1212.0,779.0,0.643,5.637,407,112,60,52,295,232,63,5,0.0,0.0
1016,182,23-09-2019 17:42:00,1,1492.0,1060.0,0.71,7.053,343,24,5,19,319,251,68,0,0.0,0.0
1016,183,23-09-2019 17:44:00,1,1643.0,1197.0,0.729,7.799,170,24,1,23,146,85,61,0,0.0,0.0
1016,184,23-09-2019 17:46:00,1,1677.0,1247.0,0.743,7.988,171,1,0,1,170,121,49,0,0.0,0.0
1016,185,23-09-2019 17:48:00,1,1684.0,1194.5,0.709,7.9575,517,1,1,0,516,429,87,0,0.0,0.0
1016,186,23-09-2019 17:50:00,1,1691.0,1142.0,0.675,7.927,428,5,0,5,423,381,42,0,0.0,0.0
1016,187,23-09-2019 17:52:00,1,1471.0,1076.0,0.732,6.987,650,0,0,0,650,603,47,0,0.0,0.0
1016,188,23-09-2019 17:54:00,1,1152.0,915.0,0.795,5.551,335,0,0,0,335,311,24,0,0.0,0.0
1016,189,23-09-2019 17:56:00,1,1173.0,941.0,0.802,5.665,169,6,3,3,163,142,21,0,0.0,0.0
1016,190,23-09-2019 17:58:00,1,1179.0,929.0,0.788,5.673,157,1,0,1,156,109,47,0,0.0,0.0
1016,191,23-09-2019 18:00:00,0,1156.0,901.0,0.78,5.552,310,2,0,2,308,256,52,0,0.0,0.0
1016,192,23-09-2019 18:02:00,0,1275.0,927.0,0.727,6.05,371,0,0,0,371,307,64,0,0.0,0.0
1016,193,23-09-2019 18:04:00,0,1285.0,931.0,0.724,6.096,517,5,4,1,512,466,46,0,0.0,0.0
1016,194,23-09-2019 18:06:00,0,1484.0,1076.0,0.725,7.04,588,176,129,47,412,345,67,22,0.0,0.0
1016,195,23-09-2019 18:08:00,0,1869.0,1357.0,0.726,8.868,464,194,162,32,270,222,48,75,0.0,0.0
1016,196,23-09-2019 18:10:00,0,2139.0,1616.0,0.756,10.217,365,176,140,36,189,136,53,94,0.0,0.0
1016,197,23-09-2019 18:12:00,0,1955.0,1485.0,0.76,9.348,314,142,111,31,172,118,54,34,0.0,0.0
1016,198,23-09-2019 18:14:00,0,2078.0,1530.0,0.736,9.882,248,51,23,28,197,141,56,8,0.0,0.0
1016,199,23-09-2019 18:16:00,0,1976.0,1461.0,0.739,9.403,58,31,9,22,27,21,6,2,0.0,0.0
1016,200,23-09-2019 18:18:00,0,1980.0,1389.0,0.701,9.339,324,118,97,21,206,161,45,53,0.0,0.01
1016,201,23-09-2019 18:20:00,0,1969.0,1425.0,0.724,9.335,399,193,152,41,206,166,40,76,0.0,0.0
1016,202,23-09-2019 18:22:00,0,2082.5,1476.5,0.71,9.839,91,43,28,15,48,1,47,63,0.0,0.0
1016,203,23-09-2019 18:24:00,0,2196.0,1528.0,0.696,10.343,90,36,17,19,54,0,54,56,0.0,0.0
1016,204,23-09-2019 18:26:00,0,2188.0,1552.0,0.709,10.34,286,136,99,37,150,89,61,51,0.0,0.05
1016,205,23-09-2019 18:28:00,0,2167.0,1579.0,0.729,10.287,519,265,218,47,254,182,72,65,0.0,0.0
1016,206,23-09-2019 18:30:00,0,2060.0,1544.0,0.749,9.827,415,238,183,55,177,134,43,107,0.0,0.0
1016,207,23-09-2019 18:32:00,0,1641.0,1281.0,0.781,7.883,253,109,78,31,144,114,30,42,0.0,0.0
1016,208,23-09-2019 18:34:00,0,2124.0,1667.0,0.785,10.215,119,62,45,17,57,21,36,45,0.0,0.0
1016,209,23-09-2019 18:36:00,0,1469.0,1076.0,0.733,6.98,83,20,10,10,63,23,40,0,0.0,0.0
1016,210,23-09-2019 18:38:00,0,982.0,751.0,0.765,4.701,16,3,2,1,13,1,12,0,0.0,0.0
1016,211,23-09-2019 18:40:00,0,1184.0,875.0,0.739,5.634,43,12,6,6,31,13,18,0,0.0,0.0
1016,212,23-09-2019 18:42:00,0,1166.0,915.0,0.784,5.608,69,16,11,5,53,18,35,0,0.0,0.0
1016,213,23-09-2019 18:44:00,0,1146.0,963.0,0.841,5.58,34,6,5,1,28,4,24,0,0.0,0.01
1016,214,23-09-2019 18:46:00,0,1476.0,1124.0,0.761,7.062,177,40,22,18,137,92,45,7,0.0,0.0
1016,215,23-09-2019 18:48:00,0,2116.0,1819.0,0.859,10.352,305,175,135,40,130,89,41,24,0.0,0.08
1016,216,23-09-2019 18:50:00,0,1912.0,1551.0,0.812,9.25,211,150,111,39,61,40,21,76,0.0,0.0
1016,217,23-09-2019 18:52:00,0,1925.0,1609.0,0.836,9.366,431,181,137,44,250,191,59,94,0.0,0.0
1016,218,23-09-2019 18:54:00,0,1906.0,1675.0,0.878,9.366,248,124,97,27,124,103,21,145,0.0,0.0
1016,219,23-09-2019 18:56:00,0,1911.5,1624.0,0.8495,9.3295,271,70,55,15,201,137,64,52,0.0,0.0
1016,220,23-09-2019 18:58:00,0,1917.0,1573.0,0.821,9.293,179,17,5,12,162,108,54,3,0.0,0.0
1016,221,23-09-2019 19:00:00,0,2092.0,1731.0,0.827,10.16,162,76,55,21,86,46,40,61,0.0,0.0
1016,222,23-09-2019 19:02:00,0,2119.0,1812.0,0.855,10.355,230,129,98,31,101,59,42,47,0.0,0.0
1016,223,23-09-2019 19:04:00,0,1938.0,1610.0,0.831,9.418,291,168,127,41,123,87,36,81,0.0,0.0
1016,224,23-09-2019 19:06:00,0,2157.0,1712.0,0.794,10.394,334,170,126,44,164,133,31,87,0.0,0.0
1016,225,23-09-2019 19:08:00,0,1932.0,1503.0,0.778,9.275,67,44,26,18,23,16,7,5,0.0,0.0
1016,226,23-09-2019 19:10:00,0,1942.0,1620.0,0.834,9.446,390,169,125,44,221,172,49,34,0.0,0.0
1016,227,23-09-2019 19:12:00,0,1854.0,1449.0,0.782,8.909,396,177,141,36,219,180,39,108,0.0,0.0
1016,228,23-09-2019 19:14:00,0,1952.0,1529.0,0.783,9.382,389,189,149,40,200,157,43,138,0.0,0.0
1016,229,23-09-2019 19:16:00,0,2133.0,1610.0,0.755,10.187,167,94,63,31,73,33,40,63,0.0,0.0
1016,230,23-09-2019 19:18:00,0,1934.0,1559.0,0.806,9.346,336,146,108,38,190,137,53,78,0.0,0.0
1016,231,23-09-2019 19:20:00,0,1498.0,1049.0,0.7,7.065,415,259,194,65,156,112,44,20,0.0,0.0
1016,232,23-09-2019 19:22:00,0,1762.0,1387.0,0.787,8.479,536,218,178,40,318,251,67,44,0.0,0.0
1016,233,23-09-2019 19:24:00,0,1671.0,1221.0,0.73,7.936,292,119,84,35,173,138,35,87,0.0,0.0
1016,234,23-09-2019 19:26:00,0,1660.0,1249.0,0.752,7.921,47,29,14,15,18,9,9,0,0.0,0.0
1016,235,23-09-2019 19:28:00,0,1679.0,1184.0,0.706,7.925,103,73,35,38,30,5,25,32,0.0,0.0
1016,236,23-09-2019 19:30:00,0,1773.5,1286.5,0.7245,8.412,157,58,40,18,99,45,54,54,0.0,0.0
1016,237,23-09-2019 19:32:00,0,1868.0,1389.0,0.743,8.899,165,73,47,26,92,57,35,45,0.0,0.0
1016,238,23-09-2019 19:34:00,0,1358.0,1052.0,0.774,6.516,199,138,99,39,61,36,25,31,0.0,0.0
1016,239,23-09-2019 19:36:00,0,1863.0,1442.0,0.774,8.936,146,74,52,22,72,32,40,110,0.0,0.0
1016,240,23-09-2019 19:38:00,0,2053.0,1562.0,0.761,9.821,139,69,56,13,70,24,46,77,0.0,0.0
1016,241,23-09-2019 19:40:00,0,1834.0,1444.0,0.787,8.825,74,30,16,14,44,2,42,38,0.0,0.0
1016,242,23-09-2019 19:42:00,0,2043.0,1521.0,0.745,9.733,147,82,56,26,65,24,41,66,0.0,0.0
1016,243,23-09-2019 19:44:00,0,1837.0,1374.0,0.748,8.758,108,53,34,19,55,15,40,69,0.0,0.0
1016,244,23-09-2019 19:46:00,0,1858.0,1464.0,0.788,8.941,100,55,40,15,45,10,35,66,0.0,0.0
1016,245,23-09-2019 19:48:00,0,1831.0,1465.0,0.8,8.835,291,166,127,39,125,82,43,71,0.0,0.04
1016,246,23-09-2019 19:50:00,0,1547.0,1219.0,0.788,7.445,360,210,151,59,150,111,39,14,0.0,0.0
1016,247,23-09-2019 19:52:00,0,1073.0,791.0,0.737,5.106,144,52,32,20,92,57,35,1,0.0,0.0
1016,248,23-09-2019 19:54:00,0,1079.0,859.0,0.796,5.201,138,37,12,25,101,53,48,4,0.0,0.0
1016,249,23-09-2019 19:56:00,0,1054.0,926.0,0.878,5.178,97,19,3,16,78,39,39,0,0.0,0.0
1016,250,23-09-2019 19:58:00,0,1387.0,1020.0,0.736,6.593,129,21,4,17,108,69,39,6,0.0,0.0
1016,251,23-09-2019 20:00:00,0,1985.0,1682.0,0.847,9.683,217,96,72,24,121,84,37,52,0.0,0.0
1016,252,23-09-2019 20:02:00,0,1084.0,812.0,0.749,5.171,10,2,0,2,8,2,6,0,0.0,0.0
1016,253,23-09-2019 20:04:00,0,1139.0,831.5,0.731,5.4095,32,3,0,3,29,9,20,0,0.0,0.0
1016,254,23-09-2019 20:06:00,0,1194.0,851.0,0.713,5.648,31,3,0,3,28,16,12,0,0.0,0.0
1016,255,23-09-2019 20:08:00,0,1147.0,901.0,0.785,5.516,38,2,0,2,36,4,32,0,0.0,0.0
1016,256,23-09-2019 20:10:00,0,1685.0,1226.0,0.728,7.995,41,2,0,2,39,23,16,0,0.0,0.0
1016,257,23-09-2019 20:12:00,0,1390.0,990.0,0.712,6.573,25,0,0,0,25,5,20,0,0.0,0.0
1016,258,23-09-2019 20:14:00,0,1173.0,862.0,0.735,5.578,34,3,1,2,31,13,18,0,0.0,0.0
1016,259,23-09-2019 20:16:00,0,1189.0,792.0,0.667,5.561,27,4,1,3,23,12,11,0,0.0,0.0
1016,260,23-09-2019 20:18:00,0,1204.0,791.0,0.657,5.619,30,1,0,1,29,10,19,0,0.0,0.0
1016,261,23-09-2019 20:20:00,0,1207.0,808.0,0.669,5.652,44,10,4,6,34,20,14,0,0.0,0.0
1016,262,23-09-2019 20:22:00,0,1184.0,850.0,0.718,5.607,14,0,0,0,14,1,13,0,0.0,0.0
1016,263,23-09-2019 20:24:00,0,1483.0,1051.0,0.709,7.008,264,113,85,28,151,101,50,28,0.0,0.01
1016,264,23-09-2019 20:26:00,0,2257.0,1781.0,0.789,10.866,328,167,130,37,161,113,48,112,0.0,0.0
1016,265,23-09-2019 20:28:00,0,2349.0,1735.0,0.739,11.177,140,83,58,25,57,18,39,74,0.0,0.0
1016,266,23-09-2019 20:30:00,0,2322.0,1792.0,0.772,11.132,106,51,26,25,55,12,43,67,0.0,0.0
1016,267,23-09-2019 20:32:00,0,2147.0,1679.0,0.782,10.317,104,59,36,23,45,1,44,67,0.0,0.0
1016,268,23-09-2019 20:34:00,0,2132.0,1731.0,0.812,10.315,290,164,119,45,126,66,60,82,0.0,0.02
1016,269,23-09-2019 20:36:00,0,2154.0,1632.0,0.758,10.293,117,74,45,29,43,2,41,59,0.0,0.0
1016,270,23-09-2019 20:38:00,0,2191.5,1700.5,0.776,10.5165,261,136,99,37,125,79,46,41,0.0,0.07
1016,271,23-09-2019 20:40:00,0,2229.0,1769.0,0.794,10.74,96,53,30,23,43,12,31,66,0.0,0.03
1016,272,23-09-2019 20:42:00,0,2038.0,1645.0,0.807,9.85,129,80,54,26,49,14,35,51,0.0,0.06
1016,273,23-09-2019 20:44:00,0,2036.0,1614.0,0.793,9.81,137,95,57,38,42,6,36,62,0.0,0.0
1016,274,23-09-2019 20:46:00,0,1832.0,1575.0,0.86,8.964,385,199,159,40,186,129,57,31,0.0,0.07
1016,275,23-09-2019 20:48:00,0,1559.0,1241.0,0.796,7.519,400,226,174,52,174,129,45,103,0.01,0.03
1016,276,23-09-2019 20:50:00,0,1836.0,1493.0,0.813,8.888,263,160,125,35,103,76,27,83,0.0,0.01
1016,277,23-09-2019 20:52:00,0,1141.0,973.0,0.852,5.573,280,132,94,38,148,105,43,20,0.0,0.0
1016,278,23-09-2019 20:54:00,0,1916.0,1701.0,0.888,9.432,410,226,171,55,184,139,45,37,0.0,0.0
1016,279,23-09-2019 20:56:00,0,2019.0,1693.0,0.838,9.828,309,146,110,36,163,114,49,89,0.0,0.0
1016,280,23-09-2019 20:58:00,0,2100.0,1875.0,0.893,10.351,131,62,37,25,69,30,39,33,0.11,0.0
1016,281,23-09-2019 21:00:00,0,2062.0,1818.0,0.882,10.136,112,77,43,34,35,7,28,62,0.0,0.0
1016,282,23-09-2019 21:02:00,0,1977.0,1747.0,0.883,9.724,146,94,68,26,52,16,36,56,0.0,0.03
1016,283,23-09-2019 21:04:00,0,2018.0,1730.0,0.858,9.865,118,79,50,29,39,12,27,63,0.0,0.06
1016,284,23-09-2019 21:06:00,0,1353.0,1171.0,0.866,6.626,307,195,149,46,112,70,42,23,0.01,0.08
1016,285,23-09-2019 21:08:00,0,1545.0,1247.0,0.807,7.468,296,117,84,33,179,137,42,20,0.0,0.0
1016,286,23-09-2019 21:10:00,0,1048.0,876.0,0.836,5.1,103,25,9,16,78,46,32,0,0.0,0.0
1016,287,23-09-2019 21:12:00,0,1300.0,1087.0,0.836,6.326,230,40,22,18,190,130,60,2,0.0,0.0
1016,288,23-09-2019 21:14:00,0,1552.0,1298.0,0.836,7.552,206,20,5,15,186,126,60,0,0.0,0.0
1016,289,23-09-2019 21:16:00,0,1531.0,1386.0,0.905,7.566,55,5,2,3,50,30,20,0,0.0,0.0
1016,290,23-09-2019 21:18:00,0,1341.0,1099.0,0.819,6.5,14,4,1,3,10,6,4,0,0.0,0.0
1016,291,23-09-2019 21:20:00,0,1257.0,1028.0,0.818,6.091,44,8,0,8,36,26,10,0,0.03,0.0
1016,292,23-09-2019 21:22:00,0,1351.0,1130.0,0.836,6.573,15,0,0,0,15,1,14,0,0.0,0.0
1016,293,23-09-2019 21:24:00,0,1245.0,1058.0,0.85,6.079,77,38,26,12,39,23,16,29,0.0,0.0
1016,294,23-09-2019 21:26:00,0,2140.0,2002.0,0.936,10.647,273,137,104,33,136,91,45,93,0.03,0.0
1016,295,23-09-2019 21:28:00,0,2246.0,2098.0,0.934,11.173,121,93,56,37,28,8,20,49,0.0,0.0
1016,296,23-09-2019 21:30:00,0,2287.0,2163.0,0.946,11.404,307,145,99,46,162,127,35,91,0.0,0.0
1016,297,23-09-2019 21:32:00,0,2166.0,2026.0,0.936,10.776,323,133,99,34,190,134,56,25,0.0,0.0
1016,298,23-09-2019 21:34:00,0,1319.0,1186.0,0.899,6.511,154,32,18,14,122,77,45,20,0.03,0.0
1016,299,23-09-2019 21:36:00,0,1533.0,1289.0,0.841,7.469,337,57,27,30,280,220,60,16,0.0,0.0
1016,300,23-09-2019 21:38:00,0,2264.0,2157.0,0.953,11.309,281,148,115,33,133,100,33,42,0.0,0.01
1016,301,23-09-2019 21:40:00,0,2091.0,1904.0,0.911,10.347,165,122,85,37,43,13,30,63,0.0,0.0
1016,302,23-09-2019 21:42:00,0,2266.0,2138.0,0.944,11.295,112,72,46,26,40,11,29,54,0.0,0.0
1016,303,23-09-2019 21:44:00,0,1979.0,1868.0,0.944,9.864,117,81,47,34,36,9,27,60,0.0,0.0
1016,304,23-09-2019 21:46:00,0,1976.5,1849.0,0.9355,9.8335,111,75,46,29,36,10,26,54,0.0,0.08
1016,305,23-09-2019 21:48:00,0,1974.0,1830.0,0.927,9.803,50,32,21,11,18,0,18,37,0.0,0.11
1016,306,23-09-2019 21:50:00,0,1963.0,1893.0,0.965,9.828,200,106,76,30,94,59,35,65,0.01,0.06
1016,307,23-09-2019 21:52:00,0,1715.0,1518.0,0.885,8.437,115,46,34,12,69,41,28,11,0.2,0.0
1016,308,23-09-2019 21:54:00,0,1980.0,1837.0,0.928,9.835,376,170,131,39,206,142,64,34,0.02,0.04
1016,309,23-09-2019 21:56:00,0,2176.0,1930.0,0.887,10.712,245,124,95,29,121,45,76,83,0.0,0.0
1016,310,23-09-2019 21:58:00,0,2165.0,1997.0,0.922,10.74,80,26,15,11,54,0,54,40,0.0,0.06
1016,311,23-09-2019 22:00:00,0,2178.0,2024.0,0.929,10.82,308,141,109,32,167,105,62,67,0.02,0.05
1016,312,23-09-2019 22:02:00,0,2459.0,2229.0,0.907,12.156,170,47,27,20,123,80,43,30,0.21,0.0
1016,313,23-09-2019 22:04:00,0,1712.0,1534.0,0.896,8.445,176,79,55,24,97,71,26,6,0.0,0.0
1016,314,23-09-2019 22:06:00,0,2007.0,1780.0,0.887,9.88,144,46,29,17,98,54,44,37,0.13,0.0
1016,315,23-09-2019 22:08:00,0,1988.0,1855.0,0.933,9.887,90,43,24,19,47,0,47,62,0.01,0.04
1016,316,23-09-2019 22:10:00,0,1485.0,1352.0,0.91,7.347,198,68,51,17,130,89,41,6,0.0,0.01
1016,317,23-09-2019 22:12:00,0,1060.0,925.0,0.873,5.2,0,0,0,0,0,0,0,0,0.0,0.0
1016,318,23-09-2019 22:14:00,0,847.0,810.0,0.956,4.234,11,5,2,3,6,4,2,0,0.0,0.0
1016,319,23-09-2019 22:16:00,0,1229.0,1059.0,0.861,6.017,8,1,0,1,7,5,2,0,0.02,0.03
1016,320,23-09-2019 22:18:00,0,1234.0,1032.0,0.836,6.005,14,8,7,1,6,6,0,0,0.0,0.0
1016,321,23-09-2019 22:20:00,0,1299.0,1089.5,0.8385,6.3245,15,5,4,1,10,8,2,0,0.0,0.0
1016,322,23-09-2019 22:22:00,0,1364.0,1147.0,0.841,6.644,8,0,0,0,8,5,3,0,0.0,0.0
1016,323,23-09-2019 22:24:00,0,1344.0,1099.0,0.818,6.513,25,1,1,0,24,10,14,0,0.0,0.0
1016,324,23-09-2019 22:26:00,0,1316.0,1162.0,0.883,6.47,24,0,0,0,24,9,15,0,0.0,0.0
1016,325,23-09-2019 22:28:00,0,1546.0,1333.0,0.862,7.568,20,0,0,0,20,12,8,0,0.0,0.0
1016,326,23-09-2019 22:30:00,0,1785.0,1695.0,0.95,8.908,104,52,40,12,52,36,16,6,0.0,0.0
1016,327,23-09-2019 22:32:00,0,1951.0,1903.0,0.976,9.794,232,70,35,35,162,107,55,12,0.01,0.0
1016,328,23-09-2019 22:34:00,0,1963.0,1900.0,0.968,9.838,383,135,107,28,248,175,73,78,0.0,0.0
1016,329,23-09-2019 22:36:00,0,1986.0,1906.0,0.959,9.936,486,228,185,43,258,182,76,56,0.0,0.02
1016,330,23-09-2019 22:38:00,0,1779.0,1703.0,0.957,8.896,288,127,96,31,161,106,55,14,0.0,0.0
1016,331,23-09-2019 22:40:00,0,1771.0,1698.0,0.959,8.858,13,1,1,0,12,6,6,0,0.0,0.0
1016,332,23-09-2019 22:42:00,0,1798.0,1666.0,0.927,8.928,0,0,0,0,0,0,0,0,0.0,0.0
1016,333,23-09-2019 22:44:00,0,1708.0,1609.0,0.942,8.509,6,0,0,0,6,2,4,0,0.0,0.0
1016,334,23-09-2019 22:46:00,0,1593.0,1545.0,0.97,7.986,178,5,1,4,173,151,22,0,0.0,0.0
1016,335,23-09-2019 22:48:00,0,1302.0,1301.0,1.0,6.569,125,2,0,2,123,110,13,0,0.0,0.0
1016,336,23-09-2019 22:50:00,0,1324.0,1219.0,0.921,6.566,1,0,0,0,1,1,0,0,0.0,0.0
1016,337,23-09-2019 22:52:00,0,1302.0,1285.0,0.987,6.552,135,81,62,19,54,18,36,33,0.0,0.47
1016,338,23-09-2019 22:54:00,0,1552.0,1466.5,0.951,7.7375,13,0,0,0,13,0,13,0,0.0,0.01
1016,339,23-09-2019 22:56:00,0,1802.0,1648.0,0.915,8.923,271,133,104,29,138,90,48,26,0.0,0.06
1016,340,23-09-2019 22:58:00,0,1762.0,1771.0,1.005,8.903,103,0,0,0,103,59,44,0,0.0,0.0
1016,341,23-09-2019 23:00:00,0,1865.0,1784.0,0.956,9.322,215,2,0,2,213,140,73,3,0.0,0.0
1016,342,23-09-2019 23:02:00,0,1747.0,1734.0,0.993,8.8,393,173,138,35,220,181,39,103,0.0,0.0
1016,343,23-09-2019 23:04:00,0,1976.0,1887.0,0.955,9.875,366,147,106,41,219,166,53,74,0.18,0.0
1016,344,23-09-2019 23:06:00,0,1800.0,1649.0,0.916,8.919,369,168,135,33,201,152,49,12,0.0,0.0
1016,345,23-09-2019 23:08:00,0,1748.0,1737.0,0.993,8.811,94,46,35,11,48,31,17,19,0.0,0.0
1016,346,23-09-2019 23:10:00,0,1775.0,1718.0,0.968,8.897,6,0,0,0,6,0,6,0,0.0,0.0
1016,347,23-09-2019 23:12:00,0,1793.0,1740.0,0.97,8.991,1,1,0,1,0,0,0,0,0.0,0.0
1016,348,23-09-2019 23:14:00,0,1972.0,1772.0,0.898,9.732,323,117,86,31,206,150,56,17,0.0,0.0
1016,349,23-09-2019 23:16:00,0,1986.0,1849.0,0.931,9.87,279,133,102,31,146,111,35,75,0.18,0.0
1016,350,23-09-2019 23:18:00,0,1786.0,1760.0,0.986,8.984,139,74,52,22,65,47,18,43,0.0,0.0
1016,351,23-09-2019 23:20:00,0,1794.0,1719.0,0.958,8.972,278,120,77,43,158,99,59,22,0.0,0.0
1016,352,23-09-2019 23:22:00,0,1765.0,1662.0,0.942,8.794,87,44,16,28,43,25,18,1,0.0,0.0
1016,353,23-09-2019 23:24:00,0,2000.0,1805.0,0.902,9.877,347,97,68,29,250,178,72,15,0.19,0.0
1016,354,23-09-2019 23:26:00,0,1819.0,1613.0,0.887,8.951,557,318,252,66,239,187,52,14,0.04,0.0
1016,355,23-09-2019 23:28:00,0,1950.5,1746.0,0.8945,9.6175,259,63,28,35,196,135,61,1,0.0,0.0
1016,356,23-09-2019 23:30:00,0,2082.0,1879.0,0.902,10.284,268,70,34,36,198,167,31,0,0.0,0.0
1016,357,23-09-2019 23:32:00,0,2101.0,1818.0,0.865,10.291,445,46,25,21,399,354,45,0,0.0,0.0
1016,358,23-09-2019 23:34:00,0,2104.0,1874.0,0.891,10.365,359,135,96,39,224,169,55,44,0.0,0.0
1016,359,23-09-2019 23:36:00,0,2060.0,1879.0,0.912,10.197,177,86,59,27,91,46,45,72,0.0,0.0
1016,360,23-09-2019 23:38:00,0,2078.0,1860.0,0.895,10.247,89,52,30,22,37,0,37,68,0.0,0.01
1016,361,23-09-2019 23:40:00,0,2081.0,1952.0,0.938,10.359,92,56,32,24,36,2,34,52,0.0,0.04
1016,362,23-09-2019 23:42:00,0,2092.0,1930.0,0.923,10.377,240,63,37,26,177,116,61,52,0.0,0.05
1016,363,23-09-2019 23:44:00,0,1888.0,1688.0,0.894,9.306,319,137,92,45,182,133,49,21,0.15,0.03
1016,364,23-09-2019 23:46:00,0,1435.0,1203.0,0.838,6.986,82,52,25,27,30,13,17,6,0.0,0.0
1016,365,23-09-2019 23:48:00,0,1447.0,1231.0,0.851,7.064,69,14,3,11,55,33,22,1,0.0,0.0
1016,366,23-09-2019 23:50:00,0,1943.0,1588.0,0.818,9.413,33,13,2,11,20,3,17,1,0.0,0.0
1016,367,23-09-2019 23:52:00,0,2182.0,1996.0,0.914,10.809,211,102,71,31,109,82,27,29,0.0,0.0
1016,368,23-09-2019 23:54:00,0,2078.0,1872.0,0.901,10.259,315,166,120,46,149,108,41,22,0.0,0.0
1016,369,23-09-2019 23:56:00,0,2280.0,2117.0,0.928,11.328,328,141,104,37,187,131,56,62,0.12,0.0
1016,370,23-09-2019 23:58:00,0,2076.0,1866.0,0.899,10.246,380,145,97,48,235,168,67,9,0.0,0.0
1016,371,24-09-2019 00:00:00,0,2071.0,1963.0,0.948,10.333,257,165,121,44,92,62,30,6,0.03,0.0
1016,372,24-09-2019 00:02:00,0,2110.5,1979.5,0.938,10.5075,113,75,43,32,38,3,35,49,0.0,0.1
1016,373,24-09-2019 00:04:00,0,2150.0,1996.0,0.928,10.682,218,122,91,31,96,51,45,67,0.0,0.0
1016,374,24-09-2019 00:06:00,0,2271.0,2028.0,0.893,11.193,121,80,44,36,41,2,39,70,0.0,0.0
1016,375,24-09-2019 00:08:00,0,2277.0,2059.0,0.905,11.25,133,77,53,24,56,13,43,62,0.0,0.0
1016,376,24-09-2019 00:10:00,0,2286.0,2006.0,0.878,11.227,200,135,90,45,65,18,47,67,0.0,0.0
1016,377,24-09-2019 00:12:00,0,2274.0,1993.0,0.876,11.166,131,87,55,32,44,10,34,58,0.0,0.0
1016,378,24-09-2019 00:14:00,0,1656.0,1351.0,0.816,8.021,299,161,116,45,138,96,42,32,0.01,0.0
1016,379,24-09-2019 00:16:00,0,1712.0,1562.0,0.912,8.473,189,109,87,22,80,57,23,0,0.08,0.0
1016,380,24-09-2019 00:18:00,0,1135.0,1059.0,0.933,5.645,21,1,0,1,20,9,11,0,0.02,0.0
1016,381,24-09-2019 00:20:00,0,1130.0,992.0,0.878,5.551,8,0,0,0,8,2,6,0,0.0,0.01
1016,382,24-09-2019 00:22:00,0,1149.0,1049.0,0.912,5.69,181,96,78,18,85,62,23,10,0.0,0.0
1016,383,24-09-2019 00:24:00,0,1604.0,1537.0,0.959,8.021,334,114,87,27,220,171,49,12,0.02,0.01
1016,384,24-09-2019 00:26:00,0,2254.0,2009.0,0.891,11.103,207,60,43,17,147,106,41,12,0.0,0.01
1016,385,24-09-2019 00:28:00,0,1413.0,1240.0,0.877,6.94,158,64,36,28,94,53,41,35,0.0,0.0
1016,386,24-09-2019 00:30:00,0,2299.0,2062.0,0.897,11.342,292,137,109,28,155,111,44,31,0.0,0.0
1016,387,24-09-2019 00:32:00,0,2182.0,1991.0,0.912,10.802,143,69,52,17,74,51,23,4,0.0,0.0
1016,388,24-09-2019 00:34:00,0,2251.0,2036.0,0.904,11.124,123,55,36,19,68,41,27,7,0.0,0.0
1016,389,24-09-2019 00:36:00,0,2181.5,1977.0,0.906,10.7835,169,98,61,37,71,35,36,47,0.0,0.01
1016,390,24-09-2019 00:38:00,0,2112.0,1918.0,0.908,10.443,278,104,75,29,174,116,58,73,0.11,0.0
1016,391,24-09-2019 00:40:00,0,2260.0,2152.0,0.952,11.286,185,118,79,39,67,29,38,66,0.0,0.0
1016,392,24-09-2019 00:42:00,0,2232.0,2150.0,0.963,11.174,155,91,60,31,64,19,45,70,0.03,0.0
1016,393,24-09-2019 00:44:00,0,2273.0,2041.0,0.898,11.217,160,100,67,33,60,15,45,50,0.0,0.0
1016,394,24-09-2019 00:46:00,0,2091.0,1962.0,0.938,10.411,193,82,55,27,111,71,40,32,0.0,0.0
1016,395,24-09-2019 00:48:00,0,1440.0,1192.0,0.828,6.993,76,44,15,29,32,13,19,5,0.0,0.0
1016,396,24-09-2019 00:50:00,0,1227.0,1101.0,0.897,6.054,170,30,4,26,140,95,45,1,0.0,0.0
1016,397,24-09-2019 00:52:00,0,1527.0,1348.0,0.883,7.508,238,130,91,39,108,71,37,38,0.0,0.01
1016,398,24-09-2019 00:54:00,0,2280.0,2142.0,0.94,11.355,185,95,67,28,90,46,44,56,0.0,0.0
1016,399,24-09-2019 00:56:00,0,2545.0,2282.0,0.897,12.552,111,58,38,20,53,3,50,59,0.0,0.0
1016,400,24-09-2019 00:58:00,0,2061.0,1984.0,0.963,10.315,68,23,15,8,45,1,44,47,0.0,0.0
1016,401,24-09-2019 01:00:00,0,2280.0,2117.0,0.929,11.325,147,94,63,31,53,4,49,65,0.0,0.01
1016,402,24-09-2019 01:02:00,0,2159.0,2020.0,0.936,10.741,125,81,58,23,44,6,38,44,0.0,0.01
1016,403,24-09-2019 01:04:00,0,2274.0,2052.0,0.902,11.232,112,53,30,23,59,13,46,54,0.0,0.0
1016,404,24-09-2019 01:06:00,0,2282.0,2015.0,0.883,11.222,100,46,27,19,54,6,48,47,0.0,0.0
1016,405,24-09-2019 01:08:00,0,1424.0,1266.0,0.889,7.01,558,176,126,50,382,306,76,28,0.0,0.06
1016,406,24-09-2019 01:10:00,0,1627.5,1426.5,0.8775,7.991,113,49,33,16,64,52,12,11,0.0,0.02
1016,407,24-09-2019 01:12:00,0,1831.0,1587.0,0.866,8.972,179,92,52,40,87,67,20,10,0.0,0.06
1016,408,24-09-2019 01:14:00,0,1603.0,1525.0,0.952,8.004,20,20,3,17,0,0,0,0,0.0,0.0
1016,409,24-09-2019 01:16:00,0,1606.0,1479.0,0.921,7.967,89,29,12,17,60,16,44,0,0.0,0.0
1016,410,24-09-2019 01:18:00,0,1713.0,1586.0,0.926,8.504,190,104,57,47,86,47,39,6,0.0,0.0
1016,411,24-09-2019 01:20:00,0,1428.0,1285.0,0.9,7.047,420,198,149,49,222,169,53,23,0.0,0.0
1016,412,24-09-2019 01:22:00,0,1989.0,1859.0,0.935,9.894,308,78,58,20,230,156,74,66,0.12,0.0
1016,413,24-09-2019 01:24:00,0,2456.0,2222.0,0.905,12.135,92,49,27,22,43,4,39,48,0.04,0.0
1016,414,24-09-2019 01:26:00,0,2346.0,2174.0,0.927,11.65,68,23,14,9,45,6,39,44,0.0,0.0
1016,415,24-09-2019 01:28:00,0,2158.0,2095.0,0.971,10.822,307,111,87,24,196,159,37,40,0.0,0.0
1016,416,24-09-2019 01:30:00,0,2077.0,1981.0,0.954,10.375,178,99,69,30,79,33,46,62,0.0,0.0
1016,417,24-09-2019 01:32:00,0,1888.0,1651.0,0.874,9.268,206,113,84,29,93,56,37,59,0.0,0.0
1016,418,24-09-2019 01:34:00,0,2050.0,1909.0,0.931,10.189,64,28,15,13,36,0,36,34,0.0,0.0
1016,419,24-09-2019 01:36:00,0,2268.0,2183.0,0.963,11.351,92,52,25,27,40,2,38,62,0.0,0.0
1016,420,24-09-2019 01:38:00,0,2074.0,1977.0,0.954,10.36,89,40,22,18,49,4,45,57,0.0,0.0
1016,421,24-09-2019 01:40:00,0,2242.0,2065.0,0.921,11.119,90,49,21,28,41,2,39,61,0.0,0.0
1016,422,24-09-2019 01:42:00,0,1915.0,1635.0,0.854,9.356,140,89,56,33,51,10,41,58,0.0,0.05
1016,423,24-09-2019 01:44:00,0,2147.5,1903.0,0.883,10.5675,97,50,30,20,47,4,43,50,0.0,0.05
1016,424,24-09-2019 01:46:00,0,2380.0,2171.0,0.912,11.779,127,73,31,42,54,8,46,63,0.0,0.02
1016,425,24-09-2019 01:48:00,0,2162.0,1993.0,0.922,10.725,233,150,113,37,83,43,40,53,0.0,0.01
1016,426,24-09-2019 01:50:00,0,2097.0,1864.0,0.889,10.328,336,173,119,54,163,113,50,11,0.07,0.19
1016,427,24-09-2019 01:52:00,0,2107.0,1899.0,0.901,10.405,198,96,66,30,102,64,38,37,0.01,0.0
1016,428,24-09-2019 01:54:00,0,1597.0,1449.0,0.908,7.896,315,135,100,35,180,126,54,13,0.0,0.0
1016,429,24-09-2019 01:56:00,0,1886.0,1741.0,0.923,9.36,252,148,112,36,104,60,44,28,0.0,0.0
1016,430,24-09-2019 01:58:00,0,2279.0,2038.0,0.894,11.235,104,56,30,26,48,0,48,55,0.0,0.0
1016,431,24-09-2019 02:00:00,0,2294.0,2066.0,0.901,11.327,100,52,31,21,48,3,45,57,0.0,0.0
1016,432,24-09-2019 02:02:00,0,2095.0,1895.0,0.904,10.354,144,62,37,25,82,28,54,28,0.0,0.01
1016,433,24-09-2019 02:04:00,0,1438.0,1240.0,0.862,7.04,259,81,56,25,178,129,49,4,0.16,0.0
1016,434,24-09-2019 02:06:00,0,1440.0,1207.0,0.838,7.009,193,29,13,16,164,109,55,7,0.01,0.0
1016,435,24-09-2019 02:08:00,0,2099.0,1846.0,0.879,10.316,201,99,62,37,102,48,54,61,0.0,0.0
1016,436,24-09-2019 02:10:00,0,2280.0,2051.0,0.9,11.252,77,38,18,20,39,0,39,52,0.0,0.0
1016,437,24-09-2019 02:12:00,0,2265.0,2099.0,0.927,11.249,135,87,53,34,48,6,42,63,0.0,0.0
1016,438,24-09-2019 02:14:00,0,1606.0,1444.0,0.899,7.927,623,318,245,73,305,229,76,11,0.0,0.0
1016,439,24-09-2019 02:16:00,0,1591.0,1498.0,0.942,7.928,501,250,185,65,251,170,81,24,0.02,0.0
1016,440,24-09-2019 02:18:00,0,1596.0,1495.5,0.9375,7.9455,1107,557,441,116,550,437,113,1,0.0,0.0
1016,441,24-09-2019 02:20:00,0,1601.0,1493.0,0.933,7.963,615,335,249,86,280,209,71,0,0.0,0.0
1016,442,24-09-2019 02:22:00,0,2276.0,2095.0,0.92,11.287,506,270,216,54,236,182,54,88,0.01,0.0
1016,443,24-09-2019 02:24:00,0,1880.0,1691.0,0.899,9.281,979,600,484,116,379,299,80,5,0.0,0.0
1016,444,24-09-2019 02:26:00,0,2564.0,2294.0,0.895,12.642,697,428,340,88,269,201,68,18,0.0,0.01
1016,445,24-09-2019 02:28:00,0,2074.0,1944.0,0.937,10.325,380,104,68,36,276,219,57,23,0.11,0.0
1016,446,24-09-2019 02:30:00,0,1828.0,1556.0,0.851,8.926,309,112,74,38,197,151,46,4,0.0,0.0
1016,447,24-09-2019 02:32:00,0,1803.0,1539.0,0.854,8.807,88,63,29,34,25,4,21,1,0.0,0.0
1016,448,24-09-2019 02:34:00,0,1800.0,1534.0,0.852,8.791,31,29,11,18,2,1,1,0,0.0,0.0
1016,449,24-09-2019 02:36:00,0,1904.0,1784.0,0.937,9.476,91,51,27,24,40,16,24,6,0.0,0.0
1016,450,24-09-2019 02:38:00,0,2088.0,1864.0,0.893,10.288,367,212,150,62,155,111,44,16,0.0,0.0
1016,451,24-09-2019 02:40:00,0,1886.0,1670.0,0.885,9.279,286,134,97,37,152,110,42,20,0.0,0.0
1016,452,24-09-2019 02:42:00,0,1900.0,1686.0,0.888,9.352,364,145,101,44,219,168,51,0,0.0,0.0
1016,453,24-09-2019 02:44:00,0,1916.0,1665.0,0.869,9.393,179,50,19,31,129,79,50,1,0.0,0.0
1016,454,24-09-2019 02:46:00,0,1935.0,1623.0,0.839,9.419,8,0,0,0,8,0,8,0,0.0,0.0
1016,455,24-09-2019 02:48:00,0,1605.0,1443.0,0.899,7.922,25,9,0,9,16,2,14,0,0.0,0.0
1016,456,24-09-2019 02:50:00,0,1415.0,1239.0,0.875,6.948,5,2,1,1,3,1,2,0,0.0,0.0
1016,457,24-09-2019 02:52:00,0,1421.5,1269.5,0.8925,7.0075,12,1,0,1,11,5,6,0,0.0,0.0
1016,458,24-09-2019 02:54:00,0,1428.0,1300.0,0.91,7.067,42,16,9,7,26,8,18,0,0.0,0.0
1016,459,24-09-2019 02:56:00,0,1438.0,1274.0,0.886,7.075,14,0,0,0,14,0,14,0,0.0,0.0
1016,460,24-09-2019 02:58:00,0,1434.0,1173.0,0.818,6.95,20,0,0,0,20,8,12,0,0.02,0.0
1016,461,24-09-2019 03:00:00,0,1110.0,1108.0,0.998,5.598,30,0,0,0,30,19,11,0,0.0,0.0
1016,462,24-09-2019 03:02:00,0,1134.0,1055.0,0.93,5.638,24,6,1,5,18,11,7,0,0.0,0.0
1016,463,24-09-2019 03:04:00,0,1128.0,1074.0,0.952,5.633,13,6,3,3,7,3,4,0,0.0,0.0
1016,464,24-09-2019 03:06:00,0,1107.0,1110.0,1.003,5.591,1,1,1,0,0,0,0,0,0.0,0.0
1016,465,24-09-2019 03:08:00,0,1226.0,1145.0,0.933,6.099,22,8,7,1,14,5,9,0,0.0,0.0
1016,466,24-09-2019 03:10:00,0,1447.0,1203.0,0.831,7.031,21,0,0,0,21,0,21,0,0.0,0.0
1016,467,24-09-2019 03:12:00,0,1448.0,1189.0,0.821,7.021,11,6,0,6,5,0,5,0,0.0,0.0
1016,468,24-09-2019 03:14:00,0,1343.0,1183.0,0.881,6.601,46,6,3,3,40,20,20,0,0.0,0.0
1016,469,24-09-2019 03:16:00,0,1336.0,1159.0,0.867,6.546,2,0,0,0,2,0,2,0,0.0,0.0
1016,470,24-09-2019 03:18:00,0,1126.0,1084.0,0.963,5.637,20,7,1,6,13,5,8,0,0.0,0.0
1016,471,24-09-2019 03:20:00,0,1133.0,1045.0,0.922,5.623,10,5,0,5,5,2,3,0,0.0,0.0
1016,472,24-09-2019 03:22:00,0,1140.0,1016.0,0.891,5.618,0,0,0,0,0,0,0,0,0.0,0.0
1016,473,24-09-2019 03:24:00,0,1143.0,989.0,0.865,5.6,0,0,0,0,0,0,0,0,0.0,0.0
1016,474,24-09-2019 03:26:00,0,1301.5,1096.5,0.845,6.3425,0,0,0,0,0,0,0,0,0.0,0.0
1016,475,24-09-2019 03:28:00,0,1460.0,1204.0,0.825,7.085,5,0,0,0,5,2,3,0,0.0,0.0
1016,476,24-09-2019 03:30:00,0,1451.0,1183.0,0.815,7.027,19,4,0,4,15,6,9,0,0.0,0.0
1016,477,24-09-2019 03:32:00,0,1339.0,1136.0,0.848,6.535,19,8,1,7,11,6,5,0,0.0,0.0
1016,478,24-09-2019 03:34:00,0,1224.0,1109.0,0.906,6.049,1,0,0,0,1,0,1,0,0.0,0.0
1016,479,24-09-2019 03:36:00,0,1335.0,1138.0,0.853,6.52,17,5,1,4,12,3,9,0,0.0,0.0
1016,480,24-09-2019 03:38:00,0,1447.0,1198.0,0.828,7.029,3,2,1,1,1,0,1,0,0.0,0.0
1016,481,24-09-2019 03:40:00,0,1454.0,1240.0,0.853,7.102,14,2,0,2,12,3,9,0,0.0,0.0
1016,482,24-09-2019 03:42:00,0,1443.0,1201.0,0.832,7.015,169,61,33,28,108,70,38,0,0.0,0.0
1016,483,24-09-2019 03:44:00,0,1627.0,1377.0,0.846,7.935,274,125,88,37,149,103,46,37,0.0,0.01
1016,484,24-09-2019 03:46:00,0,1629.0,1376.0,0.845,7.942,352,151,109,42,201,151,50,51,0.0,0.0
1016,485,24-09-2019 03:48:00,0,1596.0,1513.0,0.948,7.963,320,76,43,33,244,173,71,13,0.0,0.0
1016,486,24-09-2019 03:50:00,0,1710.0,1567.0,0.916,8.472,96,44,21,23,52,28,24,4,0.0,0.0
1016,487,24-09-2019 03:52:00,0,1805.0,1563.0,0.866,8.843,96,76,43,33,20,4,16,1,0.0,0.0
1016,488,24-09-2019 03:54:00,0,1897.0,1607.0,0.847,9.252,106,47,16,31,59,38,21,0,0.0,0.0
1016,489,24-09-2019 03:56:00,0,1785.0,1603.0,0.898,8.808,38,21,8,13,17,4,13,1,0.0,0.0
1016,490,24-09-2019 03:58:00,0,1621.0,1454.0,0.897,7.997,3,3,0,3,0,0,0,0,0.0,0.0
1016,491,24-09-2019 04:00:00,0,1632.0,1423.0,0.872,8.0055,3,1,0,1,2,0,2,0,0.0,0.0
1016,492,24-09-2019 04:02:00,0,1643.0,1392.0,0.847,8.014,3,1,0,1,2,0,2,0,0.0,0.0
1016,493,24-09-2019 04:04:00,0,1409.0,1272.0,0.903,6.96,56,43,18,25,13,6,7,0,0.0,0.0
1016,494,24-09-2019 04:06:00,0,1634.0,1327.0,0.812,7.909,108,43,14,29,65,49,16,1,0.0,0.0
1016,495,24-09-2019 04:08:00,0,1540.0,1327.0,0.861,7.538,129,68,43,25,61,10,51,44,0.0,0.0
1016,496,24-09-2019 04:10:00,0,1837.0,1531.0,0.834,8.932,73,21,7,14,52,2,50,47,0.0,0.0
1016,497,24-09-2019 04:12:00,0,1902.0,1668.0,0.877,9.339,70,36,20,16,34,0,34,58,0.0,0.0
1016,498,24-09-2019 04:14:00,0,1986.0,1738.0,0.875,9.75,82,32,19,13,50,2,48,53,0.0,0.01
1016,499,24-09-2019 04:16:00,0,1994.0,1758.0,0.882,9.804,112,51,30,21,61,6,55,61,0.0,0.0
1016,500,24-09-2019 04:18:00,0,1903.0,1711.0,0.899,9.391,104,46,27,19,58,11,47,59,0.0,0.04
1016,501,24-09-2019 04:20:00,0,2009.0,1772.0,0.882,9.876,94,50,28,22,44,2,42,48,0.0,0.0
1016,502,24-09-2019 04:22:00,0,2099.0,1815.0,0.865,10.28,98,40,17,23,58,4,54,47,0.0,0.11
1016,503,24-09-2019 04:24:00,0,1620.0,1418.0,0.875,7.953,282,149,119,30,133,86,47,44,0.0,0.03
1016,504,24-09-2019 04:26:00,0,1995.0,1728.0,0.866,9.773,449,229,191,38,220,155,65,62,0.11,0.09
1016,505,24-09-2019 04:28:00,0,1817.0,1577.0,0.868,8.904,282,118,89,29,164,119,45,52,0.01,0.0
1016,506,24-09-2019 04:30:00,0,1639.0,1366.0,0.833,7.969,366,76,45,31,290,243,47,12,0.0,0.0
1016,507,24-09-2019 04:32:00,0,1912.0,1696.0,0.887,9.412,464,206,154,52,258,198,60,60,0.12,0.0
1016,508,24-09-2019 04:34:00,0,2008.0,1742.5,0.8685,9.842,405,190,142,48,215,152,63,0,0.0,0.0
1016,509,24-09-2019 04:36:00,0,2104.0,1789.0,0.85,10.272,623,338,269,69,285,218,67,22,0.01,0.0
1016,510,24-09-2019 04:38:00,0,2114.0,1813.0,0.857,10.337,154,93,59,34,61,11,50,53,0.0,0.0
1016,511,24-09-2019 04:40:00,0,2081.0,1947.0,0.936,10.355,101,46,26,20,55,0,55,59,0.0,0.02
1016,512,24-09-2019 04:42:00,0,2044.0,1928.0,0.943,10.188,78,25,17,8,53,0,53,46,0.0,0.08
1016,513,24-09-2019 04:44:00,0,1971.0,1793.0,0.91,9.749,96,46,26,20,50,2,48,64,0.0,0.08
1016,514,24-09-2019 04:46:00,0,2094.0,1864.0,0.89,10.315,99,37,24,13,62,0,62,49,0.01,0.04
1016,515,24-09-2019 04:48:00,0,2113.0,1830.0,0.866,10.349,89,37,18,19,52,0,52,52,0.0,0.06
1016,516,24-09-2019 04:50:00,0,2077.0,2006.0,0.966,10.403,271,123,99,24,148,103,45,88,0.0,0.04
1016,517,24-09-2019 04:52:00,0,2050.0,1927.0,0.94,10.212,350,123,96,27,227,167,60,30,0.13,0.0
1016,518,24-09-2019 04:54:00,0,1609.0,1432.0,0.89,7.924,579,295,228,67,284,211,73,0,0.0,0.0
1016,519,24-09-2019 04:56:00,0,1609.0,1377.0,0.856,7.864,362,177,134,43,185,135,50,0,0.0,0.0
1016,520,24-09-2019 04:58:00,0,1621.0,1479.0,0.912,8.025,78,17,5,12,61,43,18,0,0.0,0.0
1016,521,24-09-2019 05:00:00,0,2009.0,1783.0,0.887,9.891,142,35,16,19,107,70,37,3,0.01,0.0
1016,522,24-09-2019 05:02:00,0,2086.0,1874.0,0.899,10.294,37,11,4,7,26,6,20,0,0.0,0.01
1016,523,24-09-2019 05:04:00,0,1862.0,1728.0,0.928,9.248,26,1,0,1,25,0,25,0,0.01,0.0
1016,524,24-09-2019 05:06:00,0,1620.0,1387.0,0.856,7.918,86,4,3,1,82,57,25,0,0.0,0.0
1016,525,24-09-2019 05:08:00,0,1574.5,1382.0,0.8785,7.734,27,1,1,0,26,8,18,0,0.0,0.0
1016,526,24-09-2019 05:10:00,0,1529.0,1377.0,0.901,7.55,28,9,5,4,19,11,8,0,0.0,0.0
1016,527,24-09-2019 05:12:00,0,1632.0,1396.0,0.856,7.977,3,0,0,0,3,1,2,0,0.0,0.0
1016,528,24-09-2019 05:14:00,0,1626.0,1393.0,0.857,7.948,4,0,0,0,4,0,4,0,0.0,0.0
1016,529,24-09-2019 05:16:00,0,1628.0,1412.0,0.868,7.976,50,9,2,7,41,1,40,0,0.0,0.0
1016,530,24-09-2019 05:18:00,0,1606.0,1481.0,0.922,7.965,69,20,9,11,49,25,24,0,0.0,0.0
1016,531,24-09-2019 05:20:00,0,1513.0,1406.0,0.929,7.519,2,2,1,1,0,0,0,0,0.0,0.0
1016,532,24-09-2019 05:22:00,0,1397.0,1341.0,0.96,6.987,13,11,5,6,2,0,2,0,0.0,0.0
1016,533,24-09-2019 05:24:00,0,1396.0,1337.0,0.958,6.981,39,0,0,0,39,1,38,0,0.0,0.0
1016,534,24-09-2019 05:26:00,0,1410.0,1321.0,0.937,7.019,14,1,1,0,13,6,7,0,0.0,0.0
1016,535,24-09-2019 05:28:00,0,1516.0,1398.0,0.922,7.52,188,77,44,33,111,63,48,0,0.0,0.0
1016,536,24-09-2019 05:30:00,0,1609.0,1500.0,0.933,7.999,300,162,119,43,138,90,48,31,0.0,0.01
1016,537,24-09-2019 05:32:00,0,1604.0,1479.0,0.922,7.956,288,142,103,39,146,97,49,11,0.0,0.0
1016,538,24-09-2019 05:34:00,0,1585.0,1500.0,0.947,7.906,289,46,17,29,243,176,67,10,0.0,0.0
1016,539,24-09-2019 05:36:00,0,1669.0,1586.0,0.951,8.33,272,30,19,11,242,186,56,2,0.0,0.0
1016,540,24-09-2019 05:38:00,0,1581.0,1570.0,0.993,7.969,685,230,181,49,455,372,83,25,0.09,0.0
1016,541,24-09-2019 05:40:00,0,1617.0,1471.0,0.91,7.998,237,115,78,37,122,54,68,50,0.0,0.0
1016,542,24-09-2019 05:42:00,0,1746.5,1588.5,0.9095,8.6395,233,56,28,28,177,114,63,9,0.0,0.41
1016,543,24-09-2019 05:44:00,0,1876.0,1706.0,0.909,9.281,73,2,0,2,71,29,42,0,0.0,0.0
1016,544,24-09-2019 05:46:00,0,1876.0,1776.0,0.946,9.358,95,11,3,8,84,50,34,12,0.0,0.0
1016,545,24-09-2019 05:48:00,0,1877.0,1798.0,0.958,9.386,192,95,70,25,97,69,28,60,0.0,0.0
1016,546,24-09-2019 05:50:00,0,1892.0,1781.0,0.941,9.427,114,51,34,17,63,40,23,44,0.0,0.0
1016,547,24-09-2019 05:52:00,0,1890.0,1774.0,0.939,9.409,73,12,6,6,61,34,27,0,0.0,0.0
1016,548,24-09-2019 05:54:00,0,1887.0,1766.0,0.936,9.391,103,54,35,19,49,20,29,2,0.0,0.0
1016,549,24-09-2019 05:56:00,0,1887.0,1689.0,0.895,9.304,4,2,1,1,2,1,1,0,0.0,0.0
1016,550,24-09-2019 05:58:00,0,1710.0,1570.0,0.918,8.475,5,0,0,0,5,0,5,0,0.01,0.01
1016,551,24-09-2019 06:00:00,1,1620.0,1411.0,0.871,7.944,219,29,12,17,190,159,31,11,0.0,0.0
1016,552,24-09-2019 06:02:00,1,1621.0,1501.0,0.926,8.047,322,55,32,23,267,230,37,10,0.0,0.0
1016,553,24-09-2019 06:04:00,1,1604.0,1520.0,0.948,8.001,25,1,0,1,24,4,20,0,0.0,0.0
1016,554,24-09-2019 06:06:00,1,1613.0,1424.0,0.883,7.934,9,0,0,0,9,4,5,0,0.0,0.0
1016,555,24-09-2019 06:08:00,1,1511.0,1361.0,0.901,7.462,6,0,0,0,6,0,6,0,0.0,0.0
1016,556,24-09-2019 06:10:00,1,1421.0,1296.0,0.912,7.032,14,0,0,0,14,4,10,0,0.0,0.0
1016,557,24-09-2019 06:12:00,1,1440.0,1252.0,0.87,7.059,8,0,0,0,8,1,7,0,0.0,0.0
1016,558,24-09-2019 06:14:00,1,1219.0,1182.0,0.969,6.113,24,0,0,0,24,8,16,0,0.0,0.0
1016,559,24-09-2019 06:16:00,1,1368.5,1240.0,0.912,6.7655,54,11,5,6,43,25,18,0,0.0,0.0
1016,560,24-09-2019 06:18:00,1,1518.0,1298.0,0.855,7.418,40,0,0,0,40,18,22,0,0.0,0.0
1016,561,24-09-2019 06:20:00,1,1424.0,1279.0,0.898,7.028,614,6,1,5,608,569,39,0,0.0,0.01
1016,562,24-09-2019 06:22:00,1,1438.0,1264.0,0.879,7.066,34,0,0,0,34,17,17,0,0.04,0.0
1016,563,24-09-2019 06:24:00,1,1344.0,1163.0,0.865,6.584,20,2,0,2,18,3,15,0,0.0,0.0
1016,564,24-09-2019 06:26:00,1,1222.0,1114.0,0.912,6.048,21,1,0,1,20,2,18,0,0.0,0.0
1016,565,24-09-2019 06:28:00,1,1221.0,1142.0,0.935,6.077,8,2,0,2,6,3,3,0,0.0,0.0
1016,566,24-09-2019 06:30:00,1,1436.0,1212.0,0.844,7.001,111,54,39,15,57,32,25,5,0.0,0.03
1016,567,24-09-2019 06:32:00,1,1814.0,1602.0,0.883,8.92,217,143,109,34,74,42,32,35,0.0,0.0
1016,568,24-09-2019 06:34:00,1,1802.0,1579.0,0.876,8.848,243,153,119,34,90,55,35,66,0.0,0.0
1016,569,24-09-2019 06:36:00,1,1880.0,1671.0,0.889,9.255,196,115,84,31,81,53,28,35,0.02,0.0
1016,570,24-09-2019 06:38:00,1,1892.0,1766.0,0.933,9.411,164,95,64,31,69,40,29,29,0.0,0.0
1016,571,24-09-2019 06:40:00,1,2096.0,1843.0,0.879,10.3,211,109,77,32,102,62,40,43,0.15,0.0
1016,572,24-09-2019 06:42:00,1,1911.0,1626.0,0.851,9.331,93,45,26,19,48,12,36,5,0.0,0.0
1016,573,24-09-2019 06:44:00,1,1898.0,1662.0,0.876,9.319,118,32,9,23,86,47,39,0,0.02,0.0
1016,574,24-09-2019 06:46:00,1,1888.0,1715.0,0.908,9.339,169,46,19,27,123,86,37,0,0.0,0.0
1016,575,24-09-2019 06:48:00,1,1921.0,1634.0,0.85,9.379,170,23,9,14,147,112,35,0,0.01,0.0
1016,576,24-09-2019 06:50:00,1,1960.5,1731.0,0.882,9.6415,270,117,80,37,153,112,41,5,0.0,0.0
1016,577,24-09-2019 06:52:00,1,2000.0,1828.0,0.914,9.904,222,101,65,36,121,78,43,40,0.0,0.0
1016,578,24-09-2019 06:54:00,1,1867.0,1778.0,0.952,9.323,519,254,196,58,265,190,75,25,0.0,0.0
1016,579,24-09-2019 06:56:00,1,1898.0,1730.0,0.911,9.394,370,150,98,52,220,166,54,8,0.0,0.0
1016,580,24-09-2019 06:58:00,1,1895.0,1683.0,0.888,9.33,179,83,63,20,96,67,29,28,0.0,0.0
1016,581,24-09-2019 07:00:00,1,1940.0,1619.0,0.835,9.437,119,53,37,16,66,31,35,2,0.0,0.0
1016,582,24-09-2019 07:02:00,1,1795.0,1573.0,0.876,8.815,100,30,0,30,70,31,39,0,0.0,0.0
1016,583,24-09-2019 07:04:00,1,1694.0,1522.0,0.898,8.36,115,51,16,35,64,23,41,0,0.0,0.0
1016,584,24-09-2019 07:06:00,1,1588.0,1475.0,0.929,7.889,24,9,3,6,15,11,4,0,0.0,0.0
1016,585,24-09-2019 07:08:00,1,1651.0,1403.0,0.849,8.06,23,9,3,6,14,9,5,0,0.0,0.0
1016,586,24-09-2019 07:10:00,1,1435.0,1278.0,0.891,7.069,11,5,1,4,6,4,2,0,0.0,0.0
1016,587,24-09-2019 07:12:00,1,1424.0,1173.0,0.824,6.908,19,6,3,3,13,5,8,0,0.0,0.0
1016,588,24-09-2019 07:14:00,1,1238.0,1067.0,0.862,6.058,39,0,0,0,39,25,14,0,0.0,0.0
1016,589,24-09-2019 07:16:00,1,1155.0,985.0,0.853,5.641,245,1,0,1,244,217,27,0,0.0,0.0
1016,590,24-09-2019 07:18:00,1,1176.0,946.0,0.805,5.68,0,0,0,0,0,0,0,0,0.0,0.0
1016,591,24-09-2019 07:20:00,1,1177.0,913.0,0.775,5.65,23,11,4,7,12,3,9,0,0.0,0.0
1016,592,24-09-2019 07:22:00,1,1171.0,903.0,0.771,5.613,27,3,1,2,24,2,22,0,0.0,0.0
1016,593,24-09-2019 07:24:00,1,1093.5,969.0,0.895,5.3815,18,0,0,0,18,0,18,0,0.0,0.0
1016,594,24-09-2019 07:26:00,1,1016.0,1035.0,1.019,5.15,64,0,0,0,64,11,53,0,0.0,0.0
1016,595,24-09-2019 07:28:00,1,1238.0,1079.0,0.872,6.071,62,0,0,0,62,19,43,0,0.01,0.0
1016,596,24-09-2019 07:30:00,1,1028.0,1048.0,1.02,5.211,32,4,2,2,28,13,15,0,0.0,0.0
1016,597,24-09-2019 07:32:00,1,1033.0,967.0,0.936,5.14,50,15,11,4,35,13,22,0,0.0,0.0
1016,598,24-09-2019 07:34:00,1,1126.0,1032.0,0.916,5.58,15,0,0,0,15,0,15,0,0.0,0.0
1016,599,24-09-2019 07:36:00,1,1333.0,1170.0,0.877,6.548,5,0,0,0,5,0,5,0,0.0,0.0
1016,600,24-09-2019 07:38:00,1,1314.0,1271.0,0.967,6.584,8,0,0,0,8,0,8,0,0.0,0.0
1016,601,24-09-2019 07:40:00,1,1533.0,1311.0,0.855,7.491,191,107,74,33,84,52,32,4,0.0,0.0
1016,602,24-09-2019 07:42:00,1,1484.0,1461.0,0.985,7.463,196,92,63,29,104,62,42,3,0.0,0.0
1016,603,24-09-2019 07:44:00,1,1806.0,1617.0,0.895,8.906,198,80,33,47,118,74,44,4,0.0,0.0
1016,604,24-09-2019 07:46:00,1,1805.0,1609.0,0.891,8.892,227,109,79,30,118,81,37,98,0.0,0.0
1016,605,24-09-2019 07:48:00,1,1708.0,1564.0,0.916,8.46,51,15,7,8,36,19,17,0,0.0,0.0
1016,606,24-09-2019 07:50:00,1,1488.0,1483.0,0.996,7.506,104,19,5,14,85,40,45,0,0.0,0.0
1016,607,24-09-2019 07:52:00,1,1519.0,1327.0,0.874,7.454,48,1,0,1,47,26,21,0,0.0,0.0
1016,608,24-09-2019 07:54:00,1,1322.0,1235.0,0.934,6.577,120,0,0,0,120,79,41,0,0.0,0.0
1016,609,24-09-2019 07:56:00,1,1032.0,983.0,0.952,5.156,313,0,0,0,313,264,49,0,0.0,0.0
1016,610,24-09-2019 07:58:00,1,1141.5,1027.5,0.9045,5.636,49,25,10,15,24,9,15,0,0.0,0.0
1016,611,24-09-2019 08:00:00,1,1251.0,1072.0,0.857,6.116,12,3,0,3,9,3,6,0,0.0,0.0
1016,612,24-09-2019 08:02:00,1,1329.0,1103.0,0.83,6.458,25,8,4,4,17,9,8,0,0.0,0.0
1016,613,24-09-2019 08:04:00,1,1446.0,1207.0,0.834,7.035,16,1,0,1,15,7,8,0,0.0,0.0
1016,614,24-09-2019 08:06:00,1,1444.0,1225.0,0.848,7.047,9,1,1,0,8,4,4,0,0.0,0.0
1016,615,24-09-2019 08:08:00,1,1458.0,1185.0,0.813,7.056,31,9,1,8,22,0,22,0,0.0,0.0
1016,616,24-09-2019 08:10:00,1,1437.0,1118.0,0.778,6.901,23,3,1,2,20,11,9,0,0.0,0.0
1016,617,24-09-2019 08:12:00,1,1439.0,1175.0,0.816,6.972,18,0,0,0,18,9,9,0,0.0,0.0
1016,618,24-09-2019 08:14:00,1,1455.0,1170.0,0.804,7.026,30,0,0,0,30,15,15,0,0.0,0.0
1016,619,24-09-2019 08:16:00,1,1451.0,1180.0,0.813,7.024,102,0,0,0,102,76,26,0,0.0,0.0
1016,620,24-09-2019 08:18:00,1,1456.0,1227.0,0.843,7.095,264,27,6,21,237,209,28,1,0.0,0.0
1016,621,24-09-2019 08:20:00,1,1533.0,1351.0,0.882,7.535,74,15,9,6,59,22,37,0,0.0,0.0
1016,622,24-09-2019 08:22:00,1,1626.0,1373.0,0.844,7.927,116,35,27,8,81,43,38,6,0.0,0.0
1016,623,24-09-2019 08:24:00,1,1690.0,1542.0,0.912,8.367,128,84,64,20,44,9,35,41,0.0,0.0
1016,624,24-09-2019 08:26:00,1,1708.0,1546.0,0.905,8.443,110,36,17,19,74,45,29,25,0.0,0.0
1016,625,24-09-2019 08:28:00,1,1620.0,1473.0,0.909,8.013,115,66,41,25,49,27,22,51,0.0,0.0
1016,626,24-09-2019 08:30:00,1,1634.0,1395.0,0.854,7.982,346,164,136,28,182,141,41,132,0.0,0.0
1016,627,24-09-2019 08:32:00,1,1613.5,1423.0,0.8825,7.932,194,90,59,31,104,72,32,22,0.0,0.0
1016,628,24-09-2019 08:34:00,1,1593.0,1451.0,0.911,7.882,444,57,33,24,387,326,61,3,0.0,0.0
1016,629,24-09-2019 08:36:00,1,1813.0,1534.0,0.846,8.842,432,192,143,49,240,179,61,17,0.0,0.0
1016,630,24-09-2019 08:38:00,1,1819.0,1550.0,0.852,8.883,312,146,101,45,166,120,46,9,0.0,0.0
1016,631,24-09-2019 08:40:00,1,1947.0,1591.0,0.817,9.431,246,123,83,40,123,79,44,0,0.0,0.0
1016,632,24-09-2019 08:42:00,1,1614.0,1427.0,0.884,7.938,354,137,94,43,217,169,48,9,0.0,0.0
1016,633,24-09-2019 08:44:00,1,1830.0,1544.0,0.844,8.92,634,297,228,69,337,266,71,6,0.0,0.0
1016,634,24-09-2019 08:46:00,1,1621.0,1441.0,0.889,7.981,681,257,194,63,424,372,52,0,0.0,0.0
1016,635,24-09-2019 08:48:00,1,1644.0,1321.0,0.803,7.94,478,263,214,49,215,162,53,10,0.0,0.01
1016,636,24-09-2019 08:50:00,1,1623.0,1392.0,0.858,7.936,155,57,33,24,98,53,45,11,0.0,0.0
1016,637,24-09-2019 08:52:00,1,1633.0,1405.0,0.86,7.991,541,260,206,54,281,218,63,5,0.0,0.0
1016,638,24-09-2019 08:54:00,1,1656.0,1300.0,0.785,7.964,362,193,148,45,169,125,44,3,0.0,0.0
1016,639,24-09-2019 08:56:00,1,1627.0,1429.0,0.879,7.991,166,25,6,19,141,93,48,0,0.0,0.0
1016,640,24-09-2019 08:58:00,1,1631.0,1385.0,0.849,7.96,56,23,9,14,33,20,13,1,0.0,0.0
1016,641,24-09-2019 09:00:00,1,1662.0,1331.0,0.801,8.022,173,71,45,26,102,69,33,0,0.0,0.0
1016,642,24-09-2019 09:02:00,1,1638.0,1382.0,0.843,7.986,39,35,11,24,4,1,3,0,0.0,0.0
1016,643,24-09-2019 09:04:00,1,1452.0,1185.0,0.816,7.034,27,27,5,22,0,0,0,0,0.0,0.0
1016,644,24-09-2019 09:06:00,1,1454.0,1149.5,0.791,7.002,5,1,0,1,4,1,3,0,0.0,0.0
1016,645,24-09-2019 09:08:00,1,1456.0,1114.0,0.766,6.97,6,0,0,0,6,0,6,0,0.01,0.0
1016,646,24-09-2019 09:10:00,1,1161.0,979.0,0.844,5.657,8,0,0,0,8,0,8,0,0.0,0.0
1016,647,24-09-2019 09:12:00,1,1186.0,887.0,0.748,5.656,0,0,0,0,0,0,0,0,0.0,0.0
1016,648,24-09-2019 09:14:00,1,1178.0,866.0,0.735,5.601,7,5,3,2,2,1,1,0,0.0,0.0
1016,649,24-09-2019 09:16:00,1,1177.0,898.0,0.763,5.63,0,0,0,0,0,0,0,0,0.0,0.0
1016,650,24-09-2019 09:18:00,1,1154.0,893.0,0.774,5.536,0,0,0,0,0,0,0,0,0.0,0.0
1016,651,24-09-2019 09:20:00,1,1182.0,915.0,0.774,5.671,1,1,1,0,0,0,0,0,0.0,0.0
1016,652,24-09-2019 09:22:00,1,1153.0,981.0,0.851,5.628,112,92,65,27,20,13,7,0,0.0,0.0
1016,653,24-09-2019 09:24:00,1,1138.0,999.0,0.878,5.589,30,22,14,8,8,4,4,0,0.0,0.0
1016,654,24-09-2019 09:26:00,1,1138.0,969.0,0.851,5.558,17,1,0,1,16,2,14,0,0.0,0.0
1016,655,24-09-2019 09:28:00,1,1146.0,969.0,0.846,5.587,12,0,0,0,12,0,12,0,0.0,0.0
1016,656,24-09-2019 09:30:00,1,1165.0,964.0,0.828,5.66,27,0,0,0,27,0,27,0,0.0,0.0
1016,657,24-09-2019 09:32:00,1,1180.0,928.0,0.786,5.675,30,0,0,0,30,3,27,0,0.0,0.01
1016,658,24-09-2019 09:34:00,1,1179.0,870.0,0.737,5.608,339,10,3,7,329,291,38,0,0.0,0.0
1016,659,24-09-2019 09:36:00,1,1067.0,847.0,0.793,5.143,19,3,0,3,16,3,13,0,0.0,0.0
1016,660,24-09-2019 09:38:00,1,1070.0,845.0,0.789,5.153,39,14,7,7,25,12,13,0,0.0,0.0
1016,661,24-09-2019 09:40:00,1,1270.0,997.0,0.7855,6.108,15,3,0,3,12,2,10,0,0.0,0.0
1016,662,24-09-2019 09:42:00,1,1470.0,1149.0,0.782,7.063,28,22,6,16,6,0,6,0,0.0,0.0
1016,663,24-09-2019 09:44:00,1,1452.0,1168.0,0.804,7.013,18,9,5,4,9,4,5,0,0.0,0.0
1016,664,24-09-2019 09:46:00,1,1434.0,1229.0,0.857,7.012,105,71,46,25,34,22,12,0,0.0,0.0
1016,665,24-09-2019 09:48:00,1,1540.0,1269.0,0.824,7.471,300,138,101,37,162,107,55,18,0.0,0.0
1016,666,24-09-2019 09:50:00,1,1655.0,1303.0,0.788,7.963,234,90,47,43,144,98,46,20,0.0,0.0
1016,667,24-09-2019 09:52:00,1,1546.0,1264.0,0.818,7.489,276,46,31,15,230,189,41,0,0.0,0.0
1016,668,24-09-2019 09:54:00,1,1435.0,1199.0,0.835,6.983,349,1,0,1,348,308,40,0,0.0,0.0
1016,669,24-09-2019 09:56:00,1,1441.0,1224.0,0.85,7.033,281,18,2,16,263,217,46,1,0.0,0.0
1016,670,24-09-2019 09:58:00,1,1472.0,1107.0,0.752,7.024,25,0,0,0,25,4,21,0,0.0,0.0
1016,671,24-09-2019 10:00:00,1,1152.0,998.0,0.866,5.645,35,0,0,0,35,31,4,0,0.0,0.0
1016,672,24-09-2019 10:02:00,1,1161.0,915.0,0.788,5.585,12,0,0,0,12,5,7,0,0.0,0.0
1016,673,24-09-2019 10:04:00,1,1165.0,923.0,0.793,5.611,30,3,2,1,27,9,18,0,0.0,0.0
1016,674,24-09-2019 10:06:00,1,1158.0,955.0,0.825,5.62,37,13,4,9,24,12,12,0,0.0,0.0
1016,675,24-09-2019 10:08:00,1,1168.0,915.0,0.783,5.614,1,0,0,0,1,0,1,0,0.0,0.0
1016,676,24-09-2019 10:10:00,1,1189.0,850.0,0.715,5.626,19,0,0,0,19,6,13,0,0.0,0.0
1016,677,24-09-2019 10:12:00,1,1171.0,853.0,0.728,5.561,26,0,0,0,26,0,26,0,0.0,0.0
1016,678,24-09-2019 10:14:00,1,1164.0,924.0,0.794,5.6105,27,0,0,0,27,25,2,0,0.0,0.0
1016,679,24-09-2019 10:16:00,1,1157.0,995.0,0.86,5.66,166,0,0,0,166,122,44,0,0.0,0.0
1016,680,24-09-2019 10:18:00,1,1155.0,973.0,0.842,5.629,56,0,0,0,56,16,40,0,0.0,0.0
1016,681,24-09-2019 10:20:00,1,1153.0,1003.0,0.871,5.652,19,1,1,0,18,6,12,0,0.0,0.0
1016,682,24-09-2019 10:22:00,1,1343.0,1048.0,0.78,6.453,66,0,0,0,66,25,41,0,0.0,0.0
1016,683,24-09-2019 10:24:00,1,1349.0,1044.0,0.774,6.47,346,3,1,2,343,312,31,0,0.0,0.0
1016,684,24-09-2019 10:26:00,1,1375.0,1042.0,0.758,6.57,213,10,8,2,203,179,24,0,0.0,0.0
1016,685,24-09-2019 10:28:00,1,1370.0,1059.0,0.773,6.571,178,0,0,0,178,141,37,0,0.0,0.0
1016,686,24-09-2019 10:30:00,1,1272.0,1029.0,0.809,6.15,19,4,2,2,15,3,12,0,0.0,0.0
1016,687,24-09-2019 10:32:00,1,1168.0,945.0,0.809,5.65,94,1,1,0,93,60,33,0,0.0,0.0
1016,688,24-09-2019 10:34:00,1,1168.0,858.0,0.735,5.55,17,5,1,4,12,5,7,0,0.0,0.0
1016,689,24-09-2019 10:36:00,1,1174.0,882.0,0.751,5.6,26,3,2,1,23,5,18,0,0.0,0.0
1016,690,24-09-2019 10:38:00,1,1075.0,816.0,0.759,5.139,24,0,0,0,24,0,24,0,0.0,0.0
1016,691,24-09-2019 10:40:00,1,969.0,801.0,0.827,4.706,120,5,3,2,115,91,24,0,0.0,0.0
1016,692,24-09-2019 10:42:00,1,1180.0,866.0,0.734,5.61,3,0,0,0,3,0,3,0,0.0,0.0
1016,693,24-09-2019 10:44:00,1,1150.0,961.0,0.835,5.595,1,0,0,0,1,0,1,0,0.0,0.0
1016,694,24-09-2019 10:46:00,1,1151.0,958.0,0.832,5.595,28,18,8,10,10,2,8,0,0.0,0.0
1016,695,24-09-2019 10:48:00,1,1315.0,1008.5,0.774,6.297,3,1,0,1,2,0,2,0,0.0,0.0
1016,696,24-09-2019 10:50:00,1,1479.0,1059.0,0.716,6.999,4,2,0,2,2,1,1,0,0.0,0.0
1016,697,24-09-2019 10:52:00,1,1263.0,1003.0,0.794,6.086,0,0,0,0,0,0,0,0,0.0,0.0
1016,698,24-09-2019 10:54:00,1,1149.0,944.0,0.822,5.571,8,0,0,0,8,2,6,0,0.0,0.0
1016,699,24-09-2019 10:56:00,1,1165.0,909.0,0.781,5.597,27,3,0,3,24,12,12,0,0.0,0.0
1016,700,24-09-2019 10:58:00,1,1170.0,890.0,0.76,5.597,48,13,9,4,35,20,15,0,0.0,0.0
1016,701,24-09-2019 11:00:00,1,1162.0,959.0,0.825,5.641,48,0,0,0,48,13,35,0,0.0,0.0
1016,702,24-09-2019 11:02:00,1,1157.0,967.0,0.836,5.629,136,0,0,0,136,83,53,0,0.0,0.0
1016,703,24-09-2019 11:04:00,1,1364.0,1025.0,0.751,6.508,348,0,0,0,348,270,78,0,0.0,0.0
1016,704,24-09-2019 11:06:00,1,1379.0,1034.0,0.75,6.577,182,17,7,10,165,122,43,0,0.0,0.0
1016,705,24-09-2019 11:08:00,1,1468.0,1126.0,0.767,7.03,204,45,25,20,159,127,32,4,0.0,0.0
1016,706,24-09-2019 11:10:00,1,1446.0,1209.0,0.836,7.035,142,62,48,14,80,51,29,18,0.0,0.03
1016,707,24-09-2019 11:12:00,1,1723.0,1410.0,0.818,8.349,203,138,104,34,65,33,32,71,0.0,0.0
1016,708,24-09-2019 11:14:00,1,1622.0,1370.0,0.845,7.908,121,70,42,28,51,25,26,0,0.0,0.0
1016,709,24-09-2019 11:16:00,1,1655.0,1322.0,0.799,7.987,69,5,4,1,64,38,26,0,0.0,0.0
1016,710,24-09-2019 11:18:00,1,1551.0,1247.0,0.804,7.493,95,8,0,8,87,50,37,0,0.0,0.0
1016,711,24-09-2019 11:20:00,1,1465.0,1161.0,0.792,7.059,117,19,9,10,98,43,55,1,0.0,0.0
1016,712,24-09-2019 11:22:00,1,1503.5,1185.5,0.7885,7.2375,110,16,6,10,94,52,42,0,0.02,0.0
1016,713,24-09-2019 11:24:00,1,1542.0,1210.0,0.785,7.416,43,1,0,1,42,19,23,0,0.0,0.0
1016,714,24-09-2019 11:26:00,1,1151.0,998.0,0.867,5.641,45,0,0,0,45,31,14,0,0.0,0.0
1016,715,24-09-2019 11:28:00,1,1181.0,864.0,0.731,5.611,20,2,0,2,18,2,16,0,0.0,0.0
1016,716,24-09-2019 11:30:00,1,1184.0,861.0,0.727,5.617,18,0,0,0,18,0,18,0,0.0,0.0
1016,717,24-09-2019 11:32:00,1,1176.0,847.0,0.72,5.57,12,0,0,0,12,0,12,0,0.0,0.0
1016,718,24-09-2019 11:34:00,1,1073.0,797.0,0.743,5.109,8,1,1,0,7,0,7,0,0.0,0.0
1016,719,24-09-2019 11:36:00,1,971.0,761.0,0.784,4.668,17,3,1,2,14,0,14,0,0.0,0.0
1016,720,24-09-2019 11:38:00,1,1086.0,784.0,0.722,5.146,18,0,0,0,18,0,18,0,0.0,0.0
1016,721,24-09-2019 11:40:00,1,1206.0,814.0,0.675,5.652,40,6,2,4,34,18,16,0,0.0,0.0
1016,722,24-09-2019 11:42:00,1,1191.0,856.0,0.718,5.64,32,0,0,0,32,14,18,0,0.0,0.0
1016,723,24-09-2019 11:44:00,1,1184.0,808.0,0.683,5.559,160,3,0,3,157,124,33,0,0.0,0.0
1016,724,24-09-2019 11:46:00,1,1180.0,839.0,0.711,5.578,66,7,0,7,59,33,26,0,0.0,0.0
1016,725,24-09-2019 11:48:00,1,1166.0,924.0,0.793,5.617,30,0,0,0,30,18,12,0,0.0,0.0
1016,726,24-09-2019 11:50:00,1,1196.0,865.0,0.723,5.671,64,6,4,2,58,43,15,0,0.0,0.0
1016,727,24-09-2019 11:52:00,1,1197.0,841.0,0.702,5.647,20,0,0,0,20,5,15,0,0.0,0.0
1016,728,24-09-2019 11:54:00,1,1193.0,806.0,0.675,5.595,12,0,0,0,12,0,12,0,0.0,0.0
1016,729,24-09-2019 11:56:00,1,1175.0,873.0,0.7435,5.5985,9,0,0,0,9,0,9,0,0.0,0.0
1016,730,24-09-2019 11:58:00,1,1157.0,940.0,0.812,5.602,11,0,0,0,11,0,11,0,0.0,0.0
1016,731,24-09-2019 12:00:00,1,1179.0,872.0,0.739,5.61,34,11,4,7,23,10,13,0,0.0,0.0
1016,732,24-09-2019 12:02:00,1,1178.0,887.0,0.753,5.622,28,10,0,10,18,7,11,0,0.0,0.0
1016,733,24-09-2019 12:04:00,1,1172.0,870.0,0.742,5.582,18,7,0,7,11,2,9,0,0.0,0.0
1016,734,24-09-2019 12:06:00,1,1168.0,872.0,0.747,5.566,24,4,1,3,20,6,14,0,0.0,0.0
1016,735,24-09-2019 12:08:00,1,1173.0,912.0,0.777,5.632,19,3,2,1,16,5,11,0,0.0,0.0
1016,736,24-09-2019 12:10:00,1,1272.0,969.0,0.761,6.084,72,7,2,5,65,33,32,0,0.0,0.0
1016,737,24-09-2019 12:12:00,1,1487.0,1040.0,0.699,7.01,166,6,2,4,160,146,14,0,0.0,0.0
1016,738,24-09-2019 12:14:00,1,1248.0,992.0,0.795,6.018,58,4,2,2,54,12,42,0,0.0,0.0
1016,739,24-09-2019 12:16:00,1,1253.0,980.0,0.782,6.021,41,3,1,2,38,10,28,0,0.0,0.0
1016,740,24-09-2019 12:18:00,1,1268.0,977.0,0.77,6.079,75,6,0,6,69,57,12,0,0.0,0.0
1016,741,24-09-2019 12:20:00,1,1173.0,917.0,0.782,5.635,110,12,6,6,98,65,33,0,0.0,0.0
1016,742,24-09-2019 12:22:00,1,1171.0,916.0,0.783,5.629,222,49,36,13,173,145,28,3,0.0,0.0
1016,743,24-09-2019 12:24:00,1,1483.0,1045.0,0.704,7.001,83,37,18,19,46,18,28,2,0.0,0.0
1016,744,24-09-2019 12:26:00,1,1455.0,1152.0,0.791,7.008,239,108,80,28,131,95,36,63,0.0,0.0
1016,745,24-09-2019 12:28:00,1,1483.0,1090.0,0.735,7.051,247,84,54,30,163,109,54,7,0.0,0.0
1016,746,24-09-2019 12:30:00,1,1675.0,1233.0,0.736,7.966,612,239,171,68,373,317,56,6,0.0,0.0
1016,747,24-09-2019 12:32:00,1,1867.0,1376.0,0.737,8.881,540,278,215,63,262,197,65,17,0.0,0.0
1016,748,24-09-2019 12:34:00,1,1844.0,1367.0,0.741,8.777,531,229,170,59,302,248,54,26,0.0,0.02
1016,749,24-09-2019 12:36:00,1,1974.0,1338.0,0.678,9.26,65,26,16,10,39,1,38,43,0.0,0.0
1016,750,24-09-2019 12:38:00,1,1758.0,1372.0,0.781,8.446,399,220,167,53,179,121,58,60,0.0,0.0
1016,751,24-09-2019 12:40:00,1,1767.0,1357.0,0.768,8.464,596,290,235,55,306,227,79,39,0.0,0.0
1016,752,24-09-2019 12:42:00,1,1393.0,1006.0,0.723,6.601,620,155,105,50,465,414,51,0,0.0,0.0
1016,753,24-09-2019 12:44:00,1,1657.0,1183.0,0.714,7.839,574,266,200,66,308,242,66,8,0.0,0.0
1016,754,24-09-2019 12:46:00,1,1652.0,1273.0,0.771,7.919,660,363,272,91,297,224,73,18,0.0,0.0
1016,755,24-09-2019 12:48:00,1,1684.0,1226.0,0.728,7.993,406,130,87,43,276,196,80,1,0.0,0.0
1016,756,24-09-2019 12:50:00,1,1664.0,1303.0,0.783,7.998,768,394,308,86,374,305,69,5,0.0,0.0
1016,757,24-09-2019 12:52:00,1,1659.0,1307.0,0.788,7.983,356,134,98,36,222,191,31,5,0.0,0.0
1016,758,24-09-2019 12:54:00,1,1669.0,1232.0,0.738,7.94,514,262,199,63,252,192,60,34,0.0,0.0
1016,759,24-09-2019 12:56:00,1,1670.0,1202.0,0.72,7.911,115,54,21,33,61,33,28,0,0.0,0.0
1016,760,24-09-2019 12:58:00,1,1656.0,1276.0,0.771,7.937,148,57,30,27,91,43,48,0,0.0,0.0
1016,761,24-09-2019 13:00:00,1,1650.0,1323.0,0.801,7.966,78,29,10,19,49,20,29,0,0.0,0.0
1016,762,24-09-2019 13:02:00,1,1568.0,1206.0,0.769,7.513,16,11,1,10,5,1,4,0,0.0,0.0
1016,763,24-09-2019 13:04:00,1,1513.5,1139.0,0.752,7.2245,8,4,1,3,4,2,2,0,0.0,0.0
1016,764,24-09-2019 13:06:00,1,1459.0,1072.0,0.735,6.936,38,24,14,10,14,4,10,0,0.0,0.0
1016,765,24-09-2019 13:08:00,1,1166.0,913.0,0.783,5.606,35,3,1,2,32,10,22,0,0.0,0.0
1016,766,24-09-2019 13:10:00,1,1202.0,816.0,0.679,5.641,33,13,6,7,20,8,12,0,0.0,0.0
1016,767,24-09-2019 13:12:00,1,1182.0,864.0,0.731,5.613,404,117,74,43,287,243,44,0,0.0,0.0
1016,768,24-09-2019 13:14:00,1,1461.0,1112.0,0.761,6.987,189,66,33,33,123,88,35,0,0.0,0.0
1016,769,24-09-2019 13:16:00,1,1553.0,1152.0,0.742,7.395,122,17,4,13,105,79,26,0,0.0,0.0
1016,770,24-09-2019 13:18:00,1,1652.0,1272.0,0.77,7.919,115,10,1,9,105,75,30,0,0.0,0.0
1016,771,24-09-2019 13:20:00,1,1674.0,1243.0,0.743,7.97,232,116,62,54,116,94,22,0,0.0,0.0
1016,772,24-09-2019 13:22:00,1,1460.0,1157.0,0.792,7.034,157,54,23,31,103,90,13,0,0.0,0.0
1016,773,24-09-2019 13:24:00,1,1457.0,1086.0,0.745,6.944,47,4,1,3,43,15,28,0,0.0,0.0
1016,774,24-09-2019 13:26:00,1,1381.0,969.0,0.702,6.514,80,2,0,2,78,42,36,0,0.0,0.0
1016,775,24-09-2019 13:28:00,1,1283.0,937.0,0.73,6.094,22,1,0,1,21,8,13,0,0.0,0.0
1016,776,24-09-2019 13:30:00,1,1189.0,864.0,0.727,5.641,6,6,0,6,0,0,0,0,0.0,0.0
1016,777,24-09-2019 13:32:00,1,1203.0,797.0,0.663,5.622,16,11,1,10,5,1,4,0,0.0,0.0
1016,778,24-09-2019 13:34:00,1,1195.0,791.0,0.661,5.585,189,5,2,3,184,146,38,0,0.0,0.0
1016,779,24-09-2019 13:36:00,1,1207.0,764.0,0.633,5.601,220,0,0,0,220,174,46,0,0.0,0.0
1016,780,24-09-2019 13:38:00,1,1186.0,845.0,0.714,5.6085,67,1,1,0,66,20,46,0,0.0,0.0
1016,781,24-09-2019 13:40:00,1,1165.0,926.0,0.795,5.616,43,16,12,4,27,21,6,0,0.0,0.0
1016,782,24-09-2019 13:42:00,1,1403.0,979.0,0.698,6.611,2,0,0,0,2,2,0,0,0.0,0.0
1016,783,24-09-2019 13:44:00,1,1380.0,961.0,0.696,6.499,0,0,0,0,0,0,0,0,0.0,0.0
1016,784,24-09-2019 13:46:00,1,1274.0,927.0,0.728,6.048,2,0,0,0,2,0,2,0,0.0,0.0
1016,785,24-09-2019 13:48:00,1,1280.0,924.0,0.722,6.068,1,0,0,0,1,0,1,0,0.0,0.0
1016,786,24-09-2019 13:50:00,1,1296.0,936.0,0.723,6.141,1,0,0,0,1,0,1,0,0.0,0.0
1016,787,24-09-2019 13:52:00,1,1170.0,931.0,0.796,5.642,44,9,2,7,35,18,17,0,0.0,0.0
1016,788,24-09-2019 13:54:00,1,1163.0,913.0,0.785,5.592,45,3,1,2,42,24,18,0,0.0,0.0
1016,789,24-09-2019 13:56:00,1,1263.0,943.0,0.746,6.021,474,0,0,0,474,443,31,0,0.0,0.0
1016,790,24-09-2019 13:58:00,1,1157.0,918.0,0.794,5.576,358,2,1,1,356,334,22,0,0.0,0.0
1016,791,24-09-2019 14:00:00,1,1167.0,908.0,0.778,5.603,41,1,0,1,40,34,6,0,0.0,0.0
1016,792,24-09-2019 14:02:00,1,1172.0,928.0,0.792,5.646,83,6,3,3,77,64,13,0,0.0,0.0
1016,793,24-09-2019 14:04:00,1,1179.0,917.0,0.778,5.66,88,14,8,6,74,59,15,0,0.0,0.0
1016,794,24-09-2019 14:06:00,1,1157.0,915.0,0.791,5.573,88,4,0,4,84,63,21,0,0.0,0.0
1016,795,24-09-2019 14:08:00,1,1168.0,901.0,0.771,5.599,40,1,0,1,39,36,3,0,0.0,0.0
1016,796,24-09-2019 14:10:00,1,1177.0,866.0,0.736,5.598,35,11,5,6,24,15,9,0,0.0,0.0
1016,797,24-09-2019 14:12:00,1,1330.0,965.5,0.727,6.311,13,6,1,5,7,2,5,0,0.0,0.0
1016,798,24-09-2019 14:14:00,1,1483.0,1065.0,0.718,7.024,30,0,0,0,30,0,30,0,0.0,0.0
1016,799,24-09-2019 14:16:00,1,1477.0,1075.0,0.727,7.011,108,0,0,0,108,60,48,0,0.0,0.0
1016,800,24-09-2019 14:18:00,1,1484.0,1026.0,0.691,6.981,200,0,0,0,200,164,36,0,0.0,0.0
1016,801,24-09-2019 14:20:00,1,1497.0,1010.0,0.674,7.017,283,22,14,8,261,231,30,0,0.0,0.0
1016,802,24-09-2019 14:22:00,1,1483.0,1041.0,0.702,6.996,28,1,0,1,27,11,16,0,0.0,0.0
1016,803,24-09-2019 14:24:00,1,1387.0,981.0,0.708,6.55,68,11,9,2,57,30,27,0,0.0,0.0
1016,804,24-09-2019 14:26:00,1,1483.0,1022.0,0.689,6.976,269,149,114,35,120,86,34,65,0.0,0.0
1016,805,24-09-2019 14:28:00,1,1566.0,1171.0,0.748,7.466,466,200,153,47,266,199,67,34,0.0,0.0
1016,806,24-09-2019 14:30:00,1,1669.0,1181.0,0.708,7.885,194,34,13,21,160,113,47,1,0.0,0.0
1016,807,24-09-2019 14:32:00,1,1675.0,1242.0,0.741,7.975,239,19,3,16,220,172,48,0,0.0,0.0
1016,808,24-09-2019 14:34:00,1,1674.0,1236.0,0.738,7.965,246,61,34,27,185,136,49,0,0.0,0.0
1016,809,24-09-2019 14:36:00,1,1678.0,1227.0,0.731,7.969,192,86,50,36,106,65,41,1,0.0,0.0
1016,810,24-09-2019 14:38:00,1,1430.0,1170.0,0.818,6.931,300,34,11,23,266,232,34,0,0.0,0.0
1016,811,24-09-2019 14:40:00,1,1444.0,1141.0,0.79,6.954,533,60,33,27,473,416,57,1,0.0,0.0
1016,812,24-09-2019 14:42:00,1,1475.0,1151.0,0.78,7.087,30,11,4,7,19,9,10,0,0.0,0.0
1016,813,24-09-2019 14:44:00,1,1160.0,974.0,0.84,5.647,1,0,0,0,1,0,1,0,0.0,0.0
1016,814,24-09-2019 14:46:00,1,1218.5,954.5,0.786,5.857,1,0,0,0,1,0,1,0,0.0,0.0
1016,815,24-09-2019 14:48:00,1,1277.0,935.0,0.732,6.067,0,0,0,0,0,0,0,0,0.0,0.0
1016,816,24-09-2019 14:50:00,1,1161.0,876.0,0.755,5.543,21,4,0,4,17,10,7,0,0.0,0.0
1016,817,24-09-2019 14:52:00,1,1289.0,912.0,0.708,6.087,25,2,1,1,23,13,10,0,0.0,0.0
1016,818,24-09-2019 14:54:00,1,1197.0,876.0,0.732,5.685,2,0,0,0,2,0,2,0,0.0,0.0
1016,819,24-09-2019 14:56:00,1,1179.0,844.0,0.716,5.579,30,5,2,3,25,8,17,0,0.0,0.0
1016,820,24-09-2019 14:58:00,1,1174.0,839.0,0.715,5.554,14,1,0,1,13,0,13,0,0.0,0.0
1016,821,24-09-2019 15:00:00,1,1179.0,835.0,0.709,5.57,47,0,0,0,47,0,47,0,0.0,0.0
1016,822,24-09-2019 15:02:00,1,1182.0,877.0,0.742,5.628,48,12,7,5,36,13,23,0,0.0,0.0
1016,823,24-09-2019 15:04:00,1,1190.0,867.0,0.728,5.647,2,0,0,0,2,1,1,0,0.0,0.0
1016,824,24-09-2019 15:06:00,1,1180.0,845.0,0.716,5.585,33,8,1,7,25,19,6,0,0.0,0.0
1016,825,24-09-2019 15:08:00,1,1274.0,900.0,0.706,6.017,68,16,2,14,52,41,11,0,0.0,0.0
1016,826,24-09-2019 15:10:00,1,1272.0,915.0,0.719,6.027,14,3,3,0,11,3,8,0,0.0,0.0
1016,827,24-09-2019 15:12:00,1,1380.0,974.0,0.706,6.516,16,5,3,2,11,4,7,0,0.0,0.0
1016,828,24-09-2019 15:14:00,1,1394.0,988.0,0.709,6.584,5,3,1,2,2,0,2,0,0.0,0.0
1016,829,24-09-2019 15:16:00,1,1500.0,984.0,0.656,6.998,19,11,7,4,8,4,4,0,0.0,0.0
1016,830,24-09-2019 15:18:00,1,1398.0,937.0,0.67,6.544,2,2,0,2,0,0,0,0,0.0,0.0
1016,831,24-09-2019 15:20:00,1,1447.5,979.5,0.6765,6.7865,5,2,0,2,3,1,2,0,0.0,0.0
1016,832,24-09-2019 15:22:00,1,1497.0,1022.0,0.683,7.029,25,0,0,0,25,6,19,0,0.0,0.0
1016,833,24-09-2019 15:24:00,1,1486.0,1038.0,0.699,7.002,183,0,0,0,183,151,32,0,0.0,0.0
1016,834,24-09-2019 15:26:00,1,1486.0,1016.0,0.684,6.981,287,0,0,0,287,238,49,0,0.0,0.0
1016,835,24-09-2019 15:28:00,1,1172.0,891.0,0.76,5.603,482,13,7,6,469,412,57,0,0.0,0.0
1016,836,24-09-2019 15:30:00,1,1181.0,881.0,0.747,5.627,42,7,1,6,35,21,14,0,0.0,0.0
1016,837,24-09-2019 15:32:00,1,1174.0,913.0,0.778,5.636,0,0,0,0,0,0,0,0,0.0,0.0
1016,838,24-09-2019 15:34:00,1,1157.0,903.0,0.781,5.559,35,9,5,4,26,13,13,0,0.0,0.0
1016,839,24-09-2019 15:36:00,1,1282.0,922.0,0.719,6.07,28,0,0,0,28,0,28,0,0.0,0.0
1016,840,24-09-2019 15:38:00,1,1181.0,907.0,0.768,5.656,49,0,0,0,49,0,49,0,0.0,0.0
1016,841,24-09-2019 15:40:00,1,1199.0,805.0,0.671,5.617,50,5,0,5,45,20,25,0,0.0,0.0
1016,842,24-09-2019 15:42:00,1,1191.0,858.0,0.72,5.644,56,12,7,5,44,23,21,0,0.0,0.0
1016,843,24-09-2019 15:44:00,1,1275.0,954.0,0.748,6.081,1,0,0,0,1,1,0,0,0.0,0.0
1016,844,24-09-2019 15:46:00,1,1374.0,979.0,0.712,6.5,4,1,1,0,3,1,2,0,0.0,0.0
1016,845,24-09-2019 15:48:00,1,1388.0,978.0,0.705,6.552,7,2,1,1,5,1,4,0,0.0,0.0
1016,846,24-09-2019 15:50:00,1,1488.0,1034.0,0.695,7.008,65,17,9,8,48,39,9,0,0.0,0.0
1016,847,24-09-2019 15:52:00,1,1386.0,1007.0,0.726,6.575,7,0,0,0,7,0,7,0,0.0,0.0
1016,848,24-09-2019 15:54:00,1,1415.5,1081.5,0.763,6.774,107,68,51,17,39,24,15,30,0.0,0.0
1016,849,24-09-2019 15:56:00,1,1445.0,1156.0,0.8,6.973,95,49,30,19,46,1,45,61,0.0,0.0
1016,850,24-09-2019 15:58:00,1,1854.0,1394.0,0.752,8.847,148,76,48,28,72,36,36,34,0.0,0.0
1016,851,24-09-2019 16:00:00,1,1672.0,1232.0,0.737,7.953,114,48,33,15,66,23,43,62,0.0,0.0
1016,852,24-09-2019 16:02:00,1,1673.0,1268.0,0.758,7.994,65,24,8,16,41,1,40,54,0.0,0.0
1016,853,24-09-2019 16:04:00,1,1766.0,1373.0,0.778,8.478,68,29,15,14,39,1,38,56,0.0,0.0
1016,854,24-09-2019 16:06:00,1,1773.0,1371.0,0.773,8.504,64,20,7,13,44,0,44,48,0.0,0.02
1016,855,24-09-2019 16:08:00,1,1834.0,1427.0,0.778,8.804,262,121,93,28,141,86,55,56,0.0,0.05
1016,856,24-09-2019 16:10:00,1,1651.0,1273.0,0.771,7.916,703,330,261,69,373,294,79,15,0.0,0.02
1016,857,24-09-2019 16:12:00,1,1944.0,1547.0,0.796,9.373,226,96,69,27,130,98,32,8,0.03,0.0
1016,858,24-09-2019 16:14:00,1,1457.0,1178.0,0.809,7.043,401,185,130,55,216,167,49,8,0.0,0.0
1016,859,24-09-2019 16:16:00,1,1665.0,1312.0,0.788,8.013,335,178,143,35,157,102,55,15,0.0,0.0
1016,860,24-09-2019 16:18:00,1,1260.0,1054.0,0.837,6.131,14,14,0,14,0,0,0,0,0.0,0.0
1016,861,24-09-2019 16:20:00,1,1436.0,1204.0,0.839,6.99,130,63,36,27,67,47,20,3,0.02,0.0
1016,862,24-09-2019 16:22:00,1,1644.0,1271.0,0.773,7.887,105,72,37,35,33,7,26,0,0.0,0.0
1016,863,24-09-2019 16:24:00,1,1657.0,1314.0,0.793,7.982,134,46,26,20,88,50,38,1,0.0,0.0
1016,864,24-09-2019 16:26:00,1,1551.0,1269.0,0.819,7.516,69,27,11,16,42,23,19,0,0.0,0.0
1016,865,24-09-2019 16:28:00,1,1606.0,1265.0,0.789,7.7285,16,0,0,0,16,3,13,0,0.0,0.0
1016,866,24-09-2019 16:30:00,1,1661.0,1261.0,0.759,7.941,37,0,0,0,37,24,13,0,0.0,0.0
1016,867,24-09-2019 16:32:00,1,1426.0,1222.0,0.857,6.972,17,0,0,0,17,8,9,0,0.0,0.0
1016,868,24-09-2019 16:34:00,1,1453.0,1189.0,0.818,7.042,54,19,11,8,35,23,12,0,0.0,0.0
1016,869,24-09-2019 16:36:00,1,1447.0,1202.0,0.831,7.031,15,8,5,3,7,0,7,0,0.0,0.0
1016,870,24-09-2019 16:38:00,1,1467.0,1125.0,0.767,7.025,1,0,0,0,1,0,1,0,0.0,0.0
1016,871,24-09-2019 16:40:00,1,1466.0,1139.0,0.777,7.036,0,0,0,0,0,0,0,0,0.0,0.0
1016,872,24-09-2019 16:42:00,1,1428.0,1168.0,0.818,6.919,3,1,0,1,2,0,2,0,0.0,0.0
1016,873,24-09-2019 16:44:00,1,1452.0,1147.0,0.79,6.992,3,0,0,0,3,1,2,0,0.0,0.0
1016,874,24-09-2019 16:46:00,1,1462.0,1152.0,0.788,7.035,3,0,0,0,3,0,3,0,0.0,0.0
1016,875,24-09-2019 16:48:00,1,1482.0,1065.0,0.719,7.017,6,1,0,1,5,1,4,0,0.0,0.0
1016,876,24-09-2019 16:50:00,1,1371.0,1057.0,0.771,6.57,0,0,0,0,0,0,0,0,0.0,0.0
1016,877,24-09-2019 16:52:00,1,1490.0,1058.0,0.71,7.044,10,8,6,2,2,0,2,0,0.0,0.0
1016,878,24-09-2019 16:54:00,1,1369.0,1013.0,0.74,6.514,5,2,1,1,3,1,2,0,0.0,0.0
1016,879,24-09-2019 16:56:00,1,1475.0,1031.0,0.699,6.955,8,1,0,1,7,2,5,0,0.01,0.0
1016,880,24-09-2019 16:58:00,1,1266.0,989.0,0.781,6.085,15,3,1,2,12,1,11,0,0.0,0.0
1016,881,24-09-2019 17:00:00,1,1169.0,932.0,0.797,5.638,7,2,1,1,5,0,5,0,0.0,0.0
1016,882,24-09-2019 17:02:00,1,1410.5,1085.0,0.773,6.759,33,16,6,10,17,7,10,0,0.0,0.0
1016,883,24-09-2019 17:04:00,1,1652.0,1238.0,0.749,7.88,29,8,1,7,21,6,15,0,0.0,0.0
1016,884,24-09-2019 17:06:00,1,1651.0,1207.0,0.731,7.839,138,52,18,34,86,56,30,4,0.0,0.0
1016,885,24-09-2019 17:08:00,1,1673.0,1236.0,0.739,7.958,220,32,10,22,188,123,65,0,0.0,0.0
1016,886,24-09-2019 17:10:00,1,1664.0,1299.0,0.78,7.994,135,34,5,29,101,59,42,0,0.0,0.0
1016,887,24-09-2019 17:12:00,1,1671.0,1284.0,0.769,8.006,184,67,32,35,117,77,40,3,0.0,0.0
1016,888,24-09-2019 17:14:00,1,1453.0,1216.0,0.837,7.07,11,7,0,7,4,0,4,0,0.0,0.0
1016,889,24-09-2019 17:16:00,1,1463.0,1084.0,0.741,6.964,0,0,0,0,0,0,0,0,0.0,0.0
1016,890,24-09-2019 17:18:00,1,1144.0,961.0,0.84,5.571,18,8,2,6,10,4,6,0,0.0,0.0
1016,891,24-09-2019 17:20:00,1,1168.0,881.0,0.755,5.576,10,6,0,6,4,0,4,0,0.0,0.0
1016,892,24-09-2019 17:22:00,1,1186.0,868.0,0.732,5.634,32,1,0,1,31,0,31,0,0.0,0.0
1016,893,24-09-2019 17:24:00,1,1171.0,924.0,0.789,5.638,30,13,3,10,17,6,11,0,0.0,0.0
1016,894,24-09-2019 17:26:00,1,1159.0,954.0,0.823,5.623,35,22,3,19,13,6,7,0,0.0,0.0
1016,895,24-09-2019 17:28:00,1,1477.0,1073.0,0.727,7.006,72,8,3,5,64,40,24,0,0.0,0.0
1016,896,24-09-2019 17:30:00,1,1152.0,956.0,0.829,5.598,79,14,6,8,65,47,18,0,0.0,0.0
1016,897,24-09-2019 17:32:00,1,1164.0,905.0,0.777,5.59,32,11,3,8,21,9,12,0,0.0,0.0
1016,898,24-09-2019 17:34:00,1,1167.0,931.0,0.797,5.631,30,10,6,4,20,10,10,0,0.0,0.0
1016,899,24-09-2019 17:36:00,1,1272.0,970.5,0.765,6.088,0,0,0,0,0,0,0,0,0.0,0.0
1016,900,24-09-2019 17:38:00,1,1377.0,1010.0,0.733,6.545,9,5,2,3,4,0,4,0,0.0,0.0
1016,901,24-09-2019 17:40:00,1,1486.0,1037.0,0.698,7.004,36,20,13,7,16,7,9,0,0.0,0.0
1016,902,24-09-2019 17:42:00,1,1469.0,1095.0,0.746,7.0,19,5,1,4,14,6,8,0,0.0,0.0
1016,903,24-09-2019 17:44:00,1,1483.0,1068.0,0.72,7.024,5,1,0,1,4,1,3,0,0.0,0.0
1016,904,24-09-2019 17:46:00,1,1508.0,1014.0,0.672,7.063,3,2,0,2,1,1,0,0,0.0,0.0
1016,905,24-09-2019 17:48:00,1,1386.0,976.0,0.704,6.54,59,22,8,14,37,14,23,0,0.0,0.0
1016,906,24-09-2019 17:50:00,1,1459.0,1117.0,0.766,6.987,220,60,31,29,160,105,55,3,0.0,0.0
1016,907,24-09-2019 17:52:00,1,1660.0,1339.0,0.807,8.022,315,143,103,40,172,113,59,45,0.0,0.0
1016,908,24-09-2019 17:54:00,1,1751.0,1388.0,0.792,8.435,84,32,18,14,52,2,50,65,0.0,0.0
1016,909,24-09-2019 17:56:00,1,1658.0,1323.0,0.798,7.997,96,45,16,29,51,2,49,71,0.0,0.0
1016,910,24-09-2019 17:58:00,1,1751.0,1351.0,0.771,8.395,94,47,19,28,47,0,47,64,0.0,0.0
1016,911,24-09-2019 18:00:00,0,1618.0,1317.0,0.814,7.832,190,98,67,31,92,54,38,57,0.0,0.05
1016,912,24-09-2019 18:02:00,0,1941.0,1572.0,0.81,9.389,404,232,186,46,172,131,41,113,0.0,0.0
1016,913,24-09-2019 18:04:00,0,1760.0,1394.0,0.792,8.477,390,219,174,45,171,120,51,66,0.0,0.0
1016,914,24-09-2019 18:06:00,0,1360.0,1084.0,0.797,6.558,87,25,17,8,62,54,8,49,0.0,0.0
1016,915,24-09-2019 18:08:00,0,1576.0,1197.0,0.759,7.535,208,77,49,28,131,87,44,76,0.0,0.0
1016,916,24-09-2019 18:10:00,0,1799.0,1400.0,0.776,8.638,104,44,27,17,60,7,53,63,0.0,0.0
1016,917,24-09-2019 18:12:00,0,2022.0,1603.0,0.793,9.741,239,82,57,25,157,105,52,24,0.0,0.0
1016,918,24-09-2019 18:14:00,0,1154.0,972.0,0.842,5.624,102,68,38,30,34,25,9,8,0.0,0.0
1016,919,24-09-2019 18:16:00,0,1183.0,890.0,0.752,5.646,76,33,15,18,43,12,31,0,0.0,0.0
1016,920,24-09-2019 18:18:00,0,1272.0,1006.0,0.791,6.126,303,159,115,44,144,117,27,3,0.0,0.0
1016,921,24-09-2019 18:20:00,0,1453.0,1161.0,0.799,7.01,217,61,27,34,156,116,40,3,0.0,0.0
1016,922,24-09-2019 18:22:00,0,2272.0,1954.0,0.86,11.114,193,115,78,37,78,29,49,62,0.0,0.0
1016,923,24-09-2019 18:24:00,0,2605.0,2106.0,0.808,12.596,94,50,27,23,44,11,33,70,0.0,0.0
1016,924,24-09-2019 18:26:00,0,2318.0,1931.0,0.833,11.272,103,54,31,23,49,0,49,49,0.0,0.0
1016,925,24-09-2019 18:28:00,0,2303.0,2008.0,0.872,11.295,89,43,21,22,46,0,46,72,0.0,0.0
1016,926,24-09-2019 18:30:00,0,2134.0,1792.0,0.84,10.391,352,159,123,36,193,129,64,99,0.0,0.11
1016,927,24-09-2019 18:32:00,0,2168.0,1952.0,0.901,10.702,373,162,128,34,211,150,61,87,0.05,0.02
1016,928,24-09-2019 18:34:00,0,2302.0,1934.0,0.84,11.211,111,57,33,24,54,5,49,59,0.03,0.0
1016,929,24-09-2019 18:36:00,0,2303.0,1953.0,0.848,11.234,120,63,43,20,57,17,40,56,0.0,0.0
1016,930,24-09-2019 18:38:00,0,2081.0,1875.0,0.901,10.276,182,95,66,29,87,38,49,53,0.0,0.06
1016,931,24-09-2019 18:40:00,0,2132.0,1756.0,0.824,10.344,405,178,136,42,227,174,53,67,0.05,0.03
1016,932,24-09-2019 18:42:00,0,2273.0,2056.0,0.905,11.231,355,166,133,33,189,140,49,125,0.0,0.0
1016,933,24-09-2019 18:44:00,0,1726.0,1471.5,0.8285,8.43,202,41,20,21,161,120,41,7,0.0,0.0
1016,934,24-09-2019 18:46:00,0,1179.0,887.0,0.752,5.629,172,56,31,25,116,75,41,1,0.0,0.0
1016,935,24-09-2019 18:48:00,0,1942.0,1552.0,0.799,9.368,173,90,61,29,83,32,51,45,0.01,0.0
1016,936,24-09-2019 18:50:00,0,2282.0,2058.0,0.902,11.269,89,45,30,15,44,0,44,61,0.0,0.02
1016,937,24-09-2019 18:52:00,0,2275.0,2105.0,0.925,11.294,72,24,15,9,48,2,46,59,0.0,0.03
1016,938,24-09-2019 18:54:00,0,2275.0,1983.0,0.872,11.16,177,99,71,28,78,28,50,35,0.0,0.06
1016,939,24-09-2019 18:56:00,0,2194.0,1956.0,0.892,10.807,266,146,109,37,120,78,42,20,0.0,0.05
1016,940,24-09-2019 18:58:00,0,1446.0,1195.0,0.827,7.019,84,48,23,25,36,14,22,6,0.0,0.0
1016,941,24-09-2019 19:00:00,0,1465.0,1153.0,0.787,7.051,8,8,2,6,0,0,0,0,0.0,0.0
1016,942,24-09-2019 19:02:00,0,1455.0,1146.0,0.788,7.002,10,4,2,2,6,5,1,0,0.0,0.0
1016,943,24-09-2019 19:04:00,0,1439.0,1156.0,0.803,6.948,18,2,1,1,16,7,9,0,0.01,0.0
1016,944,24-09-2019 19:06:00,0,1620.0,1466.0,0.905,8.005,11,0,0,0,11,5,6,0,0.01,0.0
1016,945,24-09-2019 19:08:00,0,1641.0,1367.0,0.833,7.98,70,9,5,4,61,44,17,0,0.0,0.0
1016,946,24-09-2019 19:10:00,0,1452.0,1205.0,0.83,7.055,62,14,1,13,48,40,8,0,0.0,0.0
1016,947,24-09-2019 19:12:00,0,1352.0,1135.0,0.839,6.583,30,19,11,8,11,6,5,0,0.0,0.0
1016,948,24-09-2019 19:14:00,0,1329.0,1103.0,0.83,6.458,28,22,7,15,6,4,2,0,0.0,0.0
1016,949,24-09-2019 19:16:00,0,1344.0,1132.0,0.842,6.55,62,19,13,6,43,32,11,0,0.0,0.0
1016,950,24-09-2019 19:18:00,0,1531.0,1353.0,0.879,7.53,194,2,0,2,192,172,20,0,0.0,0.0
1016,951,24-09-2019 19:20:00,0,1718.0,1574.0,0.916,8.51,288,1,0,1,287,256,31,0,0.0,0.0
1016,952,24-09-2019 19:22:00,0,1907.0,1727.0,0.905,9.426,575,57,35,22,518,476,42,17,0.0,0.0
1016,953,24-09-2019 19:24:00,0,1884.0,1788.0,0.949,9.404,283,144,119,25,139,80,59,51,0.0,0.0
1016,954,24-09-2019 19:26:00,0,1499.0,1366.0,0.911,7.42,279,150,113,37,129,85,44,56,0.0,0.0
1016,955,24-09-2019 19:28:00,0,1982.0,1832.0,0.924,9.838,256,79,48,31,177,120,57,48,0.11,0.0
1016,956,24-09-2019 19:30:00,0,1886.0,1776.0,0.941,9.399,164,76,53,23,88,25,63,68,0.01,0.0
1016,957,24-09-2019 19:32:00,0,2088.0,1976.0,0.946,10.414,77,31,22,9,46,4,42,66,0.02,0.0
1016,958,24-09-2019 19:34:00,0,2177.0,2025.0,0.93,10.82,101,46,24,22,55,2,53,61,0.0,0.03
1016,959,24-09-2019 19:36:00,0,2273.0,2053.0,0.904,11.227,85,31,12,19,54,0,54,67,0.0,0.0
1016,960,24-09-2019 19:38:00,0,2161.0,1964.0,0.909,10.69,145,89,66,23,56,13,43,53,0.0,0.22
1016,961,24-09-2019 19:40:00,0,1616.0,1430.0,0.885,7.952,405,229,180,49,176,123,53,90,0.0,0.01
1016,962,24-09-2019 19:42:00,0,1810.0,1605.0,0.887,8.907,405,187,147,40,218,159,59,56,0.0,0.0
1016,963,24-09-2019 19:44:00,0,1133.0,1065.0,0.94,5.642,191,33,13,20,158,111,47,9,0.0,0.0
1016,964,24-09-2019 19:46:00,0,1863.0,1802.0,0.967,9.336,368,213,165,48,155,115,40,35,0.0,0.0
1016,965,24-09-2019 19:48:00,0,2071.0,1877.0,0.907,10.239,412,98,78,20,314,271,43,92,0.14,0.0
1016,966,24-09-2019 19:50:00,0,1519.0,1374.0,0.904,7.508,245,105,73,32,140,99,41,8,0.0,0.0
1016,967,24-09-2019 19:52:00,0,1527.5,1332.0,0.872,7.494,181,28,10,18,153,92,61,0,0.0,0.0
1016,968,24-09-2019 19:54:00,0,1536.0,1290.0,0.84,7.48,224,91,55,36,133,86,47,34,0.0,0.0
1016,969,24-09-2019 19:56:00,0,2565.0,2280.0,0.889,12.631,99,52,28,24,47,2,45,71,0.0,0.0
1016,970,24-09-2019 19:58:00,0,2555.0,2257.0,0.883,12.568,119,69,43,26,50,0,50,71,0.0,0.0
1016,971,24-09-2019 20:00:00,0,2721.0,2535.0,0.932,13.528,87,52,20,32,35,0,35,57,0.0,0.03
1016,972,24-09-2019 20:02:00,0,2576.0,2259.0,0.877,12.648,104,67,39,28,37,2,35,61,0.0,0.06
1016,973,24-09-2019 20:04:00,0,2279.0,2126.0,0.933,11.334,120,78,47,31,42,0,42,89,0.0,0.08
1016,974,24-09-2019 20:06:00,0,2237.0,2106.0,0.942,11.146,109,65,46,19,44,6,38,63,0.0,0.06
1016,975,24-09-2019 20:08:00,0,2075.0,1905.0,0.918,10.285,592,311,252,59,281,199,82,143,0.16,0.03
1016,976,24-09-2019 20:10:00,0,2251.0,2073.0,0.921,11.164,405,207,170,37,198,146,52,146,0.14,0.0
1016,977,24-09-2019 20:12:00,0,1899.0,1729.0,0.911,9.396,385,164,111,53,221,162,59,25,0.0,0.01
1016,978,24-09-2019 20:14:00,0,2093.0,1863.0,0.89,10.311,222,48,32,16,174,126,48,104,0.0,0.0
1016,979,24-09-2019 20:16:00,0,2283.0,2031.0,0.889,11.245,107,50,32,18,57,0,57,76,0.0,0.08
1016,980,24-09-2019 20:18:00,0,2294.0,2075.0,0.905,11.337,105,52,34,18,53,2,51,80,0.0,0.07
1016,981,24-09-2019 20:20:00,0,2086.0,1850.0,0.887,10.268,123,69,55,14,54,5,49,46,0.0,0.45
1016,982,24-09-2019 20:22:00,0,1332.0,1104.0,0.829,6.472,3,1,0,1,2,0,2,0,0.0,0.0
1016,983,24-09-2019 20:24:00,0,2074.0,1920.0,0.926,10.297,309,159,129,30,150,107,43,54,0.12,0.0
1016,984,24-09-2019 20:26:00,0,1981.5,1831.0,0.924,9.8345,444,229,178,51,215,165,50,95,0.0,0.01
1016,985,24-09-2019 20:28:00,0,1889.0,1742.0,0.922,9.372,258,95,70,25,163,116,47,6,0.01,0.0
1016,986,24-09-2019 20:30:00,0,1734.0,1494.0,0.862,8.485,116,22,6,16,94,59,35,0,0.0,0.0
1016,987,24-09-2019 20:32:00,0,2191.0,1962.0,0.896,10.806,139,10,5,5,129,89,40,0,0.0,0.0
1016,988,24-09-2019 20:34:00,0,2424.0,2281.0,0.941,12.077,117,51,26,25,66,39,27,0,0.0,0.0
1016,989,24-09-2019 20:36:00,0,2138.0,2082.0,0.974,10.728,0,0,0,0,0,0,0,0,0.0,0.0
1016,990,24-09-2019 20:38:00,0,2168.0,2013.0,0.928,10.77,39,10,7,3,29,19,10,0,0.01,0.0
1016,991,24-09-2019 20:40:00,0,1977.0,1888.0,0.955,9.879,23,1,0,1,22,7,15,0,0.0,0.01
1016,992,24-09-2019 20:42:00,0,1705.0,1555.0,0.912,8.441,307,9,4,5,298,236,62,0,0.0,0.0
1016,993,24-09-2019 20:44:00,0,1522.0,1406.0,0.924,7.552,53,4,3,1,49,27,22,0,0.0,0.0
1016,994,24-09-2019 20:46:00,0,1409.0,1311.0,0.931,7.003,46,0,0,0,46,0,46,0,0.0,0.0
1016,995,24-09-2019 20:48:00,0,1413.0,1326.0,0.939,7.037,30,0,0,0,30,0,30,0,0.0,0.0
1016,996,24-09-2019 20:50:00,0,1531.0,1354.0,0.885,7.532,130,34,24,10,96,54,42,0,0.0,0.0
1016,997,24-09-2019 20:52:00,0,1482.0,1499.0,1.012,7.498,22,12,1,11,10,4,6,2,0.0,0.0
1016,998,24-09-2019 20:54:00,0,1580.0,1580.0,1.0,7.976,345,202,157,45,143,104,39,100,0.0,0.0
1016,999,24-09-2019 20:56:00,0,1771.0,1707.0,0.964,8.868,328,177,129,48,151,111,40,78,0.0,0.0
1016,1000,24-09-2019 20:58:00,0,1785.0,1634.0,0.916,8.843,170,116,91,25,54,38,16,115,0.1,0.0
1016,1001,24-09-2019 21:00:00,0,1937.5,1785.0,0.921,9.611,96,72,44,28,24,15,9,3,0.0,0.0
1016,1002,24-09-2019 21:02:00,0,2090.0,1936.0,0.926,10.379,86,25,6,19,61,50,11,3,0.0,0.0
1016,1003,24-09-2019 21:04:00,0,1862.0,1757.0,0.943,9.281,301,103,74,29,198,147,51,40,0.16,0.02
1016,1004,24-09-2019 21:06:00,0,2078.0,1852.0,0.891,10.237,32,20,11,9,12,8,4,0,0.01,0.0
1016,1005,24-09-2019 21:08:00,0,1909.0,1606.0,0.842,9.298,30,3,1,2,27,7,20,0,0.0,0.0
1016,1006,24-09-2019 21:10:00,0,1929.0,1617.0,0.838,9.391,379,181,131,50,198,155,43,62,0.0,0.0
1016,1007,24-09-2019 21:12:00,0,1915.0,1666.0,0.87,9.389,216,77,49,28,139,100,39,43,0.0,0.0
1016,1008,24-09-2019 21:14:00,0,2014.0,1754.0,0.871,9.877,212,31,15,16,181,135,46,0,0.0,0.0
1016,1009,24-09-2019 21:16:00,0,2101.0,1909.0,0.909,10.393,189,44,21,23,145,97,48,0,0.0,0.0
1016,1010,24-09-2019 21:18:00,0,2067.0,1881.0,0.91,10.226,282,87,48,39,195,134,61,1,0.0,0.0
1016,1011,24-09-2019 21:20:00,0,2086.0,1793.0,0.859,10.203,359,185,142,43,174,125,49,0,0.0,0.0
1016,1012,24-09-2019 21:22:00,0,2125.0,1809.0,0.851,10.377,478,176,132,44,302,229,73,1,0.1,0.0
1016,1013,24-09-2019 21:24:00,0,1899.0,1736.0,0.914,9.402,596,259,209,50,337,275,62,0,0.0,0.0
1016,1014,24-09-2019 21:26:00,0,1908.0,1727.0,0.905,9.43,316,82,49,33,234,185,49,2,0.01,0.0
1016,1015,24-09-2019 21:28:00,0,1899.0,1708.0,0.899,9.374,384,24,4,20,360,310,50,0,0.0,0.0
1016,1016,24-09-2019 21:30:00,0,1905.0,1612.0,0.846,9.29,205,0,0,0,205,188,17,0,0.0,0.0
1016,1017,24-09-2019 21:32:00,0,1605.0,1409.0,0.878,7.885,137,0,0,0,137,123,14,0,0.0,0.0
1016,1018,24-09-2019 21:34:00,0,1660.0,1452.0,0.875,8.148,233,0,0,0,233,210,23,0,0.03,0.0
1016,1019,24-09-2019 21:36:00,0,1715.0,1495.0,0.872,8.411,171,0,0,0,171,152,19,0,0.0,0.0
1016,1020,24-09-2019 21:38:00,0,1626.0,1456.0,0.896,8.018,199,0,0,0,199,137,62,0,0.0,0.0
1016,1021,24-09-2019 21:40:00,0,1537.0,1326.0,0.863,7.524,467,6,4,2,461,427,34,0,0.0,0.0
1016,1022,24-09-2019 21:42:00,0,1417.0,1273.0,0.898,6.993,160,5,5,0,155,102,53,0,0.0,0.0
1016,1023,24-09-2019 21:44:00,0,1420.0,1268.0,0.893,6.997,112,27,13,14,85,44,41,0,0.0,0.0
1016,1024,24-09-2019 21:46:00,0,1432.0,1229.0,0.859,7.002,47,0,0,0,47,4,43,0,0.0,0.0
1016,1025,24-09-2019 21:48:00,0,1440.0,1234.0,0.857,7.041,114,11,7,4,103,47,56,0,0.0,0.0
1016,1026,24-09-2019 21:50:00,0,1349.0,1168.0,0.866,6.606,89,14,4,10,75,37,38,0,0.0,0.0
1016,1027,24-09-2019 21:52:00,0,1430.0,1238.0,0.866,7.004,55,0,0,0,55,26,29,0,0.0,0.0
1016,1028,24-09-2019 21:54:00,0,1417.0,1256.0,0.886,6.974,95,23,20,3,72,42,30,0,0.0,0.0
1016,1029,24-09-2019 21:56:00,0,1423.0,1235.0,0.868,6.975,54,2,1,1,52,8,44,0,0.0,0.0
1016,1030,24-09-2019 21:58:00,0,1409.0,1351.0,0.958,7.048,259,152,115,37,107,65,42,44,0.0,0.0
1016,1031,24-09-2019 22:00:00,0,1628.0,1419.0,0.872,7.986,441,195,154,41,246,175,71,92,0.01,0.0
1016,1032,24-09-2019 22:02:00,0,1614.0,1462.0,0.906,7.979,427,201,157,44,226,159,67,116,0.0,0.0
1016,1033,24-09-2019 22:04:00,0,1911.0,1688.0,0.883,9.4,454,182,151,31,272,223,49,157,0.01,0.0
1016,1034,24-09-2019 22:06:00,0,1606.0,1494.0,0.931,7.98,144,91,71,20,53,20,33,69,0.01,0.0
1016,1035,24-09-2019 22:08:00,0,1802.0,1674.5,0.9295,8.953,317,35,18,17,282,231,51,19,0.0,0.0
1016,1036,24-09-2019 22:10:00,0,1998.0,1855.0,0.928,9.926,402,75,37,38,327,267,60,14,0.0,0.0
1016,1037,24-09-2019 22:12:00,0,1994.0,1780.0,0.893,9.828,65,15,9,6,50,2,48,44,0.0,0.0
1016,1038,24-09-2019 22:14:00,0,2059.0,1979.0,0.961,10.304,99,44,25,19,55,7,48,70,0.0,0.0
1016,1039,24-09-2019 22:16:00,0,2166.0,2059.0,0.951,10.812,99,58,35,23,41,9,32,56,0.0,0.04
1016,1040,24-09-2019 22:18:00,0,2156.0,2132.0,0.989,10.854,74,42,25,17,32,3,29,70,0.0,0.07
1016,1041,24-09-2019 22:20:00,0,2043.0,1927.0,0.943,10.181,80,49,27,22,31,0,31,49,0.01,0.02
1016,1042,24-09-2019 22:22:00,0,2157.0,1946.0,0.902,10.654,144,86,55,31,58,17,41,44,0.0,0.08
1016,1043,24-09-2019 22:24:00,0,2112.0,2102.0,0.995,10.649,250,117,81,36,133,103,30,91,0.14,0.0
1016,1044,24-09-2019 22:26:00,0,2189.0,2021.0,0.923,10.863,179,87,58,29,92,69,23,31,0.01,0.0
1016,1045,24-09-2019 22:28:00,0,2077.0,1983.0,0.955,10.379,131,71,49,22,60,18,42,66,0.01,0.02
1016,1046,24-09-2019 22:30:00,0,2159.0,2084.0,0.965,10.815,86,48,33,15,38,6,32,51,0.0,0.05
1016,1047,24-09-2019 22:32:00,0,2187.0,2000.0,0.914,10.829,93,50,31,19,43,1,42,40,0.0,0.05
1016,1048,24-09-2019 22:34:00,0,2176.0,1976.0,0.908,10.762,226,96,65,31,130,83,47,20,0.15,0.0
1016,1049,24-09-2019 22:36:00,0,1534.0,1324.0,0.863,7.51,84,16,11,5,68,43,25,4,0.01,0.02
1016,1050,24-09-2019 22:38:00,0,1518.0,1295.0,0.853,7.415,123,37,16,21,86,46,40,9,0.0,0.0
1016,1051,24-09-2019 22:40:00,0,1318.0,1203.0,0.913,6.524,53,25,4,21,28,0,28,0,0.0,0.0
1016,1052,24-09-2019 22:42:00,0,1782.5,1669.5,0.932,8.8715,212,114,88,26,98,70,28,37,0.0,0.04
1016,1053,24-09-2019 22:44:00,0,2247.0,2136.0,0.951,11.219,291,160,125,35,131,105,26,58,0.0,0.0
1016,1054,24-09-2019 22:46:00,0,2294.0,2085.0,0.909,11.347,294,198,165,33,96,61,35,67,0.0,0.0
1016,1055,24-09-2019 22:48:00,0,2259.0,2180.0,0.965,11.315,100,56,30,26,44,2,42,60,0.0,0.0
1016,1056,24-09-2019 22:50:00,0,2574.0,2357.0,0.915,12.751,108,59,43,16,49,11,38,60,0.01,0.0
1016,1057,24-09-2019 22:52:00,0,2547.0,2276.0,0.894,12.554,90,46,25,21,44,0,44,42,0.0,0.12
1016,1058,24-09-2019 22:54:00,0,2332.0,2184.0,0.937,11.606,91,44,20,24,47,2,45,73,0.0,0.0
1016,1059,24-09-2019 22:56:00,0,2554.0,2235.0,0.875,12.539,147,66,39,27,81,31,50,37,0.0,0.01
1016,1060,24-09-2019 22:58:00,0,1609.0,1447.0,0.899,7.939,137,65,48,17,72,34,38,17,0.11,0.0
1016,1061,24-09-2019 23:00:00,0,1448.0,1216.0,0.84,7.051,85,25,11,14,60,23,37,17,0.01,0.0
1016,1062,24-09-2019 23:02:00,0,1644.0,1357.0,0.825,7.978,47,17,5,12,30,12,18,0,0.0,0.0
1016,1063,24-09-2019 23:04:00,0,1999.0,1726.0,0.864,9.786,165,92,66,26,73,45,28,36,0.0,0.0
1016,1064,24-09-2019 23:06:00,0,1909.0,1581.0,0.828,9.271,93,49,27,22,44,30,14,7,0.0,0.0
1016,1065,24-09-2019 23:08:00,0,2541.0,2313.0,0.91,12.574,205,67,49,18,138,80,58,48,0.2,0.0
1016,1066,24-09-2019 23:10:00,0,2549.0,2359.0,0.926,12.656,78,36,22,14,42,0,42,65,0.0,0.0
1016,1067,24-09-2019 23:12:00,0,2246.0,2183.0,0.972,11.267,82,37,22,15,45,3,42,55,0.01,0.0
1016,1068,24-09-2019 23:14:00,0,2278.0,2078.0,0.912,11.276,95,48,31,17,47,3,44,57,0.0,0.0
1016,1069,24-09-2019 23:16:00,0,2507.5,2274.5,0.9075,12.3985,125,75,46,29,50,0,50,61,0.0,0.0
1016,1070,24-09-2019 23:18:00,0,2737.0,2471.0,0.903,13.521,97,50,25,25,47,4,43,62,0.0,0.07
1016,1071,24-09-2019 23:20:00,0,2525.0,2343.0,0.928,12.544,112,65,41,24,47,0,47,63,0.0,0.01
1016,1072,24-09-2019 23:22:00,0,2565.0,2251.0,0.878,12.598,90,42,23,19,48,0,48,45,0.0,0.08
1016,1073,24-09-2019 23:24:00,0,2476.0,2231.0,0.901,12.225,112,60,34,26,52,0,52,82,0.01,0.01
1016,1074,24-09-2019 23:26:00,0,2476.0,2251.0,0.909,12.248,112,62,35,27,50,2,48,62,0.0,0.06
1016,1075,24-09-2019 23:28:00,0,2538.0,2294.0,0.904,12.541,228,124,89,35,104,63,41,60,0.0,0.11
1016,1076,24-09-2019 23:30:00,0,1900.0,1680.0,0.884,9.347,312,158,118,40,154,109,45,24,0.1,0.0
1016,1077,24-09-2019 23:32:00,0,1419.0,1240.0,0.873,6.965,38,31,14,17,7,0,7,4,0.0,0.0
1016,1078,24-09-2019 23:34:00,0,1622.0,1423.0,0.877,7.967,172,105,80,25,67,45,22,12,0.0,0.16
1016,1079,24-09-2019 23:36:00,0,2740.0,2567.0,0.937,13.638,225,128,85,43,97,63,34,99,0.0,0.0
1016,1080,24-09-2019 23:38:00,0,1608.0,1495.0,0.93,7.99,243,43,30,13,200,138,62,0,0.02,0.0
1016,1081,24-09-2019 23:40:00,0,1924.0,1595.0,0.829,9.347,251,195,142,53,56,28,28,58,0.0,0.0
1016,1082,24-09-2019 23:42:00,0,2518.0,2327.0,0.924,12.496,135,89,51,38,46,0,46,64,0.0,0.0
1016,1083,24-09-2019 23:44:00,0,2541.0,2343.0,0.922,12.604,99,59,39,20,40,0,40,62,0.0,0.0
1016,1084,24-09-2019 23:46:00,0,2461.0,2250.0,0.914,12.187,123,70,45,25,53,0,53,78,0.0,0.01
1016,1085,24-09-2019 23:48:00,0,2271.0,2059.0,0.907,11.229,174,111,80,31,63,15,48,80,0.0,0.06
1016,1086,24-09-2019 23:50:00,0,2114.0,2010.5,0.955,10.556,363,156,124,32,207,158,49,50,0.13,0.0
1016,1087,24-09-2019 23:52:00,0,1957.0,1962.0,1.003,9.883,509,283,213,70,226,171,55,33,0.06,0.0
1016,1088,24-09-2019 23:54:00,0,2051.0,2000.0,0.975,10.294,484,311,239,72,173,129,44,33,0.01,0.02
1016,1089,24-09-2019 23:56:00,0,1773.0,1695.0,0.956,8.861,372,188,136,52,184,133,51,94,0.0,0.0
1016,1090,24-09-2019 23:58:00,0,1888.0,1724.0,0.913,9.348,216,68,26,42,148,106,42,2,0.03,0.0
1016,1091,25-09-2019 00:00:00,0,1995.0,1795.0,0.9,9.847,338,48,14,34,290,226,64,2,0.0,0.0
1016,1092,25-09-2019 00:02:00,0,1977.0,1837.0,0.929,9.824,316,33,14,19,283,217,66,0,0.0,0.0
1016,1093,25-09-2019 00:04:00,0,2163.0,2073.0,0.958,10.818,192,40,15,25,152,104,48,6,0.0,0.0
1016,1094,25-09-2019 00:06:00,0,1957.0,1980.0,1.012,9.903,245,34,8,26,211,161,50,0,0.0,0.0
1016,1095,25-09-2019 00:08:00,0,2145.0,2126.0,0.991,10.807,331,79,48,31,252,192,60,0,0.0,0.0
1016,1096,25-09-2019 00:10:00,0,2052.0,1963.0,0.956,10.259,435,241,182,59,194,156,38,25,0.0,0.0
1016,1097,25-09-2019 00:12:00,0,1938.0,1927.0,0.995,9.768,479,223,166,57,256,191,65,28,0.06,0.0
1016,1098,25-09-2019 00:14:00,0,1979.0,1866.0,0.943,9.863,407,165,122,43,242,180,62,3,0.01,0.0
1016,1099,25-09-2019 00:16:00,0,2000.0,1795.0,0.898,9.866,230,147,110,37,83,52,31,0,0.0,0.0
1016,1100,25-09-2019 00:18:00,0,1772.0,1746.0,0.986,8.913,416,212,158,54,204,152,52,6,0.01,0.0
1016,1101,25-09-2019 00:20:00,0,1793.0,1717.0,0.958,8.964,625,396,308,88,229,161,68,34,0.0,0.0
1016,1102,25-09-2019 00:22:00,0,1791.0,1625.0,0.907,8.854,321,186,146,40,135,101,34,68,0.0,0.0
1016,1103,25-09-2019 00:24:00,0,1880.5,1710.0,0.909,9.301,280,174,130,44,106,78,28,99,0.0,0.0
1016,1104,25-09-2019 00:26:00,0,1970.0,1795.0,0.911,9.748,173,88,57,31,85,50,35,34,0.0,0.0
1016,1105,25-09-2019 00:28:00,0,2005.0,1807.0,0.901,9.9,222,76,44,32,146,100,46,0,0.0,0.0
1016,1106,25-09-2019 00:30:00,0,1889.0,1763.0,0.933,9.396,563,291,227,64,272,195,77,2,0.0,0.0
1016,1107,25-09-2019 00:32:00,0,1917.0,1721.0,0.898,9.456,116,61,32,29,55,3,52,73,0.0,0.0
1016,1108,25-09-2019 00:34:00,0,2119.0,1839.0,0.868,10.385,92,41,22,19,51,0,51,67,0.0,0.07
1016,1109,25-09-2019 00:36:00,0,2102.0,1869.0,0.889,10.353,105,56,39,17,49,0,49,75,0.0,0.06
1016,1110,25-09-2019 00:38:00,0,1809.0,1583.0,0.875,8.879,92,35,23,12,57,31,26,12,0.0,0.37
1016,1111,25-09-2019 00:40:00,0,1407.0,1254.0,0.891,6.93,18,5,0,5,13,0,13,0,0.0,0.01
1016,1112,25-09-2019 00:42:00,0,1866.0,1738.0,0.931,9.277,460,266,205,61,194,147,47,13,0.0,0.0
1016,1113,25-09-2019 00:44:00,0,1987.0,1811.0,0.911,9.832,446,243,185,58,203,144,59,57,0.0,0.03
1016,1114,25-09-2019 00:46:00,0,1722.0,1552.0,0.901,8.501,474,209,147,62,265,189,76,3,0.18,0.0
1016,1115,25-09-2019 00:48:00,0,2091.0,1883.0,0.901,10.322,908,276,212,64,632,555,77,6,0.0,0.0
1016,1116,25-09-2019 00:50:00,0,2101.0,1890.0,0.9,10.372,585,280,221,59,305,243,62,58,0.0,0.0
1016,1117,25-09-2019 00:52:00,0,1884.0,1741.0,0.924,9.35,667,325,254,71,342,286,56,22,0.0,0.0
1016,1118,25-09-2019 00:54:00,0,2093.0,1807.0,0.864,10.247,811,424,346,78,387,320,67,19,0.0,0.0
1016,1119,25-09-2019 00:56:00,0,1880.0,1713.0,0.911,9.305,312,104,59,45,208,146,62,21,0.0,0.0
1016,1120,25-09-2019 00:58:00,0,2035.5,1844.0,0.9065,10.062,301,2,0,2,299,219,80,0,0.0,0.0
1016,1121,25-09-2019 01:00:00,0,2191.0,1975.0,0.902,10.819,201,21,12,9,180,138,42,0,0.0,0.0
1016,1122,25-09-2019 01:02:00,0,2122.0,1810.0,0.853,10.365,0,0,0,0,0,0,0,0,0.0,0.0
1016,1123,25-09-2019 01:04:00,0,1924.0,1627.0,0.846,9.384,11,0,0,0,11,4,7,0,0.01,0.0
1016,1124,25-09-2019 01:06:00,0,1605.0,1455.0,0.907,7.935,26,0,0,0,26,6,20,0,0.0,0.0
1016,1125,25-09-2019 01:08:00,0,1531.0,1332.0,0.87,7.506,21,0,0,0,21,10,11,0,0.0,0.0
1016,1126,25-09-2019 01:10:00,0,1424.0,1266.0,0.889,7.013,18,6,4,2,12,4,8,0,0.0,0.0
1016,1127,25-09-2019 01:12:00,0,1422.0,1295.0,0.911,7.036,0,0,0,0,0,0,0,0,0.0,0.0
1016,1128,25-09-2019 01:14:00,0,1427.0,1315.0,0.922,7.077,6,6,4,2,0,0,0,0,0.0,0.0
1016,1129,25-09-2019 01:16:00,0,1417.0,1308.0,0.923,7.031,9,9,3,6,0,0,0,0,0.0,0.0
1016,1130,25-09-2019 01:18:00,0,1632.0,1354.0,0.829,7.929,22,17,9,8,5,1,4,0,0.0,0.0
1016,1131,25-09-2019 01:20:00,0,1538.0,1327.0,0.863,7.527,0,0,0,0,0,0,0,0,0.0,0.0
1016,1132,25-09-2019 01:22:00,0,1417.0,1312.0,0.926,7.034,2,0,0,0,2,2,0,0,0.0,0.0
1016,1133,25-09-2019 01:24:00,0,1418.0,1304.0,0.92,7.033,2,1,1,0,1,1,0,0,0.0,0.0
1016,1134,25-09-2019 01:26:00,0,1638.0,1354.0,0.827,7.955,30,14,5,9,16,10,6,0,0.0,0.0
1016,1135,25-09-2019 01:28:00,0,1410.0,1287.0,0.913,6.98,7,7,0,7,0,0,0,0,0.0,0.0
1016,1136,25-09-2019 01:30:00,0,1453.0,1229.0,0.846,7.085,17,8,4,4,9,7,2,0,0.0,0.0
1016,1137,25-09-2019 01:32:00,0,1522.5,1338.0,0.8775,7.479,0,0,0,0,0,0,0,0,0.0,0.0
1016,1138,25-09-2019 01:34:00,0,1592.0,1447.0,0.909,7.873,0,0,0,0,0,0,0,0,0.0,0.0
1016,1139,25-09-2019 01:36:00,0,1635.0,1408.0,0.861,8.0,74,33,27,6,41,26,15,2,0.0,0.0
1016,1140,25-09-2019 01:38:00,0,1609.0,1439.0,0.894,7.934,148,91,61,30,57,35,22,23,0.0,0.04
1016,1141,25-09-2019 01:40:00,0,1594.0,1532.0,0.961,7.977,253,130,102,28,123,99,24,71,0.0,0.0
1016,1142,25-09-2019 01:42:00,0,1699.0,1616.0,0.951,8.481,320,84,58,26,236,182,54,37,0.03,0.0
1016,1143,25-09-2019 01:44:00,0,1907.0,1685.0,0.884,9.379,266,19,0,19,247,227,20,19,0.0,0.0
1016,1144,25-09-2019 01:46:00,0,2080.0,1949.0,0.937,10.354,394,164,124,40,230,158,72,34,0.01,0.0
1016,1145,25-09-2019 01:48:00,0,1869.0,1659.0,0.887,9.202,198,86,63,23,112,83,29,29,0.01,0.0
1016,1146,25-09-2019 01:50:00,0,1880.0,1709.0,0.909,9.299,24,6,4,2,18,7,11,0,0.0,0.0
1016,1147,25-09-2019 01:52:00,0,1881.0,1717.0,0.912,9.313,210,74,49,25,136,77,59,6,0.0,0.0
1016,1148,25-09-2019 01:54:00,0,1894.0,1723.0,0.91,9.368,250,86,68,18,164,111,53,7,0.21,0.0
1016,1149,25-09-2019 01:56:00,0,1916.0,1676.0,0.874,9.405,107,0,0,0,107,60,47,0,0.02,0.0
1016,1150,25-09-2019 01:58:00,0,1605.0,1496.0,0.932,7.98,19,0,0,0,19,2,17,0,0.0,0.0
1016,1151,25-09-2019 02:00:00,0,1632.0,1386.0,0.849,7.964,33,0,0,0,33,1,32,0,0.0,0.0
1016,1152,25-09-2019 02:02:00,0,1419.0,1291.0,0.91,7.019,32,9,6,3,23,11,12,0,0.0,0.0
1016,1153,25-09-2019 02:04:00,0,1420.0,1262.0,0.889,6.992,107,19,2,17,88,46,42,0,0.0,0.0
1016,1154,25-09-2019 02:06:00,0,1596.5,1478.0,0.9225,7.927,179,51,22,29,128,89,39,14,0.0,0.0
1016,1155,25-09-2019 02:08:00,0,1773.0,1694.0,0.956,8.862,175,25,6,19,150,118,32,4,0.0,0.0
1016,1156,25-09-2019 02:10:00,0,1779.0,1712.0,0.963,8.903,300,39,26,13,261,232,29,0,0.0,0.0
1016,1157,25-09-2019 02:12:00,0,1698.0,1554.0,0.915,8.412,225,0,0,0,225,195,30,0,0.0,0.0
1016,1158,25-09-2019 02:14:00,0,1508.0,1433.0,0.95,7.528,12,0,0,0,12,3,9,0,0.0,0.0
1016,1159,25-09-2019 02:16:00,0,1425.0,1325.0,0.93,7.081,114,9,7,2,105,84,21,0,0.0,0.0
1016,1160,25-09-2019 02:18:00,0,1295.0,1301.0,1.004,6.543,87,5,3,2,82,49,33,0,0.0,0.0
1016,1161,25-09-2019 02:20:00,0,1303.0,1240.0,0.951,6.509,0,0,0,0,0,0,0,0,0.0,0.0
1016,1162,25-09-2019 02:22:00,0,1319.0,1196.0,0.907,6.522,4,1,0,1,3,2,1,0,0.0,0.0
1016,1163,25-09-2019 02:24:00,0,1324.0,1229.0,0.928,6.578,0,0,0,0,0,0,0,0,0.0,0.0
1016,1164,25-09-2019 02:26:00,0,1340.0,1169.0,0.872,6.575,0,0,0,0,0,0,0,0,0.0,0.0
1016,1165,25-09-2019 02:28:00,0,1225.0,1163.0,0.949,6.116,8,4,2,2,4,2,2,0,0.0,0.0
1016,1166,25-09-2019 02:30:00,0,1327.0,1197.0,0.902,6.554,0,0,0,0,0,0,0,0,0.0,0.0
1016,1167,25-09-2019 02:32:00,0,1333.0,1214.0,0.911,6.595,4,0,0,0,4,3,1,0,0.0,0.0
1016,1168,25-09-2019 02:34:00,0,1327.0,1190.0,0.897,6.545,64,3,2,1,61,51,10,0,0.0,0.0
1016,1169,25-09-2019 02:36:00,0,1308.0,1261.0,0.964,6.549,99,24,18,6,75,41,34,0,0.0,0.0
1016,1170,25-09-2019 02:38:00,0,1312.0,1264.0,0.964,6.571,28,2,1,1,26,0,26,0,0.0,0.0
1016,1171,25-09-2019 02:40:00,0,1465.0,1379.5,0.944,7.3015,41,3,1,2,38,1,37,0,0.0,0.0
1016,1172,25-09-2019 02:42:00,0,1618.0,1495.0,0.924,8.032,102,23,12,11,79,48,31,0,0.0,0.0
1016,1173,25-09-2019 02:44:00,0,1634.0,1409.0,0.862,7.998,15,0,0,0,15,13,2,0,0.0,0.0
1016,1174,25-09-2019 02:46:00,0,1539.0,1335.0,0.867,7.541,17,5,2,3,12,5,7,0,0.0,0.0
1016,1175,25-09-2019 02:48:00,0,1396.0,1306.0,0.936,6.945,12,7,1,6,5,3,2,0,0.0,0.0
1016,1176,25-09-2019 02:50:00,0,1505.0,1346.0,0.895,7.419,7,2,0,2,5,1,4,0,0.0,0.0
1016,1177,25-09-2019 02:52:00,0,1396.0,1318.0,0.944,6.96,27,2,0,2,25,10,15,0,0.0,0.0
1016,1178,25-09-2019 02:54:00,0,1524.0,1374.0,0.901,7.524,27,4,1,3,23,8,15,0,0.0,0.0
1016,1179,25-09-2019 02:56:00,0,1425.0,1312.0,0.92,7.068,21,2,1,1,19,4,15,0,0.0,0.0
1016,1180,25-09-2019 02:58:00,0,1420.0,1294.0,0.912,7.026,29,16,4,12,13,4,9,0,0.0,0.0
1016,1181,25-09-2019 03:00:00,0,1437.0,1292.0,0.899,7.093,2,2,0,2,0,0,0,0,0.0,0.0
1016,1182,25-09-2019 03:02:00,0,1432.0,1273.0,0.889,7.051,56,31,16,15,25,8,17,0,0.0,0.0
1016,1183,25-09-2019 03:04:00,0,1615.0,1439.0,0.891,7.958,133,83,32,51,50,21,29,2,0.0,0.0
1016,1184,25-09-2019 03:06:00,0,1581.0,1492.0,0.944,7.879,83,17,0,17,66,38,28,0,0.0,0.0
1016,1185,25-09-2019 03:08:00,0,1687.0,1570.0,0.931,8.384,125,63,35,28,62,34,28,1,0.0,0.0
1016,1186,25-09-2019 03:10:00,0,1911.0,1632.0,0.854,9.337,105,32,6,26,73,45,28,3,0.0,0.0
1016,1187,25-09-2019 03:12:00,0,1913.0,1670.0,0.873,9.386,228,153,114,39,75,42,33,18,0.0,0.0
1016,1188,25-09-2019 03:14:00,0,1925.5,1840.5,0.955,9.625,450,194,151,43,256,199,57,49,0.0,0.0
1016,1189,25-09-2019 03:16:00,0,1938.0,2011.0,1.037,9.864,171,101,73,28,70,38,32,64,0.0,0.0
1016,1190,25-09-2019 03:18:00,0,1782.0,1706.0,0.958,8.911,74,21,9,12,53,4,49,60,0.0,0.0
1016,1191,25-09-2019 03:20:00,0,1775.0,1678.0,0.946,8.852,567,133,86,47,434,362,72,13,0.0,0.0
1016,1192,25-09-2019 03:22:00,0,1694.0,1513.0,0.894,8.348,495,58,32,26,437,389,48,14,0.0,0.0
1016,1193,25-09-2019 03:24:00,0,1764.0,1781.0,1.01,8.92,71,27,15,12,44,2,42,50,0.0,0.0
1016,1194,25-09-2019 03:26:00,0,2063.0,1977.0,0.958,10.315,154,101,65,36,53,19,34,96,0.0,0.0
1016,1195,25-09-2019 03:28:00,0,2157.0,2048.0,0.949,10.767,140,77,45,32,63,38,25,84,0.0,0.0
1016,1196,25-09-2019 03:30:00,0,2065.0,1996.0,0.967,10.346,113,80,52,28,33,5,28,70,0.0,0.0
1016,1197,25-09-2019 03:32:00,0,2060.0,2029.0,0.985,10.363,429,103,81,22,326,250,76,35,0.1,0.02
1016,1198,25-09-2019 03:34:00,0,1295.0,1288.0,0.995,6.529,28,9,3,6,19,12,7,0,0.0,0.0
1016,1199,25-09-2019 03:36:00,0,1005.0,1021.0,1.015,5.091,7,3,2,1,4,0,4,0,0.0,0.0
1016,1200,25-09-2019 03:38:00,0,1133.0,1067.0,0.942,5.645,135,32,24,8,103,64,39,0,0.0,0.0
1016,1201,25-09-2019 03:40:00,0,1523.0,1387.0,0.911,7.536,254,21,7,14,233,185,48,0,0.01,0.0
1016,1202,25-09-2019 03:42:00,0,1504.0,1460.0,0.971,7.543,85,35,6,29,50,18,32,0,0.0,0.0
1016,1203,25-09-2019 03:44:00,0,2156.0,2076.0,0.963,10.795,349,187,141,46,162,120,42,92,0.01,0.0
1016,1204,25-09-2019 03:46:00,0,2121.0,2043.0,0.963,10.618,130,66,38,28,64,34,30,63,0.0,0.0
1016,1205,25-09-2019 03:48:00,0,2318.0,2212.5,0.955,11.581,107,74,44,30,33,5,28,64,0.0,0.0
1016,1206,25-09-2019 03:50:00,0,2515.0,2382.0,0.947,12.544,82,45,24,21,37,2,35,48,0.0,0.05
1016,1207,25-09-2019 03:52:00,0,2280.0,2079.0,0.912,11.284,244,139,104,35,105,60,45,21,0.0,0.02
1016,1208,25-09-2019 03:54:00,0,2277.0,2054.0,0.902,11.244,105,58,30,28,47,2,45,59,0.0,0.02
1016,1209,25-09-2019 03:56:00,0,2267.0,2071.0,0.913,11.226,105,55,31,24,50,0,50,56,0.0,0.03
1016,1210,25-09-2019 03:58:00,0,2370.0,2245.0,0.947,11.825,177,68,42,26,109,68,41,38,0.08,0.0
1016,1211,25-09-2019 04:00:00,0,2004.0,1826.0,0.911,9.919,188,117,85,32,71,30,41,52,0.02,0.04
1016,1212,25-09-2019 04:02:00,0,2076.0,2012.0,0.969,10.405,71,30,15,15,41,0,41,45,0.0,0.0
1016,1213,25-09-2019 04:04:00,0,2072.0,1913.0,0.923,10.281,76,37,23,14,39,0,39,55,0.0,0.01
1016,1214,25-09-2019 04:06:00,0,2242.0,2024.0,0.903,11.074,99,50,24,26,49,0,49,58,0.0,0.06
1016,1215,25-09-2019 04:08:00,0,2265.0,2038.0,0.9,11.179,71,28,17,11,43,0,43,52,0.02,0.07
1016,1216,25-09-2019 04:10:00,0,2101.0,1933.0,0.92,10.418,215,88,66,22,127,77,50,46,0.12,0.01
1016,1217,25-09-2019 04:12:00,0,1440.0,1230.0,0.854,7.036,118,48,26,22,70,44,26,3,0.0,0.0
1016,1218,25-09-2019 04:14:00,0,1144.0,1036.0,0.906,5.652,250,121,96,25,129,98,31,75,0.0,0.0
1016,1219,25-09-2019 04:16:00,0,1609.0,1465.0,0.91,7.961,87,37,28,9,50,21,29,1,0.0,0.03
1016,1220,25-09-2019 04:18:00,0,1432.0,1206.0,0.843,6.976,74,25,7,18,49,25,24,0,0.0,0.0
1016,1221,25-09-2019 04:20:00,0,1336.0,1115.0,0.835,6.499,30,7,0,7,23,15,8,0,0.0,0.0
1016,1222,25-09-2019 04:22:00,0,1417.5,1278.5,0.8985,7.001,73,0,0,0,73,48,25,0,0.0,0.0
1016,1223,25-09-2019 04:24:00,0,1499.0,1442.0,0.962,7.503,115,3,1,2,112,92,20,0,0.0,0.0
1016,1224,25-09-2019 04:26:00,0,1728.0,1504.0,0.87,8.475,15,0,0,0,15,12,3,0,0.0,0.0
1016,1225,25-09-2019 04:28:00,0,1807.0,1630.0,0.902,8.924,0,0,0,0,0,0,0,0,0.0,0.0
1016,1226,25-09-2019 04:30:00,0,1779.0,1729.0,0.972,8.924,11,3,1,2,8,2,6,0,0.0,0.0
1016,1227,25-09-2019 04:32:00,0,1777.0,1750.0,0.985,8.937,121,19,7,12,102,58,44,0,0.0,0.0
1016,1228,25-09-2019 04:34:00,0,1974.0,1834.0,0.929,9.807,0,0,0,0,0,0,0,0,0.0,0.0
1016,1229,25-09-2019 04:36:00,0,1778.0,1677.0,0.944,8.861,6,0,0,0,6,3,3,0,0.02,0.0
1016,1230,25-09-2019 04:38:00,0,1687.0,1583.0,0.938,8.401,9,0,0,0,9,1,8,0,0.0,0.0
1016,1231,25-09-2019 04:40:00,0,1501.0,1414.0,0.942,7.48,38,5,1,4,33,0,33,0,0.0,0.0
1016,1232,25-09-2019 04:42:00,0,1520.0,1361.0,0.895,7.497,49,12,2,10,37,6,31,0,0.0,0.0
1016,1233,25-09-2019 04:44:00,0,1317.0,1260.0,0.957,6.582,30,8,2,6,22,9,13,0,0.0,0.0
1016,1234,25-09-2019 04:46:00,0,1290.0,1284.0,0.996,6.504,38,7,1,6,31,4,27,0,0.0,0.0
1016,1235,25-09-2019 04:48:00,0,1513.0,1360.0,0.899,7.465,24,10,10,0,14,9,5,0,0.0,0.0
1016,1236,25-09-2019 04:50:00,0,1409.0,1308.0,0.928,6.999,5,0,0,0,5,1,4,0,0.0,0.0
1016,1237,25-09-2019 04:52:00,0,1306.0,1290.0,0.988,6.575,5,4,1,3,1,0,1,0,0.0,0.0
1016,1238,25-09-2019 04:54:00,0,1306.0,1278.0,0.978,6.561,62,15,5,10,47,21,26,0,0.01,0.0
1016,1239,25-09-2019 04:56:00,0,1476.0,1329.0,0.908,7.2875,13,0,0,0,13,3,10,0,0.0,0.0
1016,1240,25-09-2019 04:58:00,0,1646.0,1380.0,0.838,8.014,11,0,0,0,11,1,10,0,0.0,0.0
1016,1241,25-09-2019 05:00:00,0,1635.0,1419.0,0.868,8.012,118,31,12,19,87,58,29,0,0.0,0.0
1016,1242,25-09-2019 05:02:00,0,1702.0,1616.0,0.949,8.495,349,183,135,48,166,113,53,93,0.0,0.0
1016,1243,25-09-2019 05:04:00,0,1781.0,1588.0,0.891,8.777,215,141,108,33,74,44,30,79,0.0,0.0
1016,1244,25-09-2019 05:06:00,0,1793.0,1575.0,0.879,8.808,36,34,7,27,2,1,1,4,0.0,0.0
1016,1245,25-09-2019 05:08:00,0,1923.0,1653.0,0.859,9.407,43,37,21,16,6,2,4,0,0.0,0.04
1016,1246,25-09-2019 05:10:00,0,1913.0,1707.0,0.892,9.426,202,138,87,51,64,36,28,4,0.0,0.0
1016,1247,25-09-2019 05:12:00,0,2119.0,1830.0,0.864,10.375,296,163,120,43,133,97,36,13,0.0,0.0
1016,1248,25-09-2019 05:14:00,0,1926.0,1653.0,0.858,9.417,299,171,122,49,128,93,35,134,0.0,0.0
1016,1249,25-09-2019 05:16:00,0,1864.0,1741.0,0.934,9.271,348,232,179,53,116,87,29,115,0.0,0.0
1016,1250,25-09-2019 05:18:00,0,1973.0,1816.0,0.921,9.783,320,192,153,39,128,88,40,83,0.03,0.0
1016,1251,25-09-2019 05:20:00,0,1884.0,1756.0,0.932,9.367,83,38,17,21,45,0,45,62,0.01,0.0
1016,1252,25-09-2019 05:22:00,0,2186.0,1969.0,0.901,10.793,74,29,16,13,45,0,45,50,0.0,0.05
1016,1253,25-09-2019 05:24:00,0,2093.0,1884.0,0.9,10.331,87,42,28,14,45,2,43,74,0.0,0.0
1016,1254,25-09-2019 05:26:00,0,2309.0,2041.0,0.884,11.358,238,126,89,37,112,67,45,93,0.01,0.03
1016,1255,25-09-2019 05:28:00,0,2076.0,1869.0,0.9,10.25,471,231,180,51,240,183,57,67,0.05,0.03
1016,1256,25-09-2019 05:30:00,0,2066.0,1920.5,0.9295,10.2675,362,175,121,54,187,131,56,41,0.01,0.0
1016,1257,25-09-2019 05:32:00,0,2056.0,1972.0,0.959,10.285,606,346,284,62,260,195,65,110,0.0,0.0
1016,1258,25-09-2019 05:34:00,0,2163.0,2000.0,0.925,10.736,334,176,132,44,158,114,44,51,0.01,0.0
1016,1259,25-09-2019 05:36:00,0,1971.0,1935.0,0.982,9.907,211,95,64,31,116,79,37,8,0.0,0.0
1016,1260,25-09-2019 05:38:00,0,1815.0,1599.0,0.881,8.923,86,36,20,16,50,24,26,7,0.0,0.0
1016,1261,25-09-2019 05:40:00,0,1775.0,1754.0,0.988,8.935,51,36,22,14,15,8,7,6,0.0,0.0
1016,1262,25-09-2019 05:42:00,0,1787.0,1698.0,0.95,8.92,22,18,2,16,4,0,4,0,0.0,0.0
1016,1263,25-09-2019 05:44:00,0,1876.0,1796.0,0.957,9.38,337,167,129,38,170,124,46,38,0.11,0.0
1016,1264,25-09-2019 05:46:00,0,1874.0,1784.0,0.952,9.358,175,68,44,24,107,64,43,44,0.0,0.01
1016,1265,25-09-2019 05:48:00,0,1978.0,1770.0,0.895,9.752,71,27,9,18,44,2,42,46,0.0,0.0
1016,1266,25-09-2019 05:50:00,0,1891.0,1745.0,0.922,9.382,86,50,25,25,36,2,34,50,0.0,0.0
1016,1267,25-09-2019 05:52:00,0,1983.0,1839.0,0.927,9.85,86,33,15,18,53,0,53,50,0.0,0.08
1016,1268,25-09-2019 05:54:00,0,1985.0,1842.0,0.928,9.862,97,53,26,27,44,0,44,40,0.0,0.08
1016,1269,25-09-2019 05:56:00,0,1893.0,1756.0,0.928,9.402,126,74,45,29,52,0,52,70,0.0,0.08
1016,1270,25-09-2019 05:58:00,0,1786.0,1722.0,0.964,8.944,133,87,56,31,46,0,46,74,0.0,0.0
1016,1271,25-09-2019 06:00:00,1,1788.0,1725.0,0.965,8.953,348,163,122,41,185,126,59,35,0.13,0.08
1016,1272,25-09-2019 06:02:00,1,2125.0,2030.0,0.955,10.622,283,150,117,33,133,92,41,49,0.01,0.0
1016,1273,25-09-2019 06:04:00,1,2340.0,2160.5,0.926,11.612,233,122,81,41,111,77,34,72,0.0,0.0
1016,1274,25-09-2019 06:06:00,1,2555.0,2291.0,0.897,12.602,348,130,90,40,218,166,52,25,0.0,0.0
1016,1275,25-09-2019 06:08:00,1,1918.0,1719.0,0.897,9.459,252,90,61,29,162,108,54,0,0.0,0.0
1016,1276,25-09-2019 06:10:00,1,1919.0,1678.0,0.874,9.417,352,162,123,39,190,134,56,0,0.0,0.0
1016,1277,25-09-2019 06:12:00,1,1899.0,1736.0,0.914,9.404,211,18,6,12,193,151,42,0,0.0,0.0
1016,1278,25-09-2019 06:14:00,1,1862.0,1732.0,0.93,9.253,167,56,31,25,111,72,39,6,0.0,0.0
1016,1279,25-09-2019 06:16:00,1,2074.0,1815.0,0.875,10.181,216,87,61,26,129,81,48,0,0.0,0.0
1016,1280,25-09-2019 06:18:00,1,1889.0,1646.0,0.872,9.265,126,34,0,34,92,51,41,0,0.0,0.0
1016,1281,25-09-2019 06:20:00,1,2107.0,1859.0,0.882,10.36,119,42,20,22,77,37,40,0,0.0,0.0
1016,1282,25-09-2019 06:22:00,1,1999.0,1792.0,0.897,9.859,5,0,0,0,5,4,1,0,0.0,0.0
1016,1283,25-09-2019 06:24:00,1,1928.0,1671.0,0.867,9.444,0,0,0,0,0,0,0,0,0.0,0.0
1016,1284,25-09-2019 06:26:00,1,1598.0,1481.0,0.927,7.934,12,1,0,1,11,1,10,0,0.0,0.0
1016,1285,25-09-2019 06:28:00,1,1612.0,1383.0,0.858,7.882,28,8,1,7,20,7,13,0,0.0,0.0
1016,1286,25-09-2019 06:30:00,1,1413.0,1279.0,0.905,6.982,10,6,1,5,4,2,2,0,0.0,0.0
1016,1287,25-09-2019 06:32:00,1,1436.0,1225.0,0.853,7.015,69,13,0,13,56,40,16,0,0.0,0.01
1016,1288,25-09-2019 06:34:00,1,1428.0,1295.0,0.907,7.06,54,0,0,0,54,11,43,0,0.0,0.0
1016,1289,25-09-2019 06:36:00,1,1459.0,1181.0,0.809,7.057,54,7,4,3,47,12,35,0,0.0,0.0
1016,1290,25-09-2019 06:38:00,1,1484.0,1269.5,0.8545,7.253,0,0,0,0,0,0,0,0,0.0,0.0
1016,1291,25-09-2019 06:40:00,1,1509.0,1358.0,0.9,7.449,19,3,0,3,16,1,15,0,0.0,0.0
1016,1292,25-09-2019 06:42:00,1,1521.0,1324.0,0.87,7.458,35,35,0,35,0,0,0,0,0.0,0.0
1016,1293,25-09-2019 06:44:00,1,1305.0,1273.0,0.976,6.553,18,8,4,4,10,5,5,0,0.0,0.0
1016,1294,25-09-2019 06:46:00,1,1324.0,1249.0,0.944,6.599,20,7,2,5,13,6,7,0,0.0,0.0
1016,1295,25-09-2019 06:48:00,1,1325.0,1246.0,0.94,6.599,16,1,0,1,15,4,11,0,0.0,0.0
1016,1296,25-09-2019 06:50:00,1,1315.0,1214.0,0.923,6.526,29,5,3,2,24,11,13,0,0.0,0.0
1016,1297,25-09-2019 06:52:00,1,1320.0,1199.0,0.908,6.526,66,39,22,17,27,7,20,0,0.01,0.0
1016,1298,25-09-2019 06:54:00,1,1310.0,1277.0,0.975,6.573,92,5,2,3,87,34,53,0,0.0,0.01
1016,1299,25-09-2019 06:56:00,1,1321.0,1228.0,0.929,6.564,25,0,0,0,25,4,21,0,0.0,0.0
1016,1300,25-09-2019 06:58:00,1,1305.0,1253.0,0.96,6.528,18,0,0,0,18,4,14,0,0.0,0.0
1016,1301,25-09-2019 07:00:00,1,1424.0,1323.0,0.929,7.076,13,6,2,4,7,2,5,0,0.0,0.0
1016,1302,25-09-2019 07:02:00,1,1507.0,1382.0,0.917,7.468,225,73,45,28,152,96,56,0,0.0,0.0
1016,1303,25-09-2019 07:04:00,1,1587.0,1546.0,0.974,7.963,151,92,59,33,59,38,21,33,0.0,0.07
1016,1304,25-09-2019 07:06:00,1,1710.0,1550.0,0.907,8.454,239,137,103,34,102,63,39,85,0.0,0.0
1016,1305,25-09-2019 07:08:00,1,1615.0,1497.0,0.927,8.019,89,42,22,20,47,11,36,50,0.0,0.0
1016,1306,25-09-2019 07:10:00,1,1726.0,1529.0,0.886,8.495,76,28,5,23,48,0,48,63,0.0,0.0
1016,1307,25-09-2019 07:12:00,1,1806.0,1637.5,0.9055,8.93,409,167,120,47,242,165,77,24,0.0,0.0
1016,1308,25-09-2019 07:14:00,1,1886.0,1746.0,0.925,9.365,354,172,137,35,182,139,43,24,0.0,0.0
1016,1309,25-09-2019 07:16:00,1,1933.0,1584.0,0.819,9.368,510,192,146,46,318,254,64,2,0.0,0.0
1016,1310,25-09-2019 07:18:00,1,1954.0,1590.0,0.814,9.46,454,311,247,64,143,98,45,5,0.0,0.0
1016,1311,25-09-2019 07:20:00,1,1722.0,1524.0,0.885,8.473,219,164,120,44,55,36,19,42,0.0,0.0
1016,1312,25-09-2019 07:22:00,1,1924.0,1634.0,0.849,9.39,188,78,45,33,110,83,27,14,0.0,0.0
1016,1313,25-09-2019 07:24:00,1,1804.0,1565.0,0.868,8.84,216,117,87,30,99,64,35,26,0.0,0.0
1016,1314,25-09-2019 07:26:00,1,1902.0,1609.0,0.846,9.275,351,127,86,41,224,159,65,0,0.0,0.0
1016,1315,25-09-2019 07:28:00,1,1922.0,1617.0,0.841,9.364,443,205,144,61,238,172,66,1,0.0,0.0
1016,1316,25-09-2019 07:30:00,1,1951.0,1615.0,0.828,9.476,547,309,246,63,238,171,67,6,0.0,0.0
1016,1317,25-09-2019 07:32:00,1,1829.0,1583.0,0.865,8.961,241,122,84,38,119,82,37,14,0.0,0.0
1016,1318,25-09-2019 07:34:00,1,1810.0,1542.0,0.852,8.84,119,28,7,21,91,57,34,0,0.0,0.0
1016,1319,25-09-2019 07:36:00,1,1816.0,1535.0,0.845,8.853,56,29,0,29,27,13,14,0,0.0,0.0
1016,1320,25-09-2019 07:38:00,1,1821.0,1546.0,0.849,8.888,169,14,2,12,155,101,54,0,0.01,0.02
1016,1321,25-09-2019 07:40:00,1,1931.0,1555.0,0.805,9.329,231,32,3,29,199,143,56,0,0.0,0.0
1016,1322,25-09-2019 07:42:00,1,1834.0,1528.0,0.833,8.92,26,2,0,2,24,15,9,0,0.0,0.0
1016,1323,25-09-2019 07:44:00,1,1548.0,1310.0,0.846,7.55,106,0,0,0,106,72,34,0,0.0,0.0
1016,1324,25-09-2019 07:46:00,1,1433.5,1250.0,0.874,7.032,199,6,2,4,193,159,34,0,0.0,0.0
1016,1325,25-09-2019 07:48:00,1,1319.0,1190.0,0.902,6.514,31,4,2,2,27,11,16,0,0.0,0.0
1016,1326,25-09-2019 07:50:00,1,1322.0,1226.0,0.928,6.564,20,18,0,18,2,1,1,0,0.0,0.0
1016,1327,25-09-2019 07:52:00,1,1315.0,1241.0,0.944,6.554,18,10,0,10,8,1,7,0,0.0,0.0
1016,1328,25-09-2019 07:54:00,1,1331.0,1191.0,0.895,6.561,45,14,1,13,31,4,27,0,0.0,0.0
1016,1329,25-09-2019 07:56:00,1,1320.0,1222.0,0.926,6.554,69,18,8,10,51,16,35,0,0.0,0.0
1016,1330,25-09-2019 07:58:00,1,1314.0,1228.0,0.934,6.538,41,0,0,0,41,0,41,0,0.0,0.0
1016,1331,25-09-2019 08:00:00,1,1319.0,1188.0,0.901,6.512,27,0,0,0,27,0,27,0,0.0,0.0
1016,1332,25-09-2019 08:02:00,1,1328.0,1208.0,0.91,6.568,28,4,2,2,24,10,14,0,0.0,0.0
1016,1333,25-09-2019 08:04:00,1,1323.0,1235.0,0.934,6.579,20,3,3,0,17,9,8,0,0.0,0.0
1016,1334,25-09-2019 08:06:00,1,1323.0,1207.0,0.912,6.55,32,0,0,0,32,22,10,0,0.0,0.0
1016,1335,25-09-2019 08:08:00,1,1541.0,1271.0,0.825,7.479,209,21,8,13,188,167,21,0,0.0,0.0
1016,1336,25-09-2019 08:10:00,1,1327.0,1184.0,0.892,6.541,145,18,11,7,127,88,39,0,0.0,0.0
1016,1337,25-09-2019 08:12:00,1,1417.0,1261.0,0.89,6.977,38,11,3,8,27,8,19,0,0.0,0.0
1016,1338,25-09-2019 08:14:00,1,1517.0,1392.0,0.918,7.519,250,133,95,38,117,76,41,1,0.0,0.0
1016,1339,25-09-2019 08:16:00,1,1526.0,1396.0,0.915,7.557,71,10,4,6,61,32,29,0,0.0,0.0
1016,1340,25-09-2019 08:18:00,1,1552.0,1304.0,0.841,7.557,25,6,3,3,19,11,8,0,0.0,0.0
1016,1341,25-09-2019 08:20:00,1,1600.0,1306.0,0.8175,7.7485,0,0,0,0,0,0,0,0,0.0,0.0
1016,1342,25-09-2019 08:22:00,1,1648.0,1308.0,0.794,7.94,5,1,0,1,4,1,3,0,0.0,0.0
1016,1343,25-09-2019 08:24:00,1,1415.0,1239.0,0.876,6.945,53,18,10,8,35,14,21,0,0.0,0.0
1016,1344,25-09-2019 08:26:00,1,1441.0,1208.0,0.838,7.014,0,0,0,0,0,0,0,0,0.0,0.0
1016,1345,25-09-2019 08:28:00,1,1462.0,1172.0,0.802,7.058,2,0,0,0,2,0,2,0,0.0,0.0
1016,1346,25-09-2019 08:30:00,1,1466.0,1167.0,0.796,7.068,3,0,0,0,3,1,2,0,0.0,0.0
1016,1347,25-09-2019 08:32:00,1,1423.0,1221.0,0.858,6.961,14,0,0,0,14,0,14,0,0.0,0.0
1016,1348,25-09-2019 08:34:00,1,1432.0,1207.0,0.843,6.981,6,0,0,0,6,1,5,0,0.0,0.0
1016,1349,25-09-2019 08:36:00,1,1424.0,1216.0,0.854,6.957,18,1,1,0,17,9,8,0,0.01,0.0
1016,1350,25-09-2019 08:38:00,1,1554.0,1261.0,0.812,7.521,5,3,1,2,2,0,2,0,0.0,0.0
1016,1351,25-09-2019 08:40:00,1,1663.0,1270.0,0.763,7.96,9,1,0,1,8,3,5,0,0.0,0.0
1016,1352,25-09-2019 08:42:00,1,1673.0,1278.0,0.764,8.008,23,0,0,0,23,19,4,0,0.0,0.0
1016,1353,25-09-2019 08:44:00,1,1658.0,1259.0,0.759,7.925,26,0,0,0,26,9,17,0,0.01,0.0
1016,1354,25-09-2019 08:46:00,1,1530.0,1238.0,0.809,7.399,21,3,1,2,18,0,18,0,0.0,0.0
1016,1355,25-09-2019 08:48:00,1,1445.0,1189.0,0.823,7.009,15,0,0,0,15,3,12,0,0.0,0.0
1016,1356,25-09-2019 08:50:00,1,1438.0,1201.0,0.835,6.995,2,0,0,0,2,0,2,0,0.0,0.0
1016,1357,25-09-2019 08:52:00,1,1449.0,1218.0,0.84,7.058,49,7,5,2,42,21,21,0,0.0,0.0
1016,1358,25-09-2019 08:54:00,1,1583.0,1326.5,0.838,7.7065,195,27,14,13,168,117,51,3,0.0,0.0
1016,1359,25-09-2019 08:56:00,1,1717.0,1435.0,0.836,8.355,113,0,0,0,113,88,25,0,0.0,0.0
1016,1360,25-09-2019 08:58:00,1,1530.0,1318.0,0.861,7.489,0,0,0,0,0,0,0,0,0.0,0.0
1016,1361,25-09-2019 09:00:00,1,1331.0,1195.0,0.898,6.567,0,0,0,0,0,0,0,0,0.0,0.0
1016,1362,25-09-2019 09:02:00,1,1355.0,1091.0,0.805,6.546,11,0,0,0,11,6,5,0,0.0,0.0
1016,1363,25-09-2019 09:04:00,1,1254.0,1032.0,0.823,6.083,41,0,0,0,41,26,15,0,0.0,0.0
1016,1364,25-09-2019 09:06:00,1,1043.0,966.0,0.926,5.177,5,0,0,0,5,0,5,0,0.0,0.0
1016,1365,25-09-2019 09:08:00,1,1035.0,989.0,0.956,5.172,8,0,0,0,8,3,5,0,0.0,0.0
1016,1366,25-09-2019 09:10:00,1,1257.0,1038.0,0.826,6.102,21,9,0,9,12,0,12,0,0.0,0.0
1016,1367,25-09-2019 09:12:00,1,1143.0,1010.0,0.883,5.621,52,16,0,16,36,25,11,0,0.0,0.0
1016,1368,25-09-2019 09:14:00,1,1359.0,1064.0,0.783,6.532,56,13,4,9,43,22,21,0,0.0,0.0
1016,1369,25-09-2019 09:16:00,1,1354.0,1037.0,0.766,6.482,0,0,0,0,0,0,0,0,0.0,0.0
1016,1370,25-09-2019 09:18:00,1,1269.0,1024.0,0.807,6.135,0,0,0,0,0,0,0,0,0.0,0.0
1016,1371,25-09-2019 09:20:00,1,1150.0,1009.0,0.877,5.65,2,0,0,0,2,0,2,0,0.0,0.0
1016,1372,25-09-2019 09:22:00,1,1348.0,1143.0,0.848,6.576,137,30,21,9,107,62,45,1,0.0,0.0
1016,1373,25-09-2019 09:24:00,1,1351.0,1138.0,0.843,6.582,7,2,1,1,5,1,4,0,0.0,0.0
1016,1374,25-09-2019 09:26:00,1,1331.0,1086.0,0.816,6.445,26,5,0,5,21,9,12,0,0.0,0.01
1016,1375,25-09-2019 09:28:00,1,1449.0,1169.0,0.8075,7.0035,64,0,0,0,64,27,37,0,0.0,0.0
1016,1376,25-09-2019 09:30:00,1,1567.0,1252.0,0.799,7.562,28,4,1,3,24,10,14,0,0.0,0.0
1016,1377,25-09-2019 09:32:00,1,1563.0,1237.0,0.792,7.527,6,1,0,1,5,2,3,0,0.0,0.0
1016,1378,25-09-2019 09:34:00,1,1569.0,1233.0,0.786,7.548,2,0,0,0,2,1,1,0,0.0,0.0
1016,1379,25-09-2019 09:36:00,1,1444.0,1164.0,0.806,6.98,33,1,0,1,32,25,7,0,0.0,0.0
1016,1380,25-09-2019 09:38:00,1,1473.0,1113.0,0.755,7.037,3,0,0,0,3,0,3,0,0.0,0.0
1016,1381,25-09-2019 09:40:00,1,1482.0,1069.0,0.722,7.023,10,0,0,0,10,6,4,0,0.0,0.0
1016,1382,25-09-2019 09:42:00,1,1386.0,1039.0,0.75,6.611,11,0,0,0,11,1,10,0,0.0,0.0
1016,1383,25-09-2019 09:44:00,1,1463.0,1101.0,0.752,6.983,150,71,41,30,79,45,34,14,0.0,0.0
1016,1384,25-09-2019 09:46:00,1,1640.0,1283.0,0.782,7.883,151,106,77,29,45,28,17,46,0.0,0.0
1016,1385,25-09-2019 09:48:00,1,1647.0,1283.0,0.779,7.911,85,48,16,32,37,0,37,63,0.0,0.0
1016,1386,25-09-2019 09:50:00,1,1873.0,1455.0,0.777,8.991,132,76,50,26,56,11,45,98,0.0,0.06
1016,1387,25-09-2019 09:52:00,1,1653.0,1367.0,0.827,8.025,154,83,51,32,71,42,29,26,0.0,0.03
1016,1388,25-09-2019 09:54:00,1,1457.0,1126.0,0.773,6.988,265,118,87,31,147,107,40,61,0.0,0.0
1016,1389,25-09-2019 09:56:00,1,1649.0,1271.0,0.771,7.903,111,77,54,23,34,18,16,0,0.0,0.0
1016,1390,25-09-2019 09:58:00,1,1627.0,1392.0,0.856,7.95,423,220,167,53,203,144,59,10,0.09,0.0
1016,1391,25-09-2019 10:00:00,1,1725.0,1475.0,0.855,8.429,392,194,141,53,198,135,63,5,0.0,0.0
1016,1392,25-09-2019 10:02:00,1,1839.0,1506.5,0.821,8.9135,518,270,207,63,248,183,65,12,0.0,0.0
1016,1393,25-09-2019 10:04:00,1,1953.0,1538.0,0.787,9.398,459,243,192,51,216,170,46,4,0.0,0.0
1016,1394,25-09-2019 10:06:00,1,1909.0,1613.0,0.845,9.308,574,314,244,70,260,191,69,7,0.0,0.0
1016,1395,25-09-2019 10:08:00,1,1920.0,1579.0,0.822,9.315,777,486,392,94,291,220,71,7,0.0,0.0
1016,1396,25-09-2019 10:10:00,1,1613.0,1441.0,0.894,7.95,357,198,162,36,159,116,43,12,0.0,0.0
1016,1397,25-09-2019 10:12:00,1,1841.0,1512.0,0.821,8.929,496,204,155,49,292,214,78,36,0.0,0.0
1016,1398,25-09-2019 10:14:00,1,1739.0,1480.0,0.851,8.489,75,24,13,11,51,0,51,64,0.02,0.04
1016,1399,25-09-2019 10:16:00,1,1840.0,1520.0,0.826,8.932,136,48,32,16,88,21,67,50,0.0,0.41
1016,1400,25-09-2019 10:18:00,1,1360.0,1091.0,0.802,6.565,26,2,1,1,24,0,24,0,0.0,0.0
1016,1401,25-09-2019 10:20:00,1,1440.0,1217.0,0.845,7.022,696,129,96,33,567,499,68,0,0.0,0.0
1016,1402,25-09-2019 10:22:00,1,1623.0,1454.0,0.896,8.005,447,99,64,35,348,313,35,3,0.0,0.01
1016,1403,25-09-2019 10:24:00,1,1731.0,1493.0,0.863,8.471,720,229,169,60,491,438,53,12,0.0,0.0
1016,1404,25-09-2019 10:26:00,1,1603.0,1478.0,0.922,7.951,288,96,71,25,192,167,25,0,0.12,0.0
1016,1405,25-09-2019 10:28:00,1,1942.0,1583.0,0.815,9.404,317,34,11,23,283,251,32,1,0.0,0.0
1016,1406,25-09-2019 10:30:00,1,1812.0,1570.0,0.866,8.878,142,29,11,18,113,108,5,0,0.0,0.0
1016,1407,25-09-2019 10:32:00,1,1619.0,1468.0,0.906,8.005,14,0,0,0,14,0,14,0,0.01,0.0
1016,1408,25-09-2019 10:34:00,1,1424.0,1287.0,0.904,7.033,122,12,7,5,110,68,42,0,0.02,0.01
1016,1409,25-09-2019 10:36:00,1,1533.0,1341.5,0.877,7.525,309,5,2,3,304,245,59,0,0.0,0.0
1016,1410,25-09-2019 10:38:00,1,1642.0,1396.0,0.85,8.017,359,6,5,1,353,303,50,0,0.0,0.0
1016,1411,25-09-2019 10:40:00,1,1603.0,1391.0,0.868,7.855,0,0,0,0,0,0,0,0,0.0,0.0
1016,1412,25-09-2019 10:42:00,1,1612.0,1412.0,0.876,7.913,3,2,0,2,1,1,0,0,0.0,0.0
1016,1413,25-09-2019 10:44:00,1,1613.0,1450.0,0.899,7.961,217,8,0,8,209,180,29,0,0.02,0.0
1016,1414,25-09-2019 10:46:00,1,1651.0,1377.0,0.834,8.029,39,10,0,10,29,0,29,0,0.0,0.0
1016,1415,25-09-2019 10:48:00,1,1647.0,1387.0,0.842,8.024,3,3,2,1,0,0,0,0,0.0,0.0
1016,1416,25-09-2019 10:50:00,1,1619.0,1373.0,0.848,7.899,57,12,4,8,45,38,7,0,0.0,0.0
1016,1417,25-09-2019 10:52:00,1,1633.0,1356.0,0.831,7.936,61,0,0,0,61,48,13,0,0.0,0.0
1016,1418,25-09-2019 10:54:00,1,1429.0,1277.0,0.894,7.045,81,14,7,7,67,62,5,0,0.0,0.0
1016,1419,25-09-2019 10:56:00,1,1523.0,1346.0,0.884,7.489,115,46,24,22,69,43,26,12,0.0,0.02
1016,1420,25-09-2019 10:58:00,1,1631.0,1444.0,0.886,8.026,371,43,21,22,328,263,65,7,0.0,0.0
1016,1421,25-09-2019 11:00:00,1,1613.0,1447.0,0.897,7.956,486,13,1,12,473,435,38,0,0.0,0.0
1016,1422,25-09-2019 11:02:00,1,1691.0,1559.0,0.922,8.388,241,18,7,11,223,186,37,1,0.0,0.0
1016,1423,25-09-2019 11:04:00,1,1923.0,1617.0,0.841,9.367,309,46,15,31,263,202,61,0,0.0,0.0
1016,1424,25-09-2019 11:06:00,1,1598.0,1522.0,0.952,7.983,35,0,0,0,35,0,35,0,0.0,0.0
1016,1425,25-09-2019 11:08:00,1,1409.0,1327.0,0.942,7.021,41,0,0,0,41,9,32,0,0.0,0.0
1016,1426,25-09-2019 11:10:00,1,1468.0,1317.5,0.899,7.2425,56,9,2,7,47,28,19,0,0.0,0.0
1016,1427,25-09-2019 11:12:00,1,1527.0,1308.0,0.856,7.464,66,3,2,1,63,4,59,0,0.0,0.0
1016,1428,25-09-2019 11:14:00,1,1421.0,1234.0,0.868,6.964,26,0,0,0,26,0,26,0,0.0,0.0
1016,1429,25-09-2019 11:16:00,1,1428.0,1201.0,0.841,6.955,37,13,7,6,24,20,4,0,0.0,0.0
1016,1430,25-09-2019 11:18:00,1,1442.0,1214.0,0.842,7.027,9,7,5,2,2,2,0,0,0.0,0.0
1016,1431,25-09-2019 11:20:00,1,1453.0,1193.0,0.821,7.047,6,1,1,0,5,0,5,0,0.0,0.0
1016,1432,25-09-2019 11:22:00,1,1432.0,1248.0,0.872,7.024,17,1,0,1,16,0,16,0,0.0,0.0
1016,1433,25-09-2019 11:24:00,1,1439.0,1225.0,0.851,7.026,18,2,0,2,16,0,16,0,0.0,0.0
1016,1434,25-09-2019 11:26:00,1,1419.0,1223.0,0.862,6.943,17,5,0,5,12,0,12,0,0.0,0.0
1016,1435,25-09-2019 11:28:00,1,1526.0,1258.0,0.824,7.407,24,0,0,0,24,0,24,0,0.0,0.0
1016,1436,25-09-2019 11:30:00,1,1552.0,1264.0,0.814,7.514,48,10,2,8,38,13,25,0,0.0,0.0
1016,1437,25-09-2019 11:32:00,1,1452.0,1237.0,0.852,7.09,82,0,0,0,82,75,7,0,0.0,0.0
1016,1438,25-09-2019 11:34:00,1,1453.0,1199.0,0.825,7.052,49,0,0,0,49,48,1,0,0.0,0.0
1016,1439,25-09-2019 11:36:00,1,1432.0,1140.0,0.796,6.904,126,0,0,0,126,114,12,0,0.0,0.0
1016,1440,25-09-2019 11:38:00,1,1439.0,1205.0,0.837,7.002,205,22,10,12,183,150,33,0,0.0,0.0
1016,1441,25-09-2019 11:40:00,1,1433.0,1214.0,0.847,6.99,67,8,1,7,59,26,33,0,0.0,0.0
1016,1442,25-09-2019 11:42:00,1,1440.0,1228.0,0.853,7.032,436,120,88,32,316,288,28,8,0.0,0.0
1016,1443,25-09-2019 11:44:00,1,1676.0,1480.5,0.88,8.242,627,226,174,52,401,333,68,11,0.02,0.0
1016,1444,25-09-2019 11:46:00,1,1912.0,1733.0,0.907,9.452,240,120,87,33,120,99,21,46,0.0,0.0
1016,1445,25-09-2019 11:48:00,1,1918.0,1669.0,0.87,9.406,1030,378,283,95,652,568,84,11,0.0,0.0
1016,1446,25-09-2019 11:50:00,1,1898.0,1591.0,0.838,9.239,509,56,24,32,453,388,65,0,0.0,0.0
1016,1447,25-09-2019 11:52:00,1,1791.0,1562.0,0.872,8.787,123,20,2,18,103,85,18,0,0.0,0.0
1016,1448,25-09-2019 11:54:00,1,1580.0,1489.0,0.942,7.876,210,58,16,42,152,115,37,0,0.0,0.0
1016,1449,25-09-2019 11:56:00,1,1600.0,1509.0,0.943,7.976,63,14,3,11,49,13,36,0,0.01,0.0
1016,1450,25-09-2019 11:58:00,1,1605.0,1497.0,0.933,7.981,83,14,4,10,69,10,59,0,0.0,0.0
1016,1451,25-09-2019 12:00:00,1,1619.0,1450.0,0.896,7.984,63,8,3,5,55,20,35,0,0.0,0.0
1016,1452,25-09-2019 12:02:00,1,1648.0,1384.0,0.839,8.026,15,0,0,0,15,2,13,0,0.02,0.0
1016,1453,25-09-2019 12:04:00,1,1442.0,1186.0,0.822,6.995,33,3,1,2,30,9,21,0,0.0,0.0
1016,1454,25-09-2019 12:06:00,1,1332.0,1142.0,0.858,6.511,17,0,0,0,17,0,17,0,0.0,0.0
1016,1455,25-09-2019 12:08:00,1,1238.0,1091.0,0.881,6.086,24,0,0,0,24,1,23,0,0.0,0.0
1016,1456,25-09-2019 12:10:00,1,1128.0,1060.0,0.94,5.618,5,1,1,0,4,1,3,0,0.0,0.0
1016,1457,25-09-2019 12:12:00,1,1137.0,1055.0,0.928,5.647,2,0,0,0,2,1,1,0,0.0,0.0
1016,1458,25-09-2019 12:14:00,1,1139.0,1027.0,0.902,5.624,11,3,2,1,8,2,6,0,0.0,0.0
1016,1459,25-09-2019 12:16:00,1,1144.0,1012.0,0.885,5.627,14,0,0,0,14,0,14,0,0.0,0.0
1016,1460,25-09-2019 12:18:00,1,1302.5,1081.5,0.8365,6.329,21,3,1,2,18,0,18,0,0.0,0.0
1016,1461,25-09-2019 12:20:00,1,1461.0,1151.0,0.788,7.031,149,20,3,17,129,79,50,0,0.0,0.0
1016,1462,25-09-2019 12:22:00,1,1432.0,1258.0,0.879,7.035,650,0,0,0,650,610,40,0,0.0,0.0
1016,1463,25-09-2019 12:24:00,1,1660.0,1332.0,0.802,8.016,137,0,0,0,137,119,18,0,0.0,0.0
1016,1464,25-09-2019 12:26:00,1,1414.0,1277.0,0.903,6.985,75,0,0,0,75,42,33,0,0.0,0.0
1016,1465,25-09-2019 12:28:00,1,1442.0,1268.0,0.88,7.084,114,7,4,3,107,90,17,0,0.0,0.0
1016,1466,25-09-2019 12:30:00,1,1523.0,1305.0,0.857,7.444,152,6,3,3,146,119,27,0,0.0,0.0
1016,1467,25-09-2019 12:32:00,1,1645.0,1370.0,0.833,8.0,264,24,10,14,240,210,30,0,0.0,0.0
1016,1468,25-09-2019 12:34:00,1,1541.0,1311.0,0.851,7.523,108,0,0,0,108,78,30,0,0.0,0.0
1016,1469,25-09-2019 12:36:00,1,1454.0,1222.0,0.84,7.081,94,0,0,0,94,83,11,0,0.0,0.0
1016,1470,25-09-2019 12:38:00,1,1459.0,1190.0,0.815,7.065,147,1,1,0,146,126,20,0,0.01,0.01
1016,1471,25-09-2019 12:40:00,1,1458.0,1196.0,0.82,7.069,243,0,0,0,243,208,35,0,0.0,0.0
1016,1472,25-09-2019 12:42:00,1,1455.0,1161.0,0.798,7.019,23,2,0,2,21,16,5,0,0.0,0.0
1016,1473,25-09-2019 12:44:00,1,1322.0,1126.0,0.852,6.457,14,0,0,0,14,9,5,0,0.0,0.0
1016,1474,25-09-2019 12:46:00,1,1338.0,1159.0,0.867,6.555,13,1,1,0,12,9,3,0,0.0,0.0
1016,1475,25-09-2019 12:48:00,1,1339.0,1150.0,0.859,6.547,16,1,1,0,15,13,2,0,0.0,0.0
1016,1476,25-09-2019 12:50:00,1,1241.0,1116.0,0.899,6.125,0,0,0,0,0,0,0,0,0.0,0.0
1016,1477,25-09-2019 12:52:00,1,1385.0,1208.0,0.875,6.794,0,0,0,0,0,0,0,0,0.0,0.0
1016,1478,25-09-2019 12:54:00,1,1529.0,1300.0,0.851,7.463,0,0,0,0,0,0,0,0,0.0,0.0
1016,1479,25-09-2019 12:56:00,1,1414.0,1241.0,0.878,6.944,13,2,1,1,11,0,11,0,0.0,0.0
1016,1480,25-09-2019 12:58:00,1,1437.0,1153.0,0.803,6.939,38,0,0,0,38,22,16,0,0.0,0.0
1016,1481,25-09-2019 13:00:00,1,1448.0,1169.0,0.807,7.0,291,40,22,18,251,208,43,0,0.0,0.0
1016,1482,25-09-2019 13:02:00,1,1634.0,1418.0,0.868,8.009,289,43,11,32,246,212,34,0,0.0,0.0
1016,1483,25-09-2019 13:04:00,1,1817.0,1580.0,0.869,8.908,202,85,54,31,117,94,23,51,0.0,0.0
1016,1484,25-09-2019 13:06:00,1,1604.0,1520.0,0.947,8.002,603,301,248,53,302,247,55,56,0.09,0.0
1016,1485,25-09-2019 13:08:00,1,1710.0,1529.0,0.894,8.429,470,191,145,46,279,218,61,2,0.02,0.0
1016,1486,25-09-2019 13:10:00,1,1605.0,1446.0,0.901,7.924,355,80,54,26,275,224,51,5,0.0,0.0
1016,1487,25-09-2019 13:12:00,1,1599.0,1426.0,0.892,7.878,115,30,8,22,85,67,18,0,0.0,0.0
1016,1488,25-09-2019 13:14:00,1,1613.0,1431.0,0.887,7.94,35,27,3,24,8,5,3,0,0.0,0.0
1016,1489,25-09-2019 13:16:00,1,1619.0,1440.0,0.889,7.974,15,15,6,9,0,0,0,0,0.0,0.0
1016,1490,25-09-2019 13:18:00,1,1619.0,1447.0,0.894,7.98,29,27,9,18,2,1,1,0,0.0,0.0
1016,1491,25-09-2019 13:20:00,1,1658.0,1297.0,0.782,7.971,8,0,0,0,8,1,7,0,0.0,0.0
1016,1492,25-09-2019 13:22:00,1,1346.0,1102.0,0.819,6.522,26,1,0,1,25,0,25,0,0.0,0.0
1016,1493,25-09-2019 13:24:00,1,1160.0,919.0,0.793,5.587,27,0,0,0,27,15,12,0,0.0,0.0
1016,1494,25-09-2019 13:26:00,1,1155.5,959.0,0.8305,5.6145,19,3,1,2,16,1,15,0,0.0,0.0
1016,1495,25-09-2019 13:28:00,1,1151.0,999.0,0.868,5.642,45,0,0,0,45,2,43,0,0.0,0.0
1016,1496,25-09-2019 13:30:00,1,1377.0,1059.0,0.77,6.597,47,9,4,5,38,6,32,0,0.0,0.0
1016,1497,25-09-2019 13:32:00,1,1358.0,1031.0,0.759,6.49,401,0,0,0,401,352,49,0,0.0,0.0
1016,1498,25-09-2019 13:34:00,1,1481.0,1045.0,0.706,6.993,185,0,0,0,185,170,15,0,0.0,0.0
1016,1499,25-09-2019 13:36:00,1,1481.0,1018.0,0.688,6.961,40,0,0,0,40,35,5,0,0.0,0.0
1016,1500,25-09-2019 13:38:00,1,1264.0,986.0,0.78,6.073,36,0,0,0,36,31,5,0,0.0,0.0
1016,1501,25-09-2019 13:40:00,1,1176.0,915.0,0.778,5.647,21,1,0,1,20,16,4,0,0.0,0.0
1016,1502,25-09-2019 13:42:00,1,1155.0,969.0,0.839,5.624,6,3,2,1,3,0,3,0,0.0,0.0
1016,1503,25-09-2019 13:44:00,1,1388.0,1018.0,0.733,6.598,0,0,0,0,0,0,0,0,0.0,0.0
1016,1504,25-09-2019 13:46:00,1,1454.0,1125.0,0.774,6.975,42,2,2,0,40,15,25,0,0.0,0.0
1016,1505,25-09-2019 13:48:00,1,1450.0,1117.0,0.771,6.949,17,0,0,0,17,0,17,0,0.0,0.0
1016,1506,25-09-2019 13:50:00,1,1467.0,1122.0,0.765,7.021,0,0,0,0,0,0,0,0,0.0,0.0
1016,1507,25-09-2019 13:52:00,1,1463.0,1147.0,0.784,7.035,0,0,0,0,0,0,0,0,0.0,0.0
1016,1508,25-09-2019 13:54:00,1,1469.0,1154.0,0.786,7.064,3,3,1,2,0,0,0,0,0.0,0.0
1016,1509,25-09-2019 13:56:00,1,1482.0,1107.0,0.747,7.065,9,7,2,5,2,1,1,0,0.0,0.0
1016,1510,25-09-2019 13:58:00,1,1481.0,1091.0,0.737,7.041,35,4,1,3,31,2,29,0,0.0,0.0
1016,1511,25-09-2019 14:00:00,1,1474.0,1081.0,0.7335,7.0035,30,5,0,5,25,9,16,0,0.0,0.0
1016,1512,25-09-2019 14:02:00,1,1467.0,1071.0,0.73,6.966,124,0,0,0,124,110,14,0,0.0,0.0
1016,1513,25-09-2019 14:04:00,1,1470.0,1052.0,0.716,6.955,242,1,0,1,241,224,17,0,0.01,0.0
1016,1514,25-09-2019 14:06:00,1,1268.0,988.0,0.779,6.089,386,4,2,2,382,371,11,0,0.0,0.0
1016,1515,25-09-2019 14:08:00,1,1382.0,1024.0,0.74,6.58,28,3,1,2,25,0,25,0,0.0,0.0
1016,1516,25-09-2019 14:10:00,1,1487.0,1076.0,0.724,7.05,18,7,2,5,11,0,11,0,0.0,0.0
1016,1517,25-09-2019 14:12:00,1,1458.0,1116.0,0.766,6.98,62,32,17,15,30,16,14,0,0.0,0.0
1016,1518,25-09-2019 14:14:00,1,1654.0,1223.0,0.739,7.869,46,30,9,21,16,3,13,6,0.0,0.0
1016,1519,25-09-2019 14:16:00,1,1661.0,1264.0,0.761,7.943,85,29,12,17,56,38,18,0,0.0,0.0
1016,1520,25-09-2019 14:18:00,1,1636.0,1334.0,0.815,7.925,354,56,23,33,298,240,58,0,0.0,0.0
1016,1521,25-09-2019 14:20:00,1,1654.0,1328.0,0.803,7.986,61,38,16,22,23,6,17,0,0.0,0.0
1016,1522,25-09-2019 14:22:00,1,1673.0,1300.0,0.777,8.032,36,8,1,7,28,8,20,1,0.0,0.0
1016,1523,25-09-2019 14:24:00,1,1456.0,1124.0,0.772,6.983,17,0,0,0,17,7,10,0,0.0,0.0
1016,1524,25-09-2019 14:26:00,1,1469.0,1058.0,0.72,6.962,43,0,0,0,43,33,10,0,0.0,0.0
1016,1525,25-09-2019 14:28:00,1,1268.0,977.0,0.771,6.076,8,0,0,0,8,2,6,0,0.0,0.0
1016,1526,25-09-2019 14:30:00,1,1161.0,940.0,0.81,5.613,148,5,1,4,143,126,17,0,0.0,0.0
1016,1527,25-09-2019 14:32:00,1,1185.0,862.0,0.727,5.626,26,11,0,11,15,4,11,0,0.0,0.0
1016,1528,25-09-2019 14:34:00,1,1333.0,954.5,0.717,6.3105,7,0,0,0,7,1,6,0,0.0,0.0
1016,1529,25-09-2019 14:36:00,1,1481.0,1047.0,0.707,6.995,49,0,0,0,49,25,24,0,0.0,0.0
1016,1530,25-09-2019 14:38:00,1,1487.0,1029.0,0.692,6.998,390,0,0,0,390,361,29,0,0.0,0.0
1016,1531,25-09-2019 14:40:00,1,1479.0,1019.0,0.689,6.956,2,0,0,0,2,0,2,0,0.0,0.0
1016,1532,25-09-2019 14:42:00,1,1505.0,1019.0,0.677,7.06,139,60,51,9,79,52,27,2,0.0,0.0
1016,1533,25-09-2019 14:44:00,1,1479.0,1111.0,0.752,7.056,74,0,0,0,74,46,28,0,0.0,0.0
1016,1534,25-09-2019 14:46:00,1,1490.0,1092.0,0.733,7.079,39,2,1,1,37,12,25,0,0.0,0.0
1016,1535,25-09-2019 14:48:00,1,1457.0,1054.0,0.724,6.907,51,12,5,7,39,5,34,0,0.0,0.0
1016,1536,25-09-2019 14:50:00,1,1459.0,1042.0,0.714,6.903,19,12,3,9,7,4,3,0,0.0,0.0
1016,1537,25-09-2019 14:52:00,1,1477.0,1073.0,0.726,7.009,223,7,4,3,216,190,26,0,0.0,0.0
1016,1538,25-09-2019 14:54:00,1,1512.0,1006.0,0.665,7.069,55,11,8,3,44,23,21,0,0.0,0.0
1016,1539,25-09-2019 14:56:00,1,1280.0,957.0,0.747,6.104,5,1,0,1,4,0,4,0,0.0,0.0
1016,1540,25-09-2019 14:58:00,1,1393.0,975.0,0.699,6.57,1,1,0,1,0,0,0,0,0.0,0.0
1016,1541,25-09-2019 15:00:00,1,1486.0,1001.0,0.674,6.965,0,0,0,0,0,0,0,0,0.0,0.0
1016,1542,25-09-2019 15:02:00,1,1360.0,964.0,0.709,6.424,11,6,2,4,5,3,2,0,0.0,0.0
1016,1543,25-09-2019 15:04:00,1,1482.0,998.0,0.673,6.946,5,3,2,1,2,0,2,0,0.0,0.0
1016,1544,25-09-2019 15:06:00,1,1384.0,966.0,0.698,6.521,5,1,0,1,4,1,3,0,0.0,0.0
1016,1545,25-09-2019 15:08:00,1,1489.0,1053.0,0.7065,7.032,39,12,7,5,27,18,9,0,0.0,0.0
1016,1546,25-09-2019 15:10:00,1,1594.0,1140.0,0.715,7.543,59,0,0,0,59,19,40,1,0.0,0.0
1016,1547,25-09-2019 15:12:00,1,1474.0,1070.0,0.726,6.993,57,3,1,2,54,18,36,0,0.0,0.0
1016,1548,25-09-2019 15:14:00,1,1476.0,1058.0,0.717,6.986,238,29,14,15,209,169,40,0,0.0,0.0
1016,1549,25-09-2019 15:16:00,1,1468.0,1093.0,0.744,6.994,190,21,5,16,169,120,49,0,0.0,0.0
1016,1550,25-09-2019 15:18:00,1,1458.0,1119.0,0.767,6.985,759,44,16,28,715,662,53,1,0.0,0.0
1016,1551,25-09-2019 15:20:00,1,1462.0,1119.0,0.766,7.0,779,62,20,42,717,664,53,0,0.0,0.0
1016,1552,25-09-2019 15:22:00,1,1462.0,1199.0,0.82,7.088,375,47,21,26,328,258,70,0,0.0,0.0
1016,1553,25-09-2019 15:24:00,1,1570.0,1227.0,0.781,7.544,151,24,3,21,127,84,43,1,0.0,0.0
1016,1554,25-09-2019 15:26:00,1,1559.0,1245.0,0.798,7.522,346,137,104,33,209,139,70,15,0.0,0.0
1016,1555,25-09-2019 15:28:00,1,1449.0,1163.0,0.803,6.996,87,65,31,34,22,2,20,21,0.0,0.1
1016,1556,25-09-2019 15:30:00,1,1459.0,1166.0,0.799,7.04,389,226,170,56,163,118,45,24,0.0,0.0
1016,1557,25-09-2019 15:32:00,1,1668.0,1245.0,0.747,7.951,448,184,135,49,264,183,81,2,0.0,0.0
1016,1558,25-09-2019 15:34:00,1,1683.0,1175.0,0.698,7.932,242,107,71,36,135,107,28,4,0.0,0.0
1016,1559,25-09-2019 15:36:00,1,1683.0,1223.0,0.727,7.987,282,145,96,49,137,119,18,5,0.0,0.0
1016,1560,25-09-2019 15:38:00,1,1667.0,1277.0,0.766,7.981,437,213,179,34,224,163,61,0,0.0,0.0
1016,1561,25-09-2019 15:40:00,1,1458.0,1136.0,0.779,7.003,356,105,73,32,251,197,54,7,0.0,0.0
1016,1562,25-09-2019 15:42:00,1,1561.5,1188.5,0.762,7.4695,223,2,0,2,221,167,54,0,0.0,0.0
1016,1563,25-09-2019 15:44:00,1,1665.0,1241.0,0.745,7.936,141,13,1,12,128,84,44,0,0.0,0.0
1016,1564,25-09-2019 15:46:00,1,1680.0,1226.0,0.73,7.977,20,6,3,3,14,7,7,0,0.0,0.0
1016,1565,25-09-2019 15:48:00,1,1475.0,1094.0,0.741,7.024,17,11,5,6,6,3,3,0,0.0,0.0
1016,1566,25-09-2019 15:50:00,1,1387.0,1003.0,0.723,6.575,1,1,0,1,0,0,0,0,0.0,0.0
1016,1567,25-09-2019 15:52:00,1,1157.0,923.0,0.797,5.581,0,0,0,0,0,0,0,0,0.0,0.0
1016,1568,25-09-2019 15:54:00,1,1166.0,886.0,0.759,5.575,12,9,4,5,3,1,2,0,0.0,0.0
1016,1569,25-09-2019 15:56:00,1,1173.0,909.0,0.775,5.63,8,2,0,2,6,1,5,0,0.0,0.0
1016,1570,25-09-2019 15:58:00,1,1184.0,881.0,0.744,5.642,21,3,0,3,18,11,7,0,0.0,0.0
1016,1571,25-09-2019 16:00:00,1,1188.0,872.0,0.734,5.644,0,0,0,0,0,0,0,0,0.0,0.0
1016,1572,25-09-2019 16:02:00,1,1176.0,856.0,0.727,5.582,5,2,0,2,3,0,3,0,0.0,0.0
1016,1573,25-09-2019 16:04:00,1,1170.0,897.0,0.767,5.602,2,1,0,1,1,0,1,0,0.0,0.0
1016,1574,25-09-2019 16:06:00,1,1165.0,923.0,0.792,5.613,2,2,0,2,0,0,0,0,0.0,0.0
1016,1575,25-09-2019 16:08:00,1,1171.0,917.0,0.783,5.63,0,0,0,0,0,0,0,0,0.0,0.0
1016,1576,25-09-2019 16:10:00,1,1404.0,980.0,0.698,6.618,0,0,0,0,0,0,0,0,0.0,0.0
1016,1577,25-09-2019 16:12:00,1,1483.0,1004.0,0.677,6.956,33,15,7,8,18,11,7,0,0.0,0.0
1016,1578,25-09-2019 16:14:00,1,1477.0,1069.0,0.724,7.002,13,8,0,8,5,0,5,0,0.0,0.0
1016,1579,25-09-2019 16:16:00,1,1584.5,1114.0,0.7045,7.476,3,2,0,2,1,0,1,0,0.0,0.0
1016,1580,25-09-2019 16:18:00,1,1692.0,1159.0,0.685,7.95,18,10,5,5,8,3,5,0,0.0,0.0
1016,1581,25-09-2019 16:20:00,1,1693.0,1147.0,0.677,7.941,7,2,0,2,5,2,3,0,0.0,0.0
1016,1582,25-09-2019 16:22:00,1,1498.0,1087.0,0.725,7.106,2,2,1,1,0,0,0,0,0.0,0.0
1016,1583,25-09-2019 16:24:00,1,1502.0,998.0,0.665,7.024,4,4,0,4,0,0,0,0,0.0,0.0
1016,1584,25-09-2019 16:26:00,1,1494.0,1006.0,0.674,7.0,3,0,0,0,3,1,2,0,0.0,0.0
1016,1585,25-09-2019 16:28:00,1,1381.0,945.0,0.685,6.486,11,5,0,5,6,3,3,0,0.0,0.0
1016,1586,25-09-2019 16:30:00,1,1496.0,972.0,0.65,6.972,1,1,0,1,0,0,0,0,0.0,0.0
1016,1587,25-09-2019 16:32:00,1,1504.0,1007.0,0.669,7.043,4,0,0,0,4,1,3,0,0.0,0.0
1016,1588,25-09-2019 16:34:00,1,1504.0,1018.0,0.677,7.053,46,29,20,9,17,9,8,0,0.0,0.0
1016,1589,25-09-2019 16:36:00,1,1506.0,1005.0,0.667,7.047,18,1,0,1,17,3,14,0,0.01,0.0
1016,1590,25-09-2019 16:38:00,1,1389.0,964.0,0.694,6.54,2,1,0,1,1,0,1,0,0.0,0.0
1016,1591,25-09-2019 16:40:00,1,1499.0,985.0,0.657,6.995,45,9,3,6,36,25,11,0,0.0,0.0
1016,1592,25-09-2019 16:42:00,1,1285.0,927.0,0.721,6.089,84,0,0,0,84,73,11,0,0.0,0.0
1016,1593,25-09-2019 16:44:00,1,1190.0,832.0,0.699,5.61,35,20,11,9,15,6,9,0,0.0,0.0
1016,1594,25-09-2019 16:46:00,1,1193.0,831.0,0.696,5.622,47,1,0,1,46,24,22,0,0.0,0.0
1016,1595,25-09-2019 16:48:00,1,1190.0,819.0,0.688,5.597,27,2,0,2,25,11,14,0,0.0,0.0
1016,1596,25-09-2019 16:50:00,1,1342.0,937.0,0.6975,6.325,16,0,0,0,16,4,12,0,0.0,0.0
1016,1597,25-09-2019 16:52:00,1,1494.0,1055.0,0.707,7.053,224,52,27,25,172,117,55,1,0.0,0.0
1016,1598,25-09-2019 16:54:00,1,1564.0,1149.0,0.735,7.436,173,96,54,42,77,42,35,2,0.0,0.0
1016,1599,25-09-2019 16:56:00,1,1575.0,1201.0,0.763,7.536,39,15,5,10,24,9,15,1,0.0,0.0
1016,1600,25-09-2019 16:58:00,1,1679.0,1234.0,0.735,7.98,63,27,8,19,36,20,16,0,0.0,0.0
1016,1601,25-09-2019 17:00:00,1,1667.0,1287.0,0.773,7.992,365,111,73,38,254,195,59,0,0.0,0.0
1016,1602,25-09-2019 17:02:00,1,1560.0,1204.0,0.772,7.479,323,79,53,26,244,189,55,14,0.0,0.0
1016,1603,25-09-2019 17:04:00,1,1464.0,1105.0,0.755,6.991,15,5,1,4,10,1,9,0,0.0,0.0
1016,1604,25-09-2019 17:06:00,1,1464.0,1112.0,0.76,6.998,122,54,36,18,68,36,32,4,0.0,0.0
1016,1605,25-09-2019 17:08:00,1,1466.0,1107.0,0.755,7.0,83,13,3,10,70,30,40,0,0.0,0.0
1016,1606,25-09-2019 17:10:00,1,1593.0,1174.0,0.737,7.577,125,47,6,41,78,43,35,0,0.0,0.0
1016,1607,25-09-2019 17:12:00,1,1462.0,1103.0,0.754,6.984,31,13,8,5,18,10,8,0,0.0,0.0
1016,1608,25-09-2019 17:14:00,1,1499.0,1002.0,0.668,7.016,1,0,0,0,1,0,1,0,0.0,0.0
1016,1609,25-09-2019 17:16:00,1,1267.0,923.0,0.729,6.012,10,6,1,5,4,2,2,0,0.0,0.0
1016,1610,25-09-2019 17:18:00,1,1393.0,965.0,0.693,6.559,1,1,0,1,0,0,0,0,0.0,0.0
1016,1611,25-09-2019 17:20:00,1,1521.0,982.0,0.646,7.082,44,7,0,7,37,3,34,0,0.0,0.0
1016,1612,25-09-2019 17:22:00,1,1176.0,894.0,0.76,5.625,17,0,0,0,17,1,16,0,0.0,0.0
1016,1613,25-09-2019 17:24:00,1,1319.5,992.5,0.753,6.298,268,2,1,1,266,238,28,0,0.02,0.0
1016,1614,25-09-2019 17:26:00,1,1463.0,1091.0,0.746,6.971,715,2,1,1,713,654,59,0,0.0,0.0
1016,1615,25-09-2019 17:28:00,1,1472.0,1075.0,0.73,6.99,65,11,4,7,54,43,11,0,0.0,0.0
1016,1616,25-09-2019 17:30:00,1,1480.0,1085.0,0.733,7.034,15,1,0,1,14,2,12,0,0.0,0.0
1016,1617,25-09-2019 17:32:00,1,1482.0,1075.0,0.725,7.029,108,29,9,20,79,57,22,0,0.0,0.0
1016,1618,25-09-2019 17:34:00,1,1590.0,1161.0,0.73,7.549,281,39,20,19,242,177,65,0,0.0,0.0
1016,1619,25-09-2019 17:36:00,1,1662.0,1228.0,0.739,7.908,653,58,22,36,595,522,73,0,0.0,0.0
1016,1620,25-09-2019 17:38:00,1,1546.0,1177.0,0.761,7.393,330,45,5,40,285,249,36,0,0.0,0.0
1016,1621,25-09-2019 17:40:00,1,1462.0,1126.0,0.77,7.008,67,10,5,5,57,47,10,0,0.0,0.0
1016,1622,25-09-2019 17:42:00,1,1485.0,1068.0,0.72,7.032,39,6,1,5,33,5,28,0,0.0,0.0
1016,1623,25-09-2019 17:44:00,1,1489.0,1053.0,0.707,7.031,42,27,14,13,15,3,12,0,0.0,0.0
1016,1624,25-09-2019 17:46:00,1,1489.0,1030.0,0.691,7.009,21,14,5,9,7,0,7,0,0.0,0.0
1016,1625,25-09-2019 17:48:00,1,1493.0,995.0,0.667,6.985,19,10,4,6,9,0,9,0,0.0,0.0
1016,1626,25-09-2019 17:50:00,1,1375.0,964.0,0.701,6.484,8,2,0,2,6,2,4,0,0.0,0.0
1016,1627,25-09-2019 17:52:00,1,1392.0,960.0,0.689,6.547,20,2,0,2,18,3,15,0,0.0,0.0
1016,1628,25-09-2019 17:54:00,1,1279.0,958.0,0.749,6.102,22,0,0,0,22,2,20,0,0.0,0.0
1016,1629,25-09-2019 17:56:00,1,1166.0,897.0,0.769,5.588,55,1,0,1,54,16,38,0,0.0,0.0
1016,1630,25-09-2019 17:58:00,1,1420.5,1021.5,0.7265,6.7285,68,0,0,0,68,37,31,0,0.0,0.0
1016,1631,25-09-2019 18:00:00,0,1675.0,1146.0,0.684,7.869,422,54,25,29,368,295,73,8,0.0,0.0
1016,1632,25-09-2019 18:02:00,0,1677.0,1248.0,0.744,7.99,661,371,311,60,290,223,67,151,0.0,0.0
1016,1633,25-09-2019 18:04:00,0,1958.0,1482.0,0.757,9.354,331,168,132,36,163,125,38,134,0.0,0.0
1016,1634,25-09-2019 18:06:00,0,1972.0,1455.0,0.738,9.38,298,173,133,40,125,77,48,94,0.0,0.0
1016,1635,25-09-2019 18:08:00,0,1964.0,1446.0,0.736,9.34,170,78,49,29,92,35,57,42,0.0,0.0
1016,1636,25-09-2019 18:10:00,0,2146.0,1536.0,0.716,10.158,419,189,150,39,230,171,59,90,0.0,0.0
1016,1637,25-09-2019 18:12:00,0,2062.0,1545.0,0.749,9.835,88,51,37,14,37,2,35,52,0.0,0.0
1016,1638,25-09-2019 18:14:00,0,2146.0,1566.0,0.73,10.191,65,21,9,12,44,0,44,31,0.0,0.0
1016,1639,25-09-2019 18:16:00,0,2157.0,1623.0,0.753,10.294,68,29,18,11,39,0,39,48,0.0,0.13
1016,1640,25-09-2019 18:18:00,0,1937.0,1557.0,0.804,9.357,166,80,60,20,86,28,58,48,0.0,0.0
1016,1641,25-09-2019 18:20:00,0,1873.0,1455.0,0.777,8.991,336,215,173,42,121,89,32,25,0.0,0.0
1016,1642,25-09-2019 18:22:00,0,1975.0,1483.0,0.751,9.422,276,176,123,53,100,72,28,46,0.0,0.0
1016,1643,25-09-2019 18:24:00,0,1658.0,1347.0,0.813,8.023,366,142,106,36,224,159,65,34,0.04,0.0
1016,1644,25-09-2019 18:26:00,0,1905.0,1612.0,0.846,9.291,258,146,111,35,112,75,37,96,0.0,0.0
1016,1645,25-09-2019 18:28:00,0,1435.0,1213.0,0.845,6.998,45,8,4,4,37,13,24,0,0.0,0.0
1016,1646,25-09-2019 18:30:00,0,1832.0,1512.0,0.825,8.895,211,81,48,33,130,84,46,3,0.01,0.0
1016,1647,25-09-2019 18:32:00,0,1978.0,1693.5,0.854,9.6695,450,246,195,51,204,145,59,129,0.03,0.0
1016,1648,25-09-2019 18:34:00,0,2124.0,1875.0,0.883,10.444,579,329,282,47,250,202,48,237,0.0,0.0
1016,1649,25-09-2019 18:36:00,0,2304.0,1985.0,0.861,11.274,242,197,183,14,45,1,44,54,0.01,0.0
1016,1650,25-09-2019 18:38:00,0,2284.0,1987.0,0.87,11.2,289,198,171,27,91,70,21,12,0.0,0.0
1016,1651,25-09-2019 18:40:00,0,1707.0,1492.0,0.874,8.376,315,148,106,42,167,116,51,27,0.0,0.04
1016,1652,25-09-2019 18:42:00,0,1536.0,1317.0,0.858,7.508,70,40,23,17,30,18,12,6,0.08,0.0
1016,1653,25-09-2019 18:44:00,0,1933.0,1542.0,0.798,9.322,171,93,62,31,78,40,38,22,0.03,0.0
1016,1654,25-09-2019 18:46:00,0,2113.0,1804.0,0.854,10.322,87,37,20,17,50,0,50,58,0.0,0.0
1016,1655,25-09-2019 18:48:00,0,2106.0,1883.0,0.894,10.383,74,29,14,15,45,0,45,55,0.0,0.03
1016,1656,25-09-2019 18:50:00,0,2100.0,1795.0,0.855,10.259,102,57,36,21,45,0,45,84,0.0,0.08
1016,1657,25-09-2019 18:52:00,0,2080.0,1787.0,0.859,10.175,245,131,94,37,114,66,48,54,0.07,0.03
1016,1658,25-09-2019 18:54:00,0,2252.0,2075.0,0.921,11.17,372,243,192,51,129,93,36,100,0.09,0.0
1016,1659,25-09-2019 18:56:00,0,2261.0,2121.0,0.938,11.257,243,128,103,25,115,87,28,72,0.02,0.0
1016,1660,25-09-2019 18:58:00,0,1595.0,1529.0,0.959,7.976,378,135,95,40,243,180,63,9,0.0,0.02
1016,1661,25-09-2019 19:00:00,0,1360.0,1121.0,0.824,6.599,199,38,18,20,161,100,61,1,0.0,0.0
1016,1662,25-09-2019 19:02:00,0,1923.0,1532.0,0.797,9.272,147,46,15,31,101,61,40,0,0.0,0.0
1016,1663,25-09-2019 19:04:00,0,1707.0,1461.0,0.856,8.344,50,19,5,14,31,8,23,0,0.0,0.0
1016,1664,25-09-2019 19:06:00,0,1827.0,1525.5,0.8365,8.887,33,3,1,2,30,3,27,0,0.0,0.0
1016,1665,25-09-2019 19:08:00,0,1947.0,1590.0,0.817,9.43,42,5,2,3,37,13,24,0,0.0,0.0
1016,1666,25-09-2019 19:10:00,0,1723.0,1533.0,0.89,8.488,14,0,0,0,14,5,9,0,0.0,0.0
1016,1667,25-09-2019 19:12:00,0,1707.0,1558.0,0.913,8.45,35,21,18,3,14,9,5,0,0.0,0.0
1016,1668,25-09-2019 19:14:00,0,1904.0,1662.0,0.873,9.344,116,54,35,19,62,10,52,57,0.0,0.0
1016,1669,25-09-2019 19:16:00,0,2053.0,1850.0,0.901,10.137,258,141,109,32,117,61,56,77,0.0,0.02
1016,1670,25-09-2019 19:18:00,0,1860.0,1770.0,0.952,9.289,193,104,85,19,89,44,45,72,0.03,0.0
1016,1671,25-09-2019 19:20:00,0,2075.0,2032.0,0.979,10.427,84,35,14,21,49,0,49,48,0.01,0.03
1016,1672,25-09-2019 19:22:00,0,2076.0,1960.0,0.944,10.348,82,36,23,13,46,0,46,66,0.0,0.0
1016,1673,25-09-2019 19:24:00,0,2165.0,1971.0,0.91,10.712,258,143,116,27,115,77,38,68,0.0,0.15
1016,1674,25-09-2019 19:26:00,0,1397.0,1290.0,0.923,6.932,68,16,8,8,52,27,25,0,0.0,0.0
1016,1675,25-09-2019 19:28:00,0,1220.0,1101.0,0.902,6.027,172,70,35,35,102,60,42,5,0.0,0.0
1016,1676,25-09-2019 19:30:00,0,1603.0,1484.0,0.926,7.957,170,37,19,18,133,85,48,0,0.0,0.0
1016,1677,25-09-2019 19:32:00,0,1912.0,1731.0,0.905,9.45,283,96,54,42,187,128,59,28,0.0,0.0
1016,1678,25-09-2019 19:34:00,0,2271.0,2158.0,0.95,11.337,286,116,83,33,170,128,42,75,0.01,0.0
1016,1679,25-09-2019 19:36:00,0,2289.0,2078.0,0.908,11.318,233,127,90,37,106,73,33,14,0.0,0.0
1016,1680,25-09-2019 19:38:00,0,2030.0,1978.0,0.974,10.187,395,172,132,40,223,157,66,40,0.08,0.0
1016,1681,25-09-2019 19:40:00,0,2143.0,2057.0,0.9605,10.7195,209,113,94,19,96,62,34,163,0.07,0.0
1016,1682,25-09-2019 19:42:00,0,2256.0,2136.0,0.947,11.252,68,29,15,14,39,3,36,32,0.02,0.04
1016,1683,25-09-2019 19:44:00,0,2304.0,2074.0,0.9,11.376,68,30,14,16,38,0,38,38,0.0,0.01
1016,1684,25-09-2019 19:46:00,0,2271.0,2153.0,0.948,11.333,68,31,14,17,37,0,37,52,0.0,0.18
1016,1685,25-09-2019 19:48:00,0,2162.0,2011.0,0.93,10.744,82,35,15,20,47,0,47,72,0.0,0.0
1016,1686,25-09-2019 19:50:00,0,2159.0,1990.0,0.922,10.707,250,144,101,43,106,56,50,73,0.0,0.08
1016,1687,25-09-2019 19:52:00,0,2335.0,2260.0,0.968,11.702,186,101,72,29,85,60,25,72,0.0,0.0
1016,1688,25-09-2019 19:54:00,0,1876.0,1780.0,0.949,9.363,413,182,134,48,231,169,62,8,0.0,0.0
1016,1689,25-09-2019 19:56:00,0,1635.0,1385.0,0.847,7.975,362,140,101,39,222,160,62,100,0.09,0.0
1016,1690,25-09-2019 19:58:00,0,1882.0,1768.0,0.94,9.373,356,217,163,54,139,89,50,115,0.01,0.0
1016,1691,25-09-2019 20:00:00,0,2083.0,1865.0,0.895,10.273,137,75,52,23,62,24,38,61,0.0,0.0
1016,1692,25-09-2019 20:02:00,0,2072.0,1997.0,0.964,10.374,109,60,34,26,49,0,49,70,0.0,0.06
1016,1693,25-09-2019 20:04:00,0,2058.0,1993.0,0.968,10.316,84,48,27,21,36,0,36,58,0.01,0.06
1016,1694,25-09-2019 20:06:00,0,2165.0,2053.0,0.948,10.804,196,69,49,20,127,75,52,30,0.09,0.04
1016,1695,25-09-2019 20:08:00,0,1509.0,1319.0,0.874,7.405,174,60,33,27,114,76,38,3,0.0,0.0
1016,1696,25-09-2019 20:10:00,0,1446.0,1164.0,0.805,6.985,104,10,0,10,94,65,29,0,0.0,0.0
1016,1697,25-09-2019 20:12:00,0,1807.0,1555.0,0.861,8.841,172,42,17,25,130,83,47,0,0.0,0.0
1016,1698,25-09-2019 20:14:00,0,1860.0,1627.0,0.8745,9.1295,31,10,4,6,21,12,9,0,0.0,0.01
1016,1699,25-09-2019 20:16:00,0,1913.0,1699.0,0.888,9.418,13,2,2,0,11,4,7,0,0.0,0.0
1016,1700,25-09-2019 20:18:00,0,1969.0,1781.0,0.905,9.732,28,14,8,6,14,7,7,0,0.0,0.0
1016,1701,25-09-2019 20:20:00,0,2068.0,1880.0,0.909,10.229,21,6,1,5,15,6,9,0,0.0,0.0
1016,1702,25-09-2019 20:22:00,0,2063.0,1905.0,0.923,10.237,14,4,0,4,10,2,8,0,0.0,0.0
1016,1703,25-09-2019 20:24:00,0,1888.0,1825.0,0.967,9.457,361,151,118,33,210,155,55,8,0.0,0.0
1016,1704,25-09-2019 20:26:00,0,1878.0,1825.0,0.972,9.421,446,240,188,52,206,149,57,88,0.01,0.0
1016,1705,25-09-2019 20:28:00,0,2079.0,1971.0,0.948,10.371,312,167,128,39,145,95,50,77,0.07,0.01
1016,1706,25-09-2019 20:30:00,0,1854.0,1708.0,0.921,9.197,183,45,33,12,138,87,51,13,0.0,0.0
1016,1707,25-09-2019 20:32:00,0,1874.0,1810.0,0.966,9.386,361,60,26,34,301,230,71,18,0.0,0.0
1016,1708,25-09-2019 20:34:00,0,1983.0,1846.0,0.931,9.856,149,42,16,26,107,65,42,2,0.0,0.0
1016,1709,25-09-2019 20:36:00,0,2111.0,1876.0,0.888,10.395,156,92,55,37,64,37,27,1,0.0,0.0
1016,1710,25-09-2019 20:38:00,0,1894.0,1806.0,0.953,9.462,8,3,0,3,5,2,3,0,0.0,0.0
1016,1711,25-09-2019 20:40:00,0,1816.0,1618.0,0.891,8.946,15,5,4,1,10,7,3,0,0.0,0.0
1016,1712,25-09-2019 20:42:00,0,1579.0,1489.0,0.942,7.871,9,3,1,2,6,4,2,0,0.0,0.0
1016,1713,25-09-2019 20:44:00,0,1624.0,1381.0,0.85,7.928,1,0,0,0,1,1,0,0,0.0,0.0
1016,1714,25-09-2019 20:46:00,0,1420.0,1280.0,0.901,7.013,26,11,6,5,15,10,5,0,0.0,0.01
1016,1715,25-09-2019 20:48:00,0,1520.0,1395.5,0.917,7.5345,29,1,1,0,28,13,15,0,0.0,0.0
1016,1716,25-09-2019 20:50:00,0,1620.0,1511.0,0.933,8.056,38,17,12,5,21,16,5,1,0.0,0.0
1016,1717,25-09-2019 20:52:00,0,1708.0,1590.0,0.931,8.492,90,46,26,20,44,1,43,75,0.0,0.0
1016,1718,25-09-2019 20:54:00,0,1879.0,1753.0,0.933,9.345,77,29,14,15,48,0,48,85,0.0,0.07
1016,1719,25-09-2019 20:56:00,0,1874.0,1751.0,0.934,9.32,80,42,35,7,38,17,21,44,0.0,0.33
1016,1720,25-09-2019 20:58:00,0,1635.0,1380.0,0.844,7.969,2,1,0,1,1,1,0,0,0.0,0.01
1016,1721,25-09-2019 21:00:00,0,1978.0,1837.0,0.929,9.828,374,213,162,51,161,113,48,97,0.11,0.0
1016,1722,25-09-2019 21:02:00,0,1904.0,1735.0,0.911,9.423,359,221,176,45,138,101,37,19,0.0,0.0
1016,1723,25-09-2019 21:04:00,0,1996.0,1840.0,0.922,9.903,103,33,18,15,70,39,31,58,0.0,0.02
1016,1724,25-09-2019 21:06:00,0,2261.0,2075.0,0.918,11.204,312,152,122,30,160,123,37,131,0.05,0.09
1016,1725,25-09-2019 21:08:00,0,1910.0,1697.0,0.888,9.403,36,20,13,7,16,13,3,0,0.0,0.0
1016,1726,25-09-2019 21:10:00,0,1997.0,1799.0,0.901,9.861,0,0,0,0,0,0,0,0,0.0,0.0
1016,1727,25-09-2019 21:12:00,0,2062.0,1967.0,0.954,10.301,179,101,70,31,78,55,23,7,0.0,0.0
1016,1728,25-09-2019 21:14:00,0,2091.0,1847.0,0.883,10.285,219,70,51,19,149,108,41,8,0.13,0.0
1016,1729,25-09-2019 21:16:00,0,2049.0,1974.0,0.963,10.258,169,31,11,20,138,90,48,12,0.0,0.0
1016,1730,25-09-2019 21:18:00,0,2098.0,1921.0,0.916,10.395,85,31,12,19,54,33,21,0,0.0,0.0
1016,1731,25-09-2019 21:20:00,0,1890.0,1763.0,0.933,9.398,41,12,4,8,29,18,11,0,0.0,0.0
1016,1732,25-09-2019 21:22:00,0,1874.5,1737.0,0.927,9.308,1,1,1,0,0,0,0,0,0.0,0.0
1016,1733,25-09-2019 21:24:00,0,1859.0,1711.0,0.921,9.218,5,1,0,1,4,1,3,0,0.0,0.0
1016,1734,25-09-2019 21:26:00,0,1893.0,1641.0,0.867,9.276,66,18,9,9,48,33,15,0,0.0,0.0
1016,1735,25-09-2019 21:28:00,0,1706.0,1564.0,0.917,8.451,9,9,0,9,0,0,0,0,0.0,0.0
1016,1736,25-09-2019 21:30:00,0,1624.0,1500.0,0.924,8.06,9,2,0,2,7,3,4,0,0.0,0.0
1016,1737,25-09-2019 21:32:00,0,1626.0,1451.0,0.892,8.011,80,40,29,11,40,24,16,16,0.0,0.0
1016,1738,25-09-2019 21:34:00,0,1886.0,1622.0,0.86,9.228,244,139,102,37,105,77,28,81,0.0,0.0
1016,1739,25-09-2019 21:36:00,0,1920.0,1636.0,0.852,9.377,210,100,75,25,110,84,26,84,0.0,0.0
1016,1740,25-09-2019 21:38:00,0,2099.0,1865.0,0.888,10.336,183,97,75,22,86,52,34,46,0.11,0.08
1016,1741,25-09-2019 21:40:00,0,1899.0,1766.0,0.93,9.437,187,102,66,36,85,67,18,14,0.0,0.16
1016,1742,25-09-2019 21:42:00,0,1865.0,1783.0,0.956,9.322,411,211,169,42,200,149,51,66,0.08,0.0
1016,1743,25-09-2019 21:44:00,0,1877.0,1691.0,0.901,9.267,386,192,140,52,194,138,56,72,0.01,0.0
1016,1744,25-09-2019 21:46:00,0,1876.0,1774.0,0.946,9.356,199,121,97,24,78,57,21,83,0.0,0.0
1016,1745,25-09-2019 21:48:00,0,2092.0,1942.0,0.928,10.393,53,42,22,20,11,0,11,54,0.01,0.0
1016,1746,25-09-2019 21:50:00,0,2078.0,1938.0,0.933,10.333,106,80,45,35,26,13,13,49,0.0,0.0
1016,1747,25-09-2019 21:52:00,0,2075.0,1948.0,0.939,10.333,65,44,26,18,21,1,20,52,0.02,0.0
1016,1748,25-09-2019 21:54:00,0,2276.0,2009.0,0.883,11.193,110,72,45,27,38,6,32,58,0.0,0.07
1016,1749,25-09-2019 21:56:00,0,2316.0,2132.0,0.92,11.487,82,53,27,26,29,9,20,38,0.0,0.1
1016,1750,25-09-2019 21:58:00,0,2356.0,2255.0,0.957,11.781,204,100,81,19,104,66,38,91,0.14,0.0
1016,1751,25-09-2019 22:00:00,0,2380.0,2207.0,0.927,11.821,200,130,91,39,70,36,34,70,0.0,0.0
1016,1752,25-09-2019 22:02:00,0,2231.0,2180.0,0.977,11.204,77,38,23,15,39,4,35,67,0.0,0.0
1016,1753,25-09-2019 22:04:00,0,2251.0,2065.0,0.917,11.153,214,118,82,36,96,61,35,36,0.0,0.0
1016,1754,25-09-2019 22:06:00,0,2177.0,1997.0,0.918,10.788,166,77,43,34,89,45,44,38,0.11,0.0
1016,1755,25-09-2019 22:08:00,0,2070.0,1908.0,0.922,10.269,165,93,58,35,72,51,21,0,0.0,0.0
1016,1756,25-09-2019 22:10:00,0,1998.0,1841.0,0.921,9.91,298,165,135,30,133,91,42,84,0.0,0.0
1016,1757,25-09-2019 22:12:00,0,2278.0,2044.0,0.897,11.238,136,102,68,34,34,10,24,41,0.01,0.11
1016,1758,25-09-2019 22:14:00,0,2545.0,2302.0,0.905,12.574,153,79,40,39,74,41,33,26,0.0,0.0
1016,1759,25-09-2019 22:16:00,0,2060.0,1949.0,0.946,10.274,328,176,133,43,152,111,41,78,0.04,0.0
1016,1760,25-09-2019 22:18:00,0,2260.0,2148.0,0.951,11.283,239,104,76,28,135,87,48,46,0.01,0.0
1016,1761,25-09-2019 22:20:00,0,2176.0,2002.0,0.92,10.791,155,79,56,23,76,32,44,57,0.01,0.0
1016,1762,25-09-2019 22:22:00,0,1918.0,1635.0,0.852,9.366,214,70,37,33,144,95,49,11,0.0,0.0
1016,1763,25-09-2019 22:24:00,0,1829.0,1565.0,0.855,8.941,215,37,12,25,178,126,52,4,0.0,0.0
1016,1764,25-09-2019 22:26:00,0,2245.0,2066.0,0.92,11.132,174,120,78,42,54,26,28,13,0.0,0.0
1016,1765,25-09-2019 22:28:00,0,2237.0,2086.0,0.933,11.124,153,73,39,34,80,45,35,7,0.0,0.01
1016,1766,25-09-2019 22:30:00,0,2385.5,2265.0,0.949,11.9075,101,66,35,31,35,12,23,68,0.0,0.0
1016,1767,25-09-2019 22:32:00,0,2534.0,2444.0,0.965,12.691,82,33,21,12,49,6,43,54,0.0,0.0
1016,1768,25-09-2019 22:34:00,0,2514.0,2358.0,0.938,12.517,164,62,43,19,102,56,46,27,0.13,0.0
1016,1769,25-09-2019 22:36:00,0,2146.0,2017.0,0.94,10.689,248,139,93,46,109,65,44,51,0.0,0.0
1016,1770,25-09-2019 22:38:00,0,2251.0,2184.0,0.97,11.288,226,128,85,43,98,58,40,48,0.0,0.0
1016,1771,25-09-2019 22:40:00,0,2267.0,2098.0,0.926,11.253,134,90,52,38,44,12,32,66,0.0,0.07
1016,1772,25-09-2019 22:42:00,0,2249.0,2081.0,0.925,11.163,174,102,73,29,72,38,34,76,0.0,0.04
1016,1773,25-09-2019 22:44:00,0,2247.0,2062.0,0.918,11.135,168,110,73,37,58,22,36,66,0.0,0.05
1016,1774,25-09-2019 22:46:00,0,2240.0,2075.0,0.926,11.123,120,72,38,34,48,20,28,26,0.0,0.06
1016,1775,25-09-2019 22:48:00,0,2084.0,1967.0,0.944,10.388,225,137,100,37,88,47,41,65,0.0,0.0
1016,1776,25-09-2019 22:50:00,0,2073.0,2022.0,0.975,10.408,280,174,126,48,106,70,36,37,0.01,0.0
1016,1777,25-09-2019 22:52:00,0,2089.0,1857.0,0.889,10.284,412,167,126,41,245,176,69,5,0.14,0.0
1016,1778,25-09-2019 22:54:00,0,1865.0,1699.0,0.911,9.229,373,159,111,48,214,147,67,29,0.0,0.0
1016,1779,25-09-2019 22:56:00,0,2314.0,2276.0,0.983,11.637,278,161,113,48,117,72,45,84,0.01,0.0
1016,1780,25-09-2019 22:58:00,0,2055.0,1981.0,0.964,10.289,80,37,26,11,43,8,35,89,0.0,0.0
1016,1781,25-09-2019 23:00:00,0,2277.0,2117.0,0.93,11.317,88,38,23,15,50,3,47,62,0.0,0.0
1016,1782,25-09-2019 23:02:00,0,2080.0,2017.0,0.97,10.428,66,27,20,7,39,0,39,52,0.0,0.0
1016,1783,25-09-2019 23:04:00,0,2345.5,2254.0,0.962,11.7365,75,32,18,14,43,0,43,50,0.0,0.0
1016,1784,25-09-2019 23:06:00,0,2611.0,2491.0,0.954,13.045,216,117,85,32,99,59,40,57,0.0,0.02
1016,1785,25-09-2019 23:08:00,0,2346.0,2188.0,0.933,11.666,81,40,21,19,41,0,41,67,0.0,0.04
1016,1786,25-09-2019 23:10:00,0,2438.0,2406.0,0.987,12.268,122,46,26,20,76,24,52,58,0.01,0.04
1016,1787,25-09-2019 23:12:00,0,1975.0,1908.0,0.966,9.894,305,152,108,44,153,113,40,31,0.13,0.0
1016,1788,25-09-2019 23:14:00,0,1877.0,1779.0,0.947,9.365,265,180,137,43,85,45,40,61,0.0,0.0
1016,1789,25-09-2019 23:16:00,0,2126.0,2095.0,0.985,10.694,168,94,70,24,74,25,49,63,0.0,0.04
1016,1790,25-09-2019 23:18:00,0,2143.0,2117.0,0.988,10.788,231,126,97,29,105,62,43,74,0.01,0.0
1016,1791,25-09-2019 23:20:00,0,1961.0,1928.0,0.983,9.862,181,122,94,28,59,16,43,30,0.0,0.0
1016,1792,25-09-2019 23:22:00,0,2317.0,2269.0,0.979,11.642,189,80,47,33,109,70,39,29,0.08,0.06
1016,1793,25-09-2019 23:24:00,0,2040.0,2008.0,0.984,10.261,245,133,104,29,112,68,44,85,0.01,0.0
1016,1794,25-09-2019 23:26:00,0,2159.0,2100.0,0.973,10.833,65,30,16,14,35,0,35,64,0.02,0.0
1016,1795,25-09-2019 23:28:00,0,2238.0,2227.0,0.995,11.284,73,30,16,14,43,0,43,47,0.0,0.0
1016,1796,25-09-2019 23:30:00,0,2255.0,2187.0,0.97,11.307,352,105,65,40,247,194,53,27,0.0,0.0
1016,1797,25-09-2019 23:32:00,0,1603.0,1529.0,0.954,8.007,374,93,52,41,281,255,26,3,0.0,0.0
1016,1798,25-09-2019 23:34:00,0,1500.0,1310.0,0.874,7.36,69,7,2,5,62,42,20,0,0.0,0.0
1016,1799,25-09-2019 23:36:00,0,1773.0,1682.0,0.949,8.846,390,64,29,35,326,299,27,0,0.0,0.0
1016,1800,25-09-2019 23:38:00,0,2177.0,2025.0,0.9335,10.818,1029,346,274,72,683,590,93,3,0.0,0.0
1016,1801,25-09-2019 23:40:00,0,2581.0,2368.0,0.918,12.79,222,135,95,40,87,54,33,29,0.0,0.05
1016,1802,25-09-2019 23:42:00,0,2457.0,2311.0,0.941,12.24,211,127,85,42,84,50,34,24,0.0,0.0
1016,1803,25-09-2019 23:44:00,0,2583.0,2315.0,0.896,12.739,630,322,261,61,308,241,67,69,0.0,0.0
1016,1804,25-09-2019 23:46:00,0,2337.0,2184.0,0.935,11.624,358,175,140,35,183,137,46,27,0.0,0.0
1016,1805,25-09-2019 23:48:00,0,2324.0,2195.0,0.944,11.588,146,77,56,21,69,28,41,99,0.0,0.0
1016,1806,25-09-2019 23:50:00,0,2252.0,2186.0,0.971,11.295,430,166,124,42,264,201,63,10,0.14,0.0
1016,1807,25-09-2019 23:52:00,0,2017.0,1802.0,0.893,9.942,336,177,127,50,159,137,22,0,0.0,0.0
1016,1808,25-09-2019 23:54:00,0,2127.0,1819.0,0.855,10.393,51,48,20,28,3,1,2,0,0.0,0.0
1016,1809,25-09-2019 23:56:00,0,1923.0,1561.0,0.812,9.305,93,58,27,31,35,6,29,2,0.0,0.0
1016,1810,25-09-2019 23:58:00,0,1979.0,1770.0,0.894,9.758,88,53,22,31,35,8,27,0,0.0,0.0
1016,1811,26-09-2019 00:00:00,0,2099.0,1852.0,0.882,10.322,288,181,141,40,107,70,37,19,0.0,0.0
1016,1812,26-09-2019 00:02:00,0,2087.0,1925.0,0.922,10.355,87,46,34,12,41,16,25,42,0.0,0.0
1016,1813,26-09-2019 00:04:00,0,2077.0,1953.0,0.94,10.344,116,73,51,22,43,0,43,55,0.0,0.0
1016,1814,26-09-2019 00:06:00,0,2082.0,1988.0,0.955,10.402,80,45,24,21,35,2,33,57,0.0,0.0
1016,1815,26-09-2019 00:08:00,0,1898.0,1761.0,0.928,9.426,254,139,101,38,115,78,37,15,0.0,0.0
1016,1816,26-09-2019 00:10:00,0,1713.0,1470.0,0.858,8.375,187,127,79,48,60,32,28,13,0.0,0.0
1016,1817,26-09-2019 00:12:00,0,1887.5,1721.5,0.9075,9.3425,102,71,40,31,31,21,10,1,0.0,0.0
1016,1818,26-09-2019 00:14:00,0,2062.0,1973.0,0.957,10.31,230,142,94,48,88,64,24,5,0.0,0.0
1016,1819,26-09-2019 00:16:00,0,1993.0,1805.0,0.906,9.85,61,46,15,31,15,6,9,0,0.0,0.0
1016,1820,26-09-2019 00:18:00,0,2083.0,1812.0,0.87,10.212,130,75,52,23,55,29,26,44,0.0,0.0
1016,1821,26-09-2019 00:20:00,0,2085.0,1908.0,0.915,10.328,203,78,43,35,125,80,45,13,0.0,0.0
1016,1822,26-09-2019 00:22:00,0,2073.0,1937.0,0.934,10.313,78,37,19,18,41,0,41,59,0.0,0.0
1016,1823,26-09-2019 00:24:00,0,2078.0,1940.0,0.934,10.334,253,158,112,46,95,52,43,75,0.0,0.0
1016,1824,26-09-2019 00:26:00,0,2089.0,1872.0,0.896,10.303,172,104,64,40,68,32,36,67,0.0,0.0
1016,1825,26-09-2019 00:28:00,0,2080.0,1873.0,0.9,10.269,125,41,22,19,84,30,54,56,0.0,0.0
1016,1826,26-09-2019 00:30:00,0,2267.0,2036.0,0.898,11.187,296,149,104,45,147,101,46,42,0.0,0.01
1016,1827,26-09-2019 00:32:00,0,1987.0,1808.0,0.91,9.832,223,113,81,32,110,79,31,43,0.01,0.01
1016,1828,26-09-2019 00:34:00,0,1432.0,1246.0,0.87,7.022,140,66,29,37,74,36,38,1,0.0,0.0
1016,1829,26-09-2019 00:36:00,0,1649.0,1331.0,0.807,7.971,67,24,14,10,43,17,26,0,0.0,0.0
1016,1830,26-09-2019 00:38:00,0,1869.0,1719.0,0.92,9.265,49,24,10,14,25,6,19,0,0.01,0.0
1016,1831,26-09-2019 00:40:00,0,2075.0,1881.0,0.907,10.257,90,59,30,29,31,17,14,1,0.0,0.0
1016,1832,26-09-2019 00:42:00,0,2062.0,1896.0,0.919,10.223,62,39,21,18,23,10,13,0,0.0,0.0
1016,1833,26-09-2019 00:44:00,0,1902.0,1738.0,0.914,9.42,22,3,2,1,19,1,18,0,0.01,0.01
1016,1834,26-09-2019 00:46:00,0,1860.0,1651.5,0.8875,9.157,4,0,0,0,4,0,4,0,0.0,0.0
1016,1835,26-09-2019 00:48:00,0,1818.0,1565.0,0.861,8.894,5,4,0,4,1,1,0,0,0.0,0.0
1016,1836,26-09-2019 00:50:00,0,1623.0,1479.0,0.911,8.031,16,8,1,7,8,1,7,0,0.0,0.0
1016,1837,26-09-2019 00:52:00,0,1596.0,1443.0,0.904,7.885,3,1,0,1,2,0,2,0,0.0,0.0
1016,1838,26-09-2019 00:54:00,0,1635.0,1399.0,0.856,7.992,1,0,0,0,1,0,1,0,0.0,0.0
1016,1839,26-09-2019 00:56:00,0,1608.0,1381.0,0.858,7.866,2,1,0,1,1,0,1,0,0.0,0.0
1016,1840,26-09-2019 00:58:00,0,1607.0,1481.0,0.921,7.971,566,310,241,69,256,194,62,26,0.0,0.0
1016,1841,26-09-2019 01:00:00,0,1897.0,1797.0,0.947,9.464,309,174,129,45,135,90,45,59,0.01,0.0
1016,1842,26-09-2019 01:02:00,0,1806.0,1671.0,0.925,8.965,241,149,116,33,92,71,21,136,0.0,0.0
1016,1843,26-09-2019 01:04:00,0,2008.0,1808.0,0.901,9.912,215,124,94,30,91,70,21,119,0.0,0.01
1016,1844,26-09-2019 01:06:00,0,1887.0,1710.0,0.906,9.328,164,115,83,32,49,5,44,72,0.0,0.0
1016,1845,26-09-2019 01:08:00,0,1963.0,1772.0,0.903,9.696,109,61,41,20,48,9,39,65,0.0,0.0
1016,1846,26-09-2019 01:10:00,0,2083.0,1788.0,0.858,10.189,74,24,16,8,50,4,46,42,0.0,0.0
1016,1847,26-09-2019 01:12:00,0,2077.0,1898.0,0.914,10.285,67,20,8,12,47,0,47,47,0.0,0.0
1016,1848,26-09-2019 01:14:00,0,1923.0,1684.0,0.876,9.44,211,113,86,27,98,45,53,55,0.0,0.0
1016,1849,26-09-2019 01:16:00,0,2092.0,1917.0,0.916,10.365,85,34,18,16,51,2,49,57,0.0,0.0
1016,1850,26-09-2019 01:18:00,0,2085.0,1977.0,0.948,10.402,74,31,16,15,43,2,41,45,0.0,0.0
1016,1851,26-09-2019 01:20:00,0,2156.5,2059.5,0.955,10.776,99,51,29,22,48,10,38,45,0.0,0.06
1016,1852,26-09-2019 01:22:00,0,2228.0,2142.0,0.962,11.15,171,84,64,20,87,38,49,69,0.0,0.03
1016,1853,26-09-2019 01:24:00,0,2252.0,2047.0,0.909,11.138,244,105,80,25,139,88,51,14,0.0,0.05
1016,1854,26-09-2019 01:26:00,0,2070.0,1910.0,0.923,10.271,296,148,109,39,148,116,32,60,0.07,0.0
1016,1855,26-09-2019 01:28:00,0,1878.0,1811.0,0.964,9.403,235,140,105,35,95,56,39,8,0.0,0.0
1016,1856,26-09-2019 01:30:00,0,2001.0,1768.0,0.883,9.843,111,48,33,15,63,18,45,78,0.01,0.0
1016,1857,26-09-2019 01:32:00,0,2264.0,2047.0,0.904,11.184,82,39,26,13,43,0,43,36,0.01,0.0
1016,1858,26-09-2019 01:34:00,0,2156.0,2002.0,0.929,10.71,91,40,22,18,51,0,51,58,0.0,0.0
1016,1859,26-09-2019 01:36:00,0,2046.0,1997.0,0.976,10.272,90,39,21,18,51,3,48,61,0.0,0.0
1016,1860,26-09-2019 01:38:00,0,2079.0,1913.0,0.92,10.309,94,46,25,21,48,0,48,71,0.0,0.12
1016,1861,26-09-2019 01:40:00,0,2279.0,2035.0,0.893,11.23,72,34,19,15,38,0,38,69,0.0,0.0
1016,1862,26-09-2019 01:42:00,0,2049.0,2005.0,0.978,10.293,101,56,39,17,45,0,45,67,0.0,0.11
1016,1863,26-09-2019 01:44:00,0,2276.0,2021.0,0.888,11.207,161,69,37,32,92,41,51,46,0.09,0.09
1016,1864,26-09-2019 01:46:00,0,1597.0,1469.0,0.919,7.92,416,192,148,44,224,161,63,37,0.0,0.0
1016,1865,26-09-2019 01:48:00,0,1998.0,1824.0,0.913,9.89,484,351,278,73,133,85,48,25,0.08,0.14
1016,1866,26-09-2019 01:50:00,0,2282.0,2061.0,0.903,11.273,143,75,48,27,68,20,48,61,0.0,0.0
1016,1867,26-09-2019 01:52:00,0,2294.0,2093.0,0.912,11.356,109,67,39,28,42,0,42,74,0.01,0.0
1016,1868,26-09-2019 01:54:00,0,2286.5,2083.0,0.9105,11.3155,112,51,35,16,61,0,61,80,0.0,0.0
1016,1869,26-09-2019 01:56:00,0,2279.0,2073.0,0.909,11.275,172,52,26,26,120,51,69,30,0.0,0.09
1016,1870,26-09-2019 01:58:00,0,2087.0,1855.0,0.889,10.275,963,264,200,64,699,602,97,3,0.09,0.0
1016,1871,26-09-2019 02:00:00,0,1900.0,1650.0,0.869,9.313,982,399,322,77,583,512,71,13,0.01,0.01
1016,1872,26-09-2019 02:02:00,0,2101.0,1842.0,0.877,10.316,792,315,248,67,477,397,80,23,0.04,0.0
1016,1873,26-09-2019 02:04:00,0,1610.0,1461.0,0.908,7.96,812,192,140,52,620,565,55,8,0.0,0.0
1016,1874,26-09-2019 02:06:00,0,1942.0,1668.0,0.859,9.498,808,24,3,21,784,730,54,0,0.0,0.0
1016,1875,26-09-2019 02:08:00,0,2107.0,1876.0,0.891,10.378,163,36,10,26,127,113,14,0,0.0,0.0
1016,1876,26-09-2019 02:10:00,0,2084.0,1944.0,0.933,10.365,151,15,4,11,136,121,15,0,0.0,0.0
1016,1877,26-09-2019 02:12:00,0,2057.0,1834.0,0.892,10.134,0,0,0,0,0,0,0,0,0.0,0.0
1016,1878,26-09-2019 02:14:00,0,2092.0,1814.0,0.867,10.252,72,0,0,0,72,66,6,0,0.0,0.0
1016,1879,26-09-2019 02:16:00,0,1898.0,1707.0,0.899,9.369,28,2,1,1,26,21,5,0,0.0,0.0
1016,1880,26-09-2019 02:18:00,0,1817.0,1596.0,0.879,8.927,0,0,0,0,0,0,0,0,0.01,0.0
1016,1881,26-09-2019 02:20:00,0,1631.0,1445.0,0.886,8.024,10,0,0,0,10,0,10,0,0.01,0.02
1016,1882,26-09-2019 02:22:00,0,1628.0,1413.0,0.868,7.977,242,16,10,6,226,173,53,0,0.0,0.0
1016,1883,26-09-2019 02:24:00,0,1628.0,1384.0,0.85,7.948,0,0,0,0,0,0,0,0,0.0,0.0
1016,1884,26-09-2019 02:26:00,0,1418.0,1237.0,0.873,6.957,0,0,0,0,0,0,0,0,0.0,0.0
1016,1885,26-09-2019 02:28:00,0,1514.5,1327.5,0.8765,7.4365,46,6,2,4,40,35,5,0,0.0,0.0
1016,1886,26-09-2019 02:30:00,0,1611.0,1418.0,0.88,7.916,0,0,0,0,0,0,0,0,0.0,0.0
1016,1887,26-09-2019 02:32:00,0,1632.0,1431.0,0.877,8.017,5,3,1,2,2,2,0,0,0.0,0.0
1016,1888,26-09-2019 02:34:00,0,1630.0,1411.0,0.866,7.986,9,0,0,0,9,0,9,0,0.0,0.0
1016,1889,26-09-2019 02:36:00,0,1643.0,1413.0,0.86,8.037,50,10,1,9,40,2,38,0,0.0,0.0
1016,1890,26-09-2019 02:38:00,0,1510.0,1367.0,0.905,7.463,7,3,0,3,4,0,4,0,0.0,0.0
1016,1891,26-09-2019 02:40:00,0,1400.0,1312.0,0.937,6.969,96,69,46,23,27,24,3,0,0.0,0.0
1016,1892,26-09-2019 02:42:00,0,1432.0,1294.0,0.904,7.073,34,6,5,1,28,23,5,0,0.0,0.0
1016,1893,26-09-2019 02:44:00,0,1438.0,1265.0,0.88,7.068,258,49,32,17,209,165,44,1,0.0,0.0
1016,1894,26-09-2019 02:46:00,0,1414.0,1318.0,0.932,7.031,9,0,0,0,9,7,2,0,0.0,0.0
1016,1895,26-09-2019 02:48:00,0,1416.0,1303.0,0.92,7.02,617,7,4,3,610,558,52,0,0.0,0.0
1016,1896,26-09-2019 02:50:00,0,1426.0,1231.0,0.863,6.981,1127,2,1,1,1125,1054,71,0,0.0,0.0
1016,1897,26-09-2019 02:52:00,0,1417.0,1237.0,0.873,6.953,12,3,0,3,9,8,1,0,0.0,0.0
1016,1898,26-09-2019 02:54:00,0,1441.0,1245.0,0.864,7.056,8,2,0,2,6,5,1,0,0.0,0.0
1016,1899,26-09-2019 02:56:00,0,1432.0,1243.0,0.868,7.019,256,47,17,30,209,182,27,0,0.0,0.0
1016,1900,26-09-2019 02:58:00,0,1529.0,1372.0,0.897,7.543,296,20,0,20,276,244,32,0,0.01,0.0
1016,1901,26-09-2019 03:00:00,0,1412.0,1264.0,0.895,6.963,91,6,1,5,85,61,24,0,0.0,0.0
1016,1902,26-09-2019 03:02:00,0,1503.5,1335.0,0.888,7.403,748,0,0,0,748,699,49,0,0.0,0.0
1016,1903,26-09-2019 03:04:00,0,1595.0,1406.0,0.881,7.843,648,0,0,0,648,609,39,0,0.0,0.0
1016,1904,26-09-2019 03:06:00,0,1415.0,1343.0,0.95,7.061,513,12,3,9,501,458,43,0,0.0,0.0
1016,1905,26-09-2019 03:08:00,0,1622.0,1434.0,0.884,7.977,739,20,1,19,719,656,63,1,0.0,0.0
1016,1906,26-09-2019 03:10:00,0,1606.0,1556.0,0.969,8.05,278,36,18,18,242,220,22,0,0.0,0.0
1016,1907,26-09-2019 03:12:00,0,1797.0,1631.0,0.907,8.886,603,19,5,14,584,512,72,0,0.0,0.0
1016,1908,26-09-2019 03:14:00,0,1786.0,1621.0,0.907,8.833,418,42,10,32,376,343,33,4,0.0,0.0
1016,1909,26-09-2019 03:16:00,0,1868.0,1750.0,0.937,9.296,457,24,2,22,433,397,36,4,0.0,0.0
1016,1910,26-09-2019 03:18:00,0,1880.0,1722.0,0.916,9.314,197,60,27,33,137,121,16,0,0.0,0.0
1016,1911,26-09-2019 03:20:00,0,1913.0,1745.0,0.912,9.467,230,97,68,29,133,78,55,44,0.0,0.0
1016,1912,26-09-2019 03:22:00,0,1894.0,1736.0,0.917,9.386,130,56,35,21,74,16,58,66,0.0,0.45
1016,1913,26-09-2019 03:24:00,0,1709.0,1547.0,0.905,8.445,17,3,1,2,14,7,7,0,0.0,0.02
1016,1914,26-09-2019 03:26:00,0,1901.0,1678.0,0.883,9.349,535,205,160,45,330,280,50,28,0.0,0.01
1016,1915,26-09-2019 03:28:00,0,2037.0,1983.0,0.974,10.219,161,55,44,11,106,83,23,122,0.0,0.0
1016,1916,26-09-2019 03:30:00,0,1867.0,1754.0,0.939,9.299,373,136,105,31,237,165,72,81,0.08,0.0
1016,1917,26-09-2019 03:32:00,0,1603.0,1478.0,0.922,7.951,146,16,2,14,130,81,49,0,0.0,0.0
1016,1918,26-09-2019 03:34:00,0,1605.0,1494.0,0.931,7.977,295,84,62,22,211,171,40,0,0.0,0.0
1016,1919,26-09-2019 03:36:00,0,1846.5,1673.0,0.909,9.1265,584,275,216,59,309,262,47,57,0.13,0.0
1016,1920,26-09-2019 03:38:00,0,2088.0,1852.0,0.887,10.276,596,143,106,37,453,401,52,3,0.0,0.0
1016,1921,26-09-2019 03:40:00,0,1874.0,1775.0,0.947,9.349,658,249,176,73,409,311,98,34,0.0,0.0
1016,1922,26-09-2019 03:42:00,0,1891.0,1740.0,0.92,9.375,427,245,177,68,182,158,24,0,0.0,0.0
1016,1923,26-09-2019 03:44:00,0,2102.0,1844.0,0.877,10.323,1000,369,288,81,631,565,66,0,0.0,0.0
1016,1924,26-09-2019 03:46:00,0,2056.0,1940.0,0.943,10.25,711,276,222,54,435,364,71,20,0.11,0.0
1016,1925,26-09-2019 03:48:00,0,2106.0,1848.0,0.877,10.344,409,18,4,14,391,357,34,0,0.0,0.0
1016,1926,26-09-2019 03:50:00,0,1901.0,1765.0,0.928,9.444,456,23,6,17,433,389,44,0,0.0,0.0
1016,1927,26-09-2019 03:52:00,0,1877.0,1791.0,0.954,9.379,376,14,5,9,362,312,50,3,0.0,0.0
1016,1928,26-09-2019 03:54:00,0,1916.0,1604.0,0.837,9.326,197,0,0,0,197,169,28,0,0.0,0.0
1016,1929,26-09-2019 03:56:00,0,1803.0,1559.0,0.865,8.83,66,7,3,4,59,35,24,0,0.01,0.0
1016,1930,26-09-2019 03:58:00,0,1598.0,1473.0,0.921,7.927,49,8,4,4,41,15,26,0,0.0,0.0
1016,1931,26-09-2019 04:00:00,0,1649.0,1393.0,0.845,8.04,64,1,0,1,63,37,26,0,0.0,0.0
1016,1932,26-09-2019 04:02:00,0,1530.0,1354.0,0.885,7.526,22,0,0,0,22,21,1,0,0.0,0.0
1016,1933,26-09-2019 04:04:00,0,1440.0,1261.0,0.876,7.071,524,4,1,3,520,483,37,0,0.0,0.0
1016,1934,26-09-2019 04:06:00,0,1424.0,1170.0,0.821,6.907,795,0,0,0,795,749,46,0,0.0,0.0
1016,1935,26-09-2019 04:08:00,0,1105.0,1098.0,0.993,5.57,503,10,3,7,493,450,43,0,0.0,0.0
1016,1936,26-09-2019 04:10:00,0,1281.0,1145.5,0.906,6.3155,559,0,0,0,559,521,38,0,0.0,0.0
1016,1937,26-09-2019 04:12:00,0,1457.0,1193.0,0.819,7.061,603,0,0,0,603,552,51,0,0.0,0.0
1016,1938,26-09-2019 04:14:00,0,1459.0,1155.0,0.791,7.028,147,7,3,4,140,128,12,0,0.0,0.0
1016,1939,26-09-2019 04:16:00,0,1354.0,1144.0,0.845,6.602,14,0,0,0,14,12,2,0,0.0,0.0
1016,1940,26-09-2019 04:18:00,0,1237.0,1114.0,0.901,6.107,0,0,0,0,0,0,0,0,0.0,0.0
1016,1941,26-09-2019 04:20:00,0,1232.0,1115.0,0.905,6.086,10,6,3,3,4,3,1,0,0.0,0.0
1016,1942,26-09-2019 04:22:00,0,1323.0,1136.0,0.858,6.471,2,0,0,0,2,0,2,0,0.0,0.0
1016,1943,26-09-2019 04:24:00,0,1339.0,1155.0,0.862,6.556,35,11,4,7,24,19,5,0,0.0,0.0
1016,1944,26-09-2019 04:26:00,0,1455.0,1199.0,0.824,7.061,20,5,2,3,15,4,11,0,0.01,0.0
1016,1945,26-09-2019 04:28:00,0,1434.0,1253.0,0.874,7.036,15,0,0,0,15,0,15,0,0.0,0.0
1016,1946,26-09-2019 04:30:00,0,1457.0,1232.0,0.846,7.104,61,9,5,4,52,19,33,0,0.0,0.0
1016,1947,26-09-2019 04:32:00,0,1426.0,1294.0,0.908,7.05,145,38,13,25,107,72,35,0,0.0,0.0
1016,1948,26-09-2019 04:34:00,0,1420.0,1225.0,0.863,6.952,118,18,7,11,100,91,9,0,0.0,0.0
1016,1949,26-09-2019 04:36:00,0,1443.0,1200.0,0.831,7.013,81,5,1,4,76,67,9,0,0.0,0.0
1016,1950,26-09-2019 04:38:00,0,1217.0,1113.0,0.914,6.026,89,7,2,5,82,75,7,0,0.0,0.0
1016,1951,26-09-2019 04:40:00,0,1233.0,1102.0,0.894,6.077,68,17,0,17,51,45,6,0,0.0,0.0
1016,1952,26-09-2019 04:42:00,0,1120.0,1091.0,0.974,5.622,100,28,0,28,72,62,10,0,0.0,0.0
1016,1953,26-09-2019 04:44:00,0,1377.5,1256.0,0.9215,6.818,100,13,0,13,87,80,7,0,0.0,0.0
1016,1954,26-09-2019 04:46:00,0,1635.0,1421.0,0.869,8.014,105,0,0,0,105,92,13,0,0.0,0.0
1016,1955,26-09-2019 04:48:00,0,1631.0,1381.0,0.847,7.953,64,0,0,0,64,58,6,0,0.0,0.0
1016,1956,26-09-2019 04:50:00,0,1629.0,1362.0,0.836,7.928,104,7,4,3,97,84,13,0,0.0,0.0
1016,1957,26-09-2019 04:52:00,0,1626.0,1378.0,0.847,7.934,82,1,0,1,81,57,24,0,0.0,0.0
1016,1958,26-09-2019 04:54:00,0,1597.0,1510.0,0.946,7.963,148,42,26,16,106,76,30,0,0.0,0.0
1016,1959,26-09-2019 04:56:00,0,1698.0,1547.0,0.911,8.403,207,36,18,18,171,130,41,9,0.0,0.0
1016,1960,26-09-2019 04:58:00,0,1899.0,1695.0,0.892,9.361,218,52,23,29,166,139,27,1,0.0,0.0
1016,1961,26-09-2019 05:00:00,0,2007.0,1815.0,0.904,9.917,373,171,126,45,202,158,44,47,0.0,0.0
1016,1962,26-09-2019 05:02:00,0,1923.0,1622.0,0.843,9.373,189,61,2,59,128,80,48,0,0.0,0.0
1016,1963,26-09-2019 05:04:00,0,1585.0,1512.0,0.954,7.918,138,45,3,42,93,44,49,0,0.0,0.0
1016,1964,26-09-2019 05:06:00,0,1807.0,1560.0,0.863,8.849,357,185,140,45,172,115,57,58,0.0,0.0
1016,1965,26-09-2019 05:08:00,0,1893.0,1687.0,0.891,9.328,237,92,62,30,145,102,43,35,0.0,0.02
1016,1966,26-09-2019 05:10:00,0,1936.0,1645.0,0.85,9.451,632,398,324,74,234,171,63,11,0.0,0.0
1016,1967,26-09-2019 05:12:00,0,1916.0,1684.0,0.879,9.413,265,135,98,37,130,85,45,81,0.0,0.0
1016,1968,26-09-2019 05:14:00,0,1918.0,1679.0,0.876,9.415,20,9,5,4,11,0,11,0,0.0,0.0
1016,1969,26-09-2019 05:16:00,0,1783.0,1578.0,0.885,8.774,77,54,24,30,23,2,21,8,0.0,0.0
1016,1970,26-09-2019 05:18:00,0,1912.5,1765.0,0.9205,9.491,104,46,30,16,58,0,58,38,0.0,0.03
1016,1971,26-09-2019 05:20:00,0,2042.0,1952.0,0.956,10.208,231,113,79,34,118,65,53,71,0.0,0.0
1016,1972,26-09-2019 05:22:00,0,1908.0,1719.0,0.901,9.42,257,79,52,27,178,119,59,5,0.18,0.0
1016,1973,26-09-2019 05:24:00,0,2101.0,1891.0,0.9,10.371,225,79,40,39,146,99,47,0,0.0,0.0
1016,1974,26-09-2019 05:26:00,0,2082.0,1861.0,0.894,10.262,186,34,13,21,152,104,48,0,0.0,0.0
1016,1975,26-09-2019 05:28:00,0,1904.0,1803.0,0.947,9.499,80,0,0,0,80,38,42,0,0.0,0.0
1016,1976,26-09-2019 05:30:00,0,1707.0,1532.0,0.897,8.423,57,0,0,0,57,11,46,0,0.0,0.0
1016,1977,26-09-2019 05:32:00,0,1631.0,1374.0,0.842,7.948,46,0,0,0,46,4,42,0,0.0,0.0
1016,1978,26-09-2019 05:34:00,0,1407.0,1262.0,0.897,6.94,66,9,6,3,57,18,39,0,0.0,0.0
1016,1979,26-09-2019 05:36:00,0,1431.0,1244.0,0.87,7.015,28,0,0,0,28,4,24,0,0.0,0.0
1016,1980,26-09-2019 05:38:00,0,1350.0,1154.0,0.855,6.596,36,7,3,4,29,8,21,0,0.0,0.0
1016,1981,26-09-2019 05:40:00,0,1136.0,1082.0,0.952,5.676,37,0,0,0,37,8,29,0,0.0,0.0
1016,1982,26-09-2019 05:42:00,0,1124.0,1064.0,0.947,5.606,38,1,0,1,37,8,29,0,0.0,0.0
1016,1983,26-09-2019 05:44:00,0,1244.0,1086.0,0.873,6.104,29,0,0,0,29,4,25,0,0.0,0.0
1016,1984,26-09-2019 05:46:00,0,1133.0,1038.0,0.916,5.613,40,1,0,1,39,11,28,0,0.0,0.0
1016,1985,26-09-2019 05:48:00,0,1132.0,1044.0,0.922,5.618,79,1,0,1,78,65,13,0,0.0,0.0
1016,1986,26-09-2019 05:50:00,0,1148.0,991.0,0.863,5.62,91,8,4,4,83,61,22,0,0.0,0.0
1016,1987,26-09-2019 05:52:00,0,1280.5,1158.0,0.9005,6.3275,41,0,0,0,41,22,19,0,0.0,0.0
1016,1988,26-09-2019 05:54:00,0,1413.0,1325.0,0.938,7.035,72,10,3,7,62,39,23,0,0.0,0.0
1016,1989,26-09-2019 05:56:00,0,1640.0,1368.0,0.834,7.975,60,8,3,5,52,42,10,0,0.0,0.0
1016,1990,26-09-2019 05:58:00,0,1521.0,1306.0,0.859,7.44,86,1,0,1,85,32,53,0,0.01,0.0
1016,1991,26-09-2019 06:00:00,1,1636.0,1342.0,0.821,7.931,47,0,0,0,47,22,25,0,0.0,0.0
1016,1992,26-09-2019 06:02:00,1,1636.0,1351.0,0.825,7.943,57,0,0,0,57,18,39,0,0.0,0.0
1016,1993,26-09-2019 06:04:00,1,1526.0,1319.0,0.864,7.475,66,0,0,0,66,23,43,0,0.0,0.0
1016,1994,26-09-2019 06:06:00,1,1630.0,1455.0,0.892,8.033,201,55,34,21,146,98,48,1,0.0,0.0
1016,1995,26-09-2019 06:08:00,1,1602.0,1479.0,0.924,7.949,321,28,10,18,293,227,66,0,0.0,0.0
1016,1996,26-09-2019 06:10:00,1,1712.0,1527.0,0.892,8.436,155,13,3,10,142,96,46,0,0.0,0.0
1016,1997,26-09-2019 06:12:00,1,1610.0,1420.0,0.882,7.914,174,34,13,21,140,96,44,0,0.0,0.0
1016,1998,26-09-2019 06:14:00,1,1625.0,1327.0,0.817,7.871,41,8,0,8,33,10,23,0,0.0,0.0
1016,1999,26-09-2019 06:16:00,1,1432.0,1291.0,0.901,7.071,161,12,2,10,149,120,29,0,0.0,0.0
1016,2000,26-09-2019 06:18:00,1,1434.0,1246.0,0.869,7.031,106,4,0,4,102,75,27,0,0.0,0.0
1016,2001,26-09-2019 06:20:00,1,1446.0,1231.0,0.851,7.062,47,3,3,0,44,33,11,0,0.0,0.0
1016,2002,26-09-2019 06:22:00,1,1433.0,1232.0,0.86,7.009,277,96,65,31,181,138,43,27,0.0,0.0
1016,2003,26-09-2019 06:24:00,1,1608.0,1435.0,0.892,7.922,192,114,69,45,78,14,64,61,0.0,0.0
1016,2004,26-09-2019 06:26:00,1,1865.5,1606.0,0.8645,9.1275,120,49,31,18,71,18,53,66,0.0,0.05
1016,2005,26-09-2019 06:28:00,1,2123.0,1777.0,0.837,10.333,126,48,24,24,78,26,52,54,0.0,0.06
1016,2006,26-09-2019 06:30:00,1,2206.0,1881.0,0.853,10.776,213,108,86,22,105,62,43,72,0.0,0.01
1016,2007,26-09-2019 06:32:00,1,1921.0,1634.0,0.851,9.378,386,137,101,36,249,210,39,46,0.0,0.01
1016,2008,26-09-2019 06:34:00,1,2012.0,1817.0,0.903,9.94,297,109,75,34,188,158,30,6,0.0,0.01
1016,2009,26-09-2019 06:36:00,1,1840.0,1539.0,0.836,8.954,403,140,95,45,263,199,64,27,0.0,0.0
1016,2010,26-09-2019 06:38:00,1,1801.0,1520.0,0.844,8.781,335,81,50,31,254,205,49,0,0.0,0.0
1016,2011,26-09-2019 06:40:00,1,1910.0,1607.0,0.842,9.304,764,228,174,54,536,466,70,22,0.0,0.0
1016,2012,26-09-2019 06:42:00,1,1929.0,1571.0,0.814,9.339,592,226,175,51,366,322,44,26,0.1,0.0
1016,2013,26-09-2019 06:44:00,1,1720.0,1523.0,0.885,8.463,511,45,27,18,466,386,80,5,0.01,0.0
1016,2014,26-09-2019 06:46:00,1,1844.0,1544.0,0.837,8.975,321,22,9,13,299,266,33,7,0.0,0.0
1016,2015,26-09-2019 06:48:00,1,1616.0,1425.0,0.882,7.943,439,48,13,35,391,346,45,0,0.0,0.0
1016,2016,26-09-2019 06:50:00,1,1622.0,1390.0,0.857,7.927,546,3,0,3,543,513,30,0,0.0,0.0
1016,2017,26-09-2019 06:52:00,1,1637.0,1344.0,0.821,7.937,35,0,0,0,35,2,33,0,0.0,0.0
1016,2018,26-09-2019 06:54:00,1,1434.0,1250.0,0.872,7.034,406,0,0,0,406,371,35,0,0.0,0.0
1016,2019,26-09-2019 06:56:00,1,1357.0,1103.0,0.813,6.57,960,0,0,0,960,909,51,0,0.02,0.0
1016,2020,26-09-2019 06:58:00,1,1150.0,960.0,0.835,5.595,564,1,0,1,563,528,35,0,0.0,0.0
1016,2021,26-09-2019 07:00:00,1,1306.5,1039.5,0.8,6.2985,9,0,0,0,9,0,9,0,0.0,0.0
1016,2022,26-09-2019 07:02:00,1,1463.0,1119.0,0.765,7.002,156,12,7,5,144,121,23,0,0.0,0.0
1016,2023,26-09-2019 07:04:00,1,1457.0,1157.0,0.794,7.022,0,0,0,0,0,0,0,0,0.0,0.0
1016,2024,26-09-2019 07:06:00,1,1361.0,1069.0,0.785,6.546,1,0,0,0,1,1,0,0,0.0,0.0
1016,2025,26-09-2019 07:08:00,1,1240.0,1069.0,0.862,6.068,0,0,0,0,0,0,0,0,0.0,0.0
1016,2026,26-09-2019 07:10:00,1,1342.0,1079.0,0.804,6.484,5,0,0,0,5,2,3,0,0.0,0.02
1016,2027,26-09-2019 07:12:00,1,1450.0,1159.0,0.8,6.996,28,0,0,0,28,0,28,0,0.0,0.0
1016,2028,26-09-2019 07:14:00,1,1246.0,1084.0,0.869,6.111,188,18,8,10,170,131,39,0,0.0,0.0
1016,2029,26-09-2019 07:16:00,1,1459.0,1136.0,0.778,7.007,156,17,13,4,139,125,14,0,0.0,0.0
1016,2030,26-09-2019 07:18:00,1,1139.0,1028.0,0.903,5.627,94,0,0,0,94,89,5,0,0.0,0.0
1016,2031,26-09-2019 07:20:00,1,1149.0,1041.0,0.906,5.68,554,9,6,3,545,495,50,0,0.0,0.0
1016,2032,26-09-2019 07:22:00,1,1472.0,1088.0,0.739,7.003,397,8,4,4,389,325,64,0,0.0,0.0
1016,2033,26-09-2019 07:24:00,1,1260.0,1032.0,0.819,6.106,898,0,0,0,898,815,83,0,0.0,0.0
1016,2034,26-09-2019 07:26:00,1,1152.0,989.0,0.859,5.633,1088,0,0,0,1088,1043,45,0,0.0,0.0
1016,2035,26-09-2019 07:28:00,1,1138.0,1008.0,0.885,5.601,1158,0,0,0,1158,1114,44,0,0.0,0.0
1016,2036,26-09-2019 07:30:00,1,1239.0,1034.0,0.835,6.026,2109,0,0,0,2109,2003,106,0,0.0,0.0
1016,2037,26-09-2019 07:32:00,1,1258.0,1035.0,0.823,6.102,1682,15,7,8,1667,1553,114,0,0.0,0.0
1016,2038,26-09-2019 07:34:00,1,1453.0,1182.5,0.815,7.0345,249,26,13,13,223,196,27,0,0.0,0.0
1016,2039,26-09-2019 07:36:00,1,1648.0,1330.0,0.807,7.967,355,40,7,33,315,272,43,0,0.0,0.0
1016,2040,26-09-2019 07:38:00,1,1626.0,1405.0,0.864,7.962,363,103,70,33,260,220,40,0,0.0,0.0
1016,2041,26-09-2019 07:40:00,1,1632.0,1287.0,0.789,7.856,301,31,3,28,270,226,44,0,0.0,0.0
1016,2042,26-09-2019 07:42:00,1,1542.0,1236.0,0.802,7.444,98,40,13,27,58,42,16,0,0.0,0.0
1016,2043,26-09-2019 07:44:00,1,1677.0,1294.0,0.772,8.041,733,4,2,2,729,683,46,0,0.0,0.0
1016,2044,26-09-2019 07:46:00,1,1452.0,1167.0,0.803,7.014,835,0,0,0,835,796,39,0,0.0,0.0
1016,2045,26-09-2019 07:48:00,1,1468.0,1088.0,0.741,6.99,541,6,2,4,535,494,41,0,0.0,0.0
1016,2046,26-09-2019 07:50:00,1,1461.0,1098.0,0.752,6.972,27,5,0,5,22,18,4,0,0.0,0.0
1016,2047,26-09-2019 07:52:00,1,1368.0,1028.0,0.751,6.529,45,1,0,1,44,38,6,0,0.0,0.0
1016,2048,26-09-2019 07:54:00,1,1365.0,1052.0,0.77,6.543,90,0,0,0,90,70,20,0,0.0,0.0
1016,2049,26-09-2019 07:56:00,1,1268.0,1007.0,0.795,6.11,100,11,6,5,89,52,37,0,0.0,0.0
1016,2050,26-09-2019 07:58:00,1,1471.0,1129.0,0.768,7.045,99,22,10,12,77,65,12,0,0.0,0.0
1016,2051,26-09-2019 08:00:00,1,1454.0,1156.0,0.795,7.01,0,0,0,0,0,0,0,0,0.0,0.0
1016,2052,26-09-2019 08:02:00,1,1468.0,1073.0,0.731,6.972,545,0,0,0,545,509,36,0,0.0,0.0
1016,2053,26-09-2019 08:04:00,1,1490.0,1063.0,0.714,7.049,448,0,0,0,448,426,22,0,0.0,0.0
1016,2054,26-09-2019 08:06:00,1,1488.0,1078.0,0.725,7.059,719,0,0,0,719,688,31,0,0.0,0.0
1016,2055,26-09-2019 08:08:00,1,1584.5,1139.0,0.7195,7.505,318,1,0,1,317,310,7,0,0.0,0.0
1016,2056,26-09-2019 08:10:00,1,1681.0,1200.0,0.714,7.951,21,0,0,0,21,18,3,0,0.0,0.0
1016,2057,26-09-2019 08:12:00,1,1684.0,1176.0,0.699,7.936,38,5,1,4,33,29,4,0,0.0,0.0
1016,2058,26-09-2019 08:14:00,1,1461.0,1135.0,0.777,7.015,370,15,9,6,355,310,45,0,0.02,0.0
1016,2059,26-09-2019 08:16:00,1,1561.0,1167.0,0.748,7.44,80,2,0,2,78,41,37,0,0.0,0.0
1016,2060,26-09-2019 08:18:00,1,1662.0,1228.0,0.739,7.907,0,0,0,0,0,0,0,0,0.0,0.0
1016,2061,26-09-2019 08:20:00,1,1585.0,1175.0,0.741,7.547,24,0,0,0,24,22,2,0,0.0,0.0
1016,2062,26-09-2019 08:22:00,1,1481.0,1076.0,0.727,7.028,58,0,0,0,58,46,12,0,0.01,0.0
1016,2063,26-09-2019 08:24:00,1,1472.0,1136.0,0.771,7.057,223,53,34,19,170,121,49,2,0.0,0.0
1016,2064,26-09-2019 08:26:00,1,1673.0,1210.0,0.723,7.931,96,10,3,7,86,73,13,0,0.0,0.0
1016,2065,26-09-2019 08:28:00,1,1676.0,1231.0,0.734,7.968,292,40,11,29,252,228,24,0,0.0,0.0
1016,2066,26-09-2019 08:30:00,1,1674.0,1242.0,0.742,7.971,572,63,33,30,509,471,38,0,0.0,0.0
1016,2067,26-09-2019 08:32:00,1,1666.0,1262.0,0.758,7.96,639,34,14,20,605,555,50,0,0.0,0.0
1016,2068,26-09-2019 08:34:00,1,1644.0,1271.0,0.773,7.886,326,17,5,12,309,286,23,0,0.0,0.0
1016,2069,26-09-2019 08:36:00,1,1635.0,1312.0,0.802,7.895,496,69,40,29,427,345,82,11,0.0,0.0
1016,2070,26-09-2019 08:38:00,1,1643.0,1434.0,0.873,8.061,349,122,95,27,227,194,33,35,0.0,0.0
1016,2071,26-09-2019 08:40:00,1,1654.0,1354.0,0.819,8.017,615,254,184,70,361,313,48,42,0.0,0.0
1016,2072,26-09-2019 08:42:00,1,1792.0,1399.5,0.784,8.61,124,46,37,9,78,40,38,11,0.0,0.0
1016,2073,26-09-2019 08:44:00,1,1930.0,1445.0,0.749,9.203,363,146,102,44,217,155,62,0,0.0,0.0
1016,2074,26-09-2019 08:46:00,1,1870.0,1361.0,0.728,8.873,701,333,258,75,368,287,81,23,0.0,0.0
1016,2075,26-09-2019 08:48:00,1,1878.0,1420.0,0.756,8.97,643,201,148,53,442,363,79,50,0.0,0.0
1016,2076,26-09-2019 08:50:00,1,1659.0,1306.0,0.788,7.982,440,108,73,35,332,256,76,0,0.0,0.0
1016,2077,26-09-2019 08:52:00,1,1649.0,1239.0,0.751,7.87,368,153,118,35,215,158,57,1,0.0,0.0
1016,2078,26-09-2019 08:54:00,1,1668.0,1247.0,0.748,7.951,357,70,54,16,287,216,71,17,0.0,0.0
1016,2079,26-09-2019 08:56:00,1,1680.0,1241.0,0.739,7.993,886,386,304,82,500,421,79,17,0.0,0.0
1016,2080,26-09-2019 08:58:00,1,1668.0,1318.0,0.79,8.033,300,160,113,47,140,108,32,7,0.0,0.0
1016,2081,26-09-2019 09:00:00,1,1679.0,1185.0,0.706,7.926,641,282,224,58,359,300,59,7,0.0,0.0
1016,2082,26-09-2019 09:02:00,1,1559.0,1147.0,0.736,7.412,664,54,33,21,610,553,57,1,0.0,0.0
1016,2083,26-09-2019 09:04:00,1,1456.0,1141.0,0.783,7.0,184,23,0,23,161,126,35,0,0.0,0.0
1016,2084,26-09-2019 09:06:00,1,1491.0,1029.0,0.69,7.012,148,12,0,12,136,119,17,0,0.0,0.0
1016,2085,26-09-2019 09:08:00,1,1157.0,907.0,0.783,5.563,560,8,0,8,552,507,45,0,0.0,0.0
1016,2086,26-09-2019 09:10:00,1,1193.0,799.0,0.67,5.584,420,0,0,0,420,342,78,0,0.0,0.0
1016,2087,26-09-2019 09:12:00,1,1199.0,778.0,0.649,5.586,1092,14,0,14,1078,992,86,0,0.0,0.0
1016,2088,26-09-2019 09:14:00,1,1196.0,831.0,0.695,5.631,402,3,0,3,399,350,49,0,0.0,0.0
1016,2089,26-09-2019 09:16:00,1,1350.5,922.5,0.6845,6.342,626,2,0,2,624,557,67,0,0.0,0.0
1016,2090,26-09-2019 09:18:00,1,1505.0,1014.0,0.674,7.053,906,1,0,1,905,833,72,0,0.0,0.0
1016,2091,26-09-2019 09:20:00,1,1500.0,982.0,0.655,6.996,496,5,0,5,491,441,50,0,0.0,0.0
1016,2092,26-09-2019 09:22:00,1,1385.0,955.0,0.689,6.512,547,2,0,2,545,497,48,0,0.0,0.0
1016,2093,26-09-2019 09:24:00,1,1272.0,937.0,0.737,6.049,68,4,1,3,64,54,10,0,0.0,0.0
1016,2094,26-09-2019 09:26:00,1,1374.0,979.0,0.712,6.497,26,0,0,0,26,9,17,0,0.0,0.0
1016,2095,26-09-2019 09:28:00,1,1394.0,992.0,0.712,6.592,102,4,2,2,98,55,43,0,0.0,0.0
1016,2096,26-09-2019 09:30:00,1,1388.0,1007.0,0.726,6.583,73,0,0,0,73,62,11,0,0.0,0.0
1016,2097,26-09-2019 09:32:00,1,1383.0,989.0,0.715,6.543,19,1,0,1,18,15,3,0,0.0,0.0
1016,2098,26-09-2019 09:34:00,1,1159.0,901.0,0.778,5.564,20,0,0,0,20,17,3,0,0.0,0.0
1016,2099,26-09-2019 09:36:00,1,1174.0,880.0,0.749,5.601,38,21,0,21,17,16,1,0,0.0,0.0
1016,2100,26-09-2019 09:38:00,1,1182.0,889.0,0.752,5.644,36,13,2,11,23,19,4,0,0.0,0.0
1016,2101,26-09-2019 09:40:00,1,1516.0,974.0,0.643,7.051,28,1,0,1,27,22,5,0,0.0,0.0
1016,2102,26-09-2019 09:42:00,1,1393.0,950.0,0.682,6.54,555,2,0,2,553,520,33,0,0.0,0.0
1016,2103,26-09-2019 09:44:00,1,1270.0,924.0,0.728,6.027,342,13,7,6,329,298,31,0,0.0,0.0
1016,2104,26-09-2019 09:46:00,1,1507.0,1001.0,0.665,7.046,8,0,0,0,8,7,1,0,0.0,0.0
1016,2105,26-09-2019 09:48:00,1,1384.0,963.0,0.696,6.52,23,3,0,3,20,9,11,0,0.0,0.0
1016,2106,26-09-2019 09:50:00,1,1436.0,974.5,0.6795,6.737,10,0,0,0,10,4,6,0,0.0,0.0
1016,2107,26-09-2019 09:52:00,1,1488.0,986.0,0.663,6.954,69,4,1,3,65,33,32,0,0.0,0.0
1016,2108,26-09-2019 09:54:00,1,1490.0,969.0,0.65,6.945,43,24,0,24,19,9,10,0,0.0,0.0
1016,2109,26-09-2019 09:56:00,1,1178.0,842.0,0.715,5.572,67,35,0,35,32,16,16,0,0.0,0.0
1016,2110,26-09-2019 09:58:00,1,1178.0,895.0,0.759,5.634,18,0,0,0,18,17,1,0,0.0,0.0
1016,2111,26-09-2019 10:00:00,1,1174.0,905.0,0.77,5.629,147,12,7,5,135,124,11,0,0.0,0.0
1016,2112,26-09-2019 10:02:00,1,1511.0,990.0,0.655,7.05,34,0,0,0,34,32,2,0,0.0,0.0
1016,2113,26-09-2019 10:04:00,1,1373.0,959.0,0.699,6.47,72,0,0,0,72,64,8,0,0.0,0.0
1016,2114,26-09-2019 10:06:00,1,1379.0,961.0,0.697,6.497,12,0,0,0,12,2,10,0,0.0,0.0
1016,2115,26-09-2019 10:08:00,1,1505.0,989.0,0.657,7.025,77,5,2,3,72,42,30,0,0.0,0.0
1016,2116,26-09-2019 10:10:00,1,1403.0,979.0,0.698,6.612,143,3,1,2,140,108,32,0,0.0,0.0
1016,2117,26-09-2019 10:12:00,1,1402.0,955.0,0.681,6.58,175,0,0,0,175,155,20,0,0.0,0.0
1016,2118,26-09-2019 10:14:00,1,1172.0,888.0,0.758,5.601,66,1,0,1,65,58,7,0,0.0,0.0
1016,2119,26-09-2019 10:16:00,1,1169.0,854.0,0.73,5.553,485,3,0,3,482,438,44,0,0.0,0.0
1016,2120,26-09-2019 10:18:00,1,1186.0,855.0,0.721,5.619,294,1,0,1,293,244,49,0,0.0,0.0
1016,2121,26-09-2019 10:20:00,1,1187.0,842.0,0.709,5.611,213,0,0,0,213,159,54,0,0.0,0.0
1016,2122,26-09-2019 10:22:00,1,1190.0,845.0,0.71,5.624,92,0,0,0,92,80,12,0,0.0,0.0
1016,2123,26-09-2019 10:24:00,1,1344.5,899.0,0.673,6.292,59,0,0,0,59,52,7,0,0.0,0.0
1016,2124,26-09-2019 10:26:00,1,1499.0,953.0,0.636,6.96,262,8,3,5,254,214,40,0,0.0,0.0
1016,2125,26-09-2019 10:28:00,1,1403.0,963.0,0.686,6.595,375,0,0,0,375,333,42,0,0.0,0.0
1016,2126,26-09-2019 10:30:00,1,1390.0,941.0,0.677,6.519,222,9,4,5,213,194,19,0,0.0,0.0
1016,2127,26-09-2019 10:32:00,1,1398.0,948.0,0.678,6.56,54,9,1,8,45,35,10,0,0.0,0.0
1016,2128,26-09-2019 10:34:00,1,1286.0,896.0,0.697,6.057,37,7,1,6,30,27,3,0,0.0,0.0
1016,2129,26-09-2019 10:36:00,1,1175.0,879.0,0.748,5.604,52,0,0,0,52,19,33,0,0.0,0.0
1016,2130,26-09-2019 10:38:00,1,1183.0,833.0,0.704,5.581,45,0,0,0,45,17,28,0,0.0,0.0
1016,2131,26-09-2019 10:40:00,1,1200.0,779.0,0.649,5.593,24,2,1,1,22,20,2,0,0.0,0.0
1016,2132,26-09-2019 10:42:00,1,1213.0,740.0,0.61,5.6,98,13,7,6,85,74,11,0,0.0,0.0
1016,2133,26-09-2019 10:44:00,1,1177.0,888.0,0.755,5.62,89,8,3,5,81,71,10,0,0.0,0.0
1016,2134,26-09-2019 10:46:00,1,1498.0,1055.0,0.704,7.071,325,17,4,13,308,259,49,1,0.0,0.0
1016,2135,26-09-2019 10:48:00,1,1679.0,1241.0,0.739,7.99,193,57,35,22,136,85,51,20,0.0,0.0
1016,2136,26-09-2019 10:50:00,1,1614.0,1300.0,0.805,7.8,37,16,11,5,21,4,17,16,0.0,0.0
1016,2137,26-09-2019 10:52:00,1,1968.0,1411.0,0.717,9.316,341,115,84,31,226,159,67,73,0.0,0.0
1016,2138,26-09-2019 10:54:00,1,1667.0,1263.0,0.758,7.965,456,196,153,43,260,200,60,99,0.0,0.0
1016,2139,26-09-2019 10:56:00,1,1661.0,1337.0,0.805,8.024,492,208,158,50,284,211,73,17,0.02,0.0
1016,2140,26-09-2019 10:58:00,1,1824.0,1368.0,0.7545,8.701,391,222,173,49,169,120,49,12,0.0,0.04
1016,2141,26-09-2019 11:00:00,1,1987.0,1399.0,0.704,9.378,410,170,126,44,240,168,72,4,0.02,0.07
1016,2142,26-09-2019 11:02:00,1,1863.0,1352.0,0.726,8.836,619,188,139,49,431,339,92,4,0.0,0.0
1016,2143,26-09-2019 11:04:00,1,1660.0,1197.0,0.722,7.865,279,162,122,40,117,77,40,7,0.0,0.0
1016,2144,26-09-2019 11:06:00,1,1643.0,1313.0,0.799,7.928,762,382,303,79,380,299,81,6,0.0,0.0
1016,2145,26-09-2019 11:08:00,1,1667.0,1239.0,0.743,7.94,91,58,30,28,33,9,24,0,0.0,0.0
1016,2146,26-09-2019 11:10:00,1,1479.0,1090.0,0.737,7.032,151,79,52,27,72,46,26,0,0.0,0.0
1016,2147,26-09-2019 11:12:00,1,1683.0,1205.0,0.716,7.964,411,182,130,52,229,165,64,19,0.0,0.0
1016,2148,26-09-2019 11:14:00,1,1481.0,1138.0,0.768,7.093,460,36,22,14,424,349,75,1,0.0,0.0
1016,2149,26-09-2019 11:16:00,1,1676.0,1198.0,0.715,7.93,586,13,4,9,573,454,119,0,0.0,0.0
1016,2150,26-09-2019 11:18:00,1,1671.0,1194.0,0.714,7.905,436,20,9,11,416,334,82,1,0.0,0.0
1016,2151,26-09-2019 11:20:00,1,1658.0,1247.0,0.752,7.914,642,18,2,16,624,531,93,0,0.0,0.0
1016,2152,26-09-2019 11:22:00,1,1663.0,1238.0,0.744,7.924,454,23,3,20,431,343,88,0,0.0,0.0
1016,2153,26-09-2019 11:24:00,1,1561.0,1225.0,0.785,7.505,297,6,3,3,291,219,72,0,0.0,0.0
1016,2154,26-09-2019 11:26:00,1,1474.0,1089.0,0.739,7.014,220,8,4,4,212,162,50,0,0.0,0.0
1016,2155,26-09-2019 11:28:00,1,1277.0,988.0,0.773,6.124,222,0,0,0,222,160,62,0,0.0,0.0
1016,2156,26-09-2019 11:30:00,1,1168.0,915.0,0.783,5.613,342,2,0,2,340,285,55,0,0.0,0.0
1016,2157,26-09-2019 11:32:00,1,1279.5,952.5,0.7475,6.0955,112,0,0,0,112,80,32,0,0.0,0.0
1016,2158,26-09-2019 11:34:00,1,1391.0,990.0,0.712,6.578,222,9,4,5,213,146,67,0,0.0,0.0
1016,2159,26-09-2019 11:36:00,1,1497.0,1023.0,0.684,7.03,270,0,0,0,270,205,65,0,0.0,0.0
1016,2160,26-09-2019 11:38:00,1,1488.0,1047.0,0.704,7.021,95,0,0,0,95,86,9,0,0.0,0.0
1016,2161,26-09-2019 11:40:00,1,1474.0,1066.0,0.723,6.989,76,0,0,0,76,67,9,0,0.0,0.0
1016,2162,26-09-2019 11:42:00,1,1499.0,1014.0,0.677,7.028,98,2,0,2,96,87,9,0,0.0,0.0
1016,2163,26-09-2019 11:44:00,1,1498.0,971.0,0.648,6.977,258,2,1,1,256,222,34,0,0.0,0.0
1016,2164,26-09-2019 11:46:00,1,1500.0,991.0,0.66,7.007,335,10,5,5,325,287,38,0,0.0,0.0
1016,2165,26-09-2019 11:48:00,1,1502.0,965.0,0.642,6.988,334,0,0,0,334,307,27,0,0.0,0.0
1016,2166,26-09-2019 11:50:00,1,1519.0,971.0,0.639,7.059,298,0,0,0,298,269,29,0,0.0,0.0
1016,2167,26-09-2019 11:52:00,1,1505.0,983.0,0.653,7.016,84,5,4,1,79,43,36,0,0.0,0.0
1016,2168,26-09-2019 11:54:00,1,1177.0,910.0,0.773,5.643,79,0,0,0,79,42,37,0,0.0,0.0
1016,2169,26-09-2019 11:56:00,1,1154.0,871.0,0.755,5.513,73,6,2,4,67,48,19,0,0.0,0.0
1016,2170,26-09-2019 11:58:00,1,1384.0,938.0,0.678,6.493,968,13,8,5,955,918,37,0,0.0,0.0
1016,2171,26-09-2019 12:00:00,1,1471.0,1011.0,0.687,6.917,813,7,4,3,806,763,43,0,0.0,0.0
1016,2172,26-09-2019 12:02:00,1,1187.0,891.0,0.751,5.663,500,2,1,1,498,462,36,0,0.0,0.0
1016,2173,26-09-2019 12:04:00,1,1291.0,924.0,0.716,6.11,31,0,0,0,31,26,5,0,0.0,0.0
1016,2174,26-09-2019 12:06:00,1,1394.0,954.0,0.6865,6.549,76,0,0,0,76,68,8,0,0.0,0.0
1016,2175,26-09-2019 12:08:00,1,1497.0,984.0,0.657,6.988,479,12,7,5,467,404,63,0,0.0,0.0
1016,2176,26-09-2019 12:10:00,1,1375.0,942.0,0.685,6.461,289,0,0,0,289,220,69,0,0.0,0.0
1016,2177,26-09-2019 12:12:00,1,1150.0,912.0,0.793,5.542,445,7,2,5,438,365,73,0,0.0,0.0
1016,2178,26-09-2019 12:14:00,1,1160.0,959.0,0.827,5.63,72,6,0,6,66,48,18,0,0.0,0.0
1016,2179,26-09-2019 12:16:00,1,1489.0,1028.0,0.69,7.007,40,0,0,0,40,15,25,0,0.0,0.0
1016,2180,26-09-2019 12:18:00,1,1502.0,1026.0,0.683,7.052,81,25,7,18,56,35,21,0,0.0,0.0
1016,2181,26-09-2019 12:20:00,1,1383.0,979.0,0.708,6.535,88,0,0,0,88,49,39,0,0.0,0.0
1016,2182,26-09-2019 12:22:00,1,1166.0,901.0,0.773,5.591,45,1,0,1,44,36,8,0,0.0,0.0
1016,2183,26-09-2019 12:24:00,1,1177.0,847.0,0.719,5.576,6,3,0,3,3,2,1,0,0.0,0.0
1016,2184,26-09-2019 12:26:00,1,1185.0,826.0,0.697,5.585,889,0,0,0,889,844,45,0,0.0,0.0
1016,2185,26-09-2019 12:28:00,1,1177.0,877.0,0.745,5.61,717,21,11,10,696,655,41,0,0.0,0.0
1016,2186,26-09-2019 12:30:00,1,1172.0,908.0,0.775,5.622,742,12,3,9,730,684,46,0,0.0,0.0
1016,2187,26-09-2019 12:32:00,1,1178.0,908.0,0.77,5.647,599,4,2,2,595,545,50,0,0.0,0.0
1016,2188,26-09-2019 12:34:00,1,1269.0,960.0,0.756,6.063,588,0,0,0,588,521,67,0,0.0,0.0
1016,2189,26-09-2019 12:36:00,1,1500.0,1007.0,0.672,7.023,112,0,0,0,112,90,22,0,0.0,0.0
1016,2190,26-09-2019 12:38:00,1,1170.0,940.0,0.804,5.65,103,4,3,1,99,57,42,0,0.0,0.0
1016,2191,26-09-2019 12:40:00,1,1325.0,995.0,0.7565,6.321,32,2,1,1,30,5,25,0,0.0,0.0
1016,2192,26-09-2019 12:42:00,1,1480.0,1050.0,0.709,6.992,112,1,1,0,111,107,4,0,0.0,0.0
1016,2193,26-09-2019 12:44:00,1,1495.0,1017.0,0.68,7.015,310,0,0,0,310,285,25,0,0.0,0.0
1016,2194,26-09-2019 12:46:00,1,1390.0,972.0,0.699,6.552,822,1,0,1,821,777,44,0,0.0,0.0
1016,2195,26-09-2019 12:48:00,1,1404.0,952.0,0.678,6.586,302,1,0,1,301,284,17,0,0.0,0.0
1016,2196,26-09-2019 12:50:00,1,1286.0,933.0,0.726,6.099,459,5,0,5,454,421,33,0,0.0,0.0
1016,2197,26-09-2019 12:52:00,1,1162.0,887.0,0.763,5.562,35,4,0,4,31,26,5,0,0.0,0.0
1016,2198,26-09-2019 12:54:00,1,1271.0,917.0,0.721,6.025,63,4,0,4,59,30,29,0,0.01,0.0
1016,2199,26-09-2019 12:56:00,1,1297.0,941.0,0.725,6.152,375,32,15,17,343,270,73,0,0.0,0.0
1016,2200,26-09-2019 12:58:00,1,1501.0,1019.0,0.679,7.041,191,36,12,24,155,126,29,0,0.0,0.0
1016,2201,26-09-2019 13:00:00,1,1490.0,1035.0,0.694,7.016,243,28,1,27,215,196,19,0,0.0,0.0
1016,2202,26-09-2019 13:02:00,1,1471.0,1078.0,0.733,6.991,153,39,3,36,114,98,16,0,0.0,0.0
1016,2203,26-09-2019 13:04:00,1,1672.0,1216.0,0.727,7.936,351,71,44,27,280,211,69,0,0.0,0.0
1016,2204,26-09-2019 13:06:00,1,1545.0,1188.0,0.769,7.403,310,30,3,27,280,220,60,0,0.0,0.0
1016,2205,26-09-2019 13:08:00,1,1560.0,1207.0,0.774,7.481,647,38,12,26,609,548,61,0,0.0,0.0
1016,2206,26-09-2019 13:10:00,1,1559.0,1197.0,0.767,7.468,671,35,10,25,636,575,61,0,0.0,0.0
1016,2207,26-09-2019 13:12:00,1,1474.0,1083.0,0.735,7.008,227,11,3,8,216,168,48,0,0.0,0.0
1016,2208,26-09-2019 13:14:00,1,1488.5,1069.5,0.7185,7.0505,48,4,1,3,44,19,25,0,0.0,0.0
1016,2209,26-09-2019 13:16:00,1,1503.0,1056.0,0.702,7.093,82,6,1,5,76,41,35,0,0.0,0.0
1016,2210,26-09-2019 13:18:00,1,1503.0,1013.0,0.674,7.046,5,0,0,0,5,4,1,0,0.0,0.0
1016,2211,26-09-2019 13:20:00,1,1481.0,987.0,0.667,6.929,4,0,0,0,4,3,1,0,0.0,0.0
1016,2212,26-09-2019 13:22:00,1,1479.0,977.0,0.661,6.908,4,0,0,0,4,4,0,0,0.0,0.0
1016,2213,26-09-2019 13:24:00,1,1498.0,974.0,0.65,6.981,14,3,0,3,11,10,1,0,0.0,0.0
1016,2214,26-09-2019 13:26:00,1,1501.0,1004.0,0.669,7.026,113,12,5,7,101,90,11,0,0.0,0.0
1016,2215,26-09-2019 13:28:00,1,1509.0,986.0,0.653,7.037,188,0,0,0,188,173,15,0,0.0,0.0
1016,2216,26-09-2019 13:30:00,1,1505.0,982.0,0.653,7.016,90,0,0,0,90,84,6,0,0.0,0.0
1016,2217,26-09-2019 13:32:00,1,1504.0,974.0,0.648,7.003,109,2,0,2,107,88,19,0,0.0,0.0
1016,2218,26-09-2019 13:34:00,1,1380.0,953.0,0.69,6.494,25,3,1,2,22,20,2,0,0.0,0.0
1016,2219,26-09-2019 13:36:00,1,1267.0,929.0,0.734,6.02,17,5,2,3,12,9,3,0,0.0,0.0
1016,2220,26-09-2019 13:38:00,1,1391.0,954.0,0.686,6.536,17,1,1,0,16,0,16,0,0.0,0.0
1016,2221,26-09-2019 13:40:00,1,1497.0,1007.0,0.673,7.013,37,3,2,1,34,20,14,0,0.0,0.0
1016,2222,26-09-2019 13:42:00,1,1505.0,974.0,0.648,7.007,39,0,0,0,39,4,35,0,0.0,0.0
1016,2223,26-09-2019 13:44:00,1,1393.0,956.0,0.686,6.547,134,18,6,12,116,98,18,0,0.0,0.0
1016,2224,26-09-2019 13:46:00,1,1285.0,934.0,0.727,6.097,18,2,0,2,16,14,2,0,0.0,0.0
1016,2225,26-09-2019 13:48:00,1,1379.5,993.0,0.7205,6.5355,124,3,2,1,121,106,15,0,0.0,0.0
1016,2226,26-09-2019 13:50:00,1,1474.0,1052.0,0.714,6.974,315,48,31,17,267,226,41,0,0.0,0.0
1016,2227,26-09-2019 13:52:00,1,1461.0,1068.0,0.731,6.94,67,25,15,10,42,17,25,8,0.0,0.0
1016,2228,26-09-2019 13:54:00,1,1705.0,1152.0,0.676,7.992,84,29,17,12,55,3,52,47,0.0,0.0
1016,2229,26-09-2019 13:56:00,1,1673.0,1257.0,0.751,7.983,58,9,5,4,49,0,49,46,0.0,0.0
1016,2230,26-09-2019 13:58:00,1,1881.0,1356.0,0.721,8.911,131,65,41,24,66,16,50,37,0.0,0.0
1016,2231,26-09-2019 14:00:00,1,1693.0,1178.0,0.696,7.973,249,85,63,22,164,136,28,47,0.0,0.0
1016,2232,26-09-2019 14:02:00,1,1636.0,1300.0,0.795,7.886,58,9,5,4,49,0,49,37,0.0,0.0
1016,2233,26-09-2019 14:04:00,1,1857.0,1358.0,0.731,8.821,69,20,12,8,49,0,49,59,0.0,0.04
1016,2234,26-09-2019 14:06:00,1,1849.0,1398.0,0.756,8.833,199,64,41,23,135,73,62,43,0.09,0.03
1016,2235,26-09-2019 14:08:00,1,1369.0,1067.0,0.78,6.575,787,367,290,77,420,334,86,7,0.03,0.03
1016,2236,26-09-2019 14:10:00,1,1565.0,1226.0,0.783,7.526,393,100,67,33,293,231,62,1,0.0,0.0
1016,2237,26-09-2019 14:12:00,1,1481.0,1092.0,0.738,7.045,318,207,148,59,111,67,44,0,0.0,0.0
1016,2238,26-09-2019 14:14:00,1,1660.0,1264.0,0.761,7.941,585,217,174,43,368,294,74,0,0.04,0.0
1016,2239,26-09-2019 14:16:00,1,1538.0,1261.0,0.82,7.457,363,179,114,65,184,145,39,1,0.0,0.0
1016,2240,26-09-2019 14:18:00,1,1432.0,1185.0,0.828,6.956,266,20,4,16,246,198,48,2,0.0,0.0
1016,2241,26-09-2019 14:20:00,1,1614.0,1396.0,0.865,7.905,597,80,40,40,517,431,86,1,0.01,0.0
1016,2242,26-09-2019 14:22:00,1,1724.0,1469.0,0.853,8.4195,646,30,6,24,616,516,100,0,0.01,0.0
1016,2243,26-09-2019 14:24:00,1,1834.0,1542.0,0.841,8.934,313,4,0,4,309,280,29,0,0.0,0.0
1016,2244,26-09-2019 14:26:00,1,1632.0,1397.0,0.856,7.977,22,0,0,0,22,0,22,0,0.0,0.0
1016,2245,26-09-2019 14:28:00,1,1420.0,1271.0,0.895,7.002,117,3,1,2,114,77,37,0,0.0,0.0
1016,2246,26-09-2019 14:30:00,1,1522.0,1287.0,0.846,7.422,355,0,0,0,355,309,46,0,0.0,0.0
1016,2247,26-09-2019 14:32:00,1,1545.0,1280.0,0.828,7.506,218,7,1,6,211,180,31,0,0.0,0.0
1016,2248,26-09-2019 14:34:00,1,1442.0,1295.0,0.898,7.114,85,3,0,3,82,38,44,0,0.01,0.01
1016,2249,26-09-2019 14:36:00,1,1429.0,1244.0,0.87,7.007,42,0,0,0,42,0,42,0,0.0,0.0
1016,2250,26-09-2019 14:38:00,1,1654.0,1314.0,0.794,7.971,61,3,1,2,58,45,13,0,0.0,0.0
1016,2251,26-09-2019 14:40:00,1,1638.0,1304.0,0.796,7.9,8,1,0,1,7,3,4,0,0.0,0.0
1016,2252,26-09-2019 14:42:00,1,1542.0,1269.0,0.823,7.481,15,0,0,0,15,6,9,0,0.0,0.0
1016,2253,26-09-2019 14:44:00,1,1453.0,1179.0,0.812,7.029,114,7,4,3,107,90,17,0,0.0,0.0
1016,2254,26-09-2019 14:46:00,1,1471.0,1129.0,0.768,7.046,67,9,0,9,58,47,11,0,0.0,0.0
1016,2255,26-09-2019 14:48:00,1,1357.0,1089.0,0.803,6.552,68,13,0,13,55,30,25,0,0.0,0.0
1016,2256,26-09-2019 14:50:00,1,1470.0,1101.0,0.749,7.011,22,16,0,16,6,3,3,0,0.0,0.0
1016,2257,26-09-2019 14:52:00,1,1464.0,1096.0,0.749,6.981,5,0,0,0,5,1,4,0,0.0,0.0
1016,2258,26-09-2019 14:54:00,1,1368.0,1081.0,0.79,6.585,72,9,3,6,63,48,15,0,0.0,0.0
1016,2259,26-09-2019 14:56:00,1,1461.5,1166.5,0.7975,7.0495,0,0,0,0,0,0,0,0,0.0,0.0
1016,2260,26-09-2019 14:58:00,1,1555.0,1252.0,0.805,7.514,64,6,3,3,58,23,35,0,0.0,0.0
1016,2261,26-09-2019 15:00:00,1,1450.0,1192.0,0.821,7.034,166,30,3,27,136,89,47,0,0.0,0.0
1016,2262,26-09-2019 15:02:00,1,1444.0,1202.0,0.833,7.019,236,9,4,5,227,183,44,0,0.0,0.0
1016,2263,26-09-2019 15:04:00,1,1434.0,1197.0,0.834,6.975,942,0,0,0,942,846,96,0,0.0,0.0
1016,2264,26-09-2019 15:06:00,1,1461.0,1135.0,0.777,7.012,697,9,3,6,688,616,72,0,0.0,0.0
1016,2265,26-09-2019 15:08:00,1,1471.0,1110.0,0.754,7.026,263,11,6,5,252,197,55,0,0.0,0.0
1016,2266,26-09-2019 15:10:00,1,1259.0,1036.0,0.823,6.107,54,1,0,1,53,7,46,0,0.0,0.0
1016,2267,26-09-2019 15:12:00,1,1259.0,1036.0,0.823,6.109,51,0,0,0,51,8,43,0,0.0,0.0
1016,2268,26-09-2019 15:14:00,1,1363.0,1078.0,0.791,6.565,39,3,2,1,36,5,31,0,0.0,0.0
1016,2269,26-09-2019 15:16:00,1,1348.0,1076.0,0.798,6.501,2,1,0,1,1,0,1,0,0.0,0.0
1016,2270,26-09-2019 15:18:00,1,1233.0,1027.0,0.832,5.997,29,7,2,5,22,16,6,0,0.0,0.0
1016,2271,26-09-2019 15:20:00,1,1365.0,1079.0,0.791,6.571,23,6,1,5,17,12,5,0,0.0,0.0
1016,2272,26-09-2019 15:22:00,1,1261.0,1056.0,0.837,6.138,110,10,2,8,100,67,33,0,0.0,0.0
1016,2273,26-09-2019 15:24:00,1,1145.0,1036.0,0.905,5.657,56,0,0,0,56,28,28,0,0.0,0.0
1016,2274,26-09-2019 15:26:00,1,1152.0,999.0,0.867,5.646,56,2,0,2,54,22,32,0,0.0,0.0
1016,2275,26-09-2019 15:28:00,1,1153.0,944.0,0.819,5.589,62,2,0,2,60,14,46,0,0.0,0.0
1016,2276,26-09-2019 15:30:00,1,1306.5,1043.0,0.8005,6.3035,51,0,0,0,51,11,40,0,0.02,0.0
1016,2277,26-09-2019 15:32:00,1,1460.0,1142.0,0.782,7.018,39,0,0,0,39,0,39,0,0.0,0.0
1016,2278,26-09-2019 15:34:00,1,1463.0,1142.0,0.78,7.03,104,14,4,10,90,58,32,0,0.0,0.0
1016,2279,26-09-2019 15:36:00,1,1467.0,1161.0,0.791,7.064,79,3,1,2,76,27,49,0,0.0,0.0
1016,2280,26-09-2019 15:38:00,1,1462.0,1169.0,0.8,7.055,67,0,0,0,67,26,41,0,0.0,0.0
1016,2281,26-09-2019 15:40:00,1,1552.0,1227.0,0.791,7.472,349,58,24,34,291,215,76,0,0.0,0.0
1016,2282,26-09-2019 15:42:00,1,1549.0,1235.0,0.797,7.469,214,33,2,31,181,136,45,0,0.0,0.0
1016,2283,26-09-2019 15:44:00,1,1433.0,1221.0,0.852,6.997,136,40,10,30,96,63,33,0,0.0,0.0
1016,2284,26-09-2019 15:46:00,1,1551.0,1264.0,0.815,7.509,152,65,28,37,87,42,45,22,0.0,0.0
1016,2285,26-09-2019 15:48:00,1,1649.0,1321.0,0.801,7.96,67,19,7,12,48,0,48,48,0.0,0.0
1016,2286,26-09-2019 15:50:00,1,1961.0,1532.0,0.781,9.423,78,23,15,8,55,0,55,50,0.0,0.07
1016,2287,26-09-2019 15:52:00,1,1852.0,1500.0,0.81,8.956,77,28,15,13,49,0,49,42,0.0,0.0
1016,2288,26-09-2019 15:54:00,1,1942.0,1528.0,0.787,9.343,412,113,91,22,299,217,82,35,0.03,0.03
1016,2289,26-09-2019 15:56:00,1,1648.0,1273.0,0.773,7.905,533,39,13,26,494,413,81,2,0.02,0.0
1016,2290,26-09-2019 15:58:00,1,1463.0,1119.0,0.765,7.002,455,166,131,35,289,212,77,18,0.02,0.03
1016,2291,26-09-2019 16:00:00,1,1653.0,1328.0,0.803,7.982,217,22,12,10,195,142,53,0,0.0,0.0
1016,2292,26-09-2019 16:02:00,1,1151.0,991.0,0.861,5.633,211,7,1,6,204,162,42,0,0.0,0.0
1016,2293,26-09-2019 16:04:00,1,1306.5,1054.5,0.813,6.3165,42,1,0,1,41,19,22,0,0.0,0.0
1016,2294,26-09-2019 16:06:00,1,1462.0,1118.0,0.765,7.0,38,0,0,0,38,6,32,0,0.0,0.0
1016,2295,26-09-2019 16:08:00,1,1433.0,1175.0,0.82,6.945,12,0,0,0,12,4,8,0,0.0,0.0
1016,2296,26-09-2019 16:10:00,1,1357.0,1142.0,0.842,6.609,49,4,2,2,45,29,16,0,0.0,0.0
1016,2297,26-09-2019 16:12:00,1,1243.0,1084.0,0.872,6.098,50,1,0,1,49,24,25,0,0.0,0.0
1016,2298,26-09-2019 16:14:00,1,1132.0,1068.0,0.943,5.643,49,2,0,2,47,17,30,0,0.0,0.0
1016,2299,26-09-2019 16:16:00,1,1243.0,1118.0,0.899,6.137,28,0,0,0,28,7,21,0,0.0,0.0
1016,2300,26-09-2019 16:18:00,1,1315.0,1144.0,0.87,6.448,42,0,0,0,42,12,30,0,0.0,0.0
1016,2301,26-09-2019 16:20:00,1,1428.0,1189.0,0.833,6.941,19,0,0,0,19,6,13,0,0.0,0.0
1016,2302,26-09-2019 16:22:00,1,1338.0,1133.0,0.847,6.525,20,2,0,2,18,7,11,0,0.0,0.0
1016,2303,26-09-2019 16:24:00,1,1352.0,1166.0,0.862,6.619,28,0,0,0,28,7,21,0,0.0,0.0
1016,2304,26-09-2019 16:26:00,1,1344.0,1186.0,0.882,6.61,118,13,4,9,105,66,39,0,0.0,0.0
1016,2305,26-09-2019 16:28:00,1,1345.0,1169.0,0.869,6.595,153,2,0,2,151,92,59,0,0.0,0.0
1016,2306,26-09-2019 16:30:00,1,1318.0,1135.0,0.861,6.449,371,16,7,9,355,287,68,0,0.0,0.0
1016,2307,26-09-2019 16:32:00,1,1425.0,1221.0,0.857,6.965,468,42,16,26,426,349,77,3,0.0,0.0
1016,2308,26-09-2019 16:34:00,1,1425.0,1303.0,0.915,7.057,335,34,14,20,301,251,50,0,0.0,0.0
1016,2309,26-09-2019 16:36:00,1,1446.0,1242.0,0.859,7.074,274,80,42,38,194,140,54,0,0.0,0.0
1016,2310,26-09-2019 16:38:00,1,1539.5,1334.0,0.866,7.5425,154,33,17,16,121,71,50,0,0.0,0.01
1016,2311,26-09-2019 16:40:00,1,1633.0,1426.0,0.873,8.011,50,2,1,1,48,26,22,0,0.0,0.0
1016,2312,26-09-2019 16:42:00,1,1640.0,1295.0,0.79,7.896,4,0,0,0,4,0,4,0,0.0,0.0
1016,2313,26-09-2019 16:44:00,1,1434.0,1209.0,0.844,6.988,25,0,0,0,25,0,25,0,0.0,0.0
1016,2314,26-09-2019 16:46:00,1,1457.0,1191.0,0.817,7.06,34,0,0,0,34,2,32,0,0.0,0.0
1016,2315,26-09-2019 16:48:00,1,1469.0,1151.0,0.784,7.061,35,2,1,1,33,1,32,0,0.0,0.0
1016,2316,26-09-2019 16:50:00,1,1481.0,1106.0,0.746,7.061,38,10,2,8,28,2,26,0,0.0,0.0
1016,2317,26-09-2019 16:52:00,1,1464.0,1092.0,0.746,6.976,134,7,4,3,127,90,37,0,0.0,0.0
1016,2318,26-09-2019 16:54:00,1,1461.0,1075.0,0.735,6.947,50,2,1,1,48,14,34,0,0.0,0.0
1016,2319,26-09-2019 16:56:00,1,1481.0,1070.0,0.722,7.018,64,2,0,2,62,22,40,0,0.0,0.0
1016,2320,26-09-2019 16:58:00,1,1477.0,1081.0,0.732,7.016,46,1,0,1,45,16,29,0,0.0,0.0
1016,2321,26-09-2019 17:00:00,1,1479.0,1068.0,0.722,7.01,102,18,12,6,84,39,45,0,0.0,0.0
1016,2322,26-09-2019 17:02:00,1,1483.0,1076.0,0.725,7.035,17,0,0,0,17,2,15,0,0.0,0.0
1016,2323,26-09-2019 17:04:00,1,1492.0,1064.0,0.713,7.057,80,11,2,9,69,30,39,0,0.0,0.0
1016,2324,26-09-2019 17:06:00,1,1465.0,1074.0,0.733,6.96,156,3,2,1,153,103,50,0,0.0,0.0
1016,2325,26-09-2019 17:08:00,1,1464.0,1050.0,0.717,6.929,144,3,1,2,141,86,55,0,0.0,0.0
1016,2326,26-09-2019 17:10:00,1,1371.0,1052.0,0.767,6.567,644,73,43,30,571,477,94,0,0.0,0.0
1016,2327,26-09-2019 17:12:00,1,1501.5,1232.0,0.816,7.2795,387,67,32,35,320,247,73,1,0.0,0.0
1016,2328,26-09-2019 17:14:00,1,1632.0,1412.0,0.865,7.992,444,43,18,25,401,324,77,0,0.0,0.0
1016,2329,26-09-2019 17:16:00,1,1897.0,1592.0,0.839,9.237,303,100,58,42,203,133,70,3,0.0,0.0
1016,2330,26-09-2019 17:18:00,1,1600.0,1413.0,0.883,7.869,61,20,13,7,41,0,41,48,0.0,0.0
1016,2331,26-09-2019 17:20:00,1,1835.0,1472.0,0.802,8.858,87,36,15,21,51,0,51,38,0.0,0.0
1016,2332,26-09-2019 17:22:00,1,1958.0,1582.0,0.808,9.467,85,29,9,20,56,0,56,72,0.0,0.0
1016,2333,26-09-2019 17:24:00,1,1956.0,1531.0,0.782,9.403,77,25,9,16,52,0,52,48,0.0,0.0
1016,2334,26-09-2019 17:26:00,1,1908.0,1554.0,0.814,9.239,120,47,27,20,73,9,64,51,0.0,0.14
1016,2335,26-09-2019 17:28:00,1,1731.0,1471.0,0.85,8.447,206,85,62,23,121,77,44,20,0.0,0.03
1016,2336,26-09-2019 17:30:00,1,1431.0,1188.0,0.831,6.953,51,9,0,9,42,23,19,0,0.0,0.0
1016,2337,26-09-2019 17:32:00,1,1451.0,1136.0,0.783,6.975,62,1,0,1,61,21,40,0,0.0,0.0
1016,2338,26-09-2019 17:34:00,1,1368.0,1137.0,0.831,6.65,101,2,1,1,99,56,43,0,0.0,0.0
1016,2339,26-09-2019 17:36:00,1,1242.0,1083.0,0.872,6.094,274,2,0,2,272,237,35,0,0.0,0.0
1016,2340,26-09-2019 17:38:00,1,1151.0,1026.0,0.892,5.671,268,3,0,3,265,219,46,0,0.0,0.0
1016,2341,26-09-2019 17:40:00,1,1145.0,998.0,0.872,5.615,493,5,1,4,488,444,44,0,0.0,0.01
1016,2342,26-09-2019 17:42:00,1,1402.0,1271.0,0.906,6.932,58,6,2,4,52,28,24,0,0.0,0.0
1016,2343,26-09-2019 17:44:00,1,1438.0,1224.0,0.851,7.022,65,0,0,0,65,22,43,0,0.0,0.0
1016,2344,26-09-2019 17:46:00,1,1488.0,1287.5,0.865,7.2885,70,12,3,9,58,16,42,0,0.0,0.0
1016,2345,26-09-2019 17:48:00,1,1538.0,1351.0,0.879,7.555,85,10,3,7,75,39,36,0,0.0,0.0
1016,2346,26-09-2019 17:50:00,1,1411.0,1305.0,0.924,7.005,230,3,0,3,227,176,51,0,0.0,0.0
1016,2347,26-09-2019 17:52:00,1,1605.0,1456.0,0.908,7.935,171,17,4,13,154,105,49,0,0.0,0.0
1016,2348,26-09-2019 17:54:00,1,1912.0,1643.0,0.859,9.352,144,41,18,23,103,65,38,0,0.0,0.0
1016,2349,26-09-2019 17:56:00,1,1874.0,1809.0,0.965,9.384,221,47,14,33,174,124,50,1,0.0,0.0
1016,2350,26-09-2019 17:58:00,1,1895.0,1724.0,0.909,9.377,370,136,113,23,234,169,65,34,0.0,0.0
1016,2351,26-09-2019 18:00:00,0,1879.0,1773.0,0.943,9.366,232,99,78,21,133,85,48,56,0.0,0.0
1016,2352,26-09-2019 18:02:00,0,2085.0,1953.0,0.937,10.376,337,233,183,50,104,83,21,127,0.0,0.0
1016,2353,26-09-2019 18:04:00,0,1872.0,1760.0,0.94,9.325,588,342,287,55,246,192,54,83,0.05,0.0
1016,2354,26-09-2019 18:06:00,0,1887.0,1744.0,0.924,9.367,440,163,114,49,277,212,65,28,0.0,0.0
1016,2355,26-09-2019 18:08:00,0,1998.0,1786.0,0.894,9.85,507,311,257,54,196,153,43,25,0.01,0.0
1016,2356,26-09-2019 18:10:00,0,2089.0,1841.0,0.882,10.268,686,423,348,75,263,210,53,60,0.0,0.0
1016,2357,26-09-2019 18:12:00,0,1923.0,1634.0,0.85,9.384,433,178,122,56,255,192,63,32,0.0,0.0
1016,2358,26-09-2019 18:14:00,0,1934.0,1626.0,0.841,9.42,131,44,23,21,87,66,21,0,0.0,0.0
1016,2359,26-09-2019 18:16:00,0,1903.0,1706.0,0.897,9.386,149,114,77,37,35,12,23,3,0.01,0.0
1016,2360,26-09-2019 18:18:00,0,2105.0,1769.0,0.841,10.251,491,299,235,64,192,156,36,38,0.0,0.0
1016,2361,26-09-2019 18:20:00,0,2116.5,1763.5,0.8335,10.291,133,89,48,41,44,17,27,0,0.0,0.0
1016,2362,26-09-2019 18:22:00,0,2128.0,1758.0,0.826,10.331,189,120,74,46,69,40,29,14,0.0,0.0
1016,2363,26-09-2019 18:24:00,0,1953.0,1516.0,0.776,9.374,179,116,88,28,63,39,24,10,0.0,0.0
1016,2364,26-09-2019 18:26:00,0,1722.0,1508.0,0.876,8.455,463,269,208,61,194,148,46,43,0.0,0.0
1016,2365,26-09-2019 18:28:00,0,1918.0,1500.0,0.782,9.216,242,183,137,46,59,39,20,4,0.0,0.0
1016,2366,26-09-2019 18:30:00,0,1432.0,1261.0,0.881,7.037,141,88,54,34,53,43,10,15,0.0,0.0
1016,2367,26-09-2019 18:32:00,0,1443.0,1096.0,0.76,6.9,127,84,55,29,43,34,9,15,0.0,0.0
1016,2368,26-09-2019 18:34:00,0,1929.0,1498.0,0.777,9.259,148,118,71,47,30,18,12,36,0.0,0.0
1016,2369,26-09-2019 18:36:00,0,1817.0,1502.0,0.827,8.824,82,74,47,27,8,4,4,13,0.0,0.0
1016,2370,26-09-2019 18:38:00,0,1655.0,1311.0,0.792,7.972,191,144,94,50,47,27,20,6,0.0,0.0
1016,2371,26-09-2019 18:40:00,0,1939.0,1562.0,0.806,9.369,363,127,76,51,236,181,55,1,0.0,0.0
1016,2372,26-09-2019 18:42:00,0,1642.0,1387.0,0.845,8.003,194,51,42,9,143,86,57,8,0.0,0.0
1016,2373,26-09-2019 18:44:00,0,1559.0,1292.0,0.828,7.575,517,326,266,60,191,144,47,133,0.0,0.0
1016,2374,26-09-2019 18:46:00,0,1652.0,1339.0,0.811,7.993,408,169,114,55,239,181,58,13,0.0,0.0
1016,2375,26-09-2019 18:48:00,0,1634.0,1383.0,0.846,7.971,371,112,67,45,259,191,68,2,0.0,0.0
1016,2376,26-09-2019 18:50:00,0,1818.0,1456.0,0.801,8.775,127,74,39,35,53,25,28,16,0.0,0.0
1016,2377,26-09-2019 18:52:00,0,1628.0,1372.0,0.843,7.932,436,371,299,72,65,53,12,42,0.0,0.0
1016,2378,26-09-2019 18:54:00,0,1778.0,1456.0,0.821,8.6165,176,122,84,38,54,33,21,0,0.0,0.0
1016,2379,26-09-2019 18:56:00,0,1928.0,1540.0,0.799,9.301,145,94,63,31,51,33,18,7,0.0,0.0
1016,2380,26-09-2019 18:58:00,0,1667.0,1246.0,0.747,7.947,99,80,35,45,19,5,14,0,0.0,0.0
1016,2381,26-09-2019 19:00:00,0,1672.0,1254.0,0.75,7.978,195,131,87,44,64,37,27,31,0.0,0.0
1016,2382,26-09-2019 19:02:00,0,1870.0,1452.0,0.776,8.976,408,176,133,43,232,173,59,17,0.0,0.0
1016,2383,26-09-2019 19:04:00,0,1563.0,1220.0,0.781,7.509,65,41,24,17,24,8,16,0,0.0,0.0
1016,2384,26-09-2019 19:06:00,0,1652.0,1347.0,0.815,8.001,98,83,41,42,15,3,12,0,0.0,0.0
1016,2385,26-09-2019 19:08:00,0,1638.0,1305.0,0.797,7.897,200,93,63,30,107,69,38,8,0.0,0.0
1016,2386,26-09-2019 19:10:00,0,1648.0,1282.0,0.778,7.913,118,57,37,20,61,43,18,0,0.0,0.0
1016,2387,26-09-2019 19:12:00,0,1457.0,1111.0,0.763,6.969,202,88,50,38,114,83,31,1,0.0,0.0
1016,2388,26-09-2019 19:14:00,0,1857.0,1422.0,0.766,8.889,359,161,120,41,198,151,47,46,0.0,0.0
1016,2389,26-09-2019 19:16:00,0,1859.0,1444.0,0.777,8.922,459,308,242,66,151,114,37,49,0.03,0.0
1016,2390,26-09-2019 19:18:00,0,1652.0,1323.0,0.801,7.972,194,155,114,41,39,27,12,81,0.01,0.0
1016,2391,26-09-2019 19:20:00,0,1651.0,1262.0,0.765,7.901,129,96,54,42,33,22,11,46,0.0,0.0
1016,2392,26-09-2019 19:22:00,0,1657.0,1248.0,0.753,7.911,191,153,107,46,38,22,16,12,0.0,0.0
1016,2393,26-09-2019 19:24:00,0,1574.0,1196.0,0.76,7.524,128,102,59,43,26,8,18,9,0.0,0.0
1016,2394,26-09-2019 19:26:00,0,1460.0,1137.0,0.779,7.011,87,71,31,40,16,4,12,0,0.0,0.0
1016,2395,26-09-2019 19:28:00,0,1557.5,1233.0,0.791,7.5025,146,67,45,22,79,48,31,5,0.0,0.0
1016,2396,26-09-2019 19:30:00,0,1655.0,1329.0,0.803,7.994,158,95,53,42,63,46,17,5,0.0,0.0
1016,2397,26-09-2019 19:32:00,0,1697.0,1191.0,0.702,8.003,226,103,66,37,123,79,44,14,0.0,0.0
1016,2398,26-09-2019 19:34:00,0,1887.0,1361.0,0.721,8.94,388,248,201,47,140,102,38,109,0.0,0.0
1016,2399,26-09-2019 19:36:00,0,1637.0,1252.0,0.765,7.835,113,74,31,43,39,12,27,0,0.0,0.0
1016,2400,26-09-2019 19:38:00,0,1571.0,1132.0,0.72,7.443,75,75,34,41,0,0,0,1,0.0,0.0
1016,2401,26-09-2019 19:40:00,0,1954.0,1411.0,0.722,9.262,159,113,78,35,46,31,15,14,0.01,0.0
1016,2402,26-09-2019 19:42:00,0,1595.0,1137.0,0.713,7.545,113,86,42,44,27,10,17,0,0.0,0.0
1016,2403,26-09-2019 19:44:00,0,1767.0,1353.0,0.765,8.462,314,272,212,60,42,32,10,10,0.0,0.0
1016,2404,26-09-2019 19:46:00,0,1670.0,1281.0,0.767,7.998,111,47,23,24,64,37,27,0,0.0,0.0
1016,2405,26-09-2019 19:48:00,0,1650.0,1236.0,0.749,7.871,252,197,144,53,55,36,19,9,0.0,0.0
1016,2406,26-09-2019 19:50:00,0,1678.0,1261.0,0.752,8.008,133,98,62,36,35,18,17,1,0.0,0.0
1016,2407,26-09-2019 19:52:00,0,1633.0,1277.0,0.782,7.848,243,159,116,43,84,57,27,10,0.0,0.0
1016,2408,26-09-2019 19:54:00,0,1667.0,1193.0,0.716,7.89,134,78,44,34,56,23,33,3,0.0,0.0
1016,2409,26-09-2019 19:56:00,0,1473.0,1117.0,0.758,7.041,344,140,93,47,204,152,52,31,0.0,0.0
1016,2410,26-09-2019 19:58:00,0,1672.0,1255.0,0.75,7.979,330,171,132,39,159,122,37,92,0.0,0.0
1016,2411,26-09-2019 20:00:00,0,1480.0,1137.0,0.768,7.089,329,170,126,44,159,120,39,121,0.0,0.0
1016,2412,26-09-2019 20:02:00,0,1621.5,1216.0,0.7515,7.735,393,57,28,29,336,270,66,0,0.0,0.0
1016,2413,26-09-2019 20:04:00,0,1763.0,1295.0,0.735,8.381,447,328,258,70,119,72,47,5,0.01,0.0
1016,2414,26-09-2019 20:06:00,0,1948.0,1473.0,0.756,9.306,808,620,487,133,188,127,61,10,0.02,0.0
1016,2415,26-09-2019 20:08:00,0,1954.0,1498.0,0.766,9.359,468,322,243,79,146,97,49,4,0.0,0.0
1016,2416,26-09-2019 20:10:00,0,1970.0,1457.0,0.739,9.377,708,468,347,121,240,170,70,9,0.0,0.0
1016,2417,26-09-2019 20:12:00,0,1967.0,1409.0,0.716,9.311,522,304,228,76,218,160,58,4,0.0,0.0
1016,2418,26-09-2019 20:14:00,0,1676.0,1221.0,0.729,7.954,204,91,49,42,113,51,62,0,0.0,0.0
1016,2419,26-09-2019 20:16:00,0,1788.0,1290.0,0.721,8.475,346,191,149,42,155,109,46,18,0.0,0.0
1016,2420,26-09-2019 20:18:00,0,1689.0,1171.0,0.694,7.951,115,51,21,30,64,39,25,4,0.0,0.0
1016,2421,26-09-2019 20:20:00,0,1685.0,1216.0,0.722,7.987,118,61,29,32,57,28,29,4,0.0,0.0
1016,2422,26-09-2019 20:22:00,0,1640.0,1292.0,0.788,7.893,429,317,251,66,112,80,32,20,0.0,0.0
1016,2423,26-09-2019 20:24:00,0,1995.0,1351.0,0.677,9.358,236,132,94,38,104,67,37,24,0.0,0.0
1016,2424,26-09-2019 20:26:00,0,1700.0,1142.0,0.672,7.964,189,135,103,32,54,35,19,18,0.0,0.0
1016,2425,26-09-2019 20:28:00,0,1680.0,1235.0,0.735,7.987,78,23,9,14,55,23,32,0,0.0,0.0
1016,2426,26-09-2019 20:30:00,0,1491.0,1033.0,0.693,7.017,54,23,2,21,31,15,16,0,0.0,0.0
1016,2427,26-09-2019 20:32:00,0,1748.0,1307.0,0.748,8.336,246,131,97,34,115,81,34,105,0.0,0.0
1016,2428,26-09-2019 20:34:00,0,1467.0,1097.0,0.748,6.996,291,148,111,37,143,101,42,20,0.0,0.0
1016,2429,26-09-2019 20:36:00,0,1528.5,1102.0,0.7225,7.2425,42,20,11,9,22,11,11,61,0.0,0.0
1016,2430,26-09-2019 20:38:00,0,1590.0,1107.0,0.697,7.489,427,316,245,71,111,81,30,59,0.0,0.0
1016,2431,26-09-2019 20:40:00,0,1976.0,1443.0,0.731,9.382,340,215,158,57,125,91,34,8,0.0,0.0
1016,2432,26-09-2019 20:42:00,0,1684.0,1214.0,0.721,7.979,117,81,53,28,36,11,25,0,0.0,0.0
1016,2433,26-09-2019 20:44:00,0,1483.0,1092.0,0.736,7.053,114,46,22,24,68,30,38,10,0.0,0.0
1016,2434,26-09-2019 20:46:00,0,1707.0,1155.0,0.677,8.004,173,98,62,36,75,47,28,33,0.0,0.0
1016,2435,26-09-2019 20:48:00,0,1651.0,1224.0,0.741,7.859,162,82,63,19,80,63,17,95,0.02,0.0
1016,2436,26-09-2019 20:50:00,0,1868.0,1292.0,0.692,8.792,209,110,75,35,99,68,31,18,0.01,0.0
1016,2437,26-09-2019 20:52:00,0,1693.0,1114.0,0.658,7.906,99,75,36,39,24,3,21,0,0.0,0.0
1016,2438,26-09-2019 20:54:00,0,1490.0,1057.0,0.709,7.041,212,142,103,39,70,52,18,24,0.0,0.0
1016,2439,26-09-2019 20:56:00,0,1672.0,1284.0,0.768,8.009,216,127,98,29,89,72,17,118,0.0,0.0
1016,2440,26-09-2019 20:58:00,0,1713.0,1156.0,0.675,8.031,264,162,129,33,102,80,22,59,0.0,0.0
1016,2441,26-09-2019 21:00:00,0,2048.0,1434.0,0.7,9.656,107,89,42,47,18,9,9,52,0.0,0.0
1016,2442,26-09-2019 21:02:00,0,1694.0,1125.0,0.664,7.922,22,14,6,8,8,4,4,1,0.0,0.0
1016,2443,26-09-2019 21:04:00,0,1461.0,1076.0,0.736,6.948,36,27,17,10,9,4,5,3,0.0,0.0
1016,2444,26-09-2019 21:06:00,0,1481.0,1038.0,0.701,6.984,2,2,1,1,0,0,0,0,0.0,0.0
1016,2445,26-09-2019 21:08:00,0,1403.0,938.0,0.669,6.567,39,33,19,14,6,1,5,6,0.0,0.0
1016,2446,26-09-2019 21:10:00,0,1398.0,960.0,0.6875,6.571,331,233,188,45,98,75,23,24,0.01,0.0
1016,2447,26-09-2019 21:12:00,0,1393.0,982.0,0.706,6.575,135,87,71,16,48,37,11,44,0.0,0.0
1016,2448,26-09-2019 21:14:00,0,1703.0,1145.0,0.672,7.978,300,188,154,34,112,78,34,137,0.0,0.0
1016,2449,26-09-2019 21:16:00,0,1887.0,1310.0,0.694,8.885,40,22,12,10,18,12,6,0,0.0,0.0
1016,2450,26-09-2019 21:18:00,0,1696.0,1137.0,0.67,7.939,20,15,10,5,5,5,0,2,0.0,0.0
1016,2451,26-09-2019 21:20:00,0,1473.0,1069.0,0.725,6.988,150,85,61,24,65,48,17,5,0.0,0.0
1016,2452,26-09-2019 21:22:00,0,1184.0,861.0,0.727,5.618,198,76,44,32,122,85,37,0,0.0,0.0
1016,2453,26-09-2019 21:24:00,0,1497.0,1044.0,0.697,7.056,141,78,45,33,63,45,18,67,0.0,0.0
1016,2454,26-09-2019 21:26:00,0,1668.0,1286.0,0.771,7.997,340,219,155,64,121,99,22,93,0.0,0.0
1016,2455,26-09-2019 21:28:00,0,1698.0,1131.0,0.666,7.943,89,69,37,32,20,4,16,0,0.0,0.0
1016,2456,26-09-2019 21:30:00,0,1778.0,1248.0,0.702,8.386,142,81,65,16,61,47,14,20,0.0,0.0
1016,2457,26-09-2019 21:32:00,0,1673.0,1180.0,0.705,7.899,116,83,52,31,33,23,10,2,0.0,0.0
1016,2458,26-09-2019 21:34:00,0,1687.0,1138.0,0.674,7.908,122,86,65,21,36,26,10,0,0.0,0.0
1016,2459,26-09-2019 21:36:00,0,1676.0,1235.0,0.737,7.972,441,266,199,67,175,134,41,5,0.01,0.0
1016,2460,26-09-2019 21:38:00,0,1905.0,1260.0,0.661,8.903,476,338,264,74,138,109,29,8,0.0,0.0
1016,2461,26-09-2019 21:40:00,0,1695.0,1165.0,0.687,7.969,182,96,63,33,86,48,38,4,0.0,0.0
1016,2462,26-09-2019 21:42:00,0,1179.0,826.0,0.7,5.559,266,152,113,39,114,88,26,102,0.0,0.0
1016,2463,26-09-2019 21:44:00,0,1529.5,1049.0,0.6885,7.1875,325,194,155,39,131,89,42,31,0.0,0.0
1016,2464,26-09-2019 21:46:00,0,1880.0,1272.0,0.677,8.816,285,102,64,38,183,132,51,4,0.0,0.0
1016,2465,26-09-2019 21:48:00,0,1908.0,1276.0,0.669,8.93,227,109,73,36,118,84,34,14,0.0,0.0
1016,2466,26-09-2019 21:50:00,0,1485.0,1036.0,0.698,6.998,220,117,86,31,103,77,26,107,0.0,0.0
1016,2467,26-09-2019 21:52:00,0,1688.0,1175.0,0.696,7.952,139,96,54,42,43,21,22,2,0.0,0.0
1016,2468,26-09-2019 21:54:00,0,1500.0,1055.0,0.704,7.078,321,201,157,44,120,82,38,12,0.0,0.0
1016,2469,26-09-2019 21:56:00,0,1997.0,1402.0,0.702,9.422,94,58,45,13,36,25,11,10,0.0,0.0
1016,2470,26-09-2019 21:58:00,0,1681.0,1223.0,0.728,7.976,311,191,145,46,120,93,27,206,0.0,0.0
1016,2471,26-09-2019 22:00:00,0,1644.0,1202.0,0.731,7.81,404,262,206,56,142,116,26,164,0.0,0.0
1016,2472,26-09-2019 22:02:00,0,1662.0,1214.0,0.73,7.895,316,194,160,34,122,88,34,147,0.0,0.0
1016,2473,26-09-2019 22:04:00,0,1901.0,1246.0,0.656,8.869,57,19,8,11,38,16,22,4,0.0,0.0
1016,2474,26-09-2019 22:06:00,0,1782.0,1258.0,0.706,8.414,143,75,51,24,68,42,26,41,0.0,0.0
1016,2475,26-09-2019 22:08:00,0,1399.0,945.0,0.676,6.559,147,88,69,19,59,45,14,86,0.0,0.0
1016,2476,26-09-2019 22:10:00,0,1613.0,1066.0,0.661,7.534,256,156,115,41,100,70,30,49,0.0,0.0
1016,2477,26-09-2019 22:12:00,0,2089.0,1436.0,0.687,9.822,262,168,125,43,94,69,25,34,0.0,0.0
1016,2478,26-09-2019 22:14:00,0,1608.0,1076.0,0.669,7.529,85,71,37,34,14,3,11,0,0.0,0.0
1016,2479,26-09-2019 22:16:00,0,1699.0,1107.0,0.652,7.918,287,192,147,45,95,62,33,106,0.0,0.0
1016,2480,26-09-2019 22:18:00,0,1990.0,1322.0,0.663,9.304,491,362,287,75,129,94,35,92,0.0,0.0
1016,2481,26-09-2019 22:20:00,0,2281.0,1537.0,0.674,10.69,243,177,124,53,66,47,19,5,0.0,0.0
1016,2482,26-09-2019 22:22:00,0,2204.0,1460.0,0.662,10.299,19,10,1,9,9,6,3,0,0.0,0.0
1016,2483,26-09-2019 22:24:00,0,1687.0,1146.0,0.679,7.916,296,215,172,43,81,59,22,74,0.03,0.0
1016,2484,26-09-2019 22:26:00,0,1693.0,1182.0,0.698,7.981,371,221,170,51,150,113,37,51,0.0,0.0
1016,2485,26-09-2019 22:28:00,0,1712.0,1126.0,0.657,7.993,210,84,43,41,126,85,41,11,0.0,0.0
1016,2486,26-09-2019 22:30:00,0,1988.0,1439.0,0.723,9.428,215,121,90,31,94,69,25,87,0.0,0.0
1016,2487,26-09-2019 22:32:00,0,1492.0,1058.0,0.709,7.049,129,93,68,25,36,23,13,62,0.0,0.0
1016,2488,26-09-2019 22:34:00,0,1596.0,1038.0,0.65,7.439,47,37,14,23,10,3,7,19,0.0,0.0
1016,2489,26-09-2019 22:36:00,0,1674.0,1140.0,0.681,7.857,149,83,55,28,66,47,19,67,0.0,0.0
1016,2490,26-09-2019 22:38:00,0,1721.0,1061.0,0.617,7.957,195,100,76,24,95,64,31,60,0.0,0.0
1016,2491,26-09-2019 22:40:00,0,1712.0,1089.0,0.636,7.953,111,59,33,26,52,36,16,15,0.0,0.0
1016,2492,26-09-2019 22:42:00,0,1720.0,1077.0,0.626,7.969,94,65,44,21,29,22,7,14,0.0,0.0
1016,2493,26-09-2019 22:44:00,0,1694.0,1175.0,0.694,7.977,291,176,138,38,115,91,24,61,0.0,0.0
1016,2494,26-09-2019 22:46:00,0,1687.0,1082.0,0.641,7.847,48,31,12,19,17,5,12,48,0.0,0.0
1016,2495,26-09-2019 22:48:00,0,1680.0,1140.0,0.679,7.88,376,227,167,60,149,119,30,71,0.0,0.0
1016,2496,26-09-2019 22:50:00,0,1590.0,1042.0,0.655,7.418,259,153,119,34,106,80,26,135,0.0,0.0
1016,2497,26-09-2019 22:52:00,0,1793.5,1193.0,0.664,8.3865,307,202,154,48,105,81,24,127,0.0,0.0
1016,2498,26-09-2019 22:54:00,0,1997.0,1344.0,0.673,9.355,530,254,196,58,276,239,37,15,0.0,0.0
1016,2499,26-09-2019 22:56:00,0,1988.0,1362.0,0.685,9.342,746,389,297,92,357,301,56,10,0.0,0.0
1016,2500,26-09-2019 22:58:00,0,2019.0,1305.0,0.647,9.399,533,322,253,69,211,174,37,13,0.0,0.0
1016,2501,26-09-2019 23:00:00,0,2011.0,1332.0,0.662,9.401,118,19,7,12,99,94,5,0,0.0,0.0
1016,2502,26-09-2019 23:02:00,0,1719.0,1088.0,0.633,7.978,184,65,35,30,119,108,11,0,0.0,0.0
1016,2503,26-09-2019 23:04:00,0,1646.0,1184.0,0.72,7.797,49,14,7,7,35,35,0,0,0.0,0.0
1016,2504,26-09-2019 23:06:00,0,1494.0,1033.0,0.691,7.032,369,145,101,44,224,190,34,9,0.0,0.0
1016,2505,26-09-2019 23:08:00,0,1480.0,1013.0,0.684,6.954,160,94,50,44,66,34,32,7,0.0,0.0
1016,2506,26-09-2019 23:10:00,0,1700.0,1141.0,0.671,7.962,196,108,81,27,88,66,22,62,0.0,0.0
1016,2507,26-09-2019 23:12:00,0,1684.0,1167.0,0.693,7.929,82,37,29,8,45,27,18,24,0.0,0.0
1016,2508,26-09-2019 23:14:00,0,1491.0,1037.0,0.695,7.024,248,132,103,29,116,91,25,122,0.0,0.0
1016,2509,26-09-2019 23:16:00,0,1722.0,1145.0,0.665,8.054,178,90,68,22,88,56,32,14,0.0,0.0
1016,2510,26-09-2019 23:18:00,0,1707.0,1141.0,0.669,7.991,86,39,31,8,47,37,10,45,0.0,0.0
1016,2511,26-09-2019 23:20:00,0,1701.0,1128.0,0.663,7.952,369,184,145,39,185,142,43,60,0.0,0.0
1016,2512,26-09-2019 23:22:00,0,1305.0,894.0,0.685,6.132,47,24,9,15,23,6,17,0,0.0,0.0
1016,2513,26-09-2019 23:24:00,0,1396.0,896.0,0.642,6.493,27,5,3,2,22,7,15,0,0.0,0.0
1016,2514,26-09-2019 23:26:00,0,1688.5,1116.0,0.6585,7.8895,160,89,69,20,71,50,21,26,0.0,0.0
1016,2515,26-09-2019 23:28:00,0,1981.0,1336.0,0.675,9.286,199,124,93,31,75,51,24,69,0.06,0.0
1016,2516,26-09-2019 23:30:00,0,1714.0,1099.0,0.641,7.97,332,200,166,34,132,105,27,127,0.0,0.0
1016,2517,26-09-2019 23:32:00,0,1710.0,1101.0,0.644,7.955,436,266,202,64,170,136,34,181,0.0,0.0
1016,2518,26-09-2019 23:34:00,0,1788.0,1214.0,0.679,8.39,330,212,173,39,118,78,40,128,0.0,0.0
1016,2519,26-09-2019 23:36:00,0,2004.0,1331.0,0.664,9.371,587,449,357,92,138,93,45,22,0.02,0.0
1016,2520,26-09-2019 23:38:00,0,2017.0,1295.0,0.642,9.382,2,2,0,2,0,0,0,1,0.0,0.0
1016,2521,26-09-2019 23:40:00,0,1716.0,1134.0,0.661,8.016,0,0,0,0,0,0,0,0,0.01,0.0
1016,2522,26-09-2019 23:42:00,0,1397.0,920.0,0.658,6.524,265,144,119,25,121,87,34,15,0.0,0.0
1016,2523,26-09-2019 23:44:00,0,1512.0,918.0,0.607,6.973,197,139,95,44,58,25,33,5,0.0,0.0
1016,2524,26-09-2019 23:46:00,0,1502.0,1023.0,0.681,7.05,176,103,66,37,73,55,18,98,0.0,0.0
1016,2525,26-09-2019 23:48:00,0,1609.0,1045.0,0.65,7.495,196,124,89,35,72,52,20,17,0.0,0.0
1016,2526,26-09-2019 23:50:00,0,1490.0,1029.0,0.691,7.011,305,152,115,37,153,114,39,183,0.01,0.0
1016,2527,26-09-2019 23:52:00,0,1707.0,1118.0,0.655,7.962,219,130,92,38,89,61,28,64,0.04,0.0
1016,2528,26-09-2019 23:54:00,0,1918.0,1218.0,0.635,8.906,171,93,69,24,78,57,21,17,0.0,0.0
1016,2529,26-09-2019 23:56:00,0,1708.0,1103.0,0.646,7.952,558,427,335,92,131,97,34,85,0.0,0.0
1016,2530,26-09-2019 23:58:00,0,1689.0,1137.0,0.674,7.913,756,582,467,115,174,120,54,8,0.0,0.0
1016,2531,27-09-2019 00:00:00,0,1833.5,1268.0,0.6905,8.6285,355,293,212,81,62,37,25,0,0.0,0.0
1016,2532,27-09-2019 00:02:00,0,1978.0,1399.0,0.707,9.344,289,238,172,66,51,34,17,1,0.0,0.0
1016,2533,27-09-2019 00:04:00,0,1988.0,1406.0,0.707,9.389,481,357,281,76,124,93,31,5,0.0,0.0
1016,2534,27-09-2019 00:06:00,0,1999.0,1362.0,0.682,9.385,284,175,128,47,109,77,32,5,0.0,0.0
1016,2535,27-09-2019 00:08:00,0,1911.0,1259.0,0.659,8.923,351,248,198,50,103,82,21,5,0.0,0.0
1016,2536,27-09-2019 00:10:00,0,1603.0,1078.0,0.673,7.508,259,156,117,39,103,83,20,85,0.0,0.0
1016,2537,27-09-2019 00:12:00,0,1587.0,1044.0,0.658,7.409,136,93,57,36,43,26,17,37,0.02,0.0
1016,2538,27-09-2019 00:14:00,0,1682.0,1117.0,0.664,7.863,236,145,98,47,91,66,25,56,0.0,0.0
1016,2539,27-09-2019 00:16:00,0,1493.0,1025.0,0.687,7.017,257,96,59,37,161,117,44,52,0.0,0.0
1016,2540,27-09-2019 00:18:00,0,1712.0,1072.0,0.627,7.931,287,162,121,41,125,82,43,45,0.0,0.0
1016,2541,27-09-2019 00:20:00,0,1597.0,1047.0,0.655,7.452,117,66,32,34,51,29,22,0,0.0,0.0
1016,2542,27-09-2019 00:22:00,0,1709.0,1100.0,0.644,7.954,275,139,107,32,136,103,33,9,0.0,0.0
1016,2543,27-09-2019 00:24:00,0,1505.0,1019.0,0.677,7.058,357,198,156,42,159,127,32,132,0.0,0.0
1016,2544,27-09-2019 00:26:00,0,1698.0,1161.0,0.684,7.975,250,144,113,31,106,80,26,147,0.0,0.0
1016,2545,27-09-2019 00:28:00,0,1704.0,1146.0,0.672,7.984,94,57,35,22,37,24,13,12,0.0,0.0
1016,2546,27-09-2019 00:30:00,0,1679.0,1149.0,0.684,7.887,106,58,35,23,48,32,16,1,0.0,0.0
1016,2547,27-09-2019 00:32:00,0,1470.0,1067.0,0.726,6.974,160,146,106,40,14,10,4,0,0.0,0.0
1016,2548,27-09-2019 00:34:00,0,1739.5,1192.0,0.691,8.175,618,525,419,106,93,63,30,4,0.0,0.0
1016,2549,27-09-2019 00:36:00,0,2009.0,1317.0,0.656,9.376,172,162,108,54,10,5,5,0,0.0,0.0
1016,2550,27-09-2019 00:38:00,0,1482.0,1040.0,0.702,6.991,257,108,74,34,149,110,39,8,0.0,0.0
1016,2551,27-09-2019 00:40:00,0,1683.0,1199.0,0.713,7.96,98,49,26,23,49,27,22,5,0.0,0.0
1016,2552,27-09-2019 00:42:00,0,1703.0,1124.0,0.66,7.954,19,3,0,3,16,0,16,0,0.0,0.0
1016,2553,27-09-2019 00:44:00,0,1504.0,1014.0,0.674,7.048,16,1,0,1,15,0,15,0,0.0,0.0
1016,2554,27-09-2019 00:46:00,0,1295.0,879.0,0.679,6.074,19,1,0,1,18,0,18,0,0.0,0.0
1016,2555,27-09-2019 00:48:00,0,1186.0,790.0,0.666,5.549,20,0,0,0,20,0,20,0,0.0,0.0
1016,2556,27-09-2019 00:50:00,0,1203.0,726.0,0.603,5.545,20,0,0,0,20,0,20,0,0.0,0.0
1016,2557,27-09-2019 00:52:00,0,999.0,685.0,0.686,4.693,10,0,0,0,10,0,10,0,0.0,0.0
1016,2558,27-09-2019 00:54:00,0,1003.0,643.0,0.641,4.663,10,0,0,0,10,0,10,0,0.0,0.0
1016,2559,27-09-2019 00:56:00,0,1014.0,590.0,0.581,4.65,7,0,0,0,7,0,7,0,0.0,0.0
1016,2560,27-09-2019 00:58:00,0,1024.0,597.0,0.582,4.697,7,0,0,0,7,0,7,0,0.0,0.0
1016,2561,27-09-2019 01:00:00,0,1030.0,582.0,0.565,4.702,35,5,3,2,30,12,18,0,0.0,0.0
1016,2562,27-09-2019 01:02:00,0,1199.0,738.0,0.615,5.543,275,176,130,46,99,74,25,19,0.0,0.0
1016,2563,27-09-2019 01:04:00,0,1163.0,877.0,0.754,5.552,453,295,240,55,158,119,39,99,0.02,0.0
1016,2564,27-09-2019 01:06:00,0,1282.0,902.0,0.704,6.048,250,116,83,33,134,87,47,18,0.0,0.0
1016,2565,27-09-2019 01:08:00,0,1487.0,1034.0,0.6965,7.002,165,96,59,37,69,41,28,9,0.0,0.0
1016,2566,27-09-2019 01:10:00,0,1692.0,1166.0,0.689,7.956,223,163,120,43,60,36,24,2,0.0,0.0
1016,2567,27-09-2019 01:12:00,0,1785.0,1219.0,0.683,8.383,345,275,212,63,70,46,24,5,0.0,0.0
1016,2568,27-09-2019 01:14:00,0,1722.0,1107.0,0.643,8.011,209,141,94,47,68,50,18,7,0.0,0.0
1016,2569,27-09-2019 01:16:00,0,1496.0,1042.0,0.696,7.05,147,104,66,38,43,24,19,0,0.0,0.0
1016,2570,27-09-2019 01:18:00,0,1711.0,1147.0,0.67,8.014,269,126,96,30,143,109,34,86,0.0,0.0
1016,2571,27-09-2019 01:20:00,0,1677.0,1137.0,0.678,7.866,313,158,117,41,155,113,42,181,0.0,0.0
1016,2572,27-09-2019 01:22:00,0,1682.0,1183.0,0.703,7.937,270,157,121,36,113,89,24,106,0.0,0.0
1016,2573,27-09-2019 01:24:00,0,1661.0,1157.0,0.697,7.826,275,117,82,35,158,120,38,68,0.0,0.0
1016,2574,27-09-2019 01:26:00,0,1873.0,1279.0,0.683,8.795,315,216,166,50,99,67,32,36,0.0,0.0
1016,2575,27-09-2019 01:28:00,0,1672.0,1181.0,0.706,7.895,392,207,164,43,185,142,43,113,0.0,0.0
1016,2576,27-09-2019 01:30:00,0,1763.0,1234.0,0.7,8.315,296,123,87,36,173,129,44,114,0.0,0.0
1016,2577,27-09-2019 01:32:00,0,1679.0,1197.0,0.713,7.939,238,140,106,34,98,67,31,71,0.0,0.0
1016,2578,27-09-2019 01:34:00,0,1682.0,1208.0,0.718,7.966,348,139,107,32,209,153,56,67,0.0,0.0
1016,2579,27-09-2019 01:36:00,0,1688.0,1172.0,0.694,7.946,195,50,36,14,145,103,42,2,0.0,0.0
1016,2580,27-09-2019 01:38:00,0,1707.0,1166.0,0.684,8.016,390,216,155,61,174,138,36,70,0.03,0.0
1016,2581,27-09-2019 01:40:00,0,1717.0,1120.0,0.652,8.006,389,212,170,42,177,141,36,150,0.0,0.0
1016,2582,27-09-2019 01:42:00,0,1849.5,1229.0,0.6635,8.649,117,75,62,13,42,31,11,149,0.0,0.0
1016,2583,27-09-2019 01:44:00,0,1982.0,1338.0,0.675,9.292,414,259,200,59,155,106,49,20,0.0,0.0
1016,2584,27-09-2019 01:46:00,0,1877.0,1251.0,0.667,8.779,278,222,166,56,56,42,14,3,0.0,0.0
1016,2585,27-09-2019 01:48:00,0,1675.0,1136.0,0.678,7.858,2,2,1,1,0,0,0,0,0.0,0.0
1016,2586,27-09-2019 01:50:00,0,1581.0,1064.0,0.673,7.408,129,97,70,27,32,19,13,1,0.0,0.0
1016,2587,27-09-2019 01:52:00,0,1399.0,928.0,0.664,6.538,90,51,40,11,39,22,17,7,0.0,0.0
1016,2588,27-09-2019 01:54:00,0,1704.0,1121.0,0.658,7.954,91,47,30,17,44,30,14,1,0.0,0.0
1016,2589,27-09-2019 01:56:00,0,1479.0,1045.0,0.707,6.983,194,93,74,19,101,72,29,2,0.0,0.0
1016,2590,27-09-2019 01:58:00,0,1295.0,917.0,0.709,6.118,31,31,16,15,0,0,0,0,0.0,0.0
1016,2591,27-09-2019 02:00:00,0,1504.0,992.0,0.66,7.022,84,58,42,16,26,14,12,65,0.0,0.0
1016,2592,27-09-2019 02:02:00,0,1493.0,978.0,0.655,6.965,190,132,103,29,58,42,16,68,0.0,0.0
1016,2593,27-09-2019 02:04:00,0,1484.0,1036.0,0.698,6.995,152,121,86,35,31,27,4,0,0.0,0.0
1016,2594,27-09-2019 02:06:00,0,1165.0,898.0,0.77,5.584,196,120,86,34,76,49,27,37,0.0,0.0
1016,2595,27-09-2019 02:08:00,0,1394.0,916.0,0.657,6.509,97,57,22,35,40,13,27,0,0.0,0.0
1016,2596,27-09-2019 02:10:00,0,1393.0,909.0,0.652,6.495,143,78,43,35,65,44,21,17,0.0,0.0
1016,2597,27-09-2019 02:12:00,0,1274.0,917.0,0.72,6.034,97,49,33,16,48,36,12,42,0.0,0.0
1016,2598,27-09-2019 02:14:00,0,1303.0,892.0,0.685,6.12,162,96,60,36,66,36,30,1,0.0,0.0
1016,2599,27-09-2019 02:16:00,0,1511.0,981.5,0.654,7.0385,44,26,14,12,18,10,8,15,0.0,0.0
1016,2600,27-09-2019 02:18:00,0,1719.0,1071.0,0.623,7.957,248,152,104,48,96,65,31,2,0.0,0.0
1016,2601,27-09-2019 02:20:00,0,1513.0,1000.0,0.661,7.07,311,125,80,45,186,122,64,3,0.04,0.0
1016,2602,27-09-2019 02:22:00,0,1527.0,936.0,0.613,7.054,451,210,166,44,241,185,56,0,0.0,0.0
1016,2603,27-09-2019 02:24:00,0,1199.0,808.0,0.674,5.619,25,0,0,0,25,0,25,0,0.0,0.0
1016,2604,27-09-2019 02:26:00,0,1196.0,709.0,0.593,5.498,20,0,0,0,20,0,20,0,0.0,0.0
1016,2605,27-09-2019 02:28:00,0,991.0,670.0,0.676,4.646,14,0,0,0,14,0,14,0,0.0,0.0
1016,2606,27-09-2019 02:30:00,0,999.0,662.0,0.662,4.67,22,5,0,5,17,4,13,0,0.0,0.0
1016,2607,27-09-2019 02:32:00,0,999.0,636.0,0.636,4.642,13,0,0,0,13,4,9,0,0.0,0.0
1016,2608,27-09-2019 02:34:00,0,1011.0,610.0,0.603,4.659,19,0,0,0,19,6,13,0,0.0,0.0
1016,2609,27-09-2019 02:36:00,0,1024.0,567.0,0.554,4.661,15,0,0,0,15,3,12,0,0.0,0.0
1016,2610,27-09-2019 02:38:00,0,1042.0,548.0,0.526,4.712,12,6,1,5,6,0,6,0,0.0,0.0
1016,2611,27-09-2019 02:40:00,0,809.0,499.0,0.617,3.74,19,7,2,5,12,3,9,0,0.0,0.0
1016,2612,27-09-2019 02:42:00,0,1010.0,626.0,0.62,4.672,321,138,93,45,183,142,41,20,0.02,0.0
1016,2613,27-09-2019 02:44:00,0,1217.0,764.0,0.627,5.643,289,190,148,42,99,76,23,37,0.0,0.0
1016,2614,27-09-2019 02:46:00,0,1173.0,887.0,0.756,5.605,216,117,88,29,99,63,36,33,0.0,0.0
1016,2615,27-09-2019 02:48:00,0,1400.0,908.0,0.649,6.524,191,102,74,28,89,69,20,0,0.0,0.0
1016,2616,27-09-2019 02:50:00,0,1546.5,1000.0,0.647,7.202,173,53,30,23,120,99,21,36,0.0,0.0
1016,2617,27-09-2019 02:52:00,0,1693.0,1092.0,0.645,7.88,192,102,81,21,90,69,21,43,0.0,0.0
1016,2618,27-09-2019 02:54:00,0,1287.0,900.0,0.699,6.067,12,2,1,1,10,0,10,0,0.0,0.0
1016,2619,27-09-2019 02:56:00,0,1192.0,805.0,0.675,5.588,10,2,1,1,8,0,8,0,0.0,0.0
1016,2620,27-09-2019 02:58:00,0,1214.0,757.0,0.624,5.622,7,0,0,0,7,0,7,0,0.0,0.0
1016,2621,27-09-2019 03:00:00,0,997.0,689.0,0.691,4.693,10,1,0,1,9,0,9,0,0.0,0.0
1016,2622,27-09-2019 03:02:00,0,1013.0,629.0,0.621,4.689,25,3,0,3,22,6,16,0,0.0,0.0
1016,2623,27-09-2019 03:04:00,0,1032.0,564.0,0.546,4.691,23,2,1,1,21,2,19,0,0.0,0.0
1016,2624,27-09-2019 03:06:00,0,921.0,531.0,0.577,4.219,16,2,0,2,14,2,12,0,0.0,0.0
1016,2625,27-09-2019 03:08:00,0,810.0,517.0,0.639,3.763,21,4,0,4,17,2,15,0,0.0,0.0
1016,2626,27-09-2019 03:10:00,0,802.0,513.0,0.639,3.728,17,2,0,2,15,1,14,0,0.0,0.0
1016,2627,27-09-2019 03:12:00,0,803.0,510.0,0.635,3.729,10,0,0,0,10,1,9,0,0.0,0.0
1016,2628,27-09-2019 03:14:00,0,914.0,548.0,0.599,4.209,9,0,0,0,9,2,7,0,0.0,0.0
1016,2629,27-09-2019 03:16:00,0,914.0,541.0,0.591,4.201,11,0,0,0,11,0,11,0,0.0,0.0
1016,2630,27-09-2019 03:18:00,0,804.0,511.0,0.635,3.734,13,0,0,0,13,0,13,0,0.0,0.0
1016,2631,27-09-2019 03:20:00,0,808.0,513.0,0.635,3.752,20,17,1,16,3,0,3,0,0.0,0.0
1016,2632,27-09-2019 03:22:00,0,695.0,486.0,0.699,3.278,20,1,0,1,19,0,19,0,0.0,0.0
1016,2633,27-09-2019 03:24:00,0,852.5,524.0,0.628,3.9395,7,0,0,0,7,1,6,0,0.0,0.0
1016,2634,27-09-2019 03:26:00,0,1010.0,562.0,0.557,4.601,30,5,3,2,25,10,15,0,0.0,0.0
1016,2635,27-09-2019 03:28:00,0,988.0,675.0,0.684,4.64,134,61,26,35,73,45,28,0,0.0,0.0
1016,2636,27-09-2019 03:30:00,0,1503.0,981.0,0.653,7.009,162,93,65,28,69,56,13,14,0.0,0.0
1016,2637,27-09-2019 03:32:00,0,1577.0,1084.0,0.687,7.415,184,106,79,27,78,60,18,8,0.0,0.0
1016,2638,27-09-2019 03:34:00,0,1191.0,866.0,0.727,5.65,112,72,44,28,40,25,15,6,0.0,0.0
1016,2639,27-09-2019 03:36:00,0,1280.0,940.0,0.734,6.084,245,146,115,31,99,82,17,46,0.0,0.0
1016,2640,27-09-2019 03:38:00,0,1196.0,875.0,0.732,5.68,167,55,23,32,112,76,36,0,0.0,0.0
1016,2641,27-09-2019 03:40:00,0,1395.0,882.0,0.632,6.472,156,93,60,33,63,40,23,37,0.0,0.0
1016,2642,27-09-2019 03:42:00,0,1271.0,888.0,0.699,5.991,182,151,102,49,31,22,9,9,0.0,0.0
1016,2643,27-09-2019 03:44:00,0,1498.0,954.0,0.637,6.959,176,100,79,21,76,53,23,83,0.01,0.0
1016,2644,27-09-2019 03:46:00,0,1491.0,1013.0,0.679,6.995,382,220,179,41,162,129,33,167,0.0,0.0
1016,2645,27-09-2019 03:48:00,0,1482.0,1041.0,0.702,6.993,198,121,70,51,77,48,29,50,0.0,0.0
1016,2646,27-09-2019 03:50:00,0,1512.0,973.0,0.643,7.034,161,97,58,39,64,34,30,16,0.0,0.0
1016,2647,27-09-2019 03:52:00,0,1502.0,1039.0,0.691,7.069,119,97,52,45,22,0,22,0,0.0,0.0
1016,2648,27-09-2019 03:54:00,0,1509.0,969.0,0.642,7.017,140,101,64,37,39,23,16,0,0.0,0.0
1016,2649,27-09-2019 03:56:00,0,1510.0,984.0,0.652,7.039,438,182,144,38,256,192,64,59,0.03,0.0
1016,2650,27-09-2019 03:58:00,0,1496.5,1005.5,0.672,7.0095,86,46,19,27,40,18,22,0,0.0,0.0
1016,2651,27-09-2019 04:00:00,0,1483.0,1027.0,0.692,6.98,31,14,0,14,17,8,9,0,0.0,0.0
1016,2652,27-09-2019 04:02:00,0,1486.0,1038.0,0.699,7.004,230,154,118,36,76,54,22,102,0.0,0.0
1016,2653,27-09-2019 04:04:00,0,1397.0,895.0,0.641,6.494,126,71,52,19,55,28,27,25,0.0,0.0
1016,2654,27-09-2019 04:06:00,0,1508.0,983.0,0.652,7.032,31,20,10,10,11,6,5,0,0.0,0.0
1016,2655,27-09-2019 04:08:00,0,1189.0,845.0,0.71,5.622,8,8,3,5,0,0,0,0,0.0,0.0
1016,2656,27-09-2019 04:10:00,0,1218.0,752.0,0.618,5.631,0,0,0,0,0,0,0,0,0.01,0.0
1016,2657,27-09-2019 04:12:00,0,1106.0,679.0,0.613,5.11,9,0,0,0,9,0,9,0,0.0,0.0
1016,2658,27-09-2019 04:14:00,0,993.0,642.0,0.647,4.624,52,18,14,4,34,26,8,0,0.0,0.0
1016,2659,27-09-2019 04:16:00,0,1021.0,599.0,0.587,4.685,5,0,0,0,5,1,4,0,0.0,0.0
1016,2660,27-09-2019 04:18:00,0,1023.0,569.0,0.556,4.659,4,0,0,0,4,0,4,0,0.0,0.0
1016,2661,27-09-2019 04:20:00,0,1034.0,543.0,0.525,4.676,27,1,0,1,26,3,23,0,0.0,0.0
1016,2662,27-09-2019 04:22:00,0,797.0,513.0,0.644,3.708,42,2,0,2,40,11,29,0,0.0,0.0
1016,2663,27-09-2019 04:24:00,0,807.0,501.0,0.621,3.732,2,1,0,1,1,0,1,0,0.0,0.0
1016,2664,27-09-2019 04:26:00,0,687.0,488.0,0.711,3.246,6,0,0,0,6,0,6,0,0.0,0.0
1016,2665,27-09-2019 04:28:00,0,688.0,478.0,0.694,3.24,6,2,0,2,4,3,1,0,0.0,0.0
1016,2666,27-09-2019 04:30:00,0,703.0,462.0,0.658,3.282,3,0,0,0,3,1,2,0,0.0,0.0
1016,2667,27-09-2019 04:32:00,0,867.0,526.0,0.615,3.998,1,0,0,0,1,0,1,0,0.01,0.0
1016,2668,27-09-2019 04:34:00,0,1031.0,590.0,0.572,4.714,3,0,0,0,3,0,3,0,0.0,0.0
1016,2669,27-09-2019 04:36:00,0,903.0,550.0,0.609,4.167,25,11,4,7,14,8,6,0,0.0,0.0
1016,2670,27-09-2019 04:38:00,0,797.0,520.0,0.652,3.718,3,0,0,0,3,0,3,0,0.0,0.0
1016,2671,27-09-2019 04:40:00,0,683.0,492.0,0.72,3.236,2,1,0,1,1,0,1,0,0.0,0.0
1016,2672,27-09-2019 04:42:00,0,699.0,473.0,0.677,3.277,7,5,0,5,2,0,2,0,0.0,0.0
1016,2673,27-09-2019 04:44:00,0,707.0,453.0,0.641,3.288,6,3,0,3,3,0,3,0,0.0,0.0
1016,2674,27-09-2019 04:46:00,0,710.0,444.0,0.626,3.288,10,4,0,4,6,0,6,0,0.0,0.0
1016,2675,27-09-2019 04:48:00,0,707.0,441.0,0.623,3.274,4,0,0,0,4,1,3,0,0.0,0.0
1016,2676,27-09-2019 04:50:00,0,706.0,452.0,0.641,3.282,92,36,16,20,56,39,17,0,0.0,0.0
1016,2677,27-09-2019 04:52:00,0,1018.0,595.0,0.585,4.668,223,135,98,37,88,65,23,39,0.0,0.0
1016,2678,27-09-2019 04:54:00,0,1202.0,748.0,0.622,5.562,140,104,70,34,36,28,8,3,0.0,0.0
1016,2679,27-09-2019 04:56:00,0,1186.0,801.0,0.675,5.558,148,105,64,41,43,32,11,41,0.0,0.0
1016,2680,27-09-2019 04:58:00,0,1176.0,851.0,0.724,5.576,98,63,34,29,35,12,23,0,0.02,0.0
1016,2681,27-09-2019 05:00:00,0,1681.0,1180.0,0.702,7.93,161,75,52,23,86,68,18,116,0.05,0.0
1016,2682,27-09-2019 05:02:00,0,1417.0,860.0,0.607,6.534,237,142,92,50,95,58,37,22,0.0,0.0
1016,2683,27-09-2019 05:04:00,0,1210.0,783.0,0.647,5.635,158,90,49,41,68,41,27,3,0.0,0.0
1016,2684,27-09-2019 05:06:00,0,1456.0,973.0,0.665,6.815,68,58,32,26,10,4,6,2,0.0,0.0
1016,2685,27-09-2019 05:08:00,0,1702.0,1163.0,0.683,7.995,56,27,17,10,29,22,7,2,0.0,0.0
1016,2686,27-09-2019 05:10:00,0,1397.0,937.0,0.67,6.543,334,292,218,74,42,30,12,6,0.0,0.0
1016,2687,27-09-2019 05:12:00,0,1496.0,935.0,0.625,6.93,175,165,111,54,10,7,3,0,0.0,0.0
1016,2688,27-09-2019 05:14:00,0,1169.0,861.0,0.737,5.558,100,54,40,14,46,32,14,0,0.0,0.0
1016,2689,27-09-2019 05:16:00,0,1202.0,789.0,0.656,5.61,122,26,8,18,96,71,25,0,0.0,0.0
1016,2690,27-09-2019 05:18:00,0,1204.0,791.0,0.657,5.619,99,5,2,3,94,53,41,0,0.0,0.0
1016,2691,27-09-2019 05:20:00,0,1201.0,793.0,0.66,5.61,39,25,11,14,14,0,14,0,0.0,0.0
1016,2692,27-09-2019 05:22:00,0,1209.0,720.0,0.595,5.563,37,8,6,2,29,16,13,0,0.0,0.0
1016,2693,27-09-2019 05:24:00,0,998.0,652.0,0.653,4.655,5,1,0,1,4,0,4,0,0.0,0.0
1016,2694,27-09-2019 05:26:00,0,1015.0,581.0,0.572,4.641,22,20,7,13,2,0,2,0,0.0,0.0
1016,2695,27-09-2019 05:28:00,0,905.0,534.0,0.59,4.156,10,3,1,2,7,0,7,0,0.0,0.0
1016,2696,27-09-2019 05:30:00,0,808.0,509.0,0.63,3.746,4,0,0,0,4,0,4,0,0.0,0.0
1016,2697,27-09-2019 05:32:00,0,690.0,484.0,0.702,3.256,51,11,3,8,40,21,19,0,0.0,0.0
1016,2698,27-09-2019 05:34:00,0,698.0,470.0,0.673,3.27,20,1,0,1,19,2,17,0,0.0,0.0
1016,2699,27-09-2019 05:36:00,0,706.0,454.0,0.643,3.285,13,0,0,0,13,0,13,0,0.0,0.0
1016,2700,27-09-2019 05:38:00,0,718.0,411.0,0.573,3.283,10,0,0,0,10,2,8,0,0.0,0.0
1016,2701,27-09-2019 05:40:00,0,704.5,433.5,0.616,3.2555,16,0,0,0,16,6,10,0,0.0,0.0
1016,2702,27-09-2019 05:42:00,0,691.0,456.0,0.659,3.228,157,2,0,2,155,103,52,0,0.0,0.0
1016,2703,27-09-2019 05:44:00,0,696.0,481.0,0.691,3.273,63,5,0,5,58,31,27,0,0.0,0.0
1016,2704,27-09-2019 05:46:00,0,695.0,481.0,0.693,3.271,64,0,0,0,64,35,29,0,0.0,0.0
1016,2705,27-09-2019 05:48:00,0,696.0,478.0,0.686,3.27,44,1,0,1,43,22,21,0,0.0,0.0
1016,2706,27-09-2019 05:50:00,0,706.0,470.0,0.665,3.303,38,0,0,0,38,12,26,0,0.0,0.0
1016,2707,27-09-2019 05:52:00,0,699.0,463.0,0.662,3.265,51,0,0,0,51,21,30,0,0.0,0.0
1016,2708,27-09-2019 05:54:00,0,705.0,469.0,0.665,3.299,99,0,0,0,99,54,45,0,0.0,0.0
1016,2709,27-09-2019 05:56:00,0,693.0,480.0,0.693,3.26,347,36,26,10,311,247,64,13,0.0,0.0
1016,2710,27-09-2019 05:58:00,0,985.0,696.0,0.707,4.651,167,78,65,13,89,57,32,23,0.0,0.0
1016,2711,27-09-2019 06:00:00,1,1007.0,599.0,0.595,4.633,70,33,18,15,37,21,16,7,0.0,0.01
1016,2712,27-09-2019 06:02:00,1,1193.0,834.0,0.7,5.623,182,82,60,22,100,43,57,42,0.0,0.01
1016,2713,27-09-2019 06:04:00,1,1714.0,1097.0,0.64,7.969,176,63,45,18,113,56,57,46,0.0,0.0
1016,2714,27-09-2019 06:06:00,1,2012.0,1308.0,0.65,9.377,92,32,21,11,60,2,58,48,0.0,0.05
1016,2715,27-09-2019 06:08:00,1,2233.0,1452.0,0.65,10.407,105,37,26,11,68,11,57,55,0.0,0.05
1016,2716,27-09-2019 06:10:00,1,1991.0,1396.0,0.701,9.392,86,18,10,8,68,17,51,51,0.0,0.05
1016,2717,27-09-2019 06:12:00,1,2095.0,1446.0,0.69,9.855,75,24,12,12,51,2,49,47,0.0,0.08
1016,2718,27-09-2019 06:14:00,1,2167.5,1566.0,0.7215,10.273,69,10,6,4,59,0,59,41,0.0,0.06
1016,2719,27-09-2019 06:16:00,1,2240.0,1686.0,0.753,10.691,190,72,53,19,118,54,64,63,0.0,0.02
1016,2720,27-09-2019 06:18:00,1,2246.0,1716.0,0.764,10.749,296,83,63,20,213,154,59,26,0.25,0.01
1016,2721,27-09-2019 06:20:00,1,2159.0,1638.0,0.759,10.319,77,20,11,9,57,19,38,36,0.01,0.53
1016,2722,27-09-2019 06:22:00,1,2136.0,1752.0,0.821,10.355,0,0,0,0,0,0,0,0,0.0,0.01
1016,2723,27-09-2019 06:24:00,1,2142.0,1673.0,0.781,10.293,213,76,55,21,137,99,38,12,0.14,0.01
1016,2724,27-09-2019 06:26:00,1,1644.0,1334.0,0.811,7.955,16,4,1,3,12,6,6,0,0.07,0.0
1016,2725,27-09-2019 06:28:00,1,1640.0,1331.0,0.811,7.937,3,3,0,3,0,0,0,0,0.0,0.0
1016,2726,27-09-2019 06:30:00,1,1622.0,1346.0,0.83,7.88,88,13,7,6,75,68,7,0,0.0,0.0
1016,2727,27-09-2019 06:32:00,1,1948.0,1559.0,0.8,9.402,407,114,90,24,293,232,61,71,0.19,0.0
1016,2728,27-09-2019 06:34:00,1,2042.0,1639.0,0.803,9.86,103,46,24,22,57,1,56,62,0.0,0.01
1016,2729,27-09-2019 06:36:00,1,2036.0,1657.0,0.814,9.858,57,40,25,15,17,5,12,21,0.0,0.0
1016,2730,27-09-2019 06:38:00,1,2322.0,1909.0,0.822,11.264,173,11,1,10,162,135,27,0,0.02,0.02
1016,2731,27-09-2019 06:40:00,1,1637.0,1409.0,0.86,8.01,26,12,11,1,14,14,0,0,0.19,0.0
1016,2732,27-09-2019 06:42:00,1,1918.0,1575.0,0.821,9.299,47,13,3,10,34,8,26,0,0.0,0.0
1016,2733,27-09-2019 06:44:00,1,1924.0,1518.0,0.789,9.262,199,97,66,31,102,67,35,11,0.14,0.0
1016,2734,27-09-2019 06:46:00,1,1625.0,1405.0,0.864,7.958,178,58,43,15,120,66,54,51,0.1,0.0
1016,2735,27-09-2019 06:48:00,1,1773.5,1500.5,0.8475,8.6485,64,20,12,8,44,0,44,64,0.01,0.0
1016,2736,27-09-2019 06:50:00,1,1922.0,1596.0,0.831,9.339,81,34,18,16,47,3,44,52,0.0,0.0
1016,2737,27-09-2019 06:52:00,1,1914.0,1654.0,0.865,9.371,96,49,30,19,47,5,42,63,0.0,0.0
1016,2738,27-09-2019 06:54:00,1,1903.0,1755.0,0.922,9.44,245,43,17,26,202,137,65,14,0.18,0.08
1016,2739,27-09-2019 06:56:00,1,1941.0,1817.0,0.936,9.66,113,48,25,23,65,31,34,29,0.0,0.0
1016,2740,27-09-2019 06:58:00,1,1709.0,1486.0,0.87,8.38,225,117,80,37,108,54,54,71,0.04,0.0
1016,2741,27-09-2019 07:00:00,1,1801.0,1620.0,0.899,8.888,137,81,57,24,56,21,35,55,0.0,0.05
1016,2742,27-09-2019 07:02:00,1,1699.0,1569.0,0.924,8.433,193,71,42,29,122,84,38,43,0.01,0.03
1016,2743,27-09-2019 07:04:00,1,1934.0,1629.0,0.842,9.426,97,44,25,19,53,11,42,35,0.0,0.02
1016,2744,27-09-2019 07:06:00,1,1430.0,1273.0,0.891,7.043,271,118,96,22,153,106,47,36,0.14,0.01
1016,2745,27-09-2019 07:08:00,1,1939.0,1618.0,0.834,9.433,90,49,28,21,41,1,40,60,0.0,0.01
1016,2746,27-09-2019 07:10:00,1,1912.0,1631.0,0.853,9.34,182,47,30,17,135,70,65,39,0.08,0.04
1016,2747,27-09-2019 07:12:00,1,1316.0,1173.0,0.891,6.485,266,127,98,29,139,93,46,9,0.0,0.12
1016,2748,27-09-2019 07:14:00,1,1701.0,1515.0,0.891,8.379,132,60,32,28,72,25,47,53,0.01,0.0
1016,2749,27-09-2019 07:16:00,1,1787.0,1621.0,0.907,8.835,196,77,44,33,119,60,59,47,0.1,0.0
1016,2750,27-09-2019 07:18:00,1,1804.0,1615.0,0.895,8.895,92,47,22,25,45,0,45,56,0.02,0.0
1016,2751,27-09-2019 07:20:00,1,1700.0,1591.0,0.936,8.46,131,56,35,21,75,27,48,54,0.0,0.0
1016,2752,27-09-2019 07:22:00,1,1898.5,1721.0,0.9095,9.386,230,93,66,27,137,84,53,48,0.04,0.0
1016,2753,27-09-2019 07:24:00,1,2097.0,1851.0,0.883,10.312,329,177,135,42,152,100,52,37,0.0,0.04
1016,2754,27-09-2019 07:26:00,1,1991.0,1858.0,0.933,9.903,139,57,36,21,82,25,57,66,0.01,0.0
1016,2755,27-09-2019 07:28:00,1,2210.0,1935.0,0.875,10.851,104,61,41,20,43,2,41,57,0.02,0.0
1016,2756,27-09-2019 07:30:00,1,1812.0,1555.0,0.858,8.862,191,104,73,31,87,43,44,52,0.0,0.0
1016,2757,27-09-2019 07:32:00,1,1973.0,1797.0,0.911,9.761,86,28,15,13,58,0,58,42,0.01,0.01
1016,2758,27-09-2019 07:34:00,1,1962.0,1839.0,0.937,9.766,79,33,13,20,46,0,46,63,0.0,0.0
1016,2759,27-09-2019 07:36:00,1,1893.0,1696.0,0.896,9.335,138,61,40,21,77,25,52,55,0.0,0.04
1016,2760,27-09-2019 07:38:00,1,1816.0,1573.0,0.866,8.895,244,81,46,35,163,107,56,46,0.12,0.14
1016,2761,27-09-2019 07:40:00,1,1348.0,1117.0,0.829,6.549,855,417,337,80,438,350,88,13,0.0,0.0
1016,2762,27-09-2019 07:42:00,1,1630.0,1397.0,0.857,7.97,554,293,233,60,261,198,63,8,0.0,0.0
1016,2763,27-09-2019 07:44:00,1,1346.0,1163.0,0.864,6.591,102,36,17,19,66,43,23,0,0.0,0.0
1016,2764,27-09-2019 07:46:00,1,1537.0,1350.0,0.879,7.549,108,44,14,30,64,35,29,0,0.0,0.0
1016,2765,27-09-2019 07:48:00,1,1719.0,1452.0,0.845,8.383,128,61,27,34,67,43,24,0,0.0,0.0
1016,2766,27-09-2019 07:50:00,1,1424.0,1192.0,0.837,6.929,51,0,0,0,51,29,22,0,0.01,0.0
1016,2767,27-09-2019 07:52:00,1,1528.0,1285.0,0.841,7.443,27,0,0,0,27,12,15,0,0.0,0.0
1016,2768,27-09-2019 07:54:00,1,1325.0,1137.0,0.858,6.481,10,3,2,1,7,3,4,0,0.0,0.0
1016,2769,27-09-2019 07:56:00,1,1327.5,1165.5,0.878,6.5215,14,0,0,0,14,0,14,0,0.0,0.0
1016,2770,27-09-2019 07:58:00,1,1330.0,1194.0,0.898,6.562,69,17,10,7,52,34,18,0,0.0,0.0
1016,2771,27-09-2019 08:00:00,1,1337.0,1186.0,0.886,6.581,36,1,1,0,35,21,14,0,0.0,0.0
1016,2772,27-09-2019 08:02:00,1,1430.0,1263.0,0.883,7.033,33,0,0,0,33,17,16,0,0.0,0.0
1016,2773,27-09-2019 08:04:00,1,1409.0,1336.0,0.948,7.03,29,0,0,0,29,12,17,0,0.01,0.0
1016,2774,27-09-2019 08:06:00,1,1422.0,1250.0,0.879,6.989,22,1,0,1,21,6,15,0,0.0,0.0
1016,2775,27-09-2019 08:08:00,1,1394.0,1278.0,0.916,6.909,283,56,25,31,227,174,53,1,0.0,0.0
1016,2776,27-09-2019 08:10:00,1,1418.0,1282.0,0.905,7.005,69,19,10,9,50,28,22,0,0.0,0.0
1016,2777,27-09-2019 08:12:00,1,1211.0,1224.0,1.011,6.128,13,0,0,0,13,6,7,0,0.0,0.0
1016,2778,27-09-2019 08:14:00,1,1220.0,1151.0,0.943,6.081,34,4,1,3,30,17,13,0,0.0,0.0
1016,2779,27-09-2019 08:16:00,1,1242.0,1130.0,0.91,6.144,29,7,0,7,22,9,13,0,0.0,0.0
1016,2780,27-09-2019 08:18:00,1,1236.0,1117.0,0.903,6.107,38,7,0,7,31,14,17,0,0.0,0.0
1016,2781,27-09-2019 08:20:00,1,1235.0,1070.0,0.866,6.052,23,0,0,0,23,11,12,0,0.0,0.0
1016,2782,27-09-2019 08:22:00,1,1014.0,1014.0,1.0,5.117,36,0,0,0,36,22,14,0,0.0,0.0
1016,2783,27-09-2019 08:24:00,1,899.0,996.0,1.108,4.645,27,0,0,0,27,12,15,0,0.0,0.0
1016,2784,27-09-2019 08:26:00,1,1015.0,1018.0,1.003,5.125,30,0,0,0,30,20,10,0,0.0,0.0
1016,2785,27-09-2019 08:28:00,1,935.0,912.0,0.976,4.692,49,6,4,2,43,25,18,0,0.0,0.0
1016,2786,27-09-2019 08:30:00,1,923.5,958.0,1.0385,4.6985,18,0,0,0,18,2,16,0,0.0,0.0
1016,2787,27-09-2019 08:32:00,1,912.0,1004.0,1.101,4.705,23,7,1,6,16,7,9,0,0.0,0.0
1016,2788,27-09-2019 08:34:00,1,906.0,1000.0,1.104,4.678,20,1,0,1,19,11,8,0,0.0,0.0
1016,2789,27-09-2019 08:36:00,1,905.0,1005.0,1.11,4.679,24,3,1,2,21,11,10,0,0.0,0.0
1016,2790,27-09-2019 08:38:00,1,915.0,929.0,1.016,4.632,54,26,0,26,28,13,15,0,0.0,0.0
1016,2791,27-09-2019 08:40:00,1,923.0,990.0,1.073,4.732,36,15,0,15,21,11,10,0,0.0,0.0
1016,2792,27-09-2019 08:42:00,1,906.0,1005.0,1.109,4.682,20,1,0,1,19,8,11,0,0.0,0.0
1016,2793,27-09-2019 08:44:00,1,914.0,1019.0,1.114,4.73,10,0,0,0,10,0,10,0,0.0,0.0
1016,2794,27-09-2019 08:46:00,1,911.0,1006.0,1.104,4.703,141,11,6,5,130,87,43,0,0.0,0.0
1016,2795,27-09-2019 08:48:00,1,903.0,1027.0,1.137,4.693,87,7,2,5,80,57,23,0,0.0,0.0
1016,2796,27-09-2019 08:50:00,1,1010.0,1062.0,1.051,5.154,28,0,0,0,28,10,18,0,0.0,0.0
1016,2797,27-09-2019 08:52:00,1,1211.0,1159.0,0.957,6.055,17,0,0,0,17,6,11,0,0.01,0.0
1016,2798,27-09-2019 08:54:00,1,1104.0,1122.0,1.016,5.593,19,4,2,2,15,5,10,0,0.0,0.0
1016,2799,27-09-2019 08:56:00,1,893.0,1037.0,1.162,4.665,13,0,0,0,13,2,11,0,0.0,0.0
1016,2800,27-09-2019 08:58:00,1,889.0,1035.0,1.164,4.648,31,6,0,6,25,11,14,0,0.0,0.0
1016,2801,27-09-2019 09:00:00,1,896.0,1070.0,1.195,4.715,64,9,4,5,55,29,26,0,0.0,0.0
1016,2802,27-09-2019 09:02:00,1,914.0,1024.0,1.12,4.735,179,76,55,21,103,58,45,22,0.0,0.0
1016,2803,27-09-2019 09:04:00,1,1348.5,1327.0,1.017,6.783,34,8,5,3,26,0,26,22,0.0,0.0
1016,2804,27-09-2019 09:06:00,1,1783.0,1630.0,0.914,8.831,70,25,12,13,45,0,45,30,0.0,0.0
1016,2805,27-09-2019 09:08:00,1,1796.0,1604.0,0.893,8.853,65,54,25,29,11,4,7,2,0.0,0.0
1016,2806,27-09-2019 09:10:00,1,1686.0,1510.0,0.895,8.316,76,32,18,14,44,2,42,37,0.0,0.0
1016,2807,27-09-2019 09:12:00,1,2007.0,1739.0,0.866,9.832,77,27,15,12,50,0,50,56,0.0,0.0
1016,2808,27-09-2019 09:14:00,1,2022.0,1780.0,0.88,9.939,55,17,9,8,38,0,38,39,0.0,0.0
1016,2809,27-09-2019 09:16:00,1,1994.0,1818.0,0.912,9.868,73,27,5,22,46,0,46,52,0.0,0.0
1016,2810,27-09-2019 09:18:00,1,1911.0,1725.0,0.903,9.438,93,36,19,17,57,0,57,68,0.0,0.0
1016,2811,27-09-2019 09:20:00,1,1804.0,1674.0,0.928,8.962,82,24,13,11,58,0,58,51,0.0,0.08
1016,2812,27-09-2019 09:22:00,1,2017.0,1753.0,0.869,9.887,99,45,29,16,54,0,54,56,0.0,0.04
1016,2813,27-09-2019 09:24:00,1,1791.0,1656.0,0.924,8.892,99,34,16,18,65,0,65,61,0.0,0.1
1016,2814,27-09-2019 09:26:00,1,1985.0,1781.0,0.897,9.791,217,95,67,28,122,61,61,46,0.11,0.04
1016,2815,27-09-2019 09:28:00,1,1978.0,1826.0,0.923,9.817,300,132,106,26,168,119,49,42,0.16,0.02
1016,2816,27-09-2019 09:30:00,1,2010.0,1766.0,0.879,9.874,380,175,130,45,205,139,66,46,0.07,0.0
1016,2817,27-09-2019 09:32:00,1,1536.0,1330.0,0.866,7.524,504,297,239,58,207,141,66,32,0.0,0.0
1016,2818,27-09-2019 09:34:00,1,2017.0,1743.0,0.864,9.875,111,57,30,27,54,2,52,61,0.01,0.03
1016,2819,27-09-2019 09:36:00,1,1802.0,1633.0,0.906,8.91,115,61,34,27,54,0,54,58,0.0,0.06
1016,2820,27-09-2019 09:38:00,1,1832.0,1737.0,0.947,9.1425,88,27,16,11,61,0,61,42,0.0,0.08
1016,2821,27-09-2019 09:40:00,1,1862.0,1841.0,0.988,9.375,293,121,95,26,172,104,68,29,0.17,0.01
1016,2822,27-09-2019 09:42:00,1,1902.0,1679.0,0.883,9.352,430,264,204,60,166,129,37,2,0.05,0.0
1016,2823,27-09-2019 09:44:00,1,1682.0,1607.0,0.955,8.407,518,194,155,39,324,234,90,0,0.0,0.0
1016,2824,27-09-2019 09:46:00,1,1609.0,1459.0,0.907,7.954,464,200,150,50,264,203,61,1,0.0,0.0
1016,2825,27-09-2019 09:48:00,1,1448.0,1215.0,0.839,7.051,309,24,3,21,285,230,55,0,0.0,0.01
1016,2826,27-09-2019 09:50:00,1,1516.0,1399.0,0.923,7.521,110,1,1,0,109,76,33,0,0.0,0.0
1016,2827,27-09-2019 09:52:00,1,1618.0,1435.0,0.887,7.961,354,1,1,0,353,303,50,0,0.0,0.0
1016,2828,27-09-2019 09:54:00,1,1417.0,1327.0,0.937,7.051,504,0,0,0,504,451,53,0,0.0,0.0
1016,2829,27-09-2019 09:56:00,1,1438.0,1228.0,0.854,7.025,364,1,1,0,363,314,49,0,0.0,0.0
1016,2830,27-09-2019 09:58:00,1,1338.0,1203.0,0.899,6.601,260,0,0,0,260,225,35,0,0.01,0.0
1016,2831,27-09-2019 10:00:00,1,1207.0,1140.0,0.944,6.018,192,2,1,1,190,167,23,0,0.0,0.0
1016,2832,27-09-2019 10:02:00,1,1225.0,1118.0,0.913,6.063,175,2,0,2,173,147,26,0,0.0,0.0
1016,2833,27-09-2019 10:04:00,1,1219.0,1108.0,0.909,6.03,113,8,0,8,105,91,14,0,0.0,0.0
1016,2834,27-09-2019 10:06:00,1,1230.0,1082.0,0.88,6.043,161,11,5,6,150,128,22,0,0.0,0.0
1016,2835,27-09-2019 10:08:00,1,1033.0,1039.0,1.005,5.222,36,0,0,0,36,16,20,0,0.0,0.01
1016,2836,27-09-2019 10:10:00,1,944.0,912.0,0.966,4.727,28,0,0,0,28,7,21,0,0.0,0.0
1016,2837,27-09-2019 10:12:00,1,974.5,987.5,1.0115,4.9315,37,3,3,0,34,19,15,0,0.0,0.0
1016,2838,27-09-2019 10:14:00,1,1005.0,1063.0,1.057,5.136,63,1,1,0,62,37,25,0,0.0,0.0
1016,2839,27-09-2019 10:16:00,1,996.0,1062.0,1.066,5.099,40,0,0,0,40,21,19,0,0.0,0.0
1016,2840,27-09-2019 10:18:00,1,906.0,1015.0,1.12,4.691,56,1,0,1,55,26,29,0,0.0,0.0
1016,2841,27-09-2019 10:20:00,1,1007.0,1085.0,1.078,5.167,140,12,7,5,128,80,48,0,0.0,0.0
1016,2842,27-09-2019 10:22:00,1,893.0,1086.0,1.216,4.719,73,1,0,1,72,45,27,0,0.01,0.0
1016,2843,27-09-2019 10:24:00,1,907.0,1038.0,1.144,4.723,669,14,9,5,655,585,70,0,0.0,0.0
1016,2844,27-09-2019 10:26:00,1,907.0,1028.0,1.133,4.713,21,0,0,0,21,7,14,0,0.01,0.0
1016,2845,27-09-2019 10:28:00,1,912.0,962.0,1.054,4.658,0,0,0,0,0,0,0,0,0.0,0.0
1016,2846,27-09-2019 10:30:00,1,924.0,913.0,0.988,4.653,186,3,0,3,183,144,39,0,0.0,0.0
1016,2847,27-09-2019 10:32:00,1,932.0,894.0,0.959,4.663,435,1,0,1,434,396,38,0,0.0,0.0
1016,2848,27-09-2019 10:34:00,1,937.0,904.0,0.965,4.693,86,4,0,4,82,62,20,0,0.0,0.0
1016,2849,27-09-2019 10:36:00,1,900.0,1061.0,1.179,4.721,222,39,25,14,183,140,43,0,0.0,0.0
1016,2850,27-09-2019 10:38:00,1,917.0,987.0,1.077,4.704,48,2,0,2,46,22,24,0,0.0,0.0
1016,2851,27-09-2019 10:40:00,1,920.0,991.0,1.077,4.721,74,2,0,2,72,33,39,0,0.0,0.0
1016,2852,27-09-2019 10:42:00,1,1191.0,1256.0,1.054,6.084,339,54,29,25,285,217,68,0,0.0,0.0
1016,2853,27-09-2019 10:44:00,1,1197.0,1195.0,0.998,6.038,447,30,4,26,417,350,67,3,0.0,0.0
1016,2854,27-09-2019 10:46:00,1,1314.5,1220.0,0.934,6.529,90,12,1,11,78,46,32,0,0.0,0.0
1016,2855,27-09-2019 10:48:00,1,1432.0,1245.0,0.87,7.02,41,11,1,10,30,18,12,0,0.0,0.0
1016,2856,27-09-2019 10:50:00,1,1318.0,1244.0,0.944,6.569,30,3,2,1,27,12,15,0,0.0,0.0
1016,2857,27-09-2019 10:52:00,1,1420.0,1284.0,0.905,7.015,4,0,0,0,4,1,3,0,0.0,0.0
1016,2858,27-09-2019 10:54:00,1,1233.0,1102.0,0.893,6.079,35,15,5,10,20,7,13,0,0.0,0.0
1016,2859,27-09-2019 10:56:00,1,1231.0,1087.0,0.883,6.055,38,17,4,13,21,4,17,0,0.0,0.0
1016,2860,27-09-2019 10:58:00,1,1224.0,1106.0,0.903,6.048,37,12,4,8,25,11,14,0,0.0,0.0
1016,2861,27-09-2019 11:00:00,1,1227.0,1148.0,0.935,6.106,58,4,2,2,54,35,19,0,0.0,0.0
1016,2862,27-09-2019 11:02:00,1,1229.0,1168.0,0.95,6.135,73,17,1,16,56,32,24,0,0.0,0.0
1016,2863,27-09-2019 11:04:00,1,1248.0,1073.0,0.86,6.106,42,3,0,3,39,19,20,0,0.0,0.0
1016,2864,27-09-2019 11:06:00,1,1236.0,1135.0,0.918,6.128,21,2,0,2,19,9,10,0,0.0,0.0
1016,2865,27-09-2019 11:08:00,1,1211.0,1107.0,0.914,5.997,16,5,0,5,11,0,11,0,0.0,0.0
1016,2866,27-09-2019 11:10:00,1,1226.0,1119.0,0.912,6.071,11,1,0,1,10,0,10,0,0.0,0.0
1016,2867,27-09-2019 11:12:00,1,1237.0,1102.0,0.891,6.094,9,2,0,2,7,0,7,0,0.0,0.0
1016,2868,27-09-2019 11:14:00,1,1203.0,1212.0,1.008,6.082,77,29,14,15,48,9,39,41,0.0,0.0
1016,2869,27-09-2019 11:16:00,1,1400.0,1425.0,1.018,7.092,73,17,7,10,56,0,56,61,0.0,0.04
1016,2870,27-09-2019 11:18:00,1,1413.0,1361.0,0.963,7.075,44,26,3,23,18,2,16,10,0.0,0.43
1016,2871,27-09-2019 11:20:00,1,1539.0,1447.0,0.9415,7.6665,31,31,0,31,0,0,0,0,0.0,0.0
1016,2872,27-09-2019 11:22:00,1,1665.0,1533.0,0.92,8.258,30,24,0,24,6,1,5,0,0.0,0.0
1016,2873,27-09-2019 11:24:00,1,1680.0,1623.0,0.966,8.418,28,28,0,28,0,0,0,0,0.0,0.0
1016,2874,27-09-2019 11:26:00,1,1792.0,1663.0,0.928,8.9,98,38,17,21,60,37,23,0,0.1,0.04
1016,2875,27-09-2019 11:28:00,1,1618.0,1477.0,0.913,8.011,155,88,67,21,67,46,21,68,0.01,0.0
1016,2876,27-09-2019 11:30:00,1,1811.0,1643.0,0.907,8.954,36,1,0,1,35,2,33,0,0.02,0.0
1016,2877,27-09-2019 11:32:00,1,1921.0,1720.0,0.895,9.475,6,0,0,0,6,0,6,0,0.0,0.0
1016,2878,27-09-2019 11:34:00,1,1863.0,1741.0,0.935,9.266,345,161,129,32,184,131,53,20,0.11,0.0
1016,2879,27-09-2019 11:36:00,1,1693.0,1503.0,0.888,8.336,114,54,26,28,60,34,26,0,0.01,0.0
1016,2880,27-09-2019 11:38:00,1,1883.0,1646.0,0.874,9.243,247,144,109,35,103,83,20,8,0.07,0.0
1016,2881,27-09-2019 11:40:00,1,1686.0,1594.0,0.945,8.41,686,290,229,61,396,310,86,2,0.06,0.0
1016,2882,27-09-2019 11:42:00,1,1693.0,1610.0,0.951,8.451,316,150,110,40,166,122,44,0,0.02,0.1
1016,2883,27-09-2019 11:44:00,1,1618.0,1431.0,0.884,7.961,365,217,166,51,148,105,43,0,0.0,0.0
1016,2884,27-09-2019 11:46:00,1,1916.0,1705.0,0.89,9.438,518,293,234,59,225,170,55,12,0.08,0.0
1016,2885,27-09-2019 11:48:00,1,1411.0,1337.0,0.948,7.039,400,239,176,63,161,122,39,3,0.03,0.0
1016,2886,27-09-2019 11:50:00,1,1714.0,1542.0,0.9,8.459,588,292,221,71,296,228,68,2,0.0,0.0
1016,2887,27-09-2019 11:52:00,1,1519.0,1378.0,0.907,7.51,210,92,54,38,118,81,37,1,0.0,0.0
1016,2888,27-09-2019 11:54:00,1,1602.0,1488.0,0.9275,7.959,95,19,7,12,76,33,43,0,0.0,0.0
1016,2889,27-09-2019 11:56:00,1,1685.0,1598.0,0.948,8.408,144,22,9,13,122,82,40,0,0.0,0.0
1016,2890,27-09-2019 11:58:00,1,1673.0,1654.0,0.988,8.423,258,41,14,27,217,151,66,0,0.0,0.0
1016,2891,27-09-2019 12:00:00,1,1688.0,1667.0,0.988,8.496,144,41,5,36,103,54,49,0,0.0,0.0
1016,2892,27-09-2019 12:02:00,1,1706.0,1611.0,0.944,8.507,66,13,0,13,53,11,42,0,0.0,0.0
1016,2893,27-09-2019 12:04:00,1,1616.0,1423.0,0.881,7.944,78,3,1,2,75,29,46,0,0.0,0.0
1016,2894,27-09-2019 12:06:00,1,1400.0,1331.0,0.95,6.99,51,0,0,0,51,11,40,0,0.0,0.0
1016,2895,27-09-2019 12:08:00,1,1437.0,1226.0,0.853,7.021,70,0,0,0,70,39,31,0,0.0,0.0
1016,2896,27-09-2019 12:10:00,1,1230.0,1131.0,0.92,6.097,29,0,0,0,29,17,12,0,0.0,0.0
1016,2897,27-09-2019 12:12:00,1,1257.0,1066.0,0.848,6.134,3,0,0,0,3,2,1,0,0.0,0.0
1016,2898,27-09-2019 12:14:00,1,1030.0,1013.0,0.984,5.178,9,0,0,0,9,9,0,0,0.0,0.0
1016,2899,27-09-2019 12:16:00,1,930.0,936.0,1.007,4.699,53,7,2,5,46,39,7,0,0.0,0.0
1016,2900,27-09-2019 12:18:00,1,927.0,921.0,0.994,4.671,11,0,0,0,11,4,7,0,0.0,0.0
1016,2901,27-09-2019 12:20:00,1,944.0,914.0,0.968,4.729,45,11,4,7,34,17,17,0,0.0,0.0
1016,2902,27-09-2019 12:22:00,1,917.0,908.0,0.99,4.618,4,4,0,4,0,0,0,0,0.0,0.0
1016,2903,27-09-2019 12:24:00,1,936.0,917.0,0.979,4.703,15,10,4,6,5,2,3,0,0.0,0.0
1016,2904,27-09-2019 12:26:00,1,950.0,823.0,0.866,4.654,4,0,0,0,4,1,3,0,0.0,0.0
1016,2905,27-09-2019 12:28:00,1,930.5,930.0,1.002,4.6955,6,1,0,1,5,2,3,0,0.0,0.0
1016,2906,27-09-2019 12:30:00,1,911.0,1037.0,1.138,4.737,48,23,11,12,25,11,14,0,0.0,0.0
1016,2907,27-09-2019 12:32:00,1,1131.0,1104.0,0.976,5.676,27,16,3,13,11,1,10,0,0.0,0.0
1016,2908,27-09-2019 12:34:00,1,1016.0,1085.0,1.068,5.204,6,3,0,3,3,1,2,0,0.0,0.0
1016,2909,27-09-2019 12:36:00,1,910.0,1002.0,1.101,4.694,3,1,0,1,2,1,1,0,0.0,0.0
1016,2910,27-09-2019 12:38:00,1,910.0,942.0,1.035,4.628,28,19,7,12,9,5,4,0,0.0,0.0
1016,2911,27-09-2019 12:40:00,1,913.0,943.0,1.032,4.643,4,0,0,0,4,2,2,0,0.0,0.0
1016,2912,27-09-2019 12:42:00,1,932.0,904.0,0.971,4.671,22,11,5,6,11,1,10,0,0.0,0.0
1016,2913,27-09-2019 12:44:00,1,938.0,896.0,0.955,4.689,21,9,2,7,12,4,8,0,0.0,0.0
1016,2914,27-09-2019 12:46:00,1,917.0,1001.0,1.092,4.721,22,12,7,5,10,4,6,0,0.0,0.0
1016,2915,27-09-2019 12:48:00,1,1129.0,1100.0,0.974,5.667,28,13,6,7,15,6,9,0,0.0,0.0
1016,2916,27-09-2019 12:50:00,1,1224.0,1152.0,0.942,6.097,63,25,13,12,38,22,16,0,0.0,0.0
