subject,interval,date_time,light,vo2,vco2,rer,heat,xyt,xt,xa,xf,yt,ya,yf,z,drink,feed
T24,1,09-10-2017 15:18:48,1,4033,3176,0.787,0.6,1014,515,98,613,499,123,622,0,0.0,0.0
T24,2,09-10-2017 15:38:48,1,2812,2111,0.751,0.4,410,336,33,369,74,9,83,0,0.0,0.0
T24,3,09-10-2017 15:58:48,1,2991,2262,0.756,0.4,31,18,3,21,13,0,13,0,0.0,0.0
T24,4,09-10-2017 16:18:48,1,2904,2196,0.756,0.4,42,31,2,33,11,4,15,0,0.0,0.0
T24,5,09-10-2017 16:38:48,1,2695,2009,0.745,0.4,77,62,6,68,15,2,17,0,0.0,0.0
T24,6,09-10-2017 16:58:48,1,2882,2197,0.762,0.4,103,45,3,48,58,5,63,0,0.0,0.0
T24,7,09-10-2017 17:18:48,1,2630,1970,0.749,0.4,4,4,2,6,0,0,0,0,0.0,0.0
T24,8,09-10-2017 17:38:48,1,4128,3210,0.778,0.6,1152,759,288,1047,393,125,518,29,0.0,0.04
T24,9,09-10-2017 17:58:48,1,3596,2992,0.832,0.5,1050,651,224,875,399,117,516,45,0.0,0.06
T24,10,09-10-2017 18:18:48,0,2859,2347,0.821,0.4,19,6,0,6,13,4,17,0,0.0,0.0
T24,11,09-10-2017 18:38:48,0,3042,2819,0.927,0.5,338,176,34,210,162,46,208,8,0.0,0.12
T24,12,09-10-2017 18:58:48,0,3455,3430,0.993,0.5,1318,805,263,1068,513,156,669,26,0.0,0.07
T24,13,09-10-2017 19:18:48,0,3676,3335,0.907,0.6,2818,1805,1117,2922,1013,495,1508,409,0.0,0.05
T24,14,09-10-2017 19:38:48,0,3690,3475,0.941,0.6,1741,1010,504,1514,731,285,1016,80,0.0,0.05
T24,15,09-10-2017 19:58:48,0,2829,2697,0.953,0.4,630,386,116,502,244,84,328,10,0.02,0.07
T24,16,09-10-2017 20:18:48,0,2940,2781,0.946,0.4,643,401,183,584,242,99,341,20,0.1,0.14
T24,17,09-10-2017 20:38:48,0,3591,3626,1.01,0.6,1563,1079,485,1564,484,219,703,131,0.08,0.16
T24,18,09-10-2017 20:58:48,0,3380,3405,1.007,0.5,2449,1603,1037,2640,846,437,1283,195,0.08,0.04
T24,19,09-10-2017 21:18:48,0,3563,3542,0.994,0.6,1366,800,407,1207,566,236,802,63,0.12,0.17
T24,20,09-10-2017 21:38:48,0,2669,2628,0.985,0.4,425,208,40,248,217,43,260,0,0.0,0.0
T24,21,09-10-2017 21:58:48,0,3187,3265,1.024,0.5,858,529,251,780,329,134,463,35,0.12,0.24
T24,22,09-10-2017 22:18:48,0,3450,3567,1.034,0.5,1059,526,299,825,533,216,749,40,0.12,0.12
T24,23,09-10-2017 22:38:48,0,3442,3518,1.022,0.5,637,367,182,549,270,98,368,50,0.08,0.11
T24,24,09-10-2017 22:58:48,0,2763,2806,1.015,0.4,361,187,21,208,174,35,209,0,0.0,0.0
T24,25,09-10-2017 23:18:48,0,2696,2728,1.012,0.4,70,55,1,56,15,8,23,0,0.0,0.0
T24,26,09-10-2017 23:38:48,0,3200,3255,1.017,0.5,218,128,32,160,90,47,137,0,0.02,0.01
T24,27,09-10-2017 23:58:48,0,2948,2960,1.004,0.5,1050,595,184,779,455,149,604,14,0.0,0.18
T24,28,10-10-2017 00:18:48,0,2732,2830,1.036,0.4,142,67,11,78,75,26,101,0,0.0,0.0
T24,29,10-10-2017 00:38:48,0,2780,2848,1.024,0.4,245,129,21,150,116,39,155,0,0.0,0.14
T24,30,10-10-2017 00:58:48,0,2735,2733,0.999,0.4,82,59,26,85,23,4,27,18,0.1,0.0
T24,31,10-10-2017 01:18:48,0,2682,2687,1.002,0.4,85,43,4,47,42,7,49,0,0.02,0.0
T24,32,10-10-2017 01:38:48,0,3715,3778,1.017,0.6,839,460,177,637,379,108,487,12,0.0,0.0
T24,33,10-10-2017 01:58:48,0,3594,3581,0.997,0.6,1662,982,276,1258,680,277,957,13,0.0,0.08
T24,34,10-10-2017 02:18:48,0,3437,3564,1.037,0.5,1314,774,333,1107,540,210,750,125,0.08,0.21
T24,35,10-10-2017 02:38:48,0,2759,2822,1.023,0.4,443,229,78,307,214,94,308,21,0.1,0.19
T24,36,10-10-2017 02:58:48,0,2688,2773,1.032,0.4,40,21,2,23,19,11,30,0,0.0,0.0
T24,37,10-10-2017 03:18:48,0,3321,3500,1.054,0.5,1244,601,176,777,643,158,801,15,0.08,0.16
T24,38,10-10-2017 03:38:48,0,3474,3585,1.032,0.5,1684,879,344,1223,805,277,1082,59,0.12,0.18
T24,39,10-10-2017 03:58:48,0,2664,2699,1.013,0.4,116,54,5,59,62,10,72,0,0.02,0.0
T24,40,10-10-2017 04:18:48,0,3464,3600,1.039,0.5,1165,723,342,1065,442,179,621,45,0.08,0.16
T24,41,10-10-2017 04:38:48,0,3338,3459,1.036,0.5,2129,1239,585,1824,890,312,1202,283,0.0,0.06
T24,42,10-10-2017 04:58:48,0,3852,3935,1.022,0.6,1243,683,235,918,560,208,768,54,0.06,0.1
T24,43,10-10-2017 05:18:48,0,2778,2743,0.988,0.4,418,302,60,362,116,35,151,0,0.0,0.0
T24,44,10-10-2017 05:38:48,0,2853,2825,0.99,0.4,121,65,11,76,56,12,68,0,0.0,0.0
T24,45,10-10-2017 05:58:48,0,3471,3483,1.004,0.5,1298,752,329,1081,546,265,811,48,0.04,0.12
T24,46,10-10-2017 06:18:48,1,3031,3025,0.998,0.5,1178,668,365,1033,510,222,732,352,0.04,0.03
T24,47,10-10-2017 06:38:48,1,2803,2725,0.972,0.4,49,28,0,28,21,0,21,0,0.0,0.0
T24,48,10-10-2017 06:58:48,1,2409,2337,0.97,0.4,382,181,40,221,201,47,248,14,0.0,0.05
T24,49,10-10-2017 07:18:48,1,2611,2513,0.962,0.4,39,22,2,24,17,5,22,0,0.0,0.0
T24,50,10-10-2017 07:38:48,1,3571,3443,0.964,0.5,995,553,264,817,442,177,619,34,0.0,0.1
T24,51,10-10-2017 07:58:48,1,2604,2506,0.962,0.4,705,308,38,346,397,63,460,7,0.0,0.0
T24,52,10-10-2017 08:18:48,1,2450,2260,0.923,0.4,40,31,11,42,9,2,11,0,0.0,0.0
T24,53,10-10-2017 08:38:48,1,2546,2208,0.867,0.4,42,21,7,28,21,5,26,0,0.02,0.0
T24,54,10-10-2017 08:58:48,1,2465,2161,0.877,0.4,299,192,53,245,107,48,155,2,0.0,0.0
T24,55,10-10-2017 09:18:48,1,2546,2220,0.872,0.4,50,33,1,34,17,5,22,0,0.0,0.0
T24,56,10-10-2017 09:38:48,1,2469,2086,0.845,0.4,18,12,4,16,6,1,7,0,0.0,0.0
T24,57,10-10-2017 09:58:48,1,3060,2659,0.869,0.5,646,348,53,401,298,92,390,0,0.0,0.07
T24,58,10-10-2017 10:18:48,1,2747,2720,0.99,0.4,877,532,217,749,345,154,499,26,0.1,0.06
T24,59,10-10-2017 10:38:48,1,2738,2454,0.896,0.4,441,231,17,248,210,28,238,0,0.0,0.0
T24,60,10-10-2017 10:58:48,1,2617,2197,0.84,0.4,42,16,3,19,26,5,31,0,0.0,0.0
T24,61,10-10-2017 11:18:48,1,2572,2140,0.832,0.4,61,41,8,49,20,2,22,0,0.0,0.0
T24,62,10-10-2017 11:38:48,1,2700,2230,0.826,0.4,71,28,7,35,43,8,51,0,0.0,0.0
T24,63,10-10-2017 11:58:48,1,3352,3194,0.953,0.5,1371,808,387,1195,563,250,813,50,0.04,0.19
T24,64,10-10-2017 12:18:48,1,3397,3239,0.953,0.5,1067,661,82,743,406,91,497,0,0.02,0.0
T24,65,10-10-2017 12:38:48,1,2663,2339,0.879,0.4,85,72,4,76,13,4,17,0,0.0,0.0
T24,66,10-10-2017 12:58:48,1,2588,2157,0.834,0.4,161,144,8,152,17,6,23,0,0.0,0.0
T24,67,10-10-2017 13:18:48,1,2852,2417,0.847,0.4,180,110,25,135,70,22,92,0,0.0,0.0
T24,68,10-10-2017 13:38:48,1,3462,3404,0.983,0.5,1040,542,262,804,498,209,707,50,0.12,0.22
T24,69,10-10-2017 13:58:48,1,3289,3186,0.969,0.5,778,466,234,700,312,122,434,17,0.0,0.08
T24,70,10-10-2017 14:18:48,1,2608,2533,0.971,0.4,428,237,17,254,191,25,216,0,0.0,0.02
T24,71,10-10-2017 14:38:48,1,2550,2317,0.909,0.4,42,20,4,24,22,10,32,0,0.02,0.0
T24,72,10-10-2017 14:58:48,1,2692,2419,0.898,0.4,60,33,4,37,27,13,40,0,0.0,-0.02
T24,73,10-10-2017 15:18:48,1,3295,3198,0.971,0.5,628,351,111,462,277,106,383,16,0.06,0.23
T24,74,10-10-2017 15:38:48,1,3469,3504,1.01,0.5,1195,705,273,978,490,189,679,33,0.1,0.02
T24,75,10-10-2017 15:58:48,1,2538,2460,0.969,0.4,92,28,4,32,64,24,88,0,0.0,0.0
T24,76,10-10-2017 16:18:48,1,2637,2446,0.928,0.4,115,74,25,99,41,22,63,0,0.0,0.0
T24,77,10-10-2017 16:38:48,1,2977,3019,1.014,0.5,723,433,116,549,290,96,386,22,0.08,0.17
T24,78,10-10-2017 16:58:48,1,2661,2639,0.991,0.4,146,70,24,94,76,17,93,0,0.0,0.0
T24,79,10-10-2017 17:18:48,1,2655,2454,0.925,0.4,32,17,1,18,15,4,19,0,0.0,0.0
T24,80,10-10-2017 17:38:48,1,3325,3161,0.951,0.5,1186,653,144,797,533,154,687,0,0.0,0.15
T24,81,10-10-2017 17:58:48,1,2899,2867,0.989,0.4,635,339,53,392,296,35,331,0,0.02,0.0
T24,82,10-10-2017 18:18:48,0,3729,3736,1.002,0.6,896,462,118,580,434,104,538,18,0.1,0.0
T24,83,10-10-2017 18:38:48,0,3549,3629,1.023,0.6,1525,845,361,1206,680,281,961,187,0.0,0.2
T24,84,10-10-2017 18:58:48,0,3475,3609,1.039,0.5,1287,705,267,972,582,205,787,76,0.08,0.25
T24,85,10-10-2017 19:18:48,0,3773,3925,1.04,0.6,1595,892,281,1173,703,243,946,102,0.1,0.03
T24,86,10-10-2017 19:38:48,0,3763,3981,1.058,0.6,1162,635,270,905,527,222,749,171,0.12,0.11
T24,87,10-10-2017 19:58:48,0,3167,3279,1.035,0.5,972,545,155,700,427,168,595,51,0.08,0.0
T24,88,10-10-2017 20:18:48,0,3588,3780,1.054,0.6,855,507,225,732,348,159,507,84,0.02,0.26
T24,89,10-10-2017 20:38:48,0,3476,3675,1.057,0.5,1551,879,392,1271,672,303,975,170,0.08,0.07
T24,90,10-10-2017 20:58:48,0,3690,3866,1.048,0.6,1522,813,379,1192,709,262,971,87,0.14,0.17
T24,91,10-10-2017 21:18:48,0,3418,3586,1.049,0.5,492,219,68,287,273,94,367,12,0.0,0.15
T24,92,10-10-2017 21:38:48,0,3027,3110,1.028,0.5,363,191,74,265,172,66,238,41,0.06,0.04
T24,93,10-10-2017 21:58:48,0,3395,3614,1.065,0.5,701,454,95,549,247,72,319,26,0.04,0.08
T24,94,10-10-2017 22:18:48,0,3240,3326,1.027,0.5,558,339,76,415,219,68,287,2,0.0,0.14
T24,95,10-10-2017 22:38:48,0,3690,3866,1.048,0.6,1458,829,318,1147,629,249,878,43,0.18,0.11
T24,96,10-10-2017 22:58:48,0,3055,3132,1.025,0.5,121,94,4,98,27,7,34,0,0.0,0.0
T24,97,10-10-2017 23:18:48,0,3155,3314,1.051,0.5,479,264,106,370,215,101,316,6,0.0,0.2
T24,98,10-10-2017 23:38:48,0,2855,2999,1.051,0.4,485,254,115,369,231,62,293,18,0.08,0.0
T24,99,10-10-2017 23:58:48,0,3343,3535,1.057,0.5,484,290,113,403,194,88,282,8,0.04,0.15
T24,100,11-10-2017 00:18:48,0,3608,3795,1.052,0.6,1447,676,123,799,771,163,934,0,0.0,0.02
T24,101,11-10-2017 00:38:48,0,3749,3844,1.025,0.6,1289,713,366,1079,576,240,816,73,0.18,0.2
T24,102,11-10-2017 00:58:48,0,2763,2766,1.001,0.4,159,94,19,113,65,15,80,0,0.02,0.0
T24,103,11-10-2017 01:18:48,0,3237,3130,0.967,0.5,323,167,65,232,156,66,222,0,0.0,0.03
T24,104,11-10-2017 01:38:48,0,3034,3122,1.029,0.5,829,453,63,516,376,109,485,0,0.0,0.18
T24,105,11-10-2017 01:58:48,0,2783,2827,1.016,0.4,55,27,6,33,28,9,37,0,0.0,0.0
T24,106,11-10-2017 02:18:48,0,2800,2780,0.993,0.4,140,73,5,78,67,15,82,0,0.0,0.0
T24,107,11-10-2017 02:38:48,0,3040,3090,1.016,0.5,990,558,86,644,432,117,549,0,0.0,0.11
T24,108,11-10-2017 02:58:48,0,3153,3107,0.985,0.5,207,118,50,168,89,37,126,16,0.06,0.0
T24,109,11-10-2017 03:18:48,0,3769,3871,1.027,0.6,1051,552,214,766,499,245,744,50,0.1,0.27
T24,110,11-10-2017 03:38:48,0,3722,3893,1.046,0.6,1719,832,153,985,887,242,1129,5,0.02,0.0
T24,111,11-10-2017 03:58:48,0,3577,3665,1.025,0.6,1465,792,239,1031,673,235,908,46,0.16,0.18
T24,112,11-10-2017 04:18:48,0,3668,3851,1.05,0.6,2035,1186,611,1797,849,380,1229,187,0.14,0.06
T24,113,11-10-2017 04:38:48,0,3596,3767,1.048,0.6,1259,659,236,895,600,221,821,54,0.02,0.09
T24,114,11-10-2017 04:58:48,0,2864,2831,0.988,0.4,349,157,30,187,192,45,237,0,0.0,0.0
T24,115,11-10-2017 05:18:48,0,2819,2903,1.03,0.4,572,312,75,387,260,93,353,9,0.0,0.13
T24,116,11-10-2017 05:38:48,0,3569,3691,1.034,0.6,1247,642,299,941,605,233,838,78,0.12,0.07
T24,117,11-10-2017 05:58:48,0,3358,3412,1.016,0.5,1693,916,353,1269,777,294,1071,35,0.02,0.08
T24,118,11-10-2017 06:18:48,1,3316,3203,0.966,0.5,1257,684,217,901,573,163,736,16,0.0,0.0
T24,119,11-10-2017 06:38:48,1,2713,2421,0.892,0.4,20,12,3,15,8,2,10,0,0.02,0.0
T24,120,11-10-2017 06:58:48,1,2774,2378,0.857,0.4,125,34,5,39,91,23,114,0,0.0,0.0
T24,121,11-10-2017 07:18:48,1,3367,2981,0.886,0.5,257,126,20,146,131,23,154,0,0.0,0.0
T24,122,11-10-2017 07:38:48,1,3471,3341,0.963,0.5,1208,655,288,943,553,184,737,44,0.02,0.11
T24,123,11-10-2017 07:58:48,1,2828,2496,0.882,0.4,54,24,1,25,30,6,36,0,0.0,0.0
T24,124,11-10-2017 08:18:48,1,2536,2228,0.878,0.4,64,31,10,41,33,3,36,0,0.02,0.0
T24,125,11-10-2017 08:38:48,1,3090,2660,0.861,0.5,243,164,30,194,79,19,98,0,0.0,0.04
T24,126,11-10-2017 08:58:48,1,3534,3462,0.98,0.5,1245,683,299,982,562,218,780,41,0.04,0.07
T24,127,11-10-2017 09:18:48,1,2830,2485,0.878,0.4,361,206,49,255,155,39,194,0,0.0,0.0
T24,128,11-10-2017 09:38:48,1,2755,2324,0.844,0.4,54,29,4,33,25,8,33,0,0.0,0.0
T24,129,11-10-2017 09:58:48,1,2515,2080,0.827,0.4,81,54,1,55,27,2,29,0,0.0,0.0
T24,130,11-10-2017 10:18:48,1,2523,2046,0.811,0.4,24,18,1,19,6,1,7,0,0.0,0.0
T24,131,11-10-2017 10:38:48,1,3420,3091,0.904,0.5,860,526,181,707,334,149,483,14,0.08,0.19
T24,132,11-10-2017 10:58:48,1,2623,2489,0.949,0.4,382,217,27,244,165,44,209,0,0.0,0.0
T24,133,11-10-2017 11:18:48,1,2741,2444,0.892,0.4,80,48,4,52,32,5,37,0,0.0,0.0
T24,134,11-10-2017 11:38:48,1,2754,2523,0.916,0.4,108,56,11,67,52,25,77,0,0.0,0.0
T24,135,11-10-2017 11:58:48,1,2730,2389,0.875,0.4,609,378,187,565,231,95,326,3,0.06,0.03
T24,136,11-10-2017 12:18:48,1,2431,2074,0.853,0.4,34,18,4,22,16,2,18,0,0.0,0.0
T24,137,11-10-2017 12:38:48,1,3282,2842,0.866,0.5,521,266,67,333,255,98,353,11,0.0,0.04
T24,138,11-10-2017 12:58:48,1,3412,3385,0.992,0.5,2237,1333,776,2109,904,389,1293,145,0.18,0.12
T24,139,11-10-2017 13:18:48,1,2656,2402,0.905,0.4,432,243,29,272,189,35,224,0,0.0,0.0
T24,140,11-10-2017 13:38:48,1,2594,2190,0.844,0.4,19,12,1,13,7,1,8,0,0.0,0.0
T24,141,11-10-2017 13:58:48,1,2563,2138,0.834,0.4,101,53,14,67,48,14,62,0,0.0,0.0
T24,142,11-10-2017 14:18:48,1,2974,2552,0.858,0.4,403,202,36,238,201,62,263,0,0.0,0.0
T24,143,11-10-2017 14:38:48,1,3372,2955,0.876,0.5,1371,668,161,829,703,173,876,0,0.0,0.1
T24,144,11-10-2017 14:58:48,1,3511,3156,0.899,0.5,1536,677,150,827,859,211,1070,0,0.02,0.0
T24,145,11-10-2017 15:18:48,1,2816,2711,0.963,0.4,1460,909,497,1406,551,237,788,59,0.08,0.14
T24,146,11-10-2017 15:38:48,1,2650,2411,0.91,0.4,77,35,2,37,42,6,48,0,0.0,0.0
T24,147,11-10-2017 15:58:48,1,2855,2524,0.884,0.4,234,160,31,191,74,20,94,0,0.02,0.0
T24,148,11-10-2017 16:18:48,1,3476,3524,1.014,0.5,1166,609,113,722,557,151,708,16,0.02,0.12
T24,149,11-10-2017 16:38:48,1,2990,2663,0.891,0.5,1157,556,116,672,601,82,683,0,0.0,0.0
T24,150,11-10-2017 16:58:48,1,2860,2275,0.795,0.4,88,38,14,52,50,10,60,0,0.02,0.0
T24,151,11-10-2017 17:18:48,1,2795,2272,0.813,0.4,319,181,23,204,138,51,189,0,0.0,0.0
T24,152,11-10-2017 17:38:48,1,3086,2809,0.91,0.5,901,541,260,801,360,148,508,18,0.0,0.13
T24,153,11-10-2017 17:58:48,1,2875,2803,0.975,0.4,125,52,11,63,73,10,83,0,0.0,0.05
T24,154,11-10-2017 18:18:48,0,3483,3578,1.027,0.5,859,509,95,604,350,86,436,0,0.0,0.04
T24,155,11-10-2017 18:38:48,0,3809,3827,1.005,0.6,1911,961,351,1312,950,318,1268,87,0.08,0.11
T24,156,11-10-2017 18:58:48,0,3744,3894,1.04,0.6,2551,1507,810,2317,1044,405,1449,229,0.16,0.1
T24,157,11-10-2017 19:18:48,0,3517,3621,1.03,0.5,2024,1103,548,1651,921,376,1297,119,0.08,0.14
T24,158,11-10-2017 19:38:48,0,3747,3940,1.051,0.6,2644,1517,905,2422,1127,593,1720,388,0.1,0.18
T24,159,11-10-2017 19:58:48,0,3768,4017,1.066,0.6,2700,1601,938,2539,1099,561,1660,377,0.12,0.18
T24,160,11-10-2017 20:18:48,0,3827,4071,1.064,0.6,2920,1762,1054,2816,1158,551,1709,283,0.08,0.14
T24,161,11-10-2017 20:38:48,0,3170,3272,1.032,0.5,673,310,42,352,363,114,477,0,0.0,0.0
T24,162,11-10-2017 20:58:48,0,3256,3315,1.018,0.5,533,295,128,423,238,107,345,12,0.0,0.18
T24,163,11-10-2017 21:18:48,0,3594,3807,1.059,0.6,3149,1894,1222,3116,1255,651,1906,275,0.14,0.11
T24,164,11-10-2017 21:38:48,0,3770,4039,1.071,0.6,4076,2496,1689,4185,1580,856,2436,366,0.14,0.15
T24,165,11-10-2017 21:58:48,0,3705,3925,1.059,0.6,1810,1116,497,1613,694,242,936,8,0.02,0.07
T24,166,11-10-2017 22:18:48,0,3624,3805,1.05,0.6,2169,1343,815,2158,826,352,1178,72,0.1,0.14
T24,167,11-10-2017 22:38:48,0,3273,3433,1.049,0.5,564,274,56,330,290,71,361,0,0.0,0.09
T24,168,11-10-2017 22:58:48,0,3450,3406,0.987,0.5,685,361,76,437,324,59,383,0,0.0,0.0
T24,169,11-10-2017 23:18:48,0,3349,3438,1.027,0.5,764,436,166,602,328,132,460,0,0.06,0.17
T24,170,11-10-2017 23:38:48,0,3569,3732,1.046,0.6,1921,1130,636,1766,791,299,1090,26,0.04,0.03
T24,171,11-10-2017 23:58:48,0,3003,2875,0.957,0.5,38,22,3,25,16,4,20,0,0.0,0.0
T24,172,12-10-2017 00:18:48,0,3326,3365,1.012,0.5,1126,649,334,983,477,213,690,11,0.02,0.2
T24,173,12-10-2017 00:38:48,0,3430,3443,1.004,0.5,706,371,90,461,335,114,449,18,0.02,0.0
T24,174,12-10-2017 00:58:48,0,3206,2970,0.926,0.5,52,24,3,27,28,8,36,0,0.0,0.0
T24,175,12-10-2017 01:18:48,0,3590,3469,0.966,0.6,2019,1196,499,1695,823,287,1110,6,0.0,0.06
T24,176,12-10-2017 01:38:48,0,3068,2723,0.887,0.5,530,245,38,283,285,46,331,0,0.0,0.0
T24,177,12-10-2017 01:58:48,0,3757,3823,1.018,0.6,2028,1270,769,2039,758,354,1112,260,0.16,0.25
T24,178,12-10-2017 02:18:48,0,3164,3262,1.031,0.5,1038,605,236,841,433,166,599,80,0.0,0.08
T24,179,12-10-2017 02:38:48,0,3025,3016,0.997,0.5,178,109,51,160,69,23,92,23,0.08,0.0
T24,180,12-10-2017 02:58:48,0,3573,3739,1.046,0.6,1079,607,241,848,472,206,678,25,0.1,0.28
T24,181,12-10-2017 03:18:48,0,3019,3138,1.039,0.5,635,353,115,468,282,86,368,14,0.04,0.03
T24,182,12-10-2017 03:38:48,0,3354,3479,1.037,0.5,805,474,125,599,331,108,439,11,0.0,0.08
T24,183,12-10-2017 03:58:48,0,3606,3778,1.048,0.6,2515,1522,794,2316,993,527,1520,198,0.1,0.12
T24,184,12-10-2017 04:18:48,0,3424,3528,1.031,0.5,2875,1698,1025,2723,1177,617,1794,134,0.08,0.02
T24,185,12-10-2017 04:38:48,0,3074,2852,0.928,0.5,379,242,35,277,137,38,175,0,0.0,0.0
T24,186,12-10-2017 04:58:48,0,3555,3461,0.973,0.5,2026,1110,438,1548,916,392,1308,25,0.04,0.16
T24,187,12-10-2017 05:18:48,0,3414,3459,1.013,0.5,2452,1456,831,2287,996,483,1479,233,0.12,0.08
T24,188,12-10-2017 05:38:48,0,4117,3985,0.968,0.6,1781,1033,513,1546,748,292,1040,15,0.02,0.02
T24,189,12-10-2017 05:58:48,0,2978,2576,0.865,0.4,191,115,20,135,76,13,89,0,0.0,0.0
T24,190,12-10-2017 06:18:48,1,3013,2494,0.828,0.4,107,78,5,83,29,9,38,0,0.0,0.0
T24,191,12-10-2017 06:38:48,1,2764,2313,0.837,0.4,166,81,22,103,85,24,109,0,0.0,-0.02
T24,192,12-10-2017 06:58:48,1,2727,2536,0.93,0.4,944,542,235,777,402,163,565,2,0.02,0.08
T24,193,12-10-2017 07:18:48,1,3129,2829,0.904,0.5,234,144,51,195,90,34,124,0,0.0,0.06
T24,194,12-10-2017 07:38:48,1,2745,2463,0.897,0.4,850,527,239,766,323,106,429,2,0.02,0.0
T24,195,12-10-2017 07:58:48,1,2651,2185,0.824,0.4,85,35,1,36,50,1,51,0,0.0,0.0
T24,196,12-10-2017 08:18:48,1,2739,2239,0.818,0.4,31,15,3,18,16,5,21,0,0.02,0.0
T24,197,12-10-2017 08:38:48,1,2694,2158,0.801,0.4,23,17,2,19,6,1,7,0,0.0,0.0
T24,198,12-10-2017 08:58:48,1,2668,2133,0.8,0.4,54,27,4,31,27,12,39,0,0.0,0.0
T24,199,12-10-2017 09:18:48,1,3698,3105,0.84,0.6,1926,1159,651,1810,767,328,1095,43,0.04,0.06
T24,200,12-10-2017 09:38:48,1,2682,2240,0.835,0.4,1154,677,229,906,477,141,618,3,0.02,0.0
T24,201,12-10-2017 09:58:48,1,2579,2065,0.801,0.4,9,4,1,5,5,0,5,0,0.0,0.0
T24,202,12-10-2017 10:18:48,1,2615,2055,0.786,0.4,58,26,5,31,32,5,37,0,0.02,0.0
T24,203,12-10-2017 10:38:48,1,2683,2148,0.801,0.4,77,42,4,46,35,7,42,0,0.0,0.0
T24,204,12-10-2017 10:58:48,1,3602,2966,0.824,0.5,1707,1058,460,1518,649,221,870,24,0.02,0.11
T24,205,12-10-2017 11:18:48,1,2836,2736,0.965,0.4,627,335,131,466,292,108,400,0,0.0,0.03
T24,206,12-10-2017 11:38:48,1,2979,2655,0.891,0.4,303,183,74,257,120,41,161,17,0.06,0.0
T24,207,12-10-2017 11:58:48,1,2831,2311,0.816,0.4,57,32,15,47,25,8,33,0,0.0,0.0
T24,208,12-10-2017 12:18:48,1,2502,2053,0.82,0.4,35,16,3,19,19,0,19,0,0.02,0.0
T24,209,12-10-2017 12:38:48,1,2387,1971,0.826,0.4,8,7,1,8,1,0,1,0,0.0,0.0
T24,210,12-10-2017 12:58:48,1,3463,3172,0.916,0.5,1165,770,237,1007,395,101,496,7,0.0,0.07
T24,211,12-10-2017 13:18:48,1,2606,2205,0.846,0.4,138,82,8,90,56,9,65,0,0.0,0.0
T24,212,12-10-2017 13:38:48,1,2700,2177,0.806,0.4,56,40,5,45,16,5,21,0,0.0,0.0
T24,213,12-10-2017 13:58:48,1,3232,2714,0.84,0.5,588,360,194,554,228,123,351,7,0.0,0.09
T24,214,12-10-2017 14:18:48,1,2668,2667,1.0,0.4,108,56,12,68,52,25,77,0,0.0,0.04
T24,215,12-10-2017 14:38:48,1,2530,2432,0.961,0.4,74,41,6,47,33,6,39,0,0.02,0.0
T24,216,12-10-2017 14:58:48,1,3274,3040,0.929,0.5,211,127,30,157,84,31,115,0,0.0,0.03
T24,217,12-10-2017 15:18:48,1,3558,3479,0.978,0.5,1220,546,166,712,674,156,830,19,0.1,0.07
T24,218,12-10-2017 15:38:48,1,2588,2295,0.887,0.4,54,37,2,39,17,7,24,0,0.0,0.0
T24,219,12-10-2017 15:58:48,1,3136,2892,0.922,0.5,332,107,26,133,225,41,266,0,0.0,0.0
T24,220,12-10-2017 16:18:48,1,2792,2770,0.992,0.4,871,572,162,734,299,91,390,25,0.06,0.16
T24,221,12-10-2017 16:38:48,1,2500,2320,0.928,0.4,26,9,1,10,17,5,22,0,0.02,0.0
T24,222,12-10-2017 16:58:48,1,2890,2697,0.933,0.4,366,188,50,238,178,70,248,0,0.0,0.13
T24,223,12-10-2017 17:18:48,1,2669,2601,0.974,0.4,573,251,23,274,322,67,389,8,0.0,0.0
T24,224,12-10-2017 17:38:48,1,2693,2530,0.939,0.4,105,71,13,84,34,13,47,0,0.0,0.0
T24,225,12-10-2017 17:58:48,1,3206,3111,0.97,0.5,596,337,116,453,259,92,351,11,0.08,0.15
T24,226,12-10-2017 18:18:48,0,3634,3663,1.008,0.6,1444,852,242,1094,592,161,753,36,0.06,0.09
T24,227,12-10-2017 18:38:48,0,3698,3842,1.039,0.6,1247,723,379,1102,524,214,738,48,0.08,0.12
T24,228,12-10-2017 18:58:48,0,3634,3820,1.051,0.6,2643,1569,918,2487,1074,551,1625,285,0.1,0.22
T24,229,12-10-2017 19:18:48,0,3828,4045,1.057,0.6,2854,1644,1025,2669,1210,731,1941,234,0.06,0.05
T24,230,12-10-2017 19:38:48,0,3625,3759,1.037,0.6,2046,1144,631,1775,902,420,1322,43,0.0,0.0
T24,231,12-10-2017 19:58:48,0,3594,3450,0.96,0.6,1906,1107,669,1776,799,408,1207,63,0.0,0.0
T24,232,12-10-2017 20:18:48,0,3661,3057,0.835,0.5,3913,2341,1481,3822,1572,883,2455,460,0.02,0.0
T24,233,12-10-2017 20:38:48,0,3355,2715,0.809,0.5,4045,2392,1471,3863,1653,903,2556,338,0.0,0.0
T24,234,12-10-2017 20:58:48,0,3353,2685,0.801,0.5,2988,1747,920,2667,1241,575,1816,297,0.04,0.0
T24,235,12-10-2017 21:18:48,0,3471,2741,0.79,0.5,3002,1793,940,2733,1209,627,1836,417,0.0,0.0
T24,236,12-10-2017 21:38:48,0,3159,2476,0.784,0.5,2513,1248,592,1840,1265,613,1878,117,0.0,0.0
T24,237,12-10-2017 21:58:48,0,2215,1669,0.753,0.3,439,217,34,251,222,41,263,0,0.0,0.0
T24,238,12-10-2017 22:18:48,0,3364,2708,0.805,0.5,1156,690,351,1041,466,215,681,64,0.04,0.0
T24,239,12-10-2017 22:38:48,0,2177,1613,0.741,0.3,702,386,187,573,316,159,475,48,0.0,0.0
T24,240,12-10-2017 22:58:48,0,3125,2403,0.769,0.5,314,190,103,293,124,31,155,1,0.0,0.0
T24,241,12-10-2017 23:18:48,0,2878,2170,0.754,0.4,3581,2200,1508,3708,1381,767,2148,496,0.02,0.0
T24,242,12-10-2017 23:38:48,0,2824,2187,0.774,0.4,1651,983,413,1396,668,302,970,89,0.02,0.0
T24,243,12-10-2017 23:58:48,0,2287,1729,0.756,0.3,1134,746,293,1039,388,119,507,121,0.02,0.0
T24,244,13-10-2017 00:18:48,0,2205,1601,0.726,0.3,14,1,0,1,13,2,15,0,0.0,0.0
T24,245,13-10-2017 00:38:48,0,2351,1767,0.752,0.3,31,0,0,0,31,2,33,0,0.0,0.0
T24,246,13-10-2017 00:58:48,0,2373,1800,0.759,0.3,55,27,1,28,28,4,32,0,0.0,0.0
T24,247,13-10-2017 01:18:48,0,2992,2314,0.774,0.4,1612,1054,521,1575,558,251,809,115,0.0,0.0
T24,248,13-10-2017 01:38:48,0,3149,2318,0.736,0.5,2604,1735,936,2671,869,413,1282,191,0.08,0.0
T24,249,13-10-2017 01:58:48,0,3115,2416,0.776,0.5,1989,1297,587,1884,692,256,948,202,0.0,0.0
T24,250,13-10-2017 02:18:48,0,1638,1184,0.723,0.2,466,269,47,316,197,59,256,0,0.02,0.0
T24,251,13-10-2017 02:38:48,0,2132,1542,0.723,0.3,21,18,0,18,3,0,3,0,0.0,0.0
T24,252,13-10-2017 02:58:48,0,2149,1595,0.742,0.3,38,35,0,35,3,1,4,0,0.0,0.0
T24,253,13-10-2017 03:18:48,0,2820,2096,0.743,0.4,855,511,244,755,344,135,479,15,0.02,0.0
T24,254,13-10-2017 03:38:48,0,3183,2363,0.742,0.5,1226,700,310,1010,526,223,749,38,0.02,0.0
T24,255,13-10-2017 03:58:48,0,1573,1142,0.726,0.2,1002,590,342,932,412,202,614,173,0.02,0.0
T24,256,13-10-2017 04:18:48,0,1402,1029,0.734,0.2,151,113,22,135,38,6,44,0,0.0,0.0
T24,257,13-10-2017 04:38:48,0,2449,1795,0.733,0.4,49,49,23,72,0,0,0,0,0.0,0.0
T24,258,13-10-2017 04:58:48,0,2596,1953,0.752,0.4,1914,1165,663,1828,749,334,1083,215,0.0,0.0
T24,259,13-10-2017 05:18:48,0,2616,1990,0.761,0.4,728,343,117,460,385,51,436,0,0.0,0.0
T24,260,13-10-2017 05:38:48,0,2561,1944,0.759,0.4,1347,736,226,962,611,199,810,32,0.16,0.0
T24,261,13-10-2017 05:58:48,0,2056,1447,0.704,0.3,77,26,12,38,51,15,66,0,0.0,0.0
T24,262,13-10-2017 06:18:48,1,2009,1422,0.707,0.3,4,2,1,3,2,0,2,0,0.0,0.0
T24,263,13-10-2017 06:38:48,1,2035,1510,0.742,0.3,16,9,4,13,7,0,7,0,0.0,0.0
T24,264,13-10-2017 06:58:48,1,2669,1993,0.747,0.4,201,164,24,188,37,5,42,0,0.0,0.0
T24,265,13-10-2017 07:18:48,1,2562,1958,0.764,0.4,228,162,78,240,66,32,98,2,0.0,0.0
T24,266,13-10-2017 07:38:48,1,3581,3202,0.894,0.5,1696,1113,666,1779,583,291,874,14,0.14,0.41
T24,267,13-10-2017 07:58:48,1,3267,3178,0.973,0.5,1606,990,501,1491,616,299,915,60,0.36,0.37
T24,268,13-10-2017 08:18:48,1,2518,2505,0.995,0.4,1043,638,258,896,405,134,539,24,0.14,0.06
T24,269,13-10-2017 08:38:48,1,2236,2256,1.009,0.3,68,59,21,80,9,2,11,0,0.0,0.0
T24,270,13-10-2017 08:58:48,1,2187,2233,1.021,0.3,69,36,4,40,33,1,34,0,0.0,-0.03
T24,271,13-10-2017 09:18:48,1,3237,3390,1.047,0.5,1062,669,257,926,393,160,553,25,0.12,0.3
T24,272,13-10-2017 09:38:48,1,2306,2432,1.055,0.4,922,527,261,788,395,159,554,35,0.22,0.15
T24,273,13-10-2017 09:58:48,1,2266,2342,1.034,0.4,46,18,2,20,28,8,36,0,0.02,0.0
T24,274,13-10-2017 10:18:48,1,2911,3059,1.051,0.5,439,244,33,277,195,23,218,0,0.0,0.0
T24,275,13-10-2017 10:38:48,1,3217,3379,1.05,0.5,1553,863,308,1171,690,234,924,35,0.18,0.29
T24,276,13-10-2017 10:58:48,1,2294,2377,1.036,0.4,588,328,87,415,260,78,338,0,0.0,0.03
T24,277,13-10-2017 11:18:48,1,2280,2414,1.059,0.4,54,27,9,36,27,13,40,0,0.02,0.0
T24,278,13-10-2017 11:38:48,1,2717,2824,1.039,0.4,220,134,17,151,86,28,114,0,0.0,0.0
T24,279,13-10-2017 11:58:48,1,3100,3349,1.08,0.5,1281,752,300,1052,529,233,762,45,0.2,0.37
T24,280,13-10-2017 12:18:48,1,2358,2481,1.052,0.4,235,133,20,153,102,22,124,0,0.02,0.0
T24,281,13-10-2017 12:38:48,1,2425,2582,1.065,0.4,116,66,16,82,50,8,58,0,0.0,0.0
T24,282,13-10-2017 12:58:48,1,2617,2755,1.053,0.4,174,111,28,139,63,11,74,0,0.0,0.0
T24,283,13-10-2017 13:18:48,1,2292,2397,1.046,0.4,116,77,25,102,39,8,47,0,0.0,0.04
T24,284,13-10-2017 13:38:48,1,3366,3603,1.071,0.5,1055,513,67,580,542,104,646,0,0.0,0.0
T24,285,13-10-2017 13:58:48,1,3082,3243,1.052,0.5,1576,936,379,1315,640,291,931,27,0.22,0.5
T24,286,31-10-2019 00:00:00,0,0,0,0.0,0.0,0,0,0,0,0,0,0,0,0.0,0.0
T22,1,09-10-2017 15:14:48,1,4548,3571,0.785,0.6,2445,1629,993,2622,816,408,1224,555,0.0,0.0
T22,2,09-10-2017 15:34:48,1,3865,2948,0.763,0.5,2457,1737,982,2719,720,373,1093,293,0.0,0.0
T22,3,09-10-2017 15:54:48,1,3523,2644,0.75,0.5,1483,1033,376,1409,450,190,640,124,0.0,0.0
T22,4,09-10-2017 16:14:48,1,2430,1765,0.726,0.3,110,76,17,93,34,3,37,0,0.0,0.0
T22,5,09-10-2017 16:34:48,1,2602,1890,0.726,0.3,33,27,7,34,6,0,6,0,0.0,0.0
T22,6,09-10-2017 16:54:48,1,2622,1901,0.725,0.3,24,14,0,14,10,5,15,0,0.0,0.0
T22,7,09-10-2017 17:14:48,1,2627,1898,0.723,0.3,18,7,1,8,11,3,14,0,0.0,0.0
T22,8,09-10-2017 17:34:48,1,3304,2494,0.755,0.4,260,136,39,175,124,36,160,0,0.0,0.0
T22,9,09-10-2017 17:54:48,1,3021,2230,0.738,0.4,1076,788,262,1050,288,108,396,52,0.0,0.0
T22,10,09-10-2017 18:14:48,0,2789,2057,0.738,0.4,22,15,0,15,7,1,8,0,0.0,0.0
T22,11,09-10-2017 18:34:48,0,2443,1744,0.714,0.3,10,7,0,7,3,2,5,0,0.0,0.0
T22,12,09-10-2017 18:54:48,0,4120,3161,0.767,0.5,715,412,99,511,303,77,380,0,0.0,0.0
T22,13,09-10-2017 19:14:48,0,4046,2982,0.737,0.5,4498,3189,2261,5450,1309,779,2088,1112,0.0,0.0
T22,14,09-10-2017 19:34:48,0,3839,2952,0.769,0.5,3282,2297,1420,3717,985,540,1525,723,0.0,0.11
T22,15,09-10-2017 19:54:48,0,3519,3152,0.896,0.5,3442,2408,1549,3957,1034,595,1629,828,0.0,0.06
T22,16,09-10-2017 20:14:48,0,3877,3477,0.897,0.5,2635,1776,861,2637,859,397,1256,399,0.0,0.04
T22,17,09-10-2017 20:34:48,0,3389,2906,0.857,0.4,3129,2225,1447,3672,904,545,1449,719,0.0,0.11
T22,18,09-10-2017 20:54:48,0,4431,4223,0.953,0.6,3610,2514,1716,4230,1096,679,1775,949,0.0,0.05
T22,19,09-10-2017 21:14:48,0,3436,3312,0.964,0.5,1766,1235,706,1941,531,309,840,339,0.0,0.09
T22,20,09-10-2017 21:34:48,0,3482,3411,0.98,0.5,1696,1214,692,1906,482,270,752,292,0.04,0.15
T22,21,09-10-2017 21:54:48,0,3471,3449,0.994,0.5,1428,984,416,1400,444,170,614,214,0.04,0.11
T22,22,09-10-2017 22:14:48,0,3420,3478,1.017,0.5,1668,1208,628,1836,460,275,735,411,0.12,0.19
T22,23,09-10-2017 22:34:48,0,2622,2530,0.965,0.4,1223,795,392,1187,428,172,600,201,0.14,0.07
T22,24,09-10-2017 22:54:48,0,2438,2367,0.971,0.3,48,25,6,31,23,10,33,0,0.0,-0.02
T22,25,09-10-2017 23:14:48,0,2451,2284,0.932,0.3,39,15,1,16,24,4,28,0,0.0,0.0
T22,26,09-10-2017 23:34:48,0,4073,4234,1.04,0.6,1199,873,308,1181,326,98,424,239,0.08,0.25
T22,27,09-10-2017 23:54:48,0,3585,3662,1.021,0.5,1025,706,398,1104,319,171,490,207,0.08,0.18
T22,28,10-10-2017 00:14:48,0,2757,2862,1.038,0.4,122,85,35,120,37,13,50,25,0.04,0.0
T22,29,10-10-2017 00:34:48,0,2543,2595,1.021,0.3,85,56,12,68,29,8,37,0,0.0,0.0
T22,30,10-10-2017 00:54:48,0,3799,3954,1.041,0.5,373,222,35,257,151,40,191,1,0.0,0.0
T22,31,10-10-2017 01:14:48,0,3563,3738,1.049,0.5,1191,842,414,1256,349,157,506,125,0.0,0.27
T22,32,10-10-2017 01:34:48,0,3998,4228,1.058,0.6,3023,2083,1336,3419,940,557,1497,624,0.28,0.13
T22,33,10-10-2017 01:54:48,0,4252,4478,1.053,0.6,3142,2159,1428,3587,983,578,1561,535,0.02,0.18
T22,34,10-10-2017 02:14:48,0,3733,3932,1.053,0.5,3323,2417,1563,3980,906,514,1420,504,0.04,0.03
T22,35,10-10-2017 02:34:48,0,3822,4090,1.07,0.5,1423,969,357,1326,454,174,628,168,0.1,0.11
T22,36,10-10-2017 02:54:48,0,2575,2597,1.008,0.4,246,154,42,196,92,26,118,1,0.0,0.0
T22,37,10-10-2017 03:14:48,0,2597,2683,1.033,0.4,136,74,16,90,62,18,80,0,0.0,0.0
T22,38,10-10-2017 03:34:48,0,2398,2347,0.979,0.3,75,73,0,73,2,0,2,0,0.0,0.0
T22,39,10-10-2017 03:54:48,0,3359,3469,1.033,0.5,1001,612,269,881,389,119,508,18,0.0,0.21
T22,40,10-10-2017 04:14:48,0,2659,2731,1.027,0.4,316,246,124,370,70,37,107,0,0.1,0.12
T22,41,10-10-2017 04:34:48,0,2422,2489,1.028,0.3,39,28,14,42,11,7,18,0,0.0,0.0
T22,42,10-10-2017 04:54:48,0,2821,2905,1.03,0.4,22,12,1,13,10,2,12,0,0.0,0.0
T22,43,10-10-2017 05:14:48,0,3930,4012,1.021,0.5,796,405,96,501,391,99,490,2,0.0,0.0
T22,44,10-10-2017 05:34:48,0,2422,2509,1.036,0.3,352,241,129,370,111,54,165,30,0.0,0.15
T22,45,10-10-2017 05:54:48,0,4010,4232,1.055,0.6,1133,721,354,1075,412,183,595,62,0.08,0.1
T22,46,10-10-2017 06:14:48,1,3626,3865,1.066,0.5,2918,2023,1344,3367,895,532,1427,464,0.14,0.17
T22,47,10-10-2017 06:34:48,1,3105,3234,1.041,0.4,1131,728,134,862,403,104,507,24,0.0,0.09
T22,48,10-10-2017 06:54:48,1,2606,2678,1.028,0.4,499,293,85,378,206,88,294,11,0.14,0.09
T22,49,10-10-2017 07:14:48,1,2471,2505,1.014,0.3,23,18,2,20,5,1,6,0,0.0,0.0
T22,50,10-10-2017 07:34:48,1,2426,2429,1.001,0.3,17,4,2,6,13,4,17,0,0.0,0.0
T22,51,10-10-2017 07:54:48,1,3233,3191,0.987,0.4,187,120,30,150,67,20,87,0,0.0,0.0
T22,52,10-10-2017 08:14:48,1,3624,3798,1.048,0.5,1234,777,287,1064,457,138,595,17,0.0,0.23
T22,53,10-10-2017 08:34:48,1,2515,2620,1.042,0.3,128,106,19,125,22,4,26,0,0.0,0.0
T22,54,10-10-2017 08:54:48,1,2558,2583,1.01,0.4,29,19,12,31,10,3,13,0,0.0,0.0
T22,55,10-10-2017 09:14:48,1,2172,2075,0.955,0.3,18,12,4,16,6,2,8,0,0.0,0.0
T22,56,10-10-2017 09:34:48,1,3473,3457,0.995,0.5,491,296,87,383,195,57,252,0,0.0,0.13
T22,57,10-10-2017 09:54:48,1,2114,2158,1.021,0.3,582,338,138,476,244,99,343,47,0.08,0.0
T22,58,10-10-2017 10:14:48,1,2360,2328,0.986,0.3,25,17,5,22,8,4,12,0,0.0,0.0
T22,59,10-10-2017 10:34:48,1,2554,2446,0.958,0.3,46,39,5,44,7,4,11,0,0.0,0.0
T22,60,10-10-2017 10:54:48,1,3765,3554,0.944,0.5,270,164,40,204,106,49,155,0,0.0,0.06
T22,61,10-10-2017 11:14:48,1,3647,3751,1.028,0.5,1075,701,244,945,374,134,508,42,0.12,0.26
T22,62,10-10-2017 11:34:48,1,2539,2562,1.009,0.3,87,40,13,53,47,6,53,0,0.0,0.0
T22,63,10-10-2017 11:54:48,1,2333,2391,1.025,0.3,63,35,12,47,28,8,36,0,0.0,0.0
T22,64,10-10-2017 12:14:48,1,2731,2791,1.022,0.4,136,88,15,103,48,18,66,0,0.0,0.0
T22,65,10-10-2017 12:34:48,1,3619,3693,1.02,0.5,643,375,150,525,268,120,388,27,0.12,0.17
T22,66,10-10-2017 12:54:48,1,2326,2390,1.028,0.3,446,328,47,375,118,27,145,0,0.0,0.0
T22,67,10-10-2017 13:14:48,1,2609,2631,1.008,0.4,32,20,5,25,12,4,16,0,0.0,0.0
T22,68,10-10-2017 13:34:48,1,2648,2619,0.989,0.4,47,34,9,43,13,8,21,0,0.0,0.0
T22,69,10-10-2017 13:54:48,1,3793,3837,1.012,0.5,1376,899,456,1355,477,231,708,64,0.0,0.02
T22,70,10-10-2017 14:14:48,1,3434,3630,1.057,0.5,1206,757,276,1033,449,154,603,10,0.18,0.25
T22,71,10-10-2017 14:34:48,1,2454,2543,1.036,0.3,158,104,15,119,54,19,73,0,0.0,0.0
T22,72,10-10-2017 14:54:48,1,2726,2776,1.018,0.4,32,17,1,18,15,0,15,0,0.0,0.0
T22,73,10-10-2017 15:14:48,1,2645,2600,0.983,0.4,44,27,8,35,17,5,22,0,0.0,0.0
T22,74,10-10-2017 15:34:48,1,2726,2690,0.987,0.4,145,111,37,148,34,18,52,0,0.0,0.0
T22,75,10-10-2017 15:54:48,1,3623,3772,1.041,0.5,579,364,183,547,215,97,312,35,0.0,0.25
T22,76,10-10-2017 16:14:48,1,3732,3892,1.043,0.5,1706,1165,299,1464,541,194,735,83,0.08,0.0
T22,77,10-10-2017 16:34:48,1,2428,2519,1.037,0.3,60,34,6,40,26,4,30,0,0.0,0.0
T22,78,10-10-2017 16:54:48,1,2423,2370,0.978,0.3,26,15,0,15,11,2,13,0,0.0,0.0
T22,79,10-10-2017 17:14:48,1,3756,3956,1.053,0.5,906,618,153,771,288,121,409,3,0.02,0.28
T22,80,10-10-2017 17:34:48,1,2307,2403,1.042,0.3,221,165,24,189,56,16,72,0,0.0,0.0
T22,81,10-10-2017 17:54:48,1,2492,2590,1.039,0.3,54,36,3,39,18,11,29,0,0.0,0.0
T22,82,10-10-2017 18:14:48,0,3941,4174,1.059,0.5,625,357,84,441,268,77,345,0,0.0,0.0
T22,83,10-10-2017 18:34:48,0,3927,4070,1.036,0.5,2633,1743,942,2685,890,412,1302,279,0.0,0.03
T22,84,10-10-2017 18:54:48,0,4018,4017,1.0,0.5,5122,3399,2444,5843,1723,1018,2741,1086,0.0,0.19
T22,85,10-10-2017 19:14:48,0,3933,3978,1.011,0.5,4933,3157,2095,5252,1776,1057,2833,931,0.0,0.02
T22,86,10-10-2017 19:34:48,0,4068,4213,1.036,0.6,4426,2842,1816,4658,1584,913,2497,907,0.0,0.13
T22,87,10-10-2017 19:54:48,0,3808,4030,1.058,0.5,5077,3328,2351,5679,1749,1069,2818,1138,0.02,0.11
T22,88,10-10-2017 20:14:48,0,3946,4154,1.053,0.5,4061,2620,1690,4310,1441,801,2242,829,0.0,0.17
T22,89,10-10-2017 20:34:48,0,3973,4290,1.08,0.6,4024,2607,1734,4341,1417,796,2213,647,0.08,0.22
T22,90,10-10-2017 20:54:48,0,3881,4163,1.073,0.5,4774,3175,2220,5395,1599,1008,2607,1055,0.08,0.1
T22,91,10-10-2017 21:14:48,0,3820,4023,1.053,0.5,4508,2984,2085,5069,1524,949,2473,979,0.04,0.13
T22,92,10-10-2017 21:34:48,0,3740,4020,1.075,0.5,3952,2577,1707,4284,1375,825,2200,777,0.06,0.12
T22,93,10-10-2017 21:54:48,0,3771,3992,1.059,0.5,1813,1129,498,1627,684,324,1008,230,0.12,0.15
T22,94,10-10-2017 22:14:48,0,2667,2795,1.048,0.4,611,395,160,555,216,101,317,18,0.08,0.14
T22,95,10-10-2017 22:34:48,0,3583,3835,1.07,0.5,1738,1077,541,1618,661,252,913,223,0.06,0.08
T22,96,10-10-2017 22:54:48,0,2560,2753,1.075,0.4,64,37,8,45,27,11,38,0,0.0,0.0
T22,97,10-10-2017 23:14:48,0,2533,2674,1.056,0.4,48,28,3,31,20,8,28,0,0.0,0.0
T22,98,10-10-2017 23:34:48,0,3859,4100,1.062,0.5,753,441,177,618,312,121,433,20,0.0,0.2
T22,99,10-10-2017 23:54:48,0,4020,4286,1.066,0.6,3581,2223,1396,3619,1358,822,2180,621,0.12,0.15
T22,100,11-10-2017 00:14:48,0,3792,4065,1.072,0.5,2429,1498,779,2277,931,495,1426,359,0.1,0.21
T22,101,11-10-2017 00:34:48,0,3980,4257,1.07,0.6,2092,1262,614,1876,830,431,1261,180,0.16,0.22
T22,102,11-10-2017 00:54:48,0,3621,3945,1.089,0.5,773,463,212,675,310,130,440,133,0.02,0.0
T22,103,11-10-2017 01:14:48,0,2813,2856,1.015,0.4,164,106,16,122,58,13,71,0,0.02,0.0
T22,104,11-10-2017 01:34:48,0,3467,3737,1.078,0.5,320,165,48,213,155,59,214,4,0.0,0.05
T22,105,11-10-2017 01:54:48,0,3982,4319,1.085,0.6,2038,1247,640,1887,791,395,1186,343,0.06,0.26
T22,106,11-10-2017 02:14:48,0,3371,3616,1.073,0.5,1088,626,174,800,462,146,608,14,0.08,0.09
T22,107,11-10-2017 02:34:48,0,2726,2909,1.067,0.4,27,14,5,19,13,4,17,0,0.0,0.0
T22,108,11-10-2017 02:54:48,0,2420,2589,1.07,0.3,27,16,1,17,11,1,12,0,0.0,0.0
T22,109,11-10-2017 03:14:48,0,3222,3412,1.059,0.4,249,168,55,223,81,36,117,0,0.0,0.03
T22,110,11-10-2017 03:34:48,0,3944,4263,1.081,0.6,1900,1168,491,1659,732,346,1078,99,0.12,0.23
T22,111,11-10-2017 03:54:48,0,3849,4233,1.1,0.5,1840,1053,556,1609,787,431,1218,282,0.14,0.2
T22,112,11-10-2017 04:14:48,0,2716,2857,1.052,0.4,989,556,143,699,433,160,593,13,0.08,0.06
T22,113,11-10-2017 04:34:48,0,2539,2733,1.076,0.4,29,22,1,23,7,1,8,0,0.0,0.0
T22,114,11-10-2017 04:54:48,0,2616,2756,1.053,0.4,202,142,21,163,60,16,76,0,0.0,0.0
T22,115,11-10-2017 05:14:48,0,4258,4610,1.083,0.6,2171,1302,776,2078,869,474,1343,420,0.06,0.19
T22,116,11-10-2017 05:34:48,0,3405,3602,1.058,0.5,1732,1089,442,1531,643,273,916,140,0.0,0.0
T22,117,11-10-2017 05:54:48,0,2791,2833,1.015,0.4,79,50,4,54,29,7,36,0,0.0,0.0
T22,118,11-10-2017 06:14:48,1,3588,3763,1.049,0.5,879,440,184,624,439,184,623,21,0.04,0.18
T22,119,11-10-2017 06:34:48,1,2387,2535,1.062,0.3,638,394,121,515,244,122,366,95,0.0,0.0
T22,120,11-10-2017 06:54:48,1,2635,2726,1.034,0.4,26,18,0,18,8,0,8,0,0.0,0.0
T22,121,11-10-2017 07:14:48,1,2198,2158,0.981,0.3,35,32,4,36,3,0,3,0,0.02,0.0
T22,122,11-10-2017 07:34:48,1,2832,2720,0.96,0.4,853,577,154,731,276,109,385,15,0.0,0.0
T22,123,11-10-2017 07:54:48,1,2611,2426,0.929,0.4,28,13,2,15,15,3,18,0,0.0,0.0
T22,124,11-10-2017 08:14:48,1,3188,3015,0.946,0.4,575,352,163,515,223,116,339,18,0.0,0.11
T22,125,11-10-2017 08:34:48,1,2626,2671,1.017,0.4,835,571,69,640,264,68,332,9,0.0,0.0
T22,126,11-10-2017 08:54:48,1,2650,2557,0.965,0.4,42,24,0,24,18,11,29,0,0.0,0.0
T22,127,11-10-2017 09:14:48,1,2435,2274,0.934,0.3,87,42,12,54,45,15,60,0,0.0,0.0
T22,128,11-10-2017 09:34:48,1,2517,2221,0.882,0.3,66,28,0,28,38,10,48,0,0.0,0.0
T22,129,11-10-2017 09:54:48,1,4315,4363,1.011,0.6,1537,921,536,1457,616,305,921,304,0.08,0.24
T22,130,11-10-2017 10:14:48,1,3458,3621,1.047,0.5,3395,2063,1299,3362,1332,755,2087,697,0.1,0.0
T22,131,11-10-2017 10:34:48,1,2535,2534,0.999,0.3,703,433,112,545,270,86,356,1,0.0,0.0
T22,132,11-10-2017 10:54:48,1,2372,2197,0.926,0.3,471,238,56,294,233,68,301,40,0.0,0.0
T22,133,11-10-2017 11:14:48,1,2605,2327,0.893,0.3,36,24,2,26,12,4,16,0,0.0,0.0
T22,134,11-10-2017 11:34:48,1,3731,3569,0.956,0.5,1471,900,454,1354,571,274,845,171,0.0,0.12
T22,135,11-10-2017 11:54:48,1,3728,3953,1.06,0.5,2155,1318,659,1977,837,387,1224,249,0.14,0.13
T22,136,11-10-2017 12:14:48,1,2359,2332,0.989,0.3,538,400,22,422,138,28,166,3,0.0,0.0
T22,137,11-10-2017 12:34:48,1,2573,2288,0.889,0.3,80,58,8,66,22,10,32,0,0.0,0.0
T22,138,11-10-2017 12:54:48,1,2212,1902,0.86,0.3,74,57,22,79,17,5,22,0,0.02,0.0
T22,139,11-10-2017 13:14:48,1,3608,3446,0.955,0.5,587,336,105,441,251,90,341,78,0.0,0.1
T22,140,11-10-2017 13:34:48,1,3460,3527,1.019,0.5,1366,850,232,1082,516,193,709,109,0.08,0.03
T22,141,11-10-2017 13:54:48,1,3080,3232,1.049,0.4,1479,881,378,1259,598,238,836,133,0.04,0.14
T22,142,11-10-2017 14:14:48,1,2509,2483,0.99,0.3,300,198,112,310,102,47,149,7,0.02,0.0
T22,143,11-10-2017 14:34:48,1,2519,2328,0.924,0.3,42,19,3,22,23,9,32,0,0.0,0.0
T22,144,11-10-2017 14:54:48,1,2684,2371,0.884,0.4,95,52,4,56,43,13,56,0,0.0,0.0
T22,145,11-10-2017 15:14:48,1,3428,3074,0.897,0.5,301,172,47,219,129,37,166,0,0.0,0.09
T22,146,11-10-2017 15:34:48,1,3764,4010,1.065,0.5,1533,963,427,1390,570,257,827,236,0.08,0.25
T22,147,11-10-2017 15:54:48,1,2273,2371,1.043,0.3,962,601,219,820,361,155,516,114,0.1,0.0
T22,148,11-10-2017 16:14:48,1,2405,2423,1.008,0.3,62,47,10,57,15,5,20,0,0.0,0.0
T22,149,11-10-2017 16:34:48,1,2590,2406,0.929,0.3,50,36,18,54,14,5,19,0,0.0,0.0
T22,150,11-10-2017 16:54:48,1,2413,2281,0.945,0.3,36,19,1,20,17,4,21,0,0.0,0.0
T22,151,11-10-2017 17:14:48,1,3664,3877,1.058,0.5,1175,738,161,899,437,117,554,19,0.04,0.16
T22,152,11-10-2017 17:34:48,1,3669,3684,1.004,0.5,1539,952,444,1396,587,247,834,99,0.02,0.0
T22,153,11-10-2017 17:54:48,1,2660,2449,0.92,0.4,413,190,42,232,223,37,260,0,0.0,0.0
T22,154,11-10-2017 18:14:48,0,4058,4040,0.996,0.6,869,498,139,637,371,104,475,29,0.0,0.11
T22,155,11-10-2017 18:34:48,0,3927,3843,0.978,0.5,3477,2112,1252,3364,1365,672,2037,788,0.0,0.03
T22,156,11-10-2017 18:54:48,0,3904,3736,0.957,0.5,4318,2787,1811,4598,1531,798,2329,1061,0.0,0.09
T22,157,11-10-2017 19:14:48,0,4063,3884,0.956,0.5,5933,3979,2780,6759,1954,1008,2962,1559,0.0,0.08
T22,158,11-10-2017 19:34:48,0,4076,4135,1.015,0.6,4860,3266,2194,5460,1594,839,2433,1299,0.0,0.14
T22,159,11-10-2017 19:54:48,0,3845,4078,1.06,0.5,4165,2710,1751,4461,1455,747,2202,931,0.1,0.19
T22,160,11-10-2017 20:14:48,0,4202,4466,1.063,0.6,4556,3103,2019,5122,1453,790,2243,1110,0.08,0.11
T22,161,11-10-2017 20:34:48,0,4015,4276,1.065,0.6,3054,2032,1093,3125,1022,450,1472,508,0.06,0.1
T22,162,11-10-2017 20:54:48,0,3725,3999,1.074,0.5,2867,1892,1152,3044,975,480,1455,466,0.1,0.23
T22,163,11-10-2017 21:14:48,0,2806,2959,1.055,0.4,1962,1211,618,1829,751,292,1043,175,0.04,0.0
T22,164,11-10-2017 21:34:48,0,3907,4223,1.081,0.5,1404,856,357,1213,548,194,742,76,0.06,0.13
T22,165,11-10-2017 21:54:48,0,2456,2578,1.05,0.3,64,43,9,52,21,7,28,0,0.0,0.0
T22,166,11-10-2017 22:14:48,0,3249,3244,0.998,0.4,270,158,80,238,112,40,152,5,0.0,0.05
T22,167,11-10-2017 22:34:48,0,4230,4545,1.074,0.6,4582,3060,2097,5157,1522,805,2327,1214,0.08,0.21
T22,168,11-10-2017 22:54:48,0,3823,4073,1.065,0.5,2239,1427,588,2015,812,316,1128,202,0.1,0.13
T22,169,11-10-2017 23:14:48,0,4078,4369,1.071,0.6,3100,2006,1244,3250,1094,490,1584,535,0.06,0.09
T22,170,11-10-2017 23:34:48,0,2515,2747,1.092,0.4,546,397,68,465,149,53,202,0,0.0,0.14
T22,171,11-10-2017 23:54:48,0,2765,2886,1.044,0.4,41,25,0,25,16,6,22,0,0.0,0.0
T22,172,12-10-2017 00:14:48,0,2610,2674,1.025,0.4,76,39,6,45,37,11,48,0,0.0,0.0
T22,173,12-10-2017 00:34:48,0,4081,4505,1.104,0.6,1354,776,401,1177,578,193,771,120,0.04,0.18
T22,174,12-10-2017 00:54:48,0,4074,4420,1.085,0.6,4198,2744,1784,4528,1454,829,2283,893,0.18,0.1
T22,175,12-10-2017 01:14:48,0,3810,4095,1.075,0.5,2640,1746,1004,2750,894,461,1355,366,0.08,0.27
T22,176,12-10-2017 01:34:48,0,3797,4079,1.074,0.5,1841,1012,337,1349,829,238,1067,104,0.02,0.03
T22,177,12-10-2017 01:54:48,0,2722,2801,1.029,0.4,141,79,4,83,62,11,73,0,0.0,0.0
T22,178,12-10-2017 02:14:48,0,2607,2607,1.0,0.4,64,37,10,47,27,2,29,0,0.0,0.0
T22,179,12-10-2017 02:34:48,0,3675,3619,0.985,0.5,370,224,43,267,146,34,180,0,0.0,0.05
T22,180,12-10-2017 02:54:48,0,4052,4297,1.06,0.6,3070,2079,1274,3353,991,488,1479,538,0.08,0.12
T22,181,12-10-2017 03:14:48,0,4020,4327,1.076,0.6,2929,1940,1096,3036,989,503,1492,556,0.14,0.19
T22,182,12-10-2017 03:34:48,0,3750,3909,1.042,0.5,1693,1037,447,1484,656,231,887,59,0.06,0.03
T22,183,12-10-2017 03:54:48,0,2641,2594,0.982,0.4,102,62,7,69,40,9,49,0,0.0,0.0
T22,184,12-10-2017 04:14:48,0,2639,2348,0.89,0.4,36,15,1,16,21,6,27,0,0.0,0.0
T22,185,12-10-2017 04:34:48,0,3939,3840,0.975,0.5,662,401,145,546,261,93,354,18,0.0,0.2
T22,186,12-10-2017 04:54:48,0,3743,3917,1.047,0.5,3102,2036,1208,3244,1066,535,1601,495,0.1,0.08
T22,187,12-10-2017 05:14:48,0,3371,3393,1.006,0.5,2245,1360,637,1997,885,394,1279,300,0.04,0.1
T22,188,12-10-2017 05:34:48,0,2765,2861,1.035,0.4,603,383,161,544,220,81,301,27,0.06,0.04
T22,189,12-10-2017 05:54:48,0,2607,2548,0.978,0.4,21,9,3,12,12,5,17,0,0.0,0.0
T22,190,12-10-2017 06:14:48,1,2601,2373,0.913,0.3,100,73,15,88,27,12,39,0,0.0,0.0
T22,191,12-10-2017 06:34:48,1,3380,3062,0.906,0.5,207,120,36,156,87,22,109,0,0.0,0.0
T22,192,12-10-2017 06:54:48,1,3525,3586,1.017,0.5,1579,1003,462,1465,576,221,797,136,0.02,0.12
T22,193,12-10-2017 07:14:48,1,2722,2684,0.986,0.4,144,72,7,79,72,15,87,0,0.0,0.0
T22,194,12-10-2017 07:34:48,1,2541,2277,0.896,0.3,37,19,6,25,18,3,21,0,0.0,0.0
T22,195,12-10-2017 07:54:48,1,2531,2186,0.864,0.3,38,12,3,15,26,8,34,0,0.0,0.0
T22,196,12-10-2017 08:14:48,1,2562,2157,0.842,0.3,33,13,4,17,20,1,21,0,0.0,0.0
T22,197,12-10-2017 08:34:48,1,3948,3698,0.937,0.5,2076,1430,699,2129,646,290,936,403,0.06,0.06
T22,198,12-10-2017 08:54:48,1,2457,2242,0.912,0.3,1258,787,347,1134,471,212,683,131,0.0,0.0
T22,199,12-10-2017 09:14:48,1,2632,2135,0.811,0.3,36,17,7,24,19,4,23,0,0.0,0.0
T22,200,12-10-2017 09:34:48,1,2417,1924,0.796,0.3,42,27,3,30,15,3,18,0,0.02,0.0
T22,201,12-10-2017 09:54:48,1,3466,2928,0.845,0.5,265,144,36,180,121,43,164,0,0.0,0.05
T22,202,12-10-2017 10:14:48,1,3418,3452,1.01,0.5,1909,1177,520,1697,732,257,989,141,0.04,0.09
T22,203,12-10-2017 10:34:48,1,2422,2164,0.894,0.3,55,31,9,40,24,12,36,0,0.0,0.0
T22,204,12-10-2017 10:54:48,1,2589,2145,0.828,0.3,43,19,0,19,24,7,31,0,0.0,0.0
T22,205,12-10-2017 11:14:48,1,3493,3127,0.895,0.5,677,447,222,669,230,108,338,38,0.0,0.18
T22,206,12-10-2017 11:34:48,1,3165,3206,1.013,0.4,1946,1230,553,1783,716,293,1009,258,0.08,0.0
T22,207,12-10-2017 11:54:48,1,2635,2438,0.925,0.4,40,17,2,19,23,11,34,0,0.0,0.0
T22,208,12-10-2017 12:14:48,1,2393,2128,0.889,0.3,46,20,2,22,26,3,29,0,0.0,0.0
T22,209,12-10-2017 12:34:48,1,3083,2767,0.897,0.4,375,209,58,267,166,59,225,8,0.0,0.16
T22,210,12-10-2017 12:54:48,1,3378,3519,1.042,0.5,1535,955,395,1350,580,209,789,100,0.1,0.0
T22,211,12-10-2017 13:14:48,1,2459,2345,0.954,0.3,288,161,23,184,127,20,147,0,0.0,0.0
T22,212,12-10-2017 13:34:48,1,2707,2443,0.902,0.4,30,16,6,22,14,5,19,0,0.0,0.0
T22,213,12-10-2017 13:54:48,1,2315,2008,0.867,0.3,42,28,10,38,14,3,17,0,0.0,0.0
T22,214,12-10-2017 14:14:48,1,3575,3293,0.921,0.5,2187,1414,793,2207,773,386,1159,231,0.0,0.0
T22,215,12-10-2017 14:34:48,1,3574,3621,1.013,0.5,1492,987,231,1218,505,137,642,77,0.04,0.13
T22,216,12-10-2017 14:54:48,1,2801,2726,0.973,0.4,820,489,121,610,331,74,405,18,0.06,0.0
T22,217,12-10-2017 15:14:48,1,2365,2003,0.847,0.3,41,35,9,44,6,2,8,0,0.0,0.0
T22,218,12-10-2017 15:34:48,1,3198,2795,0.874,0.4,331,209,66,275,122,47,169,0,0.0,0.11
T22,219,12-10-2017 15:54:48,1,2673,2758,1.032,0.4,1098,714,329,1043,384,174,558,99,0.0,0.06
T22,220,12-10-2017 16:14:48,1,2522,2383,0.945,0.3,24,10,3,13,14,8,22,0,0.0,0.0
T22,221,12-10-2017 16:34:48,1,2391,2146,0.898,0.3,55,33,9,42,22,6,28,0,0.0,0.0
T22,222,12-10-2017 16:54:48,1,3639,3477,0.955,0.5,864,485,172,657,379,111,490,31,0.0,0.13
T22,223,12-10-2017 17:14:48,1,2423,2379,0.982,0.3,531,286,45,331,245,58,303,0,0.02,-0.01
T22,224,12-10-2017 17:34:48,1,2550,2327,0.913,0.3,89,53,17,70,36,12,48,0,0.0,0.0
T22,225,12-10-2017 17:54:48,1,3389,3243,0.957,0.5,421,270,76,346,151,55,206,0,0.0,0.13
T22,226,12-10-2017 18:14:48,0,3975,4109,1.034,0.5,2248,1565,724,2289,683,226,909,185,0.06,0.0
T22,227,12-10-2017 18:34:48,0,4159,4322,1.039,0.6,1760,1102,633,1735,658,293,951,264,0.06,0.12
T22,228,12-10-2017 18:54:48,0,3915,3890,0.994,0.5,4870,3165,2081,5246,1705,1034,2739,837,0.02,0.08
T22,229,12-10-2017 19:14:48,0,4028,3859,0.958,0.5,4090,2659,1636,4295,1431,747,2178,600,0.02,0.05
T22,230,12-10-2017 19:34:48,0,4101,3657,0.892,0.5,5995,3980,2690,6670,2015,1248,3263,743,0.0,0.0
T22,231,12-10-2017 19:54:48,0,4002,3370,0.842,0.5,5984,3999,2795,6794,1985,1101,3086,1250,0.02,0.0
T22,232,12-10-2017 20:14:48,0,3787,3062,0.808,0.5,5052,3410,2285,5695,1642,887,2529,1000,0.02,0.0
T22,233,12-10-2017 20:34:48,0,3875,2992,0.772,0.5,4865,3146,2106,5252,1719,914,2633,1053,0.0,0.0
T22,234,12-10-2017 20:54:48,0,3340,2656,0.795,0.4,2894,1865,1064,2929,1029,444,1473,423,0.08,0.0
T22,235,12-10-2017 21:14:48,0,3276,2505,0.765,0.4,3646,2395,1568,3963,1251,606,1857,751,0.14,0.0
T22,236,12-10-2017 21:34:48,0,2766,2096,0.758,0.4,3579,2300,1535,3835,1279,576,1855,769,0.0,0.0
T22,237,12-10-2017 21:54:48,0,1753,1312,0.749,0.2,299,173,37,210,126,25,151,0,0.0,0.0
T22,238,12-10-2017 22:14:48,0,2351,1723,0.733,0.3,46,26,6,32,20,9,29,0,0.0,0.0
T22,239,12-10-2017 22:34:48,0,2257,1654,0.733,0.3,36,21,4,25,15,7,22,0,0.0,0.0
T22,240,12-10-2017 22:54:48,0,3057,2325,0.761,0.4,355,196,100,296,159,74,233,18,0.0,0.0
T22,241,12-10-2017 23:14:48,0,4041,3079,0.762,0.5,4063,2685,1689,4374,1378,700,2078,725,0.02,0.0
T22,242,12-10-2017 23:34:48,0,3814,2944,0.772,0.5,4704,3204,2206,5410,1500,784,2284,1001,0.04,0.0
T22,243,12-10-2017 23:54:48,0,3907,3045,0.779,0.5,4473,2899,1802,4701,1574,830,2404,774,0.1,0.0
T22,244,13-10-2017 00:14:48,0,3917,2899,0.74,0.5,4315,2831,1819,4650,1484,808,2292,1283,0.06,0.0
T22,245,13-10-2017 00:34:48,0,3767,2866,0.761,0.5,4372,2928,1938,4866,1444,799,2243,1180,0.1,0.0
T22,246,13-10-2017 00:54:48,0,3664,2819,0.769,0.5,4978,3285,2231,5516,1693,917,2610,1083,0.08,0.0
T22,247,13-10-2017 01:14:48,0,3919,2890,0.738,0.5,4293,2848,1852,4700,1445,786,2231,1181,0.1,0.0
T22,248,13-10-2017 01:34:48,0,3451,2525,0.732,0.4,4247,2758,1917,4675,1489,785,2274,944,0.12,0.0
T22,249,13-10-2017 01:54:48,0,2989,2248,0.752,0.4,1347,1002,204,1206,345,100,445,74,0.0,0.0
T22,250,13-10-2017 02:14:48,0,3091,2337,0.756,0.4,1407,798,355,1153,609,162,771,229,0.02,0.0
T22,251,13-10-2017 02:34:48,0,2954,2188,0.741,0.4,1719,1148,640,1788,571,263,834,783,0.08,0.0
T22,252,13-10-2017 02:54:48,0,2699,2082,0.772,0.3,1737,1202,486,1688,535,216,751,362,0.0,0.0
T22,253,13-10-2017 03:14:48,0,2443,1814,0.742,0.3,1079,484,144,628,595,140,735,49,0.0,0.0
T22,254,13-10-2017 03:34:48,0,1617,1146,0.709,0.2,731,373,121,494,358,89,447,38,0.06,0.0
T22,255,13-10-2017 03:54:48,0,1621,1166,0.719,0.2,36,23,12,35,13,2,15,0,0.0,0.0
T22,256,13-10-2017 04:14:48,0,2199,1558,0.709,0.3,14,9,0,9,5,0,5,0,0.0,0.0
T22,257,13-10-2017 04:34:48,0,4235,3194,0.754,0.5,849,507,269,776,342,125,467,104,0.0,0.0
T22,258,13-10-2017 04:54:48,0,3754,2817,0.75,0.5,4102,2732,1760,4492,1370,713,2083,936,0.06,0.0
T22,259,13-10-2017 05:14:48,0,3284,2408,0.733,0.4,4203,2858,2003,4861,1345,698,2043,901,0.12,0.0
T22,260,13-10-2017 05:34:48,0,2570,1957,0.761,0.3,788,446,147,593,342,82,424,30,0.0,0.0
T22,261,13-10-2017 05:54:48,0,2103,1578,0.75,0.3,622,328,97,425,294,87,381,12,0.02,0.0
T22,262,13-10-2017 06:14:48,1,1675,1187,0.708,0.2,1277,814,394,1208,463,185,648,120,0.0,0.0
T22,263,13-10-2017 06:34:48,1,1823,1308,0.717,0.2,35,26,8,34,9,0,9,0,0.0,0.0
T22,264,13-10-2017 06:54:48,1,1977,1455,0.736,0.3,16,13,2,15,3,1,4,0,0.0,0.0
T22,265,13-10-2017 07:14:48,1,1768,1318,0.745,0.2,75,63,25,88,12,1,13,0,0.0,0.0
T22,266,13-10-2017 07:34:48,1,4038,3211,0.795,0.5,1641,1045,569,1614,596,275,871,66,0.0,0.12
T22,267,13-10-2017 07:54:48,1,3725,3506,0.941,0.5,1447,915,464,1379,532,234,766,244,0.32,0.38
T22,268,13-10-2017 08:14:48,1,3410,3387,0.993,0.5,1416,923,496,1419,493,241,734,187,0.28,0.36
T22,269,13-10-2017 08:34:48,1,2880,2925,1.015,0.4,946,656,238,894,290,101,391,13,0.14,0.12
T22,270,13-10-2017 08:54:48,1,2205,2296,1.042,0.3,57,38,20,58,19,10,29,0,0.0,0.0
T22,271,13-10-2017 09:14:48,1,2307,2457,1.065,0.3,118,84,23,107,34,7,41,0,0.0,-0.02
T22,272,13-10-2017 09:34:48,1,2984,3194,1.07,0.4,278,201,56,257,77,19,96,0,0.0,0.0
T22,273,13-10-2017 09:54:48,1,2999,3199,1.067,0.4,531,345,116,461,186,88,274,10,0.14,0.29
T22,274,13-10-2017 10:14:48,1,3539,3678,1.039,0.5,1250,759,356,1115,491,188,679,106,0.24,0.16
T22,275,13-10-2017 10:34:48,1,2148,2414,1.124,0.3,63,41,31,72,22,10,32,0,0.0,0.0
T22,276,13-10-2017 10:54:48,1,2216,2426,1.095,0.3,29,18,9,27,11,5,16,0,0.0,0.0
T22,277,13-10-2017 11:14:48,1,2106,2338,1.11,0.3,61,41,14,55,20,5,25,0,0.0,0.0
T22,278,13-10-2017 11:34:48,1,2292,2484,1.084,0.3,424,206,53,259,218,46,264,0,0.0,-0.03
T22,279,13-10-2017 11:54:48,1,3385,3612,1.067,0.5,397,245,102,347,152,65,217,0,0.0,0.29
T22,280,13-10-2017 12:14:48,1,2965,3122,1.053,0.4,1200,756,385,1141,444,181,625,115,0.2,0.16
T22,281,13-10-2017 12:34:48,1,2026,2191,1.082,0.3,23,13,7,20,10,6,16,0,0.0,0.0
T22,282,13-10-2017 12:54:48,1,2437,2650,1.088,0.3,27,15,2,17,12,4,16,0,0.0,0.0
T22,283,13-10-2017 13:14:48,1,2495,2681,1.075,0.3,22,13,2,15,9,3,12,0,0.0,-0.02
T22,284,13-10-2017 13:34:48,1,2471,2647,1.071,0.3,327,189,52,241,138,41,179,0,0.02,0.0
T22,285,13-10-2017 13:54:48,1,3789,4025,1.062,0.5,1357,925,466,1391,432,194,626,100,0.14,0.34
T22,286,13-10-2017 14:14:48,1,2138,2386,1.116,0.3,131,77,26,103,54,13,67,0,0.0,0.0
T23,1,09-10-2017 15:16:48,1,3065,2335,0.762,0.5,284,105,13,118,179,125,304,0,0.0,0.0
T23,2,09-10-2017 15:36:48,1,2655,1964,0.74,0.4,68,16,7,23,52,41,93,0,0.0,0.0
T23,3,09-10-2017 15:56:48,1,2891,2237,0.774,0.4,34,28,7,35,6,5,11,0,0.0,0.0
T23,4,09-10-2017 16:16:48,1,2895,2224,0.768,0.4,57,27,4,31,30,24,54,0,0.0,0.0
T23,5,09-10-2017 16:36:48,1,2833,2149,0.759,0.4,44,25,3,28,19,12,31,0,0.0,0.0
T23,6,09-10-2017 16:56:48,1,2765,2098,0.759,0.4,83,37,3,40,46,27,73,0,0.0,0.0
T23,7,09-10-2017 17:16:48,1,3358,2606,0.776,0.5,1319,617,168,785,702,521,1223,7,0.0,0.0
T23,8,09-10-2017 17:36:48,1,2587,1907,0.737,0.4,25,11,1,12,14,12,26,0,0.0,0.0
T23,9,09-10-2017 17:56:48,1,2844,2136,0.751,0.4,39,39,4,43,0,0,0,0,0.0,0.0
T23,10,09-10-2017 18:16:48,0,3058,2353,0.77,0.5,416,252,72,324,164,133,297,0,0.0,0.0
T23,11,09-10-2017 18:36:48,0,3996,3735,0.935,0.6,2324,1242,687,1929,1082,915,1997,124,0.0,0.2
T23,12,09-10-2017 18:56:48,0,3599,3543,0.984,0.6,2229,1192,633,1825,1037,843,1880,415,0.16,0.09
T23,13,09-10-2017 19:16:48,0,3840,3880,1.011,0.6,2785,1606,966,2572,1179,1014,2193,206,0.12,0.18
T23,14,09-10-2017 19:36:48,0,3506,3518,1.003,0.6,1759,1073,537,1610,686,573,1259,44,0.1,0.1
T23,15,09-10-2017 19:56:48,0,2785,2813,1.01,0.4,1055,640,242,882,415,355,770,24,0.08,0.14
T23,16,09-10-2017 20:16:48,0,2917,2969,1.018,0.5,1243,622,298,920,621,503,1124,36,0.16,0.13
T23,17,09-10-2017 20:36:48,0,3638,3747,1.03,0.6,889,484,245,729,405,326,731,23,0.14,0.23
T23,18,09-10-2017 20:56:48,0,3463,3647,1.053,0.6,591,325,115,440,266,212,478,6,0.02,0.18
T23,19,09-10-2017 21:16:48,0,3709,3810,1.027,0.6,3130,1913,993,2906,1217,1022,2239,651,0.2,0.0
T23,20,09-10-2017 21:36:48,0,3163,3219,1.018,0.5,631,393,67,460,238,187,425,0,0.0,0.06
T23,21,09-10-2017 21:56:48,0,3370,3424,1.016,0.5,967,529,238,767,438,368,806,8,0.06,0.11
T23,22,09-10-2017 22:16:48,0,3025,3033,1.003,0.5,51,33,9,42,18,14,32,0,0.0,0.0
T23,23,09-10-2017 22:36:48,0,2890,2897,1.003,0.5,106,49,10,59,57,44,101,0,0.0,0.0
T23,24,09-10-2017 22:56:48,0,2845,2787,0.98,0.4,37,23,2,25,14,9,23,0,0.0,0.0
T23,25,09-10-2017 23:16:48,0,3560,3724,1.046,0.6,740,374,119,493,366,284,650,0,0.0,0.07
T23,26,09-10-2017 23:36:48,0,2882,2927,1.016,0.5,921,515,225,740,406,327,733,48,0.1,0.13
T23,27,09-10-2017 23:56:48,0,3244,3269,1.008,0.5,957,478,233,711,479,392,871,9,0.2,0.2
T23,28,10-10-2017 00:16:48,0,3687,3819,1.036,0.6,330,190,57,247,140,105,245,0,0.0,0.0
T23,29,10-10-2017 00:36:48,0,2868,2977,1.038,0.5,856,488,183,671,368,279,647,22,0.1,0.15
T23,30,10-10-2017 00:56:48,0,3540,3576,1.01,0.6,1116,675,181,856,441,333,774,0,0.0,0.08
T23,31,10-10-2017 01:16:48,0,3042,3179,1.045,0.5,1064,569,240,809,495,394,889,47,0.14,0.16
T23,32,10-10-2017 01:36:48,0,2593,2677,1.032,0.4,76,37,9,46,39,29,68,0,0.0,0.0
T23,33,10-10-2017 01:56:48,0,2936,2896,0.986,0.5,35,12,1,13,23,16,39,0,0.0,0.0
T23,34,10-10-2017 02:16:48,0,3072,2968,0.966,0.5,131,92,11,103,39,27,66,0,0.0,0.0
T23,35,10-10-2017 02:36:48,0,3813,3848,1.009,0.6,758,368,150,518,390,317,707,18,0.06,0.07
T23,36,10-10-2017 02:56:48,0,3471,3598,1.037,0.5,454,233,42,275,221,171,392,0,0.0,0.16
T23,37,10-10-2017 03:16:48,0,3284,3392,1.033,0.5,1816,1021,454,1475,795,668,1463,142,0.12,0.15
T23,38,10-10-2017 03:36:48,0,2776,2774,0.999,0.4,222,95,12,107,127,101,228,0,0.0,0.0
T23,39,10-10-2017 03:56:48,0,2502,2463,0.984,0.4,487,309,98,407,178,143,321,1,0.12,0.0
T23,40,10-10-2017 04:16:48,0,2581,2422,0.938,0.4,74,39,7,46,35,23,58,0,0.0,0.0
T23,41,10-10-2017 04:36:48,0,2687,2467,0.918,0.4,44,15,2,17,29,16,45,0,0.0,0.0
T23,42,10-10-2017 04:56:48,0,3536,3407,0.964,0.6,672,205,34,239,467,351,818,0,0.0,0.0
T23,43,10-10-2017 05:16:48,0,3609,3606,0.999,0.6,1309,694,297,991,615,495,1110,27,0.0,0.18
T23,44,10-10-2017 05:36:48,0,3197,3189,0.997,0.5,1324,765,334,1099,559,456,1015,57,0.1,0.12
T23,45,10-10-2017 05:56:48,0,2632,2588,0.983,0.4,63,23,4,27,40,23,63,0,0.0,0.0
T23,46,10-10-2017 06:16:48,1,3321,3251,0.979,0.5,314,173,50,223,141,95,236,4,0.0,0.16
T23,47,10-10-2017 06:36:48,1,2286,2320,1.015,0.4,283,154,81,235,129,101,230,11,0.12,0.03
T23,48,10-10-2017 06:56:48,1,2566,2492,0.971,0.4,393,136,25,161,257,189,446,0,0.0,0.0
T23,49,10-10-2017 07:16:48,1,2623,2547,0.971,0.4,57,25,14,39,32,20,52,0,0.0,0.0
T23,50,10-10-2017 07:36:48,1,2663,2444,0.918,0.4,85,31,6,37,54,35,89,0,0.0,0.0
T23,51,10-10-2017 07:56:48,1,3273,3055,0.933,0.5,242,139,21,160,103,79,182,0,0.0,0.0
T23,52,10-10-2017 08:16:48,1,3350,3442,1.028,0.5,649,247,43,290,402,312,714,0,0.0,0.2
T23,53,10-10-2017 08:36:48,1,2535,2446,0.965,0.4,115,54,7,61,61,41,102,0,0.0,0.0
T23,54,10-10-2017 08:56:48,1,2762,2608,0.944,0.4,35,23,6,29,12,9,21,0,0.0,0.0
T23,55,10-10-2017 09:16:48,1,3237,3028,0.935,0.5,206,125,17,142,81,62,143,0,0.0,0.0
T23,56,10-10-2017 09:36:48,1,3714,3607,0.971,0.6,909,513,134,647,396,294,690,3,0.2,0.09
T23,57,10-10-2017 09:56:48,1,2658,2503,0.942,0.4,763,444,107,551,319,233,552,10,0.0,0.07
T23,58,10-10-2017 10:16:48,1,2541,2351,0.925,0.4,63,29,2,31,34,21,55,0,0.0,0.0
T23,59,10-10-2017 10:36:48,1,2785,2431,0.873,0.4,28,14,1,15,14,10,24,0,0.0,0.0
T23,60,10-10-2017 10:56:48,1,3226,2772,0.859,0.5,170,100,35,135,70,56,126,3,0.0,0.0
T23,61,10-10-2017 11:16:48,1,3438,3536,1.028,0.5,1295,630,276,906,665,484,1149,47,0.08,0.23
T23,62,10-10-2017 11:36:48,1,2468,2400,0.973,0.4,215,84,24,108,131,90,221,0,0.0,0.0
T23,63,10-10-2017 11:56:48,1,2575,2381,0.925,0.4,33,13,4,17,20,12,32,0,0.0,0.0
T23,64,10-10-2017 12:16:48,1,2611,2244,0.859,0.4,40,27,5,32,13,5,18,0,0.0,0.0
T23,65,10-10-2017 12:36:48,1,3207,3043,0.949,0.5,665,355,83,438,310,238,548,0,0.02,0.22
T23,66,10-10-2017 12:56:48,1,3309,3431,1.037,0.5,933,595,158,753,338,245,583,8,0.14,0.0
T23,67,10-10-2017 13:16:48,1,2598,2570,0.989,0.4,63,28,5,33,35,25,60,0,0.0,0.0
T23,68,10-10-2017 13:36:48,1,2893,2655,0.918,0.4,32,14,1,15,18,12,30,0,0.0,0.0
T23,69,10-10-2017 13:56:48,1,3760,3500,0.931,0.6,752,404,181,585,348,282,630,22,0.0,0.1
T23,70,10-10-2017 14:16:48,1,3312,3428,1.035,0.5,1421,629,247,876,792,619,1411,47,0.12,0.08
T23,71,10-10-2017 14:36:48,1,2477,2487,1.004,0.4,228,117,33,150,111,74,185,0,0.0,0.0
T23,72,10-10-2017 14:56:48,1,2736,2455,0.897,0.4,10,6,0,6,4,2,6,0,0.0,0.0
T23,73,10-10-2017 15:16:48,1,3025,2962,0.979,0.5,453,246,64,310,207,174,381,0,0.0,0.23
T23,74,10-10-2017 15:36:48,1,2674,2780,1.04,0.4,511,202,22,224,309,228,537,0,0.0,0.0
T23,75,10-10-2017 15:56:48,1,2560,2499,0.976,0.4,58,29,6,35,29,21,50,1,0.0,0.02
T23,76,10-10-2017 16:16:48,1,2706,2463,0.91,0.4,79,34,6,40,45,30,75,0,0.02,0.0
T23,77,10-10-2017 16:36:48,1,3519,3499,0.994,0.6,843,425,225,650,418,336,754,72,0.1,0.2
T23,78,10-10-2017 16:56:48,1,3308,3339,1.009,0.5,1963,911,262,1173,1052,800,1852,178,0.0,0.0
T23,79,10-10-2017 17:16:48,1,2387,2263,0.948,0.4,30,13,3,16,17,13,30,0,0.0,0.0
T23,80,10-10-2017 17:36:48,1,3320,3050,0.919,0.5,528,248,48,296,280,209,489,0,0.0,0.06
T23,81,10-10-2017 17:56:48,1,3327,3412,1.026,0.5,842,533,180,713,309,251,560,10,0.0,0.17
T23,82,10-10-2017 18:16:48,0,3604,3835,1.064,0.6,488,255,62,317,233,176,409,0,0.0,0.0
T23,83,10-10-2017 18:36:48,0,4055,4126,1.018,0.6,2552,1471,859,2330,1081,893,1974,541,0.14,0.08
T23,84,10-10-2017 18:56:48,0,4572,4732,1.035,0.7,4424,2489,1801,4290,1935,1674,3609,1360,0.08,0.14
T23,85,10-10-2017 19:16:48,0,4159,4085,0.982,0.6,5985,3363,2448,5811,2622,2290,4912,2005,0.0,0.03
T23,86,10-10-2017 19:36:48,0,4163,4237,1.018,0.7,5542,3219,2321,5540,2323,2028,4351,1516,0.06,0.15
T23,87,10-10-2017 19:56:48,0,4051,4124,1.018,0.6,5475,3061,2200,5261,2414,2128,4542,1593,0.02,0.1
T23,88,10-10-2017 20:16:48,0,3966,4006,1.01,0.6,3344,1756,971,2727,1588,1344,2932,729,0.0,0.11
T23,89,10-10-2017 20:36:48,0,4112,4225,1.028,0.6,4297,2314,1462,3776,1983,1722,3705,1711,0.08,0.11
T23,90,10-10-2017 20:56:48,0,3940,4093,1.039,0.6,3719,1963,1175,3138,1756,1526,3282,701,0.08,0.12
T23,91,10-10-2017 21:16:48,0,3813,4020,1.054,0.6,3317,1751,1065,2816,1566,1337,2903,490,0.08,0.18
T23,92,10-10-2017 21:36:48,0,4009,4238,1.057,0.6,3771,1860,1091,2951,1911,1640,3551,460,0.06,0.07
T23,93,10-10-2017 21:56:48,0,3516,3589,1.021,0.6,1690,759,274,1033,931,753,1684,52,0.04,0.15
T23,94,10-10-2017 22:16:48,0,3790,3924,1.035,0.6,3642,1849,1103,2952,1793,1532,3325,698,0.04,0.07
T23,95,10-10-2017 22:36:48,0,3898,4055,1.04,0.6,2434,1189,552,1741,1245,1062,2307,122,0.14,0.13
T23,96,10-10-2017 22:56:48,0,2585,2604,1.008,0.4,430,248,105,353,182,148,330,2,0.04,0.07
T23,97,10-10-2017 23:16:48,0,3438,3576,1.04,0.5,1081,589,311,900,492,410,902,47,0.1,0.24
T23,98,10-10-2017 23:36:48,0,2937,3021,1.028,0.5,1959,1038,492,1530,921,753,1674,177,0.16,0.09
T23,99,10-10-2017 23:56:48,0,4062,4344,1.069,0.6,1432,848,301,1149,584,473,1057,38,0.14,0.16
T23,100,11-10-2017 00:16:48,0,2799,2879,1.029,0.4,719,373,31,404,346,277,623,0,0.0,0.0
T23,101,11-10-2017 00:36:48,0,3052,3158,1.035,0.5,523,274,55,329,249,208,457,0,0.0,0.25
T23,102,11-10-2017 00:56:48,0,2992,3151,1.053,0.5,652,355,159,514,297,243,540,27,0.1,0.02
T23,103,11-10-2017 01:16:48,0,2980,2789,0.936,0.5,91,59,22,81,32,22,54,0,0.0,0.0
T23,104,11-10-2017 01:36:48,0,2682,2803,1.045,0.4,206,96,21,117,110,85,195,0,0.0,0.09
T23,105,11-10-2017 01:56:48,0,2860,3022,1.056,0.5,614,302,124,426,312,267,579,27,0.04,0.12
T23,106,11-10-2017 02:16:48,0,3042,3198,1.051,0.5,308,121,41,162,187,158,345,0,0.0,0.16
T23,107,11-10-2017 02:36:48,0,2970,3103,1.045,0.5,1539,808,317,1125,731,583,1314,61,0.12,0.03
T23,108,11-10-2017 02:56:48,0,2464,2557,1.037,0.4,162,111,14,125,51,41,92,0,0.0,0.0
T23,109,11-10-2017 03:16:48,0,2849,2712,0.952,0.4,56,36,5,41,20,16,36,0,0.0,0.0
T23,110,11-10-2017 03:36:48,0,3854,4034,1.047,0.6,1885,1001,576,1577,884,733,1617,336,0.12,0.26
T23,111,11-10-2017 03:56:48,0,2739,2869,1.048,0.4,1019,535,201,736,484,386,870,50,0.14,0.03
T23,112,11-10-2017 04:16:48,0,2859,2824,0.988,0.4,111,95,8,103,16,14,30,0,0.0,0.0
T23,113,11-10-2017 04:36:48,0,3810,4022,1.056,0.6,1593,912,476,1388,681,562,1243,70,0.1,0.23
T23,114,11-10-2017 04:56:48,0,3203,3342,1.043,0.5,1369,716,263,979,653,522,1175,116,0.06,0.03
T23,115,11-10-2017 05:16:48,0,2762,2723,0.986,0.4,115,43,3,46,72,51,123,0,0.0,0.0
T23,116,11-10-2017 05:36:48,0,3830,4007,1.046,0.6,1913,951,506,1457,962,786,1748,224,0.08,0.18
T23,117,11-10-2017 05:56:48,0,3091,3044,0.985,0.5,837,318,106,424,519,421,940,5,0.08,0.04
T23,118,11-10-2017 06:16:48,1,2881,2704,0.938,0.4,257,191,27,218,66,50,116,2,0.0,0.0
T23,119,11-10-2017 06:36:48,1,2927,2521,0.861,0.4,54,40,2,42,14,13,27,0,0.0,0.0
T23,120,11-10-2017 06:56:48,1,3488,3428,0.983,0.5,1069,585,339,924,484,412,896,71,0.0,0.18
T23,121,11-10-2017 07:16:48,1,2717,2720,1.001,0.4,1189,533,170,703,656,519,1175,106,0.0,0.0
T23,122,11-10-2017 07:36:48,1,2831,2560,0.904,0.4,41,21,3,24,20,14,34,0,0.0,0.0
T23,123,11-10-2017 07:56:48,1,2764,2377,0.86,0.4,30,10,1,11,20,15,35,0,0.0,0.0
T23,124,11-10-2017 08:16:48,1,2677,2231,0.833,0.4,54,30,9,39,24,21,45,0,0.0,0.0
T23,125,11-10-2017 08:36:48,1,3138,2859,0.911,0.5,439,236,64,300,203,161,364,6,0.08,0.18
T23,126,11-10-2017 08:56:48,1,3450,3528,1.022,0.5,1748,943,330,1273,805,637,1442,105,0.04,0.0
T23,127,11-10-2017 09:16:48,1,2608,2510,0.963,0.4,33,21,6,27,12,9,21,0,0.0,0.0
T23,128,11-10-2017 09:36:48,1,2939,2666,0.907,0.5,227,123,22,145,104,83,187,0,0.0,0.08
T23,129,11-10-2017 09:56:48,1,3424,3507,1.024,0.5,1534,706,302,1008,828,686,1514,108,0.14,0.11
T23,130,11-10-2017 10:16:48,1,2689,2618,0.974,0.4,36,20,4,24,16,12,28,0,0.0,0.0
T23,131,11-10-2017 10:36:48,1,2979,2823,0.948,0.5,389,221,110,331,168,131,299,8,0.0,0.15
T23,132,11-10-2017 10:56:48,1,2628,2650,1.008,0.4,59,33,4,37,26,22,48,0,0.0,0.0
T23,133,11-10-2017 11:16:48,1,2867,2779,0.969,0.4,130,47,9,56,83,66,149,0,0.0,0.0
T23,134,11-10-2017 11:36:48,1,3658,3583,0.979,0.6,1774,815,239,1054,959,775,1734,25,0.12,0.08
T23,135,11-10-2017 11:56:48,1,3415,3448,1.01,0.5,1413,692,230,922,721,568,1289,23,0.0,0.06
T23,136,11-10-2017 12:16:48,1,2746,2461,0.896,0.4,183,141,9,150,42,31,73,0,0.0,0.0
T23,137,11-10-2017 12:36:48,1,2696,2271,0.842,0.4,83,48,10,58,35,25,60,0,0.0,0.0
T23,138,11-10-2017 12:56:48,1,3723,3764,1.011,0.6,1563,840,397,1237,723,584,1307,98,0.06,0.19
T23,139,11-10-2017 13:16:48,1,2769,2844,1.027,0.4,324,160,10,170,164,111,275,0,0.0,0.0
T23,140,11-10-2017 13:36:48,1,2585,2394,0.926,0.4,142,34,3,37,108,77,185,0,0.0,0.03
T23,141,11-10-2017 13:56:48,1,2734,2372,0.868,0.4,52,34,6,40,18,14,32,0,0.0,0.0
T23,142,11-10-2017 14:16:48,1,2628,2168,0.825,0.4,39,26,6,32,13,10,23,0,0.0,0.0
T23,143,11-10-2017 14:36:48,1,3556,3498,0.984,0.6,2339,1246,615,1861,1093,903,1996,241,0.14,0.18
T23,144,11-10-2017 14:56:48,1,2806,2758,0.983,0.4,1098,509,61,570,589,460,1049,0,0.0,0.0
T23,145,11-10-2017 15:16:48,1,2663,2293,0.861,0.4,73,42,3,45,31,21,52,0,0.0,0.0
T23,146,11-10-2017 15:36:48,1,2686,2206,0.821,0.4,49,40,7,47,9,7,16,0,0.0,0.03
T23,147,11-10-2017 15:56:48,1,3147,2991,0.95,0.5,1057,556,149,705,501,383,884,0,0.0,0.05
T23,148,11-10-2017 16:16:48,1,2743,2321,0.846,0.4,45,24,4,28,21,16,37,0,0.0,0.0
T23,149,11-10-2017 16:36:48,1,3275,2814,0.859,0.5,268,125,34,159,143,106,249,3,0.0,0.05
T23,150,11-10-2017 16:56:48,1,3443,3184,0.925,0.5,979,544,78,622,435,298,733,0,0.0,0.0
T23,151,11-10-2017 17:16:48,1,3828,3804,0.994,0.6,1300,670,226,896,630,506,1136,66,0.06,0.11
T23,152,11-10-2017 17:36:48,1,3681,3193,0.867,0.6,1977,1061,566,1627,916,758,1674,71,0.04,0.0
T23,153,11-10-2017 17:56:48,1,2591,2371,0.915,0.4,697,261,54,315,436,360,796,0,0.0,0.0
T23,154,11-10-2017 18:16:48,0,4064,4033,0.992,0.6,921,480,104,584,441,348,789,0,0.0,0.09
T23,155,11-10-2017 18:36:48,0,4037,3846,0.953,0.6,2506,1262,537,1799,1244,1044,2288,135,0.08,0.08
T23,156,11-10-2017 18:56:48,0,3925,4065,1.036,0.6,4225,2187,1292,3479,2038,1766,3804,574,0.0,0.14
T23,157,11-10-2017 19:16:48,0,3785,3933,1.039,0.6,4723,2546,1595,4141,2177,1921,4098,886,0.0,0.13
T23,158,11-10-2017 19:36:48,0,3816,4052,1.062,0.6,3709,2116,1216,3332,1593,1365,2958,451,0.08,0.24
T23,159,11-10-2017 19:56:48,0,3686,3844,1.043,0.6,3115,1748,857,2605,1367,1149,2516,423,0.1,0.03
T23,160,11-10-2017 20:16:48,0,4111,4293,1.044,0.7,3211,1765,841,2606,1446,1229,2675,295,0.1,0.08
T23,161,11-10-2017 20:36:48,0,3813,3923,1.029,0.6,3849,1987,1153,3140,1862,1577,3439,457,0.08,0.1
T23,162,11-10-2017 20:56:48,0,3888,4054,1.043,0.6,3242,1662,964,2626,1580,1330,2910,242,0.1,0.23
T23,163,11-10-2017 21:16:48,0,2686,2656,0.989,0.4,1015,456,147,603,559,433,992,20,0.1,0.0
T23,164,11-10-2017 21:36:48,0,3452,3420,0.991,0.5,384,170,66,236,214,173,387,22,0.0,0.2
T23,165,11-10-2017 21:56:48,0,3573,3774,1.056,0.6,995,501,252,753,494,420,914,69,0.24,0.15
T23,166,11-10-2017 22:16:48,0,3504,3751,1.07,0.6,623,274,124,398,349,279,628,4,0.06,0.11
T23,167,11-10-2017 22:36:48,0,2859,3017,1.055,0.5,474,111,27,138,363,273,636,0,0.0,0.0
T23,168,11-10-2017 22:56:48,0,2721,2885,1.06,0.4,179,125,18,143,54,39,93,0,0.0,0.0
T23,169,11-10-2017 23:16:48,0,3666,3914,1.068,0.6,1130,597,120,717,533,431,964,9,0.1,0.3
T23,170,11-10-2017 23:36:48,0,3911,4268,1.091,0.6,1571,837,510,1347,734,626,1360,87,0.18,0.11
T23,171,11-10-2017 23:56:48,0,3405,3620,1.063,0.5,2801,1427,637,2064,1374,1142,2516,157,0.12,0.08
T23,172,12-10-2017 00:16:48,0,2756,2903,1.053,0.4,620,398,42,440,222,176,398,0,0.0,0.03
T23,173,12-10-2017 00:36:48,0,2855,2828,0.991,0.4,57,32,3,35,25,18,43,0,0.0,0.0
T23,174,12-10-2017 00:56:48,0,2679,2594,0.968,0.4,245,120,22,142,125,102,227,0,0.0,0.12
T23,175,12-10-2017 01:16:48,0,2686,2739,1.02,0.4,107,52,11,63,55,43,98,0,0.0,0.0
T23,176,12-10-2017 01:36:48,0,3797,3962,1.044,0.6,1610,883,478,1361,727,609,1336,111,0.06,0.12
T23,177,12-10-2017 01:56:48,0,2671,2479,0.928,0.4,560,201,20,221,359,293,652,0,0.0,0.0
T23,178,12-10-2017 02:16:48,0,3231,2882,0.892,0.5,305,174,28,202,131,97,228,0,0.0,0.0
T23,179,12-10-2017 02:36:48,0,3696,3706,1.003,0.6,1065,698,112,810,367,270,637,0,0.0,0.13
T23,180,12-10-2017 02:56:48,0,3497,3542,1.013,0.6,2951,1532,798,2330,1419,1212,2631,223,0.16,0.14
T23,181,12-10-2017 03:16:48,0,2828,2869,1.014,0.4,2031,1007,513,1520,1024,849,1873,219,0.0,0.05
T23,182,12-10-2017 03:36:48,0,3104,3054,0.984,0.5,217,97,25,122,120,91,211,0,0.0,0.1
T23,183,12-10-2017 03:56:48,0,3561,3708,1.041,0.6,1700,863,389,1252,837,682,1519,32,0.14,0.12
T23,184,12-10-2017 04:16:48,0,3202,3281,1.025,0.5,408,235,36,271,173,136,309,0,0.0,0.0
T23,185,12-10-2017 04:36:48,0,3476,3718,1.069,0.6,517,267,92,359,250,189,439,22,0.1,0.13
T23,186,12-10-2017 04:56:48,0,3821,4088,1.07,0.6,2907,1291,699,1990,1616,1375,2991,125,0.12,0.22
T23,187,12-10-2017 05:16:48,0,2917,3062,1.049,0.5,1054,535,311,846,519,438,957,55,0.04,0.03
T23,188,12-10-2017 05:36:48,0,3766,3956,1.051,0.6,2523,1323,745,2068,1200,1008,2208,139,0.06,0.13
T23,189,12-10-2017 05:56:48,0,2817,2874,1.02,0.4,240,108,23,131,132,100,232,0,0.0,0.03
T23,190,12-10-2017 06:16:48,1,3723,3842,1.032,0.6,2243,1091,709,1800,1152,980,2132,165,0.12,0.15
T23,191,12-10-2017 06:36:48,1,2542,2562,1.008,0.4,657,306,49,355,351,279,630,0,0.0,0.0
T23,192,12-10-2017 06:56:48,1,2753,2658,0.965,0.4,21,9,1,10,12,9,21,0,0.0,0.0
T23,193,12-10-2017 07:16:48,1,2830,2786,0.984,0.4,365,192,36,228,173,126,299,0,0.0,0.14
T23,194,12-10-2017 07:36:48,1,2592,2559,0.987,0.4,42,22,8,30,20,13,33,0,0.0,0.0
T23,195,12-10-2017 07:56:48,1,3326,3305,0.994,0.5,628,250,42,292,378,281,659,0,0.0,0.11
T23,196,12-10-2017 08:16:48,1,2536,2466,0.973,0.4,173,96,52,148,77,64,141,5,0.0,0.0
T23,197,12-10-2017 08:36:48,1,2440,2315,0.949,0.4,428,204,53,257,224,166,390,0,0.02,0.06
T23,198,12-10-2017 08:56:48,1,2606,2482,0.952,0.4,55,33,9,42,22,17,39,0,0.0,0.0
T23,199,12-10-2017 09:16:48,1,2430,2219,0.913,0.4,33,25,6,31,8,6,14,0,0.0,0.0
T23,200,12-10-2017 09:36:48,1,3850,3394,0.882,0.6,1767,895,497,1392,872,721,1593,71,0.04,0.04
T23,201,12-10-2017 09:56:48,1,2971,2667,0.898,0.5,2693,1589,907,2496,1104,897,2001,112,0.04,0.0
T23,202,12-10-2017 10:16:48,1,2648,2167,0.818,0.4,38,14,4,18,24,14,38,0,0.0,0.0
T23,203,12-10-2017 10:36:48,1,2534,2046,0.807,0.4,72,31,10,41,41,26,67,0,0.0,0.0
T23,204,12-10-2017 10:56:48,1,3332,2807,0.842,0.5,801,484,125,609,317,242,559,6,0.0,0.12
T23,205,12-10-2017 11:16:48,1,2655,2531,0.953,0.4,252,108,11,119,144,92,236,0,0.0,0.0
T23,206,12-10-2017 11:36:48,1,2505,2252,0.899,0.4,106,45,9,54,61,37,98,0,0.0,0.0
T23,207,12-10-2017 11:56:48,1,3253,2900,0.892,0.5,520,247,115,362,273,205,478,31,0.14,0.09
T23,208,12-10-2017 12:16:48,1,2639,2546,0.965,0.4,446,199,23,222,247,177,424,0,0.0,0.0
T23,209,12-10-2017 12:36:48,1,3239,3108,0.96,0.5,527,298,150,448,229,185,414,38,0.08,0.16
T23,210,12-10-2017 12:56:48,1,2551,2546,0.998,0.4,1248,584,293,877,664,508,1172,25,0.04,0.0
T23,211,12-10-2017 13:16:48,1,2463,2280,0.926,0.4,134,53,19,72,81,55,136,0,0.0,0.0
T23,212,12-10-2017 13:36:48,1,2381,2103,0.883,0.4,79,17,6,23,62,41,103,0,0.0,0.0
T23,213,12-10-2017 13:56:48,1,3507,3138,0.895,0.5,819,402,214,616,417,338,755,8,0.0,0.0
T23,214,12-10-2017 14:16:48,1,2569,2241,0.872,0.4,580,261,65,326,319,224,543,0,0.0,0.0
T23,215,12-10-2017 14:36:48,1,2541,2113,0.832,0.4,56,23,10,33,33,22,55,0,0.0,0.0
T23,216,12-10-2017 14:56:48,1,2484,2013,0.81,0.4,28,16,1,17,12,10,22,0,0.0,0.0
T23,217,12-10-2017 15:16:48,1,3318,2829,0.853,0.5,263,163,32,195,100,75,175,9,0.0,0.05
T23,218,12-10-2017 15:36:48,1,3262,2924,0.896,0.5,1155,656,182,838,499,375,874,12,0.0,0.0
T23,219,12-10-2017 15:56:48,1,2709,2415,0.892,0.4,445,265,98,363,180,143,323,1,0.0,0.16
T23,220,12-10-2017 16:16:48,1,2496,2433,0.975,0.4,62,14,5,19,48,30,78,0,0.0,0.0
T23,221,12-10-2017 16:36:48,1,2490,2252,0.904,0.4,83,39,16,55,44,29,73,0,0.0,0.0
T23,222,12-10-2017 16:56:48,1,3068,3032,0.988,0.5,678,423,79,502,255,194,449,0,0.0,0.07
T23,223,12-10-2017 17:16:48,1,3200,3052,0.954,0.5,517,295,43,338,222,147,369,0,0.0,0.0
T23,224,12-10-2017 17:36:48,1,3380,3098,0.916,0.5,1985,1028,439,1467,957,786,1743,33,0.08,0.13
T23,225,12-10-2017 17:56:48,1,3054,2913,0.954,0.5,668,379,27,406,289,221,510,0,0.0,0.0
T23,226,12-10-2017 18:16:48,0,3129,2950,0.943,0.5,1665,815,459,1274,850,721,1571,88,0.08,0.14
T23,227,12-10-2017 18:36:48,0,4131,4093,0.991,0.6,1680,978,183,1161,702,531,1233,0,0.0,0.0
T23,228,12-10-2017 18:56:48,0,3745,3780,1.009,0.6,2946,1511,816,2327,1435,1257,2692,199,0.14,0.24
T23,229,12-10-2017 19:16:48,0,4009,4144,1.034,0.6,3376,1773,960,2733,1603,1395,2998,445,0.12,0.08
T23,230,12-10-2017 19:36:48,0,3326,3259,0.98,0.5,2369,1179,637,1816,1190,1004,2194,141,0.04,0.0
T23,231,12-10-2017 19:56:48,0,3486,3270,0.938,0.5,2081,1147,555,1702,934,785,1719,139,0.02,0.0
T23,232,12-10-2017 20:16:48,0,2396,2034,0.849,0.4,1775,962,416,1378,813,677,1490,98,0.0,0.0
T23,233,12-10-2017 20:36:48,0,3071,2504,0.815,0.5,170,127,39,166,43,28,71,0,0.0,0.0
T23,234,12-10-2017 20:56:48,0,3482,2783,0.799,0.5,2653,1531,734,2265,1122,948,2070,248,0.0,0.0
T23,235,12-10-2017 21:16:48,0,3180,2510,0.789,0.5,3744,1977,1123,3100,1767,1513,3280,235,0.04,0.0
T23,236,12-10-2017 21:36:48,0,2191,1699,0.775,0.3,476,305,63,368,171,119,290,0,0.0,0.0
T23,237,12-10-2017 21:56:48,0,2651,2015,0.76,0.4,57,39,0,39,18,11,29,0,0.0,0.0
T23,238,12-10-2017 22:16:48,0,2929,2290,0.782,0.4,469,215,22,237,254,182,436,0,0.0,0.0
T23,239,12-10-2017 22:36:48,0,3966,3097,0.781,0.6,2395,1352,833,2185,1043,870,1913,337,0.04,0.0
T23,240,12-10-2017 22:56:48,0,2959,2220,0.75,0.4,2266,1199,688,1887,1067,915,1982,235,0.06,0.0
T23,241,12-10-2017 23:16:48,0,2025,1464,0.723,0.3,210,96,14,110,114,82,196,0,0.0,0.0
T23,242,12-10-2017 23:36:48,0,2326,1730,0.744,0.3,100,24,3,27,76,50,126,0,0.0,0.0
T23,243,12-10-2017 23:56:48,0,2172,1631,0.751,0.3,95,24,7,31,71,52,123,0,0.0,0.0
T23,244,13-10-2017 00:16:48,0,2508,1873,0.747,0.4,37,9,2,11,28,17,45,0,0.0,0.0
T23,245,13-10-2017 00:36:48,0,3259,2455,0.753,0.5,1679,800,342,1142,879,715,1594,65,0.0,0.0
T23,246,13-10-2017 00:56:48,0,1738,1302,0.749,0.3,548,286,211,497,262,224,486,43,0.02,0.0
T23,247,13-10-2017 01:16:48,0,2102,1532,0.729,0.3,17,11,2,13,6,5,11,0,0.0,0.0
T23,248,13-10-2017 01:36:48,0,3100,2370,0.764,0.5,912,486,104,590,426,320,746,0,0.0,0.0
T23,249,13-10-2017 01:56:48,0,2620,1994,0.761,0.4,1953,1103,603,1706,850,695,1545,108,0.02,0.0
T23,250,13-10-2017 02:16:48,0,1553,1134,0.73,0.2,60,33,5,38,27,16,43,0,0.0,0.0
T23,251,13-10-2017 02:36:48,0,3191,2478,0.776,0.5,659,347,39,386,312,227,539,0,0.0,0.0
T23,252,13-10-2017 02:56:48,0,2879,2147,0.746,0.4,2281,1158,631,1789,1123,912,2035,120,0.04,0.0
T23,253,13-10-2017 03:16:48,0,1619,1254,0.775,0.2,209,80,7,87,129,80,209,0,0.0,0.0
T23,254,13-10-2017 03:36:48,0,2101,1513,0.72,0.3,83,40,2,42,43,27,70,0,0.0,0.0
T23,255,13-10-2017 03:56:48,0,1870,1382,0.739,0.3,72,33,9,42,39,23,62,0,0.0,0.0
T23,256,13-10-2017 04:16:48,0,3726,2831,0.76,0.6,1252,570,233,803,682,523,1205,12,0.0,0.0
T23,257,13-10-2017 04:36:48,0,3292,2560,0.778,0.5,1669,982,407,1389,687,537,1224,43,0.08,0.0
T23,258,13-10-2017 04:56:48,0,1755,1231,0.701,0.3,784,440,244,684,344,293,637,51,0.02,0.0
T23,259,13-10-2017 05:16:48,0,1561,1135,0.727,0.2,131,62,11,73,69,47,116,0,0.0,0.0
T23,260,13-10-2017 05:36:48,0,1639,1218,0.743,0.2,55,34,4,38,21,13,34,0,0.0,0.0
T23,261,13-10-2017 05:56:48,0,2131,1560,0.732,0.3,150,86,2,88,64,44,108,0,0.0,0.0
T23,262,13-10-2017 06:16:48,1,1915,1431,0.747,0.3,139,31,7,38,108,71,179,0,0.0,0.0
T23,263,13-10-2017 06:36:48,1,3062,2275,0.743,0.5,369,144,24,168,225,153,378,4,0.0,0.0
T23,264,13-10-2017 06:56:48,1,2320,1705,0.735,0.3,1963,1018,579,1597,945,755,1700,97,0.08,0.0
T23,265,13-10-2017 07:16:48,1,1480,1129,0.763,0.2,60,16,3,19,44,33,77,0,0.0,0.0
T23,266,13-10-2017 07:36:48,1,3619,3173,0.877,0.6,610,375,120,495,235,183,418,0,0.0,0.37
T23,267,13-10-2017 07:56:48,1,3470,3404,0.981,0.5,1283,816,417,1233,467,387,854,67,0.54,0.37
T23,268,13-10-2017 08:16:48,1,2485,2439,0.981,0.4,757,397,152,549,360,266,626,12,0.1,0.01
T23,269,13-10-2017 08:36:48,1,2349,2428,1.034,0.4,22,12,2,14,10,7,17,0,0.0,-0.03
T23,270,13-10-2017 08:56:48,1,2982,3111,1.044,0.5,377,264,82,346,113,76,189,0,0.0,-0.02
T23,271,13-10-2017 09:16:48,1,2982,3039,1.019,0.5,1029,615,294,909,414,310,724,54,0.34,0.41
T23,272,13-10-2017 09:36:48,1,2114,2261,1.07,0.3,47,24,9,33,23,16,39,0,0.0,0.0
T23,273,13-10-2017 09:56:48,1,2372,2524,1.064,0.4,69,40,14,54,29,20,49,0,0.0,-0.03
T23,274,13-10-2017 10:16:48,1,3494,3784,1.083,0.6,552,296,57,353,256,192,448,0,0.0,0.0
T23,275,13-10-2017 10:36:48,1,3486,3669,1.052,0.6,1965,1192,769,1961,773,642,1415,66,0.26,0.37
T23,276,13-10-2017 10:56:48,1,2439,2629,1.078,0.4,605,184,21,205,421,315,736,0,0.0,0.0
T23,277,13-10-2017 11:16:48,1,2273,2441,1.074,0.4,40,16,5,21,24,15,39,0,0.0,-0.02
T23,278,13-10-2017 11:36:48,1,3443,3605,1.047,0.5,739,515,100,615,224,176,400,0,0.0,0.04
T23,279,13-10-2017 11:56:48,1,2414,2483,1.029,0.4,525,320,157,477,205,160,365,44,0.26,0.3
T23,280,13-10-2017 12:16:48,1,2714,2856,1.052,0.4,130,53,7,60,77,53,130,0,0.0,0.0
T23,281,13-10-2017 12:36:48,1,2554,2743,1.074,0.4,319,172,25,197,147,100,247,0,0.0,0.0
T23,282,13-10-2017 12:56:48,1,2355,2528,1.074,0.4,344,125,19,144,219,147,366,0,0.0,0.0
T23,283,13-10-2017 13:16:48,1,2558,2732,1.068,0.4,97,55,11,66,42,32,74,0,0.0,0.0
T23,284,13-10-2017 13:36:48,1,3466,3714,1.072,0.6,698,403,175,578,295,233,528,26,0.1,0.18
T23,285,13-10-2017 13:56:48,1,2409,2520,1.046,0.4,987,460,161,621,527,393,920,22,0.14,0.0
T23,286,31-10-2019 00:00:00,0,0,0,0.0,0.0,0,0,0,0,0,0,0,0,0.0,0.0
T21,1,09-10-2017 15:12:48,1,3584,2757,0.769,0.4,455,238,39,277,217,73,290,3,0.0,0.0
T21,2,09-10-2017 15:32:48,1,3132,2350,0.75,0.4,36,20,1,21,16,9,25,0,0.0,0.0
T21,3,09-10-2017 15:52:48,1,3038,2254,0.742,0.4,48,32,2,34,16,5,21,0,0.0,0.0
T21,4,09-10-2017 16:12:48,1,3007,2247,0.747,0.4,34,25,1,26,9,0,9,0,0.0,0.0
T21,5,09-10-2017 16:32:48,1,2723,2002,0.735,0.3,90,49,15,64,41,20,61,0,0.0,0.0
T21,6,09-10-2017 16:52:48,1,2946,2199,0.746,0.4,87,62,5,67,25,10,35,0,0.0,0.0
T21,7,09-10-2017 17:12:48,1,4783,3680,0.769,0.6,1890,1246,599,1845,644,326,970,142,0.0,0.0
T21,8,09-10-2017 17:32:48,1,4182,3562,0.852,0.5,3127,1909,1148,3057,1218,683,1901,458,0.0,0.09
T21,9,09-10-2017 17:52:48,1,3284,2771,0.844,0.4,1041,584,171,755,457,141,598,25,0.0,-0.02
T21,10,09-10-2017 18:12:48,0,4377,3720,0.85,0.5,932,527,257,784,405,181,586,74,0.0,0.0
T21,11,09-10-2017 18:32:48,0,4440,3846,0.866,0.5,3732,2237,1435,3672,1495,938,2433,979,0.0,0.05
T21,12,09-10-2017 18:52:48,0,4495,4361,0.97,0.6,4034,2353,1461,3814,1681,1030,2711,944,0.0,0.09
T21,13,09-10-2017 19:12:48,0,4383,4441,1.013,0.6,4568,2670,1671,4341,1898,1203,3101,923,0.08,0.13
T21,14,09-10-2017 19:32:48,0,4681,4697,1.003,0.6,2966,1807,913,2720,1159,543,1702,384,0.04,0.11
T21,15,09-10-2017 19:52:48,0,4433,4473,1.009,0.6,2666,1490,771,2261,1176,574,1750,284,0.04,0.06
T21,16,09-10-2017 20:12:48,0,4530,4723,1.043,0.6,2934,1696,997,2693,1238,690,1928,444,0.1,0.14
T21,17,09-10-2017 20:32:48,0,4315,4497,1.042,0.6,2797,1655,825,2480,1142,582,1724,303,0.08,0.07
T21,18,09-10-2017 20:52:48,0,3133,3198,1.021,0.4,909,525,210,735,384,146,530,11,0.04,0.19
T21,19,09-10-2017 21:12:48,0,2938,3079,1.048,0.4,756,438,258,696,318,173,491,64,0.04,0.0
T21,20,09-10-2017 21:32:48,0,3781,3978,1.052,0.5,841,478,157,635,363,110,473,13,0.02,0.14
T21,21,09-10-2017 21:52:48,0,3295,3527,1.07,0.4,691,391,164,555,300,148,448,12,0.12,0.18
T21,22,09-10-2017 22:12:48,0,3522,3803,1.08,0.5,508,297,100,397,211,91,302,0,0.08,0.12
T21,23,09-10-2017 22:32:48,0,3168,3385,1.068,0.4,557,325,81,406,232,72,304,16,0.02,0.05
T21,24,09-10-2017 22:52:48,0,3552,3782,1.065,0.5,571,344,112,456,227,94,321,16,0.08,0.12
T21,25,09-10-2017 23:12:48,0,3045,3316,1.089,0.4,163,100,34,134,63,31,94,0,0.0,0.06
T21,26,09-10-2017 23:32:48,0,2951,3223,1.092,0.4,281,175,79,254,106,50,156,0,0.08,0.08
T21,27,09-10-2017 23:52:48,0,3285,3543,1.079,0.4,222,136,56,192,86,49,135,0,0.02,0.08
T21,28,10-10-2017 00:12:48,0,3810,4104,1.077,0.5,384,235,78,313,149,51,200,0,0.02,0.17
T21,29,10-10-2017 00:32:48,0,4970,5304,1.067,0.6,2624,1541,744,2285,1083,544,1627,488,0.04,0.0
T21,30,10-10-2017 00:52:48,0,4550,4941,1.086,0.6,2983,1800,1075,2875,1183,710,1893,635,0.06,0.15
T21,31,10-10-2017 01:12:48,0,4526,4862,1.074,0.6,3483,2068,1307,3375,1415,860,2275,740,0.04,0.13
T21,32,10-10-2017 01:32:48,0,3418,3607,1.055,0.4,845,494,93,587,351,97,448,3,0.0,0.0
T21,33,10-10-2017 01:52:48,0,4116,4339,1.054,0.5,1695,1000,453,1453,695,328,1023,288,0.12,0.05
T21,34,10-10-2017 02:12:48,0,2946,3085,1.047,0.4,42,21,3,24,21,0,21,0,0.0,0.0
T21,35,10-10-2017 02:32:48,0,3311,3484,1.052,0.4,273,158,57,215,115,56,171,0,0.0,0.0
T21,36,10-10-2017 02:52:48,0,4065,4321,1.063,0.5,1341,822,305,1127,519,212,731,6,0.0,0.27
T21,37,10-10-2017 03:12:48,0,3057,3220,1.053,0.4,51,19,7,26,32,7,39,0,0.08,0.0
T21,38,10-10-2017 03:32:48,0,4445,4758,1.07,0.6,1058,524,168,692,534,126,660,0,0.12,0.2
T21,39,10-10-2017 03:52:48,0,3668,3805,1.037,0.5,334,161,32,193,173,35,208,0,0.0,0.0
T21,40,10-10-2017 04:12:48,0,4454,4763,1.069,0.6,1340,732,375,1107,608,307,915,99,0.0,0.22
T21,41,10-10-2017 04:32:48,0,3666,3934,1.073,0.5,1860,994,454,1448,866,343,1209,242,0.08,0.03
T21,42,10-10-2017 04:52:48,0,4254,4577,1.076,0.5,1176,714,328,1042,462,202,664,133,0.08,0.15
T21,43,10-10-2017 05:12:48,0,3443,3641,1.058,0.4,296,172,92,264,124,60,184,16,0.0,0.0
T21,44,10-10-2017 05:32:48,0,4813,5143,1.069,0.6,2286,1341,786,2127,945,535,1480,374,0.02,0.14
T21,45,10-10-2017 05:52:48,0,4145,4376,1.056,0.5,2015,1143,611,1754,872,434,1306,314,0.04,0.0
T21,46,10-10-2017 06:12:48,1,3830,3854,1.006,0.5,1263,779,249,1028,484,235,719,87,0.0,-0.03
T21,47,10-10-2017 06:32:48,1,3220,3112,0.966,0.4,63,28,9,37,35,10,45,0,0.0,0.0
T21,48,10-10-2017 06:52:48,1,3531,3466,0.982,0.4,126,77,23,100,49,10,59,0,0.0,0.0
T21,49,10-10-2017 07:12:48,1,2640,2658,1.007,0.3,594,369,184,553,225,96,321,7,0.0,0.09
T21,50,10-10-2017 07:32:48,1,4004,3963,0.99,0.5,309,192,60,252,117,25,142,0,0.0,0.0
T21,51,10-10-2017 07:52:48,1,3176,3184,1.003,0.4,531,262,50,312,269,73,342,3,0.04,0.08
T21,52,10-10-2017 08:12:48,1,2939,2777,0.945,0.4,57,36,9,45,21,0,21,0,0.0,0.0
T21,53,10-10-2017 08:32:48,1,2580,2515,0.975,0.3,299,188,75,263,111,48,159,6,0.0,0.04
T21,54,10-10-2017 08:52:48,1,2793,2589,0.927,0.3,43,30,4,34,13,4,17,0,0.0,0.0
T21,55,10-10-2017 09:12:48,1,2560,2303,0.9,0.3,20,9,0,9,11,5,16,0,0.0,0.0
T21,56,10-10-2017 09:32:48,1,3050,2762,0.906,0.4,721,439,138,577,282,100,382,19,0.0,0.0
T21,57,10-10-2017 09:52:48,1,2831,2492,0.88,0.3,49,17,4,21,32,0,32,0,0.0,0.03
T21,58,10-10-2017 10:12:48,1,2987,2607,0.873,0.4,67,32,3,35,35,7,42,0,0.0,0.0
T21,59,10-10-2017 10:32:48,1,3615,3270,0.905,0.4,416,202,50,252,214,65,279,0,0.02,0.12
T21,60,10-10-2017 10:52:48,1,3337,3151,0.944,0.4,273,141,18,159,132,37,169,0,0.04,0.0
T21,61,10-10-2017 11:12:48,1,3082,2841,0.922,0.4,34,29,0,29,5,0,5,0,0.0,0.0
T21,62,10-10-2017 11:32:48,1,3300,2940,0.891,0.4,145,76,25,101,69,27,96,0,0.0,0.0
T21,63,10-10-2017 11:52:48,1,3452,3356,0.972,0.4,1486,894,357,1251,592,245,837,153,0.04,0.07
T21,64,10-10-2017 12:12:48,1,2975,2660,0.894,0.4,215,104,7,111,111,20,131,0,0.0,0.0
T21,65,10-10-2017 12:32:48,1,2967,2647,0.892,0.4,174,110,18,128,64,28,92,0,0.0,0.03
T21,66,10-10-2017 12:52:48,1,2922,2601,0.89,0.4,263,232,21,253,31,12,43,0,0.0,0.0
T21,67,10-10-2017 13:12:48,1,4019,3986,0.992,0.5,1129,571,172,743,558,140,698,37,0.02,0.11
T21,68,10-10-2017 13:32:48,1,3096,2912,0.94,0.4,81,36,4,40,45,5,50,0,0.0,0.0
T21,69,10-10-2017 13:52:48,1,4437,3887,0.876,0.5,671,454,242,696,217,121,338,11,0.02,0.0
T21,70,10-10-2017 14:12:48,1,2960,2551,0.862,0.4,187,112,10,122,75,16,91,0,0.0,0.0
T21,71,10-10-2017 14:32:48,1,4244,3729,0.879,0.5,207,138,48,186,69,28,97,0,0.0,0.05
T21,72,10-10-2017 14:52:48,1,2974,2775,0.933,0.4,501,244,93,337,257,64,321,14,0.02,0.0
T21,73,10-10-2017 15:12:48,1,3154,2768,0.878,0.4,71,60,2,62,11,5,16,0,0.0,0.0
T21,74,10-10-2017 15:32:48,1,3287,3199,0.973,0.4,287,144,42,186,143,44,187,0,0.0,0.1
T21,75,10-10-2017 15:52:48,1,2772,2717,0.98,0.3,41,21,7,28,20,4,24,0,0.0,0.0
T21,76,10-10-2017 16:12:48,1,3562,3235,0.908,0.4,159,99,35,134,60,28,88,0,0.02,0.04
T21,77,10-10-2017 16:32:48,1,2810,2853,1.015,0.4,398,253,87,340,145,66,211,10,0.04,0.07
T21,78,10-10-2017 16:52:48,1,3001,2835,0.945,0.4,119,73,19,92,46,15,61,0,0.0,0.0
T21,79,10-10-2017 17:12:48,1,3953,4026,1.018,0.5,1011,645,143,788,366,100,466,13,0.04,0.07
T21,80,10-10-2017 17:32:48,1,2986,2812,0.942,0.4,65,36,5,41,29,6,35,0,0.0,0.0
T21,81,10-10-2017 17:52:48,1,3920,3819,0.974,0.5,470,335,121,456,135,59,194,35,0.06,0.14
T21,82,10-10-2017 18:12:48,0,3703,3736,1.009,0.5,728,533,70,603,195,50,245,0,0.02,0.0
T21,83,10-10-2017 18:32:48,0,4288,4519,1.054,0.6,886,451,91,542,435,111,546,10,0.02,0.08
T21,84,10-10-2017 18:52:48,0,4523,4330,0.957,0.6,3982,2464,1568,4032,1518,917,2435,960,0.0,0.08
T21,85,10-10-2017 19:12:48,0,4638,4741,1.022,0.6,3057,1833,1031,2864,1224,706,1930,781,0.04,0.03
T21,86,10-10-2017 19:32:48,0,4293,4506,1.05,0.6,2158,1281,623,1904,877,443,1320,424,0.04,0.14
T21,87,10-10-2017 19:52:48,0,4592,4937,1.075,0.6,2108,1268,669,1937,840,478,1318,439,0.08,0.12
T21,88,10-10-2017 20:12:48,0,3106,3380,1.088,0.4,629,389,104,493,240,74,314,0,0.0,0.07
T21,89,10-10-2017 20:32:48,0,4810,5221,1.085,0.6,1977,1175,758,1933,802,476,1278,541,0.08,0.16
T21,90,10-10-2017 20:52:48,0,4592,4958,1.08,0.6,3834,2309,1444,3753,1525,904,2429,957,0.0,0.04
T21,91,10-10-2017 21:12:48,0,4601,4935,1.073,0.6,2637,1617,839,2456,1020,530,1550,282,0.04,0.13
T21,92,10-10-2017 21:32:48,0,4571,4938,1.08,0.6,3427,2005,1215,3220,1422,891,2313,828,0.04,0.12
T21,93,10-10-2017 21:52:48,0,3693,3839,1.04,0.5,1691,961,459,1420,730,342,1072,185,0.0,0.03
T21,94,10-10-2017 22:12:48,0,4110,4325,1.052,0.5,934,626,167,793,308,91,399,3,0.1,0.18
T21,95,10-10-2017 22:32:48,0,3483,3760,1.08,0.4,636,411,184,595,225,103,328,13,0.08,0.2
T21,96,10-10-2017 22:52:48,0,3398,3711,1.092,0.4,461,284,109,393,177,81,258,9,0.08,0.1
T21,97,10-10-2017 23:12:48,0,3811,4136,1.085,0.5,302,190,85,275,112,36,148,0,0.02,0.11
T21,98,10-10-2017 23:32:48,0,3478,3791,1.09,0.5,378,237,57,294,141,50,191,0,0.08,0.04
T21,99,10-10-2017 23:52:48,0,4181,4532,1.084,0.5,402,239,83,322,163,79,242,0,0.06,0.26
T21,100,11-10-2017 00:12:48,0,3633,4015,1.105,0.5,1328,840,490,1330,488,254,742,176,0.04,0.05
T21,101,11-10-2017 00:32:48,0,2979,3307,1.11,0.4,75,36,8,44,39,10,49,0,0.04,0.0
T21,102,11-10-2017 00:52:48,0,3974,4312,1.085,0.5,320,211,82,293,109,40,149,0,0.02,0.15
T21,103,11-10-2017 01:12:48,0,4074,4115,1.01,0.5,1309,744,293,1037,565,214,779,51,0.06,0.07
T21,104,11-10-2017 01:32:48,0,2942,3357,1.141,0.4,71,50,13,63,21,5,26,0,0.0,0.0
T21,105,11-10-2017 01:52:48,0,2970,3261,1.098,0.4,99,59,14,73,40,16,56,0,0.0,0.0
T21,106,11-10-2017 02:12:48,0,3790,4162,1.098,0.5,1100,679,269,948,421,128,549,4,0.06,0.25
T21,107,11-10-2017 02:32:48,0,3880,4256,1.097,0.5,494,343,90,433,151,50,201,0,0.04,0.06
T21,108,11-10-2017 02:52:48,0,3731,3914,1.049,0.5,781,461,32,493,320,61,381,3,0.0,0.0
T21,109,11-10-2017 03:12:48,0,4043,4157,1.028,0.5,306,164,58,222,142,48,190,0,0.0,0.04
T21,110,11-10-2017 03:32:48,0,3013,3319,1.102,0.4,805,497,151,648,308,81,389,4,0.02,0.14
T21,111,11-10-2017 03:52:48,0,3752,4097,1.092,0.5,614,361,158,519,253,128,381,25,0.06,0.16
T21,112,11-10-2017 04:12:48,0,3670,3967,1.081,0.5,107,58,22,80,49,20,69,0,0.02,0.0
T21,113,11-10-2017 04:32:48,0,4874,5328,1.093,0.6,2411,1427,886,2313,984,539,1523,427,0.06,0.15
T21,114,11-10-2017 04:52:48,0,3944,4206,1.066,0.5,2689,1574,932,2506,1115,672,1787,436,0.04,0.05
T21,115,11-10-2017 05:12:48,0,2958,3171,1.072,0.4,594,318,57,375,276,74,350,0,0.0,0.0
T21,116,11-10-2017 05:32:48,0,4375,4337,0.991,0.6,486,288,154,442,198,75,273,0,0.0,0.14
T21,117,11-10-2017 05:52:48,0,4270,4526,1.06,0.5,2946,1722,1037,2759,1224,681,1905,546,0.08,0.07
T21,118,11-10-2017 06:12:48,1,3672,3806,1.036,0.5,914,414,120,534,500,177,677,27,0.06,0.03
T21,119,11-10-2017 06:32:48,1,3105,2907,0.936,0.4,84,64,21,85,20,11,31,0,0.0,0.0
T21,120,11-10-2017 06:52:48,1,4552,4379,0.962,0.6,1208,769,475,1244,439,200,639,102,0.0,0.07
T21,121,11-10-2017 07:12:48,1,3067,2767,0.902,0.4,475,189,68,257,286,94,380,2,0.02,0.0
T21,122,11-10-2017 07:32:48,1,2949,2634,0.893,0.4,99,51,11,62,48,15,63,0,0.0,0.0
T21,123,11-10-2017 07:52:48,1,2932,2586,0.882,0.4,40,20,5,25,20,4,24,0,0.0,0.0
T21,124,11-10-2017 08:12:48,1,2912,2483,0.853,0.4,145,72,22,94,73,14,87,0,0.0,0.0
T21,125,11-10-2017 08:32:48,1,2713,2563,0.945,0.3,642,391,189,580,251,121,372,32,0.0,0.09
T21,126,11-10-2017 08:52:48,1,2941,2573,0.875,0.4,29,18,7,25,11,4,15,0,0.0,0.0
T21,127,11-10-2017 09:12:48,1,3770,3418,0.907,0.5,1096,580,146,726,516,126,642,16,0.02,0.0
T21,128,11-10-2017 09:32:48,1,3059,2601,0.85,0.4,46,9,0,9,37,5,42,0,0.0,0.03
T21,129,11-10-2017 09:52:48,1,2874,2401,0.835,0.3,203,162,21,183,41,20,61,0,0.0,0.0
T21,130,11-10-2017 10:12:48,1,3200,2573,0.804,0.4,61,47,10,57,14,4,18,0,0.0,0.0
T21,131,11-10-2017 10:32:48,1,3161,2640,0.835,0.4,187,117,37,154,70,21,91,0,0.0,0.0
T21,132,11-10-2017 10:52:48,1,3898,3592,0.922,0.5,1386,791,281,1072,595,211,806,58,0.02,0.08
T21,133,11-10-2017 11:12:48,1,3049,2525,0.828,0.4,310,212,139,351,98,55,153,24,0.02,0.0
T21,134,11-10-2017 11:32:48,1,2933,2358,0.804,0.4,131,73,17,90,58,16,74,3,0.0,0.02
T21,135,11-10-2017 11:52:48,1,2760,2243,0.813,0.3,380,229,93,322,151,40,191,2,0.02,0.03
T21,136,11-10-2017 12:12:48,1,3209,2664,0.83,0.4,75,40,9,49,35,14,49,0,0.0,0.0
T21,137,11-10-2017 12:32:48,1,3070,2462,0.802,0.4,48,32,3,35,16,0,16,0,0.0,0.0
T21,138,11-10-2017 12:52:48,1,4226,3553,0.841,0.5,1072,615,238,853,457,167,624,118,0.0,0.03
T21,139,11-10-2017 13:12:48,1,3125,2543,0.814,0.4,246,186,21,207,60,5,65,0,0.0,0.0
T21,140,11-10-2017 13:32:48,1,3061,2498,0.816,0.4,70,56,1,57,14,5,19,0,0.02,0.0
T21,141,11-10-2017 13:52:48,1,2909,2303,0.792,0.3,29,22,7,29,7,1,8,0,0.0,0.0
T21,142,11-10-2017 14:12:48,1,2776,2200,0.792,0.3,146,96,27,123,50,13,63,0,0.0,0.0
T21,143,11-10-2017 14:32:48,1,3603,2995,0.831,0.4,172,87,13,100,85,10,95,0,0.0,0.03
T21,144,11-10-2017 14:52:48,1,4243,3657,0.862,0.5,1891,1277,485,1762,614,264,878,168,0.06,0.15
T21,145,11-10-2017 15:12:48,1,3110,3124,1.005,0.4,758,399,156,555,359,121,480,32,0.0,0.0
T21,146,11-10-2017 15:32:48,1,2810,2632,0.937,0.4,37,17,3,20,20,6,26,0,0.0,0.0
T21,147,11-10-2017 15:52:48,1,2904,2496,0.86,0.4,64,33,8,41,31,4,35,0,0.0,0.0
T21,148,11-10-2017 16:12:48,1,3951,3494,0.884,0.5,603,361,121,482,242,101,343,12,0.02,0.12
T21,149,11-10-2017 16:32:48,1,2918,2866,0.982,0.4,574,334,99,433,240,63,303,37,0.0,0.0
T21,150,11-10-2017 16:52:48,1,2923,2604,0.891,0.4,86,51,6,57,35,12,47,0,0.0,0.0
T21,151,11-10-2017 17:12:48,1,3909,3915,1.002,0.5,767,337,110,447,430,85,515,0,0.04,0.14
T21,152,11-10-2017 17:32:48,1,3672,3437,0.936,0.5,974,639,368,1007,335,189,524,34,0.02,0.03
T21,153,11-10-2017 17:52:48,1,3023,2736,0.905,0.4,152,96,4,100,56,17,73,0,0.0,0.02
T21,154,11-10-2017 18:12:48,0,4450,4567,1.026,0.6,1348,769,299,1068,579,210,789,19,0.04,0.17
T21,155,11-10-2017 18:32:48,0,4210,4470,1.062,0.5,672,416,128,544,256,99,355,7,0.02,0.11
T21,156,11-10-2017 18:52:48,0,4591,4975,1.084,0.6,2555,1554,791,2345,1001,496,1497,305,0.12,0.19
T21,157,11-10-2017 19:12:48,0,4538,4994,1.1,0.6,1770,1102,612,1714,668,364,1032,345,0.06,0.14
T21,158,11-10-2017 19:32:48,0,3949,4386,1.111,0.5,1137,634,302,936,503,216,719,50,0.04,0.17
T21,159,11-10-2017 19:52:48,0,3708,4072,1.098,0.5,426,260,51,311,166,36,202,0,0.02,0.02
T21,160,11-10-2017 20:12:48,0,4315,4697,1.089,0.6,2373,1396,855,2251,977,534,1511,409,0.1,0.2
T21,161,11-10-2017 20:32:48,0,4582,5070,1.106,0.6,1982,1199,761,1960,783,421,1204,305,0.04,0.11
T21,162,11-10-2017 20:52:48,0,3233,3576,1.106,0.4,1333,707,333,1040,626,298,924,61,0.02,0.16
T21,163,11-10-2017 21:12:48,0,4195,4623,1.102,0.5,590,360,134,494,230,97,327,1,0.02,0.03
T21,164,11-10-2017 21:32:48,0,4507,4986,1.106,0.6,1870,1103,558,1661,767,345,1112,199,0.08,0.15
T21,165,11-10-2017 21:52:48,0,4034,4457,1.105,0.5,540,323,185,508,217,90,307,19,0.04,0.2
T21,166,11-10-2017 22:12:48,0,3294,3727,1.131,0.4,645,382,115,497,263,111,374,6,0.04,0.03
T21,167,11-10-2017 22:32:48,0,3259,3696,1.134,0.4,886,465,178,643,421,149,570,26,0.06,0.14
T21,168,11-10-2017 22:52:48,0,4005,4445,1.11,0.5,436,285,111,396,151,62,213,1,0.04,0.18
T21,169,11-10-2017 23:12:48,0,4269,4695,1.1,0.6,2044,1237,639,1876,807,375,1182,226,0.06,0.09
T21,170,11-10-2017 23:32:48,0,3925,4356,1.11,0.5,234,139,36,175,95,19,114,0,0.0,0.0
T21,171,11-10-2017 23:52:48,0,3242,3602,1.111,0.4,983,528,217,745,455,167,622,20,0.04,0.11
T21,172,12-10-2017 00:12:48,0,3524,3910,1.109,0.5,316,217,37,254,99,39,138,0,0.0,0.0
T21,173,12-10-2017 00:32:48,0,3825,4262,1.114,0.5,1131,676,306,982,455,191,646,83,0.06,0.15
T21,174,12-10-2017 00:52:48,0,4313,4742,1.099,0.6,1242,710,300,1010,532,196,728,83,0.04,0.13
T21,175,12-10-2017 01:12:48,0,3589,3975,1.108,0.5,260,151,24,175,109,33,142,0,0.0,0.0
T21,176,12-10-2017 01:32:48,0,4176,4506,1.079,0.5,719,356,111,467,363,117,480,0,0.0,0.0
T21,177,12-10-2017 01:52:48,0,3343,3747,1.121,0.4,1720,1023,599,1622,697,383,1080,271,0.06,0.14
T21,178,12-10-2017 02:12:48,0,4027,4279,1.062,0.5,221,118,33,151,103,28,131,0,0.0,0.0
T21,179,12-10-2017 02:32:48,0,3410,3701,1.085,0.4,906,486,164,650,420,131,551,4,0.06,0.13
T21,180,12-10-2017 02:52:48,0,3584,3817,1.065,0.5,230,154,67,221,76,34,110,0,0.0,0.0
T21,181,12-10-2017 03:12:48,0,4471,4699,1.051,0.6,2210,1292,576,1868,918,437,1355,255,0.0,0.15
T21,182,12-10-2017 03:32:48,0,3331,3618,1.086,0.4,1750,977,464,1441,773,398,1171,188,0.02,0.03
T21,183,12-10-2017 03:52:48,0,3538,3867,1.093,0.5,688,434,169,603,254,122,376,6,0.06,0.12
T21,184,12-10-2017 04:12:48,0,3547,3809,1.074,0.5,911,507,127,634,404,118,522,10,0.04,0.08
T21,185,12-10-2017 04:32:48,0,4622,4920,1.065,0.6,2312,1335,814,2149,977,541,1518,347,0.02,0.07
T21,186,12-10-2017 04:52:48,0,4083,4391,1.076,0.5,1949,1022,470,1492,927,446,1373,60,0.04,0.03
T21,187,12-10-2017 05:12:48,0,4527,4640,1.025,0.6,1380,784,445,1229,596,306,902,159,0.04,0.14
T21,188,12-10-2017 05:32:48,0,4312,4523,1.049,0.6,2935,1602,880,2482,1333,746,2079,291,0.06,0.12
T21,189,12-10-2017 05:52:48,0,3574,3488,0.976,0.5,744,457,31,488,287,54,341,0,0.0,0.0
T21,190,12-10-2017 06:12:48,1,3085,2823,0.915,0.4,222,163,8,171,59,4,63,0,0.0,0.0
T21,191,12-10-2017 06:32:48,1,4424,4261,0.963,0.6,1531,946,499,1445,585,287,872,117,0.02,0.07
T21,192,12-10-2017 06:52:48,1,3497,3450,0.987,0.4,358,194,89,283,164,54,218,0,0.0,0.04
T21,193,12-10-2017 07:12:48,1,3754,3520,0.938,0.5,466,283,28,311,183,29,212,0,0.0,0.0
T21,194,12-10-2017 07:32:48,1,3779,3103,0.821,0.5,64,37,7,44,27,8,35,0,0.0,0.0
T21,195,12-10-2017 07:52:48,1,4038,4097,1.014,0.5,1422,823,363,1186,599,291,890,84,0.04,0.1
T21,196,12-10-2017 08:12:48,1,3518,3258,0.926,0.4,191,114,8,122,77,9,86,0,0.0,0.0
T21,197,12-10-2017 08:32:48,1,2493,2222,0.891,0.3,260,154,30,184,106,28,134,9,0.02,0.0
T21,198,12-10-2017 08:52:48,1,2654,2282,0.86,0.3,127,68,19,87,59,6,65,0,0.0,0.0
T21,199,12-10-2017 09:12:48,1,2876,2333,0.811,0.3,85,49,12,61,36,11,47,0,0.0,0.0
T21,200,12-10-2017 09:32:48,1,3967,3333,0.84,0.5,287,136,28,164,151,46,197,0,0.0,-0.03
T21,201,12-10-2017 09:52:48,1,3930,3656,0.93,0.5,1563,892,411,1303,671,247,918,92,0.02,0.06
T21,202,12-10-2017 10:12:48,1,3030,2658,0.877,0.4,43,26,8,34,17,3,20,0,0.0,0.0
T21,203,12-10-2017 10:32:48,1,2891,2438,0.843,0.4,58,39,2,41,19,4,23,0,0.0,0.0
T21,204,12-10-2017 10:52:48,1,2510,2053,0.818,0.3,185,130,13,143,55,12,67,0,0.0,-0.03
T21,205,12-10-2017 11:12:48,1,2868,2338,0.815,0.3,84,57,22,79,27,7,34,0,0.02,0.0
T21,206,12-10-2017 11:32:48,1,2695,2140,0.794,0.3,574,326,122,448,248,91,339,1,0.0,0.0
T21,207,12-10-2017 11:52:48,1,2773,2162,0.78,0.3,38,12,0,12,26,8,34,0,0.0,0.0
T21,208,12-10-2017 12:12:48,1,2572,1987,0.773,0.3,40,29,5,34,11,4,15,0,0.0,0.0
T21,209,12-10-2017 12:32:48,1,3181,2542,0.799,0.4,166,129,15,144,37,6,43,0,0.0,0.0
T21,210,12-10-2017 12:52:48,1,3893,3470,0.892,0.5,1593,1062,470,1532,531,229,760,142,0.0,0.03
T21,211,12-10-2017 13:12:48,1,2924,2429,0.831,0.4,255,193,36,229,62,12,74,0,0.0,0.0
T21,212,12-10-2017 13:32:48,1,3067,2442,0.796,0.4,51,36,1,37,15,4,19,0,0.02,0.0
T21,213,12-10-2017 13:52:48,1,2924,2327,0.796,0.4,60,37,3,40,23,4,27,0,0.0,0.0
T21,214,12-10-2017 14:12:48,1,3707,2995,0.808,0.4,1224,734,318,1052,490,207,697,13,0.0,0.0
T21,215,12-10-2017 14:32:48,1,3189,2600,0.815,0.4,105,64,34,98,41,16,57,1,0.0,0.0
T21,216,12-10-2017 14:52:48,1,2955,2728,0.923,0.4,226,98,28,126,128,33,161,1,0.0,0.03
T21,217,12-10-2017 15:12:48,1,3225,2739,0.849,0.4,104,69,3,72,35,8,43,0,0.0,0.0
T21,218,12-10-2017 15:32:48,1,3767,3229,0.857,0.5,370,176,12,188,194,37,231,0,0.0,0.0
T21,219,12-10-2017 15:52:48,1,3284,2970,0.905,0.4,886,520,254,774,366,118,484,30,0.02,0.03
T21,220,12-10-2017 16:12:48,1,2915,2530,0.868,0.4,19,10,4,14,9,1,10,0,0.0,0.0
T21,221,12-10-2017 16:32:48,1,3505,2957,0.844,0.4,125,79,45,124,46,17,63,0,0.0,0.03
T21,222,12-10-2017 16:52:48,1,3509,3459,0.986,0.4,1056,643,164,807,413,75,488,12,0.04,0.1
T21,223,12-10-2017 17:12:48,1,3121,2824,0.905,0.4,91,63,4,67,28,10,38,0,0.0,0.0
T21,224,12-10-2017 17:32:48,1,3910,3394,0.868,0.5,118,77,29,106,41,13,54,0,0.0,0.06
T21,225,12-10-2017 17:52:48,1,3369,3415,1.014,0.4,415,235,70,305,180,48,228,6,0.04,0.09
T21,226,12-10-2017 18:12:48,0,4621,4708,1.019,0.6,1250,776,265,1041,474,143,617,60,0.0,-0.02
T21,227,12-10-2017 18:32:48,0,4207,4360,1.036,0.5,1091,613,211,824,478,179,657,53,0.06,0.12
T21,228,12-10-2017 18:52:48,0,4534,4841,1.068,0.6,2415,1340,742,2082,1075,569,1644,141,0.1,0.26
T21,229,12-10-2017 19:12:48,0,4527,4896,1.082,0.6,1582,894,478,1372,688,303,991,174,0.06,0.03
T21,230,12-10-2017 19:32:48,0,3423,3600,1.052,0.4,2232,1296,686,1982,936,537,1473,37,0.0,0.0
T21,231,12-10-2017 19:52:48,0,4362,4107,0.942,0.5,3454,2002,1226,3228,1452,847,2299,336,0.0,0.0
T21,232,12-10-2017 20:12:48,0,4494,3843,0.855,0.5,4348,2627,1714,4341,1721,1046,2767,887,0.0,0.0
T21,233,12-10-2017 20:32:48,0,4249,3454,0.813,0.5,3180,1952,1191,3143,1228,691,1919,789,0.04,0.0
T21,234,12-10-2017 20:52:48,0,3440,2815,0.818,0.4,1733,980,467,1447,753,340,1093,216,0.0,0.0
T21,235,12-10-2017 21:12:48,0,2471,1930,0.781,0.3,393,233,131,364,160,67,227,48,0.0,0.0
T21,236,12-10-2017 21:32:48,0,2601,2000,0.769,0.3,62,38,1,39,24,2,26,0,0.0,0.0
T21,237,12-10-2017 21:52:48,0,4674,3659,0.783,0.6,887,550,265,815,337,174,511,171,0.0,0.0
T21,238,12-10-2017 22:12:48,0,4262,3300,0.774,0.5,3178,1914,1076,2990,1264,642,1906,669,0.02,0.0
T21,239,12-10-2017 22:32:48,0,4287,3279,0.765,0.5,2506,1513,773,2286,993,531,1524,326,0.0,0.0
T21,240,12-10-2017 22:52:48,0,3535,2701,0.764,0.4,2252,1353,597,1950,899,411,1310,360,0.02,0.0
T21,241,12-10-2017 23:12:48,0,2159,1630,0.755,0.3,532,271,28,299,261,47,308,0,0.0,0.0
T21,242,12-10-2017 23:32:48,0,2719,2018,0.742,0.3,238,116,8,124,122,36,158,0,0.0,0.0
T21,243,12-10-2017 23:52:48,0,2462,1804,0.733,0.3,251,154,72,226,97,49,146,14,0.0,0.0
T21,244,13-10-2017 00:12:48,0,2686,1977,0.736,0.3,39,18,1,19,21,4,25,0,0.0,0.0
T21,245,13-10-2017 00:32:48,0,2820,2125,0.753,0.3,176,86,5,91,90,27,117,0,0.0,0.0
T21,246,13-10-2017 00:52:48,0,4564,3430,0.751,0.5,2434,1352,755,2107,1082,560,1642,298,0.0,0.0
T21,247,13-10-2017 01:12:48,0,4371,3284,0.751,0.5,3389,1980,1187,3167,1409,770,2179,833,0.04,0.0
T21,248,13-10-2017 01:32:48,0,3858,2857,0.741,0.5,2461,1473,667,2140,988,494,1482,391,0.0,0.0
T21,249,13-10-2017 01:52:48,0,2795,2103,0.752,0.3,1340,748,206,954,592,221,813,37,0.02,0.0
T21,250,13-10-2017 02:12:48,0,1808,1313,0.726,0.2,387,228,70,298,159,75,234,5,0.0,0.0
T21,251,13-10-2017 02:32:48,0,2290,1637,0.715,0.3,53,27,3,30,26,0,26,0,0.0,0.0
T21,252,13-10-2017 02:52:48,0,4369,3231,0.74,0.5,545,378,153,531,167,74,241,73,0.0,0.0
T21,253,13-10-2017 03:12:48,0,4566,3388,0.742,0.5,2264,1353,785,2138,911,499,1410,509,0.04,0.0
T21,254,13-10-2017 03:32:48,0,4053,2991,0.738,0.5,2520,1465,801,2266,1055,570,1625,452,0.06,0.0
T21,255,13-10-2017 03:52:48,0,2780,2036,0.732,0.3,1263,771,274,1045,492,204,696,106,0.02,0.0
T21,256,13-10-2017 04:12:48,0,1630,1177,0.722,0.2,256,160,48,208,96,20,116,6,0.0,0.0
T21,257,13-10-2017 04:32:48,0,1549,1113,0.718,0.2,82,56,0,56,26,3,29,0,0.0,0.0
T21,258,13-10-2017 04:52:48,0,3695,2654,0.718,0.4,328,175,60,235,153,50,203,22,0.0,0.0
T21,259,13-10-2017 05:12:48,0,3497,2610,0.746,0.4,767,449,165,614,318,133,451,55,0.02,0.0
T21,260,13-10-2017 05:32:48,0,2388,1708,0.715,0.3,1153,685,275,960,468,221,689,131,0.0,0.0
T21,261,13-10-2017 05:52:48,0,1687,1194,0.708,0.2,82,54,0,54,28,1,29,0,0.0,0.0
T21,262,13-10-2017 06:12:48,1,2079,1476,0.71,0.2,55,35,3,38,20,2,22,0,0.02,0.0
T21,263,13-10-2017 06:32:48,1,3727,2743,0.736,0.4,229,96,14,110,133,17,150,0,0.0,0.0
T21,264,13-10-2017 06:52:48,1,2677,1957,0.731,0.3,700,369,190,559,331,106,437,44,0.02,0.0
T21,265,13-10-2017 07:12:48,1,1812,1348,0.744,0.2,14,1,0,1,13,2,15,0,0.02,0.0
T21,266,13-10-2017 07:32:48,1,5412,4316,0.797,0.7,1031,629,249,878,402,170,572,4,0.0,0.16
T21,267,13-10-2017 07:52:48,1,4410,4287,0.972,0.6,1413,821,385,1206,592,260,852,38,0.34,0.41
T21,268,13-10-2017 08:12:48,1,4215,4272,1.014,0.5,1439,900,400,1300,539,243,782,21,0.18,0.35
T21,269,13-10-2017 08:32:48,1,3864,3914,1.013,0.5,1251,732,276,1008,519,243,762,69,0.12,0.24
T21,270,13-10-2017 08:52:48,1,3428,3575,1.043,0.4,422,250,76,326,172,64,236,3,0.02,0.04
T21,271,13-10-2017 09:12:48,1,2619,2781,1.062,0.3,489,308,115,423,181,68,249,20,0.08,0.11
T21,272,13-10-2017 09:32:48,1,2902,3181,1.096,0.4,134,84,38,122,50,19,69,0,0.0,0.03
T21,273,13-10-2017 09:52:48,1,3943,4225,1.072,0.5,1057,623,303,926,434,161,595,20,0.16,0.31
T21,274,13-10-2017 10:12:48,1,2506,2736,1.092,0.3,23,9,2,11,14,4,18,0,0.0,0.0
T21,275,13-10-2017 10:32:48,1,3890,4211,1.083,0.5,508,327,156,483,181,53,234,0,0.04,0.23
T21,276,13-10-2017 10:52:48,1,2992,3245,1.084,0.4,857,478,89,567,379,146,525,1,0.08,0.12
T21,277,13-10-2017 11:12:48,1,2800,3039,1.085,0.4,32,13,0,13,19,0,19,0,0.0,0.0
T21,278,13-10-2017 11:32:48,1,3174,3420,1.077,0.4,236,124,43,167,112,21,133,0,0.0,0.04
T21,279,13-10-2017 11:52:48,1,2591,2751,1.062,0.3,616,298,131,429,318,98,416,13,0.1,0.1
T21,280,13-10-2017 12:12:48,1,2764,2960,1.071,0.4,14,1,0,1,13,2,15,0,0.0,0.0
T21,281,13-10-2017 12:32:48,1,4016,4288,1.068,0.5,600,332,169,501,268,136,404,0,0.02,0.19
T21,282,13-10-2017 12:52:48,1,3853,4158,1.079,0.5,974,501,188,689,473,144,617,15,0.1,0.17
T21,283,13-10-2017 13:12:48,1,2741,2999,1.094,0.4,22,9,0,9,13,2,15,0,0.0,0.0
T21,284,13-10-2017 13:32:48,1,3177,3428,1.079,0.4,598,301,126,427,297,128,425,1,0.06,0.12
T21,285,13-10-2017 13:52:48,1,2880,3119,1.083,0.4,70,43,8,51,27,2,29,0,0.0,0.0
T21,286,13-10-2017 14:12:48,1,2727,3013,1.105,0.4,150,84,20,104,66,18,84,0,0.0,0.0
T14,1,09-10-2017 15:08:48,1,4166,3174,0.762,0.5,1348,825,340,1165,523,192,715,73,0.0,0.0
T14,2,09-10-2017 15:28:48,1,2879,2121,0.737,0.4,658,370,69,439,288,58,346,0,0.0,0.0
T14,3,09-10-2017 15:48:48,1,2590,1855,0.716,0.3,31,19,3,22,12,2,14,0,0.0,0.0
T14,4,09-10-2017 16:08:48,1,2597,1882,0.725,0.3,52,21,4,25,31,7,38,0,0.0,0.0
T14,5,09-10-2017 16:28:48,1,3559,2699,0.758,0.5,164,109,50,159,55,30,85,3,0.0,0.18
T14,6,09-10-2017 16:48:48,1,2996,2348,0.784,0.4,760,436,65,501,324,61,385,5,0.0,0.0
T14,7,09-10-2017 17:08:48,1,2721,2099,0.771,0.4,74,33,10,43,41,10,51,0,0.0,0.0
T14,8,09-10-2017 17:28:48,1,2843,2260,0.795,0.4,39,14,2,16,25,9,34,0,0.0,0.0
T14,9,09-10-2017 17:48:48,1,2906,2265,0.78,0.4,123,68,23,91,55,17,72,0,0.0,0.05
T14,10,09-10-2017 18:08:48,0,3201,2504,0.782,0.4,717,392,75,467,325,75,400,0,0.0,0.0
T14,11,09-10-2017 18:28:48,0,4405,3596,0.816,0.6,1367,823,513,1336,544,327,871,351,0.0,0.09
T14,12,09-10-2017 18:48:48,0,4344,3393,0.781,0.6,3450,2068,1200,3268,1382,744,2126,815,0.0,0.05
T14,13,09-10-2017 19:08:48,0,4376,3448,0.788,0.6,6814,4138,2941,7079,2676,1800,4476,2190,0.0,0.0
T14,14,09-10-2017 19:28:48,0,4179,3222,0.771,0.5,4918,3036,2078,5114,1882,1180,3062,1866,0.0,0.0
T14,15,09-10-2017 19:48:48,0,4615,3524,0.764,0.6,5362,3237,2200,5437,2125,1360,3485,1694,0.0,0.0
T14,16,09-10-2017 20:08:48,0,4731,3531,0.746,0.6,6619,4098,2933,7031,2521,1665,4186,2012,0.0,0.0
T14,17,09-10-2017 20:28:48,0,4581,3375,0.737,0.6,4937,3113,2040,5153,1824,1120,2944,1638,0.0,0.0
T14,18,09-10-2017 20:48:48,0,4219,3141,0.745,0.5,7244,4514,3359,7873,2730,1930,4660,2430,0.0,0.0
T14,19,09-10-2017 21:08:48,0,4430,3268,0.738,0.6,4979,2948,2007,4955,2031,1308,3339,1509,0.0,0.0
T14,20,09-10-2017 21:28:48,0,5734,4252,0.742,0.7,6114,3592,2496,6088,2522,1625,4147,1506,0.0,0.03
T14,21,09-10-2017 21:48:48,0,5255,3911,0.744,0.7,7203,4410,3116,7526,2793,1823,4616,1437,0.0,0.0
T14,22,09-10-2017 22:08:48,0,4665,3468,0.743,0.6,6717,4208,2981,7189,2509,1616,4125,1805,0.0,0.03
T14,23,09-10-2017 22:28:48,0,4603,3391,0.737,0.6,5217,3242,2058,5300,1975,1137,3112,1295,0.0,0.0
T14,24,09-10-2017 22:48:48,0,4410,3288,0.746,0.6,4782,2993,1915,4908,1789,1074,2863,1315,0.0,0.03
T14,25,09-10-2017 23:08:48,0,4452,3273,0.735,0.6,5597,3484,2406,5890,2113,1337,3450,1569,0.1,0.0
T14,26,09-10-2017 23:28:48,0,4290,3158,0.736,0.6,4695,2895,1977,4872,1800,1109,2909,1183,0.0,0.06
T14,27,09-10-2017 23:48:48,0,4103,3091,0.753,0.5,3317,2085,1335,3420,1232,659,1891,999,0.0,0.03
T14,28,10-10-2017 00:08:48,0,3965,2976,0.751,0.5,4595,2860,1882,4742,1735,1011,2746,980,0.1,0.03
T14,29,10-10-2017 00:28:48,0,5102,4099,0.803,0.7,2569,1458,763,2221,1111,541,1652,148,0.12,0.05
T14,30,10-10-2017 00:48:48,0,4487,3297,0.735,0.6,5317,3461,2407,5868,1856,1103,2959,664,0.0,0.0
T14,31,10-10-2017 01:08:48,0,4154,3097,0.746,0.5,4437,2732,1867,4599,1705,1030,2735,685,0.0,0.0
T14,32,10-10-2017 01:28:48,0,3350,2503,0.747,0.4,1169,645,150,795,524,186,710,39,0.0,0.06
T14,33,10-10-2017 01:48:48,0,2593,1979,0.763,0.3,577,343,155,498,234,104,338,60,0.16,0.14
T14,34,10-10-2017 02:08:48,0,3285,2591,0.789,0.4,271,199,103,302,72,40,112,19,0.04,0.08
T14,35,10-10-2017 02:28:48,0,2861,2234,0.781,0.4,67,52,21,73,15,8,23,0,0.0,0.0
T14,36,10-10-2017 02:48:48,0,4182,3401,0.813,0.5,1127,744,346,1090,383,160,543,122,0.14,0.1
T14,37,10-10-2017 03:08:48,0,2855,2199,0.77,0.4,629,416,102,518,213,54,267,2,0.0,0.03
T14,38,10-10-2017 03:28:48,0,3064,2402,0.784,0.4,43,21,12,33,22,3,25,0,0.0,0.0
T14,39,10-10-2017 03:48:48,0,2897,2354,0.812,0.4,296,189,80,269,107,39,146,0,0.0,0.09
T14,40,10-10-2017 04:08:48,0,2991,2420,0.809,0.4,116,87,18,105,29,9,38,0,0.0,0.04
T14,41,10-10-2017 04:28:48,0,2976,2380,0.8,0.4,167,99,50,149,68,28,96,14,0.0,0.0
T14,42,10-10-2017 04:48:48,0,3147,2542,0.808,0.4,415,218,81,299,197,69,266,13,0.16,0.06
T14,43,10-10-2017 05:08:48,0,3181,2663,0.837,0.4,304,201,29,230,103,29,132,12,0.0,0.09
T14,44,10-10-2017 05:28:48,0,4524,3758,0.831,0.6,3817,2419,1623,4042,1398,814,2212,609,0.24,0.07
T14,45,10-10-2017 05:48:48,0,4212,3386,0.804,0.6,3838,2343,1510,3853,1495,809,2304,662,0.0,0.0
T14,46,10-10-2017 06:08:48,1,4095,3195,0.78,0.5,3808,2359,1633,3992,1449,824,2273,955,0.08,0.03
T14,47,10-10-2017 06:28:48,1,3987,3189,0.8,0.5,1661,1019,487,1506,642,281,923,165,0.0,0.07
T14,48,10-10-2017 06:48:48,1,2759,2052,0.744,0.4,320,242,25,267,78,13,91,0,0.0,0.0
T14,49,10-10-2017 07:08:48,1,2861,2140,0.748,0.4,550,355,161,516,195,65,260,92,0.0,0.0
T14,50,10-10-2017 07:28:48,1,2852,2241,0.786,0.4,250,165,24,189,85,22,107,1,0.0,0.17
T14,51,10-10-2017 07:48:48,1,2918,2297,0.787,0.4,57,36,12,48,21,5,26,0,0.0,0.0
T14,52,10-10-2017 08:08:48,1,4007,3396,0.848,0.5,749,556,151,707,193,49,242,4,0.0,0.1
T14,53,10-10-2017 08:28:48,1,3427,2753,0.803,0.4,1784,1163,610,1773,621,270,891,146,0.06,0.0
T14,54,10-10-2017 08:48:48,1,2802,2143,0.765,0.4,361,247,33,280,114,24,138,0,0.0,0.0
T14,55,10-10-2017 09:08:48,1,2817,2250,0.799,0.4,51,40,15,55,11,5,16,0,0.0,0.0
T14,56,10-10-2017 09:28:48,1,2850,2252,0.79,0.4,140,95,22,117,45,14,59,0,0.0,0.08
T14,57,10-10-2017 09:48:48,1,3341,2777,0.831,0.4,296,208,64,272,88,25,113,0,0.0,0.11
T14,58,10-10-2017 10:08:48,1,2967,2398,0.808,0.4,448,326,93,419,122,38,160,0,0.08,0.0
T14,59,10-10-2017 10:28:48,1,2741,2187,0.798,0.4,120,97,13,110,23,5,28,0,0.0,0.0
T14,60,10-10-2017 10:48:48,1,2612,2074,0.794,0.3,75,43,13,56,32,6,38,0,0.0,0.0
T14,61,10-10-2017 11:08:48,1,2998,2464,0.822,0.4,758,510,142,652,248,65,313,5,0.0,0.06
T14,62,10-10-2017 11:28:48,1,2825,2251,0.797,0.4,26,14,2,16,12,7,19,0,0.0,0.0
T14,63,10-10-2017 11:48:48,1,2720,2180,0.801,0.4,140,90,18,108,50,10,60,0,0.0,0.0
T14,64,10-10-2017 12:08:48,1,2721,2169,0.797,0.4,78,43,11,54,35,19,54,0,0.0,0.0
T14,65,10-10-2017 12:28:48,1,2718,2183,0.803,0.4,256,160,25,185,96,32,128,0,0.0,0.0
T14,66,10-10-2017 12:48:48,1,3953,3312,0.838,0.5,1197,747,265,1012,450,163,613,107,0.14,0.09
T14,67,10-10-2017 13:08:48,1,2768,2228,0.805,0.4,105,81,30,111,24,3,27,0,0.0,0.0
T14,68,10-10-2017 13:28:48,1,2738,2173,0.794,0.4,133,123,8,131,10,2,12,0,0.0,0.0
T14,69,10-10-2017 13:48:48,1,4617,3775,0.818,0.6,1322,822,456,1278,500,243,743,71,0.0,0.05
T14,70,10-10-2017 14:08:48,1,2748,2175,0.791,0.4,614,480,69,549,134,15,149,0,0.0,0.0
T14,71,10-10-2017 14:28:48,1,2924,2301,0.787,0.4,104,64,28,92,40,10,50,0,0.0,0.0
T14,72,10-10-2017 14:48:48,1,2822,2170,0.769,0.4,41,20,7,27,21,0,21,0,0.0,0.0
T14,73,10-10-2017 15:08:48,1,3979,3452,0.868,0.5,676,437,213,650,239,107,346,89,0.0,0.21
T14,74,10-10-2017 15:28:48,1,3761,3311,0.88,0.5,2311,1420,761,2181,891,401,1292,542,0.14,0.02
T14,75,10-10-2017 15:48:48,1,2597,2122,0.817,0.3,302,199,38,237,103,18,121,0,0.0,0.0
T14,76,10-10-2017 16:08:48,1,2767,2193,0.793,0.4,70,58,23,81,12,1,13,0,0.0,0.0
T14,77,10-10-2017 16:28:48,1,2906,2285,0.786,0.4,59,44,14,58,15,4,19,0,0.0,0.0
T14,78,10-10-2017 16:48:48,1,3655,3214,0.879,0.5,1136,830,127,957,306,76,382,0,0.0,0.09
T14,79,10-10-2017 17:08:48,1,2943,2302,0.782,0.4,559,358,217,575,201,117,318,81,0.0,0.0
T14,80,10-10-2017 17:28:48,1,2766,2214,0.801,0.4,32,23,8,31,9,1,10,0,0.0,0.0
T14,81,10-10-2017 17:48:48,1,2804,2257,0.805,0.4,131,96,38,134,35,13,48,0,0.0,0.11
T14,82,10-10-2017 18:08:48,0,2877,2349,0.816,0.4,138,109,22,131,29,8,37,0,0.0,0.0
T14,83,10-10-2017 18:28:48,0,4054,3515,0.867,0.5,2082,1114,473,1587,968,333,1301,231,0.16,0.09
T14,84,10-10-2017 18:48:48,0,4207,3485,0.829,0.6,2518,1317,820,2137,1201,576,1777,577,0.0,0.03
T14,85,10-10-2017 19:08:48,0,3820,3101,0.812,0.5,2421,1340,777,2117,1081,537,1618,493,0.0,0.03
T14,86,10-10-2017 19:28:48,0,3767,3136,0.833,0.5,1512,739,335,1074,773,226,999,80,0.0,0.11
T14,87,10-10-2017 19:48:48,0,4221,3394,0.804,0.6,5101,2905,1981,4886,2196,1425,3621,1151,0.0,0.0
T14,88,10-10-2017 20:08:48,0,4252,3415,0.803,0.6,4582,2597,1758,4355,1985,1188,3173,1075,0.14,0.0
T14,89,10-10-2017 20:28:48,0,4176,3345,0.801,0.5,4683,2599,1669,4268,2084,1329,3413,1241,0.0,0.0
T14,90,10-10-2017 20:48:48,0,4454,3530,0.793,0.6,4308,2389,1588,3977,1919,1168,3087,1203,0.0,0.11
T14,91,10-10-2017 21:08:48,0,4439,3657,0.824,0.6,4922,2893,1982,4875,2029,1253,3282,1658,0.0,0.0
T14,92,10-10-2017 21:28:48,0,3831,3030,0.791,0.5,2091,1197,560,1757,894,474,1368,535,0.0,0.1
T14,93,10-10-2017 21:48:48,0,4016,3320,0.827,0.5,4158,2280,1421,3701,1878,1153,3031,1138,0.14,0.0
T14,94,10-10-2017 22:08:48,0,4020,3194,0.795,0.5,3724,2110,1272,3382,1614,980,2594,658,0.08,0.02
T14,95,10-10-2017 22:28:48,0,4629,3546,0.766,0.6,2048,1206,577,1783,842,355,1197,152,0.0,0.0
T14,96,10-10-2017 22:48:48,0,3562,2662,0.747,0.5,630,287,38,325,343,58,401,0,0.0,0.18
T14,97,10-10-2017 23:08:48,0,3912,3133,0.801,0.5,1399,844,292,1136,555,200,755,46,0.12,0.0
T14,98,10-10-2017 23:28:48,0,3450,2663,0.772,0.4,627,354,23,377,273,54,327,0,0.0,0.0
T14,99,10-10-2017 23:48:48,0,3313,2476,0.748,0.4,104,66,23,89,38,18,56,0,0.0,0.0
T14,100,11-10-2017 00:08:48,0,3357,2691,0.801,0.4,1097,721,244,965,376,117,493,61,0.14,0.16
T14,101,11-10-2017 00:28:48,0,3980,3241,0.814,0.5,1708,875,477,1352,833,425,1258,194,0.0,0.1
T14,102,11-10-2017 00:48:48,0,4085,3242,0.794,0.5,1408,751,133,884,657,170,827,322,0.0,0.0
T14,103,11-10-2017 01:08:48,0,3598,2797,0.777,0.5,231,120,38,158,111,43,154,0,0.0,0.0
T14,104,11-10-2017 01:28:48,0,4085,3329,0.815,0.5,1350,757,387,1144,593,325,918,316,0.22,0.0
T14,105,11-10-2017 01:48:48,0,4109,3256,0.792,0.5,3268,1721,1065,2786,1547,804,2351,786,0.0,0.0
T14,106,11-10-2017 02:08:48,0,3486,2694,0.773,0.5,764,439,172,611,325,83,408,26,0.0,0.03
T14,107,11-10-2017 02:28:48,0,3983,3141,0.789,0.5,1329,702,347,1049,627,204,831,141,0.0,0.08
T14,108,11-10-2017 02:48:48,0,3717,3001,0.807,0.5,424,210,36,246,214,51,265,0,0.0,0.0
T14,109,11-10-2017 03:08:48,0,3586,2732,0.762,0.5,1343,805,339,1144,538,281,819,96,0.0,0.07
T14,110,11-10-2017 03:28:48,0,3408,2647,0.777,0.4,1602,1015,522,1537,587,332,919,237,0.0,0.0
T14,111,11-10-2017 03:48:48,0,4119,3372,0.819,0.5,1852,1005,511,1516,847,421,1268,157,0.14,0.07
T14,112,11-10-2017 04:08:48,0,3925,3246,0.827,0.5,2597,1520,955,2475,1077,639,1716,665,0.0,0.04
T14,113,11-10-2017 04:28:48,0,3419,2707,0.792,0.4,1456,854,395,1249,602,309,911,230,0.1,0.08
T14,114,11-10-2017 04:48:48,0,4497,3659,0.814,0.6,3817,2252,1436,3688,1565,913,2478,1166,0.0,0.05
T14,115,11-10-2017 05:08:48,0,3914,3150,0.805,0.5,3142,1737,915,2652,1405,820,2225,790,0.0,0.03
T14,116,11-10-2017 05:28:48,0,3820,2979,0.78,0.5,2186,1281,782,2063,905,496,1401,589,0.14,0.0
T14,117,11-10-2017 05:48:48,0,3879,3089,0.796,0.5,1124,647,367,1014,477,266,743,169,0.0,0.17
T14,118,11-10-2017 06:08:48,1,3306,2549,0.771,0.4,1128,548,257,805,580,255,835,121,0.0,0.0
T14,119,11-10-2017 06:28:48,1,3062,2281,0.745,0.4,42,18,1,19,24,8,32,0,0.0,0.0
T14,120,11-10-2017 06:48:48,1,2830,2182,0.771,0.4,22,15,0,15,7,1,8,0,0.0,0.0
T14,121,11-10-2017 07:08:48,1,3213,2516,0.783,0.4,312,185,50,235,127,37,164,0,0.0,0.09
T14,122,11-10-2017 07:28:48,1,2859,2317,0.81,0.4,77,54,5,59,23,1,24,0,0.0,0.0
T14,123,11-10-2017 07:48:48,1,4201,3488,0.83,0.6,1094,754,408,1162,340,172,512,178,0.16,0.05
T14,124,11-10-2017 08:08:48,1,3427,2748,0.802,0.4,847,515,202,717,332,153,485,124,0.04,0.02
T14,125,11-10-2017 08:28:48,1,2652,2017,0.761,0.3,78,45,18,63,33,3,36,0,0.0,0.0
T14,126,11-10-2017 08:48:48,1,3137,2448,0.78,0.4,105,74,5,79,31,10,41,0,0.0,0.0
T14,127,11-10-2017 09:08:48,1,2999,2400,0.8,0.4,212,143,28,171,69,20,89,0,0.0,0.03
T14,128,11-10-2017 09:28:48,1,3438,2802,0.815,0.5,822,558,251,809,264,133,397,81,0.06,0.08
T14,129,11-10-2017 09:48:48,1,2974,2378,0.8,0.4,110,77,1,78,33,15,48,0,0.0,0.0
T14,130,11-10-2017 10:08:48,1,2714,2140,0.788,0.4,64,33,11,44,31,10,41,0,0.0,0.0
T14,131,11-10-2017 10:28:48,1,2849,2236,0.785,0.4,51,29,2,31,22,10,32,0,0.0,0.0
T14,132,11-10-2017 10:48:48,1,3495,2758,0.789,0.5,201,154,30,184,47,10,57,0,0.0,0.0
T14,133,11-10-2017 11:08:48,1,3813,3159,0.828,0.5,3463,2148,1305,3453,1315,758,2073,847,0.1,0.04
T14,134,11-10-2017 11:28:48,1,3816,3106,0.814,0.5,2785,1561,879,2440,1224,624,1848,316,0.0,0.03
T14,135,11-10-2017 11:48:48,1,3187,2447,0.768,0.4,933,552,260,812,381,137,518,67,0.0,0.0
T14,136,11-10-2017 12:08:48,1,2816,2135,0.758,0.4,82,57,11,68,25,10,35,0,0.0,0.0
T14,137,11-10-2017 12:28:48,1,2955,2257,0.764,0.4,196,139,43,182,57,9,66,0,0.0,0.0
T14,138,11-10-2017 12:48:48,1,3005,2287,0.761,0.4,101,59,18,77,42,15,57,0,0.0,0.0
T14,139,11-10-2017 13:08:48,1,3555,2985,0.84,0.5,1584,1040,455,1495,544,202,746,454,0.0,0.06
T14,140,11-10-2017 13:28:48,1,2829,2165,0.765,0.4,119,70,10,80,49,7,56,12,0.04,0.0
T14,141,11-10-2017 13:48:48,1,2746,2082,0.758,0.4,285,201,59,260,84,32,116,1,0.0,0.03
T14,142,11-10-2017 14:08:48,1,3479,2894,0.832,0.5,380,234,29,263,146,20,166,0,0.0,0.0
T14,143,11-10-2017 14:28:48,1,2765,2074,0.75,0.4,351,244,86,330,107,34,141,14,0.1,0.0
T14,144,11-10-2017 14:48:48,1,3243,2543,0.784,0.4,206,147,46,193,59,20,79,0,0.0,0.05
T14,145,11-10-2017 15:08:48,1,2763,2196,0.795,0.4,56,35,14,49,21,5,26,0,0.0,0.0
T14,146,11-10-2017 15:28:48,1,3003,2397,0.798,0.4,197,140,73,213,57,25,82,0,0.0,0.0
T14,147,11-10-2017 15:48:48,1,2852,2206,0.774,0.4,124,84,19,103,40,15,55,0,0.0,0.0
T14,148,11-10-2017 16:08:48,1,3649,2958,0.811,0.5,430,305,122,427,125,42,167,23,0.0,0.18
T14,149,11-10-2017 16:28:48,1,3602,2931,0.814,0.5,961,647,179,826,314,71,385,62,0.0,0.0
T14,150,11-10-2017 16:48:48,1,2983,2376,0.797,0.4,113,89,45,134,24,9,33,2,0.0,0.0
T14,151,11-10-2017 17:08:48,1,2935,2337,0.796,0.4,53,41,10,51,12,4,16,0,0.0,0.0
T14,152,11-10-2017 17:28:48,1,3715,3000,0.807,0.5,835,558,276,834,277,113,390,49,0.12,0.0
T14,153,11-10-2017 17:48:48,1,2930,2393,0.817,0.4,77,57,20,77,20,4,24,0,0.0,0.0
T14,154,11-10-2017 18:08:48,0,3650,3211,0.88,0.5,459,285,68,353,174,37,211,1,0.0,0.1
T14,155,11-10-2017 18:28:48,0,4526,3751,0.829,0.6,1920,1314,580,1894,606,263,869,160,0.16,0.13
T14,156,11-10-2017 18:48:48,0,4199,3475,0.828,0.6,3265,1976,1227,3203,1289,656,1945,647,0.02,0.07
T14,157,11-10-2017 19:08:48,0,3606,2866,0.795,0.5,738,562,178,740,176,31,207,12,0.0,0.03
T14,158,11-10-2017 19:28:48,0,4213,3506,0.832,0.6,3684,2144,1258,3402,1540,911,2451,899,0.12,0.19
T14,159,11-10-2017 19:48:48,0,3810,3193,0.838,0.5,2829,1622,935,2557,1207,675,1882,520,0.08,0.02
T14,160,11-10-2017 20:08:48,0,3665,2992,0.816,0.5,1259,666,134,800,593,127,720,19,0.0,0.03
T14,161,11-10-2017 20:28:48,0,3993,3328,0.833,0.5,2571,1515,769,2284,1056,614,1670,416,0.12,0.15
T14,162,11-10-2017 20:48:48,0,3226,2588,0.802,0.4,812,510,170,680,302,138,440,48,0.0,0.0
T14,163,11-10-2017 21:08:48,0,3659,2931,0.801,0.5,397,261,119,380,136,71,207,17,0.0,0.12
T14,164,11-10-2017 21:28:48,0,3816,3183,0.834,0.5,370,239,124,363,131,64,195,49,0.0,0.11
T14,165,11-10-2017 21:48:48,0,3959,3334,0.842,0.5,3169,1836,1074,2910,1333,748,2081,938,0.12,0.09
T14,166,11-10-2017 22:08:48,0,3578,2938,0.821,0.5,1092,625,165,790,467,146,613,43,0.0,0.03
T14,167,11-10-2017 22:28:48,0,3794,3266,0.861,0.5,785,512,177,689,273,98,371,24,0.12,0.0
T14,168,11-10-2017 22:48:48,0,3729,2979,0.799,0.5,1158,656,195,851,502,174,676,154,0.0,0.0
T14,169,11-10-2017 23:08:48,0,3415,2683,0.786,0.4,160,114,24,138,46,11,57,0,0.0,0.0
T14,170,11-10-2017 23:28:48,0,3726,3043,0.817,0.5,421,226,65,291,195,81,276,1,0.0,0.0
T14,171,11-10-2017 23:48:48,0,3941,3333,0.846,0.5,2279,1411,640,2051,868,430,1298,330,0.0,0.15
T14,172,12-10-2017 00:08:48,0,3449,2738,0.794,0.5,645,435,194,629,210,101,311,43,0.0,0.1
T14,173,12-10-2017 00:28:48,0,3857,3270,0.848,0.5,1027,647,236,883,380,128,508,51,0.04,0.1
T14,174,12-10-2017 00:48:48,0,3806,3180,0.835,0.5,553,374,68,442,179,14,193,0,0.0,0.02
T14,175,12-10-2017 01:08:48,0,4385,3495,0.797,0.6,3120,1880,959,2839,1240,666,1906,533,0.1,0.09
T14,176,12-10-2017 01:28:48,0,3917,3161,0.807,0.5,2656,1360,767,2127,1296,685,1981,361,0.06,0.0
T14,177,12-10-2017 01:48:48,0,3440,2669,0.776,0.4,460,286,41,327,174,37,211,0,0.0,0.03
T14,178,12-10-2017 02:08:48,0,3426,2643,0.772,0.4,227,162,42,204,65,27,92,0,0.0,0.0
T14,179,12-10-2017 02:28:48,0,3978,3238,0.814,0.5,1764,981,498,1479,783,330,1113,304,0.04,0.02
T14,180,12-10-2017 02:48:48,0,3909,3127,0.8,0.5,1791,1076,463,1539,715,344,1059,287,0.1,0.02
T14,181,12-10-2017 03:08:48,0,3720,2842,0.764,0.5,405,325,93,418,80,36,116,0,0.0,0.0
T14,182,12-10-2017 03:28:48,0,3695,2910,0.787,0.5,2156,1340,660,2000,816,330,1146,310,0.0,0.1
T14,183,12-10-2017 03:48:48,0,3421,2670,0.781,0.4,1025,627,253,880,398,151,549,137,0.0,0.0
T14,184,12-10-2017 04:08:48,0,4075,3338,0.819,0.5,2148,1254,632,1886,894,411,1305,237,0.14,0.13
T14,185,12-10-2017 04:28:48,0,4238,3430,0.809,0.6,2368,1441,907,2348,927,548,1475,634,0.0,0.05
T14,186,12-10-2017 04:48:48,0,3768,3116,0.827,0.5,2124,1219,541,1760,905,359,1264,303,0.08,0.11
T14,187,12-10-2017 05:08:48,0,3879,3093,0.797,0.5,1589,987,533,1520,602,350,952,267,0.0,0.0
T14,188,12-10-2017 05:28:48,0,3827,3039,0.794,0.5,1983,1104,556,1660,879,406,1285,347,0.14,0.03
T14,189,12-10-2017 05:48:48,0,3606,2744,0.761,0.5,737,432,144,576,305,92,397,38,0.0,0.0
T14,190,12-10-2017 06:08:48,1,3284,2474,0.753,0.4,273,120,25,145,153,29,182,2,0.0,0.0
T14,191,12-10-2017 06:28:48,1,3567,2919,0.818,0.5,738,482,209,691,256,95,351,40,0.0,0.03
T14,192,12-10-2017 06:48:48,1,3772,3093,0.82,0.5,3162,1734,1018,2752,1428,834,2262,560,0.12,0.11
T14,193,12-10-2017 07:08:48,1,4111,3336,0.811,0.5,1762,1022,381,1403,740,236,976,349,0.08,0.0
T14,194,12-10-2017 07:28:48,1,2800,2171,0.775,0.4,339,241,9,250,98,21,119,0,0.0,0.0
T14,195,12-10-2017 07:48:48,1,3048,2326,0.763,0.4,42,13,3,16,29,8,37,0,0.0,0.0
T14,196,12-10-2017 08:08:48,1,2846,2165,0.761,0.4,32,26,2,28,6,0,6,0,0.0,0.0
T14,197,12-10-2017 08:28:48,1,2945,2258,0.767,0.4,314,221,60,281,93,37,130,44,0.0,0.0
T14,198,12-10-2017 08:48:48,1,3097,2299,0.742,0.4,59,49,11,60,10,0,10,0,0.0,0.0
T14,199,12-10-2017 09:08:48,1,3296,2618,0.794,0.4,792,431,73,504,361,38,399,0,0.0,0.0
T14,200,12-10-2017 09:28:48,1,3177,2428,0.764,0.4,368,255,114,369,113,44,157,4,0.0,0.09
T14,201,12-10-2017 09:48:48,1,2954,2341,0.793,0.4,52,35,4,39,17,7,24,0,0.0,0.0
T14,202,12-10-2017 10:08:48,1,2667,2014,0.755,0.3,668,515,153,668,153,40,193,33,0.0,0.0
T14,203,12-10-2017 10:28:48,1,3707,3000,0.809,0.5,1263,758,366,1124,505,225,730,47,0.0,0.0
T14,204,12-10-2017 10:48:48,1,2804,2081,0.742,0.4,548,316,83,399,232,43,275,11,0.0,0.0
T14,205,12-10-2017 11:08:48,1,2904,2159,0.743,0.4,30,23,4,27,7,2,9,0,0.0,0.0
T14,206,12-10-2017 11:28:48,1,2482,1948,0.785,0.3,288,172,51,223,116,43,159,7,0.0,0.07
T14,207,12-10-2017 11:48:48,1,2939,2366,0.805,0.4,203,145,39,184,58,23,81,0,0.0,0.1
T14,208,12-10-2017 12:08:48,1,3156,2650,0.84,0.4,261,184,68,252,77,29,106,0,0.12,0.0
T14,209,12-10-2017 12:28:48,1,3813,3050,0.8,0.5,2189,1343,642,1985,846,427,1273,204,0.06,0.09
T14,210,12-10-2017 12:48:48,1,3119,2478,0.794,0.4,219,147,60,207,72,7,79,0,0.0,0.0
T14,211,12-10-2017 13:08:48,1,2971,2332,0.785,0.4,55,46,17,63,9,4,13,0,0.0,0.0
T14,212,12-10-2017 13:28:48,1,2923,2269,0.776,0.4,20,16,4,20,4,2,6,0,0.0,0.0
T14,213,12-10-2017 13:48:48,1,3413,2723,0.798,0.4,918,623,204,827,295,78,373,16,0.14,0.03
T14,214,12-10-2017 14:08:48,1,3681,3012,0.818,0.5,1169,739,375,1114,430,182,612,32,0.0,0.0
T14,215,12-10-2017 14:28:48,1,2585,2029,0.785,0.3,162,107,49,156,55,20,75,0,0.0,0.0
T14,216,12-10-2017 14:48:48,1,2842,2102,0.74,0.4,33,28,7,35,5,0,5,0,0.0,0.0
T14,217,12-10-2017 15:08:48,1,3771,3093,0.82,0.5,908,516,138,654,392,121,513,12,0.0,0.08
T14,218,12-10-2017 15:28:48,1,2812,2224,0.791,0.4,432,224,46,270,208,42,250,1,0.0,0.0
T14,219,12-10-2017 15:48:48,1,2929,2305,0.787,0.4,49,22,12,34,27,10,37,0,0.0,0.0
T14,220,12-10-2017 16:08:48,1,3760,3286,0.874,0.5,748,518,182,700,230,80,310,19,0.0,0.07
T14,221,12-10-2017 16:28:48,1,2875,2236,0.778,0.4,617,410,184,594,207,90,297,33,0.0,0.0
T14,222,12-10-2017 16:48:48,1,2651,2013,0.759,0.3,55,39,21,60,16,6,22,0,0.0,0.0
T14,223,12-10-2017 17:08:48,1,3009,2314,0.769,0.4,106,65,19,84,41,22,63,0,0.0,0.0
T14,224,12-10-2017 17:28:48,1,3290,2731,0.83,0.4,299,194,74,268,105,21,126,0,0.0,0.04
T14,225,12-10-2017 17:48:48,1,2965,2384,0.804,0.4,615,417,102,519,198,51,249,13,0.08,0.09
T14,226,12-10-2017 18:08:48,0,3829,3354,0.876,0.5,574,409,110,519,165,43,208,0,0.0,0.08
T14,227,12-10-2017 18:28:48,0,3774,3138,0.831,0.5,1436,835,295,1130,601,232,833,90,0.08,0.08
T14,228,12-10-2017 18:48:48,0,3516,2869,0.816,0.5,416,289,138,427,127,53,180,1,0.08,0.0
T14,229,12-10-2017 19:08:48,0,4419,3735,0.845,0.6,3419,2125,1096,3221,1294,693,1987,773,0.0,0.23
T14,230,12-10-2017 19:28:48,0,3883,3180,0.819,0.5,3985,2228,1465,3693,1757,1091,2848,973,0.0,0.03
T14,231,12-10-2017 19:48:48,0,3759,2993,0.796,0.5,1601,962,431,1393,639,245,884,105,0.14,0.0
T14,232,12-10-2017 20:08:48,0,3377,2555,0.756,0.4,406,147,53,200,259,61,320,1,0.0,0.0
T14,233,12-10-2017 20:28:48,0,3030,2346,0.774,0.4,280,167,72,239,113,46,159,2,0.0,0.0
T14,234,12-10-2017 20:48:48,0,3071,2350,0.765,0.4,511,322,127,449,189,90,279,34,0.0,0.0
T14,235,12-10-2017 21:08:48,0,3462,2626,0.758,0.4,365,213,95,308,152,79,231,23,0.0,0.0
T14,236,12-10-2017 21:28:48,0,3235,2508,0.775,0.4,1469,783,299,1082,686,184,870,52,0.0,0.0
T14,237,12-10-2017 21:48:48,0,3031,2282,0.753,0.4,378,216,113,329,162,58,220,14,0.0,0.0
T14,238,12-10-2017 22:08:48,0,3327,2438,0.733,0.4,1369,788,380,1168,581,229,810,103,0.0,0.0
T14,239,12-10-2017 22:28:48,0,3266,2489,0.762,0.4,465,194,56,250,271,50,321,0,0.0,0.0
T14,240,12-10-2017 22:48:48,0,3099,2231,0.72,0.4,150,77,29,106,73,14,87,0,0.0,0.0
T14,241,12-10-2017 23:08:48,0,2800,2043,0.73,0.4,396,228,109,337,168,69,237,5,0.0,0.0
T14,242,12-10-2017 23:28:48,0,3879,3020,0.779,0.5,658,328,145,473,330,112,442,30,0.0,0.0
T14,243,12-10-2017 23:48:48,0,4060,3027,0.746,0.5,5457,3181,2292,5473,2276,1443,3719,1537,0.0,0.0
T14,244,13-10-2017 00:08:48,0,3600,2682,0.745,0.5,3547,2006,1303,3309,1541,812,2353,917,0.16,0.0
T14,245,13-10-2017 00:28:48,0,3362,2431,0.723,0.4,769,598,102,700,171,49,220,0,0.0,0.0
T14,246,13-10-2017 00:48:48,0,3245,2458,0.758,0.4,322,187,79,266,135,61,196,12,0.0,0.0
T14,247,13-10-2017 01:08:48,0,3336,2404,0.721,0.4,282,156,61,217,126,38,164,6,0.0,0.0
T14,248,13-10-2017 01:28:48,0,3088,2221,0.719,0.4,712,464,78,542,248,64,312,0,0.06,0.0
T14,249,13-10-2017 01:48:48,0,2767,2034,0.735,0.4,221,143,77,220,78,43,121,10,0.08,0.0
T14,250,13-10-2017 02:08:48,0,2429,1791,0.737,0.3,87,41,14,55,46,2,48,0,0.0,0.0
T14,251,13-10-2017 02:28:48,0,3024,2165,0.716,0.4,397,233,114,347,164,55,219,14,0.0,0.0
T14,252,13-10-2017 02:48:48,0,3991,2957,0.741,0.5,2688,1535,953,2488,1153,634,1787,502,0.0,0.0
T14,253,13-10-2017 03:08:48,0,3938,2840,0.721,0.5,3204,1831,1108,2939,1373,744,2117,684,0.16,0.0
T14,254,13-10-2017 03:28:48,0,3269,2377,0.727,0.4,1811,1067,387,1454,744,266,1010,156,0.0,0.0
T14,255,13-10-2017 03:48:48,0,3155,2369,0.751,0.4,275,178,61,239,97,41,138,0,0.0,0.0
T14,256,13-10-2017 04:08:48,0,4323,3232,0.748,0.6,3862,2165,1340,3505,1697,1027,2724,969,0.0,0.0
T14,257,13-10-2017 04:28:48,0,3589,2576,0.718,0.5,2509,1364,694,2058,1145,595,1740,305,0.0,0.0
T14,258,13-10-2017 04:48:48,0,3327,2359,0.709,0.4,1519,926,390,1316,593,237,830,147,0.14,0.0
T14,259,13-10-2017 05:08:48,0,3799,2803,0.738,0.5,1128,669,282,951,459,230,689,43,0.02,0.0
T14,260,13-10-2017 05:28:48,0,3468,2443,0.704,0.4,3553,1966,1241,3207,1587,950,2537,1021,0.06,0.0
T14,261,13-10-2017 05:48:48,0,3099,2243,0.724,0.4,2072,1092,530,1622,980,384,1364,159,0.04,0.0
T14,262,13-10-2017 06:08:48,1,2542,1830,0.72,0.3,668,418,49,467,250,62,312,0,0.0,0.0
T14,263,13-10-2017 06:28:48,1,3368,2524,0.749,0.4,439,240,74,314,199,58,257,4,0.0,0.0
T14,264,13-10-2017 06:48:48,1,2962,2138,0.722,0.4,1916,1118,534,1652,798,356,1154,181,0.08,0.0
T14,265,13-10-2017 07:08:48,1,2901,2072,0.714,0.4,71,57,19,76,14,1,15,0,0.0,0.0
T14,266,13-10-2017 07:28:48,1,3654,2689,0.736,0.5,1098,679,356,1035,419,216,635,121,0.06,0.45
T14,267,13-10-2017 07:48:48,1,2923,2380,0.814,0.4,1930,981,549,1530,949,369,1318,143,0.0,0.06
T14,268,13-10-2017 08:08:48,1,2847,2314,0.813,0.4,41,38,20,58,3,2,5,0,0.0,0.0
T14,269,13-10-2017 08:28:48,1,2649,2122,0.801,0.3,26,17,7,24,9,1,10,0,0.0,0.0
T14,270,13-10-2017 08:48:48,1,2853,2288,0.802,0.4,165,72,28,100,93,52,145,0,0.0,0.0
T14,271,13-10-2017 09:08:48,1,3646,2964,0.813,0.5,1880,1116,603,1719,764,374,1138,264,0.24,0.23
T14,272,13-10-2017 09:28:48,1,3008,2373,0.789,0.4,946,549,233,782,397,154,551,87,0.1,0.0
T14,273,13-10-2017 09:48:48,1,2807,2205,0.786,0.4,44,36,4,40,8,1,9,0,0.0,0.0
T14,274,13-10-2017 10:08:48,1,2675,2134,0.798,0.4,65,43,5,48,22,10,32,0,0.0,0.0
T14,275,13-10-2017 10:28:48,1,2956,2347,0.794,0.4,70,43,12,55,27,2,29,0,0.0,0.0
T14,276,13-10-2017 10:48:48,1,3668,3103,0.846,0.5,1035,722,252,974,313,97,410,21,0.1,0.15
T14,277,13-10-2017 11:08:48,1,2795,2230,0.798,0.4,52,39,5,44,13,0,13,0,0.0,0.0
T14,278,13-10-2017 11:28:48,1,2848,2246,0.789,0.4,46,22,9,31,24,10,34,0,0.0,0.0
T14,279,13-10-2017 11:48:48,1,2777,2288,0.824,0.4,124,92,23,115,32,9,41,0,0.0,0.0
T14,280,13-10-2017 12:08:48,1,3995,3377,0.845,0.5,1579,1008,566,1574,571,232,803,50,0.06,0.1
T14,281,13-10-2017 12:28:48,1,2819,2175,0.772,0.4,1018,665,467,1132,353,202,555,91,0.1,0.0
T14,282,13-10-2017 12:48:48,1,2842,2274,0.8,0.4,234,168,99,267,66,42,108,0,0.0,0.0
T14,283,13-10-2017 13:08:48,1,2944,2374,0.807,0.4,131,107,24,131,24,12,36,0,0.0,0.0
T14,284,13-10-2017 13:28:48,1,2678,2150,0.803,0.4,126,108,11,119,18,2,20,0,0.0,0.0
T14,285,13-10-2017 13:48:48,1,3627,3108,0.857,0.5,1557,1063,436,1499,494,155,649,25,0.0,0.04
T14,286,13-10-2017 14:08:48,1,2811,2203,0.784,0.4,462,264,36,300,198,31,229,3,0.0,0.0
T11,1,09-10-2017 15:02:48,1,3168,2350,0.742,0.6,315,245,123,368,70,20,90,2,0.0,0.0
T11,2,09-10-2017 15:22:48,1,2090,1485,0.711,0.4,112,100,23,123,12,2,14,0,0.0,0.0
T11,3,09-10-2017 15:42:48,1,2116,1528,0.722,0.4,96,73,54,127,23,7,30,1,0.0,0.0
T11,4,09-10-2017 16:02:48,1,2133,1550,0.727,0.4,23,13,2,15,10,5,15,0,0.0,0.0
T11,5,09-10-2017 16:22:48,1,2433,1795,0.738,0.4,93,66,9,75,27,0,27,0,0.0,0.0
T11,6,09-10-2017 16:42:48,1,2303,1685,0.732,0.4,18,2,0,2,16,0,16,0,0.0,0.0
T11,7,09-10-2017 17:02:48,1,2328,1677,0.72,0.4,142,99,56,155,43,20,63,1,0.0,0.0
T11,8,09-10-2017 17:22:48,1,2944,2293,0.779,0.5,438,260,27,287,178,17,195,0,0.0,0.0
T11,9,09-10-2017 17:42:48,1,2349,1762,0.75,0.4,854,543,217,760,311,73,384,40,0.0,0.11
T11,10,09-10-2017 18:02:48,0,2399,1783,0.743,0.4,60,43,15,58,17,1,18,0,0.0,0.0
T11,11,09-10-2017 18:22:48,0,2613,1952,0.747,0.5,568,432,103,535,136,31,167,24,0.0,-0.03
T11,12,09-10-2017 18:42:48,0,2694,2193,0.814,0.5,400,281,128,409,119,43,162,30,0.0,0.1
T11,13,09-10-2017 19:02:48,0,3632,2896,0.797,0.7,2918,1945,1172,3117,973,416,1389,589,0.0,-0.02
T11,14,09-10-2017 19:22:48,0,3602,2798,0.777,0.7,3050,2077,1335,3412,973,464,1437,711,0.0,-0.03
T11,15,09-10-2017 19:42:48,0,2740,2056,0.75,0.5,1999,1276,662,1938,723,262,985,357,0.0,-0.01
T11,16,09-10-2017 20:02:48,0,2611,1919,0.735,0.5,1024,734,455,1189,290,160,450,239,0.0,0.0
T11,17,09-10-2017 20:22:48,0,2620,2094,0.799,0.5,447,300,136,436,147,44,191,21,0.0,0.13
T11,18,09-10-2017 20:42:48,0,3575,2975,0.832,0.7,2033,1381,957,2338,652,328,980,420,0.0,0.08
T11,19,09-10-2017 21:02:48,0,3318,2664,0.803,0.6,2231,1447,832,2279,784,363,1147,477,0.02,0.05
T11,20,09-10-2017 21:22:48,0,3395,2799,0.824,0.6,4081,2780,1809,4589,1301,674,1975,1117,0.04,0.0
T11,21,09-10-2017 21:42:48,0,3313,2605,0.786,0.6,3011,2095,1249,3344,916,403,1319,519,0.0,-0.01
T11,22,09-10-2017 22:02:48,0,3342,2576,0.771,0.6,2061,1408,606,2014,653,258,911,270,0.06,0.0
T11,23,09-10-2017 22:22:48,0,2459,1836,0.747,0.4,233,124,29,153,109,15,124,2,0.0,0.09
T11,24,09-10-2017 22:42:48,0,2745,2146,0.782,0.5,224,143,47,190,81,16,97,2,0.0,0.06
T11,25,09-10-2017 23:02:48,0,2421,1850,0.764,0.4,556,399,147,546,157,39,196,13,0.08,0.0
T11,26,09-10-2017 23:22:48,0,2621,2014,0.769,0.5,133,94,25,119,39,9,48,0,0.0,0.12
T11,27,09-10-2017 23:42:48,0,2405,1886,0.784,0.4,67,41,12,53,26,2,28,0,0.0,0.02
T11,28,10-10-2017 00:02:48,0,2752,2238,0.813,0.5,176,118,33,151,58,12,70,0,0.0,0.12
T11,29,10-10-2017 00:22:48,0,2309,1872,0.811,0.4,407,295,139,434,112,41,153,76,0.0,0.0
T11,30,10-10-2017 00:42:48,0,2915,2491,0.854,0.5,533,271,49,320,262,14,276,0,0.0,0.13
T11,31,10-10-2017 01:02:48,0,2280,1804,0.791,0.4,259,204,105,309,55,24,79,22,0.08,0.0
T11,32,10-10-2017 01:22:48,0,2603,2078,0.798,0.5,131,79,26,105,52,16,68,0,0.0,0.03
T11,33,10-10-2017 01:42:48,0,2924,2461,0.842,0.5,358,202,35,237,156,22,178,0,0.0,0.11
T11,34,10-10-2017 02:02:48,0,2463,1989,0.807,0.5,147,105,44,149,42,8,50,2,0.12,0.0
T11,35,10-10-2017 02:22:48,0,2653,2061,0.777,0.5,53,28,5,33,25,6,31,0,0.0,0.0
T11,36,10-10-2017 02:42:48,0,2374,1927,0.812,0.4,343,173,22,195,170,42,212,0,0.0,0.19
T11,37,10-10-2017 03:02:48,0,2792,2268,0.812,0.5,148,92,23,115,56,23,79,0,0.0,0.08
T11,38,10-10-2017 03:22:48,0,2601,2109,0.811,0.5,163,103,16,119,60,9,69,1,0.0,0.0
T11,39,10-10-2017 03:42:48,0,2302,1845,0.801,0.4,219,162,63,225,57,15,72,13,0.08,0.0
T11,40,10-10-2017 04:02:48,0,3231,2764,0.855,0.6,826,476,132,608,350,48,398,23,0.02,0.0
T11,41,10-10-2017 04:22:48,0,3582,2972,0.83,0.7,4439,3135,2245,5380,1304,733,2037,1423,0.08,0.02
T11,42,10-10-2017 04:42:48,0,3113,2457,0.789,0.6,3387,2315,1560,3875,1072,524,1596,982,0.04,0.04
T11,43,10-10-2017 05:02:48,0,3176,2541,0.8,0.6,2522,1713,913,2626,809,349,1158,253,0.1,0.0
T11,44,10-10-2017 05:22:48,0,3190,2620,0.821,0.6,2338,1509,732,2241,829,307,1136,345,0.04,0.03
T11,45,10-10-2017 05:42:48,0,2267,1696,0.748,0.4,1052,588,242,830,464,146,610,75,0.08,0.0
T11,46,10-10-2017 06:02:48,1,2253,1666,0.739,0.4,55,27,2,29,28,4,32,0,0.0,0.0
T11,47,10-10-2017 06:22:48,1,2226,1727,0.776,0.4,327,199,66,265,128,41,169,57,0.0,0.18
T11,48,10-10-2017 06:42:48,1,2530,2013,0.796,0.5,85,53,3,56,32,6,38,0,0.0,0.0
T11,49,10-10-2017 07:02:48,1,2959,2468,0.834,0.6,1614,1044,651,1695,570,235,805,441,0.06,0.19
T11,50,10-10-2017 07:22:48,1,2659,2210,0.831,0.5,1342,1011,196,1207,331,71,402,4,0.02,-0.03
T11,51,10-10-2017 07:42:48,1,2346,1790,0.763,0.4,89,50,4,54,39,9,48,0,0.0,0.0
T11,52,10-10-2017 08:02:48,1,2517,1995,0.793,0.5,125,91,11,102,34,7,41,0,0.0,0.12
T11,53,10-10-2017 08:22:48,1,2646,2125,0.803,0.5,108,64,20,84,44,12,56,0,0.0,0.0
T11,54,10-10-2017 08:42:48,1,2312,1859,0.804,0.4,108,49,27,76,59,13,72,0,0.0,0.0
T11,55,10-10-2017 09:02:48,1,2220,1777,0.8,0.4,74,47,11,58,27,5,32,0,0.0,0.0
T11,56,10-10-2017 09:22:48,1,2263,1812,0.801,0.4,77,44,11,55,33,10,43,0,0.0,0.0
T11,57,10-10-2017 09:42:48,1,3092,2540,0.822,0.6,1809,1146,534,1680,663,189,852,231,0.14,0.09
T11,58,10-10-2017 10:02:48,1,2324,1880,0.809,0.4,595,351,140,491,244,70,314,15,0.04,0.0
T11,59,10-10-2017 10:22:48,1,2322,1843,0.794,0.4,59,25,3,28,34,7,41,0,0.0,0.0
T11,60,10-10-2017 10:42:48,1,2293,1757,0.767,0.4,72,38,5,43,34,10,44,0,0.0,0.0
T11,61,10-10-2017 11:02:48,1,3085,2585,0.838,0.6,1182,722,396,1118,460,159,619,136,0.08,0.08
T11,62,10-10-2017 11:22:48,1,2328,1852,0.795,0.4,506,260,29,289,246,19,265,0,0.0,0.0
T11,63,10-10-2017 11:42:48,1,2629,2107,0.801,0.5,173,74,23,97,99,18,117,0,0.0,0.16
T11,64,10-10-2017 12:02:48,1,2757,2296,0.833,0.5,556,280,86,366,276,54,330,6,0.0,0.0
T11,65,10-10-2017 12:22:48,1,2457,1976,0.804,0.5,211,137,36,173,74,28,102,0,0.06,0.0
T11,66,10-10-2017 12:42:48,1,2353,1841,0.782,0.4,146,106,10,116,40,13,53,0,0.0,0.0
T11,67,10-10-2017 13:02:48,1,3138,2706,0.862,0.6,1585,991,536,1527,594,199,793,313,0.16,0.11
T11,68,10-10-2017 13:22:48,1,2309,1843,0.798,0.4,312,143,22,165,169,28,197,0,0.0,0.0
T11,69,10-10-2017 13:42:48,1,3719,2978,0.801,0.7,637,402,198,600,235,98,333,81,0.0,0.0
T11,70,10-10-2017 14:02:48,1,2294,1737,0.757,0.4,513,312,100,412,201,46,247,36,0.0,0.0
T11,71,10-10-2017 14:22:48,1,2312,1777,0.769,0.4,51,29,7,36,22,8,30,0,0.0,0.0
T11,72,10-10-2017 14:42:48,1,2896,2361,0.815,0.5,604,376,47,423,228,22,250,2,0.0,0.07
T11,73,10-10-2017 15:02:48,1,2297,1765,0.768,0.4,57,34,5,39,23,1,24,0,0.0,0.02
T11,74,10-10-2017 15:22:48,1,2284,1809,0.792,0.4,97,53,17,70,44,12,56,0,0.0,0.03
T11,75,10-10-2017 15:42:48,1,2331,1816,0.779,0.4,86,49,6,55,37,9,46,0,0.0,0.02
T11,76,10-10-2017 16:02:48,1,2401,1972,0.821,0.4,497,343,79,422,154,51,205,21,0.02,0.16
T11,77,10-10-2017 16:22:48,1,2409,1971,0.818,0.4,48,31,2,33,17,4,21,0,0.0,0.03
T11,78,10-10-2017 16:42:48,1,2339,1872,0.8,0.4,72,41,15,56,31,7,38,0,0.0,0.0
T11,79,10-10-2017 17:02:48,1,3091,2724,0.881,0.6,875,452,80,532,423,93,516,7,0.04,0.09
T11,80,10-10-2017 17:22:48,1,2487,1995,0.802,0.5,658,423,91,514,235,49,284,8,0.08,0.0
T11,81,10-10-2017 17:42:48,1,2398,1893,0.789,0.4,128,56,8,64,72,19,91,0,0.0,0.09
T11,82,10-10-2017 18:02:48,0,3459,2974,0.86,0.6,595,382,199,581,213,81,294,52,0.0,0.0
T11,83,10-10-2017 18:22:48,0,3739,3062,0.819,0.7,2261,1391,708,2099,870,276,1146,427,0.02,0.0
T11,84,10-10-2017 18:42:48,0,3452,2717,0.787,0.6,3022,1883,1179,3062,1139,587,1726,1042,0.0,0.0
T11,85,10-10-2017 19:02:48,0,3686,2888,0.784,0.7,2552,1638,660,2298,914,348,1262,643,0.0,0.01
T11,86,10-10-2017 19:22:48,0,3455,2794,0.809,0.6,3279,2104,1236,3340,1175,572,1747,941,0.02,0.04
T11,87,10-10-2017 19:42:48,0,3509,2757,0.786,0.6,4168,2634,1813,4447,1534,817,2351,1183,0.0,0.05
T11,88,10-10-2017 20:02:48,0,3572,2808,0.786,0.7,2960,1743,942,2685,1217,502,1719,751,0.12,0.05
T11,89,10-10-2017 20:22:48,0,3308,2661,0.805,0.6,2956,1789,968,2757,1167,498,1665,448,0.0,0.05
T11,90,10-10-2017 20:42:48,0,3071,2505,0.816,0.6,2515,1520,842,2362,995,415,1410,490,0.02,0.0
T11,91,10-10-2017 21:02:48,0,2648,1949,0.736,0.5,373,198,28,226,175,32,207,2,0.02,0.0
T11,92,10-10-2017 21:22:48,0,2758,2261,0.82,0.5,860,530,146,676,330,68,398,21,0.02,0.11
T11,93,10-10-2017 21:42:48,0,2962,2250,0.76,0.5,137,84,19,103,53,13,66,0,0.0,0.0
T11,94,10-10-2017 22:02:48,0,3357,2709,0.807,0.6,2651,1535,787,2322,1116,397,1513,378,0.02,0.07
T11,95,10-10-2017 22:22:48,0,2493,1890,0.758,0.5,560,276,43,319,284,45,329,13,0.04,0.0
T11,96,10-10-2017 22:42:48,0,3105,2361,0.76,0.6,264,139,54,193,125,40,165,8,0.02,0.0
T11,97,10-10-2017 23:02:48,0,3081,2497,0.81,0.6,535,247,64,311,288,43,331,1,0.0,0.13
T11,98,10-10-2017 23:22:48,0,3006,2453,0.816,0.6,2179,1279,653,1932,900,323,1223,521,0.08,0.0
T11,99,10-10-2017 23:42:48,0,2694,2054,0.762,0.5,292,169,26,195,123,18,141,0,0.02,0.09
T11,100,11-10-2017 00:02:48,0,2735,2131,0.779,0.5,46,37,12,49,9,2,11,0,0.0,0.0
T11,101,11-10-2017 00:22:48,0,2787,2218,0.796,0.5,166,109,25,134,57,11,68,0,0.02,0.09
T11,102,11-10-2017 00:42:48,0,2329,1819,0.781,0.4,1116,527,125,652,589,72,661,27,0.0,0.0
T11,103,11-10-2017 01:02:48,0,2692,2044,0.759,0.5,45,33,5,38,12,1,13,0,0.0,0.0
T11,104,11-10-2017 01:22:48,0,2817,2278,0.809,0.5,381,242,64,306,139,34,173,19,0.0,0.08
T11,105,11-10-2017 01:42:48,0,2783,2123,0.763,0.5,463,230,73,303,233,47,280,21,0.08,0.0
T11,106,11-10-2017 02:02:48,0,2920,2323,0.796,0.5,519,359,103,462,160,47,207,2,0.0,0.0
T11,107,11-10-2017 02:22:48,0,2570,2069,0.805,0.5,719,437,176,613,282,94,376,89,0.04,0.11
T11,108,11-10-2017 02:42:48,0,2685,2109,0.785,0.5,137,73,10,83,64,17,81,0,0.0,0.0
T11,109,11-10-2017 03:02:48,0,3664,2923,0.798,0.7,2887,1821,964,2785,1066,489,1555,615,0.08,0.06
T11,110,11-10-2017 03:22:48,0,3377,2753,0.815,0.6,2891,1682,921,2603,1209,435,1644,622,0.16,0.04
T11,111,11-10-2017 03:42:48,0,2516,1867,0.742,0.5,1455,904,451,1355,551,183,734,40,0.0,0.0
T11,112,11-10-2017 04:02:48,0,2662,1980,0.744,0.5,128,106,6,112,22,1,23,0,0.0,0.0
T11,113,11-10-2017 04:22:48,0,3517,2832,0.805,0.7,1717,1013,408,1421,704,222,926,151,0.02,0.18
T11,114,11-10-2017 04:42:48,0,2843,2264,0.796,0.5,2068,1263,681,1944,805,342,1147,410,0.04,0.0
T11,115,11-10-2017 05:02:48,0,2712,2064,0.761,0.5,94,65,19,84,29,3,32,0,0.0,0.0
T11,116,11-10-2017 05:22:48,0,3342,2735,0.818,0.6,781,447,215,662,334,108,442,32,0.0,0.08
T11,117,11-10-2017 05:42:48,0,2820,2314,0.821,0.5,2283,1389,757,2146,894,364,1258,220,0.04,0.0
T11,118,11-10-2017 06:02:48,1,2490,1910,0.767,0.5,246,167,66,233,79,16,95,0,0.0,0.0
T11,119,11-10-2017 06:22:48,1,2479,1877,0.757,0.5,116,74,8,82,42,10,52,0,0.0,0.0
T11,120,11-10-2017 06:42:48,1,3063,2522,0.823,0.6,680,430,167,597,250,64,314,23,0.04,0.11
T11,121,11-10-2017 07:02:48,1,2395,1891,0.79,0.4,295,197,113,310,98,34,132,16,0.0,0.0
T11,122,11-10-2017 07:22:48,1,2367,1825,0.771,0.4,60,26,5,31,34,9,43,0,0.02,0.0
T11,123,11-10-2017 07:42:48,1,2341,1892,0.808,0.4,434,234,72,306,200,25,225,10,0.0,0.07
T11,124,11-10-2017 08:02:48,1,2620,2056,0.785,0.5,122,94,8,102,28,5,33,0,0.0,0.02
T11,125,11-10-2017 08:22:48,1,2153,1667,0.774,0.4,88,45,1,46,43,5,48,0,0.0,0.0
T11,126,11-10-2017 08:42:48,1,3066,2545,0.83,0.6,558,341,96,437,217,38,255,10,0.02,0.0
T11,127,11-10-2017 09:02:48,1,2769,2185,0.789,0.5,2928,1836,1105,2941,1092,511,1603,479,0.12,0.03
T11,128,11-10-2017 09:22:48,1,2288,1737,0.759,0.4,163,89,15,104,74,17,91,10,0.02,0.0
T11,129,11-10-2017 09:42:48,1,2459,1844,0.75,0.4,29,15,0,15,14,1,15,0,0.0,0.0
T11,130,11-10-2017 10:02:48,1,2845,2329,0.819,0.5,1101,674,320,994,427,133,560,14,0.04,0.13
T11,131,11-10-2017 10:22:48,1,2199,1723,0.784,0.4,210,97,17,114,113,16,129,0,0.02,0.0
T11,132,11-10-2017 10:42:48,1,2372,1850,0.78,0.4,110,63,14,77,47,18,65,0,0.0,0.02
T11,133,11-10-2017 11:02:48,1,2466,1875,0.76,0.5,73,33,3,36,40,12,52,0,0.0,0.0
T11,134,11-10-2017 11:22:48,1,2300,1785,0.776,0.4,155,73,12,85,82,15,97,0,0.0,0.0
T11,135,11-10-2017 11:42:48,1,2872,2403,0.837,0.5,1678,1020,510,1530,658,231,889,67,0.14,0.08
T11,136,11-10-2017 12:02:48,1,2282,1757,0.77,0.4,242,206,0,206,36,0,36,0,0.0,0.0
T11,137,11-10-2017 12:22:48,1,2052,1529,0.745,0.4,40,21,1,22,19,0,19,0,0.0,0.0
T11,138,11-10-2017 12:42:48,1,2328,1760,0.756,0.4,63,31,2,33,32,12,44,0,0.0,0.03
T11,139,11-10-2017 13:02:48,1,2271,1837,0.809,0.4,1087,693,248,941,394,126,520,21,0.02,0.07
T11,140,11-10-2017 13:22:48,1,2430,1927,0.793,0.4,105,75,22,97,30,4,34,0,0.0,0.0
T11,141,11-10-2017 13:42:48,1,2319,1789,0.771,0.4,81,40,5,45,41,10,51,0,0.0,0.0
T11,142,11-10-2017 14:02:48,1,2556,1929,0.755,0.5,560,350,105,455,210,72,282,2,0.02,0.0
T11,143,11-10-2017 14:22:48,1,2287,1718,0.751,0.4,32,21,3,24,11,0,11,0,0.0,0.0
T11,144,11-10-2017 14:42:48,1,2870,2437,0.849,0.5,862,529,177,706,333,86,419,27,0.06,0.08
T11,145,11-10-2017 15:02:48,1,2395,1843,0.77,0.4,439,228,80,308,211,57,268,3,0.0,0.0
T11,146,11-10-2017 15:22:48,1,2377,1830,0.77,0.4,69,35,10,45,34,7,41,0,0.0,0.0
T11,147,11-10-2017 15:42:48,1,2371,1820,0.767,0.4,104,36,4,40,68,11,79,0,0.0,0.0
T11,148,11-10-2017 16:02:48,1,2995,2541,0.848,0.6,1040,574,170,744,466,87,553,27,0.0,0.08
T11,149,11-10-2017 16:22:48,1,2365,1830,0.774,0.4,284,175,25,200,109,14,123,0,0.02,0.0
T11,150,11-10-2017 16:42:48,1,2393,1792,0.749,0.4,36,32,7,39,4,0,4,0,0.0,0.0
T11,151,11-10-2017 17:02:48,1,2305,1759,0.763,0.4,140,79,16,95,61,16,77,5,0.02,0.0
T11,152,11-10-2017 17:22:48,1,3960,3147,0.795,0.7,1580,949,525,1474,631,276,907,144,0.0,-0.03
T11,153,11-10-2017 17:42:48,1,2780,2239,0.805,0.5,1702,963,407,1370,739,226,965,164,0.0,0.05
T11,154,11-10-2017 18:02:48,0,2596,1985,0.765,0.5,748,427,50,477,321,40,361,0,0.0,-0.02
T11,155,11-10-2017 18:22:48,0,3651,2915,0.798,0.7,765,479,143,622,286,74,360,26,0.08,0.0
T11,156,11-10-2017 18:42:48,0,3613,2960,0.819,0.7,2480,1401,648,2049,1079,454,1533,352,0.0,0.18
T11,157,11-10-2017 19:02:48,0,3598,2884,0.802,0.7,2620,1504,662,2166,1116,492,1608,354,0.0,0.15
T11,158,11-10-2017 19:22:48,0,3415,2680,0.785,0.6,2942,1586,777,2363,1356,521,1877,632,0.0,0.18
T11,159,11-10-2017 19:42:48,0,3544,2752,0.777,0.7,3078,1764,976,2740,1314,714,2028,764,0.04,0.06
T11,160,11-10-2017 20:02:48,0,3318,2588,0.78,0.6,2517,1485,602,2087,1032,403,1435,261,0.08,0.13
T11,161,11-10-2017 20:22:48,0,3083,2479,0.804,0.6,1353,678,244,922,675,231,906,168,0.1,0.11
T11,162,11-10-2017 20:42:48,0,2730,2047,0.75,0.5,93,39,3,42,54,5,59,0,0.0,0.0
T11,163,11-10-2017 21:02:48,0,2583,1926,0.746,0.5,174,73,26,99,101,29,130,0,0.0,0.0
T11,164,11-10-2017 21:22:48,0,3350,2586,0.772,0.6,1024,648,246,894,376,112,488,37,0.0,0.06
T11,165,11-10-2017 21:42:48,0,3096,2595,0.838,0.6,2550,1624,863,2487,926,436,1362,703,0.1,0.02
T11,166,11-10-2017 22:02:48,0,2693,2057,0.764,0.5,474,370,62,432,104,21,125,0,0.0,0.0
T11,167,11-10-2017 22:22:48,0,2722,2062,0.757,0.5,129,80,26,106,49,13,62,5,0.02,0.03
T11,168,11-10-2017 22:42:48,0,2462,1831,0.744,0.4,72,47,15,62,25,5,30,0,0.0,0.0
T11,169,11-10-2017 23:02:48,0,3087,2561,0.829,0.6,614,373,51,424,241,39,280,5,0.0,0.12
T11,170,11-10-2017 23:22:48,0,2845,2181,0.767,0.5,348,231,65,296,117,39,156,26,0.02,0.0
T11,171,11-10-2017 23:42:48,0,2620,1971,0.752,0.5,167,104,25,129,63,35,98,0,0.06,0.0
T11,172,12-10-2017 00:02:48,0,2566,1977,0.77,0.5,472,242,41,283,230,43,273,2,0.0,0.03
T11,173,12-10-2017 00:22:48,0,3626,2910,0.803,0.7,1036,621,345,966,415,158,573,134,0.0,0.17
T11,174,12-10-2017 00:42:48,0,3576,2953,0.826,0.7,3799,2308,1501,3809,1491,758,2249,1265,0.14,0.05
T11,175,12-10-2017 01:02:48,0,3257,2622,0.805,0.6,2541,1567,798,2365,974,412,1386,372,0.08,0.09
T11,176,12-10-2017 01:22:48,0,3067,2481,0.809,0.6,3086,1866,1131,2997,1220,518,1738,454,0.06,0.05
T11,177,12-10-2017 01:42:48,0,2797,2154,0.77,0.5,1250,759,304,1063,491,141,632,39,0.0,0.0
T11,178,12-10-2017 02:02:48,0,2445,1862,0.761,0.4,41,20,3,23,21,3,24,0,0.0,0.0
T11,179,12-10-2017 02:22:48,0,2773,2107,0.76,0.5,129,82,24,106,47,12,59,0,0.0,0.0
T11,180,12-10-2017 02:42:48,0,2949,2429,0.824,0.5,702,445,100,545,257,61,318,1,0.0,0.0
T11,181,12-10-2017 03:02:48,0,3241,2685,0.829,0.6,3340,1987,1212,3199,1353,665,2018,637,0.14,0.15
T11,182,12-10-2017 03:22:48,0,2661,2086,0.784,0.5,655,419,76,495,236,38,274,1,0.02,0.0
T11,183,12-10-2017 03:42:48,0,2681,2175,0.811,0.5,333,198,40,238,135,27,162,0,0.0,0.0
T11,184,12-10-2017 04:02:48,0,2501,1920,0.768,0.5,146,77,10,87,69,17,86,0,0.0,0.0
T11,185,12-10-2017 04:22:48,0,3770,2997,0.795,0.7,1753,1009,374,1383,744,244,988,109,0.0,0.1
T11,186,12-10-2017 04:42:48,0,3042,2537,0.834,0.6,2665,1549,761,2310,1116,424,1540,507,0.16,0.12
T11,187,12-10-2017 05:02:48,0,2843,2202,0.775,0.5,147,74,2,76,73,11,84,0,0.0,0.0
T11,188,12-10-2017 05:22:48,0,3305,2699,0.817,0.6,2532,1548,942,2490,984,412,1396,385,0.04,0.11
T11,189,12-10-2017 05:42:48,0,2536,1980,0.781,0.5,1382,741,285,1026,641,217,858,229,0.06,-0.02
T11,190,12-10-2017 06:02:48,1,2229,1713,0.769,0.4,104,66,1,67,38,9,47,0,0.0,0.0
T11,191,12-10-2017 06:22:48,1,2746,2103,0.766,0.5,200,131,13,144,69,21,90,0,0.0,0.0
T11,192,12-10-2017 06:42:48,1,2940,2269,0.772,0.5,351,203,25,228,148,18,166,0,0.0,0.0
T11,193,12-10-2017 07:02:48,1,2467,1880,0.762,0.5,85,54,15,69,31,7,38,0,0.0,0.0
T11,194,12-10-2017 07:22:48,1,2180,1651,0.757,0.4,43,18,8,26,25,13,38,0,0.02,0.0
T11,195,12-10-2017 07:42:48,1,2581,2044,0.792,0.5,1102,674,300,974,428,170,598,74,0.04,0.06
T11,196,12-10-2017 08:02:48,1,2342,1800,0.769,0.4,126,109,2,111,17,7,24,0,0.0,0.0
T11,197,12-10-2017 08:22:48,1,2261,1721,0.761,0.4,42,27,0,27,15,3,18,0,0.0,0.0
T11,198,12-10-2017 08:42:48,1,2694,2142,0.795,0.5,452,279,30,309,173,19,192,0,0.0,0.0
T11,199,12-10-2017 09:02:48,1,2341,1869,0.798,0.4,803,485,204,689,318,107,425,47,0.06,0.07
T11,200,12-10-2017 09:22:48,1,2106,1577,0.749,0.4,26,20,3,23,6,2,8,0,0.0,0.0
T11,201,12-10-2017 09:42:48,1,2358,1835,0.778,0.4,66,31,4,35,35,4,39,0,0.0,0.0
T11,202,12-10-2017 10:02:48,1,2472,1942,0.786,0.5,225,157,9,166,68,18,86,0,0.0,0.0
T11,203,12-10-2017 10:22:48,1,2278,1846,0.811,0.4,1122,690,276,966,432,135,567,69,0.06,0.05
T11,204,12-10-2017 10:42:48,1,2254,1744,0.774,0.4,13,7,1,8,6,0,6,0,0.0,0.0
T11,205,12-10-2017 11:02:48,1,2297,1772,0.771,0.4,201,124,33,157,77,23,100,0,0.0,0.0
T11,206,12-10-2017 11:22:48,1,2280,1729,0.758,0.4,111,44,9,53,67,12,79,0,0.02,0.0
T11,207,12-10-2017 11:42:48,1,2215,1665,0.752,0.4,85,71,23,94,14,1,15,0,0.0,0.0
T11,208,12-10-2017 12:02:48,1,2911,2368,0.814,0.5,825,447,163,610,378,94,472,33,0.02,0.07
T11,209,12-10-2017 12:22:48,1,2351,1825,0.776,0.4,371,175,58,233,196,41,237,7,0.02,0.0
T11,210,12-10-2017 12:42:48,1,2192,1723,0.786,0.4,187,79,13,92,108,24,132,0,0.0,0.03
T11,211,12-10-2017 13:02:48,1,2161,1725,0.798,0.4,64,55,4,59,9,4,13,0,0.0,0.0
T11,212,12-10-2017 13:22:48,1,2701,2215,0.82,0.5,275,147,30,177,128,21,149,0,0.0,0.0
T11,213,12-10-2017 13:42:48,1,2406,1925,0.8,0.4,612,381,100,481,231,58,289,10,0.0,0.11
T11,214,12-10-2017 14:02:48,1,2942,2390,0.812,0.5,764,445,186,631,319,98,417,21,0.06,-0.03
T11,215,12-10-2017 14:22:48,1,2290,1763,0.77,0.4,72,42,8,50,30,10,40,0,0.02,-0.02
T11,216,12-10-2017 14:42:48,1,2786,2304,0.827,0.5,366,152,28,180,214,25,239,0,0.0,0.0
T11,217,12-10-2017 15:02:48,1,2552,1925,0.754,0.5,269,167,67,234,102,22,124,11,0.0,0.0
T11,218,12-10-2017 15:22:48,1,2092,1572,0.751,0.4,18,10,1,11,8,0,8,0,0.0,0.0
T11,219,12-10-2017 15:42:48,1,2332,1730,0.742,0.4,81,57,15,72,24,0,24,0,0.0,0.0
T11,220,12-10-2017 16:02:48,1,2118,1579,0.745,0.4,243,156,33,189,87,30,117,0,0.0,0.0
T11,221,12-10-2017 16:22:48,1,2445,1943,0.795,0.5,83,47,12,59,36,10,46,0,0.0,0.09
T11,222,12-10-2017 16:42:48,1,2809,2400,0.854,0.5,337,187,21,208,150,28,178,0,0.02,0.0
T11,223,12-10-2017 17:02:48,1,2848,2336,0.82,0.5,1391,800,298,1098,591,133,724,99,0.1,0.07
T11,224,12-10-2017 17:22:48,1,2278,1743,0.765,0.4,176,130,14,144,46,4,50,0,0.0,0.0
T11,225,12-10-2017 17:42:48,1,2110,1611,0.763,0.4,59,53,5,58,6,1,7,0,0.02,0.0
T11,226,12-10-2017 18:02:48,0,3585,3016,0.841,0.7,829,538,270,808,291,110,401,56,0.0,0.08
T11,227,12-10-2017 18:22:48,0,2742,2305,0.841,0.5,1633,999,411,1410,634,206,840,146,0.1,0.04
T11,228,12-10-2017 18:42:48,0,3380,2821,0.835,0.6,1027,559,101,660,468,84,552,20,0.0,0.0
T11,229,12-10-2017 19:02:48,0,3480,2936,0.844,0.7,3162,1872,957,2829,1290,588,1878,405,0.0,0.65
T11,230,12-10-2017 19:22:48,0,3374,2648,0.785,0.6,3292,1951,1160,3111,1341,627,1968,542,0.02,0.03
T11,231,12-10-2017 19:42:48,0,2516,1872,0.744,0.5,739,434,107,541,305,48,353,6,0.04,0.0
T11,232,12-10-2017 20:02:48,0,2539,1862,0.734,0.5,298,170,56,226,128,56,184,0,0.02,0.0
T11,233,12-10-2017 20:22:48,0,3068,2371,0.773,0.6,2086,1145,496,1641,941,273,1214,128,0.04,0.0
T11,234,12-10-2017 20:42:48,0,3324,2548,0.767,0.6,2771,1603,814,2417,1168,499,1667,535,0.08,0.0
T11,235,12-10-2017 21:02:48,0,2583,1943,0.752,0.5,1621,892,409,1301,729,225,954,111,0.02,-0.03
T11,236,12-10-2017 21:22:48,0,2738,2041,0.745,0.5,58,44,14,58,14,0,14,0,0.0,0.0
T11,237,12-10-2017 21:42:48,0,2559,1963,0.767,0.5,335,211,49,260,124,40,164,0,0.0,0.0
T11,238,12-10-2017 22:02:48,0,2413,1758,0.728,0.4,610,270,47,317,340,37,377,0,0.0,0.0
T11,239,12-10-2017 22:22:48,0,2857,2154,0.754,0.5,946,543,158,701,403,92,495,3,0.0,0.0
T11,240,12-10-2017 22:42:48,0,2713,2064,0.761,0.5,362,224,91,315,138,44,182,21,0.02,-0.02
T11,241,12-10-2017 23:02:48,0,2491,1835,0.737,0.5,274,172,45,217,102,22,124,0,0.0,0.0
T11,242,12-10-2017 23:22:48,0,3030,2345,0.774,0.6,801,442,159,601,359,122,481,20,0.0,0.0
T11,243,12-10-2017 23:42:48,0,3296,2438,0.74,0.6,3359,1979,1231,3210,1380,712,2092,937,0.06,-0.03
T11,244,13-10-2017 00:02:48,0,2793,2084,0.746,0.5,1723,988,451,1439,735,223,958,68,0.0,-0.02
T11,245,13-10-2017 00:22:48,0,2205,1597,0.724,0.4,61,35,7,42,26,4,30,0,0.0,0.0
T11,246,13-10-2017 00:42:48,0,2607,1913,0.734,0.5,24,21,4,25,3,0,3,0,0.0,0.0
T11,247,13-10-2017 01:02:48,0,2546,1896,0.745,0.5,550,274,68,342,276,60,336,3,0.0,0.0
T11,248,13-10-2017 01:22:48,0,2747,2019,0.735,0.5,243,159,72,231,84,28,112,0,0.0,0.0
T11,249,13-10-2017 01:42:48,0,2659,1914,0.72,0.5,121,67,27,94,54,6,60,0,0.0,0.0
T11,250,13-10-2017 02:02:48,0,2641,1921,0.727,0.5,428,261,81,342,167,55,222,0,0.0,0.0
T11,251,13-10-2017 02:22:48,0,2416,1767,0.731,0.4,218,130,35,165,88,12,100,0,0.0,0.0
T11,252,13-10-2017 02:42:48,0,2841,2172,0.765,0.5,377,189,41,230,188,19,207,0,0.02,0.0
T11,253,13-10-2017 03:02:48,0,3201,2309,0.721,0.6,3610,2185,1438,3623,1425,718,2143,652,0.06,0.0
T11,254,13-10-2017 03:22:48,0,2835,2075,0.732,0.5,2092,1238,657,1895,854,313,1167,206,0.0,-0.03
T11,255,13-10-2017 03:42:48,0,2683,1911,0.712,0.5,303,150,24,174,153,14,167,0,0.0,0.0
T11,256,13-10-2017 04:02:48,0,2589,1891,0.731,0.5,129,67,17,84,62,4,66,0,0.0,0.0
T11,257,13-10-2017 04:22:48,0,2381,1718,0.722,0.4,930,513,177,690,417,98,515,41,0.08,0.0
T11,258,13-10-2017 04:42:48,0,3605,2643,0.733,0.7,1952,1158,713,1871,794,360,1154,464,0.0,0.0
T11,259,13-10-2017 05:02:48,0,3098,2232,0.72,0.6,3010,1639,966,2605,1371,591,1962,675,0.08,-0.02
T11,260,13-10-2017 05:22:48,0,2830,2024,0.715,0.5,1575,867,283,1150,708,166,874,22,0.02,0.0
T11,261,13-10-2017 05:42:48,0,2523,1807,0.716,0.5,184,84,14,98,100,10,110,0,0.0,0.0
T11,262,13-10-2017 06:02:48,1,2177,1575,0.723,0.4,18,5,1,6,13,0,13,0,0.0,0.0
T11,263,13-10-2017 06:22:48,1,3302,2482,0.752,0.6,1179,751,388,1139,428,174,602,319,0.04,0.0
T11,264,13-10-2017 06:42:48,1,2369,1703,0.719,0.4,1997,1224,644,1868,773,325,1098,178,0.04,0.0
T11,265,13-10-2017 07:02:48,1,2196,1548,0.705,0.4,13,10,3,13,3,0,3,0,0.0,0.0
T11,266,13-10-2017 07:22:48,1,3324,2428,0.73,0.6,506,355,109,464,151,49,200,15,0.0,0.22
T11,267,13-10-2017 07:42:48,1,2304,1793,0.778,0.4,388,262,53,315,126,22,148,2,0.04,0.03
T11,268,13-10-2017 08:02:48,1,2317,1789,0.772,0.4,66,49,16,65,17,3,20,0,0.06,-0.03
T11,269,13-10-2017 08:22:48,1,2124,1651,0.777,0.4,47,38,16,54,9,3,12,0,0.0,0.0
T11,270,13-10-2017 08:42:48,1,2883,2263,0.785,0.5,248,127,37,164,121,5,126,0,0.02,0.0
T11,271,13-10-2017 09:02:48,1,2086,1656,0.794,0.4,547,342,135,477,205,57,262,64,0.04,0.13
T11,272,13-10-2017 09:22:48,1,2480,1930,0.778,0.5,57,37,7,44,20,0,20,0,0.0,0.0
T11,273,13-10-2017 09:42:48,1,2257,1771,0.785,0.4,86,46,20,66,40,12,52,0,0.0,0.0
T11,274,13-10-2017 10:02:48,1,2277,1804,0.792,0.4,382,158,35,193,224,40,264,3,0.1,0.15
T11,275,13-10-2017 10:22:48,1,2146,1701,0.792,0.4,53,28,2,30,25,5,30,0,0.0,0.0
T11,276,13-10-2017 10:42:48,1,2348,1848,0.787,0.4,59,34,4,38,25,4,29,0,0.0,0.0
T11,277,13-10-2017 11:02:48,1,2396,1838,0.767,0.4,95,57,26,83,38,12,50,0,0.0,0.0
T11,278,13-10-2017 11:22:48,1,2175,1730,0.796,0.4,99,83,5,88,16,0,16,0,0.0,0.0
T11,279,13-10-2017 11:42:48,1,3317,2674,0.806,0.6,2119,1291,774,2065,828,366,1194,234,0.16,0.09
T11,280,13-10-2017 12:02:48,1,2453,2015,0.822,0.5,1522,940,440,1380,582,211,793,48,0.0,0.0
T11,281,13-10-2017 12:22:48,1,2332,1771,0.759,0.4,28,20,2,22,8,1,9,0,0.0,0.0
T11,282,13-10-2017 12:42:48,1,2304,1754,0.761,0.4,228,185,18,203,43,11,54,0,0.02,0.0
T11,283,13-10-2017 13:02:48,1,2216,1711,0.772,0.4,71,48,15,63,23,0,23,0,0.0,0.0
T11,284,13-10-2017 13:22:48,1,2598,2066,0.795,0.5,195,129,41,170,66,22,88,0,0.0,0.07
T11,285,13-10-2017 13:42:48,1,2524,2082,0.825,0.5,918,481,132,613,437,70,507,14,0.04,0.06
T11,286,13-10-2017 14:02:48,1,2406,1881,0.782,0.4,51,25,2,27,26,11,37,0,0.04,0.0
T13,1,09-10-2017 15:06:48,1,2844,2222,0.782,0.5,558,309,24,333,249,28,277,1,0.0,0.0
T13,2,09-10-2017 15:26:48,1,2156,1550,0.719,0.4,98,40,8,48,58,13,71,4,0.0,0.0
T13,3,09-10-2017 15:46:48,1,2883,2249,0.78,0.5,537,311,105,416,226,84,310,47,0.0,0.0
T13,4,09-10-2017 16:06:48,1,3213,2458,0.765,0.6,3956,2351,1486,3837,1605,920,2525,548,0.0,0.07
T13,5,09-10-2017 16:26:48,1,2522,1896,0.752,0.4,1887,995,568,1563,892,344,1236,370,0.0,0.0
T13,6,09-10-2017 16:46:48,1,2144,1553,0.724,0.4,122,77,49,126,45,21,66,7,0.0,0.0
T13,7,09-10-2017 17:06:48,1,2083,1517,0.728,0.4,73,43,9,52,30,13,43,3,0.0,0.02
T13,8,09-10-2017 17:26:48,1,2726,2059,0.755,0.5,533,363,141,504,170,82,252,15,0.0,0.04
T13,9,09-10-2017 17:46:48,1,2319,1741,0.751,0.4,494,301,104,405,193,58,251,16,0.0,0.02
T13,10,09-10-2017 18:06:48,0,2379,1776,0.747,0.4,431,213,122,335,218,84,302,16,0.0,0.0
T13,11,09-10-2017 18:26:48,0,2479,1845,0.744,0.4,320,195,125,320,125,52,177,11,0.0,0.06
T13,12,09-10-2017 18:46:48,0,3527,2898,0.822,0.6,4071,2451,1650,4101,1620,896,2516,942,0.0,0.09
T13,13,09-10-2017 19:06:48,0,3522,2765,0.785,0.6,6067,3677,2777,6454,2390,1437,3827,1597,0.0,0.0
T13,14,09-10-2017 19:26:48,0,3190,2452,0.769,0.6,3572,2128,1366,3494,1444,806,2250,808,0.0,0.0
T13,15,09-10-2017 19:46:48,0,2906,2279,0.784,0.5,3129,1756,1036,2792,1373,585,1958,377,0.0,-0.02
T13,16,09-10-2017 20:06:48,0,2446,1817,0.743,0.4,1732,912,474,1386,820,270,1090,121,0.0,0.0
T13,17,09-10-2017 20:26:48,0,3336,2516,0.754,0.6,1691,973,670,1643,718,375,1093,457,0.06,0.1
T13,18,09-10-2017 20:46:48,0,2604,2046,0.786,0.5,1162,568,218,786,594,190,784,108,0.0,0.06
T13,19,09-10-2017 21:06:48,0,2246,1734,0.772,0.4,139,71,34,105,68,31,99,4,0.04,0.02
T13,20,09-10-2017 21:26:48,0,2238,1762,0.787,0.4,845,517,260,777,328,135,463,61,0.0,0.11
T13,21,09-10-2017 21:46:48,0,2156,1708,0.792,0.4,171,83,38,121,88,20,108,7,0.04,0.0
T13,22,09-10-2017 22:06:48,0,2227,1704,0.765,0.4,73,49,7,56,24,9,33,0,0.0,0.07
T13,23,09-10-2017 22:26:48,0,2410,1913,0.794,0.4,912,465,97,562,447,94,541,35,0.0,0.05
T13,24,09-10-2017 22:46:48,0,2201,1688,0.767,0.4,99,63,39,102,36,15,51,0,0.02,0.0
T13,25,09-10-2017 23:06:48,0,2329,1849,0.794,0.4,440,223,85,308,217,93,310,17,0.0,0.18
T13,26,09-10-2017 23:26:48,0,2382,1844,0.774,0.4,248,73,33,106,175,33,208,2,0.06,0.0
T13,27,09-10-2017 23:46:48,0,2454,1863,0.759,0.4,87,44,13,57,43,20,63,0,0.0,0.0
T13,28,10-10-2017 00:06:48,0,2870,2425,0.845,0.5,886,461,58,519,425,72,497,0,0.0,0.11
T13,29,10-10-2017 00:26:48,0,2249,1761,0.783,0.4,207,79,46,125,128,39,167,30,0.08,0.0
T13,30,10-10-2017 00:46:48,0,2303,1798,0.781,0.4,69,46,6,52,23,6,29,0,0.0,0.03
T13,31,10-10-2017 01:06:48,0,3653,3059,0.837,0.7,1639,825,508,1333,814,448,1262,211,0.02,0.11
T13,32,10-10-2017 01:26:48,0,3356,2714,0.809,0.6,4492,2515,1767,4282,1977,1123,3100,1491,0.02,0.0
T13,33,10-10-2017 01:46:48,0,2902,2344,0.808,0.5,3366,1823,1139,2962,1543,742,2285,929,0.0,0.0
T13,34,10-10-2017 02:06:48,0,2394,1786,0.746,0.4,509,191,33,224,318,39,357,0,0.02,0.0
T13,35,10-10-2017 02:26:48,0,2752,2178,0.791,0.5,506,278,134,412,228,92,320,60,0.0,0.07
T13,36,10-10-2017 02:46:48,0,2253,1779,0.79,0.4,78,40,11,51,38,8,46,0,0.0,0.0
T13,37,10-10-2017 03:06:48,0,2391,1840,0.77,0.4,921,451,117,568,470,91,561,44,0.08,0.03
T13,38,10-10-2017 03:26:48,0,2232,1662,0.745,0.4,131,56,5,61,75,20,95,0,0.0,0.0
T13,39,10-10-2017 03:46:48,0,2230,1722,0.772,0.4,132,47,14,61,85,22,107,0,0.0,0.0
T13,40,10-10-2017 04:06:48,0,2246,1816,0.809,0.4,386,201,96,297,185,66,251,30,0.0,0.15
T13,41,10-10-2017 04:26:48,0,3253,2673,0.822,0.6,1337,688,323,1011,649,234,883,243,0.0,0.0
T13,42,10-10-2017 04:46:48,0,3094,2519,0.814,0.6,3716,1937,1272,3209,1779,968,2747,1069,0.0,0.03
T13,43,10-10-2017 05:06:48,0,2276,1718,0.755,0.4,712,305,29,334,407,80,487,17,0.0,0.0
T13,44,10-10-2017 05:26:48,0,3299,2587,0.784,0.6,1618,901,511,1412,717,346,1063,280,0.08,0.13
T13,45,10-10-2017 05:46:48,0,2304,1756,0.762,0.4,600,248,55,303,352,120,472,9,0.0,0.0
T13,46,10-10-2017 06:06:48,1,2303,1777,0.772,0.4,138,63,15,78,75,30,105,9,0.0,0.0
T13,47,10-10-2017 06:26:48,1,2336,1754,0.751,0.4,81,23,8,31,58,25,83,2,0.0,0.03
T13,48,10-10-2017 06:46:48,1,2312,1845,0.798,0.4,180,70,19,89,110,34,144,3,0.02,0.11
T13,49,10-10-2017 07:06:48,1,2387,1924,0.806,0.4,767,300,49,349,467,55,522,0,0.0,0.0
T13,50,10-10-2017 07:26:48,1,1909,1480,0.775,0.3,79,25,7,32,54,19,73,0,0.0,0.0
T13,51,10-10-2017 07:46:48,1,2168,1668,0.77,0.4,162,83,32,115,79,25,104,8,0.06,0.0
T13,52,10-10-2017 08:06:48,1,2249,1853,0.824,0.4,807,382,120,502,425,141,566,23,0.02,0.01
T13,53,10-10-2017 08:26:48,1,2142,1695,0.791,0.4,96,62,16,78,34,10,44,0,0.0,0.11
T13,54,10-10-2017 08:46:48,1,2099,1684,0.802,0.4,98,49,2,51,49,14,63,0,0.0,0.0
T13,55,10-10-2017 09:06:48,1,2639,2217,0.84,0.5,560,234,11,245,326,65,391,0,0.0,0.0
T13,56,10-10-2017 09:26:48,1,2225,1700,0.764,0.4,226,116,19,135,110,18,128,0,0.0,0.0
T13,57,10-10-2017 09:46:48,1,2396,1937,0.808,0.4,242,104,25,129,138,59,197,15,0.0,0.16
T13,58,10-10-2017 10:06:48,1,2325,1852,0.797,0.4,561,300,104,404,261,79,340,28,0.04,0.0
T13,59,10-10-2017 10:26:48,1,2181,1757,0.806,0.4,148,63,8,71,85,18,103,0,0.0,0.0
T13,60,10-10-2017 10:46:48,1,2093,1683,0.804,0.4,172,75,8,83,97,29,126,0,0.0,0.0
T13,61,10-10-2017 11:06:48,1,2606,2178,0.836,0.5,395,203,18,221,192,53,245,0,0.0,0.09
T13,62,10-10-2017 11:26:48,1,2212,1742,0.787,0.4,710,411,55,466,299,67,366,17,0.08,0.0
T13,63,10-10-2017 11:46:48,1,2128,1684,0.791,0.4,61,26,5,31,35,17,52,0,0.0,0.0
T13,64,10-10-2017 12:06:48,1,2528,2085,0.825,0.5,281,106,13,119,175,31,206,0,0.0,0.08
T13,65,10-10-2017 12:26:48,1,2263,1828,0.808,0.4,386,208,4,212,178,25,203,0,0.0,0.0
T13,66,10-10-2017 12:46:48,1,2212,1745,0.789,0.4,111,58,13,71,53,20,73,0,0.02,0.0
T13,67,10-10-2017 13:06:48,1,2050,1625,0.793,0.4,117,75,12,87,42,19,61,0,0.0,0.0
T13,68,10-10-2017 13:26:48,1,3431,2856,0.832,0.6,1227,637,350,987,590,239,829,221,0.04,0.03
T13,69,10-10-2017 13:46:48,1,3602,2959,0.822,0.6,2849,1526,903,2429,1323,706,2029,417,0.06,0.02
T13,70,10-10-2017 14:06:48,1,2341,1847,0.789,0.4,983,462,145,607,521,152,673,14,0.0,0.0
T13,71,10-10-2017 14:26:48,1,2186,1660,0.759,0.4,117,52,16,68,65,22,87,0,0.0,0.0
T13,72,10-10-2017 14:46:48,1,2383,1834,0.769,0.4,129,79,34,113,50,17,67,0,0.0,0.03
T13,73,10-10-2017 15:06:48,1,2298,1753,0.763,0.4,584,278,25,303,306,46,352,0,0.0,0.0
T13,74,10-10-2017 15:26:48,1,2137,1635,0.765,0.4,74,22,4,26,52,23,75,0,0.02,0.0
T13,75,10-10-2017 15:46:48,1,2289,1749,0.764,0.4,91,24,7,31,67,27,94,0,0.0,0.0
T13,76,10-10-2017 16:06:48,1,2361,1969,0.834,0.4,242,126,14,140,116,41,157,0,0.0,0.18
T13,77,10-10-2017 16:26:48,1,2240,1830,0.817,0.4,112,50,19,69,62,23,85,0,0.0,0.0
T13,78,10-10-2017 16:46:48,1,2231,1782,0.799,0.4,125,71,30,101,54,36,90,0,0.0,0.14
T13,79,10-10-2017 17:06:48,1,2236,1775,0.794,0.4,888,361,104,465,527,89,616,18,0.0,0.0
T13,80,10-10-2017 17:26:48,1,2235,1769,0.791,0.4,61,43,2,45,18,6,24,0,0.0,0.0
T13,81,10-10-2017 17:46:48,1,2797,2376,0.85,0.5,791,221,21,242,570,147,717,0,0.02,0.0
T13,82,10-10-2017 18:06:48,0,3029,2443,0.807,0.5,1455,746,383,1129,709,212,921,82,0.04,0.05
T13,83,10-10-2017 18:26:48,0,2697,2124,0.788,0.5,1063,487,96,583,576,170,746,55,0.0,0.0
T13,84,10-10-2017 18:46:48,0,2948,2320,0.787,0.5,672,367,119,486,305,103,408,14,0.08,0.05
T13,85,10-10-2017 19:06:48,0,3498,2805,0.802,0.6,4807,2667,1793,4460,2140,1176,3316,1292,0.0,0.0
T13,86,10-10-2017 19:26:48,0,3396,2691,0.792,0.6,4701,2520,1594,4114,2181,1226,3407,1052,0.0,0.08
T13,87,10-10-2017 19:46:48,0,3333,2645,0.794,0.6,5242,2812,1856,4668,2430,1337,3767,1258,0.0,0.0
T13,88,10-10-2017 20:06:48,0,3651,2832,0.776,0.6,3354,1695,938,2633,1659,792,2451,835,0.0,0.0
T13,89,10-10-2017 20:26:48,0,3115,2412,0.774,0.6,3975,2001,1163,3164,1974,951,2925,894,0.0,0.0
T13,90,10-10-2017 20:46:48,0,2830,2109,0.745,0.5,1320,523,82,605,797,213,1010,4,0.0,0.0
T13,91,10-10-2017 21:06:48,0,2351,1754,0.746,0.4,417,240,100,340,177,67,244,10,0.02,0.03
T13,92,10-10-2017 21:26:48,0,3410,2718,0.797,0.6,2412,1222,711,1933,1190,597,1787,596,0.04,0.17
T13,93,10-10-2017 21:46:48,0,2708,2170,0.801,0.5,1524,592,45,637,932,166,1098,12,0.0,0.0
T13,94,10-10-2017 22:06:48,0,2320,1747,0.753,0.4,136,46,8,54,90,33,123,0,0.0,0.0
T13,95,10-10-2017 22:26:48,0,2672,2083,0.78,0.5,394,185,70,255,209,68,277,16,0.02,0.09
T13,96,10-10-2017 22:46:48,0,2808,2186,0.779,0.5,1396,688,232,920,708,217,925,82,0.06,-0.03
T13,97,10-10-2017 23:06:48,0,2874,2165,0.753,0.5,247,80,9,89,167,14,181,0,0.0,0.0
T13,98,10-10-2017 23:26:48,0,2725,2049,0.752,0.5,239,110,26,136,129,53,182,0,0.0,0.03
T13,99,10-10-2017 23:46:48,0,2308,1802,0.781,0.4,1267,635,149,784,632,126,758,12,0.02,0.09
T13,100,11-10-2017 00:06:48,0,2514,1881,0.748,0.4,175,85,33,118,90,19,109,5,0.06,0.0
T13,101,11-10-2017 00:26:48,0,2831,2308,0.815,0.5,870,404,169,573,466,146,612,57,0.0,0.09
T13,102,11-10-2017 00:46:48,0,2790,2179,0.781,0.5,617,255,50,305,362,66,428,0,0.0,0.03
T13,103,11-10-2017 01:06:48,0,2458,1856,0.755,0.4,229,107,28,135,122,47,169,0,0.02,0.0
T13,104,11-10-2017 01:26:48,0,2538,1974,0.778,0.4,171,78,20,98,93,51,144,1,0.0,0.12
T13,105,11-10-2017 01:46:48,0,2724,2153,0.79,0.5,735,330,52,382,405,90,495,13,0.08,0.05
T13,106,11-10-2017 02:06:48,0,2405,1867,0.776,0.4,2127,1009,569,1578,1118,552,1670,424,0.02,0.0
T13,107,11-10-2017 02:26:48,0,2428,1839,0.757,0.4,160,70,37,107,90,43,133,5,0.06,0.0
T13,108,11-10-2017 02:46:48,0,2652,2143,0.808,0.5,500,148,15,163,352,40,392,0,0.0,0.0
T13,109,11-10-2017 03:06:48,0,2560,2018,0.788,0.5,2348,1197,681,1878,1151,591,1742,586,0.0,0.07
T13,110,11-10-2017 03:26:48,0,2574,1953,0.759,0.5,153,70,13,83,83,27,110,0,0.0,0.0
T13,111,11-10-2017 03:46:48,0,2876,2285,0.794,0.5,598,303,66,369,295,96,391,1,0.0,0.0
T13,112,11-10-2017 04:06:48,0,3130,2483,0.793,0.6,1207,645,304,949,562,227,789,158,0.0,0.19
T13,113,11-10-2017 04:26:48,0,2759,2168,0.786,0.5,498,274,96,370,224,101,325,16,0.0,0.0
T13,114,11-10-2017 04:46:48,0,2325,1829,0.787,0.4,1136,501,212,713,635,220,855,91,0.1,-0.02
T13,115,11-10-2017 05:06:48,0,2289,1847,0.807,0.4,124,49,17,66,75,33,108,0,0.0,0.06
T13,116,11-10-2017 05:26:48,0,2906,2336,0.804,0.5,1637,773,305,1078,864,274,1138,96,0.02,0.05
T13,117,11-10-2017 05:46:48,0,2586,2049,0.792,0.5,854,402,127,529,452,120,572,17,0.0,0.0
T13,118,11-10-2017 06:06:48,1,2459,1920,0.781,0.4,753,412,240,652,341,178,519,115,0.04,0.0
T13,119,11-10-2017 06:26:48,1,2496,1881,0.753,0.4,386,122,17,139,264,50,314,0,0.0,0.0
T13,120,11-10-2017 06:46:48,1,2217,1675,0.756,0.4,79,37,6,43,42,14,56,0,0.0,0.0
T13,121,11-10-2017 07:06:48,1,1968,1583,0.805,0.4,530,282,108,390,248,90,338,15,0.02,0.14
T13,122,11-10-2017 07:26:48,1,2245,1818,0.81,0.4,53,35,16,51,18,0,18,0,0.0,0.0
T13,123,11-10-2017 07:46:48,1,2337,1921,0.822,0.4,184,84,27,111,100,34,134,0,0.0,0.0
T13,124,11-10-2017 08:06:48,1,2303,1879,0.816,0.4,823,313,137,450,510,142,652,21,0.08,0.11
T13,125,11-10-2017 08:26:48,1,2296,1804,0.786,0.4,30,9,0,9,21,6,27,0,0.0,0.0
T13,126,11-10-2017 08:46:48,1,2276,1835,0.806,0.4,210,84,24,108,126,58,184,0,0.0,0.11
T13,127,11-10-2017 09:06:48,1,2298,1916,0.834,0.4,133,80,10,90,53,6,59,0,0.0,0.0
T13,128,11-10-2017 09:26:48,1,2595,2201,0.848,0.5,511,167,56,223,344,76,420,3,0.06,0.0
T13,129,11-10-2017 09:46:48,1,2306,1829,0.793,0.4,182,53,14,67,129,22,151,0,0.0,0.0
T13,130,11-10-2017 10:06:48,1,2197,1789,0.814,0.4,124,50,4,54,74,19,93,0,0.0,0.06
T13,131,11-10-2017 10:26:48,1,2120,1755,0.828,0.4,60,38,10,48,22,2,24,0,0.0,0.0
T13,132,11-10-2017 10:46:48,1,2804,2388,0.852,0.5,1356,624,295,919,732,299,1031,99,0.06,0.06
T13,133,11-10-2017 11:06:48,1,2344,1853,0.791,0.4,457,215,30,245,242,31,273,0,0.0,-0.03
T13,134,11-10-2017 11:26:48,1,2462,1905,0.774,0.4,107,66,34,100,41,15,56,3,0.0,0.0
T13,135,11-10-2017 11:46:48,1,2395,1849,0.772,0.4,188,89,44,133,99,30,129,6,0.0,0.0
T13,136,11-10-2017 12:06:48,1,2431,1881,0.774,0.4,1341,566,192,758,775,219,994,21,0.06,0.07
T13,137,11-10-2017 12:26:48,1,2246,1747,0.778,0.4,61,38,2,40,23,6,29,0,0.0,0.03
T13,138,11-10-2017 12:46:48,1,2100,1641,0.781,0.4,100,21,3,24,79,35,114,0,0.0,0.0
T13,139,11-10-2017 13:06:48,1,2740,2257,0.823,0.5,838,428,93,521,410,118,528,7,0.0,0.08
T13,140,11-10-2017 13:26:48,1,2323,1823,0.785,0.4,339,137,15,152,202,34,236,0,0.02,0.0
T13,141,11-10-2017 13:46:48,1,2090,1653,0.791,0.4,82,28,5,33,54,19,73,0,0.0,0.0
T13,142,11-10-2017 14:06:48,1,2596,2103,0.81,0.5,438,199,54,253,239,77,316,3,0.06,0.08
T13,143,11-10-2017 14:26:48,1,2593,2067,0.797,0.5,685,326,67,393,359,100,459,3,0.0,0.0
T13,144,11-10-2017 14:46:48,1,2553,2164,0.847,0.5,383,170,33,203,213,51,264,0,0.0,0.0
T13,145,11-10-2017 15:06:48,1,2237,1702,0.761,0.4,173,55,8,63,118,24,142,0,0.02,0.0
T13,146,11-10-2017 15:26:48,1,2381,1931,0.811,0.4,428,219,28,247,209,49,258,0,0.0,0.09
T13,147,11-10-2017 15:46:48,1,2366,1854,0.783,0.4,128,55,27,82,73,47,120,3,0.0,0.0
T13,148,11-10-2017 16:06:48,1,3104,2594,0.836,0.6,1350,681,408,1089,669,297,966,187,0.02,0.11
T13,149,11-10-2017 16:26:48,1,2899,2375,0.819,0.5,3104,1565,872,2437,1539,732,2271,641,0.04,0.05
T13,150,11-10-2017 16:46:48,1,2606,2019,0.775,0.5,649,340,52,392,309,61,370,0,0.0,0.0
T13,151,11-10-2017 17:06:48,1,2288,1849,0.808,0.4,217,114,29,143,103,41,144,0,0.0,0.1
T13,152,11-10-2017 17:26:48,1,3025,2430,0.803,0.5,1377,732,384,1116,645,311,956,42,0.04,-0.03
T13,153,11-10-2017 17:46:48,1,2426,1975,0.814,0.4,742,343,32,375,399,96,495,0,0.0,0.08
T13,154,11-10-2017 18:06:48,0,2602,2029,0.78,0.5,668,316,69,385,352,76,428,0,0.06,0.03
T13,155,11-10-2017 18:26:48,0,2431,1897,0.78,0.4,721,276,31,307,445,99,544,0,0.02,0.0
T13,156,11-10-2017 18:46:48,0,3436,2761,0.803,0.6,1448,778,303,1081,670,266,936,120,0.0,0.08
T13,157,11-10-2017 19:06:48,0,2712,2200,0.812,0.5,2531,1267,666,1933,1264,673,1937,414,0.0,0.11
T13,158,11-10-2017 19:26:48,0,2418,1927,0.797,0.4,378,214,98,312,164,76,240,20,0.02,0.04
T13,159,11-10-2017 19:46:48,0,2510,1952,0.777,0.4,340,156,58,214,184,76,260,10,0.02,0.0
T13,160,11-10-2017 20:06:48,0,2555,1944,0.761,0.5,1051,375,60,435,676,103,779,0,0.0,0.0
T13,161,11-10-2017 20:26:48,0,3126,2543,0.813,0.6,1035,495,255,750,540,284,824,100,0.0,0.14
T13,162,11-10-2017 20:46:48,0,3203,2681,0.837,0.6,3496,1699,1014,2713,1797,1012,2809,1194,0.12,0.09
T13,163,11-10-2017 21:06:48,0,2621,2092,0.798,0.5,890,385,78,463,505,119,624,19,0.0,0.03
T13,164,11-10-2017 21:26:48,0,2511,1958,0.78,0.4,210,100,62,162,110,56,166,7,0.04,0.0
T13,165,11-10-2017 21:46:48,0,3164,2554,0.807,0.6,2048,1079,566,1645,969,488,1457,305,0.02,0.06
T13,166,11-10-2017 22:06:48,0,2572,1988,0.773,0.5,481,177,35,212,304,28,332,0,0.0,0.0
T13,167,11-10-2017 22:26:48,0,2362,1810,0.766,0.4,201,74,32,106,127,36,163,5,0.04,0.0
T13,168,11-10-2017 22:46:48,0,2778,2280,0.821,0.5,791,331,43,374,460,92,552,0,0.0,0.03
T13,169,11-10-2017 23:06:48,0,2757,2108,0.765,0.5,434,209,51,260,225,63,288,0,0.02,0.16
T13,170,11-10-2017 23:26:48,0,2757,2173,0.788,0.5,281,130,32,162,151,44,195,1,0.0,0.0
T13,171,11-10-2017 23:46:48,0,2609,2036,0.78,0.5,595,245,44,289,350,61,411,2,0.04,0.0
T13,172,12-10-2017 00:06:48,0,2940,2318,0.789,0.5,692,299,54,353,393,108,501,2,0.0,0.0
T13,173,12-10-2017 00:26:48,0,3221,2629,0.816,0.6,3448,1744,1014,2758,1704,948,2652,886,0.06,0.09
T13,174,12-10-2017 00:46:48,0,2548,1984,0.779,0.5,267,137,40,177,130,44,174,2,0.0,0.0
T13,175,12-10-2017 01:06:48,0,2661,2051,0.771,0.5,326,122,36,158,204,54,258,0,0.0,0.0
T13,176,12-10-2017 01:26:48,0,2839,2238,0.788,0.5,529,254,64,318,275,90,365,0,0.06,0.0
T13,177,12-10-2017 01:46:48,0,2750,2053,0.747,0.5,656,311,28,339,345,61,406,0,0.0,0.0
T13,178,12-10-2017 02:06:48,0,2770,2210,0.798,0.5,384,188,69,257,196,94,290,8,0.04,0.18
T13,179,12-10-2017 02:26:48,0,2494,1956,0.784,0.4,152,60,25,85,92,48,140,0,0.0,0.0
T13,180,12-10-2017 02:46:48,0,2865,2313,0.807,0.5,1672,817,387,1204,855,358,1213,96,0.02,0.07
T13,181,12-10-2017 03:06:48,0,2383,1885,0.791,0.4,450,247,89,336,203,67,270,25,0.0,0.0
T13,182,12-10-2017 03:26:48,0,2516,1945,0.773,0.4,165,87,38,125,78,24,102,1,0.04,0.0
T13,183,12-10-2017 03:46:48,0,3197,2622,0.82,0.6,1347,615,298,913,732,284,1016,179,0.0,0.1
T13,184,12-10-2017 04:06:48,0,2844,2378,0.836,0.5,2836,1433,776,2209,1403,661,2064,756,0.06,0.03
T13,185,12-10-2017 04:26:48,0,2890,2307,0.798,0.5,412,233,71,304,179,50,229,0,0.08,0.0
T13,186,12-10-2017 04:46:48,0,2553,1987,0.778,0.5,273,109,29,138,164,77,241,0,0.0,0.0
T13,187,12-10-2017 05:06:48,0,3332,2723,0.817,0.6,3018,1558,922,2480,1460,732,2192,785,0.0,0.15
T13,188,12-10-2017 05:26:48,0,2870,2350,0.819,0.5,2786,1359,675,2034,1427,615,2042,429,0.08,0.03
T13,189,12-10-2017 05:46:48,0,2455,1873,0.763,0.4,357,208,21,229,149,36,185,0,0.0,0.0
T13,190,12-10-2017 06:06:48,1,2120,1667,0.786,0.4,275,130,24,154,145,61,206,3,0.0,0.11
T13,191,12-10-2017 06:26:48,1,2022,1639,0.81,0.4,60,20,4,24,40,14,54,0,0.0,0.0
T13,192,12-10-2017 06:46:48,1,2081,1655,0.795,0.4,115,64,13,77,51,11,62,0,0.0,0.0
T13,193,12-10-2017 07:06:48,1,2624,2259,0.861,0.5,675,312,103,415,363,97,460,35,0.02,0.07
T13,194,12-10-2017 07:26:48,1,2213,1738,0.786,0.4,399,195,106,301,204,84,288,34,0.02,0.0
T13,195,12-10-2017 07:46:48,1,2102,1664,0.791,0.4,180,87,18,105,93,35,128,0,0.0,0.0
T13,196,12-10-2017 08:06:48,1,2460,2043,0.831,0.4,617,194,14,208,423,64,487,0,0.0,0.08
T13,197,12-10-2017 08:26:48,1,2097,1668,0.796,0.4,237,98,30,128,139,30,169,9,0.08,0.0
T13,198,12-10-2017 08:46:48,1,2061,1621,0.787,0.4,94,32,7,39,62,24,86,0,0.0,0.09
T13,199,12-10-2017 09:06:48,1,2264,1862,0.822,0.4,37,8,3,11,29,12,41,0,0.0,0.0
T13,200,12-10-2017 09:26:48,1,2445,2127,0.87,0.4,676,278,25,303,398,87,485,0,0.0,0.11
T13,201,12-10-2017 09:46:48,1,2393,1945,0.813,0.4,156,64,33,97,92,35,127,0,0.06,0.0
T13,202,12-10-2017 10:06:48,1,2107,1665,0.79,0.4,52,27,5,32,25,11,36,0,0.0,0.0
T13,203,12-10-2017 10:26:48,1,2515,2128,0.846,0.5,721,342,90,432,379,84,463,10,0.0,0.0
T13,204,12-10-2017 10:46:48,1,2370,1813,0.765,0.4,202,105,13,118,97,9,106,0,0.0,0.0
T13,205,12-10-2017 11:06:48,1,2256,1749,0.775,0.4,138,68,6,74,70,30,100,0,0.02,0.0
T13,206,12-10-2017 11:26:48,1,2539,2131,0.839,0.5,614,213,31,244,401,66,467,0,0.0,0.05
T13,207,12-10-2017 11:46:48,1,2281,1894,0.83,0.4,1542,776,439,1215,766,348,1114,126,0.04,0.05
T13,208,12-10-2017 12:06:48,1,2086,1642,0.787,0.4,31,8,2,10,23,7,30,0,0.0,0.0
T13,209,12-10-2017 12:26:48,1,2009,1569,0.781,0.4,96,35,2,37,61,10,71,0,0.02,0.0
T13,210,12-10-2017 12:46:48,1,2567,2125,0.828,0.5,532,177,14,191,355,84,439,0,0.0,0.0
T13,211,12-10-2017 13:06:48,1,2115,1597,0.755,0.4,182,60,11,71,122,28,150,0,0.0,0.0
T13,212,12-10-2017 13:26:48,1,2193,1748,0.797,0.4,302,151,23,174,151,53,204,0,0.0,0.13
T13,213,12-10-2017 13:46:48,1,2347,1895,0.808,0.4,159,68,30,98,91,41,132,0,0.0,0.0
T13,214,12-10-2017 14:06:48,1,2622,2122,0.809,0.5,1591,766,447,1213,825,362,1187,135,0.02,-0.05
T13,215,12-10-2017 14:26:48,1,2238,1751,0.782,0.4,369,149,20,169,220,37,257,0,0.0,-0.03
T13,216,12-10-2017 14:46:48,1,2548,1959,0.769,0.5,204,84,35,119,120,51,171,0,0.0,0.12
T13,217,12-10-2017 15:06:48,1,2006,1662,0.829,0.4,106,55,16,71,51,15,66,0,0.0,0.0
T13,218,12-10-2017 15:26:48,1,2692,2305,0.856,0.5,979,322,43,365,657,110,767,3,0.0,0.12
T13,219,12-10-2017 15:46:48,1,2221,1795,0.808,0.4,60,27,10,37,33,6,39,0,0.0,0.0
T13,220,12-10-2017 16:06:48,1,2088,1666,0.798,0.4,208,140,65,205,68,32,100,3,0.08,0.0
T13,221,12-10-2017 16:26:48,1,2328,1872,0.804,0.4,173,79,18,97,94,45,139,0,0.0,0.0
T13,222,12-10-2017 16:46:48,1,2477,2044,0.825,0.4,587,280,34,314,307,74,381,0,0.0,0.09
T13,223,12-10-2017 17:06:48,1,2333,1859,0.797,0.4,786,358,71,429,428,74,502,0,0.04,0.0
T13,224,12-10-2017 17:26:48,1,2308,1812,0.785,0.4,127,55,5,60,72,28,100,0,0.0,0.0
T13,225,12-10-2017 17:46:48,1,2442,1965,0.805,0.4,339,151,42,193,188,67,255,0,0.02,0.16
T13,226,12-10-2017 18:06:48,0,3167,2647,0.836,0.6,2461,1242,736,1978,1219,501,1720,264,0.08,0.1
T13,227,12-10-2017 18:26:48,0,2572,2098,0.816,0.5,866,410,113,523,456,158,614,22,0.0,0.0
T13,228,12-10-2017 18:46:48,0,3292,2754,0.837,0.6,2040,1123,683,1806,917,478,1395,369,0.08,0.03
T13,229,12-10-2017 19:06:48,0,3225,2728,0.846,0.6,3677,1944,1161,3105,1733,922,2655,772,0.0,0.18
T13,230,12-10-2017 19:26:48,0,2847,2321,0.815,0.5,2520,1349,759,2108,1171,535,1706,219,0.0,0.0
T13,231,12-10-2017 19:46:48,0,2432,1933,0.795,0.4,406,212,103,315,194,113,307,3,0.06,0.0
T13,232,12-10-2017 20:06:48,0,2796,2229,0.797,0.5,1902,903,459,1362,999,424,1423,69,0.0,0.0
T13,233,12-10-2017 20:26:48,0,2348,1793,0.764,0.4,86,25,4,29,61,21,82,0,0.0,0.0
T13,234,12-10-2017 20:46:48,0,2591,2013,0.777,0.5,940,350,26,376,590,73,663,0,0.0,0.0
T13,235,12-10-2017 21:06:48,0,3014,2413,0.801,0.5,1013,556,320,876,457,255,712,47,0.02,0.0
T13,236,12-10-2017 21:26:48,0,2623,1957,0.746,0.5,666,310,35,345,356,57,413,0,0.0,0.0
T13,237,12-10-2017 21:46:48,0,2942,2290,0.778,0.5,1760,1026,714,1740,734,422,1156,230,0.0,0.0
T13,238,12-10-2017 22:06:48,0,2650,2054,0.775,0.5,3056,1538,965,2503,1518,730,2248,652,0.02,0.0
T13,239,12-10-2017 22:26:48,0,2295,1673,0.729,0.4,258,47,8,55,211,44,255,2,0.0,0.0
T13,240,12-10-2017 22:46:48,0,2483,1816,0.731,0.4,137,50,14,64,87,42,129,0,0.0,0.0
T13,241,12-10-2017 23:06:48,0,3009,2245,0.746,0.5,1707,777,373,1150,930,397,1327,103,0.02,0.0
T13,242,12-10-2017 23:26:48,0,2473,1821,0.736,0.4,100,43,12,55,57,23,80,0,0.0,0.0
T13,243,12-10-2017 23:46:48,0,2510,1832,0.73,0.4,181,92,32,124,89,43,132,0,0.0,0.0
T13,244,13-10-2017 00:06:48,0,2745,2112,0.769,0.5,612,241,76,317,371,99,470,3,0.02,0.0
T13,245,13-10-2017 00:26:48,0,2855,2102,0.736,0.5,2893,1453,896,2349,1440,764,2204,473,0.04,0.0
T13,246,13-10-2017 00:46:48,0,2195,1587,0.723,0.4,1059,570,197,767,489,139,628,14,0.0,0.0
T13,247,13-10-2017 01:06:48,0,1861,1360,0.731,0.3,123,43,10,53,80,33,113,0,0.0,0.0
T13,248,13-10-2017 01:26:48,0,2194,1625,0.741,0.4,529,248,86,334,281,101,382,0,0.0,0.0
T13,249,13-10-2017 01:46:48,0,2304,1690,0.733,0.4,264,112,50,162,152,65,217,1,0.0,0.0
T13,250,13-10-2017 02:06:48,0,2278,1682,0.738,0.4,711,310,72,382,401,80,481,0,0.0,0.0
T13,251,13-10-2017 02:26:48,0,2633,1951,0.741,0.5,742,398,161,559,344,126,470,18,0.0,0.0
T13,252,13-10-2017 02:46:48,0,2559,1857,0.726,0.4,474,289,91,380,185,67,252,17,0.0,0.0
T13,253,13-10-2017 03:06:48,0,2254,1630,0.724,0.4,530,207,39,246,323,41,364,0,0.0,0.0
T13,254,13-10-2017 03:26:48,0,3146,2387,0.759,0.6,1965,1068,658,1726,897,514,1411,359,0.02,0.0
T13,255,13-10-2017 03:46:48,0,2510,1857,0.74,0.4,3151,1665,992,2657,1486,745,2231,699,0.06,0.0
T13,256,13-10-2017 04:06:48,0,2458,1791,0.729,0.4,336,164,22,186,172,35,207,0,0.0,0.0
T13,257,13-10-2017 04:26:48,0,2711,1967,0.725,0.5,214,96,6,102,118,22,140,0,0.0,0.0
T13,258,13-10-2017 04:46:48,0,2640,1897,0.719,0.5,521,174,13,187,347,69,416,0,0.0,0.0
T13,259,13-10-2017 05:06:48,0,3093,2325,0.752,0.5,3577,1930,1278,3208,1647,967,2614,803,0.06,0.0
T13,260,13-10-2017 05:26:48,0,2415,1724,0.714,0.4,1683,776,304,1080,907,316,1223,63,0.02,0.0
T13,261,13-10-2017 05:46:48,0,2223,1598,0.719,0.4,73,45,5,50,28,6,34,0,0.0,0.0
T13,262,13-10-2017 06:06:48,1,2008,1480,0.737,0.4,553,270,130,400,283,150,433,10,0.0,0.0
T13,263,13-10-2017 06:26:48,1,1952,1421,0.728,0.3,54,26,8,34,28,7,35,0,0.0,0.0
T13,264,13-10-2017 06:46:48,1,2371,1794,0.757,0.4,388,142,19,161,246,57,303,0,0.0,0.0
T13,265,13-10-2017 07:06:48,1,2228,1616,0.725,0.4,105,12,5,17,93,38,131,0,0.0,0.0
T13,266,13-10-2017 07:26:48,1,2695,1996,0.741,0.5,861,447,156,603,414,169,583,24,0.0,0.12
T13,267,13-10-2017 07:46:48,1,2334,1751,0.75,0.4,643,313,41,354,330,48,378,0,0.0,-0.03
T13,268,13-10-2017 08:06:48,1,2209,1756,0.795,0.4,335,171,74,245,164,69,233,3,0.06,0.12
T13,269,13-10-2017 08:26:48,1,2323,1859,0.8,0.4,86,21,2,23,65,14,79,0,0.02,0.0
T13,270,13-10-2017 08:46:48,1,1996,1641,0.822,0.4,466,218,84,302,248,70,318,13,0.04,0.19
T13,271,13-10-2017 09:06:48,1,2117,1759,0.831,0.4,83,48,12,60,35,14,49,0,0.0,0.0
T13,272,13-10-2017 09:26:48,1,2192,1755,0.801,0.4,834,390,89,479,444,123,567,1,0.06,0.0
T13,273,13-10-2017 09:46:48,1,2128,1668,0.783,0.4,41,27,3,30,14,3,17,0,0.0,0.0
T13,274,13-10-2017 10:06:48,1,2622,2154,0.822,0.5,241,110,23,133,131,23,154,1,0.0,0.17
T13,275,13-10-2017 10:26:48,1,2141,1719,0.803,0.4,230,80,34,114,150,28,178,0,0.06,0.0
T13,276,13-10-2017 10:46:48,1,2055,1671,0.813,0.4,18,12,7,19,6,0,6,0,0.0,0.0
T13,277,13-10-2017 11:06:48,1,2560,2128,0.832,0.5,415,228,31,259,187,54,241,0,0.0,0.07
T13,278,13-10-2017 11:26:48,1,2398,1937,0.808,0.4,187,86,6,92,101,12,113,0,0.0,0.0
T13,279,13-10-2017 11:46:48,1,2716,2318,0.854,0.5,721,333,104,437,388,118,506,27,0.04,0.1
T13,280,13-10-2017 12:06:48,1,2284,1872,0.82,0.4,1889,1096,574,1670,793,350,1143,180,0.06,0.0
T13,281,13-10-2017 12:26:48,1,2379,1864,0.783,0.4,74,37,3,40,37,11,48,0,0.0,0.0
T13,282,13-10-2017 12:46:48,1,2417,1894,0.784,0.4,158,98,35,133,60,19,79,18,0.04,0.0
T13,283,13-10-2017 13:06:48,1,2223,1790,0.805,0.4,231,93,7,100,138,33,171,0,0.0,0.0
T13,284,13-10-2017 13:26:48,1,2314,1799,0.778,0.4,582,198,15,213,384,64,448,0,0.0,0.0
T13,285,13-10-2017 13:46:48,1,2286,1796,0.786,0.4,282,156,62,218,126,51,177,1,0.06,0.0
T13,286,13-10-2017 14:06:48,1,2320,1937,0.835,0.4,133,74,3,77,59,10,69,0,0.0,0.13
T12,1,09-10-2017 15:04:48,1,3503,2750,0.785,0.5,318,168,34,202,150,26,176,2,0.0,0.0
T12,2,09-10-2017 15:24:48,1,2581,1902,0.737,0.4,72,37,8,45,35,12,47,0,0.0,0.0
T12,3,09-10-2017 15:44:48,1,2727,2138,0.784,0.4,253,154,65,219,99,46,145,7,0.0,0.0
T12,4,09-10-2017 16:04:48,1,2677,2026,0.757,0.4,159,115,27,142,44,11,55,0,0.0,0.0
T12,5,09-10-2017 16:24:48,1,3310,2742,0.829,0.5,875,505,115,620,370,81,451,13,0.0,0.04
T12,6,09-10-2017 16:44:48,1,2525,1907,0.755,0.4,155,126,8,134,29,9,38,0,0.0,0.0
T12,7,09-10-2017 17:04:48,1,2745,2105,0.767,0.4,275,222,30,252,53,21,74,9,0.0,0.09
T12,8,09-10-2017 17:24:48,1,3452,2833,0.821,0.5,1247,755,294,1049,492,190,682,172,0.0,0.0
T12,9,09-10-2017 17:44:48,1,2722,2057,0.756,0.4,996,581,241,822,415,170,585,196,0.0,0.0
T12,10,09-10-2017 18:04:48,0,2893,2134,0.738,0.4,107,77,9,86,30,18,48,0,0.0,0.0
T12,11,09-10-2017 18:24:48,0,4512,3541,0.785,0.7,2944,1902,1159,3061,1042,516,1558,616,0.0,0.02
T12,12,09-10-2017 18:44:48,0,4439,3550,0.8,0.7,5253,3421,2414,5835,1832,1092,2924,1610,0.0,0.15
T12,13,09-10-2017 19:04:48,0,4190,3291,0.785,0.6,4245,2812,1829,4641,1433,794,2227,976,0.0,0.0
T12,14,09-10-2017 19:24:48,0,4229,3240,0.766,0.7,4155,2671,1726,4397,1484,799,2283,1004,0.0,0.0
T12,15,09-10-2017 19:44:48,0,4169,3123,0.749,0.6,3947,2607,1675,4282,1340,717,2057,1110,0.0,0.0
T12,16,09-10-2017 20:04:48,0,4003,3070,0.767,0.6,2557,1483,773,2256,1074,458,1532,518,0.0,0.04
T12,17,09-10-2017 20:24:48,0,3862,2903,0.752,0.6,2850,1793,1079,2872,1057,503,1560,615,0.0,0.02
T12,18,09-10-2017 20:44:48,0,3268,2400,0.735,0.5,1437,877,305,1182,560,223,783,164,0.02,0.0
T12,19,09-10-2017 21:04:48,0,2852,2065,0.724,0.4,323,207,8,215,116,18,134,0,0.0,0.0
T12,20,09-10-2017 21:24:48,0,3817,3143,0.823,0.6,2093,1302,798,2100,791,429,1220,275,0.06,0.31
T12,21,09-10-2017 21:44:48,0,2733,2183,0.799,0.4,836,523,147,670,313,81,394,24,0.06,-0.02
T12,22,09-10-2017 22:04:48,0,2845,2299,0.808,0.4,640,384,139,523,256,86,342,15,0.04,0.17
T12,23,09-10-2017 22:24:48,0,2656,2121,0.798,0.4,328,222,95,317,106,32,138,5,0.02,0.05
T12,24,09-10-2017 22:44:48,0,2943,2359,0.802,0.5,222,139,37,176,83,38,121,10,0.0,0.07
T12,25,09-10-2017 23:04:48,0,3715,2935,0.79,0.6,1844,1121,547,1668,723,346,1069,344,0.12,0.0
T12,26,09-10-2017 23:24:48,0,3039,2300,0.757,0.5,451,200,35,235,251,60,311,0,0.0,0.0
T12,27,09-10-2017 23:44:48,0,2909,2305,0.792,0.5,204,112,28,140,92,45,137,1,0.0,0.14
T12,28,10-10-2017 00:04:48,0,2893,2281,0.789,0.4,66,30,7,37,36,14,50,0,0.0,0.0
T12,29,10-10-2017 00:24:48,0,2919,2366,0.811,0.5,247,155,27,182,92,35,127,0,0.02,0.15
T12,30,10-10-2017 00:44:48,0,2965,2436,0.822,0.5,992,617,200,817,375,133,508,29,0.12,0.0
T12,31,10-10-2017 01:04:48,0,2780,2229,0.802,0.4,140,93,27,120,47,19,66,0,0.0,0.0
T12,32,10-10-2017 01:24:48,0,2902,2317,0.799,0.5,572,335,21,356,237,60,297,0,0.0,0.0
T12,33,10-10-2017 01:44:48,0,3447,2818,0.818,0.5,657,375,150,525,282,121,403,32,0.06,0.11
T12,34,10-10-2017 02:04:48,0,2686,2144,0.798,0.4,25,9,1,10,16,2,18,0,0.0,0.0
T12,35,10-10-2017 02:24:48,0,3326,2783,0.837,0.5,414,241,59,300,173,59,232,0,0.0,0.15
T12,36,10-10-2017 02:44:48,0,2910,2357,0.81,0.5,122,76,33,109,46,19,65,8,0.1,0.0
T12,37,10-10-2017 03:04:48,0,2993,2397,0.801,0.5,197,134,57,191,63,21,84,0,0.04,0.0
T12,38,10-10-2017 03:24:48,0,2858,2301,0.805,0.4,546,339,149,488,207,85,292,36,0.0,0.12
T12,39,10-10-2017 03:44:48,0,3237,2710,0.837,0.5,412,230,59,289,182,37,219,1,0.06,0.0
T12,40,10-10-2017 04:04:48,0,3459,2735,0.791,0.5,1529,914,421,1335,615,282,897,220,0.02,0.0
T12,41,10-10-2017 04:24:48,0,3356,2661,0.793,0.5,1720,1096,525,1621,624,286,910,383,0.0,0.0
T12,42,10-10-2017 04:44:48,0,2949,2217,0.752,0.5,146,96,32,128,50,16,66,0,0.0,0.0
T12,43,10-10-2017 05:04:48,0,3674,2898,0.789,0.6,411,229,52,281,182,66,248,2,0.0,0.0
T12,44,10-10-2017 05:24:48,0,3944,3191,0.809,0.6,1062,686,394,1080,376,175,551,272,0.02,0.09
T12,45,10-10-2017 05:44:48,0,2852,2281,0.8,0.4,635,431,138,569,204,93,297,74,0.0,0.0
T12,46,10-10-2017 06:04:48,1,3052,2343,0.768,0.5,114,53,7,60,61,24,85,0,0.02,0.0
T12,47,10-10-2017 06:24:48,1,3083,2454,0.796,0.5,307,149,8,157,158,32,190,9,0.0,0.0
T12,48,10-10-2017 06:44:48,1,2704,2045,0.756,0.4,89,69,6,75,20,1,21,0,0.0,0.0
T12,49,10-10-2017 07:04:48,1,2845,2250,0.791,0.4,219,158,29,187,61,22,83,0,0.0,0.13
T12,50,10-10-2017 07:24:48,1,2473,1949,0.788,0.4,211,139,47,186,72,25,97,4,0.1,0.0
T12,51,10-10-2017 07:44:48,1,2653,2079,0.784,0.4,92,57,12,69,35,14,49,0,0.0,0.0
T12,52,10-10-2017 08:04:48,1,2528,1981,0.784,0.4,80,47,11,58,33,17,50,0,0.0,0.0
T12,53,10-10-2017 08:24:48,1,2950,2376,0.805,0.5,184,84,12,96,100,35,135,0,0.0,0.03
T12,54,10-10-2017 08:44:48,1,2753,2153,0.782,0.4,620,439,67,506,181,33,214,0,0.0,0.0
T12,55,10-10-2017 09:04:48,1,2546,1968,0.773,0.4,59,33,3,36,26,7,33,0,0.02,0.0
T12,56,10-10-2017 09:24:48,1,2460,1935,0.787,0.4,72,42,14,56,30,10,40,0,0.0,0.0
T12,57,10-10-2017 09:44:48,1,2638,2086,0.791,0.4,169,100,21,121,69,35,104,0,0.0,0.07
T12,58,10-10-2017 10:04:48,1,2884,2359,0.818,0.5,160,106,2,108,54,13,67,0,0.0,0.02
T12,59,10-10-2017 10:24:48,1,3251,2618,0.805,0.5,648,390,112,502,258,65,323,5,0.04,0.11
T12,60,10-10-2017 10:44:48,1,2641,2149,0.814,0.4,281,186,42,228,95,10,105,0,0.0,0.0
T12,61,10-10-2017 11:04:48,1,2673,2140,0.801,0.4,75,42,5,47,33,7,40,0,0.0,0.0
T12,62,10-10-2017 11:24:48,1,2675,2130,0.796,0.4,60,45,9,54,15,6,21,0,0.0,0.0
T12,63,10-10-2017 11:44:48,1,2840,2337,0.823,0.4,448,289,104,393,159,62,221,6,0.06,0.19
T12,64,10-10-2017 12:04:48,1,2994,2473,0.826,0.5,207,117,39,156,90,24,114,0,0.0,0.0
T12,65,10-10-2017 12:24:48,1,3047,2439,0.8,0.5,1000,628,199,827,372,137,509,85,0.1,0.0
T12,66,10-10-2017 12:44:48,1,2760,2173,0.788,0.4,51,27,3,30,24,9,33,0,0.0,0.0
T12,67,10-10-2017 13:04:48,1,2550,2026,0.794,0.4,41,21,5,26,20,8,28,0,0.02,0.0
T12,68,10-10-2017 13:24:48,1,2540,2023,0.796,0.4,95,60,7,67,35,13,48,0,0.0,0.0
T12,69,10-10-2017 13:44:48,1,4692,3778,0.805,0.7,1538,949,470,1419,589,246,835,43,0.0,0.0
T12,70,10-10-2017 14:04:48,1,2826,2169,0.767,0.4,471,285,112,397,186,62,248,14,0.0,0.0
T12,71,10-10-2017 14:24:48,1,2834,2165,0.764,0.4,74,45,9,54,29,14,43,0,0.0,0.0
T12,72,10-10-2017 14:44:48,1,2882,2242,0.778,0.4,54,35,10,45,19,4,23,0,0.0,0.0
T12,73,10-10-2017 15:04:48,1,2709,2114,0.78,0.4,102,54,15,69,48,17,65,0,0.0,0.0
T12,74,10-10-2017 15:24:48,1,2692,2103,0.781,0.4,64,33,12,45,31,15,46,0,0.0,0.0
T12,75,10-10-2017 15:44:48,1,3304,2727,0.825,0.5,398,199,41,240,199,59,258,0,0.0,0.08
T12,76,10-10-2017 16:04:48,1,2771,2263,0.817,0.4,446,267,49,316,179,20,199,0,0.0,0.02
T12,77,10-10-2017 16:24:48,1,2906,2385,0.821,0.5,172,95,21,116,77,26,103,0,0.0,0.07
T12,78,10-10-2017 16:44:48,1,2941,2348,0.798,0.5,103,74,26,100,29,12,41,0,0.0,0.03
T12,79,10-10-2017 17:04:48,1,2554,2009,0.786,0.4,259,125,30,155,134,33,167,0,0.0,0.0
T12,80,10-10-2017 17:24:48,1,2784,2167,0.778,0.4,179,114,42,156,65,15,80,0,0.0,0.0
T12,81,10-10-2017 17:44:48,1,3055,2455,0.804,0.5,228,122,40,162,106,30,136,0,0.0,0.0
T12,82,10-10-2017 18:04:48,0,3100,2469,0.796,0.5,462,272,113,385,190,65,255,8,0.0,0.12
T12,83,10-10-2017 18:24:48,0,4202,3533,0.841,0.7,1564,919,419,1338,645,331,976,244,0.0,0.04
T12,84,10-10-2017 18:44:48,0,4229,3462,0.819,0.7,3380,2122,1008,3130,1258,613,1871,506,0.06,0.31
T12,85,10-10-2017 19:04:48,0,3993,3201,0.802,0.6,2256,1324,547,1871,932,347,1279,212,0.0,0.12
T12,86,10-10-2017 19:24:48,0,4236,3247,0.766,0.7,2559,1534,786,2320,1025,461,1486,424,0.02,0.13
T12,87,10-10-2017 19:44:48,0,3335,2512,0.753,0.5,1458,789,150,939,669,183,852,21,0.0,0.0
T12,88,10-10-2017 20:04:48,0,3022,2240,0.741,0.5,157,89,34,123,68,30,98,0,0.0,0.0
T12,89,10-10-2017 20:24:48,0,3901,3048,0.781,0.6,959,602,197,799,357,154,511,95,0.0,0.0
T12,90,10-10-2017 20:44:48,0,3817,2911,0.762,0.6,2857,1875,1124,2999,982,484,1466,833,0.04,0.0
T12,91,10-10-2017 21:04:48,0,3482,2612,0.75,0.5,1627,1038,246,1284,589,210,799,169,0.0,0.0
T12,92,10-10-2017 21:24:48,0,3310,2468,0.745,0.5,286,186,47,233,100,29,129,0,0.0,0.1
T12,93,10-10-2017 21:44:48,0,3990,3212,0.805,0.6,2109,1309,803,2112,800,408,1208,697,0.12,0.08
T12,94,10-10-2017 22:04:48,0,2714,2063,0.76,0.4,815,513,133,646,302,105,407,17,0.02,0.0
T12,95,10-10-2017 22:24:48,0,3341,2610,0.781,0.5,502,292,82,374,210,59,269,9,0.0,0.0
T12,96,10-10-2017 22:44:48,0,3645,2778,0.762,0.6,1782,1069,573,1642,713,335,1048,846,0.12,0.03
T12,97,10-10-2017 23:04:48,0,3225,2390,0.741,0.5,274,119,21,140,155,47,202,0,0.0,0.0
T12,98,10-10-2017 23:24:48,0,3524,2747,0.78,0.5,1097,702,166,868,395,138,533,38,0.0,0.13
T12,99,10-10-2017 23:44:48,0,2966,2244,0.756,0.5,1190,767,319,1086,423,207,630,336,0.04,0.0
T12,100,11-10-2017 00:04:48,0,3432,2604,0.759,0.5,301,165,38,203,136,53,189,0,0.0,0.0
T12,101,11-10-2017 00:24:48,0,3660,2898,0.792,0.6,443,266,53,319,177,70,247,12,0.0,0.07
T12,102,11-10-2017 00:44:48,0,3229,2466,0.764,0.5,559,306,67,373,253,67,320,0,0.0,0.0
T12,103,11-10-2017 01:04:48,0,3259,2482,0.762,0.5,543,309,150,459,234,81,315,20,0.0,0.0
T12,104,11-10-2017 01:24:48,0,3055,2327,0.762,0.5,528,281,34,315,247,59,306,0,0.02,0.0
T12,105,11-10-2017 01:44:48,0,3740,2804,0.75,0.6,449,251,49,300,198,54,252,0,0.0,0.0
T12,106,11-10-2017 02:04:48,0,3520,2696,0.766,0.5,691,486,85,571,205,59,264,6,0.0,0.0
T12,107,11-10-2017 02:24:48,0,3480,2732,0.785,0.5,2319,1434,779,2213,885,424,1309,539,0.14,0.15
T12,108,11-10-2017 02:44:48,0,3337,2523,0.756,0.5,92,50,4,54,42,15,57,0,0.0,0.0
T12,109,11-10-2017 03:04:48,0,2931,2237,0.763,0.5,584,360,52,412,224,50,274,0,0.0,0.0
T12,110,11-10-2017 03:24:48,0,3142,2389,0.76,0.5,356,217,71,288,139,65,204,0,0.0,0.07
T12,111,11-10-2017 03:44:48,0,3139,2368,0.754,0.5,616,384,140,524,232,71,303,46,0.0,0.0
T12,112,11-10-2017 04:04:48,0,3343,2673,0.8,0.5,656,430,65,495,226,71,297,3,0.0,0.0
T12,113,11-10-2017 04:24:48,0,3572,2719,0.761,0.6,2317,1423,784,2207,894,461,1355,574,0.18,0.02
T12,114,11-10-2017 04:44:48,0,3212,2352,0.732,0.5,219,162,51,213,57,14,71,0,0.0,0.0
T12,115,11-10-2017 05:04:48,0,2820,2095,0.743,0.4,437,263,63,326,174,50,224,0,0.0,0.0
T12,116,11-10-2017 05:24:48,0,2938,2195,0.747,0.5,398,217,53,270,181,64,245,1,0.0,0.0
T12,117,11-10-2017 05:44:48,0,3617,2745,0.759,0.6,1749,1075,554,1629,674,326,1000,287,0.0,0.09
T12,118,11-10-2017 06:04:48,1,2825,2131,0.754,0.4,170,110,25,135,60,11,71,0,0.0,0.0
T12,119,11-10-2017 06:24:48,1,3299,2502,0.758,0.5,50,28,12,40,22,6,28,0,0.0,0.0
T12,120,11-10-2017 06:44:48,1,2738,2233,0.816,0.4,413,291,77,368,122,49,171,0,0.0,0.1
T12,121,11-10-2017 07:04:48,1,3033,2357,0.777,0.5,79,56,6,62,23,7,30,0,0.0,0.03
T12,122,11-10-2017 07:24:48,1,3288,2698,0.821,0.5,657,461,184,645,196,82,278,73,0.0,0.0
T12,123,11-10-2017 07:44:48,1,2664,2041,0.766,0.4,104,40,6,46,64,10,74,0,0.0,0.0
T12,124,11-10-2017 08:04:48,1,2713,2203,0.812,0.4,164,92,20,112,72,19,91,0,0.0,0.13
T12,125,11-10-2017 08:24:48,1,2651,2160,0.815,0.4,47,13,4,17,34,23,57,0,0.0,0.0
T12,126,11-10-2017 08:44:48,1,2490,1960,0.787,0.4,220,164,77,241,56,24,80,16,0.0,0.02
T12,127,11-10-2017 09:04:48,1,2582,2047,0.793,0.4,224,141,37,178,83,22,105,0,0.0,0.0
T12,128,11-10-2017 09:24:48,1,2525,1970,0.78,0.4,154,102,57,159,52,14,66,15,0.0,0.0
T12,129,11-10-2017 09:44:48,1,2595,2116,0.815,0.4,139,70,12,82,69,23,92,0,0.0,0.09
T12,130,11-10-2017 10:04:48,1,2683,2223,0.829,0.4,312,231,85,316,81,26,107,14,0.0,0.0
T12,131,11-10-2017 10:24:48,1,3267,2637,0.807,0.5,1845,1264,573,1837,581,264,845,365,0.0,0.0
T12,132,11-10-2017 10:44:48,1,2780,2173,0.781,0.4,148,59,1,60,89,16,105,0,0.0,0.0
T12,133,11-10-2017 11:04:48,1,2744,2129,0.776,0.4,201,113,28,141,88,40,128,0,0.0,0.1
T12,134,11-10-2017 11:24:48,1,2611,2172,0.832,0.4,48,32,2,34,16,2,18,0,0.0,0.0
T12,135,11-10-2017 11:44:48,1,3090,2602,0.842,0.5,616,394,107,501,222,70,292,2,0.0,0.0
T12,136,11-10-2017 12:04:48,1,2606,2024,0.777,0.4,238,117,20,137,121,29,150,0,0.0,0.0
T12,137,11-10-2017 12:24:48,1,2688,2046,0.761,0.4,103,72,16,88,31,17,48,0,0.0,0.0
T12,138,11-10-2017 12:44:48,1,2477,1966,0.794,0.4,108,74,23,97,34,13,47,0,0.0,0.07
T12,139,11-10-2017 13:04:48,1,2523,2049,0.812,0.4,175,160,13,173,15,7,22,0,0.04,0.0
T12,140,11-10-2017 13:24:48,1,3417,2785,0.815,0.5,1000,701,151,852,299,105,404,46,0.22,0.0
T12,141,11-10-2017 13:44:48,1,2755,2046,0.743,0.4,328,215,59,274,113,19,132,0,0.0,0.0
T12,142,11-10-2017 14:04:48,1,2988,2301,0.77,0.5,232,154,61,215,78,37,115,0,0.0,0.03
T12,143,11-10-2017 14:24:48,1,2881,2209,0.767,0.4,281,150,19,169,131,22,153,0,0.0,0.0
T12,144,11-10-2017 14:44:48,1,2714,2091,0.77,0.4,185,107,21,128,78,31,109,0,0.0,0.0
T12,145,11-10-2017 15:04:48,1,2747,2064,0.751,0.4,81,38,7,45,43,12,55,0,0.0,0.03
T12,146,11-10-2017 15:24:48,1,3155,2630,0.834,0.5,658,358,81,439,300,69,369,3,0.0,0.12
T12,147,11-10-2017 15:44:48,1,2779,2130,0.767,0.4,653,409,188,597,244,122,366,92,0.0,0.0
T12,148,11-10-2017 16:04:48,1,2768,2171,0.784,0.4,52,31,12,43,21,6,27,0,0.0,0.0
T12,149,11-10-2017 16:24:48,1,2590,2026,0.782,0.4,133,84,25,109,49,14,63,0,0.0,0.0
T12,150,11-10-2017 16:44:48,1,2557,1962,0.767,0.4,779,519,149,668,260,91,351,73,0.0,0.0
T12,151,11-10-2017 17:04:48,1,2643,1983,0.75,0.4,48,39,8,47,9,3,12,0,0.0,0.0
T12,152,11-10-2017 17:24:48,1,3728,2864,0.768,0.6,715,449,242,691,266,135,401,8,0.0,0.03
T12,153,11-10-2017 17:44:48,1,2746,2080,0.757,0.4,100,56,14,70,44,23,67,0,0.0,0.0
T12,154,11-10-2017 18:04:48,0,3440,2812,0.818,0.5,415,229,49,278,186,61,247,0,0.0,0.05
T12,155,11-10-2017 18:24:48,0,3212,2455,0.764,0.5,754,463,149,612,291,96,387,23,0.0,0.0
T12,156,11-10-2017 18:44:48,0,4071,3353,0.824,0.6,2400,1551,864,2415,849,431,1280,409,0.0,0.44
T12,157,11-10-2017 19:04:48,0,3700,2944,0.796,0.6,2403,1502,818,2320,901,458,1359,402,0.24,0.17
T12,158,11-10-2017 19:24:48,0,2830,2144,0.758,0.4,985,636,210,846,349,93,442,150,0.02,0.0
T12,159,11-10-2017 19:44:48,0,2790,2182,0.782,0.4,495,301,103,404,194,87,281,33,0.0,0.13
T12,160,11-10-2017 20:04:48,0,3246,2707,0.834,0.5,760,459,84,543,301,67,368,8,0.0,0.14
T12,161,11-10-2017 20:24:48,0,3166,2519,0.796,0.5,260,170,53,223,90,43,133,16,0.04,0.02
T12,162,11-10-2017 20:44:48,0,3084,2446,0.793,0.5,220,146,31,177,74,23,97,0,0.0,0.0
T12,163,11-10-2017 21:04:48,0,4197,3407,0.812,0.7,1829,1079,445,1524,750,324,1074,312,0.02,0.24
T12,164,11-10-2017 21:24:48,0,3883,3097,0.797,0.6,2360,1373,603,1976,987,440,1427,471,0.18,0.18
T12,165,11-10-2017 21:44:48,0,2946,2238,0.76,0.5,334,189,38,227,145,32,177,0,0.0,0.0
T12,166,11-10-2017 22:04:48,0,2871,2210,0.77,0.4,186,96,35,131,90,48,138,0,0.0,0.1
T12,167,11-10-2017 22:24:48,0,3017,2372,0.786,0.5,101,34,10,44,67,31,98,0,0.0,0.0
T12,168,11-10-2017 22:44:48,0,3398,2829,0.833,0.5,831,447,115,562,384,138,522,6,0.0,0.0
T12,169,11-10-2017 23:04:48,0,2922,2260,0.774,0.5,231,141,49,190,90,36,126,0,0.0,0.1
T12,170,11-10-2017 23:24:48,0,3438,2742,0.797,0.5,195,105,33,138,90,43,133,0,0.0,0.0
T12,171,11-10-2017 23:44:48,0,4044,3339,0.826,0.6,1950,1236,586,1822,714,340,1054,478,0.18,0.13
T12,172,12-10-2017 00:04:48,0,3446,2684,0.779,0.5,383,249,31,280,134,29,163,9,0.0,0.0
T12,173,12-10-2017 00:24:48,0,3030,2396,0.791,0.5,692,382,81,463,310,99,409,0,0.0,0.03
T12,174,12-10-2017 00:44:48,0,3239,2524,0.779,0.5,178,89,23,112,89,51,140,0,0.0,0.0
T12,175,12-10-2017 01:04:48,0,3336,2773,0.831,0.5,604,343,46,389,261,55,316,2,0.0,0.0
T12,176,12-10-2017 01:24:48,0,3459,2645,0.765,0.5,390,222,50,272,168,63,231,0,0.0,0.1
T12,177,12-10-2017 01:44:48,0,3202,2525,0.789,0.5,233,161,67,228,72,34,106,8,0.0,0.0
T12,178,12-10-2017 02:04:48,0,4083,3293,0.807,0.6,1699,1002,360,1362,697,303,1000,215,0.14,0.18
T12,179,12-10-2017 02:24:48,0,3428,2777,0.81,0.5,313,122,13,135,191,44,235,0,0.0,0.0
T12,180,12-10-2017 02:44:48,0,3422,2724,0.796,0.5,578,369,174,543,209,97,306,50,0.06,0.03
T12,181,12-10-2017 03:04:48,0,3125,2506,0.802,0.5,376,228,39,267,148,54,202,0,0.0,0.0
T12,182,12-10-2017 03:24:48,0,3308,2509,0.758,0.5,292,171,58,229,121,28,149,0,0.0,0.0
T12,183,12-10-2017 03:44:48,0,3275,2510,0.766,0.5,199,119,39,158,80,25,105,0,0.0,0.0
T12,184,12-10-2017 04:04:48,0,3803,3052,0.803,0.6,798,524,140,664,274,85,359,20,0.04,0.0
T12,185,12-10-2017 04:24:48,0,3822,3096,0.81,0.6,2234,1388,731,2119,846,398,1244,476,0.1,0.16
T12,186,12-10-2017 04:44:48,0,3404,2689,0.79,0.5,157,104,15,119,53,13,66,0,0.0,0.0
T12,187,12-10-2017 05:04:48,0,3287,2545,0.774,0.5,418,224,49,273,194,64,258,0,0.0,0.0
T12,188,12-10-2017 05:24:48,0,3254,2485,0.764,0.5,404,252,72,324,152,50,202,0,0.02,0.06
T12,189,12-10-2017 05:44:48,0,3739,3033,0.811,0.6,795,470,164,634,325,117,442,92,0.0,0.0
T12,190,12-10-2017 06:04:48,1,3191,2555,0.801,0.5,1102,676,279,955,426,150,576,108,0.1,0.03
T12,191,12-10-2017 06:24:48,1,3188,2435,0.764,0.5,78,32,20,52,46,17,63,0,0.0,0.0
T12,192,12-10-2017 06:44:48,1,2308,1791,0.776,0.4,177,101,21,122,76,37,113,0,0.0,0.13
T12,193,12-10-2017 07:04:48,1,3172,2565,0.809,0.5,63,33,5,38,30,5,35,1,0.0,0.0
T12,194,12-10-2017 07:24:48,1,3093,2476,0.8,0.5,453,303,66,369,150,31,181,0,0.0,0.0
T12,195,12-10-2017 07:44:48,1,2696,2082,0.772,0.4,609,334,103,437,275,66,341,13,0.0,0.0
T12,196,12-10-2017 08:04:48,1,2863,2171,0.758,0.4,59,30,8,38,29,5,34,0,0.0,0.0
T12,197,12-10-2017 08:24:48,1,2718,2061,0.758,0.4,118,48,10,58,70,36,106,0,0.0,0.0
T12,198,12-10-2017 08:44:48,1,2577,2036,0.79,0.4,202,119,26,145,83,38,121,0,0.0,0.04
T12,199,12-10-2017 09:04:48,1,2339,1871,0.8,0.4,161,90,29,119,71,26,97,0,0.0,0.06
T12,200,12-10-2017 09:24:48,1,2296,1842,0.803,0.4,96,49,16,65,47,12,59,0,0.0,0.0
T12,201,12-10-2017 09:44:48,1,3502,2845,0.813,0.5,856,543,204,747,313,124,437,108,0.0,0.0
T12,202,12-10-2017 10:04:48,1,2819,2185,0.775,0.4,401,202,30,232,199,40,239,0,0.0,0.0
T12,203,12-10-2017 10:24:48,1,2579,1960,0.76,0.4,80,58,4,62,22,7,29,0,0.0,0.0
T12,204,12-10-2017 10:44:48,1,2741,2090,0.762,0.4,62,37,7,44,25,8,33,0,0.0,0.0
T12,205,12-10-2017 11:04:48,1,2797,2259,0.808,0.4,317,188,64,252,129,64,193,1,0.0,0.12
T12,206,12-10-2017 11:24:48,1,2877,2284,0.794,0.4,76,42,9,51,34,14,48,0,0.0,0.0
T12,207,12-10-2017 11:44:48,1,2829,2233,0.79,0.4,965,520,141,661,445,122,567,37,0.0,0.0
T12,208,12-10-2017 12:04:48,1,2958,2302,0.778,0.5,77,41,10,51,36,12,48,0,0.0,0.0
T12,209,12-10-2017 12:24:48,1,2652,2053,0.774,0.4,76,40,16,56,36,11,47,0,0.0,0.0
T12,210,12-10-2017 12:44:48,1,2912,2371,0.814,0.5,177,111,48,159,66,32,98,4,0.0,0.09
T12,211,12-10-2017 13:04:48,1,2673,2198,0.822,0.4,473,245,52,297,228,59,287,0,0.0,0.0
T12,212,12-10-2017 13:24:48,1,2654,2039,0.768,0.4,11,7,0,7,4,1,5,0,0.0,0.0
T12,213,12-10-2017 13:44:48,1,2650,2202,0.831,0.4,464,317,66,383,147,47,194,3,0.0,0.06
T12,214,12-10-2017 14:04:48,1,3054,2391,0.783,0.5,536,351,170,521,185,97,282,19,0.0,0.0
T12,215,12-10-2017 14:24:48,1,2507,1981,0.79,0.4,111,46,12,58,65,22,87,0,0.0,0.0
T12,216,12-10-2017 14:44:48,1,2800,2135,0.763,0.4,110,66,17,83,44,17,61,0,0.0,0.0
T12,217,12-10-2017 15:04:48,1,2899,2227,0.768,0.4,116,81,17,98,35,19,54,0,0.0,0.08
T12,218,12-10-2017 15:24:48,1,3130,2639,0.843,0.5,327,198,37,235,129,44,173,1,0.0,0.1
T12,219,12-10-2017 15:44:48,1,2812,2253,0.801,0.4,218,119,6,125,99,25,124,0,0.0,0.0
T12,220,12-10-2017 16:04:48,1,2810,2258,0.803,0.4,72,43,27,70,29,22,51,0,0.0,0.0
T12,221,12-10-2017 16:24:48,1,2796,2291,0.819,0.4,167,137,27,164,30,8,38,0,0.0,0.04
T12,222,12-10-2017 16:44:48,1,3291,2763,0.84,0.5,781,450,102,552,331,87,418,4,0.2,0.0
T12,223,12-10-2017 17:04:48,1,2808,2242,0.798,0.4,463,297,42,339,166,30,196,0,0.0,0.05
T12,224,12-10-2017 17:24:48,1,2752,2206,0.802,0.4,53,29,7,36,24,10,34,0,0.0,0.0
T12,225,12-10-2017 17:44:48,1,3183,2594,0.815,0.5,695,449,68,517,246,56,302,0,0.0,0.0
T12,226,12-10-2017 18:04:48,0,3457,2701,0.782,0.5,470,291,74,365,179,61,240,5,0.0,0.0
T12,227,12-10-2017 18:24:48,0,4211,3458,0.821,0.7,2354,1454,730,2184,900,414,1314,465,0.0,0.36
T12,228,12-10-2017 18:44:48,0,3246,2631,0.811,0.5,1828,1121,541,1662,707,306,1013,253,0.16,0.03
T12,229,12-10-2017 19:04:48,0,3159,2438,0.772,0.5,146,92,43,135,54,18,72,0,0.0,0.0
T12,230,12-10-2017 19:24:48,0,3868,2999,0.775,0.6,1956,1255,725,1980,701,380,1081,204,0.0,0.0
T12,231,12-10-2017 19:44:48,0,2812,2070,0.736,0.4,1094,690,283,973,404,192,596,125,0.0,0.0
T12,232,12-10-2017 20:04:48,0,3896,2969,0.762,0.6,1131,736,238,974,395,140,535,56,0.0,0.0
T12,233,12-10-2017 20:24:48,0,3030,2288,0.755,0.5,1644,1076,432,1508,568,261,829,131,0.04,0.0
T12,234,12-10-2017 20:44:48,0,3270,2470,0.755,0.5,288,212,54,266,76,31,107,0,0.0,0.0
T12,235,12-10-2017 21:04:48,0,3167,2382,0.752,0.5,275,129,15,144,146,27,173,0,0.0,0.0
T12,236,12-10-2017 21:24:48,0,3941,3017,0.766,0.6,2223,1477,747,2224,746,364,1110,464,0.0,0.0
T12,237,12-10-2017 21:44:48,0,2659,2010,0.756,0.4,903,568,182,750,335,147,482,208,0.04,0.0
T12,238,12-10-2017 22:04:48,0,3389,2481,0.732,0.5,199,131,31,162,68,26,94,0,0.0,0.0
T12,239,12-10-2017 22:24:48,0,2837,2057,0.725,0.4,753,488,146,634,265,120,385,37,0.0,0.0
T12,240,12-10-2017 22:44:48,0,3363,2555,0.76,0.5,492,285,46,331,207,42,249,0,0.0,0.0
T12,241,12-10-2017 23:04:48,0,3440,2570,0.747,0.5,2466,1515,821,2336,951,492,1443,707,0.0,0.0
T12,242,12-10-2017 23:24:48,0,2573,1854,0.72,0.4,731,423,133,556,308,106,414,49,0.04,0.0
T12,243,12-10-2017 23:44:48,0,2866,2083,0.727,0.4,50,34,3,37,16,5,21,0,0.0,0.0
T12,244,13-10-2017 00:04:48,0,2499,1833,0.734,0.4,935,539,199,738,396,157,553,88,0.0,0.0
T12,245,13-10-2017 00:24:48,0,2821,2064,0.731,0.4,118,71,10,81,47,14,61,0,0.0,0.0
T12,246,13-10-2017 00:44:48,0,2665,1945,0.73,0.4,1018,656,216,872,362,130,492,55,0.0,0.0
T12,247,13-10-2017 01:04:48,0,3051,2213,0.725,0.5,263,165,63,228,98,31,129,12,0.0,0.0
T12,248,13-10-2017 01:24:48,0,3154,2318,0.735,0.5,312,208,46,254,104,16,120,0,0.0,0.0
T12,249,13-10-2017 01:44:48,0,3868,2885,0.746,0.6,508,339,94,433,169,58,227,0,0.0,0.0
T12,250,13-10-2017 02:04:48,0,2936,2134,0.727,0.4,932,580,247,827,352,161,513,75,0.0,0.0
T12,251,13-10-2017 02:24:48,0,2730,1996,0.731,0.4,308,193,54,247,115,38,153,0,0.0,0.0
T12,252,13-10-2017 02:44:48,0,2900,2102,0.725,0.4,524,261,37,298,263,49,312,0,0.0,0.0
T12,253,13-10-2017 03:04:48,0,2851,2053,0.72,0.4,329,243,128,371,86,40,126,8,0.0,0.0
T12,254,13-10-2017 03:24:48,0,3102,2251,0.726,0.5,449,274,58,332,175,54,229,0,0.0,0.0
T12,255,13-10-2017 03:44:48,0,3289,2418,0.735,0.5,733,471,97,568,262,46,308,2,0.0,0.0
T12,256,13-10-2017 04:04:48,0,3110,2255,0.725,0.5,296,194,53,247,102,51,153,1,0.0,0.0
T12,257,13-10-2017 04:24:48,0,3004,2128,0.708,0.5,250,171,61,232,79,26,105,7,0.0,0.0
T12,258,13-10-2017 04:44:48,0,2766,1961,0.709,0.4,610,386,85,471,224,71,295,0,0.0,0.0
T12,259,13-10-2017 05:04:48,0,3365,2499,0.743,0.5,429,274,51,325,155,42,197,12,0.0,0.0
T12,260,13-10-2017 05:24:48,0,3865,2792,0.722,0.6,2899,1921,1024,2945,978,472,1450,649,0.0,0.0
T12,261,13-10-2017 05:44:48,0,3050,2235,0.733,0.5,1884,1225,636,1861,659,305,964,380,0.08,0.0
T12,262,13-10-2017 06:04:48,1,2359,1725,0.731,0.4,284,189,47,236,95,27,122,6,0.0,0.0
T12,263,13-10-2017 06:24:48,1,2767,2023,0.731,0.4,215,170,38,208,45,17,62,0,0.0,0.0
T12,264,13-10-2017 06:44:48,1,2141,1591,0.743,0.3,343,198,34,232,145,33,178,0,0.0,0.0
T12,265,13-10-2017 07:04:48,1,2811,2027,0.721,0.4,163,89,23,112,74,24,98,0,0.0,0.0
T12,266,13-10-2017 07:24:48,1,3242,2359,0.728,0.5,808,455,137,592,353,144,497,15,0.0,0.21
T12,267,13-10-2017 07:44:48,1,2649,2058,0.777,0.4,160,119,56,175,41,14,55,5,0.0,0.0
T12,268,13-10-2017 08:04:48,1,2926,2323,0.794,0.5,224,138,26,164,86,34,120,0,0.0,0.13
T12,269,13-10-2017 08:24:48,1,2905,2386,0.821,0.5,154,113,59,172,41,22,63,4,0.0,0.08
T12,270,13-10-2017 08:44:48,1,2520,2024,0.803,0.4,105,62,17,79,43,16,59,0,0.0,0.0
T12,271,13-10-2017 09:04:48,1,2931,2347,0.801,0.5,121,96,23,119,25,11,36,5,0.0,0.0
T12,272,13-10-2017 09:24:48,1,3364,2771,0.824,0.5,1210,776,367,1143,434,204,638,251,0.0,0.06
T12,273,13-10-2017 09:44:48,1,2978,2308,0.775,0.5,262,148,19,167,114,33,147,0,0.02,0.0
T12,274,13-10-2017 10:04:48,1,2685,2110,0.786,0.4,62,36,12,48,26,8,34,0,0.0,0.0
T12,275,13-10-2017 10:24:48,1,2893,2341,0.809,0.5,109,67,17,84,42,13,55,0,0.0,0.07
T12,276,13-10-2017 10:44:48,1,2483,2054,0.827,0.4,182,128,42,170,54,18,72,1,0.0,0.0
T12,277,13-10-2017 11:04:48,1,2727,2189,0.803,0.4,40,30,13,43,10,2,12,0,0.0,0.0
T12,278,13-10-2017 11:24:48,1,3107,2588,0.833,0.5,438,321,132,453,117,52,169,7,0.0,0.13
T12,279,13-10-2017 11:44:48,1,2551,2048,0.803,0.4,841,541,187,728,300,117,417,77,0.0,0.0
T12,280,13-10-2017 12:04:48,1,2464,1995,0.81,0.4,67,29,11,40,38,20,58,0,0.0,0.0
T12,281,13-10-2017 12:24:48,1,2297,1828,0.796,0.4,68,47,15,62,21,10,31,0,0.0,0.0
T12,282,13-10-2017 12:44:48,1,2761,2175,0.788,0.4,103,58,20,78,45,17,62,0,0.0,0.0
T12,283,13-10-2017 13:04:48,1,2599,2025,0.779,0.4,73,59,10,69,14,6,20,0,0.0,0.0
T12,284,13-10-2017 13:24:48,1,3764,3209,0.852,0.6,930,629,303,932,301,119,420,65,0.12,0.13
T12,285,13-10-2017 13:44:48,1,3247,2667,0.821,0.5,1133,660,169,829,473,127,600,40,0.22,0.0
T12,286,13-10-2017 14:04:48,1,2503,1965,0.785,0.4,52,29,5,34,23,11,34,0,0.0,0.0
